"SUMLEV","STATE","COUNTY","STNAME","CTYNAME","YEAR","AGE","TOT_POP","TOT_MALE","TOT_FEMALE"
050,18,001,"Indiana","Adams County",1,0,625,318,307
050,18,001,"Indiana","Adams County",1,1,623,307,316
050,18,001,"Indiana","Adams County",1,2,644,322,322
050,18,001,"Indiana","Adams County",1,3,658,338,320
050,18,001,"Indiana","Adams County",1,4,680,345,335
050,18,001,"Indiana","Adams County",1,5,627,331,296
050,18,001,"Indiana","Adams County",1,6,666,350,316
050,18,001,"Indiana","Adams County",1,7,652,338,314
050,18,001,"Indiana","Adams County",1,8,621,323,298
050,18,001,"Indiana","Adams County",1,9,599,330,269
050,18,001,"Indiana","Adams County",1,10,624,352,272
050,18,001,"Indiana","Adams County",1,11,615,323,292
050,18,001,"Indiana","Adams County",1,12,634,309,325
050,18,001,"Indiana","Adams County",1,13,638,314,324
050,18,001,"Indiana","Adams County",1,14,598,290,308
050,18,001,"Indiana","Adams County",1,15,573,300,273
050,18,001,"Indiana","Adams County",1,16,595,310,285
050,18,001,"Indiana","Adams County",1,17,599,304,295
050,18,001,"Indiana","Adams County",1,18,480,252,228
050,18,001,"Indiana","Adams County",1,19,381,198,183
050,18,001,"Indiana","Adams County",1,20,415,206,209
050,18,001,"Indiana","Adams County",1,21,433,234,199
050,18,001,"Indiana","Adams County",1,22,441,224,217
050,18,001,"Indiana","Adams County",1,23,429,203,226
050,18,001,"Indiana","Adams County",1,24,422,226,196
050,18,001,"Indiana","Adams County",1,25,434,227,207
050,18,001,"Indiana","Adams County",1,26,434,232,202
050,18,001,"Indiana","Adams County",1,27,430,225,205
050,18,001,"Indiana","Adams County",1,28,443,229,214
050,18,001,"Indiana","Adams County",1,29,447,238,209
050,18,001,"Indiana","Adams County",1,30,440,232,208
050,18,001,"Indiana","Adams County",1,31,402,217,185
050,18,001,"Indiana","Adams County",1,32,371,180,191
050,18,001,"Indiana","Adams County",1,33,355,181,174
050,18,001,"Indiana","Adams County",1,34,370,195,175
050,18,001,"Indiana","Adams County",1,35,385,192,193
050,18,001,"Indiana","Adams County",1,36,387,191,196
050,18,001,"Indiana","Adams County",1,37,399,199,200
050,18,001,"Indiana","Adams County",1,38,385,197,188
050,18,001,"Indiana","Adams County",1,39,379,201,178
050,18,001,"Indiana","Adams County",1,40,382,199,183
050,18,001,"Indiana","Adams County",1,41,373,180,193
050,18,001,"Indiana","Adams County",1,42,370,182,188
050,18,001,"Indiana","Adams County",1,43,375,192,183
050,18,001,"Indiana","Adams County",1,44,383,212,171
050,18,001,"Indiana","Adams County",1,45,390,219,171
050,18,001,"Indiana","Adams County",1,46,350,187,163
050,18,001,"Indiana","Adams County",1,47,354,171,183
050,18,001,"Indiana","Adams County",1,48,358,174,184
050,18,001,"Indiana","Adams County",1,49,440,228,212
050,18,001,"Indiana","Adams County",1,50,380,195,185
050,18,001,"Indiana","Adams County",1,51,385,197,188
050,18,001,"Indiana","Adams County",1,52,382,197,185
050,18,001,"Indiana","Adams County",1,53,409,213,196
050,18,001,"Indiana","Adams County",1,54,381,197,184
050,18,001,"Indiana","Adams County",1,55,403,203,200
050,18,001,"Indiana","Adams County",1,56,418,203,215
050,18,001,"Indiana","Adams County",1,57,409,214,195
050,18,001,"Indiana","Adams County",1,58,418,221,197
050,18,001,"Indiana","Adams County",1,59,426,213,213
050,18,001,"Indiana","Adams County",1,60,391,185,206
050,18,001,"Indiana","Adams County",1,61,416,209,207
050,18,001,"Indiana","Adams County",1,62,406,205,201
050,18,001,"Indiana","Adams County",1,63,417,196,221
050,18,001,"Indiana","Adams County",1,64,407,192,215
050,18,001,"Indiana","Adams County",1,65,392,187,205
050,18,001,"Indiana","Adams County",1,66,371,182,189
050,18,001,"Indiana","Adams County",1,67,338,159,179
050,18,001,"Indiana","Adams County",1,68,341,167,174
050,18,001,"Indiana","Adams County",1,69,322,155,167
050,18,001,"Indiana","Adams County",1,70,299,144,155
050,18,001,"Indiana","Adams County",1,71,289,135,154
050,18,001,"Indiana","Adams County",1,72,294,139,155
050,18,001,"Indiana","Adams County",1,73,297,138,159
050,18,001,"Indiana","Adams County",1,74,211,92,119
050,18,001,"Indiana","Adams County",1,75,223,103,120
050,18,001,"Indiana","Adams County",1,76,212,96,116
050,18,001,"Indiana","Adams County",1,77,197,82,115
050,18,001,"Indiana","Adams County",1,78,174,82,92
050,18,001,"Indiana","Adams County",1,79,163,71,92
050,18,001,"Indiana","Adams County",1,80,136,53,83
050,18,001,"Indiana","Adams County",1,81,159,67,92
050,18,001,"Indiana","Adams County",1,82,148,61,87
050,18,001,"Indiana","Adams County",1,83,131,49,82
050,18,001,"Indiana","Adams County",1,84,120,40,80
050,18,001,"Indiana","Adams County",1,85,832,289,543
050,18,001,"Indiana","Adams County",2,0,638,318,320
050,18,001,"Indiana","Adams County",2,1,621,308,313
050,18,001,"Indiana","Adams County",2,2,639,318,321
050,18,001,"Indiana","Adams County",2,3,650,332,318
050,18,001,"Indiana","Adams County",2,4,672,341,331
050,18,001,"Indiana","Adams County",2,5,640,333,307
050,18,001,"Indiana","Adams County",2,6,658,347,311
050,18,001,"Indiana","Adams County",2,7,655,342,313
050,18,001,"Indiana","Adams County",2,8,623,325,298
050,18,001,"Indiana","Adams County",2,9,601,326,275
050,18,001,"Indiana","Adams County",2,10,613,345,268
050,18,001,"Indiana","Adams County",2,11,614,327,287
050,18,001,"Indiana","Adams County",2,12,630,311,319
050,18,001,"Indiana","Adams County",2,13,637,312,325
050,18,001,"Indiana","Adams County",2,14,607,295,312
050,18,001,"Indiana","Adams County",2,15,577,297,280
050,18,001,"Indiana","Adams County",2,16,589,308,281
050,18,001,"Indiana","Adams County",2,17,596,304,292
050,18,001,"Indiana","Adams County",2,18,486,257,229
050,18,001,"Indiana","Adams County",2,19,384,200,184
050,18,001,"Indiana","Adams County",2,20,419,208,211
050,18,001,"Indiana","Adams County",2,21,433,227,206
050,18,001,"Indiana","Adams County",2,22,444,226,218
050,18,001,"Indiana","Adams County",2,23,432,208,224
050,18,001,"Indiana","Adams County",2,24,425,222,203
050,18,001,"Indiana","Adams County",2,25,435,229,206
050,18,001,"Indiana","Adams County",2,26,436,231,205
050,18,001,"Indiana","Adams County",2,27,431,227,204
050,18,001,"Indiana","Adams County",2,28,440,230,210
050,18,001,"Indiana","Adams County",2,29,445,235,210
050,18,001,"Indiana","Adams County",2,30,444,235,209
050,18,001,"Indiana","Adams County",2,31,412,221,191
050,18,001,"Indiana","Adams County",2,32,379,190,189
050,18,001,"Indiana","Adams County",2,33,358,180,178
050,18,001,"Indiana","Adams County",2,34,366,192,174
050,18,001,"Indiana","Adams County",2,35,383,194,189
050,18,001,"Indiana","Adams County",2,36,383,189,194
050,18,001,"Indiana","Adams County",2,37,397,197,200
050,18,001,"Indiana","Adams County",2,38,389,198,191
050,18,001,"Indiana","Adams County",2,39,379,200,179
050,18,001,"Indiana","Adams County",2,40,383,202,181
050,18,001,"Indiana","Adams County",2,41,371,183,188
050,18,001,"Indiana","Adams County",2,42,368,181,187
050,18,001,"Indiana","Adams County",2,43,376,191,185
050,18,001,"Indiana","Adams County",2,44,374,205,169
050,18,001,"Indiana","Adams County",2,45,387,216,171
050,18,001,"Indiana","Adams County",2,46,356,192,164
050,18,001,"Indiana","Adams County",2,47,353,174,179
050,18,001,"Indiana","Adams County",2,48,357,172,185
050,18,001,"Indiana","Adams County",2,49,424,218,206
050,18,001,"Indiana","Adams County",2,50,393,201,192
050,18,001,"Indiana","Adams County",2,51,380,193,187
050,18,001,"Indiana","Adams County",2,52,382,196,186
050,18,001,"Indiana","Adams County",2,53,406,212,194
050,18,001,"Indiana","Adams County",2,54,385,201,184
050,18,001,"Indiana","Adams County",2,55,398,202,196
050,18,001,"Indiana","Adams County",2,56,419,206,213
050,18,001,"Indiana","Adams County",2,57,411,211,200
050,18,001,"Indiana","Adams County",2,58,411,215,196
050,18,001,"Indiana","Adams County",2,59,425,216,209
050,18,001,"Indiana","Adams County",2,60,400,192,208
050,18,001,"Indiana","Adams County",2,61,408,203,205
050,18,001,"Indiana","Adams County",2,62,406,205,201
050,18,001,"Indiana","Adams County",2,63,421,203,218
050,18,001,"Indiana","Adams County",2,64,403,188,215
050,18,001,"Indiana","Adams County",2,65,396,189,207
050,18,001,"Indiana","Adams County",2,66,377,182,195
050,18,001,"Indiana","Adams County",2,67,345,164,181
050,18,001,"Indiana","Adams County",2,68,336,163,173
050,18,001,"Indiana","Adams County",2,69,327,159,168
050,18,001,"Indiana","Adams County",2,70,302,145,157
050,18,001,"Indiana","Adams County",2,71,292,136,156
050,18,001,"Indiana","Adams County",2,72,286,135,151
050,18,001,"Indiana","Adams County",2,73,308,143,165
050,18,001,"Indiana","Adams County",2,74,218,97,121
050,18,001,"Indiana","Adams County",2,75,222,101,121
050,18,001,"Indiana","Adams County",2,76,211,95,116
050,18,001,"Indiana","Adams County",2,77,204,87,117
050,18,001,"Indiana","Adams County",2,78,174,78,96
050,18,001,"Indiana","Adams County",2,79,162,70,92
050,18,001,"Indiana","Adams County",2,80,141,57,84
050,18,001,"Indiana","Adams County",2,81,154,65,89
050,18,001,"Indiana","Adams County",2,82,148,61,87
050,18,001,"Indiana","Adams County",2,83,132,51,81
050,18,001,"Indiana","Adams County",2,84,120,39,81
050,18,001,"Indiana","Adams County",2,85,837,290,547
050,18,001,"Indiana","Adams County",3,0,665,336,329
050,18,001,"Indiana","Adams County",3,1,608,310,298
050,18,001,"Indiana","Adams County",3,2,610,298,312
050,18,001,"Indiana","Adams County",3,3,640,320,320
050,18,001,"Indiana","Adams County",3,4,645,327,318
050,18,001,"Indiana","Adams County",3,5,656,327,329
050,18,001,"Indiana","Adams County",3,6,642,337,305
050,18,001,"Indiana","Adams County",3,7,644,334,310
050,18,001,"Indiana","Adams County",3,8,659,338,321
050,18,001,"Indiana","Adams County",3,9,629,319,310
050,18,001,"Indiana","Adams County",3,10,603,328,275
050,18,001,"Indiana","Adams County",3,11,612,357,255
050,18,001,"Indiana","Adams County",3,12,615,315,300
050,18,001,"Indiana","Adams County",3,13,637,318,319
050,18,001,"Indiana","Adams County",3,14,644,307,337
050,18,001,"Indiana","Adams County",3,15,610,304,306
050,18,001,"Indiana","Adams County",3,16,584,298,286
050,18,001,"Indiana","Adams County",3,17,595,305,290
050,18,001,"Indiana","Adams County",3,18,517,275,242
050,18,001,"Indiana","Adams County",3,19,383,200,183
050,18,001,"Indiana","Adams County",3,20,422,219,203
050,18,001,"Indiana","Adams County",3,21,426,211,215
050,18,001,"Indiana","Adams County",3,22,447,234,213
050,18,001,"Indiana","Adams County",3,23,457,236,221
050,18,001,"Indiana","Adams County",3,24,431,212,219
050,18,001,"Indiana","Adams County",3,25,419,226,193
050,18,001,"Indiana","Adams County",3,26,424,230,194
050,18,001,"Indiana","Adams County",3,27,426,229,197
050,18,001,"Indiana","Adams County",3,28,416,218,198
050,18,001,"Indiana","Adams County",3,29,454,234,220
050,18,001,"Indiana","Adams County",3,30,429,221,208
050,18,001,"Indiana","Adams County",3,31,441,232,209
050,18,001,"Indiana","Adams County",3,32,415,227,188
050,18,001,"Indiana","Adams County",3,33,381,191,190
050,18,001,"Indiana","Adams County",3,34,370,186,184
050,18,001,"Indiana","Adams County",3,35,362,190,172
050,18,001,"Indiana","Adams County",3,36,384,197,187
050,18,001,"Indiana","Adams County",3,37,376,188,188
050,18,001,"Indiana","Adams County",3,38,400,196,204
050,18,001,"Indiana","Adams County",3,39,385,196,189
050,18,001,"Indiana","Adams County",3,40,394,210,184
050,18,001,"Indiana","Adams County",3,41,377,196,181
050,18,001,"Indiana","Adams County",3,42,378,182,196
050,18,001,"Indiana","Adams County",3,43,363,179,184
050,18,001,"Indiana","Adams County",3,44,376,185,191
050,18,001,"Indiana","Adams County",3,45,374,206,168
050,18,001,"Indiana","Adams County",3,46,376,208,168
050,18,001,"Indiana","Adams County",3,47,354,190,164
050,18,001,"Indiana","Adams County",3,48,353,173,180
050,18,001,"Indiana","Adams County",3,49,370,180,190
050,18,001,"Indiana","Adams County",3,50,416,211,205
050,18,001,"Indiana","Adams County",3,51,387,201,186
050,18,001,"Indiana","Adams County",3,52,375,191,184
050,18,001,"Indiana","Adams County",3,53,383,201,182
050,18,001,"Indiana","Adams County",3,54,398,206,192
050,18,001,"Indiana","Adams County",3,55,383,200,183
050,18,001,"Indiana","Adams County",3,56,403,203,200
050,18,001,"Indiana","Adams County",3,57,417,203,214
050,18,001,"Indiana","Adams County",3,58,398,201,197
050,18,001,"Indiana","Adams County",3,59,403,207,196
050,18,001,"Indiana","Adams County",3,60,434,220,214
050,18,001,"Indiana","Adams County",3,61,399,192,207
050,18,001,"Indiana","Adams County",3,62,389,194,195
050,18,001,"Indiana","Adams County",3,63,411,207,204
050,18,001,"Indiana","Adams County",3,64,413,198,215
050,18,001,"Indiana","Adams County",3,65,391,183,208
050,18,001,"Indiana","Adams County",3,66,390,184,206
050,18,001,"Indiana","Adams County",3,67,371,184,187
050,18,001,"Indiana","Adams County",3,68,329,155,174
050,18,001,"Indiana","Adams County",3,69,333,158,175
050,18,001,"Indiana","Adams County",3,70,313,151,162
050,18,001,"Indiana","Adams County",3,71,292,136,156
050,18,001,"Indiana","Adams County",3,72,284,135,149
050,18,001,"Indiana","Adams County",3,73,285,131,154
050,18,001,"Indiana","Adams County",3,74,295,136,159
050,18,001,"Indiana","Adams County",3,75,218,95,123
050,18,001,"Indiana","Adams County",3,76,214,92,122
050,18,001,"Indiana","Adams County",3,77,205,91,114
050,18,001,"Indiana","Adams County",3,78,187,77,110
050,18,001,"Indiana","Adams County",3,79,169,73,96
050,18,001,"Indiana","Adams County",3,80,151,66,85
050,18,001,"Indiana","Adams County",3,81,143,57,86
050,18,001,"Indiana","Adams County",3,82,135,56,79
050,18,001,"Indiana","Adams County",3,83,137,55,82
050,18,001,"Indiana","Adams County",3,84,125,45,80
050,18,001,"Indiana","Adams County",3,85,837,284,553
050,18,001,"Indiana","Adams County",4,0,666,319,347
050,18,001,"Indiana","Adams County",4,1,658,331,327
050,18,001,"Indiana","Adams County",4,2,619,318,301
050,18,001,"Indiana","Adams County",4,3,607,301,306
050,18,001,"Indiana","Adams County",4,4,638,319,319
050,18,001,"Indiana","Adams County",4,5,648,327,321
050,18,001,"Indiana","Adams County",4,6,651,327,324
050,18,001,"Indiana","Adams County",4,7,654,338,316
050,18,001,"Indiana","Adams County",4,8,636,327,309
050,18,001,"Indiana","Adams County",4,9,651,340,311
050,18,001,"Indiana","Adams County",4,10,621,318,303
050,18,001,"Indiana","Adams County",4,11,600,328,272
050,18,001,"Indiana","Adams County",4,12,609,348,261
050,18,001,"Indiana","Adams County",4,13,614,319,295
050,18,001,"Indiana","Adams County",4,14,631,309,322
050,18,001,"Indiana","Adams County",4,15,640,310,330
050,18,001,"Indiana","Adams County",4,16,609,300,309
050,18,001,"Indiana","Adams County",4,17,591,302,289
050,18,001,"Indiana","Adams County",4,18,507,275,232
050,18,001,"Indiana","Adams County",4,19,399,207,192
050,18,001,"Indiana","Adams County",4,20,410,223,187
050,18,001,"Indiana","Adams County",4,21,424,219,205
050,18,001,"Indiana","Adams County",4,22,446,210,236
050,18,001,"Indiana","Adams County",4,23,448,233,215
050,18,001,"Indiana","Adams County",4,24,453,231,222
050,18,001,"Indiana","Adams County",4,25,425,214,211
050,18,001,"Indiana","Adams County",4,26,425,224,201
050,18,001,"Indiana","Adams County",4,27,429,237,192
050,18,001,"Indiana","Adams County",4,28,425,224,201
050,18,001,"Indiana","Adams County",4,29,421,225,196
050,18,001,"Indiana","Adams County",4,30,459,236,223
050,18,001,"Indiana","Adams County",4,31,416,210,206
050,18,001,"Indiana","Adams County",4,32,451,230,221
050,18,001,"Indiana","Adams County",4,33,413,227,186
050,18,001,"Indiana","Adams County",4,34,393,198,195
050,18,001,"Indiana","Adams County",4,35,376,186,190
050,18,001,"Indiana","Adams County",4,36,354,187,167
050,18,001,"Indiana","Adams County",4,37,381,201,180
050,18,001,"Indiana","Adams County",4,38,392,195,197
050,18,001,"Indiana","Adams County",4,39,399,195,204
050,18,001,"Indiana","Adams County",4,40,389,201,188
050,18,001,"Indiana","Adams County",4,41,385,199,186
050,18,001,"Indiana","Adams County",4,42,384,204,180
050,18,001,"Indiana","Adams County",4,43,380,188,192
050,18,001,"Indiana","Adams County",4,44,370,187,183
050,18,001,"Indiana","Adams County",4,45,379,186,193
050,18,001,"Indiana","Adams County",4,46,370,201,169
050,18,001,"Indiana","Adams County",4,47,369,206,163
050,18,001,"Indiana","Adams County",4,48,356,191,165
050,18,001,"Indiana","Adams County",4,49,351,177,174
050,18,001,"Indiana","Adams County",4,50,370,181,189
050,18,001,"Indiana","Adams County",4,51,415,207,208
050,18,001,"Indiana","Adams County",4,52,377,194,183
050,18,001,"Indiana","Adams County",4,53,380,194,186
050,18,001,"Indiana","Adams County",4,54,375,197,178
050,18,001,"Indiana","Adams County",4,55,398,208,190
050,18,001,"Indiana","Adams County",4,56,386,208,178
050,18,001,"Indiana","Adams County",4,57,403,200,203
050,18,001,"Indiana","Adams County",4,58,409,195,214
050,18,001,"Indiana","Adams County",4,59,394,199,195
050,18,001,"Indiana","Adams County",4,60,397,204,193
050,18,001,"Indiana","Adams County",4,61,424,216,208
050,18,001,"Indiana","Adams County",4,62,393,191,202
050,18,001,"Indiana","Adams County",4,63,389,194,195
050,18,001,"Indiana","Adams County",4,64,400,198,202
050,18,001,"Indiana","Adams County",4,65,398,191,207
050,18,001,"Indiana","Adams County",4,66,388,177,211
050,18,001,"Indiana","Adams County",4,67,386,185,201
050,18,001,"Indiana","Adams County",4,68,358,172,186
050,18,001,"Indiana","Adams County",4,69,320,149,171
050,18,001,"Indiana","Adams County",4,70,323,154,169
050,18,001,"Indiana","Adams County",4,71,307,147,160
050,18,001,"Indiana","Adams County",4,72,287,137,150
050,18,001,"Indiana","Adams County",4,73,284,135,149
050,18,001,"Indiana","Adams County",4,74,281,128,153
050,18,001,"Indiana","Adams County",4,75,294,136,158
050,18,001,"Indiana","Adams County",4,76,204,86,118
050,18,001,"Indiana","Adams County",4,77,202,88,114
050,18,001,"Indiana","Adams County",4,78,191,82,109
050,18,001,"Indiana","Adams County",4,79,184,69,115
050,18,001,"Indiana","Adams County",4,80,154,69,85
050,18,001,"Indiana","Adams County",4,81,154,66,88
050,18,001,"Indiana","Adams County",4,82,126,49,77
050,18,001,"Indiana","Adams County",4,83,121,48,73
050,18,001,"Indiana","Adams County",4,84,128,48,80
050,18,001,"Indiana","Adams County",4,85,829,279,550
050,18,001,"Indiana","Adams County",5,0,623,297,326
050,18,001,"Indiana","Adams County",5,1,667,316,351
050,18,001,"Indiana","Adams County",5,2,651,323,328
050,18,001,"Indiana","Adams County",5,3,601,306,295
050,18,001,"Indiana","Adams County",5,4,595,279,316
050,18,001,"Indiana","Adams County",5,5,632,316,316
050,18,001,"Indiana","Adams County",5,6,648,325,323
050,18,001,"Indiana","Adams County",5,7,647,323,324
050,18,001,"Indiana","Adams County",5,8,639,338,301
050,18,001,"Indiana","Adams County",5,9,621,314,307
050,18,001,"Indiana","Adams County",5,10,663,346,317
050,18,001,"Indiana","Adams County",5,11,621,315,306
050,18,001,"Indiana","Adams County",5,12,608,330,278
050,18,001,"Indiana","Adams County",5,13,617,358,259
050,18,001,"Indiana","Adams County",5,14,611,315,296
050,18,001,"Indiana","Adams County",5,15,645,320,325
050,18,001,"Indiana","Adams County",5,16,655,315,340
050,18,001,"Indiana","Adams County",5,17,620,306,314
050,18,001,"Indiana","Adams County",5,18,491,263,228
050,18,001,"Indiana","Adams County",5,19,387,209,178
050,18,001,"Indiana","Adams County",5,20,436,227,209
050,18,001,"Indiana","Adams County",5,21,424,225,199
050,18,001,"Indiana","Adams County",5,22,431,221,210
050,18,001,"Indiana","Adams County",5,23,446,209,237
050,18,001,"Indiana","Adams County",5,24,437,228,209
050,18,001,"Indiana","Adams County",5,25,447,226,221
050,18,001,"Indiana","Adams County",5,26,425,213,212
050,18,001,"Indiana","Adams County",5,27,414,210,204
050,18,001,"Indiana","Adams County",5,28,448,246,202
050,18,001,"Indiana","Adams County",5,29,423,223,200
050,18,001,"Indiana","Adams County",5,30,409,214,195
050,18,001,"Indiana","Adams County",5,31,451,230,221
050,18,001,"Indiana","Adams County",5,32,422,215,207
050,18,001,"Indiana","Adams County",5,33,453,228,225
050,18,001,"Indiana","Adams County",5,34,396,218,178
050,18,001,"Indiana","Adams County",5,35,390,198,192
050,18,001,"Indiana","Adams County",5,36,377,187,190
050,18,001,"Indiana","Adams County",5,37,364,190,174
050,18,001,"Indiana","Adams County",5,38,388,205,183
050,18,001,"Indiana","Adams County",5,39,396,195,201
050,18,001,"Indiana","Adams County",5,40,407,204,203
050,18,001,"Indiana","Adams County",5,41,396,204,192
050,18,001,"Indiana","Adams County",5,42,388,206,182
050,18,001,"Indiana","Adams County",5,43,393,207,186
050,18,001,"Indiana","Adams County",5,44,374,182,192
050,18,001,"Indiana","Adams County",5,45,376,190,186
050,18,001,"Indiana","Adams County",5,46,377,185,192
050,18,001,"Indiana","Adams County",5,47,369,197,172
050,18,001,"Indiana","Adams County",5,48,360,202,158
050,18,001,"Indiana","Adams County",5,49,356,196,160
050,18,001,"Indiana","Adams County",5,50,342,167,175
050,18,001,"Indiana","Adams County",5,51,370,179,191
050,18,001,"Indiana","Adams County",5,52,407,206,201
050,18,001,"Indiana","Adams County",5,53,385,196,189
050,18,001,"Indiana","Adams County",5,54,371,185,186
050,18,001,"Indiana","Adams County",5,55,376,197,179
050,18,001,"Indiana","Adams County",5,56,394,210,184
050,18,001,"Indiana","Adams County",5,57,382,204,178
050,18,001,"Indiana","Adams County",5,58,400,195,205
050,18,001,"Indiana","Adams County",5,59,401,191,210
050,18,001,"Indiana","Adams County",5,60,387,196,191
050,18,001,"Indiana","Adams County",5,61,394,199,195
050,18,001,"Indiana","Adams County",5,62,422,211,211
050,18,001,"Indiana","Adams County",5,63,391,190,201
050,18,001,"Indiana","Adams County",5,64,384,189,195
050,18,001,"Indiana","Adams County",5,65,391,194,197
050,18,001,"Indiana","Adams County",5,66,394,188,206
050,18,001,"Indiana","Adams County",5,67,384,178,206
050,18,001,"Indiana","Adams County",5,68,380,179,201
050,18,001,"Indiana","Adams County",5,69,346,166,180
050,18,001,"Indiana","Adams County",5,70,319,148,171
050,18,001,"Indiana","Adams County",5,71,315,150,165
050,18,001,"Indiana","Adams County",5,72,303,148,155
050,18,001,"Indiana","Adams County",5,73,291,134,157
050,18,001,"Indiana","Adams County",5,74,278,133,145
050,18,001,"Indiana","Adams County",5,75,282,126,156
050,18,001,"Indiana","Adams County",5,76,278,126,152
050,18,001,"Indiana","Adams County",5,77,190,80,110
050,18,001,"Indiana","Adams County",5,78,189,78,111
050,18,001,"Indiana","Adams County",5,79,191,78,113
050,18,001,"Indiana","Adams County",5,80,173,64,109
050,18,001,"Indiana","Adams County",5,81,163,72,91
050,18,001,"Indiana","Adams County",5,82,135,57,78
050,18,001,"Indiana","Adams County",5,83,115,42,73
050,18,001,"Indiana","Adams County",5,84,111,39,72
050,18,001,"Indiana","Adams County",5,85,839,282,557
050,18,003,"Indiana","Allen County",1,0,5246,2680,2566
050,18,003,"Indiana","Allen County",1,1,5348,2722,2626
050,18,003,"Indiana","Allen County",1,2,5344,2748,2596
050,18,003,"Indiana","Allen County",1,3,5424,2786,2638
050,18,003,"Indiana","Allen County",1,4,5407,2798,2609
050,18,003,"Indiana","Allen County",1,5,5524,2868,2656
050,18,003,"Indiana","Allen County",1,6,5390,2787,2603
050,18,003,"Indiana","Allen County",1,7,5454,2816,2638
050,18,003,"Indiana","Allen County",1,8,5468,2817,2651
050,18,003,"Indiana","Allen County",1,9,5542,2825,2717
050,18,003,"Indiana","Allen County",1,10,5611,2882,2729
050,18,003,"Indiana","Allen County",1,11,5672,2884,2788
050,18,003,"Indiana","Allen County",1,12,5835,2942,2893
050,18,003,"Indiana","Allen County",1,13,5791,2927,2864
050,18,003,"Indiana","Allen County",1,14,5644,2879,2765
050,18,003,"Indiana","Allen County",1,15,5612,2857,2755
050,18,003,"Indiana","Allen County",1,16,5531,2788,2743
050,18,003,"Indiana","Allen County",1,17,5568,2796,2772
050,18,003,"Indiana","Allen County",1,18,4985,2549,2436
050,18,003,"Indiana","Allen County",1,19,4651,2383,2268
050,18,003,"Indiana","Allen County",1,20,4655,2341,2314
050,18,003,"Indiana","Allen County",1,21,4659,2342,2317
050,18,003,"Indiana","Allen County",1,22,4895,2401,2494
050,18,003,"Indiana","Allen County",1,23,5228,2620,2608
050,18,003,"Indiana","Allen County",1,24,5482,2724,2758
050,18,003,"Indiana","Allen County",1,25,5418,2725,2693
050,18,003,"Indiana","Allen County",1,26,5428,2712,2716
050,18,003,"Indiana","Allen County",1,27,5649,2784,2865
050,18,003,"Indiana","Allen County",1,28,5724,2834,2890
050,18,003,"Indiana","Allen County",1,29,5542,2728,2814
050,18,003,"Indiana","Allen County",1,30,5457,2662,2795
050,18,003,"Indiana","Allen County",1,31,5312,2613,2699
050,18,003,"Indiana","Allen County",1,32,5101,2516,2585
050,18,003,"Indiana","Allen County",1,33,5046,2484,2562
050,18,003,"Indiana","Allen County",1,34,5155,2557,2598
050,18,003,"Indiana","Allen County",1,35,5038,2494,2544
050,18,003,"Indiana","Allen County",1,36,4857,2376,2481
050,18,003,"Indiana","Allen County",1,37,5060,2502,2558
050,18,003,"Indiana","Allen County",1,38,5059,2521,2538
050,18,003,"Indiana","Allen County",1,39,5013,2486,2527
050,18,003,"Indiana","Allen County",1,40,4952,2444,2508
050,18,003,"Indiana","Allen County",1,41,4776,2373,2403
050,18,003,"Indiana","Allen County",1,42,4595,2300,2295
050,18,003,"Indiana","Allen County",1,43,4460,2207,2253
050,18,003,"Indiana","Allen County",1,44,4455,2216,2239
050,18,003,"Indiana","Allen County",1,45,4403,2229,2174
050,18,003,"Indiana","Allen County",1,46,4247,2120,2127
050,18,003,"Indiana","Allen County",1,47,4468,2206,2262
050,18,003,"Indiana","Allen County",1,48,4771,2394,2377
050,18,003,"Indiana","Allen County",1,49,5002,2515,2487
050,18,003,"Indiana","Allen County",1,50,4802,2425,2377
050,18,003,"Indiana","Allen County",1,51,4631,2325,2306
050,18,003,"Indiana","Allen County",1,52,4361,2169,2192
050,18,003,"Indiana","Allen County",1,53,4320,2116,2204
050,18,003,"Indiana","Allen County",1,54,4336,2155,2181
050,18,003,"Indiana","Allen County",1,55,4639,2340,2299
050,18,003,"Indiana","Allen County",1,56,4756,2396,2360
050,18,003,"Indiana","Allen County",1,57,4709,2331,2378
050,18,003,"Indiana","Allen County",1,58,4878,2404,2474
050,18,003,"Indiana","Allen County",1,59,4764,2337,2427
050,18,003,"Indiana","Allen County",1,60,4683,2285,2398
050,18,003,"Indiana","Allen County",1,61,4587,2217,2370
050,18,003,"Indiana","Allen County",1,62,4610,2220,2390
050,18,003,"Indiana","Allen County",1,63,4530,2131,2399
050,18,003,"Indiana","Allen County",1,64,4426,2099,2327
050,18,003,"Indiana","Allen County",1,65,4319,2090,2229
050,18,003,"Indiana","Allen County",1,66,4119,2000,2119
050,18,003,"Indiana","Allen County",1,67,3961,1921,2040
050,18,003,"Indiana","Allen County",1,68,3829,1812,2017
050,18,003,"Indiana","Allen County",1,69,3511,1651,1860
050,18,003,"Indiana","Allen County",1,70,3315,1524,1791
050,18,003,"Indiana","Allen County",1,71,3226,1497,1729
050,18,003,"Indiana","Allen County",1,72,3262,1497,1765
050,18,003,"Indiana","Allen County",1,73,3185,1450,1735
050,18,003,"Indiana","Allen County",1,74,2264,1016,1248
050,18,003,"Indiana","Allen County",1,75,2190,993,1197
050,18,003,"Indiana","Allen County",1,76,2164,944,1220
050,18,003,"Indiana","Allen County",1,77,2153,988,1165
050,18,003,"Indiana","Allen County",1,78,1780,800,980
050,18,003,"Indiana","Allen County",1,79,1526,675,851
050,18,003,"Indiana","Allen County",1,80,1375,603,772
050,18,003,"Indiana","Allen County",1,81,1305,547,758
050,18,003,"Indiana","Allen County",1,82,1245,512,733
050,18,003,"Indiana","Allen County",1,83,1103,448,655
050,18,003,"Indiana","Allen County",1,84,981,389,592
050,18,003,"Indiana","Allen County",1,85,6595,2154,4441
050,18,003,"Indiana","Allen County",2,0,5223,2686,2537
050,18,003,"Indiana","Allen County",2,1,5325,2715,2610
050,18,003,"Indiana","Allen County",2,2,5365,2749,2616
050,18,003,"Indiana","Allen County",2,3,5391,2769,2622
050,18,003,"Indiana","Allen County",2,4,5427,2802,2625
050,18,003,"Indiana","Allen County",2,5,5497,2850,2647
050,18,003,"Indiana","Allen County",2,6,5437,2816,2621
050,18,003,"Indiana","Allen County",2,7,5436,2806,2630
050,18,003,"Indiana","Allen County",2,8,5450,2809,2641
050,18,003,"Indiana","Allen County",2,9,5520,2822,2698
050,18,003,"Indiana","Allen County",2,10,5600,2872,2728
050,18,003,"Indiana","Allen County",2,11,5645,2878,2767
050,18,003,"Indiana","Allen County",2,12,5816,2934,2882
050,18,003,"Indiana","Allen County",2,13,5797,2926,2871
050,18,003,"Indiana","Allen County",2,14,5683,2893,2790
050,18,003,"Indiana","Allen County",2,15,5625,2869,2756
050,18,003,"Indiana","Allen County",2,16,5555,2808,2747
050,18,003,"Indiana","Allen County",2,17,5568,2792,2776
050,18,003,"Indiana","Allen County",2,18,4966,2537,2429
050,18,003,"Indiana","Allen County",2,19,4680,2397,2283
050,18,003,"Indiana","Allen County",2,20,4720,2371,2349
050,18,003,"Indiana","Allen County",2,21,4705,2356,2349
050,18,003,"Indiana","Allen County",2,22,4927,2421,2506
050,18,003,"Indiana","Allen County",2,23,5227,2605,2622
050,18,003,"Indiana","Allen County",2,24,5449,2720,2729
050,18,003,"Indiana","Allen County",2,25,5453,2740,2713
050,18,003,"Indiana","Allen County",2,26,5455,2733,2722
050,18,003,"Indiana","Allen County",2,27,5598,2775,2823
050,18,003,"Indiana","Allen County",2,28,5714,2833,2881
050,18,003,"Indiana","Allen County",2,29,5605,2762,2843
050,18,003,"Indiana","Allen County",2,30,5517,2695,2822
050,18,003,"Indiana","Allen County",2,31,5339,2624,2715
050,18,003,"Indiana","Allen County",2,32,5145,2533,2612
050,18,003,"Indiana","Allen County",2,33,5061,2498,2563
050,18,003,"Indiana","Allen County",2,34,5122,2536,2586
050,18,003,"Indiana","Allen County",2,35,5090,2525,2565
050,18,003,"Indiana","Allen County",2,36,4874,2394,2480
050,18,003,"Indiana","Allen County",2,37,5028,2478,2550
050,18,003,"Indiana","Allen County",2,38,5088,2535,2553
050,18,003,"Indiana","Allen County",2,39,5019,2495,2524
050,18,003,"Indiana","Allen County",2,40,4995,2468,2527
050,18,003,"Indiana","Allen County",2,41,4805,2383,2422
050,18,003,"Indiana","Allen County",2,42,4623,2309,2314
050,18,003,"Indiana","Allen County",2,43,4523,2246,2277
050,18,003,"Indiana","Allen County",2,44,4412,2193,2219
050,18,003,"Indiana","Allen County",2,45,4445,2237,2208
050,18,003,"Indiana","Allen County",2,46,4282,2141,2141
050,18,003,"Indiana","Allen County",2,47,4403,2185,2218
050,18,003,"Indiana","Allen County",2,48,4699,2350,2349
050,18,003,"Indiana","Allen County",2,49,4970,2496,2474
050,18,003,"Indiana","Allen County",2,50,4871,2457,2414
050,18,003,"Indiana","Allen County",2,51,4645,2334,2311
050,18,003,"Indiana","Allen County",2,52,4408,2192,2216
050,18,003,"Indiana","Allen County",2,53,4325,2131,2194
050,18,003,"Indiana","Allen County",2,54,4323,2143,2180
050,18,003,"Indiana","Allen County",2,55,4557,2292,2265
050,18,003,"Indiana","Allen County",2,56,4727,2379,2348
050,18,003,"Indiana","Allen County",2,57,4712,2344,2368
050,18,003,"Indiana","Allen County",2,58,4820,2374,2446
050,18,003,"Indiana","Allen County",2,59,4795,2349,2446
050,18,003,"Indiana","Allen County",2,60,4673,2277,2396
050,18,003,"Indiana","Allen County",2,61,4593,2226,2367
050,18,003,"Indiana","Allen County",2,62,4591,2214,2377
050,18,003,"Indiana","Allen County",2,63,4558,2163,2395
050,18,003,"Indiana","Allen County",2,64,4415,2090,2325
050,18,003,"Indiana","Allen County",2,65,4324,2079,2245
050,18,003,"Indiana","Allen County",2,66,4150,2011,2139
050,18,003,"Indiana","Allen County",2,67,3979,1927,2052
050,18,003,"Indiana","Allen County",2,68,3820,1816,2004
050,18,003,"Indiana","Allen County",2,69,3607,1695,1912
050,18,003,"Indiana","Allen County",2,70,3327,1541,1786
050,18,003,"Indiana","Allen County",2,71,3240,1493,1747
050,18,003,"Indiana","Allen County",2,72,3182,1462,1720
050,18,003,"Indiana","Allen County",2,73,3348,1530,1818
050,18,003,"Indiana","Allen County",2,74,2323,1043,1280
050,18,003,"Indiana","Allen County",2,75,2204,988,1216
050,18,003,"Indiana","Allen County",2,76,2123,929,1194
050,18,003,"Indiana","Allen County",2,77,2188,987,1201
050,18,003,"Indiana","Allen County",2,78,1816,822,994
050,18,003,"Indiana","Allen County",2,79,1567,696,871
050,18,003,"Indiana","Allen County",2,80,1389,605,784
050,18,003,"Indiana","Allen County",2,81,1298,545,753
050,18,003,"Indiana","Allen County",2,82,1244,510,734
050,18,003,"Indiana","Allen County",2,83,1116,453,663
050,18,003,"Indiana","Allen County",2,84,987,396,591
050,18,003,"Indiana","Allen County",2,85,6559,2149,4410
050,18,003,"Indiana","Allen County",3,0,5127,2657,2470
050,18,003,"Indiana","Allen County",3,1,5204,2694,2510
050,18,003,"Indiana","Allen County",3,2,5369,2753,2616
050,18,003,"Indiana","Allen County",3,3,5395,2751,2644
050,18,003,"Indiana","Allen County",3,4,5415,2794,2621
050,18,003,"Indiana","Allen County",3,5,5473,2826,2647
050,18,003,"Indiana","Allen County",3,6,5512,2872,2640
050,18,003,"Indiana","Allen County",3,7,5496,2841,2655
050,18,003,"Indiana","Allen County",3,8,5486,2838,2648
050,18,003,"Indiana","Allen County",3,9,5497,2845,2652
050,18,003,"Indiana","Allen County",3,10,5550,2844,2706
050,18,003,"Indiana","Allen County",3,11,5617,2872,2745
050,18,003,"Indiana","Allen County",3,12,5679,2899,2780
050,18,003,"Indiana","Allen County",3,13,5876,2971,2905
050,18,003,"Indiana","Allen County",3,14,5831,2967,2864
050,18,003,"Indiana","Allen County",3,15,5753,2930,2823
050,18,003,"Indiana","Allen County",3,16,5661,2888,2773
050,18,003,"Indiana","Allen County",3,17,5577,2840,2737
050,18,003,"Indiana","Allen County",3,18,4991,2545,2446
050,18,003,"Indiana","Allen County",3,19,4595,2335,2260
050,18,003,"Indiana","Allen County",3,20,4812,2404,2408
050,18,003,"Indiana","Allen County",3,21,4862,2415,2447
050,18,003,"Indiana","Allen County",3,22,5076,2480,2596
050,18,003,"Indiana","Allen County",3,23,5280,2615,2665
050,18,003,"Indiana","Allen County",3,24,5409,2699,2710
050,18,003,"Indiana","Allen County",3,25,5575,2786,2789
050,18,003,"Indiana","Allen County",3,26,5601,2823,2778
050,18,003,"Indiana","Allen County",3,27,5517,2747,2770
050,18,003,"Indiana","Allen County",3,28,5678,2813,2865
050,18,003,"Indiana","Allen County",3,29,5752,2868,2884
050,18,003,"Indiana","Allen County",3,30,5643,2773,2870
050,18,003,"Indiana","Allen County",3,31,5570,2721,2849
050,18,003,"Indiana","Allen County",3,32,5323,2639,2684
050,18,003,"Indiana","Allen County",3,33,5169,2537,2632
050,18,003,"Indiana","Allen County",3,34,5021,2475,2546
050,18,003,"Indiana","Allen County",3,35,5193,2583,2610
050,18,003,"Indiana","Allen County",3,36,5076,2519,2557
050,18,003,"Indiana","Allen County",3,37,4913,2408,2505
050,18,003,"Indiana","Allen County",3,38,5052,2488,2564
050,18,003,"Indiana","Allen County",3,39,5112,2527,2585
050,18,003,"Indiana","Allen County",3,40,5037,2500,2537
050,18,003,"Indiana","Allen County",3,41,4988,2473,2515
050,18,003,"Indiana","Allen County",3,42,4814,2372,2442
050,18,003,"Indiana","Allen County",3,43,4656,2336,2320
050,18,003,"Indiana","Allen County",3,44,4505,2226,2279
050,18,003,"Indiana","Allen County",3,45,4407,2205,2202
050,18,003,"Indiana","Allen County",3,46,4485,2239,2246
050,18,003,"Indiana","Allen County",3,47,4260,2147,2113
050,18,003,"Indiana","Allen County",3,48,4452,2222,2230
050,18,003,"Indiana","Allen County",3,49,4638,2315,2323
050,18,003,"Indiana","Allen County",3,50,4972,2500,2472
050,18,003,"Indiana","Allen County",3,51,4800,2424,2376
050,18,003,"Indiana","Allen County",3,52,4569,2299,2270
050,18,003,"Indiana","Allen County",3,53,4394,2203,2191
050,18,003,"Indiana","Allen County",3,54,4261,2101,2160
050,18,003,"Indiana","Allen County",3,55,4299,2133,2166
050,18,003,"Indiana","Allen County",3,56,4549,2271,2278
050,18,003,"Indiana","Allen County",3,57,4625,2317,2308
050,18,003,"Indiana","Allen County",3,58,4664,2319,2345
050,18,003,"Indiana","Allen County",3,59,4769,2328,2441
050,18,003,"Indiana","Allen County",3,60,4728,2298,2430
050,18,003,"Indiana","Allen County",3,61,4625,2244,2381
050,18,003,"Indiana","Allen County",3,62,4503,2161,2342
050,18,003,"Indiana","Allen County",3,63,4516,2163,2353
050,18,003,"Indiana","Allen County",3,64,4484,2113,2371
050,18,003,"Indiana","Allen County",3,65,4360,2059,2301
050,18,003,"Indiana","Allen County",3,66,4230,2025,2205
050,18,003,"Indiana","Allen County",3,67,4063,1956,2107
050,18,003,"Indiana","Allen County",3,68,3909,1882,2027
050,18,003,"Indiana","Allen County",3,69,3774,1781,1993
050,18,003,"Indiana","Allen County",3,70,3510,1656,1854
050,18,003,"Indiana","Allen County",3,71,3247,1488,1759
050,18,003,"Indiana","Allen County",3,72,3164,1451,1713
050,18,003,"Indiana","Allen County",3,73,3084,1406,1678
050,18,003,"Indiana","Allen County",3,74,3262,1487,1775
050,18,003,"Indiana","Allen County",3,75,2225,993,1232
050,18,003,"Indiana","Allen County",3,76,2130,945,1185
050,18,003,"Indiana","Allen County",3,77,2015,873,1142
050,18,003,"Indiana","Allen County",3,78,2077,927,1150
050,18,003,"Indiana","Allen County",3,79,1766,784,982
050,18,003,"Indiana","Allen County",3,80,1446,627,819
050,18,003,"Indiana","Allen County",3,81,1309,551,758
050,18,003,"Indiana","Allen County",3,82,1190,495,695
050,18,003,"Indiana","Allen County",3,83,1154,456,698
050,18,003,"Indiana","Allen County",3,84,1021,403,618
050,18,003,"Indiana","Allen County",3,85,6489,2159,4330
050,18,003,"Indiana","Allen County",4,0,5271,2710,2561
050,18,003,"Indiana","Allen County",4,1,5170,2669,2501
050,18,003,"Indiana","Allen County",4,2,5291,2709,2582
050,18,003,"Indiana","Allen County",4,3,5417,2769,2648
050,18,003,"Indiana","Allen County",4,4,5420,2780,2640
050,18,003,"Indiana","Allen County",4,5,5421,2796,2625
050,18,003,"Indiana","Allen County",4,6,5543,2843,2700
050,18,003,"Indiana","Allen County",4,7,5532,2894,2638
050,18,003,"Indiana","Allen County",4,8,5521,2843,2678
050,18,003,"Indiana","Allen County",4,9,5501,2810,2691
050,18,003,"Indiana","Allen County",4,10,5511,2835,2676
050,18,003,"Indiana","Allen County",4,11,5565,2873,2692
050,18,003,"Indiana","Allen County",4,12,5611,2883,2728
050,18,003,"Indiana","Allen County",4,13,5675,2894,2781
050,18,003,"Indiana","Allen County",4,14,5870,2969,2901
050,18,003,"Indiana","Allen County",4,15,5871,3018,2853
050,18,003,"Indiana","Allen County",4,16,5745,2907,2838
050,18,003,"Indiana","Allen County",4,17,5690,2888,2802
050,18,003,"Indiana","Allen County",4,18,4931,2568,2363
050,18,003,"Indiana","Allen County",4,19,4516,2307,2209
050,18,003,"Indiana","Allen County",4,20,4603,2257,2346
050,18,003,"Indiana","Allen County",4,21,4949,2458,2491
050,18,003,"Indiana","Allen County",4,22,5178,2551,2627
050,18,003,"Indiana","Allen County",4,23,5464,2697,2767
050,18,003,"Indiana","Allen County",4,24,5469,2705,2764
050,18,003,"Indiana","Allen County",4,25,5475,2778,2697
050,18,003,"Indiana","Allen County",4,26,5575,2817,2758
050,18,003,"Indiana","Allen County",4,27,5599,2833,2766
050,18,003,"Indiana","Allen County",4,28,5591,2770,2821
050,18,003,"Indiana","Allen County",4,29,5715,2824,2891
050,18,003,"Indiana","Allen County",4,30,5749,2856,2893
050,18,003,"Indiana","Allen County",4,31,5650,2775,2875
050,18,003,"Indiana","Allen County",4,32,5602,2742,2860
050,18,003,"Indiana","Allen County",4,33,5384,2680,2704
050,18,003,"Indiana","Allen County",4,34,5176,2539,2637
050,18,003,"Indiana","Allen County",4,35,5085,2534,2551
050,18,003,"Indiana","Allen County",4,36,5229,2605,2624
050,18,003,"Indiana","Allen County",4,37,5056,2511,2545
050,18,003,"Indiana","Allen County",4,38,4933,2403,2530
050,18,003,"Indiana","Allen County",4,39,5027,2466,2561
050,18,003,"Indiana","Allen County",4,40,5110,2532,2578
050,18,003,"Indiana","Allen County",4,41,5015,2482,2533
050,18,003,"Indiana","Allen County",4,42,4970,2465,2505
050,18,003,"Indiana","Allen County",4,43,4808,2370,2438
050,18,003,"Indiana","Allen County",4,44,4656,2325,2331
050,18,003,"Indiana","Allen County",4,45,4527,2240,2287
050,18,003,"Indiana","Allen County",4,46,4461,2222,2239
050,18,003,"Indiana","Allen County",4,47,4444,2216,2228
050,18,003,"Indiana","Allen County",4,48,4243,2145,2098
050,18,003,"Indiana","Allen County",4,49,4423,2180,2243
050,18,003,"Indiana","Allen County",4,50,4649,2320,2329
050,18,003,"Indiana","Allen County",4,51,4894,2461,2433
050,18,003,"Indiana","Allen County",4,52,4780,2408,2372
050,18,003,"Indiana","Allen County",4,53,4526,2285,2241
050,18,003,"Indiana","Allen County",4,54,4355,2188,2167
050,18,003,"Indiana","Allen County",4,55,4237,2092,2145
050,18,003,"Indiana","Allen County",4,56,4270,2105,2165
050,18,003,"Indiana","Allen County",4,57,4520,2238,2282
050,18,003,"Indiana","Allen County",4,58,4614,2293,2321
050,18,003,"Indiana","Allen County",4,59,4615,2289,2326
050,18,003,"Indiana","Allen County",4,60,4693,2272,2421
050,18,003,"Indiana","Allen County",4,61,4651,2274,2377
050,18,003,"Indiana","Allen County",4,62,4556,2208,2348
050,18,003,"Indiana","Allen County",4,63,4416,2105,2311
050,18,003,"Indiana","Allen County",4,64,4431,2115,2316
050,18,003,"Indiana","Allen County",4,65,4429,2104,2325
050,18,003,"Indiana","Allen County",4,66,4255,1974,2281
050,18,003,"Indiana","Allen County",4,67,4136,1959,2177
050,18,003,"Indiana","Allen County",4,68,3961,1909,2052
050,18,003,"Indiana","Allen County",4,69,3833,1833,2000
050,18,003,"Indiana","Allen County",4,70,3674,1744,1930
050,18,003,"Indiana","Allen County",4,71,3455,1597,1858
050,18,003,"Indiana","Allen County",4,72,3164,1439,1725
050,18,003,"Indiana","Allen County",4,73,3059,1397,1662
050,18,003,"Indiana","Allen County",4,74,3013,1369,1644
050,18,003,"Indiana","Allen County",4,75,3173,1431,1742
050,18,003,"Indiana","Allen County",4,76,2157,954,1203
050,18,003,"Indiana","Allen County",4,77,2039,892,1147
050,18,003,"Indiana","Allen County",4,78,1916,812,1104
050,18,003,"Indiana","Allen County",4,79,2009,890,1119
050,18,003,"Indiana","Allen County",4,80,1665,723,942
050,18,003,"Indiana","Allen County",4,81,1380,580,800
050,18,003,"Indiana","Allen County",4,82,1207,502,705
050,18,003,"Indiana","Allen County",4,83,1088,441,647
050,18,003,"Indiana","Allen County",4,84,1054,409,645
050,18,003,"Indiana","Allen County",4,85,6532,2179,4353
050,18,003,"Indiana","Allen County",5,0,5237,2691,2546
050,18,003,"Indiana","Allen County",5,1,5262,2698,2564
050,18,003,"Indiana","Allen County",5,2,5220,2699,2521
050,18,003,"Indiana","Allen County",5,3,5224,2665,2559
050,18,003,"Indiana","Allen County",5,4,5448,2780,2668
050,18,003,"Indiana","Allen County",5,5,5444,2800,2644
050,18,003,"Indiana","Allen County",5,6,5432,2775,2657
050,18,003,"Indiana","Allen County",5,7,5560,2839,2721
050,18,003,"Indiana","Allen County",5,8,5577,2904,2673
050,18,003,"Indiana","Allen County",5,9,5549,2847,2702
050,18,003,"Indiana","Allen County",5,10,5515,2830,2685
050,18,003,"Indiana","Allen County",5,11,5508,2867,2641
050,18,003,"Indiana","Allen County",5,12,5614,2887,2727
050,18,003,"Indiana","Allen County",5,13,5695,2926,2769
050,18,003,"Indiana","Allen County",5,14,5736,2922,2814
050,18,003,"Indiana","Allen County",5,15,5985,3026,2959
050,18,003,"Indiana","Allen County",5,16,5883,3013,2870
050,18,003,"Indiana","Allen County",5,17,5751,2915,2836
050,18,003,"Indiana","Allen County",5,18,5006,2601,2405
050,18,003,"Indiana","Allen County",5,19,4533,2355,2178
050,18,003,"Indiana","Allen County",5,20,4631,2302,2329
050,18,003,"Indiana","Allen County",5,21,4761,2321,2440
050,18,003,"Indiana","Allen County",5,22,5257,2558,2699
050,18,003,"Indiana","Allen County",5,23,5531,2774,2757
050,18,003,"Indiana","Allen County",5,24,5530,2726,2804
050,18,003,"Indiana","Allen County",5,25,5576,2786,2790
050,18,003,"Indiana","Allen County",5,26,5524,2807,2717
050,18,003,"Indiana","Allen County",5,27,5567,2817,2750
050,18,003,"Indiana","Allen County",5,28,5581,2794,2787
050,18,003,"Indiana","Allen County",5,29,5582,2793,2789
050,18,003,"Indiana","Allen County",5,30,5709,2822,2887
050,18,003,"Indiana","Allen County",5,31,5771,2854,2917
050,18,003,"Indiana","Allen County",5,32,5679,2800,2879
050,18,003,"Indiana","Allen County",5,33,5635,2772,2863
050,18,003,"Indiana","Allen County",5,34,5364,2679,2685
050,18,003,"Indiana","Allen County",5,35,5206,2542,2664
050,18,003,"Indiana","Allen County",5,36,5089,2497,2592
050,18,003,"Indiana","Allen County",5,37,5219,2583,2636
050,18,003,"Indiana","Allen County",5,38,5094,2535,2559
050,18,003,"Indiana","Allen County",5,39,4906,2396,2510
050,18,003,"Indiana","Allen County",5,40,5069,2488,2581
050,18,003,"Indiana","Allen County",5,41,5105,2533,2572
050,18,003,"Indiana","Allen County",5,42,5007,2487,2520
050,18,003,"Indiana","Allen County",5,43,4985,2462,2523
050,18,003,"Indiana","Allen County",5,44,4767,2343,2424
050,18,003,"Indiana","Allen County",5,45,4659,2333,2326
050,18,003,"Indiana","Allen County",5,46,4524,2234,2290
050,18,003,"Indiana","Allen County",5,47,4422,2194,2228
050,18,003,"Indiana","Allen County",5,48,4461,2247,2214
050,18,003,"Indiana","Allen County",5,49,4215,2128,2087
050,18,003,"Indiana","Allen County",5,50,4396,2167,2229
050,18,003,"Indiana","Allen County",5,51,4609,2291,2318
050,18,003,"Indiana","Allen County",5,52,4851,2431,2420
050,18,003,"Indiana","Allen County",5,53,4754,2405,2349
050,18,003,"Indiana","Allen County",5,54,4501,2263,2238
050,18,003,"Indiana","Allen County",5,55,4332,2176,2156
050,18,003,"Indiana","Allen County",5,56,4244,2081,2163
050,18,003,"Indiana","Allen County",5,57,4269,2091,2178
050,18,003,"Indiana","Allen County",5,58,4522,2231,2291
050,18,003,"Indiana","Allen County",5,59,4557,2265,2292
050,18,003,"Indiana","Allen County",5,60,4546,2231,2315
050,18,003,"Indiana","Allen County",5,61,4668,2264,2404
050,18,003,"Indiana","Allen County",5,62,4604,2241,2363
050,18,003,"Indiana","Allen County",5,63,4500,2167,2333
050,18,003,"Indiana","Allen County",5,64,4333,2074,2259
050,18,003,"Indiana","Allen County",5,65,4395,2082,2313
050,18,003,"Indiana","Allen County",5,66,4349,2028,2321
050,18,003,"Indiana","Allen County",5,67,4204,1943,2261
050,18,003,"Indiana","Allen County",5,68,4093,1938,2155
050,18,003,"Indiana","Allen County",5,69,3893,1862,2031
050,18,003,"Indiana","Allen County",5,70,3768,1805,1963
050,18,003,"Indiana","Allen County",5,71,3624,1710,1914
050,18,003,"Indiana","Allen County",5,72,3400,1557,1843
050,18,003,"Indiana","Allen County",5,73,3066,1395,1671
050,18,003,"Indiana","Allen County",5,74,2993,1355,1638
050,18,003,"Indiana","Allen County",5,75,2942,1325,1617
050,18,003,"Indiana","Allen County",5,76,3106,1397,1709
050,18,003,"Indiana","Allen County",5,77,2086,915,1171
050,18,003,"Indiana","Allen County",5,78,1955,843,1112
050,18,003,"Indiana","Allen County",5,79,1867,787,1080
050,18,003,"Indiana","Allen County",5,80,1897,836,1061
050,18,003,"Indiana","Allen County",5,81,1590,669,921
050,18,003,"Indiana","Allen County",5,82,1278,532,746
050,18,003,"Indiana","Allen County",5,83,1130,462,668
050,18,003,"Indiana","Allen County",5,84,1007,402,605
050,18,003,"Indiana","Allen County",5,85,6611,2230,4381
050,18,005,"Indiana","Bartholomew County",1,0,1027,528,499
050,18,005,"Indiana","Bartholomew County",1,1,1020,547,473
050,18,005,"Indiana","Bartholomew County",1,2,1052,540,512
050,18,005,"Indiana","Bartholomew County",1,3,1090,546,544
050,18,005,"Indiana","Bartholomew County",1,4,1105,588,517
050,18,005,"Indiana","Bartholomew County",1,5,1130,610,520
050,18,005,"Indiana","Bartholomew County",1,6,1184,628,556
050,18,005,"Indiana","Bartholomew County",1,7,1166,587,579
050,18,005,"Indiana","Bartholomew County",1,8,1157,589,568
050,18,005,"Indiana","Bartholomew County",1,9,1100,556,544
050,18,005,"Indiana","Bartholomew County",1,10,1092,566,526
050,18,005,"Indiana","Bartholomew County",1,11,1145,579,566
050,18,005,"Indiana","Bartholomew County",1,12,1128,580,548
050,18,005,"Indiana","Bartholomew County",1,13,1110,542,568
050,18,005,"Indiana","Bartholomew County",1,14,1157,566,591
050,18,005,"Indiana","Bartholomew County",1,15,1136,538,598
050,18,005,"Indiana","Bartholomew County",1,16,1103,550,553
050,18,005,"Indiana","Bartholomew County",1,17,1091,535,556
050,18,005,"Indiana","Bartholomew County",1,18,942,448,494
050,18,005,"Indiana","Bartholomew County",1,19,870,442,428
050,18,005,"Indiana","Bartholomew County",1,20,890,476,414
050,18,005,"Indiana","Bartholomew County",1,21,887,450,437
050,18,005,"Indiana","Bartholomew County",1,22,969,511,458
050,18,005,"Indiana","Bartholomew County",1,23,1094,589,505
050,18,005,"Indiana","Bartholomew County",1,24,1121,614,507
050,18,005,"Indiana","Bartholomew County",1,25,1143,625,518
050,18,005,"Indiana","Bartholomew County",1,26,1176,630,546
050,18,005,"Indiana","Bartholomew County",1,27,1239,677,562
050,18,005,"Indiana","Bartholomew County",1,28,1274,666,608
050,18,005,"Indiana","Bartholomew County",1,29,1246,666,580
050,18,005,"Indiana","Bartholomew County",1,30,1175,643,532
050,18,005,"Indiana","Bartholomew County",1,31,1163,631,532
050,18,005,"Indiana","Bartholomew County",1,32,1068,567,501
050,18,005,"Indiana","Bartholomew County",1,33,1073,544,529
050,18,005,"Indiana","Bartholomew County",1,34,1111,579,532
050,18,005,"Indiana","Bartholomew County",1,35,1141,615,526
050,18,005,"Indiana","Bartholomew County",1,36,1116,584,532
050,18,005,"Indiana","Bartholomew County",1,37,1127,607,520
050,18,005,"Indiana","Bartholomew County",1,38,1049,557,492
050,18,005,"Indiana","Bartholomew County",1,39,993,520,473
050,18,005,"Indiana","Bartholomew County",1,40,1027,545,482
050,18,005,"Indiana","Bartholomew County",1,41,1016,541,475
050,18,005,"Indiana","Bartholomew County",1,42,1015,513,502
050,18,005,"Indiana","Bartholomew County",1,43,975,481,494
050,18,005,"Indiana","Bartholomew County",1,44,958,475,483
050,18,005,"Indiana","Bartholomew County",1,45,997,514,483
050,18,005,"Indiana","Bartholomew County",1,46,996,508,488
050,18,005,"Indiana","Bartholomew County",1,47,1016,535,481
050,18,005,"Indiana","Bartholomew County",1,48,1104,567,537
050,18,005,"Indiana","Bartholomew County",1,49,1103,568,535
050,18,005,"Indiana","Bartholomew County",1,50,1055,558,497
050,18,005,"Indiana","Bartholomew County",1,51,964,515,449
050,18,005,"Indiana","Bartholomew County",1,52,955,499,456
050,18,005,"Indiana","Bartholomew County",1,53,982,512,470
050,18,005,"Indiana","Bartholomew County",1,54,987,508,479
050,18,005,"Indiana","Bartholomew County",1,55,1024,529,495
050,18,005,"Indiana","Bartholomew County",1,56,998,493,505
050,18,005,"Indiana","Bartholomew County",1,57,1043,519,524
050,18,005,"Indiana","Bartholomew County",1,58,1021,503,518
050,18,005,"Indiana","Bartholomew County",1,59,1023,493,530
050,18,005,"Indiana","Bartholomew County",1,60,1000,494,506
050,18,005,"Indiana","Bartholomew County",1,61,986,496,490
050,18,005,"Indiana","Bartholomew County",1,62,997,495,502
050,18,005,"Indiana","Bartholomew County",1,63,964,463,501
050,18,005,"Indiana","Bartholomew County",1,64,898,440,458
050,18,005,"Indiana","Bartholomew County",1,65,924,449,475
050,18,005,"Indiana","Bartholomew County",1,66,895,431,464
050,18,005,"Indiana","Bartholomew County",1,67,843,408,435
050,18,005,"Indiana","Bartholomew County",1,68,868,411,457
050,18,005,"Indiana","Bartholomew County",1,69,789,361,428
050,18,005,"Indiana","Bartholomew County",1,70,757,359,398
050,18,005,"Indiana","Bartholomew County",1,71,735,357,378
050,18,005,"Indiana","Bartholomew County",1,72,734,338,396
050,18,005,"Indiana","Bartholomew County",1,73,736,338,398
050,18,005,"Indiana","Bartholomew County",1,74,514,244,270
050,18,005,"Indiana","Bartholomew County",1,75,534,235,299
050,18,005,"Indiana","Bartholomew County",1,76,544,251,293
050,18,005,"Indiana","Bartholomew County",1,77,522,238,284
050,18,005,"Indiana","Bartholomew County",1,78,444,192,252
050,18,005,"Indiana","Bartholomew County",1,79,401,169,232
050,18,005,"Indiana","Bartholomew County",1,80,361,156,205
050,18,005,"Indiana","Bartholomew County",1,81,359,166,193
050,18,005,"Indiana","Bartholomew County",1,82,308,132,176
050,18,005,"Indiana","Bartholomew County",1,83,278,116,162
050,18,005,"Indiana","Bartholomew County",1,84,252,100,152
050,18,005,"Indiana","Bartholomew County",1,85,1449,526,923
050,18,005,"Indiana","Bartholomew County",2,0,1024,539,485
050,18,005,"Indiana","Bartholomew County",2,1,1015,543,472
050,18,005,"Indiana","Bartholomew County",2,2,1045,542,503
050,18,005,"Indiana","Bartholomew County",2,3,1076,541,535
050,18,005,"Indiana","Bartholomew County",2,4,1100,573,527
050,18,005,"Indiana","Bartholomew County",2,5,1129,604,525
050,18,005,"Indiana","Bartholomew County",2,6,1178,627,551
050,18,005,"Indiana","Bartholomew County",2,7,1171,597,574
050,18,005,"Indiana","Bartholomew County",2,8,1155,586,569
050,18,005,"Indiana","Bartholomew County",2,9,1108,564,544
050,18,005,"Indiana","Bartholomew County",2,10,1093,564,529
050,18,005,"Indiana","Bartholomew County",2,11,1126,574,552
050,18,005,"Indiana","Bartholomew County",2,12,1137,582,555
050,18,005,"Indiana","Bartholomew County",2,13,1115,550,565
050,18,005,"Indiana","Bartholomew County",2,14,1145,559,586
050,18,005,"Indiana","Bartholomew County",2,15,1144,546,598
050,18,005,"Indiana","Bartholomew County",2,16,1114,550,564
050,18,005,"Indiana","Bartholomew County",2,17,1099,539,560
050,18,005,"Indiana","Bartholomew County",2,18,948,458,490
050,18,005,"Indiana","Bartholomew County",2,19,874,438,436
050,18,005,"Indiana","Bartholomew County",2,20,899,474,425
050,18,005,"Indiana","Bartholomew County",2,21,892,456,436
050,18,005,"Indiana","Bartholomew County",2,22,957,500,457
050,18,005,"Indiana","Bartholomew County",2,23,1068,575,493
050,18,005,"Indiana","Bartholomew County",2,24,1118,615,503
050,18,005,"Indiana","Bartholomew County",2,25,1146,629,517
050,18,005,"Indiana","Bartholomew County",2,26,1175,634,541
050,18,005,"Indiana","Bartholomew County",2,27,1221,663,558
050,18,005,"Indiana","Bartholomew County",2,28,1263,667,596
050,18,005,"Indiana","Bartholomew County",2,29,1249,667,582
050,18,005,"Indiana","Bartholomew County",2,30,1200,653,547
050,18,005,"Indiana","Bartholomew County",2,31,1157,628,529
050,18,005,"Indiana","Bartholomew County",2,32,1093,580,513
050,18,005,"Indiana","Bartholomew County",2,33,1068,547,521
050,18,005,"Indiana","Bartholomew County",2,34,1098,569,529
050,18,005,"Indiana","Bartholomew County",2,35,1137,606,531
050,18,005,"Indiana","Bartholomew County",2,36,1110,584,526
050,18,005,"Indiana","Bartholomew County",2,37,1131,604,527
050,18,005,"Indiana","Bartholomew County",2,38,1070,571,499
050,18,005,"Indiana","Bartholomew County",2,39,1004,527,477
050,18,005,"Indiana","Bartholomew County",2,40,1020,542,478
050,18,005,"Indiana","Bartholomew County",2,41,1020,539,481
050,18,005,"Indiana","Bartholomew County",2,42,1004,514,490
050,18,005,"Indiana","Bartholomew County",2,43,993,491,502
050,18,005,"Indiana","Bartholomew County",2,44,954,471,483
050,18,005,"Indiana","Bartholomew County",2,45,989,504,485
050,18,005,"Indiana","Bartholomew County",2,46,989,506,483
050,18,005,"Indiana","Bartholomew County",2,47,1008,526,482
050,18,005,"Indiana","Bartholomew County",2,48,1079,558,521
050,18,005,"Indiana","Bartholomew County",2,49,1107,569,538
050,18,005,"Indiana","Bartholomew County",2,50,1069,563,506
050,18,005,"Indiana","Bartholomew County",2,51,978,521,457
050,18,005,"Indiana","Bartholomew County",2,52,955,502,453
050,18,005,"Indiana","Bartholomew County",2,53,976,508,468
050,18,005,"Indiana","Bartholomew County",2,54,980,506,474
050,18,005,"Indiana","Bartholomew County",2,55,1012,521,491
050,18,005,"Indiana","Bartholomew County",2,56,1006,501,505
050,18,005,"Indiana","Bartholomew County",2,57,1035,513,522
050,18,005,"Indiana","Bartholomew County",2,58,1023,507,516
050,18,005,"Indiana","Bartholomew County",2,59,1026,496,530
050,18,005,"Indiana","Bartholomew County",2,60,999,490,509
050,18,005,"Indiana","Bartholomew County",2,61,981,489,492
050,18,005,"Indiana","Bartholomew County",2,62,992,495,497
050,18,005,"Indiana","Bartholomew County",2,63,975,470,505
050,18,005,"Indiana","Bartholomew County",2,64,905,438,467
050,18,005,"Indiana","Bartholomew County",2,65,911,442,469
050,18,005,"Indiana","Bartholomew County",2,66,898,431,467
050,18,005,"Indiana","Bartholomew County",2,67,847,407,440
050,18,005,"Indiana","Bartholomew County",2,68,850,403,447
050,18,005,"Indiana","Bartholomew County",2,69,814,376,438
050,18,005,"Indiana","Bartholomew County",2,70,757,357,400
050,18,005,"Indiana","Bartholomew County",2,71,742,358,384
050,18,005,"Indiana","Bartholomew County",2,72,719,333,386
050,18,005,"Indiana","Bartholomew County",2,73,771,357,414
050,18,005,"Indiana","Bartholomew County",2,74,530,247,283
050,18,005,"Indiana","Bartholomew County",2,75,530,237,293
050,18,005,"Indiana","Bartholomew County",2,76,531,243,288
050,18,005,"Indiana","Bartholomew County",2,77,529,241,288
050,18,005,"Indiana","Bartholomew County",2,78,452,198,254
050,18,005,"Indiana","Bartholomew County",2,79,407,173,234
050,18,005,"Indiana","Bartholomew County",2,80,361,153,208
050,18,005,"Indiana","Bartholomew County",2,81,353,159,194
050,18,005,"Indiana","Bartholomew County",2,82,320,141,179
050,18,005,"Indiana","Bartholomew County",2,83,279,118,161
050,18,005,"Indiana","Bartholomew County",2,84,252,100,152
050,18,005,"Indiana","Bartholomew County",2,85,1438,517,921
050,18,005,"Indiana","Bartholomew County",3,0,1039,523,516
050,18,005,"Indiana","Bartholomew County",3,1,1004,500,504
050,18,005,"Indiana","Bartholomew County",3,2,1041,544,497
050,18,005,"Indiana","Bartholomew County",3,3,1045,533,512
050,18,005,"Indiana","Bartholomew County",3,4,1098,543,555
050,18,005,"Indiana","Bartholomew County",3,5,1138,615,523
050,18,005,"Indiana","Bartholomew County",3,6,1144,605,539
050,18,005,"Indiana","Bartholomew County",3,7,1171,615,556
050,18,005,"Indiana","Bartholomew County",3,8,1190,608,582
050,18,005,"Indiana","Bartholomew County",3,9,1168,606,562
050,18,005,"Indiana","Bartholomew County",3,10,1117,560,557
050,18,005,"Indiana","Bartholomew County",3,11,1098,576,522
050,18,005,"Indiana","Bartholomew County",3,12,1144,568,576
050,18,005,"Indiana","Bartholomew County",3,13,1145,578,567
050,18,005,"Indiana","Bartholomew County",3,14,1119,559,560
050,18,005,"Indiana","Bartholomew County",3,15,1155,550,605
050,18,005,"Indiana","Bartholomew County",3,16,1165,560,605
050,18,005,"Indiana","Bartholomew County",3,17,1140,562,578
050,18,005,"Indiana","Bartholomew County",3,18,1003,500,503
050,18,005,"Indiana","Bartholomew County",3,19,885,428,457
050,18,005,"Indiana","Bartholomew County",3,20,936,472,464
050,18,005,"Indiana","Bartholomew County",3,21,961,501,460
050,18,005,"Indiana","Bartholomew County",3,22,928,471,457
050,18,005,"Indiana","Bartholomew County",3,23,984,513,471
050,18,005,"Indiana","Bartholomew County",3,24,1074,582,492
050,18,005,"Indiana","Bartholomew County",3,25,1145,645,500
050,18,005,"Indiana","Bartholomew County",3,26,1199,669,530
050,18,005,"Indiana","Bartholomew County",3,27,1145,629,516
050,18,005,"Indiana","Bartholomew County",3,28,1207,645,562
050,18,005,"Indiana","Bartholomew County",3,29,1241,633,608
050,18,005,"Indiana","Bartholomew County",3,30,1239,651,588
050,18,005,"Indiana","Bartholomew County",3,31,1172,632,540
050,18,005,"Indiana","Bartholomew County",3,32,1155,622,533
050,18,005,"Indiana","Bartholomew County",3,33,1074,567,507
050,18,005,"Indiana","Bartholomew County",3,34,1091,563,528
050,18,005,"Indiana","Bartholomew County",3,35,1099,577,522
050,18,005,"Indiana","Bartholomew County",3,36,1131,611,520
050,18,005,"Indiana","Bartholomew County",3,37,1113,575,538
050,18,005,"Indiana","Bartholomew County",3,38,1089,577,512
050,18,005,"Indiana","Bartholomew County",3,39,1070,566,504
050,18,005,"Indiana","Bartholomew County",3,40,1007,530,477
050,18,005,"Indiana","Bartholomew County",3,41,1037,550,487
050,18,005,"Indiana","Bartholomew County",3,42,999,521,478
050,18,005,"Indiana","Bartholomew County",3,43,1008,514,494
050,18,005,"Indiana","Bartholomew County",3,44,1000,493,507
050,18,005,"Indiana","Bartholomew County",3,45,941,464,477
050,18,005,"Indiana","Bartholomew County",3,46,1014,518,496
050,18,005,"Indiana","Bartholomew County",3,47,999,514,485
050,18,005,"Indiana","Bartholomew County",3,48,1018,535,483
050,18,005,"Indiana","Bartholomew County",3,49,1067,546,521
050,18,005,"Indiana","Bartholomew County",3,50,1103,579,524
050,18,005,"Indiana","Bartholomew County",3,51,1069,553,516
050,18,005,"Indiana","Bartholomew County",3,52,986,527,459
050,18,005,"Indiana","Bartholomew County",3,53,950,501,449
050,18,005,"Indiana","Bartholomew County",3,54,971,506,465
050,18,005,"Indiana","Bartholomew County",3,55,987,508,479
050,18,005,"Indiana","Bartholomew County",3,56,986,512,474
050,18,005,"Indiana","Bartholomew County",3,57,992,491,501
050,18,005,"Indiana","Bartholomew County",3,58,1028,510,518
050,18,005,"Indiana","Bartholomew County",3,59,1022,511,511
050,18,005,"Indiana","Bartholomew County",3,60,999,482,517
050,18,005,"Indiana","Bartholomew County",3,61,977,470,507
050,18,005,"Indiana","Bartholomew County",3,62,976,491,485
050,18,005,"Indiana","Bartholomew County",3,63,999,493,506
050,18,005,"Indiana","Bartholomew County",3,64,948,456,492
050,18,005,"Indiana","Bartholomew County",3,65,887,432,455
050,18,005,"Indiana","Bartholomew County",3,66,893,427,466
050,18,005,"Indiana","Bartholomew County",3,67,873,413,460
050,18,005,"Indiana","Bartholomew County",3,68,828,398,430
050,18,005,"Indiana","Bartholomew County",3,69,841,401,440
050,18,005,"Indiana","Bartholomew County",3,70,795,373,422
050,18,005,"Indiana","Bartholomew County",3,71,740,347,393
050,18,005,"Indiana","Bartholomew County",3,72,728,353,375
050,18,005,"Indiana","Bartholomew County",3,73,701,327,374
050,18,005,"Indiana","Bartholomew County",3,74,755,347,408
050,18,005,"Indiana","Bartholomew County",3,75,522,236,286
050,18,005,"Indiana","Bartholomew County",3,76,502,228,274
050,18,005,"Indiana","Bartholomew County",3,77,508,230,278
050,18,005,"Indiana","Bartholomew County",3,78,518,229,289
050,18,005,"Indiana","Bartholomew County",3,79,434,186,248
050,18,005,"Indiana","Bartholomew County",3,80,382,159,223
050,18,005,"Indiana","Bartholomew County",3,81,352,146,206
050,18,005,"Indiana","Bartholomew County",3,82,345,159,186
050,18,005,"Indiana","Bartholomew County",3,83,295,128,167
050,18,005,"Indiana","Bartholomew County",3,84,252,108,144
050,18,005,"Indiana","Bartholomew County",3,85,1433,514,919
050,18,005,"Indiana","Bartholomew County",4,0,1037,539,498
050,18,005,"Indiana","Bartholomew County",4,1,1055,533,522
050,18,005,"Indiana","Bartholomew County",4,2,1034,526,508
050,18,005,"Indiana","Bartholomew County",4,3,1036,545,491
050,18,005,"Indiana","Bartholomew County",4,4,1065,534,531
050,18,005,"Indiana","Bartholomew County",4,5,1100,546,554
050,18,005,"Indiana","Bartholomew County",4,6,1174,623,551
050,18,005,"Indiana","Bartholomew County",4,7,1155,608,547
050,18,005,"Indiana","Bartholomew County",4,8,1183,633,550
050,18,005,"Indiana","Bartholomew County",4,9,1175,605,570
050,18,005,"Indiana","Bartholomew County",4,10,1197,614,583
050,18,005,"Indiana","Bartholomew County",4,11,1136,579,557
050,18,005,"Indiana","Bartholomew County",4,12,1102,573,529
050,18,005,"Indiana","Bartholomew County",4,13,1151,570,581
050,18,005,"Indiana","Bartholomew County",4,14,1142,590,552
050,18,005,"Indiana","Bartholomew County",4,15,1139,552,587
050,18,005,"Indiana","Bartholomew County",4,16,1178,584,594
050,18,005,"Indiana","Bartholomew County",4,17,1182,566,616
050,18,005,"Indiana","Bartholomew County",4,18,1033,535,498
050,18,005,"Indiana","Bartholomew County",4,19,908,465,443
050,18,005,"Indiana","Bartholomew County",4,20,901,436,465
050,18,005,"Indiana","Bartholomew County",4,21,958,493,465
050,18,005,"Indiana","Bartholomew County",4,22,1037,537,500
050,18,005,"Indiana","Bartholomew County",4,23,1053,534,519
050,18,005,"Indiana","Bartholomew County",4,24,1043,552,491
050,18,005,"Indiana","Bartholomew County",4,25,1148,635,513
050,18,005,"Indiana","Bartholomew County",4,26,1142,639,503
050,18,005,"Indiana","Bartholomew County",4,27,1176,627,549
050,18,005,"Indiana","Bartholomew County",4,28,1150,608,542
050,18,005,"Indiana","Bartholomew County",4,29,1180,623,557
050,18,005,"Indiana","Bartholomew County",4,30,1237,618,619
050,18,005,"Indiana","Bartholomew County",4,31,1232,648,584
050,18,005,"Indiana","Bartholomew County",4,32,1164,610,554
050,18,005,"Indiana","Bartholomew County",4,33,1132,619,513
050,18,005,"Indiana","Bartholomew County",4,34,1089,575,514
050,18,005,"Indiana","Bartholomew County",4,35,1097,573,524
050,18,005,"Indiana","Bartholomew County",4,36,1064,556,508
050,18,005,"Indiana","Bartholomew County",4,37,1145,620,525
050,18,005,"Indiana","Bartholomew County",4,38,1087,555,532
050,18,005,"Indiana","Bartholomew County",4,39,1099,576,523
050,18,005,"Indiana","Bartholomew County",4,40,1047,553,494
050,18,005,"Indiana","Bartholomew County",4,41,1008,520,488
050,18,005,"Indiana","Bartholomew County",4,42,1018,547,471
050,18,005,"Indiana","Bartholomew County",4,43,984,519,465
050,18,005,"Indiana","Bartholomew County",4,44,1031,523,508
050,18,005,"Indiana","Bartholomew County",4,45,1010,506,504
050,18,005,"Indiana","Bartholomew County",4,46,944,463,481
050,18,005,"Indiana","Bartholomew County",4,47,1014,513,501
050,18,005,"Indiana","Bartholomew County",4,48,992,508,484
050,18,005,"Indiana","Bartholomew County",4,49,1019,526,493
050,18,005,"Indiana","Bartholomew County",4,50,1050,541,509
050,18,005,"Indiana","Bartholomew County",4,51,1119,584,535
050,18,005,"Indiana","Bartholomew County",4,52,1074,559,515
050,18,005,"Indiana","Bartholomew County",4,53,976,512,464
050,18,005,"Indiana","Bartholomew County",4,54,934,500,434
050,18,005,"Indiana","Bartholomew County",4,55,961,501,460
050,18,005,"Indiana","Bartholomew County",4,56,978,504,474
050,18,005,"Indiana","Bartholomew County",4,57,991,505,486
050,18,005,"Indiana","Bartholomew County",4,58,983,495,488
050,18,005,"Indiana","Bartholomew County",4,59,1008,508,500
050,18,005,"Indiana","Bartholomew County",4,60,1009,509,500
050,18,005,"Indiana","Bartholomew County",4,61,980,473,507
050,18,005,"Indiana","Bartholomew County",4,62,945,450,495
050,18,005,"Indiana","Bartholomew County",4,63,979,486,493
050,18,005,"Indiana","Bartholomew County",4,64,972,473,499
050,18,005,"Indiana","Bartholomew County",4,65,942,453,489
050,18,005,"Indiana","Bartholomew County",4,66,867,418,449
050,18,005,"Indiana","Bartholomew County",4,67,898,431,467
050,18,005,"Indiana","Bartholomew County",4,68,856,401,455
050,18,005,"Indiana","Bartholomew County",4,69,822,392,430
050,18,005,"Indiana","Bartholomew County",4,70,820,396,424
050,18,005,"Indiana","Bartholomew County",4,71,799,370,429
050,18,005,"Indiana","Bartholomew County",4,72,734,339,395
050,18,005,"Indiana","Bartholomew County",4,73,713,345,368
050,18,005,"Indiana","Bartholomew County",4,74,690,319,371
050,18,005,"Indiana","Bartholomew County",4,75,732,326,406
050,18,005,"Indiana","Bartholomew County",4,76,493,223,270
050,18,005,"Indiana","Bartholomew County",4,77,489,218,271
050,18,005,"Indiana","Bartholomew County",4,78,500,223,277
050,18,005,"Indiana","Bartholomew County",4,79,503,219,284
050,18,005,"Indiana","Bartholomew County",4,80,406,174,232
050,18,005,"Indiana","Bartholomew County",4,81,376,155,221
050,18,005,"Indiana","Bartholomew County",4,82,342,141,201
050,18,005,"Indiana","Bartholomew County",4,83,329,148,181
050,18,005,"Indiana","Bartholomew County",4,84,282,116,166
050,18,005,"Indiana","Bartholomew County",4,85,1459,543,916
050,18,005,"Indiana","Bartholomew County",5,0,1026,534,492
050,18,005,"Indiana","Bartholomew County",5,1,1079,565,514
050,18,005,"Indiana","Bartholomew County",5,2,1056,533,523
050,18,005,"Indiana","Bartholomew County",5,3,1043,531,512
050,18,005,"Indiana","Bartholomew County",5,4,1080,560,520
050,18,005,"Indiana","Bartholomew County",5,5,1073,547,526
050,18,005,"Indiana","Bartholomew County",5,6,1117,558,559
050,18,005,"Indiana","Bartholomew County",5,7,1169,621,548
050,18,005,"Indiana","Bartholomew County",5,8,1149,595,554
050,18,005,"Indiana","Bartholomew County",5,9,1213,661,552
050,18,005,"Indiana","Bartholomew County",5,10,1182,598,584
050,18,005,"Indiana","Bartholomew County",5,11,1180,611,569
050,18,005,"Indiana","Bartholomew County",5,12,1131,582,549
050,18,005,"Indiana","Bartholomew County",5,13,1119,569,550
050,18,005,"Indiana","Bartholomew County",5,14,1131,554,577
050,18,005,"Indiana","Bartholomew County",5,15,1139,589,550
050,18,005,"Indiana","Bartholomew County",5,16,1142,582,560
050,18,005,"Indiana","Bartholomew County",5,17,1186,590,596
050,18,005,"Indiana","Bartholomew County",5,18,1062,528,534
050,18,005,"Indiana","Bartholomew County",5,19,951,490,461
050,18,005,"Indiana","Bartholomew County",5,20,950,483,467
050,18,005,"Indiana","Bartholomew County",5,21,932,460,472
050,18,005,"Indiana","Bartholomew County",5,22,1022,528,494
050,18,005,"Indiana","Bartholomew County",5,23,1165,596,569
050,18,005,"Indiana","Bartholomew County",5,24,1088,579,509
050,18,005,"Indiana","Bartholomew County",5,25,1104,582,522
050,18,005,"Indiana","Bartholomew County",5,26,1134,650,484
050,18,005,"Indiana","Bartholomew County",5,27,1118,629,489
050,18,005,"Indiana","Bartholomew County",5,28,1158,594,564
050,18,005,"Indiana","Bartholomew County",5,29,1164,606,558
050,18,005,"Indiana","Bartholomew County",5,30,1165,623,542
050,18,005,"Indiana","Bartholomew County",5,31,1218,613,605
050,18,005,"Indiana","Bartholomew County",5,32,1242,655,587
050,18,005,"Indiana","Bartholomew County",5,33,1165,615,550
050,18,005,"Indiana","Bartholomew County",5,34,1134,602,532
050,18,005,"Indiana","Bartholomew County",5,35,1131,601,530
050,18,005,"Indiana","Bartholomew County",5,36,1076,573,503
050,18,005,"Indiana","Bartholomew County",5,37,1062,551,511
050,18,005,"Indiana","Bartholomew County",5,38,1126,609,517
050,18,005,"Indiana","Bartholomew County",5,39,1084,551,533
050,18,005,"Indiana","Bartholomew County",5,40,1106,579,527
050,18,005,"Indiana","Bartholomew County",5,41,1037,534,503
050,18,005,"Indiana","Bartholomew County",5,42,989,507,482
050,18,005,"Indiana","Bartholomew County",5,43,1033,556,477
050,18,005,"Indiana","Bartholomew County",5,44,1004,530,474
050,18,005,"Indiana","Bartholomew County",5,45,998,507,491
050,18,005,"Indiana","Bartholomew County",5,46,982,495,487
050,18,005,"Indiana","Bartholomew County",5,47,961,472,489
050,18,005,"Indiana","Bartholomew County",5,48,1016,511,505
050,18,005,"Indiana","Bartholomew County",5,49,982,501,481
050,18,005,"Indiana","Bartholomew County",5,50,1029,538,491
050,18,005,"Indiana","Bartholomew County",5,51,1039,543,496
050,18,005,"Indiana","Bartholomew County",5,52,1123,584,539
050,18,005,"Indiana","Bartholomew County",5,53,1072,549,523
050,18,005,"Indiana","Bartholomew County",5,54,991,511,480
050,18,005,"Indiana","Bartholomew County",5,55,922,499,423
050,18,005,"Indiana","Bartholomew County",5,56,956,488,468
050,18,005,"Indiana","Bartholomew County",5,57,956,489,467
050,18,005,"Indiana","Bartholomew County",5,58,980,501,479
050,18,005,"Indiana","Bartholomew County",5,59,983,492,491
050,18,005,"Indiana","Bartholomew County",5,60,1002,510,492
050,18,005,"Indiana","Bartholomew County",5,61,1004,508,496
050,18,005,"Indiana","Bartholomew County",5,62,974,467,507
050,18,005,"Indiana","Bartholomew County",5,63,954,446,508
050,18,005,"Indiana","Bartholomew County",5,64,959,460,499
050,18,005,"Indiana","Bartholomew County",5,65,956,462,494
050,18,005,"Indiana","Bartholomew County",5,66,941,450,491
050,18,005,"Indiana","Bartholomew County",5,67,855,418,437
050,18,005,"Indiana","Bartholomew County",5,68,895,424,471
050,18,005,"Indiana","Bartholomew County",5,69,829,391,438
050,18,005,"Indiana","Bartholomew County",5,70,800,381,419
050,18,005,"Indiana","Bartholomew County",5,71,803,383,420
050,18,005,"Indiana","Bartholomew County",5,72,792,363,429
050,18,005,"Indiana","Bartholomew County",5,73,728,331,397
050,18,005,"Indiana","Bartholomew County",5,74,696,328,368
050,18,005,"Indiana","Bartholomew County",5,75,667,302,365
050,18,005,"Indiana","Bartholomew County",5,76,703,317,386
050,18,005,"Indiana","Bartholomew County",5,77,480,215,265
050,18,005,"Indiana","Bartholomew County",5,78,474,211,263
050,18,005,"Indiana","Bartholomew County",5,79,488,215,273
050,18,005,"Indiana","Bartholomew County",5,80,477,208,269
050,18,005,"Indiana","Bartholomew County",5,81,390,162,228
050,18,005,"Indiana","Bartholomew County",5,82,355,147,208
050,18,005,"Indiana","Bartholomew County",5,83,323,128,195
050,18,005,"Indiana","Bartholomew County",5,84,311,139,172
050,18,005,"Indiana","Bartholomew County",5,85,1522,585,937
050,18,007,"Indiana","Benton County",1,0,110,55,55
050,18,007,"Indiana","Benton County",1,1,103,50,53
050,18,007,"Indiana","Benton County",1,2,113,61,52
050,18,007,"Indiana","Benton County",1,3,106,51,55
050,18,007,"Indiana","Benton County",1,4,119,58,61
050,18,007,"Indiana","Benton County",1,5,130,60,70
050,18,007,"Indiana","Benton County",1,6,123,69,54
050,18,007,"Indiana","Benton County",1,7,110,67,43
050,18,007,"Indiana","Benton County",1,8,111,69,42
050,18,007,"Indiana","Benton County",1,9,108,64,44
050,18,007,"Indiana","Benton County",1,10,107,67,40
050,18,007,"Indiana","Benton County",1,11,142,78,64
050,18,007,"Indiana","Benton County",1,12,132,64,68
050,18,007,"Indiana","Benton County",1,13,128,61,67
050,18,007,"Indiana","Benton County",1,14,144,72,72
050,18,007,"Indiana","Benton County",1,15,151,67,84
050,18,007,"Indiana","Benton County",1,16,144,78,66
050,18,007,"Indiana","Benton County",1,17,130,71,59
050,18,007,"Indiana","Benton County",1,18,114,62,52
050,18,007,"Indiana","Benton County",1,19,80,42,38
050,18,007,"Indiana","Benton County",1,20,97,53,44
050,18,007,"Indiana","Benton County",1,21,95,49,46
050,18,007,"Indiana","Benton County",1,22,95,48,47
050,18,007,"Indiana","Benton County",1,23,98,52,46
050,18,007,"Indiana","Benton County",1,24,88,47,41
050,18,007,"Indiana","Benton County",1,25,80,44,36
050,18,007,"Indiana","Benton County",1,26,105,57,48
050,18,007,"Indiana","Benton County",1,27,111,56,55
050,18,007,"Indiana","Benton County",1,28,119,66,53
050,18,007,"Indiana","Benton County",1,29,89,42,47
050,18,007,"Indiana","Benton County",1,30,99,50,49
050,18,007,"Indiana","Benton County",1,31,89,43,46
050,18,007,"Indiana","Benton County",1,32,94,45,49
050,18,007,"Indiana","Benton County",1,33,90,50,40
050,18,007,"Indiana","Benton County",1,34,94,57,37
050,18,007,"Indiana","Benton County",1,35,107,60,47
050,18,007,"Indiana","Benton County",1,36,108,52,56
050,18,007,"Indiana","Benton County",1,37,114,61,53
050,18,007,"Indiana","Benton County",1,38,124,60,64
050,18,007,"Indiana","Benton County",1,39,104,50,54
050,18,007,"Indiana","Benton County",1,40,106,59,47
050,18,007,"Indiana","Benton County",1,41,89,46,43
050,18,007,"Indiana","Benton County",1,42,107,65,42
050,18,007,"Indiana","Benton County",1,43,113,61,52
050,18,007,"Indiana","Benton County",1,44,104,45,59
050,18,007,"Indiana","Benton County",1,45,109,55,54
050,18,007,"Indiana","Benton County",1,46,98,50,48
050,18,007,"Indiana","Benton County",1,47,82,43,39
050,18,007,"Indiana","Benton County",1,48,94,47,47
050,18,007,"Indiana","Benton County",1,49,129,56,73
050,18,007,"Indiana","Benton County",1,50,108,53,55
050,18,007,"Indiana","Benton County",1,51,103,54,49
050,18,007,"Indiana","Benton County",1,52,108,56,52
050,18,007,"Indiana","Benton County",1,53,116,61,55
050,18,007,"Indiana","Benton County",1,54,118,56,62
050,18,007,"Indiana","Benton County",1,55,129,67,62
050,18,007,"Indiana","Benton County",1,56,109,60,49
050,18,007,"Indiana","Benton County",1,57,123,68,55
050,18,007,"Indiana","Benton County",1,58,126,59,67
050,18,007,"Indiana","Benton County",1,59,122,63,59
050,18,007,"Indiana","Benton County",1,60,129,63,66
050,18,007,"Indiana","Benton County",1,61,131,60,71
050,18,007,"Indiana","Benton County",1,62,130,64,66
050,18,007,"Indiana","Benton County",1,63,125,60,65
050,18,007,"Indiana","Benton County",1,64,106,55,51
050,18,007,"Indiana","Benton County",1,65,104,56,48
050,18,007,"Indiana","Benton County",1,66,92,47,45
050,18,007,"Indiana","Benton County",1,67,96,53,43
050,18,007,"Indiana","Benton County",1,68,95,50,45
050,18,007,"Indiana","Benton County",1,69,87,43,44
050,18,007,"Indiana","Benton County",1,70,89,45,44
050,18,007,"Indiana","Benton County",1,71,84,39,45
050,18,007,"Indiana","Benton County",1,72,77,38,39
050,18,007,"Indiana","Benton County",1,73,64,29,35
050,18,007,"Indiana","Benton County",1,74,55,19,36
050,18,007,"Indiana","Benton County",1,75,66,32,34
050,18,007,"Indiana","Benton County",1,76,69,31,38
050,18,007,"Indiana","Benton County",1,77,64,28,36
050,18,007,"Indiana","Benton County",1,78,52,20,32
050,18,007,"Indiana","Benton County",1,79,61,26,35
050,18,007,"Indiana","Benton County",1,80,46,19,27
050,18,007,"Indiana","Benton County",1,81,47,24,23
050,18,007,"Indiana","Benton County",1,82,29,16,13
050,18,007,"Indiana","Benton County",1,83,20,7,13
050,18,007,"Indiana","Benton County",1,84,26,8,18
050,18,007,"Indiana","Benton County",1,85,175,52,123
050,18,007,"Indiana","Benton County",2,0,111,52,59
050,18,007,"Indiana","Benton County",2,1,104,52,52
050,18,007,"Indiana","Benton County",2,2,112,59,53
050,18,007,"Indiana","Benton County",2,3,109,54,55
050,18,007,"Indiana","Benton County",2,4,118,57,61
050,18,007,"Indiana","Benton County",2,5,128,60,68
050,18,007,"Indiana","Benton County",2,6,123,66,57
050,18,007,"Indiana","Benton County",2,7,113,68,45
050,18,007,"Indiana","Benton County",2,8,110,69,41
050,18,007,"Indiana","Benton County",2,9,108,65,43
050,18,007,"Indiana","Benton County",2,10,108,66,42
050,18,007,"Indiana","Benton County",2,11,132,74,58
050,18,007,"Indiana","Benton County",2,12,135,67,68
050,18,007,"Indiana","Benton County",2,13,128,62,66
050,18,007,"Indiana","Benton County",2,14,139,70,69
050,18,007,"Indiana","Benton County",2,15,149,69,80
050,18,007,"Indiana","Benton County",2,16,144,75,69
050,18,007,"Indiana","Benton County",2,17,132,72,60
050,18,007,"Indiana","Benton County",2,18,110,61,49
050,18,007,"Indiana","Benton County",2,19,81,44,37
050,18,007,"Indiana","Benton County",2,20,97,52,45
050,18,007,"Indiana","Benton County",2,21,94,48,46
050,18,007,"Indiana","Benton County",2,22,96,49,47
050,18,007,"Indiana","Benton County",2,23,97,51,46
050,18,007,"Indiana","Benton County",2,24,89,48,41
050,18,007,"Indiana","Benton County",2,25,87,48,39
050,18,007,"Indiana","Benton County",2,26,100,55,45
050,18,007,"Indiana","Benton County",2,27,111,57,54
050,18,007,"Indiana","Benton County",2,28,116,63,53
050,18,007,"Indiana","Benton County",2,29,98,49,49
050,18,007,"Indiana","Benton County",2,30,99,48,51
050,18,007,"Indiana","Benton County",2,31,92,44,48
050,18,007,"Indiana","Benton County",2,32,93,45,48
050,18,007,"Indiana","Benton County",2,33,92,50,42
050,18,007,"Indiana","Benton County",2,34,95,57,38
050,18,007,"Indiana","Benton County",2,35,106,61,45
050,18,007,"Indiana","Benton County",2,36,107,53,54
050,18,007,"Indiana","Benton County",2,37,113,59,54
050,18,007,"Indiana","Benton County",2,38,121,60,61
050,18,007,"Indiana","Benton County",2,39,109,53,56
050,18,007,"Indiana","Benton County",2,40,107,57,50
050,18,007,"Indiana","Benton County",2,41,93,50,43
050,18,007,"Indiana","Benton County",2,42,103,61,42
050,18,007,"Indiana","Benton County",2,43,111,60,51
050,18,007,"Indiana","Benton County",2,44,103,48,55
050,18,007,"Indiana","Benton County",2,45,108,52,56
050,18,007,"Indiana","Benton County",2,46,99,50,49
050,18,007,"Indiana","Benton County",2,47,86,45,41
050,18,007,"Indiana","Benton County",2,48,92,46,46
050,18,007,"Indiana","Benton County",2,49,119,54,65
050,18,007,"Indiana","Benton County",2,50,111,53,58
050,18,007,"Indiana","Benton County",2,51,105,54,51
050,18,007,"Indiana","Benton County",2,52,107,55,52
050,18,007,"Indiana","Benton County",2,53,114,59,55
050,18,007,"Indiana","Benton County",2,54,117,56,61
050,18,007,"Indiana","Benton County",2,55,127,64,63
050,18,007,"Indiana","Benton County",2,56,116,63,53
050,18,007,"Indiana","Benton County",2,57,121,67,54
050,18,007,"Indiana","Benton County",2,58,125,60,65
050,18,007,"Indiana","Benton County",2,59,122,62,60
050,18,007,"Indiana","Benton County",2,60,126,62,64
050,18,007,"Indiana","Benton County",2,61,129,60,69
050,18,007,"Indiana","Benton County",2,62,131,64,67
050,18,007,"Indiana","Benton County",2,63,128,62,66
050,18,007,"Indiana","Benton County",2,64,111,56,55
050,18,007,"Indiana","Benton County",2,65,104,57,47
050,18,007,"Indiana","Benton County",2,66,94,50,44
050,18,007,"Indiana","Benton County",2,67,92,50,42
050,18,007,"Indiana","Benton County",2,68,91,48,43
050,18,007,"Indiana","Benton County",2,69,90,45,45
050,18,007,"Indiana","Benton County",2,70,88,44,44
050,18,007,"Indiana","Benton County",2,71,85,40,45
050,18,007,"Indiana","Benton County",2,72,77,38,39
050,18,007,"Indiana","Benton County",2,73,70,32,38
050,18,007,"Indiana","Benton County",2,74,53,20,33
050,18,007,"Indiana","Benton County",2,75,62,28,34
050,18,007,"Indiana","Benton County",2,76,67,31,36
050,18,007,"Indiana","Benton County",2,77,67,29,38
050,18,007,"Indiana","Benton County",2,78,54,21,33
050,18,007,"Indiana","Benton County",2,79,58,24,34
050,18,007,"Indiana","Benton County",2,80,49,21,28
050,18,007,"Indiana","Benton County",2,81,46,23,23
050,18,007,"Indiana","Benton County",2,82,32,17,15
050,18,007,"Indiana","Benton County",2,83,22,9,13
050,18,007,"Indiana","Benton County",2,84,24,7,17
050,18,007,"Indiana","Benton County",2,85,173,51,122
050,18,007,"Indiana","Benton County",3,0,90,48,42
050,18,007,"Indiana","Benton County",3,1,112,49,63
050,18,007,"Indiana","Benton County",3,2,102,52,50
050,18,007,"Indiana","Benton County",3,3,104,56,48
050,18,007,"Indiana","Benton County",3,4,116,54,62
050,18,007,"Indiana","Benton County",3,5,113,60,53
050,18,007,"Indiana","Benton County",3,6,126,64,62
050,18,007,"Indiana","Benton County",3,7,112,62,50
050,18,007,"Indiana","Benton County",3,8,116,74,42
050,18,007,"Indiana","Benton County",3,9,111,72,39
050,18,007,"Indiana","Benton County",3,10,109,67,42
050,18,007,"Indiana","Benton County",3,11,114,66,48
050,18,007,"Indiana","Benton County",3,12,135,77,58
050,18,007,"Indiana","Benton County",3,13,132,68,64
050,18,007,"Indiana","Benton County",3,14,129,64,65
050,18,007,"Indiana","Benton County",3,15,130,60,70
050,18,007,"Indiana","Benton County",3,16,143,64,79
050,18,007,"Indiana","Benton County",3,17,146,80,66
050,18,007,"Indiana","Benton County",3,18,121,69,52
050,18,007,"Indiana","Benton County",3,19,84,47,37
050,18,007,"Indiana","Benton County",3,20,80,46,34
050,18,007,"Indiana","Benton County",3,21,100,55,45
050,18,007,"Indiana","Benton County",3,22,100,52,48
050,18,007,"Indiana","Benton County",3,23,93,52,41
050,18,007,"Indiana","Benton County",3,24,96,46,50
050,18,007,"Indiana","Benton County",3,25,90,49,41
050,18,007,"Indiana","Benton County",3,26,100,56,44
050,18,007,"Indiana","Benton County",3,27,108,59,49
050,18,007,"Indiana","Benton County",3,28,123,66,57
050,18,007,"Indiana","Benton County",3,29,117,63,54
050,18,007,"Indiana","Benton County",3,30,97,46,51
050,18,007,"Indiana","Benton County",3,31,100,50,50
050,18,007,"Indiana","Benton County",3,32,96,49,47
050,18,007,"Indiana","Benton County",3,33,89,44,45
050,18,007,"Indiana","Benton County",3,34,95,53,42
050,18,007,"Indiana","Benton County",3,35,97,59,38
050,18,007,"Indiana","Benton County",3,36,106,59,47
050,18,007,"Indiana","Benton County",3,37,111,53,58
050,18,007,"Indiana","Benton County",3,38,112,56,56
050,18,007,"Indiana","Benton County",3,39,120,59,61
050,18,007,"Indiana","Benton County",3,40,108,50,58
050,18,007,"Indiana","Benton County",3,41,111,62,49
050,18,007,"Indiana","Benton County",3,42,88,49,39
050,18,007,"Indiana","Benton County",3,43,101,59,42
050,18,007,"Indiana","Benton County",3,44,110,59,51
050,18,007,"Indiana","Benton County",3,45,107,52,55
050,18,007,"Indiana","Benton County",3,46,110,55,55
050,18,007,"Indiana","Benton County",3,47,99,49,50
050,18,007,"Indiana","Benton County",3,48,87,48,39
050,18,007,"Indiana","Benton County",3,49,91,44,47
050,18,007,"Indiana","Benton County",3,50,119,54,65
050,18,007,"Indiana","Benton County",3,51,108,53,55
050,18,007,"Indiana","Benton County",3,52,104,51,53
050,18,007,"Indiana","Benton County",3,53,106,55,51
050,18,007,"Indiana","Benton County",3,54,114,61,53
050,18,007,"Indiana","Benton County",3,55,122,56,66
050,18,007,"Indiana","Benton County",3,56,123,65,58
050,18,007,"Indiana","Benton County",3,57,114,61,53
050,18,007,"Indiana","Benton County",3,58,124,65,59
050,18,007,"Indiana","Benton County",3,59,122,59,63
050,18,007,"Indiana","Benton County",3,60,123,61,62
050,18,007,"Indiana","Benton County",3,61,129,61,68
050,18,007,"Indiana","Benton County",3,62,129,59,70
050,18,007,"Indiana","Benton County",3,63,128,66,62
050,18,007,"Indiana","Benton County",3,64,126,63,63
050,18,007,"Indiana","Benton County",3,65,111,58,53
050,18,007,"Indiana","Benton County",3,66,97,51,46
050,18,007,"Indiana","Benton County",3,67,92,51,41
050,18,007,"Indiana","Benton County",3,68,91,49,42
050,18,007,"Indiana","Benton County",3,69,85,46,39
050,18,007,"Indiana","Benton County",3,70,88,45,43
050,18,007,"Indiana","Benton County",3,71,84,39,45
050,18,007,"Indiana","Benton County",3,72,78,38,40
050,18,007,"Indiana","Benton County",3,73,76,37,39
050,18,007,"Indiana","Benton County",3,74,67,30,37
050,18,007,"Indiana","Benton County",3,75,51,19,32
050,18,007,"Indiana","Benton County",3,76,57,29,28
050,18,007,"Indiana","Benton County",3,77,61,26,35
050,18,007,"Indiana","Benton County",3,78,67,29,38
050,18,007,"Indiana","Benton County",3,79,51,18,33
050,18,007,"Indiana","Benton County",3,80,56,24,32
050,18,007,"Indiana","Benton County",3,81,48,20,28
050,18,007,"Indiana","Benton County",3,82,36,14,22
050,18,007,"Indiana","Benton County",3,83,28,14,14
050,18,007,"Indiana","Benton County",3,84,20,10,10
050,18,007,"Indiana","Benton County",3,85,164,45,119
050,18,007,"Indiana","Benton County",4,0,92,48,44
050,18,007,"Indiana","Benton County",4,1,95,53,42
050,18,007,"Indiana","Benton County",4,2,113,51,62
050,18,007,"Indiana","Benton County",4,3,98,57,41
050,18,007,"Indiana","Benton County",4,4,108,57,51
050,18,007,"Indiana","Benton County",4,5,119,60,59
050,18,007,"Indiana","Benton County",4,6,122,66,56
050,18,007,"Indiana","Benton County",4,7,110,56,54
050,18,007,"Indiana","Benton County",4,8,113,68,45
050,18,007,"Indiana","Benton County",4,9,121,74,47
050,18,007,"Indiana","Benton County",4,10,112,73,39
050,18,007,"Indiana","Benton County",4,11,108,65,43
050,18,007,"Indiana","Benton County",4,12,114,64,50
050,18,007,"Indiana","Benton County",4,13,137,77,60
050,18,007,"Indiana","Benton County",4,14,125,63,62
050,18,007,"Indiana","Benton County",4,15,127,60,67
050,18,007,"Indiana","Benton County",4,16,138,63,75
050,18,007,"Indiana","Benton County",4,17,141,63,78
050,18,007,"Indiana","Benton County",4,18,115,68,47
050,18,007,"Indiana","Benton County",4,19,88,46,42
050,18,007,"Indiana","Benton County",4,20,91,53,38
050,18,007,"Indiana","Benton County",4,21,93,54,39
050,18,007,"Indiana","Benton County",4,22,108,59,49
050,18,007,"Indiana","Benton County",4,23,94,49,45
050,18,007,"Indiana","Benton County",4,24,87,47,40
050,18,007,"Indiana","Benton County",4,25,98,46,52
050,18,007,"Indiana","Benton County",4,26,81,45,36
050,18,007,"Indiana","Benton County",4,27,105,58,47
050,18,007,"Indiana","Benton County",4,28,116,61,55
050,18,007,"Indiana","Benton County",4,29,119,61,58
050,18,007,"Indiana","Benton County",4,30,127,64,63
050,18,007,"Indiana","Benton County",4,31,108,54,54
050,18,007,"Indiana","Benton County",4,32,108,57,51
050,18,007,"Indiana","Benton County",4,33,94,47,47
050,18,007,"Indiana","Benton County",4,34,99,51,48
050,18,007,"Indiana","Benton County",4,35,94,53,41
050,18,007,"Indiana","Benton County",4,36,94,54,40
050,18,007,"Indiana","Benton County",4,37,102,55,47
050,18,007,"Indiana","Benton County",4,38,106,54,52
050,18,007,"Indiana","Benton County",4,39,108,55,53
050,18,007,"Indiana","Benton County",4,40,122,62,60
050,18,007,"Indiana","Benton County",4,41,104,49,55
050,18,007,"Indiana","Benton County",4,42,113,62,51
050,18,007,"Indiana","Benton County",4,43,88,50,38
050,18,007,"Indiana","Benton County",4,44,99,58,41
050,18,007,"Indiana","Benton County",4,45,105,57,48
050,18,007,"Indiana","Benton County",4,46,106,52,54
050,18,007,"Indiana","Benton County",4,47,109,54,55
050,18,007,"Indiana","Benton County",4,48,95,50,45
050,18,007,"Indiana","Benton County",4,49,86,47,39
050,18,007,"Indiana","Benton County",4,50,93,46,47
050,18,007,"Indiana","Benton County",4,51,115,53,62
050,18,007,"Indiana","Benton County",4,52,109,53,56
050,18,007,"Indiana","Benton County",4,53,108,54,54
050,18,007,"Indiana","Benton County",4,54,110,58,52
050,18,007,"Indiana","Benton County",4,55,114,61,53
050,18,007,"Indiana","Benton County",4,56,122,54,68
050,18,007,"Indiana","Benton County",4,57,123,67,56
050,18,007,"Indiana","Benton County",4,58,119,61,58
050,18,007,"Indiana","Benton County",4,59,118,63,55
050,18,007,"Indiana","Benton County",4,60,119,58,61
050,18,007,"Indiana","Benton County",4,61,123,61,62
050,18,007,"Indiana","Benton County",4,62,123,57,66
050,18,007,"Indiana","Benton County",4,63,125,58,67
050,18,007,"Indiana","Benton County",4,64,128,66,62
050,18,007,"Indiana","Benton County",4,65,127,65,62
050,18,007,"Indiana","Benton County",4,66,108,54,54
050,18,007,"Indiana","Benton County",4,67,96,51,45
050,18,007,"Indiana","Benton County",4,68,87,50,37
050,18,007,"Indiana","Benton County",4,69,89,49,40
050,18,007,"Indiana","Benton County",4,70,85,45,40
050,18,007,"Indiana","Benton County",4,71,86,41,45
050,18,007,"Indiana","Benton County",4,72,80,39,41
050,18,007,"Indiana","Benton County",4,73,77,38,39
050,18,007,"Indiana","Benton County",4,74,73,35,38
050,18,007,"Indiana","Benton County",4,75,68,30,38
050,18,007,"Indiana","Benton County",4,76,49,20,29
050,18,007,"Indiana","Benton County",4,77,52,28,24
050,18,007,"Indiana","Benton County",4,78,62,26,36
050,18,007,"Indiana","Benton County",4,79,65,26,39
050,18,007,"Indiana","Benton County",4,80,46,19,27
050,18,007,"Indiana","Benton County",4,81,56,23,33
050,18,007,"Indiana","Benton County",4,82,44,16,28
050,18,007,"Indiana","Benton County",4,83,35,13,22
050,18,007,"Indiana","Benton County",4,84,26,14,12
050,18,007,"Indiana","Benton County",4,85,157,44,113
050,18,007,"Indiana","Benton County",5,0,90,48,42
050,18,007,"Indiana","Benton County",5,1,102,47,55
050,18,007,"Indiana","Benton County",5,2,95,50,45
050,18,007,"Indiana","Benton County",5,3,111,43,68
050,18,007,"Indiana","Benton County",5,4,100,55,45
050,18,007,"Indiana","Benton County",5,5,115,55,60
050,18,007,"Indiana","Benton County",5,6,116,56,60
050,18,007,"Indiana","Benton County",5,7,130,71,59
050,18,007,"Indiana","Benton County",5,8,121,67,54
050,18,007,"Indiana","Benton County",5,9,117,66,51
050,18,007,"Indiana","Benton County",5,10,119,76,43
050,18,007,"Indiana","Benton County",5,11,110,71,39
050,18,007,"Indiana","Benton County",5,12,111,67,44
050,18,007,"Indiana","Benton County",5,13,117,65,52
050,18,007,"Indiana","Benton County",5,14,136,76,60
050,18,007,"Indiana","Benton County",5,15,129,67,62
050,18,007,"Indiana","Benton County",5,16,134,68,66
050,18,007,"Indiana","Benton County",5,17,142,67,75
050,18,007,"Indiana","Benton County",5,18,112,54,58
050,18,007,"Indiana","Benton County",5,19,86,54,32
050,18,007,"Indiana","Benton County",5,20,106,58,48
050,18,007,"Indiana","Benton County",5,21,96,55,41
050,18,007,"Indiana","Benton County",5,22,100,57,43
050,18,007,"Indiana","Benton County",5,23,109,57,52
050,18,007,"Indiana","Benton County",5,24,95,47,48
050,18,007,"Indiana","Benton County",5,25,90,42,48
050,18,007,"Indiana","Benton County",5,26,101,50,51
050,18,007,"Indiana","Benton County",5,27,81,48,33
050,18,007,"Indiana","Benton County",5,28,113,60,53
050,18,007,"Indiana","Benton County",5,29,121,56,65
050,18,007,"Indiana","Benton County",5,30,115,59,56
050,18,007,"Indiana","Benton County",5,31,125,70,55
050,18,007,"Indiana","Benton County",5,32,119,60,59
050,18,007,"Indiana","Benton County",5,33,110,58,52
050,18,007,"Indiana","Benton County",5,34,100,54,46
050,18,007,"Indiana","Benton County",5,35,111,58,53
050,18,007,"Indiana","Benton County",5,36,94,49,45
050,18,007,"Indiana","Benton County",5,37,92,54,38
050,18,007,"Indiana","Benton County",5,38,103,55,48
050,18,007,"Indiana","Benton County",5,39,101,48,53
050,18,007,"Indiana","Benton County",5,40,117,60,57
050,18,007,"Indiana","Benton County",5,41,129,66,63
050,18,007,"Indiana","Benton County",5,42,108,52,56
050,18,007,"Indiana","Benton County",5,43,115,66,49
050,18,007,"Indiana","Benton County",5,44,86,50,36
050,18,007,"Indiana","Benton County",5,45,97,57,40
050,18,007,"Indiana","Benton County",5,46,100,56,44
050,18,007,"Indiana","Benton County",5,47,109,53,56
050,18,007,"Indiana","Benton County",5,48,115,56,59
050,18,007,"Indiana","Benton County",5,49,96,48,48
050,18,007,"Indiana","Benton County",5,50,86,47,39
050,18,007,"Indiana","Benton County",5,51,92,45,47
050,18,007,"Indiana","Benton County",5,52,111,51,60
050,18,007,"Indiana","Benton County",5,53,109,52,57
050,18,007,"Indiana","Benton County",5,54,107,54,53
050,18,007,"Indiana","Benton County",5,55,111,57,54
050,18,007,"Indiana","Benton County",5,56,108,56,52
050,18,007,"Indiana","Benton County",5,57,119,53,66
050,18,007,"Indiana","Benton County",5,58,116,65,51
050,18,007,"Indiana","Benton County",5,59,112,56,56
050,18,007,"Indiana","Benton County",5,60,114,59,55
050,18,007,"Indiana","Benton County",5,61,123,59,64
050,18,007,"Indiana","Benton County",5,62,120,59,61
050,18,007,"Indiana","Benton County",5,63,124,57,67
050,18,007,"Indiana","Benton County",5,64,124,58,66
050,18,007,"Indiana","Benton County",5,65,133,69,64
050,18,007,"Indiana","Benton County",5,66,121,61,60
050,18,007,"Indiana","Benton County",5,67,103,52,51
050,18,007,"Indiana","Benton County",5,68,95,52,43
050,18,007,"Indiana","Benton County",5,69,84,50,34
050,18,007,"Indiana","Benton County",5,70,88,49,39
050,18,007,"Indiana","Benton County",5,71,81,43,38
050,18,007,"Indiana","Benton County",5,72,80,40,40
050,18,007,"Indiana","Benton County",5,73,76,37,39
050,18,007,"Indiana","Benton County",5,74,70,34,36
050,18,007,"Indiana","Benton County",5,75,72,36,36
050,18,007,"Indiana","Benton County",5,76,69,31,38
050,18,007,"Indiana","Benton County",5,77,44,19,25
050,18,007,"Indiana","Benton County",5,78,47,26,21
050,18,007,"Indiana","Benton County",5,79,57,24,33
050,18,007,"Indiana","Benton County",5,80,61,25,36
050,18,007,"Indiana","Benton County",5,81,45,18,27
050,18,007,"Indiana","Benton County",5,82,51,19,32
050,18,007,"Indiana","Benton County",5,83,42,16,26
050,18,007,"Indiana","Benton County",5,84,32,12,20
050,18,007,"Indiana","Benton County",5,85,155,45,110
050,18,009,"Indiana","Blackford County",1,0,144,74,70
050,18,009,"Indiana","Blackford County",1,1,143,71,72
050,18,009,"Indiana","Blackford County",1,2,136,67,69
050,18,009,"Indiana","Blackford County",1,3,124,67,57
050,18,009,"Indiana","Blackford County",1,4,146,73,73
050,18,009,"Indiana","Blackford County",1,5,154,82,72
050,18,009,"Indiana","Blackford County",1,6,131,68,63
050,18,009,"Indiana","Blackford County",1,7,140,70,70
050,18,009,"Indiana","Blackford County",1,8,147,72,75
050,18,009,"Indiana","Blackford County",1,9,163,81,82
050,18,009,"Indiana","Blackford County",1,10,147,71,76
050,18,009,"Indiana","Blackford County",1,11,157,68,89
050,18,009,"Indiana","Blackford County",1,12,179,85,94
050,18,009,"Indiana","Blackford County",1,13,165,77,88
050,18,009,"Indiana","Blackford County",1,14,155,81,74
050,18,009,"Indiana","Blackford County",1,15,144,74,70
050,18,009,"Indiana","Blackford County",1,16,157,91,66
050,18,009,"Indiana","Blackford County",1,17,155,79,76
050,18,009,"Indiana","Blackford County",1,18,146,87,59
050,18,009,"Indiana","Blackford County",1,19,104,62,42
050,18,009,"Indiana","Blackford County",1,20,112,69,43
050,18,009,"Indiana","Blackford County",1,21,117,71,46
050,18,009,"Indiana","Blackford County",1,22,137,74,63
050,18,009,"Indiana","Blackford County",1,23,133,64,69
050,18,009,"Indiana","Blackford County",1,24,131,69,62
050,18,009,"Indiana","Blackford County",1,25,129,69,60
050,18,009,"Indiana","Blackford County",1,26,135,66,69
050,18,009,"Indiana","Blackford County",1,27,140,72,68
050,18,009,"Indiana","Blackford County",1,28,143,67,76
050,18,009,"Indiana","Blackford County",1,29,138,66,72
050,18,009,"Indiana","Blackford County",1,30,145,66,79
050,18,009,"Indiana","Blackford County",1,31,128,61,67
050,18,009,"Indiana","Blackford County",1,32,144,68,76
050,18,009,"Indiana","Blackford County",1,33,144,78,66
050,18,009,"Indiana","Blackford County",1,34,129,63,66
050,18,009,"Indiana","Blackford County",1,35,133,69,64
050,18,009,"Indiana","Blackford County",1,36,110,51,59
050,18,009,"Indiana","Blackford County",1,37,123,64,59
050,18,009,"Indiana","Blackford County",1,38,126,63,63
050,18,009,"Indiana","Blackford County",1,39,132,65,67
050,18,009,"Indiana","Blackford County",1,40,123,59,64
050,18,009,"Indiana","Blackford County",1,41,132,63,69
050,18,009,"Indiana","Blackford County",1,42,112,51,61
050,18,009,"Indiana","Blackford County",1,43,117,58,59
050,18,009,"Indiana","Blackford County",1,44,115,62,53
050,18,009,"Indiana","Blackford County",1,45,138,67,71
050,18,009,"Indiana","Blackford County",1,46,159,84,75
050,18,009,"Indiana","Blackford County",1,47,169,86,83
050,18,009,"Indiana","Blackford County",1,48,183,98,85
050,18,009,"Indiana","Blackford County",1,49,178,93,85
050,18,009,"Indiana","Blackford County",1,50,159,82,77
050,18,009,"Indiana","Blackford County",1,51,172,88,84
050,18,009,"Indiana","Blackford County",1,52,153,71,82
050,18,009,"Indiana","Blackford County",1,53,137,65,72
050,18,009,"Indiana","Blackford County",1,54,149,76,73
050,18,009,"Indiana","Blackford County",1,55,164,77,87
050,18,009,"Indiana","Blackford County",1,56,176,85,91
050,18,009,"Indiana","Blackford County",1,57,170,87,83
050,18,009,"Indiana","Blackford County",1,58,182,91,91
050,18,009,"Indiana","Blackford County",1,59,189,93,96
050,18,009,"Indiana","Blackford County",1,60,182,99,83
050,18,009,"Indiana","Blackford County",1,61,187,104,83
050,18,009,"Indiana","Blackford County",1,62,167,87,80
050,18,009,"Indiana","Blackford County",1,63,163,82,81
050,18,009,"Indiana","Blackford County",1,64,176,83,93
050,18,009,"Indiana","Blackford County",1,65,158,77,81
050,18,009,"Indiana","Blackford County",1,66,166,84,82
050,18,009,"Indiana","Blackford County",1,67,168,76,92
050,18,009,"Indiana","Blackford County",1,68,150,74,76
050,18,009,"Indiana","Blackford County",1,69,158,79,79
050,18,009,"Indiana","Blackford County",1,70,150,74,76
050,18,009,"Indiana","Blackford County",1,71,136,64,72
050,18,009,"Indiana","Blackford County",1,72,155,74,81
050,18,009,"Indiana","Blackford County",1,73,148,75,73
050,18,009,"Indiana","Blackford County",1,74,88,40,48
050,18,009,"Indiana","Blackford County",1,75,103,43,60
050,18,009,"Indiana","Blackford County",1,76,106,44,62
050,18,009,"Indiana","Blackford County",1,77,107,48,59
050,18,009,"Indiana","Blackford County",1,78,97,44,53
050,18,009,"Indiana","Blackford County",1,79,84,34,50
050,18,009,"Indiana","Blackford County",1,80,88,35,53
050,18,009,"Indiana","Blackford County",1,81,67,29,38
050,18,009,"Indiana","Blackford County",1,82,63,25,38
050,18,009,"Indiana","Blackford County",1,83,52,18,34
050,18,009,"Indiana","Blackford County",1,84,57,17,40
050,18,009,"Indiana","Blackford County",1,85,290,97,193
050,18,009,"Indiana","Blackford County",2,0,143,72,71
050,18,009,"Indiana","Blackford County",2,1,143,70,73
050,18,009,"Indiana","Blackford County",2,2,138,68,70
050,18,009,"Indiana","Blackford County",2,3,127,67,60
050,18,009,"Indiana","Blackford County",2,4,145,73,72
050,18,009,"Indiana","Blackford County",2,5,153,81,72
050,18,009,"Indiana","Blackford County",2,6,138,73,65
050,18,009,"Indiana","Blackford County",2,7,139,71,68
050,18,009,"Indiana","Blackford County",2,8,146,72,74
050,18,009,"Indiana","Blackford County",2,9,158,80,78
050,18,009,"Indiana","Blackford County",2,10,151,73,78
050,18,009,"Indiana","Blackford County",2,11,157,70,87
050,18,009,"Indiana","Blackford County",2,12,176,81,95
050,18,009,"Indiana","Blackford County",2,13,167,79,88
050,18,009,"Indiana","Blackford County",2,14,153,78,75
050,18,009,"Indiana","Blackford County",2,15,148,77,71
050,18,009,"Indiana","Blackford County",2,16,154,87,67
050,18,009,"Indiana","Blackford County",2,17,155,82,73
050,18,009,"Indiana","Blackford County",2,18,141,82,59
050,18,009,"Indiana","Blackford County",2,19,107,64,43
050,18,009,"Indiana","Blackford County",2,20,113,70,43
050,18,009,"Indiana","Blackford County",2,21,118,72,46
050,18,009,"Indiana","Blackford County",2,22,135,73,62
050,18,009,"Indiana","Blackford County",2,23,136,68,68
050,18,009,"Indiana","Blackford County",2,24,133,70,63
050,18,009,"Indiana","Blackford County",2,25,130,69,61
050,18,009,"Indiana","Blackford County",2,26,134,68,66
050,18,009,"Indiana","Blackford County",2,27,139,71,68
050,18,009,"Indiana","Blackford County",2,28,144,70,74
050,18,009,"Indiana","Blackford County",2,29,139,66,73
050,18,009,"Indiana","Blackford County",2,30,143,66,77
050,18,009,"Indiana","Blackford County",2,31,133,63,70
050,18,009,"Indiana","Blackford County",2,32,141,67,74
050,18,009,"Indiana","Blackford County",2,33,145,75,70
050,18,009,"Indiana","Blackford County",2,34,133,67,66
050,18,009,"Indiana","Blackford County",2,35,133,68,65
050,18,009,"Indiana","Blackford County",2,36,116,57,59
050,18,009,"Indiana","Blackford County",2,37,121,62,59
050,18,009,"Indiana","Blackford County",2,38,126,64,62
050,18,009,"Indiana","Blackford County",2,39,128,63,65
050,18,009,"Indiana","Blackford County",2,40,128,62,66
050,18,009,"Indiana","Blackford County",2,41,130,62,68
050,18,009,"Indiana","Blackford County",2,42,117,55,62
050,18,009,"Indiana","Blackford County",2,43,115,57,58
050,18,009,"Indiana","Blackford County",2,44,115,61,54
050,18,009,"Indiana","Blackford County",2,45,135,66,69
050,18,009,"Indiana","Blackford County",2,46,152,79,73
050,18,009,"Indiana","Blackford County",2,47,166,86,80
050,18,009,"Indiana","Blackford County",2,48,179,95,84
050,18,009,"Indiana","Blackford County",2,49,180,95,85
050,18,009,"Indiana","Blackford County",2,50,163,84,79
050,18,009,"Indiana","Blackford County",2,51,171,87,84
050,18,009,"Indiana","Blackford County",2,52,157,74,83
050,18,009,"Indiana","Blackford County",2,53,140,66,74
050,18,009,"Indiana","Blackford County",2,54,148,74,74
050,18,009,"Indiana","Blackford County",2,55,160,77,83
050,18,009,"Indiana","Blackford County",2,56,173,82,91
050,18,009,"Indiana","Blackford County",2,57,171,85,86
050,18,009,"Indiana","Blackford County",2,58,176,88,88
050,18,009,"Indiana","Blackford County",2,59,187,93,94
050,18,009,"Indiana","Blackford County",2,60,180,96,84
050,18,009,"Indiana","Blackford County",2,61,184,102,82
050,18,009,"Indiana","Blackford County",2,62,170,90,80
050,18,009,"Indiana","Blackford County",2,63,168,86,82
050,18,009,"Indiana","Blackford County",2,64,171,81,90
050,18,009,"Indiana","Blackford County",2,65,163,78,85
050,18,009,"Indiana","Blackford County",2,66,163,82,81
050,18,009,"Indiana","Blackford County",2,67,166,77,89
050,18,009,"Indiana","Blackford County",2,68,150,72,78
050,18,009,"Indiana","Blackford County",2,69,157,78,79
050,18,009,"Indiana","Blackford County",2,70,149,73,76
050,18,009,"Indiana","Blackford County",2,71,139,67,72
050,18,009,"Indiana","Blackford County",2,72,148,71,77
050,18,009,"Indiana","Blackford County",2,73,159,78,81
050,18,009,"Indiana","Blackford County",2,74,94,43,51
050,18,009,"Indiana","Blackford County",2,75,98,41,57
050,18,009,"Indiana","Blackford County",2,76,103,43,60
050,18,009,"Indiana","Blackford County",2,77,108,48,60
050,18,009,"Indiana","Blackford County",2,78,97,44,53
050,18,009,"Indiana","Blackford County",2,79,85,36,49
050,18,009,"Indiana","Blackford County",2,80,85,34,51
050,18,009,"Indiana","Blackford County",2,81,67,28,39
050,18,009,"Indiana","Blackford County",2,82,64,26,38
050,18,009,"Indiana","Blackford County",2,83,52,19,33
050,18,009,"Indiana","Blackford County",2,84,56,17,39
050,18,009,"Indiana","Blackford County",2,85,287,96,191
050,18,009,"Indiana","Blackford County",3,0,96,41,55
050,18,009,"Indiana","Blackford County",3,1,144,62,82
050,18,009,"Indiana","Blackford County",3,2,141,65,76
050,18,009,"Indiana","Blackford County",3,3,140,68,72
050,18,009,"Indiana","Blackford County",3,4,127,63,64
050,18,009,"Indiana","Blackford County",3,5,157,80,77
050,18,009,"Indiana","Blackford County",3,6,155,84,71
050,18,009,"Indiana","Blackford County",3,7,135,74,61
050,18,009,"Indiana","Blackford County",3,8,140,72,68
050,18,009,"Indiana","Blackford County",3,9,148,68,80
050,18,009,"Indiana","Blackford County",3,10,155,78,77
050,18,009,"Indiana","Blackford County",3,11,152,73,79
050,18,009,"Indiana","Blackford County",3,12,154,69,85
050,18,009,"Indiana","Blackford County",3,13,179,82,97
050,18,009,"Indiana","Blackford County",3,14,174,83,91
050,18,009,"Indiana","Blackford County",3,15,149,74,75
050,18,009,"Indiana","Blackford County",3,16,166,88,78
050,18,009,"Indiana","Blackford County",3,17,148,81,67
050,18,009,"Indiana","Blackford County",3,18,137,73,64
050,18,009,"Indiana","Blackford County",3,19,109,63,46
050,18,009,"Indiana","Blackford County",3,20,109,60,49
050,18,009,"Indiana","Blackford County",3,21,115,72,43
050,18,009,"Indiana","Blackford County",3,22,125,75,50
050,18,009,"Indiana","Blackford County",3,23,129,70,59
050,18,009,"Indiana","Blackford County",3,24,137,65,72
050,18,009,"Indiana","Blackford County",3,25,121,65,56
050,18,009,"Indiana","Blackford County",3,26,141,72,69
050,18,009,"Indiana","Blackford County",3,27,143,75,68
050,18,009,"Indiana","Blackford County",3,28,135,69,66
050,18,009,"Indiana","Blackford County",3,29,144,75,69
050,18,009,"Indiana","Blackford County",3,30,138,63,75
050,18,009,"Indiana","Blackford County",3,31,141,67,74
050,18,009,"Indiana","Blackford County",3,32,136,66,70
050,18,009,"Indiana","Blackford County",3,33,143,68,75
050,18,009,"Indiana","Blackford County",3,34,136,70,66
050,18,009,"Indiana","Blackford County",3,35,143,71,72
050,18,009,"Indiana","Blackford County",3,36,136,67,69
050,18,009,"Indiana","Blackford County",3,37,121,56,65
050,18,009,"Indiana","Blackford County",3,38,129,67,62
050,18,009,"Indiana","Blackford County",3,39,123,63,60
050,18,009,"Indiana","Blackford County",3,40,130,63,67
050,18,009,"Indiana","Blackford County",3,41,133,65,68
050,18,009,"Indiana","Blackford County",3,42,129,63,66
050,18,009,"Indiana","Blackford County",3,43,119,53,66
050,18,009,"Indiana","Blackford County",3,44,118,55,63
050,18,009,"Indiana","Blackford County",3,45,112,57,55
050,18,009,"Indiana","Blackford County",3,46,138,68,70
050,18,009,"Indiana","Blackford County",3,47,148,78,70
050,18,009,"Indiana","Blackford County",3,48,165,84,81
050,18,009,"Indiana","Blackford County",3,49,174,90,84
050,18,009,"Indiana","Blackford County",3,50,176,95,81
050,18,009,"Indiana","Blackford County",3,51,165,86,79
050,18,009,"Indiana","Blackford County",3,52,172,86,86
050,18,009,"Indiana","Blackford County",3,53,150,74,76
050,18,009,"Indiana","Blackford County",3,54,137,66,71
050,18,009,"Indiana","Blackford County",3,55,151,79,72
050,18,009,"Indiana","Blackford County",3,56,166,79,87
050,18,009,"Indiana","Blackford County",3,57,172,79,93
050,18,009,"Indiana","Blackford County",3,58,167,86,81
050,18,009,"Indiana","Blackford County",3,59,173,85,88
050,18,009,"Indiana","Blackford County",3,60,183,90,93
050,18,009,"Indiana","Blackford County",3,61,174,95,79
050,18,009,"Indiana","Blackford County",3,62,181,102,79
050,18,009,"Indiana","Blackford County",3,63,165,85,80
050,18,009,"Indiana","Blackford County",3,64,164,82,82
050,18,009,"Indiana","Blackford County",3,65,172,79,93
050,18,009,"Indiana","Blackford County",3,66,159,82,77
050,18,009,"Indiana","Blackford County",3,67,164,80,84
050,18,009,"Indiana","Blackford County",3,68,157,74,83
050,18,009,"Indiana","Blackford County",3,69,149,73,76
050,18,009,"Indiana","Blackford County",3,70,150,75,75
050,18,009,"Indiana","Blackford County",3,71,144,69,75
050,18,009,"Indiana","Blackford County",3,72,135,64,71
050,18,009,"Indiana","Blackford County",3,73,154,75,79
050,18,009,"Indiana","Blackford County",3,74,149,74,75
050,18,009,"Indiana","Blackford County",3,75,94,43,51
050,18,009,"Indiana","Blackford County",3,76,94,39,55
050,18,009,"Indiana","Blackford County",3,77,96,41,55
050,18,009,"Indiana","Blackford County",3,78,105,45,60
050,18,009,"Indiana","Blackford County",3,79,88,42,46
050,18,009,"Indiana","Blackford County",3,80,86,34,52
050,18,009,"Indiana","Blackford County",3,81,70,27,43
050,18,009,"Indiana","Blackford County",3,82,68,28,40
050,18,009,"Indiana","Blackford County",3,83,46,14,32
050,18,009,"Indiana","Blackford County",3,84,49,16,33
050,18,009,"Indiana","Blackford County",3,85,299,106,193
050,18,009,"Indiana","Blackford County",4,0,127,62,65
050,18,009,"Indiana","Blackford County",4,1,96,41,55
050,18,009,"Indiana","Blackford County",4,2,140,65,75
050,18,009,"Indiana","Blackford County",4,3,144,70,74
050,18,009,"Indiana","Blackford County",4,4,148,70,78
050,18,009,"Indiana","Blackford County",4,5,124,65,59
050,18,009,"Indiana","Blackford County",4,6,153,82,71
050,18,009,"Indiana","Blackford County",4,7,157,85,72
050,18,009,"Indiana","Blackford County",4,8,135,72,63
050,18,009,"Indiana","Blackford County",4,9,136,75,61
050,18,009,"Indiana","Blackford County",4,10,148,75,73
050,18,009,"Indiana","Blackford County",4,11,158,83,75
050,18,009,"Indiana","Blackford County",4,12,150,69,81
050,18,009,"Indiana","Blackford County",4,13,165,72,93
050,18,009,"Indiana","Blackford County",4,14,185,83,102
050,18,009,"Indiana","Blackford County",4,15,171,87,84
050,18,009,"Indiana","Blackford County",4,16,152,79,73
050,18,009,"Indiana","Blackford County",4,17,157,85,72
050,18,009,"Indiana","Blackford County",4,18,129,74,55
050,18,009,"Indiana","Blackford County",4,19,99,52,47
050,18,009,"Indiana","Blackford County",4,20,114,70,44
050,18,009,"Indiana","Blackford County",4,21,112,61,51
050,18,009,"Indiana","Blackford County",4,22,126,68,58
050,18,009,"Indiana","Blackford County",4,23,133,81,52
050,18,009,"Indiana","Blackford County",4,24,121,57,64
050,18,009,"Indiana","Blackford County",4,25,132,66,66
050,18,009,"Indiana","Blackford County",4,26,119,65,54
050,18,009,"Indiana","Blackford County",4,27,141,74,67
050,18,009,"Indiana","Blackford County",4,28,143,79,64
050,18,009,"Indiana","Blackford County",4,29,128,66,62
050,18,009,"Indiana","Blackford County",4,30,135,68,67
050,18,009,"Indiana","Blackford County",4,31,144,65,79
050,18,009,"Indiana","Blackford County",4,32,141,73,68
050,18,009,"Indiana","Blackford County",4,33,134,65,69
050,18,009,"Indiana","Blackford County",4,34,139,69,70
050,18,009,"Indiana","Blackford County",4,35,135,67,68
050,18,009,"Indiana","Blackford County",4,36,148,70,78
050,18,009,"Indiana","Blackford County",4,37,137,68,69
050,18,009,"Indiana","Blackford County",4,38,112,52,60
050,18,009,"Indiana","Blackford County",4,39,132,70,62
050,18,009,"Indiana","Blackford County",4,40,126,64,62
050,18,009,"Indiana","Blackford County",4,41,123,55,68
050,18,009,"Indiana","Blackford County",4,42,132,66,66
050,18,009,"Indiana","Blackford County",4,43,128,63,65
050,18,009,"Indiana","Blackford County",4,44,118,52,66
050,18,009,"Indiana","Blackford County",4,45,121,58,63
050,18,009,"Indiana","Blackford County",4,46,113,58,55
050,18,009,"Indiana","Blackford County",4,47,148,72,76
050,18,009,"Indiana","Blackford County",4,48,143,73,70
050,18,009,"Indiana","Blackford County",4,49,161,84,77
050,18,009,"Indiana","Blackford County",4,50,168,87,81
050,18,009,"Indiana","Blackford County",4,51,176,95,81
050,18,009,"Indiana","Blackford County",4,52,161,84,77
050,18,009,"Indiana","Blackford County",4,53,169,80,89
050,18,009,"Indiana","Blackford County",4,54,156,72,84
050,18,009,"Indiana","Blackford County",4,55,134,62,72
050,18,009,"Indiana","Blackford County",4,56,151,76,75
050,18,009,"Indiana","Blackford County",4,57,166,76,90
050,18,009,"Indiana","Blackford County",4,58,171,78,93
050,18,009,"Indiana","Blackford County",4,59,165,88,77
050,18,009,"Indiana","Blackford County",4,60,172,83,89
050,18,009,"Indiana","Blackford County",4,61,183,89,94
050,18,009,"Indiana","Blackford County",4,62,164,84,80
050,18,009,"Indiana","Blackford County",4,63,177,98,79
050,18,009,"Indiana","Blackford County",4,64,165,83,82
050,18,009,"Indiana","Blackford County",4,65,162,77,85
050,18,009,"Indiana","Blackford County",4,66,164,79,85
050,18,009,"Indiana","Blackford County",4,67,154,74,80
050,18,009,"Indiana","Blackford County",4,68,162,79,83
050,18,009,"Indiana","Blackford County",4,69,149,71,78
050,18,009,"Indiana","Blackford County",4,70,140,71,69
050,18,009,"Indiana","Blackford County",4,71,146,71,75
050,18,009,"Indiana","Blackford County",4,72,137,65,72
050,18,009,"Indiana","Blackford County",4,73,138,67,71
050,18,009,"Indiana","Blackford County",4,74,139,68,71
050,18,009,"Indiana","Blackford County",4,75,147,73,74
050,18,009,"Indiana","Blackford County",4,76,88,41,47
050,18,009,"Indiana","Blackford County",4,77,89,36,53
050,18,009,"Indiana","Blackford County",4,78,99,40,59
050,18,009,"Indiana","Blackford County",4,79,90,40,50
050,18,009,"Indiana","Blackford County",4,80,87,37,50
050,18,009,"Indiana","Blackford County",4,81,72,27,45
050,18,009,"Indiana","Blackford County",4,82,64,22,42
050,18,009,"Indiana","Blackford County",4,83,60,25,35
050,18,009,"Indiana","Blackford County",4,84,44,13,31
050,18,009,"Indiana","Blackford County",4,85,297,107,190
050,18,009,"Indiana","Blackford County",5,0,130,63,67
050,18,009,"Indiana","Blackford County",5,1,114,52,62
050,18,009,"Indiana","Blackford County",5,2,102,45,57
050,18,009,"Indiana","Blackford County",5,3,149,72,77
050,18,009,"Indiana","Blackford County",5,4,135,66,69
050,18,009,"Indiana","Blackford County",5,5,149,71,78
050,18,009,"Indiana","Blackford County",5,6,114,60,54
050,18,009,"Indiana","Blackford County",5,7,158,86,72
050,18,009,"Indiana","Blackford County",5,8,172,92,80
050,18,009,"Indiana","Blackford County",5,9,129,69,60
050,18,009,"Indiana","Blackford County",5,10,143,79,64
050,18,009,"Indiana","Blackford County",5,11,148,72,76
050,18,009,"Indiana","Blackford County",5,12,155,84,71
050,18,009,"Indiana","Blackford County",5,13,158,73,85
050,18,009,"Indiana","Blackford County",5,14,167,68,99
050,18,009,"Indiana","Blackford County",5,15,190,88,102
050,18,009,"Indiana","Blackford County",5,16,186,92,94
050,18,009,"Indiana","Blackford County",5,17,154,75,79
050,18,009,"Indiana","Blackford County",5,18,138,72,66
050,18,009,"Indiana","Blackford County",5,19,103,56,47
050,18,009,"Indiana","Blackford County",5,20,100,53,47
050,18,009,"Indiana","Blackford County",5,21,120,72,48
050,18,009,"Indiana","Blackford County",5,22,114,65,49
050,18,009,"Indiana","Blackford County",5,23,126,66,60
050,18,009,"Indiana","Blackford County",5,24,126,76,50
050,18,009,"Indiana","Blackford County",5,25,127,62,65
050,18,009,"Indiana","Blackford County",5,26,131,67,64
050,18,009,"Indiana","Blackford County",5,27,110,60,50
050,18,009,"Indiana","Blackford County",5,28,144,78,66
050,18,009,"Indiana","Blackford County",5,29,138,75,63
050,18,009,"Indiana","Blackford County",5,30,130,65,65
050,18,009,"Indiana","Blackford County",5,31,144,71,73
050,18,009,"Indiana","Blackford County",5,32,160,81,79
050,18,009,"Indiana","Blackford County",5,33,130,64,66
050,18,009,"Indiana","Blackford County",5,34,136,63,73
050,18,009,"Indiana","Blackford County",5,35,134,66,68
050,18,009,"Indiana","Blackford County",5,36,147,76,71
050,18,009,"Indiana","Blackford County",5,37,152,77,75
050,18,009,"Indiana","Blackford County",5,38,135,66,69
050,18,009,"Indiana","Blackford County",5,39,116,51,65
050,18,009,"Indiana","Blackford County",5,40,134,69,65
050,18,009,"Indiana","Blackford County",5,41,123,62,61
050,18,009,"Indiana","Blackford County",5,42,127,55,72
050,18,009,"Indiana","Blackford County",5,43,134,67,67
050,18,009,"Indiana","Blackford County",5,44,132,66,66
050,18,009,"Indiana","Blackford County",5,45,121,50,71
050,18,009,"Indiana","Blackford County",5,46,121,59,62
050,18,009,"Indiana","Blackford County",5,47,109,57,52
050,18,009,"Indiana","Blackford County",5,48,138,68,70
050,18,009,"Indiana","Blackford County",5,49,145,74,71
050,18,009,"Indiana","Blackford County",5,50,156,82,74
050,18,009,"Indiana","Blackford County",5,51,165,82,83
050,18,009,"Indiana","Blackford County",5,52,182,99,83
050,18,009,"Indiana","Blackford County",5,53,165,86,79
050,18,009,"Indiana","Blackford County",5,54,168,78,90
050,18,009,"Indiana","Blackford County",5,55,148,71,77
050,18,009,"Indiana","Blackford County",5,56,140,64,76
050,18,009,"Indiana","Blackford County",5,57,150,75,75
050,18,009,"Indiana","Blackford County",5,58,165,75,90
050,18,009,"Indiana","Blackford County",5,59,173,78,95
050,18,009,"Indiana","Blackford County",5,60,159,85,74
050,18,009,"Indiana","Blackford County",5,61,169,83,86
050,18,009,"Indiana","Blackford County",5,62,178,83,95
050,18,009,"Indiana","Blackford County",5,63,164,87,77
050,18,009,"Indiana","Blackford County",5,64,175,96,79
050,18,009,"Indiana","Blackford County",5,65,162,79,83
050,18,009,"Indiana","Blackford County",5,66,159,82,77
050,18,009,"Indiana","Blackford County",5,67,155,69,86
050,18,009,"Indiana","Blackford County",5,68,146,69,77
050,18,009,"Indiana","Blackford County",5,69,159,78,81
050,18,009,"Indiana","Blackford County",5,70,142,70,72
050,18,009,"Indiana","Blackford County",5,71,134,67,67
050,18,009,"Indiana","Blackford County",5,72,142,69,73
050,18,009,"Indiana","Blackford County",5,73,141,70,71
050,18,009,"Indiana","Blackford County",5,74,121,60,61
050,18,009,"Indiana","Blackford County",5,75,141,70,71
050,18,009,"Indiana","Blackford County",5,76,143,72,71
050,18,009,"Indiana","Blackford County",5,77,79,37,42
050,18,009,"Indiana","Blackford County",5,78,93,36,57
050,18,009,"Indiana","Blackford County",5,79,87,37,50
050,18,009,"Indiana","Blackford County",5,80,88,35,53
050,18,009,"Indiana","Blackford County",5,81,71,30,41
050,18,009,"Indiana","Blackford County",5,82,68,22,46
050,18,009,"Indiana","Blackford County",5,83,54,17,37
050,18,009,"Indiana","Blackford County",5,84,60,24,36
050,18,009,"Indiana","Blackford County",5,85,293,108,185
050,18,011,"Indiana","Boone County",1,0,780,402,378
050,18,011,"Indiana","Boone County",1,1,846,432,414
050,18,011,"Indiana","Boone County",1,2,896,485,411
050,18,011,"Indiana","Boone County",1,3,955,501,454
050,18,011,"Indiana","Boone County",1,4,1022,553,469
050,18,011,"Indiana","Boone County",1,5,998,538,460
050,18,011,"Indiana","Boone County",1,6,1063,561,502
050,18,011,"Indiana","Boone County",1,7,1055,552,503
050,18,011,"Indiana","Boone County",1,8,1055,542,513
050,18,011,"Indiana","Boone County",1,9,1046,532,514
050,18,011,"Indiana","Boone County",1,10,1072,545,527
050,18,011,"Indiana","Boone County",1,11,1112,557,555
050,18,011,"Indiana","Boone County",1,12,1141,591,550
050,18,011,"Indiana","Boone County",1,13,1111,573,538
050,18,011,"Indiana","Boone County",1,14,1136,598,538
050,18,011,"Indiana","Boone County",1,15,1070,575,495
050,18,011,"Indiana","Boone County",1,16,1081,557,524
050,18,011,"Indiana","Boone County",1,17,1070,555,515
050,18,011,"Indiana","Boone County",1,18,859,456,403
050,18,011,"Indiana","Boone County",1,19,685,365,320
050,18,011,"Indiana","Boone County",1,20,733,393,340
050,18,011,"Indiana","Boone County",1,21,753,402,351
050,18,011,"Indiana","Boone County",1,22,775,394,381
050,18,011,"Indiana","Boone County",1,23,765,381,384
050,18,011,"Indiana","Boone County",1,24,781,377,404
050,18,011,"Indiana","Boone County",1,25,763,361,402
050,18,011,"Indiana","Boone County",1,26,771,379,392
050,18,011,"Indiana","Boone County",1,27,811,432,379
050,18,011,"Indiana","Boone County",1,28,814,426,388
050,18,011,"Indiana","Boone County",1,29,823,422,401
050,18,011,"Indiana","Boone County",1,30,859,428,431
050,18,011,"Indiana","Boone County",1,31,900,482,418
050,18,011,"Indiana","Boone County",1,32,886,447,439
050,18,011,"Indiana","Boone County",1,33,856,437,419
050,18,011,"Indiana","Boone County",1,34,931,455,476
050,18,011,"Indiana","Boone County",1,35,979,473,506
050,18,011,"Indiana","Boone County",1,36,1038,501,537
050,18,011,"Indiana","Boone County",1,37,1031,494,537
050,18,011,"Indiana","Boone County",1,38,1010,510,500
050,18,011,"Indiana","Boone County",1,39,1065,539,526
050,18,011,"Indiana","Boone County",1,40,1052,526,526
050,18,011,"Indiana","Boone County",1,41,1006,499,507
050,18,011,"Indiana","Boone County",1,42,1002,509,493
050,18,011,"Indiana","Boone County",1,43,1009,502,507
050,18,011,"Indiana","Boone County",1,44,953,489,464
050,18,011,"Indiana","Boone County",1,45,917,450,467
050,18,011,"Indiana","Boone County",1,46,979,479,500
050,18,011,"Indiana","Boone County",1,47,953,476,477
050,18,011,"Indiana","Boone County",1,48,992,522,470
050,18,011,"Indiana","Boone County",1,49,1019,503,516
050,18,011,"Indiana","Boone County",1,50,1007,487,520
050,18,011,"Indiana","Boone County",1,51,899,451,448
050,18,011,"Indiana","Boone County",1,52,879,456,423
050,18,011,"Indiana","Boone County",1,53,936,492,444
050,18,011,"Indiana","Boone County",1,54,950,491,459
050,18,011,"Indiana","Boone County",1,55,922,460,462
050,18,011,"Indiana","Boone County",1,56,930,441,489
050,18,011,"Indiana","Boone County",1,57,983,480,503
050,18,011,"Indiana","Boone County",1,58,985,503,482
050,18,011,"Indiana","Boone County",1,59,963,483,480
050,18,011,"Indiana","Boone County",1,60,877,413,464
050,18,011,"Indiana","Boone County",1,61,850,407,443
050,18,011,"Indiana","Boone County",1,62,841,440,401
050,18,011,"Indiana","Boone County",1,63,871,442,429
050,18,011,"Indiana","Boone County",1,64,848,429,419
050,18,011,"Indiana","Boone County",1,65,776,388,388
050,18,011,"Indiana","Boone County",1,66,672,330,342
050,18,011,"Indiana","Boone County",1,67,638,314,324
050,18,011,"Indiana","Boone County",1,68,634,302,332
050,18,011,"Indiana","Boone County",1,69,594,276,318
050,18,011,"Indiana","Boone County",1,70,536,256,280
050,18,011,"Indiana","Boone County",1,71,562,278,284
050,18,011,"Indiana","Boone County",1,72,557,268,289
050,18,011,"Indiana","Boone County",1,73,551,256,295
050,18,011,"Indiana","Boone County",1,74,378,164,214
050,18,011,"Indiana","Boone County",1,75,376,187,189
050,18,011,"Indiana","Boone County",1,76,399,185,214
050,18,011,"Indiana","Boone County",1,77,378,176,202
050,18,011,"Indiana","Boone County",1,78,321,140,181
050,18,011,"Indiana","Boone County",1,79,271,112,159
050,18,011,"Indiana","Boone County",1,80,239,95,144
050,18,011,"Indiana","Boone County",1,81,229,91,138
050,18,011,"Indiana","Boone County",1,82,224,85,139
050,18,011,"Indiana","Boone County",1,83,203,90,113
050,18,011,"Indiana","Boone County",1,84,198,71,127
050,18,011,"Indiana","Boone County",1,85,1053,359,694
050,18,011,"Indiana","Boone County",2,0,790,404,386
050,18,011,"Indiana","Boone County",2,1,845,431,414
050,18,011,"Indiana","Boone County",2,2,896,478,418
050,18,011,"Indiana","Boone County",2,3,949,504,445
050,18,011,"Indiana","Boone County",2,4,1015,546,469
050,18,011,"Indiana","Boone County",2,5,1015,549,466
050,18,011,"Indiana","Boone County",2,6,1058,562,496
050,18,011,"Indiana","Boone County",2,7,1070,561,509
050,18,011,"Indiana","Boone County",2,8,1058,547,511
050,18,011,"Indiana","Boone County",2,9,1053,538,515
050,18,011,"Indiana","Boone County",2,10,1069,544,525
050,18,011,"Indiana","Boone County",2,11,1098,551,547
050,18,011,"Indiana","Boone County",2,12,1141,585,556
050,18,011,"Indiana","Boone County",2,13,1121,580,541
050,18,011,"Indiana","Boone County",2,14,1136,595,541
050,18,011,"Indiana","Boone County",2,15,1088,581,507
050,18,011,"Indiana","Boone County",2,16,1079,561,518
050,18,011,"Indiana","Boone County",2,17,1074,557,517
050,18,011,"Indiana","Boone County",2,18,866,462,404
050,18,011,"Indiana","Boone County",2,19,690,367,323
050,18,011,"Indiana","Boone County",2,20,744,400,344
050,18,011,"Indiana","Boone County",2,21,752,401,351
050,18,011,"Indiana","Boone County",2,22,773,396,377
050,18,011,"Indiana","Boone County",2,23,773,385,388
050,18,011,"Indiana","Boone County",2,24,773,375,398
050,18,011,"Indiana","Boone County",2,25,763,366,397
050,18,011,"Indiana","Boone County",2,26,777,384,393
050,18,011,"Indiana","Boone County",2,27,803,419,384
050,18,011,"Indiana","Boone County",2,28,828,435,393
050,18,011,"Indiana","Boone County",2,29,829,422,407
050,18,011,"Indiana","Boone County",2,30,870,438,432
050,18,011,"Indiana","Boone County",2,31,902,473,429
050,18,011,"Indiana","Boone County",2,32,901,462,439
050,18,011,"Indiana","Boone County",2,33,879,447,432
050,18,011,"Indiana","Boone County",2,34,927,458,469
050,18,011,"Indiana","Boone County",2,35,985,478,507
050,18,011,"Indiana","Boone County",2,36,1033,500,533
050,18,011,"Indiana","Boone County",2,37,1050,504,546
050,18,011,"Indiana","Boone County",2,38,1033,516,517
050,18,011,"Indiana","Boone County",2,39,1062,538,524
050,18,011,"Indiana","Boone County",2,40,1071,537,534
050,18,011,"Indiana","Boone County",2,41,1018,508,510
050,18,011,"Indiana","Boone County",2,42,1009,509,500
050,18,011,"Indiana","Boone County",2,43,1015,510,505
050,18,011,"Indiana","Boone County",2,44,960,491,469
050,18,011,"Indiana","Boone County",2,45,935,465,470
050,18,011,"Indiana","Boone County",2,46,963,471,492
050,18,011,"Indiana","Boone County",2,47,956,475,481
050,18,011,"Indiana","Boone County",2,48,982,510,472
050,18,011,"Indiana","Boone County",2,49,1024,512,512
050,18,011,"Indiana","Boone County",2,50,1005,488,517
050,18,011,"Indiana","Boone County",2,51,921,457,464
050,18,011,"Indiana","Boone County",2,52,879,453,426
050,18,011,"Indiana","Boone County",2,53,923,483,440
050,18,011,"Indiana","Boone County",2,54,942,490,452
050,18,011,"Indiana","Boone County",2,55,920,465,455
050,18,011,"Indiana","Boone County",2,56,929,448,481
050,18,011,"Indiana","Boone County",2,57,968,470,498
050,18,011,"Indiana","Boone County",2,58,984,497,487
050,18,011,"Indiana","Boone County",2,59,973,489,484
050,18,011,"Indiana","Boone County",2,60,895,428,467
050,18,011,"Indiana","Boone County",2,61,852,407,445
050,18,011,"Indiana","Boone County",2,62,840,431,409
050,18,011,"Indiana","Boone County",2,63,871,442,429
050,18,011,"Indiana","Boone County",2,64,852,431,421
050,18,011,"Indiana","Boone County",2,65,787,394,393
050,18,011,"Indiana","Boone County",2,66,701,348,353
050,18,011,"Indiana","Boone County",2,67,644,315,329
050,18,011,"Indiana","Boone County",2,68,625,302,323
050,18,011,"Indiana","Boone County",2,69,608,284,324
050,18,011,"Indiana","Boone County",2,70,550,261,289
050,18,011,"Indiana","Boone County",2,71,558,273,285
050,18,011,"Indiana","Boone County",2,72,546,264,282
050,18,011,"Indiana","Boone County",2,73,575,270,305
050,18,011,"Indiana","Boone County",2,74,392,173,219
050,18,011,"Indiana","Boone County",2,75,375,181,194
050,18,011,"Indiana","Boone County",2,76,389,182,207
050,18,011,"Indiana","Boone County",2,77,384,178,206
050,18,011,"Indiana","Boone County",2,78,327,144,183
050,18,011,"Indiana","Boone County",2,79,277,116,161
050,18,011,"Indiana","Boone County",2,80,247,98,149
050,18,011,"Indiana","Boone County",2,81,225,90,135
050,18,011,"Indiana","Boone County",2,82,222,86,136
050,18,011,"Indiana","Boone County",2,83,207,89,118
050,18,011,"Indiana","Boone County",2,84,192,71,121
050,18,011,"Indiana","Boone County",2,85,1051,353,698
050,18,011,"Indiana","Boone County",3,0,773,409,364
050,18,011,"Indiana","Boone County",3,1,876,461,415
050,18,011,"Indiana","Boone County",3,2,927,472,455
050,18,011,"Indiana","Boone County",3,3,950,507,443
050,18,011,"Indiana","Boone County",3,4,979,516,463
050,18,011,"Indiana","Boone County",3,5,1070,568,502
050,18,011,"Indiana","Boone County",3,6,1043,564,479
050,18,011,"Indiana","Boone County",3,7,1100,591,509
050,18,011,"Indiana","Boone County",3,8,1075,572,503
050,18,011,"Indiana","Boone County",3,9,1089,567,522
050,18,011,"Indiana","Boone County",3,10,1064,535,529
050,18,011,"Indiana","Boone County",3,11,1075,541,534
050,18,011,"Indiana","Boone County",3,12,1124,559,565
050,18,011,"Indiana","Boone County",3,13,1176,603,573
050,18,011,"Indiana","Boone County",3,14,1134,589,545
050,18,011,"Indiana","Boone County",3,15,1140,590,550
050,18,011,"Indiana","Boone County",3,16,1088,577,511
050,18,011,"Indiana","Boone County",3,17,1104,573,531
050,18,011,"Indiana","Boone County",3,18,910,491,419
050,18,011,"Indiana","Boone County",3,19,694,370,324
050,18,011,"Indiana","Boone County",3,20,752,400,352
050,18,011,"Indiana","Boone County",3,21,781,405,376
050,18,011,"Indiana","Boone County",3,22,793,404,389
050,18,011,"Indiana","Boone County",3,23,841,426,415
050,18,011,"Indiana","Boone County",3,24,855,417,438
050,18,011,"Indiana","Boone County",3,25,822,401,421
050,18,011,"Indiana","Boone County",3,26,770,390,380
050,18,011,"Indiana","Boone County",3,27,792,375,417
050,18,011,"Indiana","Boone County",3,28,859,422,437
050,18,011,"Indiana","Boone County",3,29,861,455,406
050,18,011,"Indiana","Boone County",3,30,913,470,443
050,18,011,"Indiana","Boone County",3,31,945,472,473
050,18,011,"Indiana","Boone County",3,32,975,499,476
050,18,011,"Indiana","Boone County",3,33,968,492,476
050,18,011,"Indiana","Boone County",3,34,954,494,460
050,18,011,"Indiana","Boone County",3,35,981,487,494
050,18,011,"Indiana","Boone County",3,36,1027,499,528
050,18,011,"Indiana","Boone County",3,37,1064,512,552
050,18,011,"Indiana","Boone County",3,38,1079,522,557
050,18,011,"Indiana","Boone County",3,39,1068,531,537
050,18,011,"Indiana","Boone County",3,40,1072,555,517
050,18,011,"Indiana","Boone County",3,41,1090,541,549
050,18,011,"Indiana","Boone County",3,42,1040,534,506
050,18,011,"Indiana","Boone County",3,43,1015,502,513
050,18,011,"Indiana","Boone County",3,44,1041,524,517
050,18,011,"Indiana","Boone County",3,45,961,498,463
050,18,011,"Indiana","Boone County",3,46,957,485,472
050,18,011,"Indiana","Boone County",3,47,975,484,491
050,18,011,"Indiana","Boone County",3,48,970,472,498
050,18,011,"Indiana","Boone County",3,49,998,513,485
050,18,011,"Indiana","Boone County",3,50,1031,515,516
050,18,011,"Indiana","Boone County",3,51,1002,491,511
050,18,011,"Indiana","Boone County",3,52,941,474,467
050,18,011,"Indiana","Boone County",3,53,873,456,417
050,18,011,"Indiana","Boone County",3,54,924,477,447
050,18,011,"Indiana","Boone County",3,55,958,503,455
050,18,011,"Indiana","Boone County",3,56,927,465,462
050,18,011,"Indiana","Boone County",3,57,909,432,477
050,18,011,"Indiana","Boone County",3,58,966,471,495
050,18,011,"Indiana","Boone County",3,59,995,494,501
050,18,011,"Indiana","Boone County",3,60,972,487,485
050,18,011,"Indiana","Boone County",3,61,903,434,469
050,18,011,"Indiana","Boone County",3,62,876,430,446
050,18,011,"Indiana","Boone County",3,63,841,427,414
050,18,011,"Indiana","Boone County",3,64,871,441,430
050,18,011,"Indiana","Boone County",3,65,842,416,426
050,18,011,"Indiana","Boone County",3,66,787,391,396
050,18,011,"Indiana","Boone County",3,67,696,334,362
050,18,011,"Indiana","Boone County",3,68,631,312,319
050,18,011,"Indiana","Boone County",3,69,620,296,324
050,18,011,"Indiana","Boone County",3,70,604,285,319
050,18,011,"Indiana","Boone County",3,71,553,261,292
050,18,011,"Indiana","Boone County",3,72,561,271,290
050,18,011,"Indiana","Boone County",3,73,545,258,287
050,18,011,"Indiana","Boone County",3,74,555,254,301
050,18,011,"Indiana","Boone County",3,75,387,170,217
050,18,011,"Indiana","Boone County",3,76,363,171,192
050,18,011,"Indiana","Boone County",3,77,369,171,198
050,18,011,"Indiana","Boone County",3,78,390,188,202
050,18,011,"Indiana","Boone County",3,79,317,142,175
050,18,011,"Indiana","Boone County",3,80,279,113,166
050,18,011,"Indiana","Boone County",3,81,225,90,135
050,18,011,"Indiana","Boone County",3,82,220,89,131
050,18,011,"Indiana","Boone County",3,83,219,82,137
050,18,011,"Indiana","Boone County",3,84,206,87,119
050,18,011,"Indiana","Boone County",3,85,1112,378,734
050,18,011,"Indiana","Boone County",4,0,876,453,423
050,18,011,"Indiana","Boone County",4,1,820,439,381
050,18,011,"Indiana","Boone County",4,2,920,488,432
050,18,011,"Indiana","Boone County",4,3,953,482,471
050,18,011,"Indiana","Boone County",4,4,996,520,476
050,18,011,"Indiana","Boone County",4,5,1031,531,500
050,18,011,"Indiana","Boone County",4,6,1099,581,518
050,18,011,"Indiana","Boone County",4,7,1060,573,487
050,18,011,"Indiana","Boone County",4,8,1142,596,546
050,18,011,"Indiana","Boone County",4,9,1104,583,521
050,18,011,"Indiana","Boone County",4,10,1133,593,540
050,18,011,"Indiana","Boone County",4,11,1059,528,531
050,18,011,"Indiana","Boone County",4,12,1096,544,552
050,18,011,"Indiana","Boone County",4,13,1137,567,570
050,18,011,"Indiana","Boone County",4,14,1177,603,574
050,18,011,"Indiana","Boone County",4,15,1133,605,528
050,18,011,"Indiana","Boone County",4,16,1130,580,550
050,18,011,"Indiana","Boone County",4,17,1106,588,518
050,18,011,"Indiana","Boone County",4,18,926,499,427
050,18,011,"Indiana","Boone County",4,19,672,371,301
050,18,011,"Indiana","Boone County",4,20,728,390,338
050,18,011,"Indiana","Boone County",4,21,794,416,378
050,18,011,"Indiana","Boone County",4,22,806,414,392
050,18,011,"Indiana","Boone County",4,23,833,412,421
050,18,011,"Indiana","Boone County",4,24,853,432,421
050,18,011,"Indiana","Boone County",4,25,856,428,428
050,18,011,"Indiana","Boone County",4,26,790,393,397
050,18,011,"Indiana","Boone County",4,27,778,403,375
050,18,011,"Indiana","Boone County",4,28,805,397,408
050,18,011,"Indiana","Boone County",4,29,818,389,429
050,18,011,"Indiana","Boone County",4,30,872,463,409
050,18,011,"Indiana","Boone County",4,31,934,490,444
050,18,011,"Indiana","Boone County",4,32,1002,498,504
050,18,011,"Indiana","Boone County",4,33,989,496,493
050,18,011,"Indiana","Boone County",4,34,999,500,499
050,18,011,"Indiana","Boone County",4,35,968,494,474
050,18,011,"Indiana","Boone County",4,36,1063,528,535
050,18,011,"Indiana","Boone County",4,37,1082,532,550
050,18,011,"Indiana","Boone County",4,38,1101,534,567
050,18,011,"Indiana","Boone County",4,39,1108,547,561
050,18,011,"Indiana","Boone County",4,40,1072,525,547
050,18,011,"Indiana","Boone County",4,41,1104,571,533
050,18,011,"Indiana","Boone County",4,42,1141,575,566
050,18,011,"Indiana","Boone County",4,43,1036,539,497
050,18,011,"Indiana","Boone County",4,44,1023,502,521
050,18,011,"Indiana","Boone County",4,45,1021,508,513
050,18,011,"Indiana","Boone County",4,46,970,502,468
050,18,011,"Indiana","Boone County",4,47,955,490,465
050,18,011,"Indiana","Boone County",4,48,995,489,506
050,18,011,"Indiana","Boone County",4,49,990,482,508
050,18,011,"Indiana","Boone County",4,50,1001,516,485
050,18,011,"Indiana","Boone County",4,51,1048,531,517
050,18,011,"Indiana","Boone County",4,52,1009,499,510
050,18,011,"Indiana","Boone County",4,53,926,460,466
050,18,011,"Indiana","Boone County",4,54,868,449,419
050,18,011,"Indiana","Boone County",4,55,918,473,445
050,18,011,"Indiana","Boone County",4,56,968,509,459
050,18,011,"Indiana","Boone County",4,57,917,462,455
050,18,011,"Indiana","Boone County",4,58,948,452,496
050,18,011,"Indiana","Boone County",4,59,963,463,500
050,18,011,"Indiana","Boone County",4,60,975,486,489
050,18,011,"Indiana","Boone County",4,61,966,485,481
050,18,011,"Indiana","Boone County",4,62,918,452,466
050,18,011,"Indiana","Boone County",4,63,878,427,451
050,18,011,"Indiana","Boone County",4,64,842,419,423
050,18,011,"Indiana","Boone County",4,65,870,432,438
050,18,011,"Indiana","Boone County",4,66,808,398,410
050,18,011,"Indiana","Boone County",4,67,775,377,398
050,18,011,"Indiana","Boone County",4,68,677,329,348
050,18,011,"Indiana","Boone County",4,69,634,307,327
050,18,011,"Indiana","Boone County",4,70,619,298,321
050,18,011,"Indiana","Boone County",4,71,602,289,313
050,18,011,"Indiana","Boone County",4,72,557,258,299
050,18,011,"Indiana","Boone County",4,73,552,264,288
050,18,011,"Indiana","Boone County",4,74,539,239,300
050,18,011,"Indiana","Boone County",4,75,550,249,301
050,18,011,"Indiana","Boone County",4,76,384,167,217
050,18,011,"Indiana","Boone County",4,77,358,167,191
050,18,011,"Indiana","Boone County",4,78,373,174,199
050,18,011,"Indiana","Boone County",4,79,381,186,195
050,18,011,"Indiana","Boone County",4,80,315,138,177
050,18,011,"Indiana","Boone County",4,81,271,111,160
050,18,011,"Indiana","Boone County",4,82,217,89,128
050,18,011,"Indiana","Boone County",4,83,218,82,136
050,18,011,"Indiana","Boone County",4,84,219,84,135
050,18,011,"Indiana","Boone County",4,85,1189,409,780
050,18,011,"Indiana","Boone County",5,0,877,454,423
050,18,011,"Indiana","Boone County",5,1,939,491,448
050,18,011,"Indiana","Boone County",5,2,854,451,403
050,18,011,"Indiana","Boone County",5,3,978,518,460
050,18,011,"Indiana","Boone County",5,4,1004,498,506
050,18,011,"Indiana","Boone County",5,5,1039,542,497
050,18,011,"Indiana","Boone County",5,6,1080,552,528
050,18,011,"Indiana","Boone County",5,7,1131,606,525
050,18,011,"Indiana","Boone County",5,8,1080,584,496
050,18,011,"Indiana","Boone County",5,9,1162,602,560
050,18,011,"Indiana","Boone County",5,10,1144,612,532
050,18,011,"Indiana","Boone County",5,11,1122,598,524
050,18,011,"Indiana","Boone County",5,12,1101,568,533
050,18,011,"Indiana","Boone County",5,13,1094,537,557
050,18,011,"Indiana","Boone County",5,14,1173,586,587
050,18,011,"Indiana","Boone County",5,15,1174,606,568
050,18,011,"Indiana","Boone County",5,16,1139,595,544
050,18,011,"Indiana","Boone County",5,17,1149,594,555
050,18,011,"Indiana","Boone County",5,18,935,514,421
050,18,011,"Indiana","Boone County",5,19,728,388,340
050,18,011,"Indiana","Boone County",5,20,751,411,340
050,18,011,"Indiana","Boone County",5,21,771,404,367
050,18,011,"Indiana","Boone County",5,22,845,419,426
050,18,011,"Indiana","Boone County",5,23,863,440,423
050,18,011,"Indiana","Boone County",5,24,878,446,432
050,18,011,"Indiana","Boone County",5,25,851,425,426
050,18,011,"Indiana","Boone County",5,26,882,459,423
050,18,011,"Indiana","Boone County",5,27,817,400,417
050,18,011,"Indiana","Boone County",5,28,835,430,405
050,18,011,"Indiana","Boone County",5,29,868,429,439
050,18,011,"Indiana","Boone County",5,30,852,421,431
050,18,011,"Indiana","Boone County",5,31,897,473,424
050,18,011,"Indiana","Boone County",5,32,996,507,489
050,18,011,"Indiana","Boone County",5,33,1053,515,538
050,18,011,"Indiana","Boone County",5,34,1045,521,524
050,18,011,"Indiana","Boone County",5,35,1065,543,522
050,18,011,"Indiana","Boone County",5,36,1021,534,487
050,18,011,"Indiana","Boone County",5,37,1070,533,537
050,18,011,"Indiana","Boone County",5,38,1130,550,580
050,18,011,"Indiana","Boone County",5,39,1151,554,597
050,18,011,"Indiana","Boone County",5,40,1148,563,585
050,18,011,"Indiana","Boone County",5,41,1108,532,576
050,18,011,"Indiana","Boone County",5,42,1136,591,545
050,18,011,"Indiana","Boone County",5,43,1133,564,569
050,18,011,"Indiana","Boone County",5,44,1058,560,498
050,18,011,"Indiana","Boone County",5,45,1034,504,530
050,18,011,"Indiana","Boone County",5,46,1025,517,508
050,18,011,"Indiana","Boone County",5,47,993,508,485
050,18,011,"Indiana","Boone County",5,48,961,498,463
050,18,011,"Indiana","Boone County",5,49,996,493,503
050,18,011,"Indiana","Boone County",5,50,984,486,498
050,18,011,"Indiana","Boone County",5,51,1028,530,498
050,18,011,"Indiana","Boone County",5,52,1039,531,508
050,18,011,"Indiana","Boone County",5,53,999,490,509
050,18,011,"Indiana","Boone County",5,54,969,477,492
050,18,011,"Indiana","Boone County",5,55,864,446,418
050,18,011,"Indiana","Boone County",5,56,909,467,442
050,18,011,"Indiana","Boone County",5,57,962,507,455
050,18,011,"Indiana","Boone County",5,58,917,464,453
050,18,011,"Indiana","Boone County",5,59,953,456,497
050,18,011,"Indiana","Boone County",5,60,944,444,500
050,18,011,"Indiana","Boone County",5,61,969,483,486
050,18,011,"Indiana","Boone County",5,62,968,497,471
050,18,011,"Indiana","Boone County",5,63,908,445,463
050,18,011,"Indiana","Boone County",5,64,869,414,455
050,18,011,"Indiana","Boone County",5,65,821,407,414
050,18,011,"Indiana","Boone County",5,66,875,431,444
050,18,011,"Indiana","Boone County",5,67,810,387,423
050,18,011,"Indiana","Boone County",5,68,765,374,391
050,18,011,"Indiana","Boone County",5,69,668,321,347
050,18,011,"Indiana","Boone County",5,70,615,295,320
050,18,011,"Indiana","Boone County",5,71,614,299,315
050,18,011,"Indiana","Boone County",5,72,600,288,312
050,18,011,"Indiana","Boone County",5,73,570,253,317
050,18,011,"Indiana","Boone County",5,74,545,247,298
050,18,011,"Indiana","Boone County",5,75,529,232,297
050,18,011,"Indiana","Boone County",5,76,542,236,306
050,18,011,"Indiana","Boone County",5,77,377,164,213
050,18,011,"Indiana","Boone County",5,78,354,169,185
050,18,011,"Indiana","Boone County",5,79,366,168,198
050,18,011,"Indiana","Boone County",5,80,380,176,204
050,18,011,"Indiana","Boone County",5,81,304,133,171
050,18,011,"Indiana","Boone County",5,82,262,110,152
050,18,011,"Indiana","Boone County",5,83,220,85,135
050,18,011,"Indiana","Boone County",5,84,208,81,127
050,18,011,"Indiana","Boone County",5,85,1277,438,839
050,18,013,"Indiana","Brown County",1,0,118,61,57
050,18,013,"Indiana","Brown County",1,1,120,59,61
050,18,013,"Indiana","Brown County",1,2,134,59,75
050,18,013,"Indiana","Brown County",1,3,124,60,64
050,18,013,"Indiana","Brown County",1,4,131,65,66
050,18,013,"Indiana","Brown County",1,5,137,71,66
050,18,013,"Indiana","Brown County",1,6,133,69,64
050,18,013,"Indiana","Brown County",1,7,138,69,69
050,18,013,"Indiana","Brown County",1,8,152,82,70
050,18,013,"Indiana","Brown County",1,9,151,77,74
050,18,013,"Indiana","Brown County",1,10,155,71,84
050,18,013,"Indiana","Brown County",1,11,149,80,69
050,18,013,"Indiana","Brown County",1,12,174,83,91
050,18,013,"Indiana","Brown County",1,13,162,81,81
050,18,013,"Indiana","Brown County",1,14,174,92,82
050,18,013,"Indiana","Brown County",1,15,165,81,84
050,18,013,"Indiana","Brown County",1,16,190,93,97
050,18,013,"Indiana","Brown County",1,17,193,97,96
050,18,013,"Indiana","Brown County",1,18,158,82,76
050,18,013,"Indiana","Brown County",1,19,128,72,56
050,18,013,"Indiana","Brown County",1,20,127,68,59
050,18,013,"Indiana","Brown County",1,21,124,74,50
050,18,013,"Indiana","Brown County",1,22,133,69,64
050,18,013,"Indiana","Brown County",1,23,139,72,67
050,18,013,"Indiana","Brown County",1,24,128,59,69
050,18,013,"Indiana","Brown County",1,25,148,78,70
050,18,013,"Indiana","Brown County",1,26,143,77,66
050,18,013,"Indiana","Brown County",1,27,156,81,75
050,18,013,"Indiana","Brown County",1,28,147,80,67
050,18,013,"Indiana","Brown County",1,29,146,65,81
050,18,013,"Indiana","Brown County",1,30,152,71,81
050,18,013,"Indiana","Brown County",1,31,137,68,69
050,18,013,"Indiana","Brown County",1,32,155,88,67
050,18,013,"Indiana","Brown County",1,33,159,80,79
050,18,013,"Indiana","Brown County",1,34,161,79,82
050,18,013,"Indiana","Brown County",1,35,144,76,68
050,18,013,"Indiana","Brown County",1,36,158,79,79
050,18,013,"Indiana","Brown County",1,37,159,87,72
050,18,013,"Indiana","Brown County",1,38,166,87,79
050,18,013,"Indiana","Brown County",1,39,166,84,82
050,18,013,"Indiana","Brown County",1,40,164,79,85
050,18,013,"Indiana","Brown County",1,41,154,79,75
050,18,013,"Indiana","Brown County",1,42,155,78,77
050,18,013,"Indiana","Brown County",1,43,173,90,83
050,18,013,"Indiana","Brown County",1,44,171,94,77
050,18,013,"Indiana","Brown County",1,45,158,80,78
050,18,013,"Indiana","Brown County",1,46,184,104,80
050,18,013,"Indiana","Brown County",1,47,188,101,87
050,18,013,"Indiana","Brown County",1,48,204,99,105
050,18,013,"Indiana","Brown County",1,49,242,123,119
050,18,013,"Indiana","Brown County",1,50,211,117,94
050,18,013,"Indiana","Brown County",1,51,219,110,109
050,18,013,"Indiana","Brown County",1,52,226,104,122
050,18,013,"Indiana","Brown County",1,53,243,100,143
050,18,013,"Indiana","Brown County",1,54,235,111,124
050,18,013,"Indiana","Brown County",1,55,267,134,133
050,18,013,"Indiana","Brown County",1,56,270,132,138
050,18,013,"Indiana","Brown County",1,57,260,132,128
050,18,013,"Indiana","Brown County",1,58,272,139,133
050,18,013,"Indiana","Brown County",1,59,267,138,129
050,18,013,"Indiana","Brown County",1,60,260,135,125
050,18,013,"Indiana","Brown County",1,61,281,142,139
050,18,013,"Indiana","Brown County",1,62,314,159,155
050,18,013,"Indiana","Brown County",1,63,295,142,153
050,18,013,"Indiana","Brown County",1,64,280,142,138
050,18,013,"Indiana","Brown County",1,65,292,146,146
050,18,013,"Indiana","Brown County",1,66,279,132,147
050,18,013,"Indiana","Brown County",1,67,257,131,126
050,18,013,"Indiana","Brown County",1,68,247,123,124
050,18,013,"Indiana","Brown County",1,69,252,132,120
050,18,013,"Indiana","Brown County",1,70,260,128,132
050,18,013,"Indiana","Brown County",1,71,241,122,119
050,18,013,"Indiana","Brown County",1,72,249,125,124
050,18,013,"Indiana","Brown County",1,73,255,111,144
050,18,013,"Indiana","Brown County",1,74,159,83,76
050,18,013,"Indiana","Brown County",1,75,150,80,70
050,18,013,"Indiana","Brown County",1,76,156,83,73
050,18,013,"Indiana","Brown County",1,77,153,82,71
050,18,013,"Indiana","Brown County",1,78,129,61,68
050,18,013,"Indiana","Brown County",1,79,111,50,61
050,18,013,"Indiana","Brown County",1,80,89,43,46
050,18,013,"Indiana","Brown County",1,81,86,47,39
050,18,013,"Indiana","Brown County",1,82,73,38,35
050,18,013,"Indiana","Brown County",1,83,64,28,36
050,18,013,"Indiana","Brown County",1,84,62,29,33
050,18,013,"Indiana","Brown County",1,85,283,108,175
050,18,013,"Indiana","Brown County",2,0,113,59,54
050,18,013,"Indiana","Brown County",2,1,121,59,62
050,18,013,"Indiana","Brown County",2,2,131,61,70
050,18,013,"Indiana","Brown County",2,3,126,59,67
050,18,013,"Indiana","Brown County",2,4,133,67,66
050,18,013,"Indiana","Brown County",2,5,137,70,67
050,18,013,"Indiana","Brown County",2,6,133,69,64
050,18,013,"Indiana","Brown County",2,7,136,69,67
050,18,013,"Indiana","Brown County",2,8,149,79,70
050,18,013,"Indiana","Brown County",2,9,153,79,74
050,18,013,"Indiana","Brown County",2,10,152,73,79
050,18,013,"Indiana","Brown County",2,11,149,76,73
050,18,013,"Indiana","Brown County",2,12,168,83,85
050,18,013,"Indiana","Brown County",2,13,164,82,82
050,18,013,"Indiana","Brown County",2,14,171,89,82
050,18,013,"Indiana","Brown County",2,15,169,84,85
050,18,013,"Indiana","Brown County",2,16,185,90,95
050,18,013,"Indiana","Brown County",2,17,193,96,97
050,18,013,"Indiana","Brown County",2,18,157,82,75
050,18,013,"Indiana","Brown County",2,19,129,70,59
050,18,013,"Indiana","Brown County",2,20,130,70,60
050,18,013,"Indiana","Brown County",2,21,125,72,53
050,18,013,"Indiana","Brown County",2,22,131,71,60
050,18,013,"Indiana","Brown County",2,23,133,69,64
050,18,013,"Indiana","Brown County",2,24,130,62,68
050,18,013,"Indiana","Brown County",2,25,142,73,69
050,18,013,"Indiana","Brown County",2,26,146,78,68
050,18,013,"Indiana","Brown County",2,27,153,81,72
050,18,013,"Indiana","Brown County",2,28,149,80,69
050,18,013,"Indiana","Brown County",2,29,149,70,79
050,18,013,"Indiana","Brown County",2,30,151,70,81
050,18,013,"Indiana","Brown County",2,31,143,71,72
050,18,013,"Indiana","Brown County",2,32,149,83,66
050,18,013,"Indiana","Brown County",2,33,161,84,77
050,18,013,"Indiana","Brown County",2,34,162,81,81
050,18,013,"Indiana","Brown County",2,35,154,80,74
050,18,013,"Indiana","Brown County",2,36,153,78,75
050,18,013,"Indiana","Brown County",2,37,159,85,74
050,18,013,"Indiana","Brown County",2,38,165,87,78
050,18,013,"Indiana","Brown County",2,39,167,86,81
050,18,013,"Indiana","Brown County",2,40,166,81,85
050,18,013,"Indiana","Brown County",2,41,155,77,78
050,18,013,"Indiana","Brown County",2,42,155,78,77
050,18,013,"Indiana","Brown County",2,43,170,88,82
050,18,013,"Indiana","Brown County",2,44,170,92,78
050,18,013,"Indiana","Brown County",2,45,165,86,79
050,18,013,"Indiana","Brown County",2,46,179,98,81
050,18,013,"Indiana","Brown County",2,47,189,102,87
050,18,013,"Indiana","Brown County",2,48,200,100,100
050,18,013,"Indiana","Brown County",2,49,236,119,117
050,18,013,"Indiana","Brown County",2,50,220,119,101
050,18,013,"Indiana","Brown County",2,51,218,113,105
050,18,013,"Indiana","Brown County",2,52,225,104,121
050,18,013,"Indiana","Brown County",2,53,243,103,140
050,18,013,"Indiana","Brown County",2,54,240,110,130
050,18,013,"Indiana","Brown County",2,55,261,128,133
050,18,013,"Indiana","Brown County",2,56,270,134,136
050,18,013,"Indiana","Brown County",2,57,265,133,132
050,18,013,"Indiana","Brown County",2,58,271,140,131
050,18,013,"Indiana","Brown County",2,59,269,141,128
050,18,013,"Indiana","Brown County",2,60,261,135,126
050,18,013,"Indiana","Brown County",2,61,277,141,136
050,18,013,"Indiana","Brown County",2,62,308,156,152
050,18,013,"Indiana","Brown County",2,63,302,149,153
050,18,013,"Indiana","Brown County",2,64,281,141,140
050,18,013,"Indiana","Brown County",2,65,291,145,146
050,18,013,"Indiana","Brown County",2,66,283,136,147
050,18,013,"Indiana","Brown County",2,67,261,130,131
050,18,013,"Indiana","Brown County",2,68,246,125,121
050,18,013,"Indiana","Brown County",2,69,253,131,122
050,18,013,"Indiana","Brown County",2,70,253,125,128
050,18,013,"Indiana","Brown County",2,71,245,124,121
050,18,013,"Indiana","Brown County",2,72,241,121,120
050,18,013,"Indiana","Brown County",2,73,264,120,144
050,18,013,"Indiana","Brown County",2,74,167,81,86
050,18,013,"Indiana","Brown County",2,75,149,78,71
050,18,013,"Indiana","Brown County",2,76,150,79,71
050,18,013,"Indiana","Brown County",2,77,155,81,74
050,18,013,"Indiana","Brown County",2,78,130,65,65
050,18,013,"Indiana","Brown County",2,79,114,52,62
050,18,013,"Indiana","Brown County",2,80,93,44,49
050,18,013,"Indiana","Brown County",2,81,84,44,40
050,18,013,"Indiana","Brown County",2,82,75,40,35
050,18,013,"Indiana","Brown County",2,83,63,30,33
050,18,013,"Indiana","Brown County",2,84,62,28,34
050,18,013,"Indiana","Brown County",2,85,289,111,178
050,18,013,"Indiana","Brown County",3,0,117,46,71
050,18,013,"Indiana","Brown County",3,1,107,62,45
050,18,013,"Indiana","Brown County",3,2,123,63,60
050,18,013,"Indiana","Brown County",3,3,134,63,71
050,18,013,"Indiana","Brown County",3,4,133,65,68
050,18,013,"Indiana","Brown County",3,5,137,67,70
050,18,013,"Indiana","Brown County",3,6,137,67,70
050,18,013,"Indiana","Brown County",3,7,146,76,70
050,18,013,"Indiana","Brown County",3,8,149,73,76
050,18,013,"Indiana","Brown County",3,9,156,83,73
050,18,013,"Indiana","Brown County",3,10,159,83,76
050,18,013,"Indiana","Brown County",3,11,154,70,84
050,18,013,"Indiana","Brown County",3,12,156,78,78
050,18,013,"Indiana","Brown County",3,13,180,91,89
050,18,013,"Indiana","Brown County",3,14,166,81,85
050,18,013,"Indiana","Brown County",3,15,179,93,86
050,18,013,"Indiana","Brown County",3,16,173,89,84
050,18,013,"Indiana","Brown County",3,17,203,98,105
050,18,013,"Indiana","Brown County",3,18,164,85,79
050,18,013,"Indiana","Brown County",3,19,126,64,62
050,18,013,"Indiana","Brown County",3,20,133,68,65
050,18,013,"Indiana","Brown County",3,21,138,74,64
050,18,013,"Indiana","Brown County",3,22,130,79,51
050,18,013,"Indiana","Brown County",3,23,123,61,62
050,18,013,"Indiana","Brown County",3,24,121,66,55
050,18,013,"Indiana","Brown County",3,25,134,66,68
050,18,013,"Indiana","Brown County",3,26,133,71,62
050,18,013,"Indiana","Brown County",3,27,148,75,73
050,18,013,"Indiana","Brown County",3,28,156,88,68
050,18,013,"Indiana","Brown County",3,29,148,81,67
050,18,013,"Indiana","Brown County",3,30,144,70,74
050,18,013,"Indiana","Brown County",3,31,153,73,80
050,18,013,"Indiana","Brown County",3,32,157,77,80
050,18,013,"Indiana","Brown County",3,33,151,85,66
050,18,013,"Indiana","Brown County",3,34,175,94,81
050,18,013,"Indiana","Brown County",3,35,158,75,83
050,18,013,"Indiana","Brown County",3,36,156,81,75
050,18,013,"Indiana","Brown County",3,37,160,81,79
050,18,013,"Indiana","Brown County",3,38,160,89,71
050,18,013,"Indiana","Brown County",3,39,166,90,76
050,18,013,"Indiana","Brown County",3,40,167,79,88
050,18,013,"Indiana","Brown County",3,41,162,76,86
050,18,013,"Indiana","Brown County",3,42,166,86,80
050,18,013,"Indiana","Brown County",3,43,159,81,78
050,18,013,"Indiana","Brown County",3,44,172,92,80
050,18,013,"Indiana","Brown County",3,45,180,100,80
050,18,013,"Indiana","Brown County",3,46,172,84,88
050,18,013,"Indiana","Brown County",3,47,184,100,84
050,18,013,"Indiana","Brown County",3,48,196,103,93
050,18,013,"Indiana","Brown County",3,49,215,102,113
050,18,013,"Indiana","Brown County",3,50,232,115,117
050,18,013,"Indiana","Brown County",3,51,232,125,107
050,18,013,"Indiana","Brown County",3,52,219,114,105
050,18,013,"Indiana","Brown County",3,53,216,101,115
050,18,013,"Indiana","Brown County",3,54,252,105,147
050,18,013,"Indiana","Brown County",3,55,249,117,132
050,18,013,"Indiana","Brown County",3,56,265,133,132
050,18,013,"Indiana","Brown County",3,57,277,136,141
050,18,013,"Indiana","Brown County",3,58,261,131,130
050,18,013,"Indiana","Brown County",3,59,269,137,132
050,18,013,"Indiana","Brown County",3,60,276,148,128
050,18,013,"Indiana","Brown County",3,61,264,137,127
050,18,013,"Indiana","Brown County",3,62,278,139,139
050,18,013,"Indiana","Brown County",3,63,306,154,152
050,18,013,"Indiana","Brown County",3,64,306,155,151
050,18,013,"Indiana","Brown County",3,65,277,139,138
050,18,013,"Indiana","Brown County",3,66,286,144,142
050,18,013,"Indiana","Brown County",3,67,275,132,143
050,18,013,"Indiana","Brown County",3,68,261,129,132
050,18,013,"Indiana","Brown County",3,69,232,117,115
050,18,013,"Indiana","Brown County",3,70,246,125,121
050,18,013,"Indiana","Brown County",3,71,234,112,122
050,18,013,"Indiana","Brown County",3,72,245,124,121
050,18,013,"Indiana","Brown County",3,73,238,118,120
050,18,013,"Indiana","Brown County",3,74,257,115,142
050,18,013,"Indiana","Brown County",3,75,171,78,93
050,18,013,"Indiana","Brown County",3,76,136,72,64
050,18,013,"Indiana","Brown County",3,77,146,74,72
050,18,013,"Indiana","Brown County",3,78,154,83,71
050,18,013,"Indiana","Brown County",3,79,121,62,59
050,18,013,"Indiana","Brown County",3,80,106,48,58
050,18,013,"Indiana","Brown County",3,81,89,42,47
050,18,013,"Indiana","Brown County",3,82,80,41,39
050,18,013,"Indiana","Brown County",3,83,62,33,29
050,18,013,"Indiana","Brown County",3,84,56,26,30
050,18,013,"Indiana","Brown County",3,85,302,117,185
050,18,013,"Indiana","Brown County",4,0,104,51,53
050,18,013,"Indiana","Brown County",4,1,108,45,63
050,18,013,"Indiana","Brown County",4,2,112,61,51
050,18,013,"Indiana","Brown County",4,3,120,63,57
050,18,013,"Indiana","Brown County",4,4,135,68,67
050,18,013,"Indiana","Brown County",4,5,128,68,60
050,18,013,"Indiana","Brown County",4,6,137,72,65
050,18,013,"Indiana","Brown County",4,7,142,68,74
050,18,013,"Indiana","Brown County",4,8,146,74,72
050,18,013,"Indiana","Brown County",4,9,148,72,76
050,18,013,"Indiana","Brown County",4,10,151,81,70
050,18,013,"Indiana","Brown County",4,11,152,80,72
050,18,013,"Indiana","Brown County",4,12,154,75,79
050,18,013,"Indiana","Brown County",4,13,162,79,83
050,18,013,"Indiana","Brown County",4,14,185,96,89
050,18,013,"Indiana","Brown County",4,15,165,81,84
050,18,013,"Indiana","Brown County",4,16,179,87,92
050,18,013,"Indiana","Brown County",4,17,174,84,90
050,18,013,"Indiana","Brown County",4,18,157,85,72
050,18,013,"Indiana","Brown County",4,19,125,69,56
050,18,013,"Indiana","Brown County",4,20,131,71,60
050,18,013,"Indiana","Brown County",4,21,143,73,70
050,18,013,"Indiana","Brown County",4,22,137,78,59
050,18,013,"Indiana","Brown County",4,23,131,83,48
050,18,013,"Indiana","Brown County",4,24,114,60,54
050,18,013,"Indiana","Brown County",4,25,123,60,63
050,18,013,"Indiana","Brown County",4,26,125,58,67
050,18,013,"Indiana","Brown County",4,27,128,71,57
050,18,013,"Indiana","Brown County",4,28,153,75,78
050,18,013,"Indiana","Brown County",4,29,155,89,66
050,18,013,"Indiana","Brown County",4,30,142,78,64
050,18,013,"Indiana","Brown County",4,31,135,65,70
050,18,013,"Indiana","Brown County",4,32,158,77,81
050,18,013,"Indiana","Brown County",4,33,151,71,80
050,18,013,"Indiana","Brown County",4,34,146,78,68
050,18,013,"Indiana","Brown County",4,35,187,103,84
050,18,013,"Indiana","Brown County",4,36,159,80,79
050,18,013,"Indiana","Brown County",4,37,162,83,79
050,18,013,"Indiana","Brown County",4,38,169,85,84
050,18,013,"Indiana","Brown County",4,39,151,83,68
050,18,013,"Indiana","Brown County",4,40,157,84,73
050,18,013,"Indiana","Brown County",4,41,174,80,94
050,18,013,"Indiana","Brown County",4,42,167,78,89
050,18,013,"Indiana","Brown County",4,43,166,85,81
050,18,013,"Indiana","Brown County",4,44,156,78,78
050,18,013,"Indiana","Brown County",4,45,169,90,79
050,18,013,"Indiana","Brown County",4,46,180,102,78
050,18,013,"Indiana","Brown County",4,47,167,84,83
050,18,013,"Indiana","Brown County",4,48,188,109,79
050,18,013,"Indiana","Brown County",4,49,202,104,98
050,18,013,"Indiana","Brown County",4,50,209,102,107
050,18,013,"Indiana","Brown County",4,51,247,124,123
050,18,013,"Indiana","Brown County",4,52,242,130,112
050,18,013,"Indiana","Brown County",4,53,236,118,118
050,18,013,"Indiana","Brown County",4,54,230,104,126
050,18,013,"Indiana","Brown County",4,55,257,110,147
050,18,013,"Indiana","Brown County",4,56,256,125,131
050,18,013,"Indiana","Brown County",4,57,274,141,133
050,18,013,"Indiana","Brown County",4,58,295,149,146
050,18,013,"Indiana","Brown County",4,59,271,134,137
050,18,013,"Indiana","Brown County",4,60,273,138,135
050,18,013,"Indiana","Brown County",4,61,287,154,133
050,18,013,"Indiana","Brown County",4,62,272,142,130
050,18,013,"Indiana","Brown County",4,63,293,138,155
050,18,013,"Indiana","Brown County",4,64,311,161,150
050,18,013,"Indiana","Brown County",4,65,314,158,156
050,18,013,"Indiana","Brown County",4,66,280,140,140
050,18,013,"Indiana","Brown County",4,67,291,151,140
050,18,013,"Indiana","Brown County",4,68,275,131,144
050,18,013,"Indiana","Brown County",4,69,259,130,129
050,18,013,"Indiana","Brown County",4,70,224,115,109
050,18,013,"Indiana","Brown County",4,71,247,125,122
050,18,013,"Indiana","Brown County",4,72,224,108,116
050,18,013,"Indiana","Brown County",4,73,238,119,119
050,18,013,"Indiana","Brown County",4,74,230,115,115
050,18,013,"Indiana","Brown County",4,75,245,109,136
050,18,013,"Indiana","Brown County",4,76,167,78,89
050,18,013,"Indiana","Brown County",4,77,133,67,66
050,18,013,"Indiana","Brown County",4,78,141,73,68
050,18,013,"Indiana","Brown County",4,79,150,76,74
050,18,013,"Indiana","Brown County",4,80,113,57,56
050,18,013,"Indiana","Brown County",4,81,96,44,52
050,18,013,"Indiana","Brown County",4,82,80,35,45
050,18,013,"Indiana","Brown County",4,83,71,38,33
050,18,013,"Indiana","Brown County",4,84,58,33,25
050,18,013,"Indiana","Brown County",4,85,288,112,176
050,18,013,"Indiana","Brown County",5,0,94,46,48
050,18,013,"Indiana","Brown County",5,1,105,50,55
050,18,013,"Indiana","Brown County",5,2,121,53,68
050,18,013,"Indiana","Brown County",5,3,121,68,53
050,18,013,"Indiana","Brown County",5,4,135,70,65
050,18,013,"Indiana","Brown County",5,5,142,65,77
050,18,013,"Indiana","Brown County",5,6,135,74,61
050,18,013,"Indiana","Brown County",5,7,137,72,65
050,18,013,"Indiana","Brown County",5,8,140,67,73
050,18,013,"Indiana","Brown County",5,9,154,78,76
050,18,013,"Indiana","Brown County",5,10,146,72,74
050,18,013,"Indiana","Brown County",5,11,152,78,74
050,18,013,"Indiana","Brown County",5,12,153,75,78
050,18,013,"Indiana","Brown County",5,13,155,72,83
050,18,013,"Indiana","Brown County",5,14,168,85,83
050,18,013,"Indiana","Brown County",5,15,187,101,86
050,18,013,"Indiana","Brown County",5,16,162,81,81
050,18,013,"Indiana","Brown County",5,17,181,87,94
050,18,013,"Indiana","Brown County",5,18,154,81,73
050,18,013,"Indiana","Brown County",5,19,127,72,55
050,18,013,"Indiana","Brown County",5,20,126,72,54
050,18,013,"Indiana","Brown County",5,21,140,73,67
050,18,013,"Indiana","Brown County",5,22,140,70,70
050,18,013,"Indiana","Brown County",5,23,144,77,67
050,18,013,"Indiana","Brown County",5,24,121,77,44
050,18,013,"Indiana","Brown County",5,25,128,67,61
050,18,013,"Indiana","Brown County",5,26,129,67,62
050,18,013,"Indiana","Brown County",5,27,127,57,70
050,18,013,"Indiana","Brown County",5,28,133,72,61
050,18,013,"Indiana","Brown County",5,29,149,65,84
050,18,013,"Indiana","Brown County",5,30,164,96,68
050,18,013,"Indiana","Brown County",5,31,134,72,62
050,18,013,"Indiana","Brown County",5,32,132,64,68
050,18,013,"Indiana","Brown County",5,33,159,77,82
050,18,013,"Indiana","Brown County",5,34,154,74,80
050,18,013,"Indiana","Brown County",5,35,153,76,77
050,18,013,"Indiana","Brown County",5,36,178,100,78
050,18,013,"Indiana","Brown County",5,37,168,86,82
050,18,013,"Indiana","Brown County",5,38,165,81,84
050,18,013,"Indiana","Brown County",5,39,156,79,77
050,18,013,"Indiana","Brown County",5,40,163,89,74
050,18,013,"Indiana","Brown County",5,41,150,82,68
050,18,013,"Indiana","Brown County",5,42,186,84,102
050,18,013,"Indiana","Brown County",5,43,172,81,91
050,18,013,"Indiana","Brown County",5,44,162,80,82
050,18,013,"Indiana","Brown County",5,45,170,82,88
050,18,013,"Indiana","Brown County",5,46,167,88,79
050,18,013,"Indiana","Brown County",5,47,189,104,85
050,18,013,"Indiana","Brown County",5,48,176,91,85
050,18,013,"Indiana","Brown County",5,49,191,107,84
050,18,013,"Indiana","Brown County",5,50,208,103,105
050,18,013,"Indiana","Brown County",5,51,219,105,114
050,18,013,"Indiana","Brown County",5,52,255,131,124
050,18,013,"Indiana","Brown County",5,53,245,128,117
050,18,013,"Indiana","Brown County",5,54,244,122,122
050,18,013,"Indiana","Brown County",5,55,238,105,133
050,18,013,"Indiana","Brown County",5,56,252,110,142
050,18,013,"Indiana","Brown County",5,57,263,125,138
050,18,013,"Indiana","Brown County",5,58,276,143,133
050,18,013,"Indiana","Brown County",5,59,292,152,140
050,18,013,"Indiana","Brown County",5,60,280,139,141
050,18,013,"Indiana","Brown County",5,61,272,139,133
050,18,013,"Indiana","Brown County",5,62,286,155,131
050,18,013,"Indiana","Brown County",5,63,269,138,131
050,18,013,"Indiana","Brown County",5,64,296,139,157
050,18,013,"Indiana","Brown County",5,65,311,165,146
050,18,013,"Indiana","Brown County",5,66,309,154,155
050,18,013,"Indiana","Brown County",5,67,273,138,135
050,18,013,"Indiana","Brown County",5,68,294,151,143
050,18,013,"Indiana","Brown County",5,69,270,128,142
050,18,013,"Indiana","Brown County",5,70,256,132,124
050,18,013,"Indiana","Brown County",5,71,219,113,106
050,18,013,"Indiana","Brown County",5,72,245,124,121
050,18,013,"Indiana","Brown County",5,73,213,102,111
050,18,013,"Indiana","Brown County",5,74,223,113,110
050,18,013,"Indiana","Brown County",5,75,222,111,111
050,18,013,"Indiana","Brown County",5,76,235,108,127
050,18,013,"Indiana","Brown County",5,77,163,76,87
050,18,013,"Indiana","Brown County",5,78,128,67,61
050,18,013,"Indiana","Brown County",5,79,127,60,67
050,18,013,"Indiana","Brown County",5,80,146,71,75
050,18,013,"Indiana","Brown County",5,81,109,55,54
050,18,013,"Indiana","Brown County",5,82,89,41,48
050,18,013,"Indiana","Brown County",5,83,74,32,42
050,18,013,"Indiana","Brown County",5,84,68,37,31
050,18,013,"Indiana","Brown County",5,85,289,121,168
050,18,015,"Indiana","Carroll County",1,0,192,99,93
050,18,015,"Indiana","Carroll County",1,1,207,107,100
050,18,015,"Indiana","Carroll County",1,2,261,133,128
050,18,015,"Indiana","Carroll County",1,3,231,120,111
050,18,015,"Indiana","Carroll County",1,4,225,126,99
050,18,015,"Indiana","Carroll County",1,5,243,140,103
050,18,015,"Indiana","Carroll County",1,6,244,131,113
050,18,015,"Indiana","Carroll County",1,7,242,121,121
050,18,015,"Indiana","Carroll County",1,8,211,111,100
050,18,015,"Indiana","Carroll County",1,9,230,115,115
050,18,015,"Indiana","Carroll County",1,10,247,127,120
050,18,015,"Indiana","Carroll County",1,11,279,146,133
050,18,015,"Indiana","Carroll County",1,12,276,138,138
050,18,015,"Indiana","Carroll County",1,13,281,139,142
050,18,015,"Indiana","Carroll County",1,14,265,138,127
050,18,015,"Indiana","Carroll County",1,15,276,137,139
050,18,015,"Indiana","Carroll County",1,16,291,147,144
050,18,015,"Indiana","Carroll County",1,17,276,153,123
050,18,015,"Indiana","Carroll County",1,18,218,124,94
050,18,015,"Indiana","Carroll County",1,19,179,93,86
050,18,015,"Indiana","Carroll County",1,20,204,104,100
050,18,015,"Indiana","Carroll County",1,21,222,107,115
050,18,015,"Indiana","Carroll County",1,22,216,107,109
050,18,015,"Indiana","Carroll County",1,23,212,108,104
050,18,015,"Indiana","Carroll County",1,24,203,103,100
050,18,015,"Indiana","Carroll County",1,25,215,111,104
050,18,015,"Indiana","Carroll County",1,26,227,113,114
050,18,015,"Indiana","Carroll County",1,27,242,120,122
050,18,015,"Indiana","Carroll County",1,28,234,124,110
050,18,015,"Indiana","Carroll County",1,29,239,125,114
050,18,015,"Indiana","Carroll County",1,30,243,123,120
050,18,015,"Indiana","Carroll County",1,31,256,126,130
050,18,015,"Indiana","Carroll County",1,32,235,122,113
050,18,015,"Indiana","Carroll County",1,33,214,117,97
050,18,015,"Indiana","Carroll County",1,34,212,122,90
050,18,015,"Indiana","Carroll County",1,35,226,116,110
050,18,015,"Indiana","Carroll County",1,36,231,111,120
050,18,015,"Indiana","Carroll County",1,37,235,115,120
050,18,015,"Indiana","Carroll County",1,38,231,114,117
050,18,015,"Indiana","Carroll County",1,39,247,127,120
050,18,015,"Indiana","Carroll County",1,40,229,119,110
050,18,015,"Indiana","Carroll County",1,41,217,102,115
050,18,015,"Indiana","Carroll County",1,42,230,116,114
050,18,015,"Indiana","Carroll County",1,43,259,133,126
050,18,015,"Indiana","Carroll County",1,44,248,123,125
050,18,015,"Indiana","Carroll County",1,45,237,118,119
050,18,015,"Indiana","Carroll County",1,46,249,133,116
050,18,015,"Indiana","Carroll County",1,47,263,145,118
050,18,015,"Indiana","Carroll County",1,48,285,157,128
050,18,015,"Indiana","Carroll County",1,49,297,165,132
050,18,015,"Indiana","Carroll County",1,50,267,144,123
050,18,015,"Indiana","Carroll County",1,51,255,140,115
050,18,015,"Indiana","Carroll County",1,52,236,121,115
050,18,015,"Indiana","Carroll County",1,53,255,131,124
050,18,015,"Indiana","Carroll County",1,54,295,151,144
050,18,015,"Indiana","Carroll County",1,55,290,146,144
050,18,015,"Indiana","Carroll County",1,56,285,148,137
050,18,015,"Indiana","Carroll County",1,57,304,146,158
050,18,015,"Indiana","Carroll County",1,58,310,160,150
050,18,015,"Indiana","Carroll County",1,59,308,161,147
050,18,015,"Indiana","Carroll County",1,60,316,146,170
050,18,015,"Indiana","Carroll County",1,61,317,167,150
050,18,015,"Indiana","Carroll County",1,62,311,164,147
050,18,015,"Indiana","Carroll County",1,63,309,160,149
050,18,015,"Indiana","Carroll County",1,64,275,138,137
050,18,015,"Indiana","Carroll County",1,65,281,153,128
050,18,015,"Indiana","Carroll County",1,66,263,141,122
050,18,015,"Indiana","Carroll County",1,67,264,130,134
050,18,015,"Indiana","Carroll County",1,68,277,136,141
050,18,015,"Indiana","Carroll County",1,69,236,120,116
050,18,015,"Indiana","Carroll County",1,70,237,120,117
050,18,015,"Indiana","Carroll County",1,71,231,109,122
050,18,015,"Indiana","Carroll County",1,72,235,115,120
050,18,015,"Indiana","Carroll County",1,73,211,99,112
050,18,015,"Indiana","Carroll County",1,74,163,76,87
050,18,015,"Indiana","Carroll County",1,75,169,79,90
050,18,015,"Indiana","Carroll County",1,76,181,80,101
050,18,015,"Indiana","Carroll County",1,77,173,78,95
050,18,015,"Indiana","Carroll County",1,78,123,57,66
050,18,015,"Indiana","Carroll County",1,79,116,58,58
050,18,015,"Indiana","Carroll County",1,80,107,57,50
050,18,015,"Indiana","Carroll County",1,81,89,37,52
050,18,015,"Indiana","Carroll County",1,82,96,48,48
050,18,015,"Indiana","Carroll County",1,83,85,35,50
050,18,015,"Indiana","Carroll County",1,84,70,31,39
050,18,015,"Indiana","Carroll County",1,85,436,146,290
050,18,015,"Indiana","Carroll County",2,0,205,111,94
050,18,015,"Indiana","Carroll County",2,1,205,105,100
050,18,015,"Indiana","Carroll County",2,2,253,130,123
050,18,015,"Indiana","Carroll County",2,3,242,126,116
050,18,015,"Indiana","Carroll County",2,4,230,126,104
050,18,015,"Indiana","Carroll County",2,5,238,136,102
050,18,015,"Indiana","Carroll County",2,6,242,132,110
050,18,015,"Indiana","Carroll County",2,7,238,121,117
050,18,015,"Indiana","Carroll County",2,8,216,112,104
050,18,015,"Indiana","Carroll County",2,9,226,116,110
050,18,015,"Indiana","Carroll County",2,10,242,125,117
050,18,015,"Indiana","Carroll County",2,11,271,142,129
050,18,015,"Indiana","Carroll County",2,12,280,142,138
050,18,015,"Indiana","Carroll County",2,13,280,140,140
050,18,015,"Indiana","Carroll County",2,14,268,138,130
050,18,015,"Indiana","Carroll County",2,15,272,137,135
050,18,015,"Indiana","Carroll County",2,16,288,144,144
050,18,015,"Indiana","Carroll County",2,17,279,151,128
050,18,015,"Indiana","Carroll County",2,18,219,125,94
050,18,015,"Indiana","Carroll County",2,19,179,94,85
050,18,015,"Indiana","Carroll County",2,20,203,103,100
050,18,015,"Indiana","Carroll County",2,21,221,107,114
050,18,015,"Indiana","Carroll County",2,22,218,108,110
050,18,015,"Indiana","Carroll County",2,23,214,110,104
050,18,015,"Indiana","Carroll County",2,24,209,106,103
050,18,015,"Indiana","Carroll County",2,25,213,109,104
050,18,015,"Indiana","Carroll County",2,26,227,114,113
050,18,015,"Indiana","Carroll County",2,27,242,119,123
050,18,015,"Indiana","Carroll County",2,28,239,125,114
050,18,015,"Indiana","Carroll County",2,29,236,123,113
050,18,015,"Indiana","Carroll County",2,30,246,125,121
050,18,015,"Indiana","Carroll County",2,31,257,128,129
050,18,015,"Indiana","Carroll County",2,32,239,123,116
050,18,015,"Indiana","Carroll County",2,33,223,121,102
050,18,015,"Indiana","Carroll County",2,34,213,120,93
050,18,015,"Indiana","Carroll County",2,35,225,118,107
050,18,015,"Indiana","Carroll County",2,36,229,112,117
050,18,015,"Indiana","Carroll County",2,37,237,115,122
050,18,015,"Indiana","Carroll County",2,38,234,115,119
050,18,015,"Indiana","Carroll County",2,39,243,125,118
050,18,015,"Indiana","Carroll County",2,40,234,122,112
050,18,015,"Indiana","Carroll County",2,41,221,107,114
050,18,015,"Indiana","Carroll County",2,42,226,112,114
050,18,015,"Indiana","Carroll County",2,43,254,131,123
050,18,015,"Indiana","Carroll County",2,44,247,125,122
050,18,015,"Indiana","Carroll County",2,45,242,121,121
050,18,015,"Indiana","Carroll County",2,46,245,130,115
050,18,015,"Indiana","Carroll County",2,47,258,142,116
050,18,015,"Indiana","Carroll County",2,48,281,155,126
050,18,015,"Indiana","Carroll County",2,49,296,165,131
050,18,015,"Indiana","Carroll County",2,50,275,150,125
050,18,015,"Indiana","Carroll County",2,51,258,141,117
050,18,015,"Indiana","Carroll County",2,52,239,126,113
050,18,015,"Indiana","Carroll County",2,53,251,129,122
050,18,015,"Indiana","Carroll County",2,54,286,146,140
050,18,015,"Indiana","Carroll County",2,55,291,146,145
050,18,015,"Indiana","Carroll County",2,56,284,146,138
050,18,015,"Indiana","Carroll County",2,57,298,145,153
050,18,015,"Indiana","Carroll County",2,58,309,158,151
050,18,015,"Indiana","Carroll County",2,59,308,159,149
050,18,015,"Indiana","Carroll County",2,60,311,149,162
050,18,015,"Indiana","Carroll County",2,61,314,160,154
050,18,015,"Indiana","Carroll County",2,62,314,166,148
050,18,015,"Indiana","Carroll County",2,63,311,161,150
050,18,015,"Indiana","Carroll County",2,64,280,143,137
050,18,015,"Indiana","Carroll County",2,65,276,146,130
050,18,015,"Indiana","Carroll County",2,66,268,143,125
050,18,015,"Indiana","Carroll County",2,67,262,131,131
050,18,015,"Indiana","Carroll County",2,68,272,134,138
050,18,015,"Indiana","Carroll County",2,69,243,122,121
050,18,015,"Indiana","Carroll County",2,70,235,120,115
050,18,015,"Indiana","Carroll County",2,71,232,111,121
050,18,015,"Indiana","Carroll County",2,72,228,110,118
050,18,015,"Indiana","Carroll County",2,73,225,106,119
050,18,015,"Indiana","Carroll County",2,74,162,77,85
050,18,015,"Indiana","Carroll County",2,75,167,78,89
050,18,015,"Indiana","Carroll County",2,76,178,80,98
050,18,015,"Indiana","Carroll County",2,77,177,79,98
050,18,015,"Indiana","Carroll County",2,78,129,60,69
050,18,015,"Indiana","Carroll County",2,79,117,57,60
050,18,015,"Indiana","Carroll County",2,80,110,59,51
050,18,015,"Indiana","Carroll County",2,81,92,41,51
050,18,015,"Indiana","Carroll County",2,82,96,46,50
050,18,015,"Indiana","Carroll County",2,83,87,38,49
050,18,015,"Indiana","Carroll County",2,84,70,30,40
050,18,015,"Indiana","Carroll County",2,85,439,150,289
050,18,015,"Indiana","Carroll County",3,0,227,117,110
050,18,015,"Indiana","Carroll County",3,1,211,111,100
050,18,015,"Indiana","Carroll County",3,2,212,103,109
050,18,015,"Indiana","Carroll County",3,3,244,127,117
050,18,015,"Indiana","Carroll County",3,4,235,124,111
050,18,015,"Indiana","Carroll County",3,5,233,118,115
050,18,015,"Indiana","Carroll County",3,6,227,132,95
050,18,015,"Indiana","Carroll County",3,7,253,130,123
050,18,015,"Indiana","Carroll County",3,8,248,130,118
050,18,015,"Indiana","Carroll County",3,9,220,114,106
050,18,015,"Indiana","Carroll County",3,10,235,120,115
050,18,015,"Indiana","Carroll County",3,11,266,139,127
050,18,015,"Indiana","Carroll County",3,12,290,154,136
050,18,015,"Indiana","Carroll County",3,13,289,146,143
050,18,015,"Indiana","Carroll County",3,14,285,146,139
050,18,015,"Indiana","Carroll County",3,15,275,140,135
050,18,015,"Indiana","Carroll County",3,16,280,141,139
050,18,015,"Indiana","Carroll County",3,17,298,147,151
050,18,015,"Indiana","Carroll County",3,18,243,135,108
050,18,015,"Indiana","Carroll County",3,19,179,102,77
050,18,015,"Indiana","Carroll County",3,20,188,100,88
050,18,015,"Indiana","Carroll County",3,21,209,107,102
050,18,015,"Indiana","Carroll County",3,22,225,107,118
050,18,015,"Indiana","Carroll County",3,23,214,93,121
050,18,015,"Indiana","Carroll County",3,24,209,104,105
050,18,015,"Indiana","Carroll County",3,25,207,107,100
050,18,015,"Indiana","Carroll County",3,26,221,111,110
050,18,015,"Indiana","Carroll County",3,27,224,111,113
050,18,015,"Indiana","Carroll County",3,28,240,123,117
050,18,015,"Indiana","Carroll County",3,29,232,122,110
050,18,015,"Indiana","Carroll County",3,30,242,127,115
050,18,015,"Indiana","Carroll County",3,31,242,119,123
050,18,015,"Indiana","Carroll County",3,32,266,137,129
050,18,015,"Indiana","Carroll County",3,33,243,128,115
050,18,015,"Indiana","Carroll County",3,34,229,123,106
050,18,015,"Indiana","Carroll County",3,35,226,131,95
050,18,015,"Indiana","Carroll County",3,36,222,113,109
050,18,015,"Indiana","Carroll County",3,37,226,116,110
050,18,015,"Indiana","Carroll County",3,38,231,104,127
050,18,015,"Indiana","Carroll County",3,39,251,119,132
050,18,015,"Indiana","Carroll County",3,40,246,128,118
050,18,015,"Indiana","Carroll County",3,41,239,126,113
050,18,015,"Indiana","Carroll County",3,42,225,108,117
050,18,015,"Indiana","Carroll County",3,43,236,120,116
050,18,015,"Indiana","Carroll County",3,44,252,132,120
050,18,015,"Indiana","Carroll County",3,45,248,124,124
050,18,015,"Indiana","Carroll County",3,46,239,121,118
050,18,015,"Indiana","Carroll County",3,47,242,125,117
050,18,015,"Indiana","Carroll County",3,48,264,144,120
050,18,015,"Indiana","Carroll County",3,49,281,156,125
050,18,015,"Indiana","Carroll County",3,50,304,165,139
050,18,015,"Indiana","Carroll County",3,51,284,157,127
050,18,015,"Indiana","Carroll County",3,52,259,143,116
050,18,015,"Indiana","Carroll County",3,53,241,126,115
050,18,015,"Indiana","Carroll County",3,54,256,133,123
050,18,015,"Indiana","Carroll County",3,55,285,148,137
050,18,015,"Indiana","Carroll County",3,56,295,146,149
050,18,015,"Indiana","Carroll County",3,57,282,139,143
050,18,015,"Indiana","Carroll County",3,58,300,148,152
050,18,015,"Indiana","Carroll County",3,59,312,155,157
050,18,015,"Indiana","Carroll County",3,60,314,160,154
050,18,015,"Indiana","Carroll County",3,61,316,154,162
050,18,015,"Indiana","Carroll County",3,62,323,165,158
050,18,015,"Indiana","Carroll County",3,63,311,163,148
050,18,015,"Indiana","Carroll County",3,64,315,161,154
050,18,015,"Indiana","Carroll County",3,65,283,144,139
050,18,015,"Indiana","Carroll County",3,66,275,147,128
050,18,015,"Indiana","Carroll County",3,67,261,139,122
050,18,015,"Indiana","Carroll County",3,68,262,129,133
050,18,015,"Indiana","Carroll County",3,69,265,133,132
050,18,015,"Indiana","Carroll County",3,70,241,122,119
050,18,015,"Indiana","Carroll County",3,71,222,110,112
050,18,015,"Indiana","Carroll County",3,72,230,109,121
050,18,015,"Indiana","Carroll County",3,73,221,103,118
050,18,015,"Indiana","Carroll County",3,74,212,103,109
050,18,015,"Indiana","Carroll County",3,75,153,70,83
050,18,015,"Indiana","Carroll County",3,76,163,76,87
050,18,015,"Indiana","Carroll County",3,77,180,77,103
050,18,015,"Indiana","Carroll County",3,78,161,72,89
050,18,015,"Indiana","Carroll County",3,79,127,58,69
050,18,015,"Indiana","Carroll County",3,80,108,55,53
050,18,015,"Indiana","Carroll County",3,81,98,53,45
050,18,015,"Indiana","Carroll County",3,82,91,38,53
050,18,015,"Indiana","Carroll County",3,83,88,42,46
050,18,015,"Indiana","Carroll County",3,84,78,36,42
050,18,015,"Indiana","Carroll County",3,85,440,159,281
050,18,015,"Indiana","Carroll County",4,0,208,106,102
050,18,015,"Indiana","Carroll County",4,1,242,121,121
050,18,015,"Indiana","Carroll County",4,2,201,108,93
050,18,015,"Indiana","Carroll County",4,3,219,113,106
050,18,015,"Indiana","Carroll County",4,4,239,125,114
050,18,015,"Indiana","Carroll County",4,5,234,121,113
050,18,015,"Indiana","Carroll County",4,6,248,126,122
050,18,015,"Indiana","Carroll County",4,7,233,136,97
050,18,015,"Indiana","Carroll County",4,8,261,142,119
050,18,015,"Indiana","Carroll County",4,9,264,137,127
050,18,015,"Indiana","Carroll County",4,10,230,121,109
050,18,015,"Indiana","Carroll County",4,11,234,123,111
050,18,015,"Indiana","Carroll County",4,12,265,138,127
050,18,015,"Indiana","Carroll County",4,13,286,154,132
050,18,015,"Indiana","Carroll County",4,14,285,141,144
050,18,015,"Indiana","Carroll County",4,15,276,145,131
050,18,015,"Indiana","Carroll County",4,16,268,137,131
050,18,015,"Indiana","Carroll County",4,17,274,142,132
050,18,015,"Indiana","Carroll County",4,18,249,124,125
050,18,015,"Indiana","Carroll County",4,19,193,113,80
050,18,015,"Indiana","Carroll County",4,20,183,102,81
050,18,015,"Indiana","Carroll County",4,21,191,104,87
050,18,015,"Indiana","Carroll County",4,22,224,116,108
050,18,015,"Indiana","Carroll County",4,23,236,117,119
050,18,015,"Indiana","Carroll County",4,24,213,97,116
050,18,015,"Indiana","Carroll County",4,25,200,101,99
050,18,015,"Indiana","Carroll County",4,26,200,108,92
050,18,015,"Indiana","Carroll County",4,27,223,110,113
050,18,015,"Indiana","Carroll County",4,28,244,117,127
050,18,015,"Indiana","Carroll County",4,29,249,129,120
050,18,015,"Indiana","Carroll County",4,30,231,122,109
050,18,015,"Indiana","Carroll County",4,31,229,119,110
050,18,015,"Indiana","Carroll County",4,32,243,121,122
050,18,015,"Indiana","Carroll County",4,33,274,143,131
050,18,015,"Indiana","Carroll County",4,34,248,133,115
050,18,015,"Indiana","Carroll County",4,35,234,123,111
050,18,015,"Indiana","Carroll County",4,36,228,131,97
050,18,015,"Indiana","Carroll County",4,37,230,121,109
050,18,015,"Indiana","Carroll County",4,38,237,121,116
050,18,015,"Indiana","Carroll County",4,39,229,108,121
050,18,015,"Indiana","Carroll County",4,40,261,127,134
050,18,015,"Indiana","Carroll County",4,41,258,136,122
050,18,015,"Indiana","Carroll County",4,42,248,132,116
050,18,015,"Indiana","Carroll County",4,43,229,105,124
050,18,015,"Indiana","Carroll County",4,44,235,122,113
050,18,015,"Indiana","Carroll County",4,45,257,138,119
050,18,015,"Indiana","Carroll County",4,46,247,125,122
050,18,015,"Indiana","Carroll County",4,47,240,124,116
050,18,015,"Indiana","Carroll County",4,48,241,123,118
050,18,015,"Indiana","Carroll County",4,49,260,143,117
050,18,015,"Indiana","Carroll County",4,50,279,154,125
050,18,015,"Indiana","Carroll County",4,51,303,161,142
050,18,015,"Indiana","Carroll County",4,52,281,160,121
050,18,015,"Indiana","Carroll County",4,53,265,145,120
050,18,015,"Indiana","Carroll County",4,54,246,129,117
050,18,015,"Indiana","Carroll County",4,55,252,129,123
050,18,015,"Indiana","Carroll County",4,56,291,151,140
050,18,015,"Indiana","Carroll County",4,57,297,144,153
050,18,015,"Indiana","Carroll County",4,58,285,142,143
050,18,015,"Indiana","Carroll County",4,59,302,151,151
050,18,015,"Indiana","Carroll County",4,60,304,146,158
050,18,015,"Indiana","Carroll County",4,61,312,158,154
050,18,015,"Indiana","Carroll County",4,62,308,149,159
050,18,015,"Indiana","Carroll County",4,63,313,157,156
050,18,015,"Indiana","Carroll County",4,64,298,157,141
050,18,015,"Indiana","Carroll County",4,65,310,157,153
050,18,015,"Indiana","Carroll County",4,66,274,136,138
050,18,015,"Indiana","Carroll County",4,67,268,144,124
050,18,015,"Indiana","Carroll County",4,68,254,128,126
050,18,015,"Indiana","Carroll County",4,69,249,125,124
050,18,015,"Indiana","Carroll County",4,70,260,134,126
050,18,015,"Indiana","Carroll County",4,71,231,114,117
050,18,015,"Indiana","Carroll County",4,72,227,109,118
050,18,015,"Indiana","Carroll County",4,73,233,108,125
050,18,015,"Indiana","Carroll County",4,74,216,102,114
050,18,015,"Indiana","Carroll County",4,75,191,90,101
050,18,015,"Indiana","Carroll County",4,76,147,68,79
050,18,015,"Indiana","Carroll County",4,77,161,71,90
050,18,015,"Indiana","Carroll County",4,78,162,70,92
050,18,015,"Indiana","Carroll County",4,79,151,68,83
050,18,015,"Indiana","Carroll County",4,80,118,58,60
050,18,015,"Indiana","Carroll County",4,81,96,50,46
050,18,015,"Indiana","Carroll County",4,82,98,51,47
050,18,015,"Indiana","Carroll County",4,83,79,31,48
050,18,015,"Indiana","Carroll County",4,84,76,34,42
050,18,015,"Indiana","Carroll County",4,85,446,173,273
050,18,015,"Indiana","Carroll County",5,0,189,97,92
050,18,015,"Indiana","Carroll County",5,1,223,124,99
050,18,015,"Indiana","Carroll County",5,2,221,117,104
050,18,015,"Indiana","Carroll County",5,3,212,116,96
050,18,015,"Indiana","Carroll County",5,4,211,105,106
050,18,015,"Indiana","Carroll County",5,5,241,132,109
050,18,015,"Indiana","Carroll County",5,6,250,131,119
050,18,015,"Indiana","Carroll County",5,7,253,122,131
050,18,015,"Indiana","Carroll County",5,8,234,137,97
050,18,015,"Indiana","Carroll County",5,9,259,131,128
050,18,015,"Indiana","Carroll County",5,10,262,140,122
050,18,015,"Indiana","Carroll County",5,11,228,118,110
050,18,015,"Indiana","Carroll County",5,12,231,122,109
050,18,015,"Indiana","Carroll County",5,13,261,130,131
050,18,015,"Indiana","Carroll County",5,14,301,157,144
050,18,015,"Indiana","Carroll County",5,15,290,147,143
050,18,015,"Indiana","Carroll County",5,16,278,143,135
050,18,015,"Indiana","Carroll County",5,17,278,140,138
050,18,015,"Indiana","Carroll County",5,18,228,118,110
050,18,015,"Indiana","Carroll County",5,19,184,96,88
050,18,015,"Indiana","Carroll County",5,20,205,117,88
050,18,015,"Indiana","Carroll County",5,21,183,102,81
050,18,015,"Indiana","Carroll County",5,22,203,107,96
050,18,015,"Indiana","Carroll County",5,23,227,123,104
050,18,015,"Indiana","Carroll County",5,24,222,115,107
050,18,015,"Indiana","Carroll County",5,25,222,103,119
050,18,015,"Indiana","Carroll County",5,26,219,110,109
050,18,015,"Indiana","Carroll County",5,27,197,109,88
050,18,015,"Indiana","Carroll County",5,28,239,119,120
050,18,015,"Indiana","Carroll County",5,29,242,115,127
050,18,015,"Indiana","Carroll County",5,30,263,131,132
050,18,015,"Indiana","Carroll County",5,31,242,131,111
050,18,015,"Indiana","Carroll County",5,32,227,125,102
050,18,015,"Indiana","Carroll County",5,33,245,124,121
050,18,015,"Indiana","Carroll County",5,34,276,149,127
050,18,015,"Indiana","Carroll County",5,35,249,126,123
050,18,015,"Indiana","Carroll County",5,36,239,122,117
050,18,015,"Indiana","Carroll County",5,37,227,129,98
050,18,015,"Indiana","Carroll County",5,38,226,118,108
050,18,015,"Indiana","Carroll County",5,39,244,119,125
050,18,015,"Indiana","Carroll County",5,40,229,105,124
050,18,015,"Indiana","Carroll County",5,41,259,128,131
050,18,015,"Indiana","Carroll County",5,42,262,136,126
050,18,015,"Indiana","Carroll County",5,43,251,130,121
050,18,015,"Indiana","Carroll County",5,44,228,112,116
050,18,015,"Indiana","Carroll County",5,45,237,126,111
050,18,015,"Indiana","Carroll County",5,46,260,138,122
050,18,015,"Indiana","Carroll County",5,47,241,119,122
050,18,015,"Indiana","Carroll County",5,48,228,115,113
050,18,015,"Indiana","Carroll County",5,49,241,126,115
050,18,015,"Indiana","Carroll County",5,50,267,143,124
050,18,015,"Indiana","Carroll County",5,51,284,157,127
050,18,015,"Indiana","Carroll County",5,52,304,160,144
050,18,015,"Indiana","Carroll County",5,53,284,160,124
050,18,015,"Indiana","Carroll County",5,54,268,145,123
050,18,015,"Indiana","Carroll County",5,55,253,129,124
050,18,015,"Indiana","Carroll County",5,56,252,134,118
050,18,015,"Indiana","Carroll County",5,57,281,143,138
050,18,015,"Indiana","Carroll County",5,58,307,150,157
050,18,015,"Indiana","Carroll County",5,59,285,141,144
050,18,015,"Indiana","Carroll County",5,60,293,143,150
050,18,015,"Indiana","Carroll County",5,61,302,145,157
050,18,015,"Indiana","Carroll County",5,62,315,161,154
050,18,015,"Indiana","Carroll County",5,63,310,145,165
050,18,015,"Indiana","Carroll County",5,64,310,158,152
050,18,015,"Indiana","Carroll County",5,65,296,157,139
050,18,015,"Indiana","Carroll County",5,66,296,147,149
050,18,015,"Indiana","Carroll County",5,67,267,129,138
050,18,015,"Indiana","Carroll County",5,68,256,135,121
050,18,015,"Indiana","Carroll County",5,69,252,131,121
050,18,015,"Indiana","Carroll County",5,70,248,126,122
050,18,015,"Indiana","Carroll County",5,71,252,130,122
050,18,015,"Indiana","Carroll County",5,72,230,109,121
050,18,015,"Indiana","Carroll County",5,73,225,106,119
050,18,015,"Indiana","Carroll County",5,74,223,105,118
050,18,015,"Indiana","Carroll County",5,75,200,91,109
050,18,015,"Indiana","Carroll County",5,76,186,86,100
050,18,015,"Indiana","Carroll County",5,77,147,62,85
050,18,015,"Indiana","Carroll County",5,78,146,65,81
050,18,015,"Indiana","Carroll County",5,79,154,65,89
050,18,015,"Indiana","Carroll County",5,80,143,66,77
050,18,015,"Indiana","Carroll County",5,81,111,56,55
050,18,015,"Indiana","Carroll County",5,82,94,48,46
050,18,015,"Indiana","Carroll County",5,83,89,46,43
050,18,015,"Indiana","Carroll County",5,84,70,28,42
050,18,015,"Indiana","Carroll County",5,85,458,185,273
050,18,017,"Indiana","Cass County",1,0,395,199,196
050,18,017,"Indiana","Cass County",1,1,412,211,201
050,18,017,"Indiana","Cass County",1,2,437,234,203
050,18,017,"Indiana","Cass County",1,3,452,241,211
050,18,017,"Indiana","Cass County",1,4,491,250,241
050,18,017,"Indiana","Cass County",1,5,472,250,222
050,18,017,"Indiana","Cass County",1,6,439,214,225
050,18,017,"Indiana","Cass County",1,7,484,238,246
050,18,017,"Indiana","Cass County",1,8,476,233,243
050,18,017,"Indiana","Cass County",1,9,471,234,237
050,18,017,"Indiana","Cass County",1,10,498,269,229
050,18,017,"Indiana","Cass County",1,11,532,290,242
050,18,017,"Indiana","Cass County",1,12,515,265,250
050,18,017,"Indiana","Cass County",1,13,496,240,256
050,18,017,"Indiana","Cass County",1,14,518,245,273
050,18,017,"Indiana","Cass County",1,15,523,256,267
050,18,017,"Indiana","Cass County",1,16,528,261,267
050,18,017,"Indiana","Cass County",1,17,527,274,253
050,18,017,"Indiana","Cass County",1,18,464,248,216
050,18,017,"Indiana","Cass County",1,19,387,210,177
050,18,017,"Indiana","Cass County",1,20,412,219,193
050,18,017,"Indiana","Cass County",1,21,430,226,204
050,18,017,"Indiana","Cass County",1,22,445,225,220
050,18,017,"Indiana","Cass County",1,23,447,228,219
050,18,017,"Indiana","Cass County",1,24,433,230,203
050,18,017,"Indiana","Cass County",1,25,421,205,216
050,18,017,"Indiana","Cass County",1,26,468,235,233
050,18,017,"Indiana","Cass County",1,27,463,243,220
050,18,017,"Indiana","Cass County",1,28,479,251,228
050,18,017,"Indiana","Cass County",1,29,414,236,178
050,18,017,"Indiana","Cass County",1,30,435,229,206
050,18,017,"Indiana","Cass County",1,31,382,195,187
050,18,017,"Indiana","Cass County",1,32,388,200,188
050,18,017,"Indiana","Cass County",1,33,426,216,210
050,18,017,"Indiana","Cass County",1,34,435,216,219
050,18,017,"Indiana","Cass County",1,35,437,218,219
050,18,017,"Indiana","Cass County",1,36,456,231,225
050,18,017,"Indiana","Cass County",1,37,509,254,255
050,18,017,"Indiana","Cass County",1,38,467,226,241
050,18,017,"Indiana","Cass County",1,39,437,215,222
050,18,017,"Indiana","Cass County",1,40,480,230,250
050,18,017,"Indiana","Cass County",1,41,490,261,229
050,18,017,"Indiana","Cass County",1,42,491,257,234
050,18,017,"Indiana","Cass County",1,43,465,238,227
050,18,017,"Indiana","Cass County",1,44,489,255,234
050,18,017,"Indiana","Cass County",1,45,453,226,227
050,18,017,"Indiana","Cass County",1,46,450,226,224
050,18,017,"Indiana","Cass County",1,47,498,251,247
050,18,017,"Indiana","Cass County",1,48,493,254,239
050,18,017,"Indiana","Cass County",1,49,536,288,248
050,18,017,"Indiana","Cass County",1,50,491,261,230
050,18,017,"Indiana","Cass County",1,51,492,257,235
050,18,017,"Indiana","Cass County",1,52,498,268,230
050,18,017,"Indiana","Cass County",1,53,510,278,232
050,18,017,"Indiana","Cass County",1,54,468,243,225
050,18,017,"Indiana","Cass County",1,55,521,259,262
050,18,017,"Indiana","Cass County",1,56,523,265,258
050,18,017,"Indiana","Cass County",1,57,551,289,262
050,18,017,"Indiana","Cass County",1,58,545,284,261
050,18,017,"Indiana","Cass County",1,59,542,265,277
050,18,017,"Indiana","Cass County",1,60,547,271,276
050,18,017,"Indiana","Cass County",1,61,543,283,260
050,18,017,"Indiana","Cass County",1,62,553,296,257
050,18,017,"Indiana","Cass County",1,63,535,272,263
050,18,017,"Indiana","Cass County",1,64,519,257,262
050,18,017,"Indiana","Cass County",1,65,484,248,236
050,18,017,"Indiana","Cass County",1,66,465,228,237
050,18,017,"Indiana","Cass County",1,67,427,197,230
050,18,017,"Indiana","Cass County",1,68,417,195,222
050,18,017,"Indiana","Cass County",1,69,390,187,203
050,18,017,"Indiana","Cass County",1,70,398,190,208
050,18,017,"Indiana","Cass County",1,71,371,176,195
050,18,017,"Indiana","Cass County",1,72,359,165,194
050,18,017,"Indiana","Cass County",1,73,366,180,186
050,18,017,"Indiana","Cass County",1,74,247,113,134
050,18,017,"Indiana","Cass County",1,75,262,115,147
050,18,017,"Indiana","Cass County",1,76,278,131,147
050,18,017,"Indiana","Cass County",1,77,263,118,145
050,18,017,"Indiana","Cass County",1,78,246,100,146
050,18,017,"Indiana","Cass County",1,79,210,77,133
050,18,017,"Indiana","Cass County",1,80,184,69,115
050,18,017,"Indiana","Cass County",1,81,188,79,109
050,18,017,"Indiana","Cass County",1,82,180,74,106
050,18,017,"Indiana","Cass County",1,83,160,75,85
050,18,017,"Indiana","Cass County",1,84,138,49,89
050,18,017,"Indiana","Cass County",1,85,842,284,558
050,18,017,"Indiana","Cass County",2,0,394,203,191
050,18,017,"Indiana","Cass County",2,1,406,209,197
050,18,017,"Indiana","Cass County",2,2,430,228,202
050,18,017,"Indiana","Cass County",2,3,447,238,209
050,18,017,"Indiana","Cass County",2,4,480,246,234
050,18,017,"Indiana","Cass County",2,5,477,250,227
050,18,017,"Indiana","Cass County",2,6,449,224,225
050,18,017,"Indiana","Cass County",2,7,473,231,242
050,18,017,"Indiana","Cass County",2,8,476,234,242
050,18,017,"Indiana","Cass County",2,9,472,235,237
050,18,017,"Indiana","Cass County",2,10,492,262,230
050,18,017,"Indiana","Cass County",2,11,519,281,238
050,18,017,"Indiana","Cass County",2,12,518,269,249
050,18,017,"Indiana","Cass County",2,13,499,245,254
050,18,017,"Indiana","Cass County",2,14,512,241,271
050,18,017,"Indiana","Cass County",2,15,524,253,271
050,18,017,"Indiana","Cass County",2,16,526,261,265
050,18,017,"Indiana","Cass County",2,17,529,271,258
050,18,017,"Indiana","Cass County",2,18,457,242,215
050,18,017,"Indiana","Cass County",2,19,389,210,179
050,18,017,"Indiana","Cass County",2,20,414,223,191
050,18,017,"Indiana","Cass County",2,21,426,225,201
050,18,017,"Indiana","Cass County",2,22,448,229,219
050,18,017,"Indiana","Cass County",2,23,448,227,221
050,18,017,"Indiana","Cass County",2,24,437,227,210
050,18,017,"Indiana","Cass County",2,25,427,213,214
050,18,017,"Indiana","Cass County",2,26,457,229,228
050,18,017,"Indiana","Cass County",2,27,464,240,224
050,18,017,"Indiana","Cass County",2,28,469,249,220
050,18,017,"Indiana","Cass County",2,29,429,240,189
050,18,017,"Indiana","Cass County",2,30,430,232,198
050,18,017,"Indiana","Cass County",2,31,392,202,190
050,18,017,"Indiana","Cass County",2,32,382,196,186
050,18,017,"Indiana","Cass County",2,33,417,213,204
050,18,017,"Indiana","Cass County",2,34,432,217,215
050,18,017,"Indiana","Cass County",2,35,440,221,219
050,18,017,"Indiana","Cass County",2,36,447,226,221
050,18,017,"Indiana","Cass County",2,37,494,248,246
050,18,017,"Indiana","Cass County",2,38,472,228,244
050,18,017,"Indiana","Cass County",2,39,447,216,231
050,18,017,"Indiana","Cass County",2,40,474,230,244
050,18,017,"Indiana","Cass County",2,41,490,253,237
050,18,017,"Indiana","Cass County",2,42,490,256,234
050,18,017,"Indiana","Cass County",2,43,474,245,229
050,18,017,"Indiana","Cass County",2,44,478,247,231
050,18,017,"Indiana","Cass County",2,45,459,231,228
050,18,017,"Indiana","Cass County",2,46,444,222,222
050,18,017,"Indiana","Cass County",2,47,486,246,240
050,18,017,"Indiana","Cass County",2,48,493,255,238
050,18,017,"Indiana","Cass County",2,49,528,282,246
050,18,017,"Indiana","Cass County",2,50,503,267,236
050,18,017,"Indiana","Cass County",2,51,487,256,231
050,18,017,"Indiana","Cass County",2,52,493,261,232
050,18,017,"Indiana","Cass County",2,53,503,275,228
050,18,017,"Indiana","Cass County",2,54,474,248,226
050,18,017,"Indiana","Cass County",2,55,507,254,253
050,18,017,"Indiana","Cass County",2,56,523,264,259
050,18,017,"Indiana","Cass County",2,57,542,283,259
050,18,017,"Indiana","Cass County",2,58,550,289,261
050,18,017,"Indiana","Cass County",2,59,540,270,270
050,18,017,"Indiana","Cass County",2,60,542,268,274
050,18,017,"Indiana","Cass County",2,61,541,279,262
050,18,017,"Indiana","Cass County",2,62,549,291,258
050,18,017,"Indiana","Cass County",2,63,540,279,261
050,18,017,"Indiana","Cass County",2,64,518,258,260
050,18,017,"Indiana","Cass County",2,65,488,249,239
050,18,017,"Indiana","Cass County",2,66,467,231,236
050,18,017,"Indiana","Cass County",2,67,435,203,232
050,18,017,"Indiana","Cass County",2,68,415,193,222
050,18,017,"Indiana","Cass County",2,69,395,188,207
050,18,017,"Indiana","Cass County",2,70,392,189,203
050,18,017,"Indiana","Cass County",2,71,375,179,196
050,18,017,"Indiana","Cass County",2,72,354,165,189
050,18,017,"Indiana","Cass County",2,73,379,182,197
050,18,017,"Indiana","Cass County",2,74,258,121,137
050,18,017,"Indiana","Cass County",2,75,258,115,143
050,18,017,"Indiana","Cass County",2,76,271,125,146
050,18,017,"Indiana","Cass County",2,77,269,120,149
050,18,017,"Indiana","Cass County",2,78,242,101,141
050,18,017,"Indiana","Cass County",2,79,218,82,136
050,18,017,"Indiana","Cass County",2,80,190,72,118
050,18,017,"Indiana","Cass County",2,81,183,73,110
050,18,017,"Indiana","Cass County",2,82,183,77,106
050,18,017,"Indiana","Cass County",2,83,164,75,89
050,18,017,"Indiana","Cass County",2,84,141,56,85
050,18,017,"Indiana","Cass County",2,85,840,281,559
050,18,017,"Indiana","Cass County",3,0,447,247,200
050,18,017,"Indiana","Cass County",3,1,411,213,198
050,18,017,"Indiana","Cass County",3,2,414,211,203
050,18,017,"Indiana","Cass County",3,3,423,216,207
050,18,017,"Indiana","Cass County",3,4,454,233,221
050,18,017,"Indiana","Cass County",3,5,477,241,236
050,18,017,"Indiana","Cass County",3,6,477,249,228
050,18,017,"Indiana","Cass County",3,7,468,241,227
050,18,017,"Indiana","Cass County",3,8,476,231,245
050,18,017,"Indiana","Cass County",3,9,479,241,238
050,18,017,"Indiana","Cass County",3,10,464,236,228
050,18,017,"Indiana","Cass County",3,11,489,255,234
050,18,017,"Indiana","Cass County",3,12,523,294,229
050,18,017,"Indiana","Cass County",3,13,519,269,250
050,18,017,"Indiana","Cass County",3,14,499,244,255
050,18,017,"Indiana","Cass County",3,15,521,252,269
050,18,017,"Indiana","Cass County",3,16,522,260,262
050,18,017,"Indiana","Cass County",3,17,538,275,263
050,18,017,"Indiana","Cass County",3,18,455,241,214
050,18,017,"Indiana","Cass County",3,19,358,191,167
050,18,017,"Indiana","Cass County",3,20,425,225,200
050,18,017,"Indiana","Cass County",3,21,426,224,202
050,18,017,"Indiana","Cass County",3,22,444,240,204
050,18,017,"Indiana","Cass County",3,23,426,227,199
050,18,017,"Indiana","Cass County",3,24,440,220,220
050,18,017,"Indiana","Cass County",3,25,447,235,212
050,18,017,"Indiana","Cass County",3,26,435,216,219
050,18,017,"Indiana","Cass County",3,27,452,238,214
050,18,017,"Indiana","Cass County",3,28,458,233,225
050,18,017,"Indiana","Cass County",3,29,476,266,210
050,18,017,"Indiana","Cass County",3,30,425,237,188
050,18,017,"Indiana","Cass County",3,31,441,232,209
050,18,017,"Indiana","Cass County",3,32,378,191,187
050,18,017,"Indiana","Cass County",3,33,398,202,196
050,18,017,"Indiana","Cass County",3,34,431,212,219
050,18,017,"Indiana","Cass County",3,35,435,218,217
050,18,017,"Indiana","Cass County",3,36,443,225,218
050,18,017,"Indiana","Cass County",3,37,448,225,223
050,18,017,"Indiana","Cass County",3,38,484,235,249
050,18,017,"Indiana","Cass County",3,39,481,231,250
050,18,017,"Indiana","Cass County",3,40,443,222,221
050,18,017,"Indiana","Cass County",3,41,481,232,249
050,18,017,"Indiana","Cass County",3,42,498,256,242
050,18,017,"Indiana","Cass County",3,43,485,256,229
050,18,017,"Indiana","Cass County",3,44,461,237,224
050,18,017,"Indiana","Cass County",3,45,460,234,226
050,18,017,"Indiana","Cass County",3,46,454,237,217
050,18,017,"Indiana","Cass County",3,47,447,220,227
050,18,017,"Indiana","Cass County",3,48,475,240,235
050,18,017,"Indiana","Cass County",3,49,495,252,243
050,18,017,"Indiana","Cass County",3,50,515,282,233
050,18,017,"Indiana","Cass County",3,51,501,276,225
050,18,017,"Indiana","Cass County",3,52,477,246,231
050,18,017,"Indiana","Cass County",3,53,485,260,225
050,18,017,"Indiana","Cass County",3,54,489,268,221
050,18,017,"Indiana","Cass County",3,55,472,243,229
050,18,017,"Indiana","Cass County",3,56,495,242,253
050,18,017,"Indiana","Cass County",3,57,519,263,256
050,18,017,"Indiana","Cass County",3,58,527,276,251
050,18,017,"Indiana","Cass County",3,59,530,281,249
050,18,017,"Indiana","Cass County",3,60,536,264,272
050,18,017,"Indiana","Cass County",3,61,536,265,271
050,18,017,"Indiana","Cass County",3,62,521,270,251
050,18,017,"Indiana","Cass County",3,63,536,281,255
050,18,017,"Indiana","Cass County",3,64,526,274,252
050,18,017,"Indiana","Cass County",3,65,513,258,255
050,18,017,"Indiana","Cass County",3,66,473,242,231
050,18,017,"Indiana","Cass County",3,67,457,225,232
050,18,017,"Indiana","Cass County",3,68,418,199,219
050,18,017,"Indiana","Cass County",3,69,402,186,216
050,18,017,"Indiana","Cass County",3,70,382,180,202
050,18,017,"Indiana","Cass County",3,71,367,180,187
050,18,017,"Indiana","Cass County",3,72,361,170,191
050,18,017,"Indiana","Cass County",3,73,345,162,183
050,18,017,"Indiana","Cass County",3,74,356,167,189
050,18,017,"Indiana","Cass County",3,75,243,113,130
050,18,017,"Indiana","Cass County",3,76,245,110,135
050,18,017,"Indiana","Cass County",3,77,258,117,141
050,18,017,"Indiana","Cass County",3,78,248,113,135
050,18,017,"Indiana","Cass County",3,79,235,93,142
050,18,017,"Indiana","Cass County",3,80,199,79,120
050,18,017,"Indiana","Cass County",3,81,169,60,109
050,18,017,"Indiana","Cass County",3,82,176,69,107
050,18,017,"Indiana","Cass County",3,83,159,68,91
050,18,017,"Indiana","Cass County",3,84,153,68,85
050,18,017,"Indiana","Cass County",3,85,828,277,551
050,18,017,"Indiana","Cass County",4,0,489,276,213
050,18,017,"Indiana","Cass County",4,1,419,227,192
050,18,017,"Indiana","Cass County",4,2,423,218,205
050,18,017,"Indiana","Cass County",4,3,414,218,196
050,18,017,"Indiana","Cass County",4,4,446,231,215
050,18,017,"Indiana","Cass County",4,5,456,232,224
050,18,017,"Indiana","Cass County",4,6,491,260,231
050,18,017,"Indiana","Cass County",4,7,489,264,225
050,18,017,"Indiana","Cass County",4,8,472,245,227
050,18,017,"Indiana","Cass County",4,9,505,241,264
050,18,017,"Indiana","Cass County",4,10,482,237,245
050,18,017,"Indiana","Cass County",4,11,484,250,234
050,18,017,"Indiana","Cass County",4,12,502,269,233
050,18,017,"Indiana","Cass County",4,13,538,292,246
050,18,017,"Indiana","Cass County",4,14,523,278,245
050,18,017,"Indiana","Cass County",4,15,498,248,250
050,18,017,"Indiana","Cass County",4,16,517,251,266
050,18,017,"Indiana","Cass County",4,17,537,272,265
050,18,017,"Indiana","Cass County",4,18,486,266,220
050,18,017,"Indiana","Cass County",4,19,360,188,172
050,18,017,"Indiana","Cass County",4,20,395,211,184
050,18,017,"Indiana","Cass County",4,21,440,232,208
050,18,017,"Indiana","Cass County",4,22,424,213,211
050,18,017,"Indiana","Cass County",4,23,416,231,185
050,18,017,"Indiana","Cass County",4,24,419,220,199
050,18,017,"Indiana","Cass County",4,25,442,230,212
050,18,017,"Indiana","Cass County",4,26,446,241,205
050,18,017,"Indiana","Cass County",4,27,393,194,199
050,18,017,"Indiana","Cass County",4,28,460,242,218
050,18,017,"Indiana","Cass County",4,29,459,242,217
050,18,017,"Indiana","Cass County",4,30,465,254,211
050,18,017,"Indiana","Cass County",4,31,428,240,188
050,18,017,"Indiana","Cass County",4,32,443,223,220
050,18,017,"Indiana","Cass County",4,33,390,196,194
050,18,017,"Indiana","Cass County",4,34,410,213,197
050,18,017,"Indiana","Cass County",4,35,432,216,216
050,18,017,"Indiana","Cass County",4,36,447,230,217
050,18,017,"Indiana","Cass County",4,37,443,223,220
050,18,017,"Indiana","Cass County",4,38,451,225,226
050,18,017,"Indiana","Cass County",4,39,494,232,262
050,18,017,"Indiana","Cass County",4,40,487,232,255
050,18,017,"Indiana","Cass County",4,41,452,222,230
050,18,017,"Indiana","Cass County",4,42,464,224,240
050,18,017,"Indiana","Cass County",4,43,495,261,234
050,18,017,"Indiana","Cass County",4,44,481,252,229
050,18,017,"Indiana","Cass County",4,45,447,228,219
050,18,017,"Indiana","Cass County",4,46,474,245,229
050,18,017,"Indiana","Cass County",4,47,465,245,220
050,18,017,"Indiana","Cass County",4,48,445,215,230
050,18,017,"Indiana","Cass County",4,49,474,240,234
050,18,017,"Indiana","Cass County",4,50,494,244,250
050,18,017,"Indiana","Cass County",4,51,515,281,234
050,18,017,"Indiana","Cass County",4,52,487,267,220
050,18,017,"Indiana","Cass County",4,53,493,255,238
050,18,017,"Indiana","Cass County",4,54,480,258,222
050,18,017,"Indiana","Cass County",4,55,488,269,219
050,18,017,"Indiana","Cass County",4,56,466,240,226
050,18,017,"Indiana","Cass County",4,57,498,246,252
050,18,017,"Indiana","Cass County",4,58,513,261,252
050,18,017,"Indiana","Cass County",4,59,512,271,241
050,18,017,"Indiana","Cass County",4,60,521,272,249
050,18,017,"Indiana","Cass County",4,61,521,255,266
050,18,017,"Indiana","Cass County",4,62,530,264,266
050,18,017,"Indiana","Cass County",4,63,510,262,248
050,18,017,"Indiana","Cass County",4,64,525,280,245
050,18,017,"Indiana","Cass County",4,65,524,275,249
050,18,017,"Indiana","Cass County",4,66,495,249,246
050,18,017,"Indiana","Cass County",4,67,452,235,217
050,18,017,"Indiana","Cass County",4,68,452,222,230
050,18,017,"Indiana","Cass County",4,69,404,188,216
050,18,017,"Indiana","Cass County",4,70,389,180,209
050,18,017,"Indiana","Cass County",4,71,368,176,192
050,18,017,"Indiana","Cass County",4,72,353,169,184
050,18,017,"Indiana","Cass County",4,73,345,167,178
050,18,017,"Indiana","Cass County",4,74,329,153,176
050,18,017,"Indiana","Cass County",4,75,341,158,183
050,18,017,"Indiana","Cass County",4,76,228,103,125
050,18,017,"Indiana","Cass County",4,77,234,104,130
050,18,017,"Indiana","Cass County",4,78,245,113,132
050,18,017,"Indiana","Cass County",4,79,226,102,124
050,18,017,"Indiana","Cass County",4,80,219,89,130
050,18,017,"Indiana","Cass County",4,81,175,65,110
050,18,017,"Indiana","Cass County",4,82,158,55,103
050,18,017,"Indiana","Cass County",4,83,154,61,93
050,18,017,"Indiana","Cass County",4,84,145,60,85
050,18,017,"Indiana","Cass County",4,85,836,289,547
050,18,017,"Indiana","Cass County",5,0,478,271,207
050,18,017,"Indiana","Cass County",5,1,509,277,232
050,18,017,"Indiana","Cass County",5,2,437,231,206
050,18,017,"Indiana","Cass County",5,3,415,218,197
050,18,017,"Indiana","Cass County",5,4,425,216,209
050,18,017,"Indiana","Cass County",5,5,454,231,223
050,18,017,"Indiana","Cass County",5,6,479,249,230
050,18,017,"Indiana","Cass County",5,7,488,258,230
050,18,017,"Indiana","Cass County",5,8,486,261,225
050,18,017,"Indiana","Cass County",5,9,479,251,228
050,18,017,"Indiana","Cass County",5,10,497,243,254
050,18,017,"Indiana","Cass County",5,11,488,245,243
050,18,017,"Indiana","Cass County",5,12,487,247,240
050,18,017,"Indiana","Cass County",5,13,514,276,238
050,18,017,"Indiana","Cass County",5,14,528,283,245
050,18,017,"Indiana","Cass County",5,15,523,280,243
050,18,017,"Indiana","Cass County",5,16,500,254,246
050,18,017,"Indiana","Cass County",5,17,540,268,272
050,18,017,"Indiana","Cass County",5,18,473,256,217
050,18,017,"Indiana","Cass County",5,19,391,212,179
050,18,017,"Indiana","Cass County",5,20,395,201,194
050,18,017,"Indiana","Cass County",5,21,424,229,195
050,18,017,"Indiana","Cass County",5,22,465,240,225
050,18,017,"Indiana","Cass County",5,23,414,210,204
050,18,017,"Indiana","Cass County",5,24,425,224,201
050,18,017,"Indiana","Cass County",5,25,433,242,191
050,18,017,"Indiana","Cass County",5,26,460,242,218
050,18,017,"Indiana","Cass County",5,27,454,242,212
050,18,017,"Indiana","Cass County",5,28,377,186,191
050,18,017,"Indiana","Cass County",5,29,474,247,227
050,18,017,"Indiana","Cass County",5,30,458,236,222
050,18,017,"Indiana","Cass County",5,31,476,256,220
050,18,017,"Indiana","Cass County",5,32,443,244,199
050,18,017,"Indiana","Cass County",5,33,463,235,228
050,18,017,"Indiana","Cass County",5,34,400,203,197
050,18,017,"Indiana","Cass County",5,35,404,209,195
050,18,017,"Indiana","Cass County",5,36,431,216,215
050,18,017,"Indiana","Cass County",5,37,442,221,221
050,18,017,"Indiana","Cass County",5,38,432,212,220
050,18,017,"Indiana","Cass County",5,39,452,226,226
050,18,017,"Indiana","Cass County",5,40,508,242,266
050,18,017,"Indiana","Cass County",5,41,486,230,256
050,18,017,"Indiana","Cass County",5,42,445,226,219
050,18,017,"Indiana","Cass County",5,43,461,221,240
050,18,017,"Indiana","Cass County",5,44,492,261,231
050,18,017,"Indiana","Cass County",5,45,479,250,229
050,18,017,"Indiana","Cass County",5,46,452,228,224
050,18,017,"Indiana","Cass County",5,47,489,253,236
050,18,017,"Indiana","Cass County",5,48,455,239,216
050,18,017,"Indiana","Cass County",5,49,434,214,220
050,18,017,"Indiana","Cass County",5,50,478,240,238
050,18,017,"Indiana","Cass County",5,51,497,244,253
050,18,017,"Indiana","Cass County",5,52,507,272,235
050,18,017,"Indiana","Cass County",5,53,490,268,222
050,18,017,"Indiana","Cass County",5,54,485,253,232
050,18,017,"Indiana","Cass County",5,55,480,260,220
050,18,017,"Indiana","Cass County",5,56,488,271,217
050,18,017,"Indiana","Cass County",5,57,464,235,229
050,18,017,"Indiana","Cass County",5,58,497,245,252
050,18,017,"Indiana","Cass County",5,59,506,260,246
050,18,017,"Indiana","Cass County",5,60,510,271,239
050,18,017,"Indiana","Cass County",5,61,516,265,251
050,18,017,"Indiana","Cass County",5,62,503,246,257
050,18,017,"Indiana","Cass County",5,63,526,259,267
050,18,017,"Indiana","Cass County",5,64,511,265,246
050,18,017,"Indiana","Cass County",5,65,522,278,244
050,18,017,"Indiana","Cass County",5,66,509,264,245
050,18,017,"Indiana","Cass County",5,67,486,242,244
050,18,017,"Indiana","Cass County",5,68,431,226,205
050,18,017,"Indiana","Cass County",5,69,439,211,228
050,18,017,"Indiana","Cass County",5,70,395,182,213
050,18,017,"Indiana","Cass County",5,71,372,176,196
050,18,017,"Indiana","Cass County",5,72,357,167,190
050,18,017,"Indiana","Cass County",5,73,339,164,175
050,18,017,"Indiana","Cass County",5,74,328,157,171
050,18,017,"Indiana","Cass County",5,75,320,146,174
050,18,017,"Indiana","Cass County",5,76,328,151,177
050,18,017,"Indiana","Cass County",5,77,218,97,121
050,18,017,"Indiana","Cass County",5,78,222,104,118
050,18,017,"Indiana","Cass County",5,79,230,107,123
050,18,017,"Indiana","Cass County",5,80,210,96,114
050,18,017,"Indiana","Cass County",5,81,200,75,125
050,18,017,"Indiana","Cass County",5,82,163,60,103
050,18,017,"Indiana","Cass County",5,83,137,47,90
050,18,017,"Indiana","Cass County",5,84,144,56,88
050,18,017,"Indiana","Cass County",5,85,844,291,553
050,18,019,"Indiana","Clark County",1,0,1394,713,681
050,18,019,"Indiana","Clark County",1,1,1418,713,705
050,18,019,"Indiana","Clark County",1,2,1502,739,763
050,18,019,"Indiana","Clark County",1,3,1481,745,736
050,18,019,"Indiana","Clark County",1,4,1549,809,740
050,18,019,"Indiana","Clark County",1,5,1501,746,755
050,18,019,"Indiana","Clark County",1,6,1478,754,724
050,18,019,"Indiana","Clark County",1,7,1490,764,726
050,18,019,"Indiana","Clark County",1,8,1503,769,734
050,18,019,"Indiana","Clark County",1,9,1498,782,716
050,18,019,"Indiana","Clark County",1,10,1550,798,752
050,18,019,"Indiana","Clark County",1,11,1625,816,809
050,18,019,"Indiana","Clark County",1,12,1594,808,786
050,18,019,"Indiana","Clark County",1,13,1591,790,801
050,18,019,"Indiana","Clark County",1,14,1555,767,788
050,18,019,"Indiana","Clark County",1,15,1505,797,708
050,18,019,"Indiana","Clark County",1,16,1546,812,734
050,18,019,"Indiana","Clark County",1,17,1521,787,734
050,18,019,"Indiana","Clark County",1,18,1295,696,599
050,18,019,"Indiana","Clark County",1,19,1105,595,510
050,18,019,"Indiana","Clark County",1,20,1210,614,596
050,18,019,"Indiana","Clark County",1,21,1296,644,652
050,18,019,"Indiana","Clark County",1,22,1370,651,719
050,18,019,"Indiana","Clark County",1,23,1476,739,737
050,18,019,"Indiana","Clark County",1,24,1471,751,720
050,18,019,"Indiana","Clark County",1,25,1553,778,775
050,18,019,"Indiana","Clark County",1,26,1645,816,829
050,18,019,"Indiana","Clark County",1,27,1682,810,872
050,18,019,"Indiana","Clark County",1,28,1813,905,908
050,18,019,"Indiana","Clark County",1,29,1742,862,880
050,18,019,"Indiana","Clark County",1,30,1726,842,884
050,18,019,"Indiana","Clark County",1,31,1716,861,855
050,18,019,"Indiana","Clark County",1,32,1650,821,829
050,18,019,"Indiana","Clark County",1,33,1682,843,839
050,18,019,"Indiana","Clark County",1,34,1641,823,818
050,18,019,"Indiana","Clark County",1,35,1605,796,809
050,18,019,"Indiana","Clark County",1,36,1506,760,746
050,18,019,"Indiana","Clark County",1,37,1649,850,799
050,18,019,"Indiana","Clark County",1,38,1732,894,838
050,18,019,"Indiana","Clark County",1,39,1651,837,814
050,18,019,"Indiana","Clark County",1,40,1732,850,882
050,18,019,"Indiana","Clark County",1,41,1677,857,820
050,18,019,"Indiana","Clark County",1,42,1497,763,734
050,18,019,"Indiana","Clark County",1,43,1525,760,765
050,18,019,"Indiana","Clark County",1,44,1550,740,810
050,18,019,"Indiana","Clark County",1,45,1547,776,771
050,18,019,"Indiana","Clark County",1,46,1483,759,724
050,18,019,"Indiana","Clark County",1,47,1585,809,776
050,18,019,"Indiana","Clark County",1,48,1733,865,868
050,18,019,"Indiana","Clark County",1,49,1806,904,902
050,18,019,"Indiana","Clark County",1,50,1656,864,792
050,18,019,"Indiana","Clark County",1,51,1574,796,778
050,18,019,"Indiana","Clark County",1,52,1469,721,748
050,18,019,"Indiana","Clark County",1,53,1476,705,771
050,18,019,"Indiana","Clark County",1,54,1553,752,801
050,18,019,"Indiana","Clark County",1,55,1653,821,832
050,18,019,"Indiana","Clark County",1,56,1736,885,851
050,18,019,"Indiana","Clark County",1,57,1687,848,839
050,18,019,"Indiana","Clark County",1,58,1713,833,880
050,18,019,"Indiana","Clark County",1,59,1642,814,828
050,18,019,"Indiana","Clark County",1,60,1687,835,852
050,18,019,"Indiana","Clark County",1,61,1578,738,840
050,18,019,"Indiana","Clark County",1,62,1639,776,863
050,18,019,"Indiana","Clark County",1,63,1574,740,834
050,18,019,"Indiana","Clark County",1,64,1466,680,786
050,18,019,"Indiana","Clark County",1,65,1443,691,752
050,18,019,"Indiana","Clark County",1,66,1433,686,747
050,18,019,"Indiana","Clark County",1,67,1331,617,714
050,18,019,"Indiana","Clark County",1,68,1305,580,725
050,18,019,"Indiana","Clark County",1,69,1188,535,653
050,18,019,"Indiana","Clark County",1,70,1182,545,637
050,18,019,"Indiana","Clark County",1,71,1123,506,617
050,18,019,"Indiana","Clark County",1,72,1164,527,637
050,18,019,"Indiana","Clark County",1,73,1155,523,632
050,18,019,"Indiana","Clark County",1,74,778,354,424
050,18,019,"Indiana","Clark County",1,75,752,328,424
050,18,019,"Indiana","Clark County",1,76,750,338,412
050,18,019,"Indiana","Clark County",1,77,741,323,418
050,18,019,"Indiana","Clark County",1,78,605,269,336
050,18,019,"Indiana","Clark County",1,79,524,223,301
050,18,019,"Indiana","Clark County",1,80,450,191,259
050,18,019,"Indiana","Clark County",1,81,432,156,276
050,18,019,"Indiana","Clark County",1,82,444,169,275
050,18,019,"Indiana","Clark County",1,83,354,138,216
050,18,019,"Indiana","Clark County",1,84,338,109,229
050,18,019,"Indiana","Clark County",1,85,1846,598,1248
050,18,019,"Indiana","Clark County",2,0,1386,713,673
050,18,019,"Indiana","Clark County",2,1,1411,714,697
050,18,019,"Indiana","Clark County",2,2,1483,733,750
050,18,019,"Indiana","Clark County",2,3,1481,742,739
050,18,019,"Indiana","Clark County",2,4,1534,792,742
050,18,019,"Indiana","Clark County",2,5,1512,759,753
050,18,019,"Indiana","Clark County",2,6,1491,756,735
050,18,019,"Indiana","Clark County",2,7,1496,769,727
050,18,019,"Indiana","Clark County",2,8,1503,768,735
050,18,019,"Indiana","Clark County",2,9,1498,778,720
050,18,019,"Indiana","Clark County",2,10,1537,794,743
050,18,019,"Indiana","Clark County",2,11,1604,811,793
050,18,019,"Indiana","Clark County",2,12,1607,814,793
050,18,019,"Indiana","Clark County",2,13,1593,795,798
050,18,019,"Indiana","Clark County",2,14,1566,774,792
050,18,019,"Indiana","Clark County",2,15,1517,790,727
050,18,019,"Indiana","Clark County",2,16,1540,812,728
050,18,019,"Indiana","Clark County",2,17,1528,793,735
050,18,019,"Indiana","Clark County",2,18,1295,695,600
050,18,019,"Indiana","Clark County",2,19,1103,594,509
050,18,019,"Indiana","Clark County",2,20,1224,631,593
050,18,019,"Indiana","Clark County",2,21,1295,645,650
050,18,019,"Indiana","Clark County",2,22,1387,665,722
050,18,019,"Indiana","Clark County",2,23,1477,729,748
050,18,019,"Indiana","Clark County",2,24,1486,753,733
050,18,019,"Indiana","Clark County",2,25,1559,789,770
050,18,019,"Indiana","Clark County",2,26,1638,809,829
050,18,019,"Indiana","Clark County",2,27,1687,821,866
050,18,019,"Indiana","Clark County",2,28,1800,894,906
050,18,019,"Indiana","Clark County",2,29,1760,873,887
050,18,019,"Indiana","Clark County",2,30,1736,848,888
050,18,019,"Indiana","Clark County",2,31,1710,847,863
050,18,019,"Indiana","Clark County",2,32,1671,831,840
050,18,019,"Indiana","Clark County",2,33,1681,844,837
050,18,019,"Indiana","Clark County",2,34,1654,832,822
050,18,019,"Indiana","Clark County",2,35,1617,804,813
050,18,019,"Indiana","Clark County",2,36,1522,764,758
050,18,019,"Indiana","Clark County",2,37,1628,837,791
050,18,019,"Indiana","Clark County",2,38,1721,886,835
050,18,019,"Indiana","Clark County",2,39,1676,853,823
050,18,019,"Indiana","Clark County",2,40,1727,852,875
050,18,019,"Indiana","Clark County",2,41,1683,848,835
050,18,019,"Indiana","Clark County",2,42,1537,787,750
050,18,019,"Indiana","Clark County",2,43,1530,767,763
050,18,019,"Indiana","Clark County",2,44,1536,740,796
050,18,019,"Indiana","Clark County",2,45,1551,766,785
050,18,019,"Indiana","Clark County",2,46,1492,756,736
050,18,019,"Indiana","Clark County",2,47,1563,800,763
050,18,019,"Indiana","Clark County",2,48,1698,851,847
050,18,019,"Indiana","Clark County",2,49,1798,905,893
050,18,019,"Indiana","Clark County",2,50,1694,872,822
050,18,019,"Indiana","Clark County",2,51,1585,812,773
050,18,019,"Indiana","Clark County",2,52,1493,739,754
050,18,019,"Indiana","Clark County",2,53,1462,700,762
050,18,019,"Indiana","Clark County",2,54,1531,740,791
050,18,019,"Indiana","Clark County",2,55,1635,803,832
050,18,019,"Indiana","Clark County",2,56,1723,870,853
050,18,019,"Indiana","Clark County",2,57,1699,855,844
050,18,019,"Indiana","Clark County",2,58,1700,832,868
050,18,019,"Indiana","Clark County",2,59,1663,822,841
050,18,019,"Indiana","Clark County",2,60,1671,829,842
050,18,019,"Indiana","Clark County",2,61,1597,757,840
050,18,019,"Indiana","Clark County",2,62,1618,763,855
050,18,019,"Indiana","Clark County",2,63,1602,753,849
050,18,019,"Indiana","Clark County",2,64,1482,687,795
050,18,019,"Indiana","Clark County",2,65,1445,686,759
050,18,019,"Indiana","Clark County",2,66,1431,688,743
050,18,019,"Indiana","Clark County",2,67,1353,630,723
050,18,019,"Indiana","Clark County",2,68,1294,576,718
050,18,019,"Indiana","Clark County",2,69,1217,546,671
050,18,019,"Indiana","Clark County",2,70,1186,545,641
050,18,019,"Indiana","Clark County",2,71,1119,502,617
050,18,019,"Indiana","Clark County",2,72,1132,508,624
050,18,019,"Indiana","Clark County",2,73,1208,550,658
050,18,019,"Indiana","Clark County",2,74,810,364,446
050,18,019,"Indiana","Clark County",2,75,758,333,425
050,18,019,"Indiana","Clark County",2,76,737,330,407
050,18,019,"Indiana","Clark County",2,77,757,332,425
050,18,019,"Indiana","Clark County",2,78,609,272,337
050,18,019,"Indiana","Clark County",2,79,540,233,307
050,18,019,"Indiana","Clark County",2,80,461,196,265
050,18,019,"Indiana","Clark County",2,81,435,161,274
050,18,019,"Indiana","Clark County",2,82,429,161,268
050,18,019,"Indiana","Clark County",2,83,369,143,226
050,18,019,"Indiana","Clark County",2,84,338,116,222
050,18,019,"Indiana","Clark County",2,85,1848,600,1248
050,18,019,"Indiana","Clark County",3,0,1383,744,639
050,18,019,"Indiana","Clark County",3,1,1406,733,673
050,18,019,"Indiana","Clark County",3,2,1436,724,712
050,18,019,"Indiana","Clark County",3,3,1503,739,764
050,18,019,"Indiana","Clark County",3,4,1510,776,734
050,18,019,"Indiana","Clark County",3,5,1518,776,742
050,18,019,"Indiana","Clark County",3,6,1557,792,765
050,18,019,"Indiana","Clark County",3,7,1486,744,742
050,18,019,"Indiana","Clark County",3,8,1474,761,713
050,18,019,"Indiana","Clark County",3,9,1503,778,725
050,18,019,"Indiana","Clark County",3,10,1503,798,705
050,18,019,"Indiana","Clark County",3,11,1578,800,778
050,18,019,"Indiana","Clark County",3,12,1633,826,807
050,18,019,"Indiana","Clark County",3,13,1606,819,787
050,18,019,"Indiana","Clark County",3,14,1624,822,802
050,18,019,"Indiana","Clark County",3,15,1570,780,790
050,18,019,"Indiana","Clark County",3,16,1541,807,734
050,18,019,"Indiana","Clark County",3,17,1552,814,738
050,18,019,"Indiana","Clark County",3,18,1346,713,633
050,18,019,"Indiana","Clark County",3,19,1099,595,504
050,18,019,"Indiana","Clark County",3,20,1210,652,558
050,18,019,"Indiana","Clark County",3,21,1323,645,678
050,18,019,"Indiana","Clark County",3,22,1458,703,755
050,18,019,"Indiana","Clark County",3,23,1467,704,763
050,18,019,"Indiana","Clark County",3,24,1521,763,758
050,18,019,"Indiana","Clark County",3,25,1554,769,785
050,18,019,"Indiana","Clark County",3,26,1613,805,808
050,18,019,"Indiana","Clark County",3,27,1707,853,854
050,18,019,"Indiana","Clark County",3,28,1826,902,924
050,18,019,"Indiana","Clark County",3,29,1868,936,932
050,18,019,"Indiana","Clark County",3,30,1828,920,908
050,18,019,"Indiana","Clark County",3,31,1756,853,903
050,18,019,"Indiana","Clark County",3,32,1756,870,886
050,18,019,"Indiana","Clark County",3,33,1679,834,845
050,18,019,"Indiana","Clark County",3,34,1690,861,829
050,18,019,"Indiana","Clark County",3,35,1684,845,839
050,18,019,"Indiana","Clark County",3,36,1634,808,826
050,18,019,"Indiana","Clark County",3,37,1510,758,752
050,18,019,"Indiana","Clark County",3,38,1657,858,799
050,18,019,"Indiana","Clark County",3,39,1737,899,838
050,18,019,"Indiana","Clark County",3,40,1664,834,830
050,18,019,"Indiana","Clark County",3,41,1745,842,903
050,18,019,"Indiana","Clark County",3,42,1685,852,833
050,18,019,"Indiana","Clark County",3,43,1542,798,744
050,18,019,"Indiana","Clark County",3,44,1534,771,763
050,18,019,"Indiana","Clark County",3,45,1552,756,796
050,18,019,"Indiana","Clark County",3,46,1546,763,783
050,18,019,"Indiana","Clark County",3,47,1484,750,734
050,18,019,"Indiana","Clark County",3,48,1560,787,773
050,18,019,"Indiana","Clark County",3,49,1717,871,846
050,18,019,"Indiana","Clark County",3,50,1783,898,885
050,18,019,"Indiana","Clark County",3,51,1712,891,821
050,18,019,"Indiana","Clark County",3,52,1596,816,780
050,18,019,"Indiana","Clark County",3,53,1500,730,770
050,18,019,"Indiana","Clark County",3,54,1490,720,770
050,18,019,"Indiana","Clark County",3,55,1536,730,806
050,18,019,"Indiana","Clark County",3,56,1629,780,849
050,18,019,"Indiana","Clark County",3,57,1738,868,870
050,18,019,"Indiana","Clark County",3,58,1690,842,848
050,18,019,"Indiana","Clark County",3,59,1699,828,871
050,18,019,"Indiana","Clark County",3,60,1654,828,826
050,18,019,"Indiana","Clark County",3,61,1640,807,833
050,18,019,"Indiana","Clark County",3,62,1585,746,839
050,18,019,"Indiana","Clark County",3,63,1617,762,855
050,18,019,"Indiana","Clark County",3,64,1566,727,839
050,18,019,"Indiana","Clark County",3,65,1478,688,790
050,18,019,"Indiana","Clark County",3,66,1416,677,739
050,18,019,"Indiana","Clark County",3,67,1405,673,732
050,18,019,"Indiana","Clark County",3,68,1339,614,725
050,18,019,"Indiana","Clark County",3,69,1278,563,715
050,18,019,"Indiana","Clark County",3,70,1224,549,675
050,18,019,"Indiana","Clark County",3,71,1140,518,622
050,18,019,"Indiana","Clark County",3,72,1090,484,606
050,18,019,"Indiana","Clark County",3,73,1088,485,603
050,18,019,"Indiana","Clark County",3,74,1164,530,634
050,18,019,"Indiana","Clark County",3,75,786,349,437
050,18,019,"Indiana","Clark County",3,76,719,297,422
050,18,019,"Indiana","Clark County",3,77,720,316,404
050,18,019,"Indiana","Clark County",3,78,717,321,396
050,18,019,"Indiana","Clark County",3,79,599,265,334
050,18,019,"Indiana","Clark County",3,80,507,217,290
050,18,019,"Indiana","Clark County",3,81,434,170,264
050,18,019,"Indiana","Clark County",3,82,409,157,252
050,18,019,"Indiana","Clark County",3,83,380,142,238
050,18,019,"Indiana","Clark County",3,84,367,139,228
050,18,019,"Indiana","Clark County",3,85,1865,592,1273
050,18,019,"Indiana","Clark County",4,0,1384,737,647
050,18,019,"Indiana","Clark County",4,1,1455,766,689
050,18,019,"Indiana","Clark County",4,2,1395,724,671
050,18,019,"Indiana","Clark County",4,3,1446,744,702
050,18,019,"Indiana","Clark County",4,4,1542,771,771
050,18,019,"Indiana","Clark County",4,5,1516,762,754
050,18,019,"Indiana","Clark County",4,6,1506,771,735
050,18,019,"Indiana","Clark County",4,7,1525,769,756
050,18,019,"Indiana","Clark County",4,8,1495,762,733
050,18,019,"Indiana","Clark County",4,9,1462,757,705
050,18,019,"Indiana","Clark County",4,10,1509,768,741
050,18,019,"Indiana","Clark County",4,11,1534,816,718
050,18,019,"Indiana","Clark County",4,12,1577,795,782
050,18,019,"Indiana","Clark County",4,13,1642,838,804
050,18,019,"Indiana","Clark County",4,14,1631,837,794
050,18,019,"Indiana","Clark County",4,15,1595,815,780
050,18,019,"Indiana","Clark County",4,16,1583,784,799
050,18,019,"Indiana","Clark County",4,17,1537,793,744
050,18,019,"Indiana","Clark County",4,18,1315,710,605
050,18,019,"Indiana","Clark County",4,19,1116,585,531
050,18,019,"Indiana","Clark County",4,20,1183,631,552
050,18,019,"Indiana","Clark County",4,21,1305,689,616
050,18,019,"Indiana","Clark County",4,22,1480,712,768
050,18,019,"Indiana","Clark County",4,23,1553,750,803
050,18,019,"Indiana","Clark County",4,24,1561,761,800
050,18,019,"Indiana","Clark County",4,25,1638,814,824
050,18,019,"Indiana","Clark County",4,26,1672,819,853
050,18,019,"Indiana","Clark County",4,27,1752,882,870
050,18,019,"Indiana","Clark County",4,28,1782,901,881
050,18,019,"Indiana","Clark County",4,29,1849,914,935
050,18,019,"Indiana","Clark County",4,30,1871,937,934
050,18,019,"Indiana","Clark County",4,31,1860,923,937
050,18,019,"Indiana","Clark County",4,32,1784,874,910
050,18,019,"Indiana","Clark County",4,33,1754,856,898
050,18,019,"Indiana","Clark County",4,34,1698,839,859
050,18,019,"Indiana","Clark County",4,35,1686,854,832
050,18,019,"Indiana","Clark County",4,36,1686,849,837
050,18,019,"Indiana","Clark County",4,37,1667,829,838
050,18,019,"Indiana","Clark County",4,38,1541,765,776
050,18,019,"Indiana","Clark County",4,39,1672,872,800
050,18,019,"Indiana","Clark County",4,40,1738,884,854
050,18,019,"Indiana","Clark County",4,41,1671,833,838
050,18,019,"Indiana","Clark County",4,42,1748,844,904
050,18,019,"Indiana","Clark County",4,43,1684,857,827
050,18,019,"Indiana","Clark County",4,44,1581,816,765
050,18,019,"Indiana","Clark County",4,45,1520,753,767
050,18,019,"Indiana","Clark County",4,46,1561,750,811
050,18,019,"Indiana","Clark County",4,47,1547,779,768
050,18,019,"Indiana","Clark County",4,48,1509,759,750
050,18,019,"Indiana","Clark County",4,49,1546,788,758
050,18,019,"Indiana","Clark County",4,50,1707,866,841
050,18,019,"Indiana","Clark County",4,51,1795,912,883
050,18,019,"Indiana","Clark County",4,52,1745,899,846
050,18,019,"Indiana","Clark County",4,53,1576,772,804
050,18,019,"Indiana","Clark County",4,54,1504,732,772
050,18,019,"Indiana","Clark County",4,55,1492,713,779
050,18,019,"Indiana","Clark County",4,56,1522,719,803
050,18,019,"Indiana","Clark County",4,57,1642,803,839
050,18,019,"Indiana","Clark County",4,58,1751,864,887
050,18,019,"Indiana","Clark County",4,59,1686,830,856
050,18,019,"Indiana","Clark County",4,60,1699,845,854
050,18,019,"Indiana","Clark County",4,61,1647,821,826
050,18,019,"Indiana","Clark County",4,62,1606,788,818
050,18,019,"Indiana","Clark County",4,63,1595,756,839
050,18,019,"Indiana","Clark County",4,64,1584,747,837
050,18,019,"Indiana","Clark County",4,65,1570,735,835
050,18,019,"Indiana","Clark County",4,66,1459,681,778
050,18,019,"Indiana","Clark County",4,67,1394,660,734
050,18,019,"Indiana","Clark County",4,68,1392,654,738
050,18,019,"Indiana","Clark County",4,69,1296,590,706
050,18,019,"Indiana","Clark County",4,70,1271,567,704
050,18,019,"Indiana","Clark County",4,71,1190,541,649
050,18,019,"Indiana","Clark County",4,72,1100,499,601
050,18,019,"Indiana","Clark County",4,73,1059,466,593
050,18,019,"Indiana","Clark County",4,74,1053,468,585
050,18,019,"Indiana","Clark County",4,75,1117,501,616
050,18,019,"Indiana","Clark County",4,76,755,325,430
050,18,019,"Indiana","Clark County",4,77,701,293,408
050,18,019,"Indiana","Clark County",4,78,673,293,380
050,18,019,"Indiana","Clark County",4,79,694,312,382
050,18,019,"Indiana","Clark County",4,80,569,259,310
050,18,019,"Indiana","Clark County",4,81,492,202,290
050,18,019,"Indiana","Clark County",4,82,404,158,246
050,18,019,"Indiana","Clark County",4,83,373,136,237
050,18,019,"Indiana","Clark County",4,84,368,137,231
050,18,019,"Indiana","Clark County",4,85,1877,597,1280
050,18,019,"Indiana","Clark County",5,0,1301,690,611
050,18,019,"Indiana","Clark County",5,1,1405,782,623
050,18,019,"Indiana","Clark County",5,2,1460,775,685
050,18,019,"Indiana","Clark County",5,3,1416,739,677
050,18,019,"Indiana","Clark County",5,4,1469,735,734
050,18,019,"Indiana","Clark County",5,5,1544,792,752
050,18,019,"Indiana","Clark County",5,6,1549,773,776
050,18,019,"Indiana","Clark County",5,7,1557,780,777
050,18,019,"Indiana","Clark County",5,8,1547,784,763
050,18,019,"Indiana","Clark County",5,9,1523,779,744
050,18,019,"Indiana","Clark County",5,10,1468,755,713
050,18,019,"Indiana","Clark County",5,11,1520,783,737
050,18,019,"Indiana","Clark County",5,12,1538,812,726
050,18,019,"Indiana","Clark County",5,13,1582,782,800
050,18,019,"Indiana","Clark County",5,14,1631,834,797
050,18,019,"Indiana","Clark County",5,15,1629,836,793
050,18,019,"Indiana","Clark County",5,16,1604,821,783
050,18,019,"Indiana","Clark County",5,17,1568,771,797
050,18,019,"Indiana","Clark County",5,18,1322,696,626
050,18,019,"Indiana","Clark County",5,19,1081,574,507
050,18,019,"Indiana","Clark County",5,20,1239,630,609
050,18,019,"Indiana","Clark County",5,21,1282,676,606
050,18,019,"Indiana","Clark County",5,22,1424,733,691
050,18,019,"Indiana","Clark County",5,23,1575,755,820
050,18,019,"Indiana","Clark County",5,24,1591,792,799
050,18,019,"Indiana","Clark County",5,25,1637,793,844
050,18,019,"Indiana","Clark County",5,26,1674,826,848
050,18,019,"Indiana","Clark County",5,27,1745,860,885
050,18,019,"Indiana","Clark County",5,28,1827,921,906
050,18,019,"Indiana","Clark County",5,29,1837,931,906
050,18,019,"Indiana","Clark County",5,30,1883,926,957
050,18,019,"Indiana","Clark County",5,31,1947,987,960
050,18,019,"Indiana","Clark County",5,32,1885,944,941
050,18,019,"Indiana","Clark County",5,33,1824,892,932
050,18,019,"Indiana","Clark County",5,34,1766,876,890
050,18,019,"Indiana","Clark County",5,35,1715,844,871
050,18,019,"Indiana","Clark County",5,36,1669,841,828
050,18,019,"Indiana","Clark County",5,37,1689,867,822
050,18,019,"Indiana","Clark County",5,38,1679,837,842
050,18,019,"Indiana","Clark County",5,39,1553,777,776
050,18,019,"Indiana","Clark County",5,40,1684,857,827
050,18,019,"Indiana","Clark County",5,41,1709,859,850
050,18,019,"Indiana","Clark County",5,42,1678,848,830
050,18,019,"Indiana","Clark County",5,43,1752,831,921
050,18,019,"Indiana","Clark County",5,44,1698,867,831
050,18,019,"Indiana","Clark County",5,45,1567,811,756
050,18,019,"Indiana","Clark County",5,46,1529,743,786
050,18,019,"Indiana","Clark County",5,47,1570,768,802
050,18,019,"Indiana","Clark County",5,48,1566,774,792
050,18,019,"Indiana","Clark County",5,49,1507,760,747
050,18,019,"Indiana","Clark County",5,50,1555,791,764
050,18,019,"Indiana","Clark County",5,51,1710,869,841
050,18,019,"Indiana","Clark County",5,52,1807,905,902
050,18,019,"Indiana","Clark County",5,53,1730,881,849
050,18,019,"Indiana","Clark County",5,54,1606,791,815
050,18,019,"Indiana","Clark County",5,55,1513,739,774
050,18,019,"Indiana","Clark County",5,56,1474,703,771
050,18,019,"Indiana","Clark County",5,57,1516,715,801
050,18,019,"Indiana","Clark County",5,58,1643,806,837
050,18,019,"Indiana","Clark County",5,59,1742,868,874
050,18,019,"Indiana","Clark County",5,60,1713,856,857
050,18,019,"Indiana","Clark County",5,61,1656,811,845
050,18,019,"Indiana","Clark County",5,62,1619,793,826
050,18,019,"Indiana","Clark County",5,63,1636,806,830
050,18,019,"Indiana","Clark County",5,64,1569,729,840
050,18,019,"Indiana","Clark County",5,65,1571,739,832
050,18,019,"Indiana","Clark County",5,66,1557,735,822
050,18,019,"Indiana","Clark County",5,67,1424,661,763
050,18,019,"Indiana","Clark County",5,68,1366,649,717
050,18,019,"Indiana","Clark County",5,69,1345,629,716
050,18,019,"Indiana","Clark County",5,70,1302,593,709
050,18,019,"Indiana","Clark County",5,71,1226,550,676
050,18,019,"Indiana","Clark County",5,72,1163,527,636
050,18,019,"Indiana","Clark County",5,73,1081,494,587
050,18,019,"Indiana","Clark County",5,74,1034,457,577
050,18,019,"Indiana","Clark County",5,75,1021,453,568
050,18,019,"Indiana","Clark County",5,76,1099,484,615
050,18,019,"Indiana","Clark County",5,77,735,315,420
050,18,019,"Indiana","Clark County",5,78,659,275,384
050,18,019,"Indiana","Clark County",5,79,645,278,367
050,18,019,"Indiana","Clark County",5,80,660,302,358
050,18,019,"Indiana","Clark County",5,81,554,242,312
050,18,019,"Indiana","Clark County",5,82,456,193,263
050,18,019,"Indiana","Clark County",5,83,367,138,229
050,18,019,"Indiana","Clark County",5,84,368,133,235
050,18,019,"Indiana","Clark County",5,85,1930,615,1315
050,18,021,"Indiana","Clay County",1,0,326,166,160
050,18,021,"Indiana","Clay County",1,1,324,153,171
050,18,021,"Indiana","Clay County",1,2,319,152,167
050,18,021,"Indiana","Clay County",1,3,352,168,184
050,18,021,"Indiana","Clay County",1,4,327,151,176
050,18,021,"Indiana","Clay County",1,5,330,170,160
050,18,021,"Indiana","Clay County",1,6,326,165,161
050,18,021,"Indiana","Clay County",1,7,317,167,150
050,18,021,"Indiana","Clay County",1,8,325,176,149
050,18,021,"Indiana","Clay County",1,9,349,183,166
050,18,021,"Indiana","Clay County",1,10,329,187,142
050,18,021,"Indiana","Clay County",1,11,350,177,173
050,18,021,"Indiana","Clay County",1,12,366,185,181
050,18,021,"Indiana","Clay County",1,13,350,191,159
050,18,021,"Indiana","Clay County",1,14,371,195,176
050,18,021,"Indiana","Clay County",1,15,354,180,174
050,18,021,"Indiana","Clay County",1,16,368,181,187
050,18,021,"Indiana","Clay County",1,17,385,207,178
050,18,021,"Indiana","Clay County",1,18,307,168,139
050,18,021,"Indiana","Clay County",1,19,237,112,125
050,18,021,"Indiana","Clay County",1,20,237,117,120
050,18,021,"Indiana","Clay County",1,21,253,126,127
050,18,021,"Indiana","Clay County",1,22,284,138,146
050,18,021,"Indiana","Clay County",1,23,284,148,136
050,18,021,"Indiana","Clay County",1,24,295,158,137
050,18,021,"Indiana","Clay County",1,25,304,154,150
050,18,021,"Indiana","Clay County",1,26,284,145,139
050,18,021,"Indiana","Clay County",1,27,334,174,160
050,18,021,"Indiana","Clay County",1,28,338,173,165
050,18,021,"Indiana","Clay County",1,29,337,168,169
050,18,021,"Indiana","Clay County",1,30,314,158,156
050,18,021,"Indiana","Clay County",1,31,305,134,171
050,18,021,"Indiana","Clay County",1,32,317,155,162
050,18,021,"Indiana","Clay County",1,33,335,173,162
050,18,021,"Indiana","Clay County",1,34,318,168,150
050,18,021,"Indiana","Clay County",1,35,305,153,152
050,18,021,"Indiana","Clay County",1,36,321,164,157
050,18,021,"Indiana","Clay County",1,37,340,170,170
050,18,021,"Indiana","Clay County",1,38,338,177,161
050,18,021,"Indiana","Clay County",1,39,343,180,163
050,18,021,"Indiana","Clay County",1,40,331,172,159
050,18,021,"Indiana","Clay County",1,41,309,141,168
050,18,021,"Indiana","Clay County",1,42,327,157,170
050,18,021,"Indiana","Clay County",1,43,338,168,170
050,18,021,"Indiana","Clay County",1,44,326,177,149
050,18,021,"Indiana","Clay County",1,45,317,179,138
050,18,021,"Indiana","Clay County",1,46,323,168,155
050,18,021,"Indiana","Clay County",1,47,334,167,167
050,18,021,"Indiana","Clay County",1,48,346,178,168
050,18,021,"Indiana","Clay County",1,49,344,166,178
050,18,021,"Indiana","Clay County",1,50,341,173,168
050,18,021,"Indiana","Clay County",1,51,320,163,157
050,18,021,"Indiana","Clay County",1,52,337,173,164
050,18,021,"Indiana","Clay County",1,53,340,174,166
050,18,021,"Indiana","Clay County",1,54,334,168,166
050,18,021,"Indiana","Clay County",1,55,332,163,169
050,18,021,"Indiana","Clay County",1,56,387,200,187
050,18,021,"Indiana","Clay County",1,57,397,206,191
050,18,021,"Indiana","Clay County",1,58,405,209,196
050,18,021,"Indiana","Clay County",1,59,381,196,185
050,18,021,"Indiana","Clay County",1,60,381,207,174
050,18,021,"Indiana","Clay County",1,61,387,191,196
050,18,021,"Indiana","Clay County",1,62,380,189,191
050,18,021,"Indiana","Clay County",1,63,401,208,193
050,18,021,"Indiana","Clay County",1,64,362,176,186
050,18,021,"Indiana","Clay County",1,65,341,155,186
050,18,021,"Indiana","Clay County",1,66,341,166,175
050,18,021,"Indiana","Clay County",1,67,327,154,173
050,18,021,"Indiana","Clay County",1,68,312,156,156
050,18,021,"Indiana","Clay County",1,69,307,146,161
050,18,021,"Indiana","Clay County",1,70,300,145,155
050,18,021,"Indiana","Clay County",1,71,275,131,144
050,18,021,"Indiana","Clay County",1,72,258,122,136
050,18,021,"Indiana","Clay County",1,73,259,123,136
050,18,021,"Indiana","Clay County",1,74,187,95,92
050,18,021,"Indiana","Clay County",1,75,185,90,95
050,18,021,"Indiana","Clay County",1,76,161,68,93
050,18,021,"Indiana","Clay County",1,77,170,79,91
050,18,021,"Indiana","Clay County",1,78,142,65,77
050,18,021,"Indiana","Clay County",1,79,134,58,76
050,18,021,"Indiana","Clay County",1,80,149,65,84
050,18,021,"Indiana","Clay County",1,81,122,48,74
050,18,021,"Indiana","Clay County",1,82,123,52,71
050,18,021,"Indiana","Clay County",1,83,102,40,62
050,18,021,"Indiana","Clay County",1,84,103,38,65
050,18,021,"Indiana","Clay County",1,85,486,191,295
050,18,021,"Indiana","Clay County",2,0,311,157,154
050,18,021,"Indiana","Clay County",2,1,322,156,166
050,18,021,"Indiana","Clay County",2,2,322,152,170
050,18,021,"Indiana","Clay County",2,3,343,163,180
050,18,021,"Indiana","Clay County",2,4,334,155,179
050,18,021,"Indiana","Clay County",2,5,329,164,165
050,18,021,"Indiana","Clay County",2,6,330,166,164
050,18,021,"Indiana","Clay County",2,7,321,168,153
050,18,021,"Indiana","Clay County",2,8,325,176,149
050,18,021,"Indiana","Clay County",2,9,345,184,161
050,18,021,"Indiana","Clay County",2,10,335,186,149
050,18,021,"Indiana","Clay County",2,11,345,180,165
050,18,021,"Indiana","Clay County",2,12,363,185,178
050,18,021,"Indiana","Clay County",2,13,354,191,163
050,18,021,"Indiana","Clay County",2,14,365,192,173
050,18,021,"Indiana","Clay County",2,15,357,183,174
050,18,021,"Indiana","Clay County",2,16,366,182,184
050,18,021,"Indiana","Clay County",2,17,383,202,181
050,18,021,"Indiana","Clay County",2,18,309,170,139
050,18,021,"Indiana","Clay County",2,19,238,116,122
050,18,021,"Indiana","Clay County",2,20,239,117,122
050,18,021,"Indiana","Clay County",2,21,251,124,127
050,18,021,"Indiana","Clay County",2,22,277,135,142
050,18,021,"Indiana","Clay County",2,23,283,144,139
050,18,021,"Indiana","Clay County",2,24,295,155,140
050,18,021,"Indiana","Clay County",2,25,297,153,144
050,18,021,"Indiana","Clay County",2,26,291,149,142
050,18,021,"Indiana","Clay County",2,27,319,165,154
050,18,021,"Indiana","Clay County",2,28,336,172,164
050,18,021,"Indiana","Clay County",2,29,339,170,169
050,18,021,"Indiana","Clay County",2,30,320,159,161
050,18,021,"Indiana","Clay County",2,31,305,138,167
050,18,021,"Indiana","Clay County",2,32,313,148,165
050,18,021,"Indiana","Clay County",2,33,331,169,162
050,18,021,"Indiana","Clay County",2,34,321,167,154
050,18,021,"Indiana","Clay County",2,35,314,161,153
050,18,021,"Indiana","Clay County",2,36,317,163,154
050,18,021,"Indiana","Clay County",2,37,336,169,167
050,18,021,"Indiana","Clay County",2,38,341,177,164
050,18,021,"Indiana","Clay County",2,39,345,181,164
050,18,021,"Indiana","Clay County",2,40,334,175,159
050,18,021,"Indiana","Clay County",2,41,312,148,164
050,18,021,"Indiana","Clay County",2,42,322,154,168
050,18,021,"Indiana","Clay County",2,43,336,167,169
050,18,021,"Indiana","Clay County",2,44,327,175,152
050,18,021,"Indiana","Clay County",2,45,319,178,141
050,18,021,"Indiana","Clay County",2,46,320,170,150
050,18,021,"Indiana","Clay County",2,47,328,165,163
050,18,021,"Indiana","Clay County",2,48,340,174,166
050,18,021,"Indiana","Clay County",2,49,344,170,174
050,18,021,"Indiana","Clay County",2,50,342,171,171
050,18,021,"Indiana","Clay County",2,51,326,165,161
050,18,021,"Indiana","Clay County",2,52,331,169,162
050,18,021,"Indiana","Clay County",2,53,338,174,164
050,18,021,"Indiana","Clay County",2,54,332,167,165
050,18,021,"Indiana","Clay County",2,55,330,163,167
050,18,021,"Indiana","Clay County",2,56,372,190,182
050,18,021,"Indiana","Clay County",2,57,394,205,189
050,18,021,"Indiana","Clay County",2,58,401,207,194
050,18,021,"Indiana","Clay County",2,59,387,200,187
050,18,021,"Indiana","Clay County",2,60,380,203,177
050,18,021,"Indiana","Clay County",2,61,384,195,189
050,18,021,"Indiana","Clay County",2,62,380,190,190
050,18,021,"Indiana","Clay County",2,63,402,207,195
050,18,021,"Indiana","Clay County",2,64,368,183,185
050,18,021,"Indiana","Clay County",2,65,346,160,186
050,18,021,"Indiana","Clay County",2,66,339,162,177
050,18,021,"Indiana","Clay County",2,67,328,155,173
050,18,021,"Indiana","Clay County",2,68,311,152,159
050,18,021,"Indiana","Clay County",2,69,310,149,161
050,18,021,"Indiana","Clay County",2,70,299,144,155
050,18,021,"Indiana","Clay County",2,71,280,134,146
050,18,021,"Indiana","Clay County",2,72,257,122,135
050,18,021,"Indiana","Clay County",2,73,271,128,143
050,18,021,"Indiana","Clay County",2,74,190,96,94
050,18,021,"Indiana","Clay County",2,75,183,90,93
050,18,021,"Indiana","Clay County",2,76,164,72,92
050,18,021,"Indiana","Clay County",2,77,169,77,92
050,18,021,"Indiana","Clay County",2,78,144,67,77
050,18,021,"Indiana","Clay County",2,79,134,59,75
050,18,021,"Indiana","Clay County",2,80,147,64,83
050,18,021,"Indiana","Clay County",2,81,124,51,73
050,18,021,"Indiana","Clay County",2,82,122,50,72
050,18,021,"Indiana","Clay County",2,83,100,39,61
050,18,021,"Indiana","Clay County",2,84,100,37,63
050,18,021,"Indiana","Clay County",2,85,493,193,300
050,18,021,"Indiana","Clay County",3,0,294,145,149
050,18,021,"Indiana","Clay County",3,1,316,159,157
050,18,021,"Indiana","Clay County",3,2,320,154,166
050,18,021,"Indiana","Clay County",3,3,331,161,170
050,18,021,"Indiana","Clay County",3,4,350,168,182
050,18,021,"Indiana","Clay County",3,5,344,161,183
050,18,021,"Indiana","Clay County",3,6,322,156,166
050,18,021,"Indiana","Clay County",3,7,338,173,165
050,18,021,"Indiana","Clay County",3,8,320,168,152
050,18,021,"Indiana","Clay County",3,9,328,178,150
050,18,021,"Indiana","Clay County",3,10,352,185,167
050,18,021,"Indiana","Clay County",3,11,336,188,148
050,18,021,"Indiana","Clay County",3,12,349,177,172
050,18,021,"Indiana","Clay County",3,13,365,192,173
050,18,021,"Indiana","Clay County",3,14,364,190,174
050,18,021,"Indiana","Clay County",3,15,366,188,178
050,18,021,"Indiana","Clay County",3,16,346,174,172
050,18,021,"Indiana","Clay County",3,17,355,186,169
050,18,021,"Indiana","Clay County",3,18,318,178,140
050,18,021,"Indiana","Clay County",3,19,241,132,109
050,18,021,"Indiana","Clay County",3,20,245,119,126
050,18,021,"Indiana","Clay County",3,21,249,121,128
050,18,021,"Indiana","Clay County",3,22,276,135,141
050,18,021,"Indiana","Clay County",3,23,288,142,146
050,18,021,"Indiana","Clay County",3,24,286,146,140
050,18,021,"Indiana","Clay County",3,25,309,161,148
050,18,021,"Indiana","Clay County",3,26,323,169,154
050,18,021,"Indiana","Clay County",3,27,295,143,152
050,18,021,"Indiana","Clay County",3,28,333,171,162
050,18,021,"Indiana","Clay County",3,29,344,167,177
050,18,021,"Indiana","Clay County",3,30,312,159,153
050,18,021,"Indiana","Clay County",3,31,324,163,161
050,18,021,"Indiana","Clay County",3,32,317,145,172
050,18,021,"Indiana","Clay County",3,33,326,160,166
050,18,021,"Indiana","Clay County",3,34,319,165,154
050,18,021,"Indiana","Clay County",3,35,342,180,162
050,18,021,"Indiana","Clay County",3,36,313,163,150
050,18,021,"Indiana","Clay County",3,37,307,163,144
050,18,021,"Indiana","Clay County",3,38,336,168,168
050,18,021,"Indiana","Clay County",3,39,351,179,172
050,18,021,"Indiana","Clay County",3,40,336,172,164
050,18,021,"Indiana","Clay County",3,41,333,174,159
050,18,021,"Indiana","Clay County",3,42,326,163,163
050,18,021,"Indiana","Clay County",3,43,322,150,172
050,18,021,"Indiana","Clay County",3,44,341,173,168
050,18,021,"Indiana","Clay County",3,45,314,164,150
050,18,021,"Indiana","Clay County",3,46,328,182,146
050,18,021,"Indiana","Clay County",3,47,318,168,150
050,18,021,"Indiana","Clay County",3,48,318,158,160
050,18,021,"Indiana","Clay County",3,49,339,170,169
050,18,021,"Indiana","Clay County",3,50,331,164,167
050,18,021,"Indiana","Clay County",3,51,345,170,175
050,18,021,"Indiana","Clay County",3,52,318,160,158
050,18,021,"Indiana","Clay County",3,53,331,171,160
050,18,021,"Indiana","Clay County",3,54,328,169,159
050,18,021,"Indiana","Clay County",3,55,332,165,167
050,18,021,"Indiana","Clay County",3,56,316,158,158
050,18,021,"Indiana","Clay County",3,57,374,192,182
050,18,021,"Indiana","Clay County",3,58,390,200,190
050,18,021,"Indiana","Clay County",3,59,393,205,188
050,18,021,"Indiana","Clay County",3,60,381,195,186
050,18,021,"Indiana","Clay County",3,61,382,202,180
050,18,021,"Indiana","Clay County",3,62,372,184,188
050,18,021,"Indiana","Clay County",3,63,372,183,189
050,18,021,"Indiana","Clay County",3,64,399,205,194
050,18,021,"Indiana","Clay County",3,65,364,180,184
050,18,021,"Indiana","Clay County",3,66,342,155,187
050,18,021,"Indiana","Clay County",3,67,336,159,177
050,18,021,"Indiana","Clay County",3,68,328,153,175
050,18,021,"Indiana","Clay County",3,69,296,141,155
050,18,021,"Indiana","Clay County",3,70,299,144,155
050,18,021,"Indiana","Clay County",3,71,287,137,150
050,18,021,"Indiana","Clay County",3,72,272,128,144
050,18,021,"Indiana","Clay County",3,73,255,122,133
050,18,021,"Indiana","Clay County",3,74,263,125,138
050,18,021,"Indiana","Clay County",3,75,187,94,93
050,18,021,"Indiana","Clay County",3,76,172,82,90
050,18,021,"Indiana","Clay County",3,77,149,65,84
050,18,021,"Indiana","Clay County",3,78,153,67,86
050,18,021,"Indiana","Clay County",3,79,134,59,75
050,18,021,"Indiana","Clay County",3,80,132,54,78
050,18,021,"Indiana","Clay County",3,81,133,58,75
050,18,021,"Indiana","Clay County",3,82,115,47,68
050,18,021,"Indiana","Clay County",3,83,109,39,70
050,18,021,"Indiana","Clay County",3,84,94,33,61
050,18,021,"Indiana","Clay County",3,85,485,186,299
050,18,021,"Indiana","Clay County",4,0,293,148,145
050,18,021,"Indiana","Clay County",4,1,290,136,154
050,18,021,"Indiana","Clay County",4,2,306,152,154
050,18,021,"Indiana","Clay County",4,3,337,162,175
050,18,021,"Indiana","Clay County",4,4,326,158,168
050,18,021,"Indiana","Clay County",4,5,358,176,182
050,18,021,"Indiana","Clay County",4,6,337,159,178
050,18,021,"Indiana","Clay County",4,7,345,163,182
050,18,021,"Indiana","Clay County",4,8,342,177,165
050,18,021,"Indiana","Clay County",4,9,314,165,149
050,18,021,"Indiana","Clay County",4,10,334,188,146
050,18,021,"Indiana","Clay County",4,11,352,179,173
050,18,021,"Indiana","Clay County",4,12,345,186,159
050,18,021,"Indiana","Clay County",4,13,349,180,169
050,18,021,"Indiana","Clay County",4,14,369,189,180
050,18,021,"Indiana","Clay County",4,15,355,188,167
050,18,021,"Indiana","Clay County",4,16,365,195,170
050,18,021,"Indiana","Clay County",4,17,355,186,169
050,18,021,"Indiana","Clay County",4,18,298,162,136
050,18,021,"Indiana","Clay County",4,19,235,134,101
050,18,021,"Indiana","Clay County",4,20,262,143,119
050,18,021,"Indiana","Clay County",4,21,258,125,133
050,18,021,"Indiana","Clay County",4,22,279,131,148
050,18,021,"Indiana","Clay County",4,23,268,124,144
050,18,021,"Indiana","Clay County",4,24,299,146,153
050,18,021,"Indiana","Clay County",4,25,291,149,142
050,18,021,"Indiana","Clay County",4,26,317,171,146
050,18,021,"Indiana","Clay County",4,27,314,173,141
050,18,021,"Indiana","Clay County",4,28,296,143,153
050,18,021,"Indiana","Clay County",4,29,333,169,164
050,18,021,"Indiana","Clay County",4,30,353,178,175
050,18,021,"Indiana","Clay County",4,31,323,168,155
050,18,021,"Indiana","Clay County",4,32,324,160,164
050,18,021,"Indiana","Clay County",4,33,319,149,170
050,18,021,"Indiana","Clay County",4,34,311,155,156
050,18,021,"Indiana","Clay County",4,35,320,167,153
050,18,021,"Indiana","Clay County",4,36,342,179,163
050,18,021,"Indiana","Clay County",4,37,315,164,151
050,18,021,"Indiana","Clay County",4,38,309,164,145
050,18,021,"Indiana","Clay County",4,39,338,164,174
050,18,021,"Indiana","Clay County",4,40,346,180,166
050,18,021,"Indiana","Clay County",4,41,345,173,172
050,18,021,"Indiana","Clay County",4,42,332,173,159
050,18,021,"Indiana","Clay County",4,43,323,162,161
050,18,021,"Indiana","Clay County",4,44,332,161,171
050,18,021,"Indiana","Clay County",4,45,329,166,163
050,18,021,"Indiana","Clay County",4,46,306,152,154
050,18,021,"Indiana","Clay County",4,47,317,177,140
050,18,021,"Indiana","Clay County",4,48,312,167,145
050,18,021,"Indiana","Clay County",4,49,315,160,155
050,18,021,"Indiana","Clay County",4,50,342,167,175
050,18,021,"Indiana","Clay County",4,51,336,166,170
050,18,021,"Indiana","Clay County",4,52,342,169,173
050,18,021,"Indiana","Clay County",4,53,318,162,156
050,18,021,"Indiana","Clay County",4,54,328,168,160
050,18,021,"Indiana","Clay County",4,55,321,167,154
050,18,021,"Indiana","Clay County",4,56,328,164,164
050,18,021,"Indiana","Clay County",4,57,329,162,167
050,18,021,"Indiana","Clay County",4,58,380,193,187
050,18,021,"Indiana","Clay County",4,59,391,197,194
050,18,021,"Indiana","Clay County",4,60,398,204,194
050,18,021,"Indiana","Clay County",4,61,386,195,191
050,18,021,"Indiana","Clay County",4,62,389,204,185
050,18,021,"Indiana","Clay County",4,63,367,181,186
050,18,021,"Indiana","Clay County",4,64,374,179,195
050,18,021,"Indiana","Clay County",4,65,396,202,194
050,18,021,"Indiana","Clay County",4,66,358,175,183
050,18,021,"Indiana","Clay County",4,67,341,151,190
050,18,021,"Indiana","Clay County",4,68,332,159,173
050,18,021,"Indiana","Clay County",4,69,307,141,166
050,18,021,"Indiana","Clay County",4,70,286,137,149
050,18,021,"Indiana","Clay County",4,71,283,133,150
050,18,021,"Indiana","Clay County",4,72,278,130,148
050,18,021,"Indiana","Clay County",4,73,274,129,145
050,18,021,"Indiana","Clay County",4,74,256,123,133
050,18,021,"Indiana","Clay County",4,75,257,122,135
050,18,021,"Indiana","Clay County",4,76,176,85,91
050,18,021,"Indiana","Clay County",4,77,163,78,85
050,18,021,"Indiana","Clay County",4,78,143,60,83
050,18,021,"Indiana","Clay County",4,79,146,65,81
050,18,021,"Indiana","Clay County",4,80,132,56,76
050,18,021,"Indiana","Clay County",4,81,116,48,68
050,18,021,"Indiana","Clay County",4,82,130,58,72
050,18,021,"Indiana","Clay County",4,83,106,42,64
050,18,021,"Indiana","Clay County",4,84,98,32,66
050,18,021,"Indiana","Clay County",4,85,470,179,291
050,18,021,"Indiana","Clay County",5,0,298,152,146
050,18,021,"Indiana","Clay County",5,1,271,148,123
050,18,021,"Indiana","Clay County",5,2,292,145,147
050,18,021,"Indiana","Clay County",5,3,318,147,171
050,18,021,"Indiana","Clay County",5,4,331,153,178
050,18,021,"Indiana","Clay County",5,5,335,160,175
050,18,021,"Indiana","Clay County",5,6,360,174,186
050,18,021,"Indiana","Clay County",5,7,354,162,192
050,18,021,"Indiana","Clay County",5,8,340,157,183
050,18,021,"Indiana","Clay County",5,9,338,176,162
050,18,021,"Indiana","Clay County",5,10,328,173,155
050,18,021,"Indiana","Clay County",5,11,331,188,143
050,18,021,"Indiana","Clay County",5,12,356,182,174
050,18,021,"Indiana","Clay County",5,13,351,195,156
050,18,021,"Indiana","Clay County",5,14,359,187,172
050,18,021,"Indiana","Clay County",5,15,370,183,187
050,18,021,"Indiana","Clay County",5,16,358,185,173
050,18,021,"Indiana","Clay County",5,17,371,197,174
050,18,021,"Indiana","Clay County",5,18,298,161,137
050,18,021,"Indiana","Clay County",5,19,230,125,105
050,18,021,"Indiana","Clay County",5,20,254,147,107
050,18,021,"Indiana","Clay County",5,21,249,130,119
050,18,021,"Indiana","Clay County",5,22,293,138,155
050,18,021,"Indiana","Clay County",5,23,283,141,142
050,18,021,"Indiana","Clay County",5,24,280,128,152
050,18,021,"Indiana","Clay County",5,25,316,148,168
050,18,021,"Indiana","Clay County",5,26,284,151,133
050,18,021,"Indiana","Clay County",5,27,316,174,142
050,18,021,"Indiana","Clay County",5,28,313,171,142
050,18,021,"Indiana","Clay County",5,29,305,151,154
050,18,021,"Indiana","Clay County",5,30,337,172,165
050,18,021,"Indiana","Clay County",5,31,350,177,173
050,18,021,"Indiana","Clay County",5,32,320,167,153
050,18,021,"Indiana","Clay County",5,33,327,158,169
050,18,021,"Indiana","Clay County",5,34,317,147,170
050,18,021,"Indiana","Clay County",5,35,316,160,156
050,18,021,"Indiana","Clay County",5,36,312,163,149
050,18,021,"Indiana","Clay County",5,37,328,168,160
050,18,021,"Indiana","Clay County",5,38,333,168,165
050,18,021,"Indiana","Clay County",5,39,324,169,155
050,18,021,"Indiana","Clay County",5,40,343,175,168
050,18,021,"Indiana","Clay County",5,41,352,189,163
050,18,021,"Indiana","Clay County",5,42,340,172,168
050,18,021,"Indiana","Clay County",5,43,326,170,156
050,18,021,"Indiana","Clay County",5,44,346,175,171
050,18,021,"Indiana","Clay County",5,45,304,139,165
050,18,021,"Indiana","Clay County",5,46,329,171,158
050,18,021,"Indiana","Clay County",5,47,308,154,154
050,18,021,"Indiana","Clay County",5,48,323,177,146
050,18,021,"Indiana","Clay County",5,49,321,167,154
050,18,021,"Indiana","Clay County",5,50,302,149,153
050,18,021,"Indiana","Clay County",5,51,342,170,172
050,18,021,"Indiana","Clay County",5,52,344,171,173
050,18,021,"Indiana","Clay County",5,53,334,167,167
050,18,021,"Indiana","Clay County",5,54,319,159,160
050,18,021,"Indiana","Clay County",5,55,324,164,160
050,18,021,"Indiana","Clay County",5,56,330,173,157
050,18,021,"Indiana","Clay County",5,57,325,162,163
050,18,021,"Indiana","Clay County",5,58,326,159,167
050,18,021,"Indiana","Clay County",5,59,377,190,187
050,18,021,"Indiana","Clay County",5,60,388,196,192
050,18,021,"Indiana","Clay County",5,61,390,196,194
050,18,021,"Indiana","Clay County",5,62,382,193,189
050,18,021,"Indiana","Clay County",5,63,389,205,184
050,18,021,"Indiana","Clay County",5,64,363,181,182
050,18,021,"Indiana","Clay County",5,65,375,175,200
050,18,021,"Indiana","Clay County",5,66,388,196,192
050,18,021,"Indiana","Clay County",5,67,345,167,178
050,18,021,"Indiana","Clay County",5,68,337,150,187
050,18,021,"Indiana","Clay County",5,69,318,146,172
050,18,021,"Indiana","Clay County",5,70,299,136,163
050,18,021,"Indiana","Clay County",5,71,280,132,148
050,18,021,"Indiana","Clay County",5,72,275,130,145
050,18,021,"Indiana","Clay County",5,73,282,131,151
050,18,021,"Indiana","Clay County",5,74,262,124,138
050,18,021,"Indiana","Clay County",5,75,253,120,133
050,18,021,"Indiana","Clay County",5,76,240,109,131
050,18,021,"Indiana","Clay County",5,77,166,79,87
050,18,021,"Indiana","Clay County",5,78,156,73,83
050,18,021,"Indiana","Clay County",5,79,134,54,80
050,18,021,"Indiana","Clay County",5,80,145,61,84
050,18,021,"Indiana","Clay County",5,81,120,50,70
050,18,021,"Indiana","Clay County",5,82,112,48,64
050,18,021,"Indiana","Clay County",5,83,121,51,70
050,18,021,"Indiana","Clay County",5,84,99,37,62
050,18,021,"Indiana","Clay County",5,85,480,177,303
050,18,023,"Indiana","Clinton County",1,0,434,222,212
050,18,023,"Indiana","Clinton County",1,1,432,215,217
050,18,023,"Indiana","Clinton County",1,2,455,223,232
050,18,023,"Indiana","Clinton County",1,3,475,244,231
050,18,023,"Indiana","Clinton County",1,4,460,235,225
050,18,023,"Indiana","Clinton County",1,5,498,253,245
050,18,023,"Indiana","Clinton County",1,6,490,253,237
050,18,023,"Indiana","Clinton County",1,7,460,243,217
050,18,023,"Indiana","Clinton County",1,8,454,230,224
050,18,023,"Indiana","Clinton County",1,9,472,236,236
050,18,023,"Indiana","Clinton County",1,10,526,264,262
050,18,023,"Indiana","Clinton County",1,11,530,279,251
050,18,023,"Indiana","Clinton County",1,12,574,306,268
050,18,023,"Indiana","Clinton County",1,13,578,309,269
050,18,023,"Indiana","Clinton County",1,14,542,270,272
050,18,023,"Indiana","Clinton County",1,15,517,267,250
050,18,023,"Indiana","Clinton County",1,16,529,266,263
050,18,023,"Indiana","Clinton County",1,17,527,282,245
050,18,023,"Indiana","Clinton County",1,18,452,233,219
050,18,023,"Indiana","Clinton County",1,19,387,199,188
050,18,023,"Indiana","Clinton County",1,20,358,195,163
050,18,023,"Indiana","Clinton County",1,21,356,184,172
050,18,023,"Indiana","Clinton County",1,22,388,203,185
050,18,023,"Indiana","Clinton County",1,23,394,204,190
050,18,023,"Indiana","Clinton County",1,24,371,191,180
050,18,023,"Indiana","Clinton County",1,25,362,192,170
050,18,023,"Indiana","Clinton County",1,26,397,193,204
050,18,023,"Indiana","Clinton County",1,27,418,219,199
050,18,023,"Indiana","Clinton County",1,28,419,207,212
050,18,023,"Indiana","Clinton County",1,29,421,216,205
050,18,023,"Indiana","Clinton County",1,30,371,190,181
050,18,023,"Indiana","Clinton County",1,31,393,191,202
050,18,023,"Indiana","Clinton County",1,32,410,212,198
050,18,023,"Indiana","Clinton County",1,33,399,198,201
050,18,023,"Indiana","Clinton County",1,34,434,224,210
050,18,023,"Indiana","Clinton County",1,35,389,207,182
050,18,023,"Indiana","Clinton County",1,36,391,206,185
050,18,023,"Indiana","Clinton County",1,37,414,208,206
050,18,023,"Indiana","Clinton County",1,38,420,195,225
050,18,023,"Indiana","Clinton County",1,39,405,201,204
050,18,023,"Indiana","Clinton County",1,40,378,204,174
050,18,023,"Indiana","Clinton County",1,41,370,189,181
050,18,023,"Indiana","Clinton County",1,42,380,196,184
050,18,023,"Indiana","Clinton County",1,43,374,196,178
050,18,023,"Indiana","Clinton County",1,44,370,181,189
050,18,023,"Indiana","Clinton County",1,45,399,204,195
050,18,023,"Indiana","Clinton County",1,46,388,194,194
050,18,023,"Indiana","Clinton County",1,47,403,202,201
050,18,023,"Indiana","Clinton County",1,48,398,225,173
050,18,023,"Indiana","Clinton County",1,49,437,247,190
050,18,023,"Indiana","Clinton County",1,50,417,226,191
050,18,023,"Indiana","Clinton County",1,51,403,211,192
050,18,023,"Indiana","Clinton County",1,52,370,201,169
050,18,023,"Indiana","Clinton County",1,53,361,179,182
050,18,023,"Indiana","Clinton County",1,54,396,190,206
050,18,023,"Indiana","Clinton County",1,55,419,207,212
050,18,023,"Indiana","Clinton County",1,56,439,213,226
050,18,023,"Indiana","Clinton County",1,57,447,222,225
050,18,023,"Indiana","Clinton County",1,58,439,231,208
050,18,023,"Indiana","Clinton County",1,59,456,225,231
050,18,023,"Indiana","Clinton County",1,60,459,210,249
050,18,023,"Indiana","Clinton County",1,61,424,194,230
050,18,023,"Indiana","Clinton County",1,62,405,205,200
050,18,023,"Indiana","Clinton County",1,63,405,196,209
050,18,023,"Indiana","Clinton County",1,64,414,207,207
050,18,023,"Indiana","Clinton County",1,65,383,189,194
050,18,023,"Indiana","Clinton County",1,66,371,188,183
050,18,023,"Indiana","Clinton County",1,67,357,173,184
050,18,023,"Indiana","Clinton County",1,68,347,179,168
050,18,023,"Indiana","Clinton County",1,69,307,151,156
050,18,023,"Indiana","Clinton County",1,70,279,129,150
050,18,023,"Indiana","Clinton County",1,71,286,138,148
050,18,023,"Indiana","Clinton County",1,72,280,145,135
050,18,023,"Indiana","Clinton County",1,73,271,135,136
050,18,023,"Indiana","Clinton County",1,74,189,79,110
050,18,023,"Indiana","Clinton County",1,75,186,81,105
050,18,023,"Indiana","Clinton County",1,76,187,85,102
050,18,023,"Indiana","Clinton County",1,77,181,75,106
050,18,023,"Indiana","Clinton County",1,78,177,75,102
050,18,023,"Indiana","Clinton County",1,79,145,60,85
050,18,023,"Indiana","Clinton County",1,80,141,60,81
050,18,023,"Indiana","Clinton County",1,81,154,66,88
050,18,023,"Indiana","Clinton County",1,82,141,61,80
050,18,023,"Indiana","Clinton County",1,83,122,49,73
050,18,023,"Indiana","Clinton County",1,84,96,37,59
050,18,023,"Indiana","Clinton County",1,85,736,242,494
050,18,023,"Indiana","Clinton County",2,0,456,234,222
050,18,023,"Indiana","Clinton County",2,1,426,213,213
050,18,023,"Indiana","Clinton County",2,2,447,219,228
050,18,023,"Indiana","Clinton County",2,3,468,237,231
050,18,023,"Indiana","Clinton County",2,4,465,238,227
050,18,023,"Indiana","Clinton County",2,5,492,250,242
050,18,023,"Indiana","Clinton County",2,6,491,254,237
050,18,023,"Indiana","Clinton County",2,7,468,245,223
050,18,023,"Indiana","Clinton County",2,8,456,232,224
050,18,023,"Indiana","Clinton County",2,9,471,236,235
050,18,023,"Indiana","Clinton County",2,10,512,258,254
050,18,023,"Indiana","Clinton County",2,11,529,276,253
050,18,023,"Indiana","Clinton County",2,12,569,304,265
050,18,023,"Indiana","Clinton County",2,13,580,308,272
050,18,023,"Indiana","Clinton County",2,14,552,279,273
050,18,023,"Indiana","Clinton County",2,15,525,266,259
050,18,023,"Indiana","Clinton County",2,16,527,267,260
050,18,023,"Indiana","Clinton County",2,17,526,277,249
050,18,023,"Indiana","Clinton County",2,18,451,238,213
050,18,023,"Indiana","Clinton County",2,19,384,199,185
050,18,023,"Indiana","Clinton County",2,20,370,199,171
050,18,023,"Indiana","Clinton County",2,21,361,190,171
050,18,023,"Indiana","Clinton County",2,22,384,199,185
050,18,023,"Indiana","Clinton County",2,23,393,204,189
050,18,023,"Indiana","Clinton County",2,24,374,193,181
050,18,023,"Indiana","Clinton County",2,25,365,193,172
050,18,023,"Indiana","Clinton County",2,26,387,192,195
050,18,023,"Indiana","Clinton County",2,27,413,214,199
050,18,023,"Indiana","Clinton County",2,28,416,208,208
050,18,023,"Indiana","Clinton County",2,29,413,210,203
050,18,023,"Indiana","Clinton County",2,30,385,197,188
050,18,023,"Indiana","Clinton County",2,31,384,189,195
050,18,023,"Indiana","Clinton County",2,32,409,209,200
050,18,023,"Indiana","Clinton County",2,33,403,201,202
050,18,023,"Indiana","Clinton County",2,34,429,220,209
050,18,023,"Indiana","Clinton County",2,35,400,212,188
050,18,023,"Indiana","Clinton County",2,36,390,206,184
050,18,023,"Indiana","Clinton County",2,37,409,208,201
050,18,023,"Indiana","Clinton County",2,38,424,200,224
050,18,023,"Indiana","Clinton County",2,39,405,198,207
050,18,023,"Indiana","Clinton County",2,40,391,207,184
050,18,023,"Indiana","Clinton County",2,41,370,192,178
050,18,023,"Indiana","Clinton County",2,42,375,195,180
050,18,023,"Indiana","Clinton County",2,43,378,197,181
050,18,023,"Indiana","Clinton County",2,44,369,185,184
050,18,023,"Indiana","Clinton County",2,45,394,199,195
050,18,023,"Indiana","Clinton County",2,46,388,195,193
050,18,023,"Indiana","Clinton County",2,47,396,198,198
050,18,023,"Indiana","Clinton County",2,48,399,220,179
050,18,023,"Indiana","Clinton County",2,49,428,242,186
050,18,023,"Indiana","Clinton County",2,50,420,229,191
050,18,023,"Indiana","Clinton County",2,51,403,214,189
050,18,023,"Indiana","Clinton County",2,52,377,203,174
050,18,023,"Indiana","Clinton County",2,53,360,182,178
050,18,023,"Indiana","Clinton County",2,54,384,187,197
050,18,023,"Indiana","Clinton County",2,55,415,202,213
050,18,023,"Indiana","Clinton County",2,56,436,212,224
050,18,023,"Indiana","Clinton County",2,57,444,220,224
050,18,023,"Indiana","Clinton County",2,58,438,226,212
050,18,023,"Indiana","Clinton County",2,59,450,225,225
050,18,023,"Indiana","Clinton County",2,60,457,213,244
050,18,023,"Indiana","Clinton County",2,61,430,196,234
050,18,023,"Indiana","Clinton County",2,62,405,200,205
050,18,023,"Indiana","Clinton County",2,63,408,199,209
050,18,023,"Indiana","Clinton County",2,64,406,202,204
050,18,023,"Indiana","Clinton County",2,65,389,194,195
050,18,023,"Indiana","Clinton County",2,66,373,187,186
050,18,023,"Indiana","Clinton County",2,67,358,175,183
050,18,023,"Indiana","Clinton County",2,68,347,176,171
050,18,023,"Indiana","Clinton County",2,69,317,158,159
050,18,023,"Indiana","Clinton County",2,70,283,134,149
050,18,023,"Indiana","Clinton County",2,71,282,135,147
050,18,023,"Indiana","Clinton County",2,72,275,140,135
050,18,023,"Indiana","Clinton County",2,73,281,141,140
050,18,023,"Indiana","Clinton County",2,74,196,86,110
050,18,023,"Indiana","Clinton County",2,75,186,80,106
050,18,023,"Indiana","Clinton County",2,76,184,83,101
050,18,023,"Indiana","Clinton County",2,77,181,74,107
050,18,023,"Indiana","Clinton County",2,78,174,74,100
050,18,023,"Indiana","Clinton County",2,79,146,59,87
050,18,023,"Indiana","Clinton County",2,80,138,58,80
050,18,023,"Indiana","Clinton County",2,81,146,60,86
050,18,023,"Indiana","Clinton County",2,82,139,59,80
050,18,023,"Indiana","Clinton County",2,83,123,48,75
050,18,023,"Indiana","Clinton County",2,84,100,39,61
050,18,023,"Indiana","Clinton County",2,85,730,239,491
050,18,023,"Indiana","Clinton County",3,0,373,207,166
050,18,023,"Indiana","Clinton County",3,1,468,236,232
050,18,023,"Indiana","Clinton County",3,2,436,215,221
050,18,023,"Indiana","Clinton County",3,3,446,221,225
050,18,023,"Indiana","Clinton County",3,4,488,252,236
050,18,023,"Indiana","Clinton County",3,5,463,236,227
050,18,023,"Indiana","Clinton County",3,6,502,262,240
050,18,023,"Indiana","Clinton County",3,7,476,250,226
050,18,023,"Indiana","Clinton County",3,8,487,244,243
050,18,023,"Indiana","Clinton County",3,9,458,235,223
050,18,023,"Indiana","Clinton County",3,10,486,246,240
050,18,023,"Indiana","Clinton County",3,11,509,260,249
050,18,023,"Indiana","Clinton County",3,12,532,278,254
050,18,023,"Indiana","Clinton County",3,13,553,296,257
050,18,023,"Indiana","Clinton County",3,14,561,293,268
050,18,023,"Indiana","Clinton County",3,15,548,281,267
050,18,023,"Indiana","Clinton County",3,16,524,267,257
050,18,023,"Indiana","Clinton County",3,17,515,264,251
050,18,023,"Indiana","Clinton County",3,18,461,254,207
050,18,023,"Indiana","Clinton County",3,19,375,195,180
050,18,023,"Indiana","Clinton County",3,20,381,194,187
050,18,023,"Indiana","Clinton County",3,21,387,205,182
050,18,023,"Indiana","Clinton County",3,22,382,194,188
050,18,023,"Indiana","Clinton County",3,23,390,203,187
050,18,023,"Indiana","Clinton County",3,24,379,202,177
050,18,023,"Indiana","Clinton County",3,25,373,198,175
050,18,023,"Indiana","Clinton County",3,26,376,187,189
050,18,023,"Indiana","Clinton County",3,27,381,184,197
050,18,023,"Indiana","Clinton County",3,28,409,206,203
050,18,023,"Indiana","Clinton County",3,29,422,208,214
050,18,023,"Indiana","Clinton County",3,30,428,220,208
050,18,023,"Indiana","Clinton County",3,31,373,186,187
050,18,023,"Indiana","Clinton County",3,32,392,199,193
050,18,023,"Indiana","Clinton County",3,33,411,206,205
050,18,023,"Indiana","Clinton County",3,34,404,203,201
050,18,023,"Indiana","Clinton County",3,35,429,225,204
050,18,023,"Indiana","Clinton County",3,36,390,206,184
050,18,023,"Indiana","Clinton County",3,37,393,217,176
050,18,023,"Indiana","Clinton County",3,38,407,205,202
050,18,023,"Indiana","Clinton County",3,39,425,204,221
050,18,023,"Indiana","Clinton County",3,40,405,196,209
050,18,023,"Indiana","Clinton County",3,41,397,210,187
050,18,023,"Indiana","Clinton County",3,42,381,195,186
050,18,023,"Indiana","Clinton County",3,43,386,201,185
050,18,023,"Indiana","Clinton County",3,44,374,191,183
050,18,023,"Indiana","Clinton County",3,45,374,187,187
050,18,023,"Indiana","Clinton County",3,46,372,188,184
050,18,023,"Indiana","Clinton County",3,47,392,195,197
050,18,023,"Indiana","Clinton County",3,48,390,197,193
050,18,023,"Indiana","Clinton County",3,49,393,220,173
050,18,023,"Indiana","Clinton County",3,50,422,239,183
050,18,023,"Indiana","Clinton County",3,51,416,225,191
050,18,023,"Indiana","Clinton County",3,52,394,204,190
050,18,023,"Indiana","Clinton County",3,53,372,195,177
050,18,023,"Indiana","Clinton County",3,54,351,184,167
050,18,023,"Indiana","Clinton County",3,55,367,175,192
050,18,023,"Indiana","Clinton County",3,56,403,197,206
050,18,023,"Indiana","Clinton County",3,57,429,211,218
050,18,023,"Indiana","Clinton County",3,58,433,218,215
050,18,023,"Indiana","Clinton County",3,59,433,220,213
050,18,023,"Indiana","Clinton County",3,60,433,214,219
050,18,023,"Indiana","Clinton County",3,61,436,200,236
050,18,023,"Indiana","Clinton County",3,62,426,197,229
050,18,023,"Indiana","Clinton County",3,63,407,191,216
050,18,023,"Indiana","Clinton County",3,64,400,197,203
050,18,023,"Indiana","Clinton County",3,65,387,190,197
050,18,023,"Indiana","Clinton County",3,66,383,190,193
050,18,023,"Indiana","Clinton County",3,67,349,177,172
050,18,023,"Indiana","Clinton County",3,68,350,168,182
050,18,023,"Indiana","Clinton County",3,69,336,172,164
050,18,023,"Indiana","Clinton County",3,70,304,153,151
050,18,023,"Indiana","Clinton County",3,71,275,125,150
050,18,023,"Indiana","Clinton County",3,72,274,134,140
050,18,023,"Indiana","Clinton County",3,73,260,137,123
050,18,023,"Indiana","Clinton County",3,74,266,129,137
050,18,023,"Indiana","Clinton County",3,75,192,81,111
050,18,023,"Indiana","Clinton County",3,76,173,74,99
050,18,023,"Indiana","Clinton County",3,77,174,81,93
050,18,023,"Indiana","Clinton County",3,78,177,70,107
050,18,023,"Indiana","Clinton County",3,79,156,65,91
050,18,023,"Indiana","Clinton County",3,80,134,54,80
050,18,023,"Indiana","Clinton County",3,81,127,48,79
050,18,023,"Indiana","Clinton County",3,82,125,50,75
050,18,023,"Indiana","Clinton County",3,83,133,48,85
050,18,023,"Indiana","Clinton County",3,84,116,52,64
050,18,023,"Indiana","Clinton County",3,85,713,233,480
050,18,023,"Indiana","Clinton County",4,0,391,206,185
050,18,023,"Indiana","Clinton County",4,1,372,201,171
050,18,023,"Indiana","Clinton County",4,2,458,219,239
050,18,023,"Indiana","Clinton County",4,3,432,205,227
050,18,023,"Indiana","Clinton County",4,4,444,219,225
050,18,023,"Indiana","Clinton County",4,5,466,243,223
050,18,023,"Indiana","Clinton County",4,6,464,233,231
050,18,023,"Indiana","Clinton County",4,7,490,261,229
050,18,023,"Indiana","Clinton County",4,8,481,244,237
050,18,023,"Indiana","Clinton County",4,9,477,241,236
050,18,023,"Indiana","Clinton County",4,10,455,236,219
050,18,023,"Indiana","Clinton County",4,11,488,251,237
050,18,023,"Indiana","Clinton County",4,12,509,261,248
050,18,023,"Indiana","Clinton County",4,13,517,265,252
050,18,023,"Indiana","Clinton County",4,14,561,305,256
050,18,023,"Indiana","Clinton County",4,15,573,296,277
050,18,023,"Indiana","Clinton County",4,16,529,274,255
050,18,023,"Indiana","Clinton County",4,17,527,268,259
050,18,023,"Indiana","Clinton County",4,18,449,235,214
050,18,023,"Indiana","Clinton County",4,19,388,212,176
050,18,023,"Indiana","Clinton County",4,20,385,197,188
050,18,023,"Indiana","Clinton County",4,21,403,199,204
050,18,023,"Indiana","Clinton County",4,22,415,213,202
050,18,023,"Indiana","Clinton County",4,23,387,198,189
050,18,023,"Indiana","Clinton County",4,24,379,195,184
050,18,023,"Indiana","Clinton County",4,25,379,201,178
050,18,023,"Indiana","Clinton County",4,26,356,186,170
050,18,023,"Indiana","Clinton County",4,27,385,198,187
050,18,023,"Indiana","Clinton County",4,28,378,180,198
050,18,023,"Indiana","Clinton County",4,29,404,200,204
050,18,023,"Indiana","Clinton County",4,30,419,209,210
050,18,023,"Indiana","Clinton County",4,31,441,226,215
050,18,023,"Indiana","Clinton County",4,32,379,190,189
050,18,023,"Indiana","Clinton County",4,33,398,205,193
050,18,023,"Indiana","Clinton County",4,34,416,203,213
050,18,023,"Indiana","Clinton County",4,35,404,205,199
050,18,023,"Indiana","Clinton County",4,36,417,216,201
050,18,023,"Indiana","Clinton County",4,37,386,201,185
050,18,023,"Indiana","Clinton County",4,38,398,217,181
050,18,023,"Indiana","Clinton County",4,39,403,195,208
050,18,023,"Indiana","Clinton County",4,40,415,199,216
050,18,023,"Indiana","Clinton County",4,41,389,188,201
050,18,023,"Indiana","Clinton County",4,42,391,206,185
050,18,023,"Indiana","Clinton County",4,43,390,204,186
050,18,023,"Indiana","Clinton County",4,44,388,201,187
050,18,023,"Indiana","Clinton County",4,45,380,187,193
050,18,023,"Indiana","Clinton County",4,46,362,179,183
050,18,023,"Indiana","Clinton County",4,47,376,189,187
050,18,023,"Indiana","Clinton County",4,48,375,190,185
050,18,023,"Indiana","Clinton County",4,49,397,200,197
050,18,023,"Indiana","Clinton County",4,50,392,216,176
050,18,023,"Indiana","Clinton County",4,51,437,247,190
050,18,023,"Indiana","Clinton County",4,52,407,218,189
050,18,023,"Indiana","Clinton County",4,53,388,200,188
050,18,023,"Indiana","Clinton County",4,54,371,198,173
050,18,023,"Indiana","Clinton County",4,55,351,178,173
050,18,023,"Indiana","Clinton County",4,56,365,178,187
050,18,023,"Indiana","Clinton County",4,57,409,199,210
050,18,023,"Indiana","Clinton County",4,58,417,202,215
050,18,023,"Indiana","Clinton County",4,59,431,215,216
050,18,023,"Indiana","Clinton County",4,60,423,216,207
050,18,023,"Indiana","Clinton County",4,61,425,212,213
050,18,023,"Indiana","Clinton County",4,62,434,198,236
050,18,023,"Indiana","Clinton County",4,63,420,191,229
050,18,023,"Indiana","Clinton County",4,64,401,186,215
050,18,023,"Indiana","Clinton County",4,65,385,187,198
050,18,023,"Indiana","Clinton County",4,66,371,185,186
050,18,023,"Indiana","Clinton County",4,67,370,181,189
050,18,023,"Indiana","Clinton County",4,68,336,171,165
050,18,023,"Indiana","Clinton County",4,69,340,163,177
050,18,023,"Indiana","Clinton County",4,70,330,164,166
050,18,023,"Indiana","Clinton County",4,71,294,143,151
050,18,023,"Indiana","Clinton County",4,72,270,120,150
050,18,023,"Indiana","Clinton County",4,73,255,130,125
050,18,023,"Indiana","Clinton County",4,74,248,125,123
050,18,023,"Indiana","Clinton County",4,75,258,125,133
050,18,023,"Indiana","Clinton County",4,76,170,68,102
050,18,023,"Indiana","Clinton County",4,77,164,70,94
050,18,023,"Indiana","Clinton County",4,78,165,82,83
050,18,023,"Indiana","Clinton County",4,79,157,65,92
050,18,023,"Indiana","Clinton County",4,80,152,67,85
050,18,023,"Indiana","Clinton County",4,81,122,44,78
050,18,023,"Indiana","Clinton County",4,82,111,41,70
050,18,023,"Indiana","Clinton County",4,83,117,39,78
050,18,023,"Indiana","Clinton County",4,84,120,49,71
050,18,023,"Indiana","Clinton County",4,85,697,226,471
050,18,023,"Indiana","Clinton County",5,0,395,208,187
050,18,023,"Indiana","Clinton County",5,1,396,198,198
050,18,023,"Indiana","Clinton County",5,2,392,207,185
050,18,023,"Indiana","Clinton County",5,3,469,221,248
050,18,023,"Indiana","Clinton County",5,4,442,205,237
050,18,023,"Indiana","Clinton County",5,5,449,218,231
050,18,023,"Indiana","Clinton County",5,6,479,258,221
050,18,023,"Indiana","Clinton County",5,7,449,227,222
050,18,023,"Indiana","Clinton County",5,8,502,256,246
050,18,023,"Indiana","Clinton County",5,9,491,249,242
050,18,023,"Indiana","Clinton County",5,10,485,238,247
050,18,023,"Indiana","Clinton County",5,11,470,251,219
050,18,023,"Indiana","Clinton County",5,12,495,246,249
050,18,023,"Indiana","Clinton County",5,13,520,263,257
050,18,023,"Indiana","Clinton County",5,14,513,261,252
050,18,023,"Indiana","Clinton County",5,15,564,304,260
050,18,023,"Indiana","Clinton County",5,16,565,295,270
050,18,023,"Indiana","Clinton County",5,17,532,275,257
050,18,023,"Indiana","Clinton County",5,18,471,254,217
050,18,023,"Indiana","Clinton County",5,19,368,192,176
050,18,023,"Indiana","Clinton County",5,20,403,219,184
050,18,023,"Indiana","Clinton County",5,21,409,213,196
050,18,023,"Indiana","Clinton County",5,22,425,207,218
050,18,023,"Indiana","Clinton County",5,23,427,226,201
050,18,023,"Indiana","Clinton County",5,24,388,201,187
050,18,023,"Indiana","Clinton County",5,25,365,187,178
050,18,023,"Indiana","Clinton County",5,26,381,201,180
050,18,023,"Indiana","Clinton County",5,27,368,198,170
050,18,023,"Indiana","Clinton County",5,28,377,186,191
050,18,023,"Indiana","Clinton County",5,29,386,184,202
050,18,023,"Indiana","Clinton County",5,30,411,194,217
050,18,023,"Indiana","Clinton County",5,31,411,201,210
050,18,023,"Indiana","Clinton County",5,32,441,231,210
050,18,023,"Indiana","Clinton County",5,33,377,183,194
050,18,023,"Indiana","Clinton County",5,34,402,207,195
050,18,023,"Indiana","Clinton County",5,35,414,211,203
050,18,023,"Indiana","Clinton County",5,36,397,195,202
050,18,023,"Indiana","Clinton County",5,37,408,213,195
050,18,023,"Indiana","Clinton County",5,38,391,201,190
050,18,023,"Indiana","Clinton County",5,39,390,212,178
050,18,023,"Indiana","Clinton County",5,40,402,195,207
050,18,023,"Indiana","Clinton County",5,41,414,197,217
050,18,023,"Indiana","Clinton County",5,42,397,198,199
050,18,023,"Indiana","Clinton County",5,43,381,199,182
050,18,023,"Indiana","Clinton County",5,44,379,196,183
050,18,023,"Indiana","Clinton County",5,45,379,197,182
050,18,023,"Indiana","Clinton County",5,46,383,191,192
050,18,023,"Indiana","Clinton County",5,47,357,173,184
050,18,023,"Indiana","Clinton County",5,48,379,193,186
050,18,023,"Indiana","Clinton County",5,49,380,194,186
050,18,023,"Indiana","Clinton County",5,50,398,202,196
050,18,023,"Indiana","Clinton County",5,51,392,222,170
050,18,023,"Indiana","Clinton County",5,52,422,236,186
050,18,023,"Indiana","Clinton County",5,53,392,206,186
050,18,023,"Indiana","Clinton County",5,54,382,201,181
050,18,023,"Indiana","Clinton County",5,55,361,194,167
050,18,023,"Indiana","Clinton County",5,56,344,173,171
050,18,023,"Indiana","Clinton County",5,57,360,174,186
050,18,023,"Indiana","Clinton County",5,58,395,187,208
050,18,023,"Indiana","Clinton County",5,59,418,201,217
050,18,023,"Indiana","Clinton County",5,60,424,216,208
050,18,023,"Indiana","Clinton County",5,61,418,217,201
050,18,023,"Indiana","Clinton County",5,62,417,207,210
050,18,023,"Indiana","Clinton County",5,63,421,187,234
050,18,023,"Indiana","Clinton County",5,64,409,186,223
050,18,023,"Indiana","Clinton County",5,65,381,174,207
050,18,023,"Indiana","Clinton County",5,66,374,183,191
050,18,023,"Indiana","Clinton County",5,67,356,175,181
050,18,023,"Indiana","Clinton County",5,68,363,178,185
050,18,023,"Indiana","Clinton County",5,69,320,166,154
050,18,023,"Indiana","Clinton County",5,70,335,159,176
050,18,023,"Indiana","Clinton County",5,71,321,153,168
050,18,023,"Indiana","Clinton County",5,72,286,140,146
050,18,023,"Indiana","Clinton County",5,73,262,119,143
050,18,023,"Indiana","Clinton County",5,74,248,123,125
050,18,023,"Indiana","Clinton County",5,75,235,117,118
050,18,023,"Indiana","Clinton County",5,76,239,113,126
050,18,023,"Indiana","Clinton County",5,77,160,64,96
050,18,023,"Indiana","Clinton County",5,78,160,65,95
050,18,023,"Indiana","Clinton County",5,79,157,78,79
050,18,023,"Indiana","Clinton County",5,80,152,66,86
050,18,023,"Indiana","Clinton County",5,81,139,60,79
050,18,023,"Indiana","Clinton County",5,82,104,37,67
050,18,023,"Indiana","Clinton County",5,83,104,31,73
050,18,023,"Indiana","Clinton County",5,84,107,41,66
050,18,023,"Indiana","Clinton County",5,85,705,226,479
050,18,025,"Indiana","Crawford County",1,0,116,61,55
050,18,025,"Indiana","Crawford County",1,1,125,68,57
050,18,025,"Indiana","Crawford County",1,2,120,60,60
050,18,025,"Indiana","Crawford County",1,3,126,66,60
050,18,025,"Indiana","Crawford County",1,4,107,57,50
050,18,025,"Indiana","Crawford County",1,5,121,60,61
050,18,025,"Indiana","Crawford County",1,6,120,54,66
050,18,025,"Indiana","Crawford County",1,7,119,62,57
050,18,025,"Indiana","Crawford County",1,8,121,61,60
050,18,025,"Indiana","Crawford County",1,9,109,55,54
050,18,025,"Indiana","Crawford County",1,10,133,66,67
050,18,025,"Indiana","Crawford County",1,11,136,66,70
050,18,025,"Indiana","Crawford County",1,12,155,78,77
050,18,025,"Indiana","Crawford County",1,13,133,66,67
050,18,025,"Indiana","Crawford County",1,14,141,67,74
050,18,025,"Indiana","Crawford County",1,15,153,79,74
050,18,025,"Indiana","Crawford County",1,16,141,72,69
050,18,025,"Indiana","Crawford County",1,17,134,66,68
050,18,025,"Indiana","Crawford County",1,18,111,60,51
050,18,025,"Indiana","Crawford County",1,19,87,51,36
050,18,025,"Indiana","Crawford County",1,20,98,58,40
050,18,025,"Indiana","Crawford County",1,21,95,53,42
050,18,025,"Indiana","Crawford County",1,22,104,53,51
050,18,025,"Indiana","Crawford County",1,23,100,49,51
050,18,025,"Indiana","Crawford County",1,24,112,56,56
050,18,025,"Indiana","Crawford County",1,25,106,49,57
050,18,025,"Indiana","Crawford County",1,26,106,50,56
050,18,025,"Indiana","Crawford County",1,27,113,58,55
050,18,025,"Indiana","Crawford County",1,28,125,60,65
050,18,025,"Indiana","Crawford County",1,29,116,60,56
050,18,025,"Indiana","Crawford County",1,30,125,65,60
050,18,025,"Indiana","Crawford County",1,31,98,58,40
050,18,025,"Indiana","Crawford County",1,32,89,49,40
050,18,025,"Indiana","Crawford County",1,33,102,50,52
050,18,025,"Indiana","Crawford County",1,34,116,58,58
050,18,025,"Indiana","Crawford County",1,35,108,52,56
050,18,025,"Indiana","Crawford County",1,36,113,62,51
050,18,025,"Indiana","Crawford County",1,37,107,54,53
050,18,025,"Indiana","Crawford County",1,38,116,61,55
050,18,025,"Indiana","Crawford County",1,39,130,71,59
050,18,025,"Indiana","Crawford County",1,40,118,66,52
050,18,025,"Indiana","Crawford County",1,41,134,74,60
050,18,025,"Indiana","Crawford County",1,42,123,70,53
050,18,025,"Indiana","Crawford County",1,43,114,60,54
050,18,025,"Indiana","Crawford County",1,44,129,68,61
050,18,025,"Indiana","Crawford County",1,45,135,64,71
050,18,025,"Indiana","Crawford County",1,46,128,58,70
050,18,025,"Indiana","Crawford County",1,47,152,72,80
050,18,025,"Indiana","Crawford County",1,48,142,70,72
050,18,025,"Indiana","Crawford County",1,49,132,70,62
050,18,025,"Indiana","Crawford County",1,50,115,63,52
050,18,025,"Indiana","Crawford County",1,51,127,65,62
050,18,025,"Indiana","Crawford County",1,52,134,69,65
050,18,025,"Indiana","Crawford County",1,53,148,75,73
050,18,025,"Indiana","Crawford County",1,54,163,85,78
050,18,025,"Indiana","Crawford County",1,55,170,82,88
050,18,025,"Indiana","Crawford County",1,56,172,88,84
050,18,025,"Indiana","Crawford County",1,57,182,97,85
050,18,025,"Indiana","Crawford County",1,58,178,93,85
050,18,025,"Indiana","Crawford County",1,59,172,89,83
050,18,025,"Indiana","Crawford County",1,60,180,103,77
050,18,025,"Indiana","Crawford County",1,61,182,100,82
050,18,025,"Indiana","Crawford County",1,62,172,83,89
050,18,025,"Indiana","Crawford County",1,63,166,87,79
050,18,025,"Indiana","Crawford County",1,64,148,72,76
050,18,025,"Indiana","Crawford County",1,65,160,83,77
050,18,025,"Indiana","Crawford County",1,66,166,82,84
050,18,025,"Indiana","Crawford County",1,67,149,72,77
050,18,025,"Indiana","Crawford County",1,68,148,76,72
050,18,025,"Indiana","Crawford County",1,69,140,82,58
050,18,025,"Indiana","Crawford County",1,70,129,72,57
050,18,025,"Indiana","Crawford County",1,71,128,71,57
050,18,025,"Indiana","Crawford County",1,72,122,67,55
050,18,025,"Indiana","Crawford County",1,73,125,66,59
050,18,025,"Indiana","Crawford County",1,74,89,39,50
050,18,025,"Indiana","Crawford County",1,75,71,34,37
050,18,025,"Indiana","Crawford County",1,76,94,49,45
050,18,025,"Indiana","Crawford County",1,77,88,42,46
050,18,025,"Indiana","Crawford County",1,78,74,35,39
050,18,025,"Indiana","Crawford County",1,79,60,34,26
050,18,025,"Indiana","Crawford County",1,80,49,20,29
050,18,025,"Indiana","Crawford County",1,81,57,30,27
050,18,025,"Indiana","Crawford County",1,82,43,20,23
050,18,025,"Indiana","Crawford County",1,83,44,22,22
050,18,025,"Indiana","Crawford County",1,84,37,16,21
050,18,025,"Indiana","Crawford County",1,85,152,50,102
050,18,025,"Indiana","Crawford County",2,0,108,57,51
050,18,025,"Indiana","Crawford County",2,1,123,67,56
050,18,025,"Indiana","Crawford County",2,2,120,61,59
050,18,025,"Indiana","Crawford County",2,3,122,64,58
050,18,025,"Indiana","Crawford County",2,4,113,60,53
050,18,025,"Indiana","Crawford County",2,5,118,59,59
050,18,025,"Indiana","Crawford County",2,6,122,56,66
050,18,025,"Indiana","Crawford County",2,7,122,62,60
050,18,025,"Indiana","Crawford County",2,8,119,61,58
050,18,025,"Indiana","Crawford County",2,9,113,57,56
050,18,025,"Indiana","Crawford County",2,10,126,63,63
050,18,025,"Indiana","Crawford County",2,11,133,65,68
050,18,025,"Indiana","Crawford County",2,12,150,76,74
050,18,025,"Indiana","Crawford County",2,13,137,68,69
050,18,025,"Indiana","Crawford County",2,14,140,68,72
050,18,025,"Indiana","Crawford County",2,15,151,77,74
050,18,025,"Indiana","Crawford County",2,16,146,75,71
050,18,025,"Indiana","Crawford County",2,17,137,69,68
050,18,025,"Indiana","Crawford County",2,18,111,59,52
050,18,025,"Indiana","Crawford County",2,19,88,49,39
050,18,025,"Indiana","Crawford County",2,20,97,57,40
050,18,025,"Indiana","Crawford County",2,21,98,55,43
050,18,025,"Indiana","Crawford County",2,22,103,53,50
050,18,025,"Indiana","Crawford County",2,23,103,51,52
050,18,025,"Indiana","Crawford County",2,24,109,55,54
050,18,025,"Indiana","Crawford County",2,25,106,50,56
050,18,025,"Indiana","Crawford County",2,26,107,51,56
050,18,025,"Indiana","Crawford County",2,27,111,56,55
050,18,025,"Indiana","Crawford County",2,28,120,59,61
050,18,025,"Indiana","Crawford County",2,29,117,59,58
050,18,025,"Indiana","Crawford County",2,30,124,65,59
050,18,025,"Indiana","Crawford County",2,31,103,59,44
050,18,025,"Indiana","Crawford County",2,32,88,49,39
050,18,025,"Indiana","Crawford County",2,33,100,50,50
050,18,025,"Indiana","Crawford County",2,34,113,56,57
050,18,025,"Indiana","Crawford County",2,35,109,54,55
050,18,025,"Indiana","Crawford County",2,36,112,59,53
050,18,025,"Indiana","Crawford County",2,37,108,55,53
050,18,025,"Indiana","Crawford County",2,38,117,61,56
050,18,025,"Indiana","Crawford County",2,39,127,68,59
050,18,025,"Indiana","Crawford County",2,40,123,68,55
050,18,025,"Indiana","Crawford County",2,41,131,74,57
050,18,025,"Indiana","Crawford County",2,42,126,72,54
050,18,025,"Indiana","Crawford County",2,43,119,64,55
050,18,025,"Indiana","Crawford County",2,44,125,66,59
050,18,025,"Indiana","Crawford County",2,45,136,66,70
050,18,025,"Indiana","Crawford County",2,46,130,59,71
050,18,025,"Indiana","Crawford County",2,47,147,69,78
050,18,025,"Indiana","Crawford County",2,48,145,71,74
050,18,025,"Indiana","Crawford County",2,49,135,71,64
050,18,025,"Indiana","Crawford County",2,50,119,65,54
050,18,025,"Indiana","Crawford County",2,51,124,64,60
050,18,025,"Indiana","Crawford County",2,52,132,68,64
050,18,025,"Indiana","Crawford County",2,53,148,75,73
050,18,025,"Indiana","Crawford County",2,54,158,81,77
050,18,025,"Indiana","Crawford County",2,55,168,81,87
050,18,025,"Indiana","Crawford County",2,56,171,86,85
050,18,025,"Indiana","Crawford County",2,57,179,95,84
050,18,025,"Indiana","Crawford County",2,58,178,94,84
050,18,025,"Indiana","Crawford County",2,59,174,90,84
050,18,025,"Indiana","Crawford County",2,60,179,100,79
050,18,025,"Indiana","Crawford County",2,61,180,100,80
050,18,025,"Indiana","Crawford County",2,62,174,87,87
050,18,025,"Indiana","Crawford County",2,63,168,86,82
050,18,025,"Indiana","Crawford County",2,64,153,76,77
050,18,025,"Indiana","Crawford County",2,65,158,81,77
050,18,025,"Indiana","Crawford County",2,66,165,82,83
050,18,025,"Indiana","Crawford County",2,67,153,73,80
050,18,025,"Indiana","Crawford County",2,68,147,75,72
050,18,025,"Indiana","Crawford County",2,69,142,81,61
050,18,025,"Indiana","Crawford County",2,70,128,73,55
050,18,025,"Indiana","Crawford County",2,71,127,70,57
050,18,025,"Indiana","Crawford County",2,72,122,67,55
050,18,025,"Indiana","Crawford County",2,73,130,70,60
050,18,025,"Indiana","Crawford County",2,74,92,43,49
050,18,025,"Indiana","Crawford County",2,75,74,35,39
050,18,025,"Indiana","Crawford County",2,76,87,46,41
050,18,025,"Indiana","Crawford County",2,77,91,46,45
050,18,025,"Indiana","Crawford County",2,78,76,35,41
050,18,025,"Indiana","Crawford County",2,79,60,32,28
050,18,025,"Indiana","Crawford County",2,80,49,21,28
050,18,025,"Indiana","Crawford County",2,81,53,26,27
050,18,025,"Indiana","Crawford County",2,82,46,22,24
050,18,025,"Indiana","Crawford County",2,83,44,21,23
050,18,025,"Indiana","Crawford County",2,84,38,17,21
050,18,025,"Indiana","Crawford County",2,85,149,49,100
050,18,025,"Indiana","Crawford County",3,0,97,33,64
050,18,025,"Indiana","Crawford County",3,1,112,61,51
050,18,025,"Indiana","Crawford County",3,2,115,62,53
050,18,025,"Indiana","Crawford County",3,3,120,60,60
050,18,025,"Indiana","Crawford County",3,4,119,64,55
050,18,025,"Indiana","Crawford County",3,5,118,66,52
050,18,025,"Indiana","Crawford County",3,6,111,56,55
050,18,025,"Indiana","Crawford County",3,7,114,52,62
050,18,025,"Indiana","Crawford County",3,8,120,64,56
050,18,025,"Indiana","Crawford County",3,9,116,59,57
050,18,025,"Indiana","Crawford County",3,10,114,59,55
050,18,025,"Indiana","Crawford County",3,11,124,64,60
050,18,025,"Indiana","Crawford County",3,12,135,66,69
050,18,025,"Indiana","Crawford County",3,13,139,75,64
050,18,025,"Indiana","Crawford County",3,14,141,68,73
050,18,025,"Indiana","Crawford County",3,15,138,64,74
050,18,025,"Indiana","Crawford County",3,16,152,77,75
050,18,025,"Indiana","Crawford County",3,17,151,76,75
050,18,025,"Indiana","Crawford County",3,18,114,60,54
050,18,025,"Indiana","Crawford County",3,19,91,47,44
050,18,025,"Indiana","Crawford County",3,20,90,48,42
050,18,025,"Indiana","Crawford County",3,21,88,52,36
050,18,025,"Indiana","Crawford County",3,22,108,57,51
050,18,025,"Indiana","Crawford County",3,23,104,51,53
050,18,025,"Indiana","Crawford County",3,24,95,46,49
050,18,025,"Indiana","Crawford County",3,25,106,54,52
050,18,025,"Indiana","Crawford County",3,26,109,54,55
050,18,025,"Indiana","Crawford County",3,27,114,54,60
050,18,025,"Indiana","Crawford County",3,28,119,57,62
050,18,025,"Indiana","Crawford County",3,29,118,62,56
050,18,025,"Indiana","Crawford County",3,30,111,59,52
050,18,025,"Indiana","Crawford County",3,31,124,65,59
050,18,025,"Indiana","Crawford County",3,32,102,59,43
050,18,025,"Indiana","Crawford County",3,33,91,46,45
050,18,025,"Indiana","Crawford County",3,34,100,47,53
050,18,025,"Indiana","Crawford County",3,35,110,51,59
050,18,025,"Indiana","Crawford County",3,36,115,60,55
050,18,025,"Indiana","Crawford County",3,37,114,60,54
050,18,025,"Indiana","Crawford County",3,38,106,58,48
050,18,025,"Indiana","Crawford County",3,39,120,57,63
050,18,025,"Indiana","Crawford County",3,40,122,64,58
050,18,025,"Indiana","Crawford County",3,41,126,69,57
050,18,025,"Indiana","Crawford County",3,42,130,74,56
050,18,025,"Indiana","Crawford County",3,43,129,71,58
050,18,025,"Indiana","Crawford County",3,44,120,63,57
050,18,025,"Indiana","Crawford County",3,45,120,66,54
050,18,025,"Indiana","Crawford County",3,46,137,64,73
050,18,025,"Indiana","Crawford County",3,47,139,64,75
050,18,025,"Indiana","Crawford County",3,48,152,77,75
050,18,025,"Indiana","Crawford County",3,49,152,74,78
050,18,025,"Indiana","Crawford County",3,50,129,71,58
050,18,025,"Indiana","Crawford County",3,51,132,77,55
050,18,025,"Indiana","Crawford County",3,52,127,65,62
050,18,025,"Indiana","Crawford County",3,53,139,73,66
050,18,025,"Indiana","Crawford County",3,54,154,75,79
050,18,025,"Indiana","Crawford County",3,55,161,80,81
050,18,025,"Indiana","Crawford County",3,56,176,82,94
050,18,025,"Indiana","Crawford County",3,57,177,90,87
050,18,025,"Indiana","Crawford County",3,58,179,93,86
050,18,025,"Indiana","Crawford County",3,59,179,96,83
050,18,025,"Indiana","Crawford County",3,60,168,92,76
050,18,025,"Indiana","Crawford County",3,61,178,98,80
050,18,025,"Indiana","Crawford County",3,62,184,101,83
050,18,025,"Indiana","Crawford County",3,63,168,89,79
050,18,025,"Indiana","Crawford County",3,64,165,86,79
050,18,025,"Indiana","Crawford County",3,65,147,75,72
050,18,025,"Indiana","Crawford County",3,66,153,79,74
050,18,025,"Indiana","Crawford County",3,67,163,80,83
050,18,025,"Indiana","Crawford County",3,68,156,74,82
050,18,025,"Indiana","Crawford County",3,69,143,75,68
050,18,025,"Indiana","Crawford County",3,70,139,79,60
050,18,025,"Indiana","Crawford County",3,71,125,70,55
050,18,025,"Indiana","Crawford County",3,72,116,62,54
050,18,025,"Indiana","Crawford County",3,73,114,62,52
050,18,025,"Indiana","Crawford County",3,74,122,63,59
050,18,025,"Indiana","Crawford County",3,75,91,43,48
050,18,025,"Indiana","Crawford County",3,76,68,31,37
050,18,025,"Indiana","Crawford County",3,77,82,42,40
050,18,025,"Indiana","Crawford County",3,78,90,44,46
050,18,025,"Indiana","Crawford County",3,79,69,33,36
050,18,025,"Indiana","Crawford County",3,80,54,29,25
050,18,025,"Indiana","Crawford County",3,81,47,18,29
050,18,025,"Indiana","Crawford County",3,82,48,24,24
050,18,025,"Indiana","Crawford County",3,83,46,22,24
050,18,025,"Indiana","Crawford County",3,84,39,20,19
050,18,025,"Indiana","Crawford County",3,85,151,44,107
050,18,025,"Indiana","Crawford County",4,0,100,38,62
050,18,025,"Indiana","Crawford County",4,1,99,34,65
050,18,025,"Indiana","Crawford County",4,2,114,61,53
050,18,025,"Indiana","Crawford County",4,3,115,57,58
050,18,025,"Indiana","Crawford County",4,4,116,52,64
050,18,025,"Indiana","Crawford County",4,5,129,71,58
050,18,025,"Indiana","Crawford County",4,6,122,72,50
050,18,025,"Indiana","Crawford County",4,7,121,64,57
050,18,025,"Indiana","Crawford County",4,8,120,55,65
050,18,025,"Indiana","Crawford County",4,9,121,63,58
050,18,025,"Indiana","Crawford County",4,10,118,61,57
050,18,025,"Indiana","Crawford County",4,11,107,56,51
050,18,025,"Indiana","Crawford County",4,12,128,66,62
050,18,025,"Indiana","Crawford County",4,13,133,64,69
050,18,025,"Indiana","Crawford County",4,14,145,74,71
050,18,025,"Indiana","Crawford County",4,15,146,75,71
050,18,025,"Indiana","Crawford County",4,16,133,61,72
050,18,025,"Indiana","Crawford County",4,17,149,75,74
050,18,025,"Indiana","Crawford County",4,18,122,64,58
050,18,025,"Indiana","Crawford County",4,19,84,43,41
050,18,025,"Indiana","Crawford County",4,20,99,53,46
050,18,025,"Indiana","Crawford County",4,21,93,49,44
050,18,025,"Indiana","Crawford County",4,22,97,52,45
050,18,025,"Indiana","Crawford County",4,23,97,54,43
050,18,025,"Indiana","Crawford County",4,24,104,54,50
050,18,025,"Indiana","Crawford County",4,25,101,50,51
050,18,025,"Indiana","Crawford County",4,26,98,52,46
050,18,025,"Indiana","Crawford County",4,27,109,45,64
050,18,025,"Indiana","Crawford County",4,28,110,56,54
050,18,025,"Indiana","Crawford County",4,29,118,54,64
050,18,025,"Indiana","Crawford County",4,30,117,64,53
050,18,025,"Indiana","Crawford County",4,31,114,61,53
050,18,025,"Indiana","Crawford County",4,32,136,68,68
050,18,025,"Indiana","Crawford County",4,33,96,54,42
050,18,025,"Indiana","Crawford County",4,34,94,47,47
050,18,025,"Indiana","Crawford County",4,35,103,50,53
050,18,025,"Indiana","Crawford County",4,36,105,50,55
050,18,025,"Indiana","Crawford County",4,37,119,62,57
050,18,025,"Indiana","Crawford County",4,38,117,62,55
050,18,025,"Indiana","Crawford County",4,39,112,59,53
050,18,025,"Indiana","Crawford County",4,40,118,56,62
050,18,025,"Indiana","Crawford County",4,41,126,67,59
050,18,025,"Indiana","Crawford County",4,42,134,76,58
050,18,025,"Indiana","Crawford County",4,43,134,74,60
050,18,025,"Indiana","Crawford County",4,44,123,72,51
050,18,025,"Indiana","Crawford County",4,45,120,67,53
050,18,025,"Indiana","Crawford County",4,46,119,65,54
050,18,025,"Indiana","Crawford County",4,47,144,65,79
050,18,025,"Indiana","Crawford County",4,48,137,65,72
050,18,025,"Indiana","Crawford County",4,49,164,79,85
050,18,025,"Indiana","Crawford County",4,50,151,75,76
050,18,025,"Indiana","Crawford County",4,51,134,68,66
050,18,025,"Indiana","Crawford County",4,52,137,79,58
050,18,025,"Indiana","Crawford County",4,53,127,67,60
050,18,025,"Indiana","Crawford County",4,54,148,78,70
050,18,025,"Indiana","Crawford County",4,55,153,71,82
050,18,025,"Indiana","Crawford County",4,56,161,83,78
050,18,025,"Indiana","Crawford County",4,57,176,81,95
050,18,025,"Indiana","Crawford County",4,58,175,89,86
050,18,025,"Indiana","Crawford County",4,59,171,87,84
050,18,025,"Indiana","Crawford County",4,60,188,101,87
050,18,025,"Indiana","Crawford County",4,61,172,92,80
050,18,025,"Indiana","Crawford County",4,62,182,102,80
050,18,025,"Indiana","Crawford County",4,63,183,101,82
050,18,025,"Indiana","Crawford County",4,64,166,87,79
050,18,025,"Indiana","Crawford County",4,65,161,85,76
050,18,025,"Indiana","Crawford County",4,66,147,73,74
050,18,025,"Indiana","Crawford County",4,67,153,80,73
050,18,025,"Indiana","Crawford County",4,68,160,79,81
050,18,025,"Indiana","Crawford County",4,69,152,73,79
050,18,025,"Indiana","Crawford County",4,70,146,76,70
050,18,025,"Indiana","Crawford County",4,71,140,79,61
050,18,025,"Indiana","Crawford County",4,72,121,68,53
050,18,025,"Indiana","Crawford County",4,73,111,59,52
050,18,025,"Indiana","Crawford County",4,74,109,62,47
050,18,025,"Indiana","Crawford County",4,75,117,58,59
050,18,025,"Indiana","Crawford County",4,76,84,41,43
050,18,025,"Indiana","Crawford County",4,77,64,30,34
050,18,025,"Indiana","Crawford County",4,78,77,38,39
050,18,025,"Indiana","Crawford County",4,79,83,41,42
050,18,025,"Indiana","Crawford County",4,80,61,29,32
050,18,025,"Indiana","Crawford County",4,81,46,26,20
050,18,025,"Indiana","Crawford County",4,82,44,17,27
050,18,025,"Indiana","Crawford County",4,83,45,22,23
050,18,025,"Indiana","Crawford County",4,84,40,21,19
050,18,025,"Indiana","Crawford County",4,85,152,42,110
050,18,025,"Indiana","Crawford County",5,0,96,36,60
050,18,025,"Indiana","Crawford County",5,1,113,45,68
050,18,025,"Indiana","Crawford County",5,2,101,36,65
050,18,025,"Indiana","Crawford County",5,3,110,56,54
050,18,025,"Indiana","Crawford County",5,4,116,56,60
050,18,025,"Indiana","Crawford County",5,5,112,47,65
050,18,025,"Indiana","Crawford County",5,6,129,69,60
050,18,025,"Indiana","Crawford County",5,7,112,67,45
050,18,025,"Indiana","Crawford County",5,8,125,67,58
050,18,025,"Indiana","Crawford County",5,9,110,49,61
050,18,025,"Indiana","Crawford County",5,10,118,65,53
050,18,025,"Indiana","Crawford County",5,11,117,59,58
050,18,025,"Indiana","Crawford County",5,12,108,53,55
050,18,025,"Indiana","Crawford County",5,13,125,66,59
050,18,025,"Indiana","Crawford County",5,14,127,65,62
050,18,025,"Indiana","Crawford County",5,15,135,70,65
050,18,025,"Indiana","Crawford County",5,16,138,67,71
050,18,025,"Indiana","Crawford County",5,17,127,59,68
050,18,025,"Indiana","Crawford County",5,18,121,67,54
050,18,025,"Indiana","Crawford County",5,19,94,49,45
050,18,025,"Indiana","Crawford County",5,20,91,48,43
050,18,025,"Indiana","Crawford County",5,21,110,55,55
050,18,025,"Indiana","Crawford County",5,22,106,52,54
050,18,025,"Indiana","Crawford County",5,23,102,59,43
050,18,025,"Indiana","Crawford County",5,24,96,50,46
050,18,025,"Indiana","Crawford County",5,25,104,55,49
050,18,025,"Indiana","Crawford County",5,26,105,54,51
050,18,025,"Indiana","Crawford County",5,27,105,58,47
050,18,025,"Indiana","Crawford County",5,28,106,44,62
050,18,025,"Indiana","Crawford County",5,29,107,52,55
050,18,025,"Indiana","Crawford County",5,30,109,53,56
050,18,025,"Indiana","Crawford County",5,31,115,65,50
050,18,025,"Indiana","Crawford County",5,32,110,60,50
050,18,025,"Indiana","Crawford County",5,33,146,76,70
050,18,025,"Indiana","Crawford County",5,34,98,54,44
050,18,025,"Indiana","Crawford County",5,35,93,47,46
050,18,025,"Indiana","Crawford County",5,36,110,53,57
050,18,025,"Indiana","Crawford County",5,37,107,51,56
050,18,025,"Indiana","Crawford County",5,38,118,64,54
050,18,025,"Indiana","Crawford County",5,39,113,60,53
050,18,025,"Indiana","Crawford County",5,40,109,55,54
050,18,025,"Indiana","Crawford County",5,41,114,55,59
050,18,025,"Indiana","Crawford County",5,42,129,69,60
050,18,025,"Indiana","Crawford County",5,43,130,73,57
050,18,025,"Indiana","Crawford County",5,44,128,72,56
050,18,025,"Indiana","Crawford County",5,45,123,73,50
050,18,025,"Indiana","Crawford County",5,46,119,62,57
050,18,025,"Indiana","Crawford County",5,47,119,64,55
050,18,025,"Indiana","Crawford County",5,48,141,64,77
050,18,025,"Indiana","Crawford County",5,49,140,62,78
050,18,025,"Indiana","Crawford County",5,50,152,77,75
050,18,025,"Indiana","Crawford County",5,51,148,72,76
050,18,025,"Indiana","Crawford County",5,52,129,68,61
050,18,025,"Indiana","Crawford County",5,53,130,77,53
050,18,025,"Indiana","Crawford County",5,54,128,68,60
050,18,025,"Indiana","Crawford County",5,55,145,74,71
050,18,025,"Indiana","Crawford County",5,56,154,73,81
050,18,025,"Indiana","Crawford County",5,57,160,84,76
050,18,025,"Indiana","Crawford County",5,58,175,81,94
050,18,025,"Indiana","Crawford County",5,59,168,85,83
050,18,025,"Indiana","Crawford County",5,60,176,88,88
050,18,025,"Indiana","Crawford County",5,61,197,105,92
050,18,025,"Indiana","Crawford County",5,62,180,98,82
050,18,025,"Indiana","Crawford County",5,63,184,103,81
050,18,025,"Indiana","Crawford County",5,64,179,98,81
050,18,025,"Indiana","Crawford County",5,65,168,91,77
050,18,025,"Indiana","Crawford County",5,66,163,90,73
050,18,025,"Indiana","Crawford County",5,67,146,73,73
050,18,025,"Indiana","Crawford County",5,68,154,80,74
050,18,025,"Indiana","Crawford County",5,69,157,79,78
050,18,025,"Indiana","Crawford County",5,70,155,76,79
050,18,025,"Indiana","Crawford County",5,71,151,81,70
050,18,025,"Indiana","Crawford County",5,72,132,74,58
050,18,025,"Indiana","Crawford County",5,73,119,67,52
050,18,025,"Indiana","Crawford County",5,74,105,54,51
050,18,025,"Indiana","Crawford County",5,75,106,59,47
050,18,025,"Indiana","Crawford County",5,76,112,56,56
050,18,025,"Indiana","Crawford County",5,77,81,40,41
050,18,025,"Indiana","Crawford County",5,78,61,28,33
050,18,025,"Indiana","Crawford County",5,79,73,37,36
050,18,025,"Indiana","Crawford County",5,80,70,36,34
050,18,025,"Indiana","Crawford County",5,81,56,27,29
050,18,025,"Indiana","Crawford County",5,82,44,26,18
050,18,025,"Indiana","Crawford County",5,83,42,16,26
050,18,025,"Indiana","Crawford County",5,84,40,23,17
050,18,025,"Indiana","Crawford County",5,85,161,48,113
050,18,027,"Indiana","Daviess County",1,0,559,288,271
050,18,027,"Indiana","Daviess County",1,1,558,299,259
050,18,027,"Indiana","Daviess County",1,2,580,298,282
050,18,027,"Indiana","Daviess County",1,3,529,274,255
050,18,027,"Indiana","Daviess County",1,4,537,283,254
050,18,027,"Indiana","Daviess County",1,5,557,279,278
050,18,027,"Indiana","Daviess County",1,6,531,282,249
050,18,027,"Indiana","Daviess County",1,7,537,289,248
050,18,027,"Indiana","Daviess County",1,8,516,267,249
050,18,027,"Indiana","Daviess County",1,9,552,291,261
050,18,027,"Indiana","Daviess County",1,10,559,279,280
050,18,027,"Indiana","Daviess County",1,11,576,297,279
050,18,027,"Indiana","Daviess County",1,12,577,291,286
050,18,027,"Indiana","Daviess County",1,13,583,292,291
050,18,027,"Indiana","Daviess County",1,14,556,271,285
050,18,027,"Indiana","Daviess County",1,15,553,273,280
050,18,027,"Indiana","Daviess County",1,16,555,296,259
050,18,027,"Indiana","Daviess County",1,17,542,286,256
050,18,027,"Indiana","Daviess County",1,18,458,246,212
050,18,027,"Indiana","Daviess County",1,19,361,193,168
050,18,027,"Indiana","Daviess County",1,20,374,192,182
050,18,027,"Indiana","Daviess County",1,21,373,190,183
050,18,027,"Indiana","Daviess County",1,22,382,199,183
050,18,027,"Indiana","Daviess County",1,23,382,208,174
050,18,027,"Indiana","Daviess County",1,24,429,225,204
050,18,027,"Indiana","Daviess County",1,25,419,216,203
050,18,027,"Indiana","Daviess County",1,26,416,216,200
050,18,027,"Indiana","Daviess County",1,27,416,207,209
050,18,027,"Indiana","Daviess County",1,28,453,249,204
050,18,027,"Indiana","Daviess County",1,29,420,223,197
050,18,027,"Indiana","Daviess County",1,30,428,210,218
050,18,027,"Indiana","Daviess County",1,31,407,201,206
050,18,027,"Indiana","Daviess County",1,32,378,196,182
050,18,027,"Indiana","Daviess County",1,33,368,186,182
050,18,027,"Indiana","Daviess County",1,34,387,201,186
050,18,027,"Indiana","Daviess County",1,35,379,206,173
050,18,027,"Indiana","Daviess County",1,36,387,200,187
050,18,027,"Indiana","Daviess County",1,37,407,213,194
050,18,027,"Indiana","Daviess County",1,38,396,211,185
050,18,027,"Indiana","Daviess County",1,39,420,225,195
050,18,027,"Indiana","Daviess County",1,40,367,199,168
050,18,027,"Indiana","Daviess County",1,41,362,191,171
050,18,027,"Indiana","Daviess County",1,42,351,171,180
050,18,027,"Indiana","Daviess County",1,43,351,162,189
050,18,027,"Indiana","Daviess County",1,44,362,171,191
050,18,027,"Indiana","Daviess County",1,45,377,199,178
050,18,027,"Indiana","Daviess County",1,46,345,190,155
050,18,027,"Indiana","Daviess County",1,47,334,178,156
050,18,027,"Indiana","Daviess County",1,48,369,180,189
050,18,027,"Indiana","Daviess County",1,49,391,204,187
050,18,027,"Indiana","Daviess County",1,50,342,186,156
050,18,027,"Indiana","Daviess County",1,51,349,176,173
050,18,027,"Indiana","Daviess County",1,52,333,165,168
050,18,027,"Indiana","Daviess County",1,53,354,176,178
050,18,027,"Indiana","Daviess County",1,54,352,171,181
050,18,027,"Indiana","Daviess County",1,55,415,214,201
050,18,027,"Indiana","Daviess County",1,56,404,206,198
050,18,027,"Indiana","Daviess County",1,57,419,207,212
050,18,027,"Indiana","Daviess County",1,58,432,215,217
050,18,027,"Indiana","Daviess County",1,59,410,215,195
050,18,027,"Indiana","Daviess County",1,60,406,217,189
050,18,027,"Indiana","Daviess County",1,61,409,207,202
050,18,027,"Indiana","Daviess County",1,62,411,204,207
050,18,027,"Indiana","Daviess County",1,63,391,190,201
050,18,027,"Indiana","Daviess County",1,64,362,187,175
050,18,027,"Indiana","Daviess County",1,65,353,174,179
050,18,027,"Indiana","Daviess County",1,66,344,167,177
050,18,027,"Indiana","Daviess County",1,67,342,177,165
050,18,027,"Indiana","Daviess County",1,68,342,160,182
050,18,027,"Indiana","Daviess County",1,69,295,144,151
050,18,027,"Indiana","Daviess County",1,70,277,137,140
050,18,027,"Indiana","Daviess County",1,71,287,136,151
050,18,027,"Indiana","Daviess County",1,72,281,141,140
050,18,027,"Indiana","Daviess County",1,73,263,131,132
050,18,027,"Indiana","Daviess County",1,74,188,90,98
050,18,027,"Indiana","Daviess County",1,75,219,98,121
050,18,027,"Indiana","Daviess County",1,76,196,90,106
050,18,027,"Indiana","Daviess County",1,77,203,105,98
050,18,027,"Indiana","Daviess County",1,78,178,80,98
050,18,027,"Indiana","Daviess County",1,79,162,65,97
050,18,027,"Indiana","Daviess County",1,80,147,63,84
050,18,027,"Indiana","Daviess County",1,81,137,64,73
050,18,027,"Indiana","Daviess County",1,82,135,52,83
050,18,027,"Indiana","Daviess County",1,83,113,44,69
050,18,027,"Indiana","Daviess County",1,84,106,42,64
050,18,027,"Indiana","Daviess County",1,85,617,186,431
050,18,027,"Indiana","Daviess County",2,0,522,264,258
050,18,027,"Indiana","Daviess County",2,1,557,294,263
050,18,027,"Indiana","Daviess County",2,2,570,295,275
050,18,027,"Indiana","Daviess County",2,3,535,277,258
050,18,027,"Indiana","Daviess County",2,4,535,279,256
050,18,027,"Indiana","Daviess County",2,5,552,279,273
050,18,027,"Indiana","Daviess County",2,6,538,281,257
050,18,027,"Indiana","Daviess County",2,7,533,285,248
050,18,027,"Indiana","Daviess County",2,8,519,270,249
050,18,027,"Indiana","Daviess County",2,9,538,282,256
050,18,027,"Indiana","Daviess County",2,10,554,282,272
050,18,027,"Indiana","Daviess County",2,11,567,290,277
050,18,027,"Indiana","Daviess County",2,12,582,294,288
050,18,027,"Indiana","Daviess County",2,13,578,289,289
050,18,027,"Indiana","Daviess County",2,14,560,273,287
050,18,027,"Indiana","Daviess County",2,15,556,275,281
050,18,027,"Indiana","Daviess County",2,16,556,291,265
050,18,027,"Indiana","Daviess County",2,17,549,289,260
050,18,027,"Indiana","Daviess County",2,18,458,247,211
050,18,027,"Indiana","Daviess County",2,19,368,196,172
050,18,027,"Indiana","Daviess County",2,20,383,199,184
050,18,027,"Indiana","Daviess County",2,21,378,193,185
050,18,027,"Indiana","Daviess County",2,22,381,197,184
050,18,027,"Indiana","Daviess County",2,23,387,208,179
050,18,027,"Indiana","Daviess County",2,24,422,223,199
050,18,027,"Indiana","Daviess County",2,25,424,222,202
050,18,027,"Indiana","Daviess County",2,26,417,218,199
050,18,027,"Indiana","Daviess County",2,27,416,211,205
050,18,027,"Indiana","Daviess County",2,28,443,237,206
050,18,027,"Indiana","Daviess County",2,29,425,226,199
050,18,027,"Indiana","Daviess County",2,30,428,214,214
050,18,027,"Indiana","Daviess County",2,31,407,200,207
050,18,027,"Indiana","Daviess County",2,32,386,197,189
050,18,027,"Indiana","Daviess County",2,33,368,185,183
050,18,027,"Indiana","Daviess County",2,34,379,196,183
050,18,027,"Indiana","Daviess County",2,35,383,206,177
050,18,027,"Indiana","Daviess County",2,36,382,200,182
050,18,027,"Indiana","Daviess County",2,37,400,209,191
050,18,027,"Indiana","Daviess County",2,38,398,211,187
050,18,027,"Indiana","Daviess County",2,39,414,219,195
050,18,027,"Indiana","Daviess County",2,40,380,206,174
050,18,027,"Indiana","Daviess County",2,41,364,192,172
050,18,027,"Indiana","Daviess County",2,42,352,174,178
050,18,027,"Indiana","Daviess County",2,43,355,168,187
050,18,027,"Indiana","Daviess County",2,44,358,169,189
050,18,027,"Indiana","Daviess County",2,45,373,191,182
050,18,027,"Indiana","Daviess County",2,46,352,192,160
050,18,027,"Indiana","Daviess County",2,47,337,181,156
050,18,027,"Indiana","Daviess County",2,48,360,180,180
050,18,027,"Indiana","Daviess County",2,49,389,200,189
050,18,027,"Indiana","Daviess County",2,50,356,193,163
050,18,027,"Indiana","Daviess County",2,51,347,176,171
050,18,027,"Indiana","Daviess County",2,52,337,168,169
050,18,027,"Indiana","Daviess County",2,53,348,173,175
050,18,027,"Indiana","Daviess County",2,54,352,171,181
050,18,027,"Indiana","Daviess County",2,55,401,204,197
050,18,027,"Indiana","Daviess County",2,56,406,207,199
050,18,027,"Indiana","Daviess County",2,57,416,209,207
050,18,027,"Indiana","Daviess County",2,58,431,213,218
050,18,027,"Indiana","Daviess County",2,59,414,216,198
050,18,027,"Indiana","Daviess County",2,60,401,213,188
050,18,027,"Indiana","Daviess County",2,61,403,208,195
050,18,027,"Indiana","Daviess County",2,62,411,205,206
050,18,027,"Indiana","Daviess County",2,63,397,192,205
050,18,027,"Indiana","Daviess County",2,64,362,186,176
050,18,027,"Indiana","Daviess County",2,65,353,175,178
050,18,027,"Indiana","Daviess County",2,66,350,171,179
050,18,027,"Indiana","Daviess County",2,67,337,171,166
050,18,027,"Indiana","Daviess County",2,68,341,163,178
050,18,027,"Indiana","Daviess County",2,69,308,150,158
050,18,027,"Indiana","Daviess County",2,70,277,137,140
050,18,027,"Indiana","Daviess County",2,71,283,136,147
050,18,027,"Indiana","Daviess County",2,72,278,140,138
050,18,027,"Indiana","Daviess County",2,73,274,136,138
050,18,027,"Indiana","Daviess County",2,74,195,94,101
050,18,027,"Indiana","Daviess County",2,75,210,95,115
050,18,027,"Indiana","Daviess County",2,76,197,89,108
050,18,027,"Indiana","Daviess County",2,77,207,105,102
050,18,027,"Indiana","Daviess County",2,78,180,83,97
050,18,027,"Indiana","Daviess County",2,79,161,66,95
050,18,027,"Indiana","Daviess County",2,80,148,64,84
050,18,027,"Indiana","Daviess County",2,81,137,61,76
050,18,027,"Indiana","Daviess County",2,82,137,52,85
050,18,027,"Indiana","Daviess County",2,83,113,45,68
050,18,027,"Indiana","Daviess County",2,84,103,40,63
050,18,027,"Indiana","Daviess County",2,85,618,186,432
050,18,027,"Indiana","Daviess County",3,0,535,252,283
050,18,027,"Indiana","Daviess County",3,1,507,258,249
050,18,027,"Indiana","Daviess County",3,2,569,300,269
050,18,027,"Indiana","Daviess County",3,3,576,300,276
050,18,027,"Indiana","Daviess County",3,4,540,287,253
050,18,027,"Indiana","Daviess County",3,5,544,284,260
050,18,027,"Indiana","Daviess County",3,6,554,282,272
050,18,027,"Indiana","Daviess County",3,7,533,282,251
050,18,027,"Indiana","Daviess County",3,8,527,281,246
050,18,027,"Indiana","Daviess County",3,9,527,271,256
050,18,027,"Indiana","Daviess County",3,10,549,283,266
050,18,027,"Indiana","Daviess County",3,11,559,278,281
050,18,027,"Indiana","Daviess County",3,12,575,290,285
050,18,027,"Indiana","Daviess County",3,13,579,298,281
050,18,027,"Indiana","Daviess County",3,14,568,281,287
050,18,027,"Indiana","Daviess County",3,15,564,276,288
050,18,027,"Indiana","Daviess County",3,16,550,273,277
050,18,027,"Indiana","Daviess County",3,17,540,279,261
050,18,027,"Indiana","Daviess County",3,18,466,254,212
050,18,027,"Indiana","Daviess County",3,19,374,200,174
050,18,027,"Indiana","Daviess County",3,20,385,207,178
050,18,027,"Indiana","Daviess County",3,21,402,198,204
050,18,027,"Indiana","Daviess County",3,22,390,196,194
050,18,027,"Indiana","Daviess County",3,23,409,209,200
050,18,027,"Indiana","Daviess County",3,24,390,217,173
050,18,027,"Indiana","Daviess County",3,25,410,223,187
050,18,027,"Indiana","Daviess County",3,26,434,226,208
050,18,027,"Indiana","Daviess County",3,27,427,229,198
050,18,027,"Indiana","Daviess County",3,28,412,204,208
050,18,027,"Indiana","Daviess County",3,29,435,234,201
050,18,027,"Indiana","Daviess County",3,30,434,235,199
050,18,027,"Indiana","Daviess County",3,31,409,203,206
050,18,027,"Indiana","Daviess County",3,32,412,203,209
050,18,027,"Indiana","Daviess County",3,33,390,194,196
050,18,027,"Indiana","Daviess County",3,34,357,183,174
050,18,027,"Indiana","Daviess County",3,35,395,200,195
050,18,027,"Indiana","Daviess County",3,36,392,214,178
050,18,027,"Indiana","Daviess County",3,37,390,207,183
050,18,027,"Indiana","Daviess County",3,38,400,204,196
050,18,027,"Indiana","Daviess County",3,39,396,208,188
050,18,027,"Indiana","Daviess County",3,40,416,222,194
050,18,027,"Indiana","Daviess County",3,41,385,205,180
050,18,027,"Indiana","Daviess County",3,42,352,182,170
050,18,027,"Indiana","Daviess County",3,43,348,173,175
050,18,027,"Indiana","Daviess County",3,44,352,165,187
050,18,027,"Indiana","Daviess County",3,45,353,161,192
050,18,027,"Indiana","Daviess County",3,46,365,191,174
050,18,027,"Indiana","Daviess County",3,47,349,191,158
050,18,027,"Indiana","Daviess County",3,48,331,172,159
050,18,027,"Indiana","Daviess County",3,49,349,169,180
050,18,027,"Indiana","Daviess County",3,50,385,200,185
050,18,027,"Indiana","Daviess County",3,51,356,186,170
050,18,027,"Indiana","Daviess County",3,52,339,178,161
050,18,027,"Indiana","Daviess County",3,53,336,165,171
050,18,027,"Indiana","Daviess County",3,54,340,165,175
050,18,027,"Indiana","Daviess County",3,55,356,180,176
050,18,027,"Indiana","Daviess County",3,56,394,197,197
050,18,027,"Indiana","Daviess County",3,57,415,215,200
050,18,027,"Indiana","Daviess County",3,58,419,208,211
050,18,027,"Indiana","Daviess County",3,59,415,204,211
050,18,027,"Indiana","Daviess County",3,60,402,209,193
050,18,027,"Indiana","Daviess County",3,61,397,210,187
050,18,027,"Indiana","Daviess County",3,62,402,210,192
050,18,027,"Indiana","Daviess County",3,63,407,201,206
050,18,027,"Indiana","Daviess County",3,64,383,189,194
050,18,027,"Indiana","Daviess County",3,65,358,178,180
050,18,027,"Indiana","Daviess County",3,66,343,170,173
050,18,027,"Indiana","Daviess County",3,67,333,162,171
050,18,027,"Indiana","Daviess County",3,68,328,168,160
050,18,027,"Indiana","Daviess County",3,69,336,162,174
050,18,027,"Indiana","Daviess County",3,70,298,143,155
050,18,027,"Indiana","Daviess County",3,71,272,134,138
050,18,027,"Indiana","Daviess County",3,72,282,143,139
050,18,027,"Indiana","Daviess County",3,73,256,124,132
050,18,027,"Indiana","Daviess County",3,74,266,131,135
050,18,027,"Indiana","Daviess County",3,75,189,89,100
050,18,027,"Indiana","Daviess County",3,76,185,81,104
050,18,027,"Indiana","Daviess County",3,77,207,96,111
050,18,027,"Indiana","Daviess County",3,78,199,94,105
050,18,027,"Indiana","Daviess County",3,79,151,72,79
050,18,027,"Indiana","Daviess County",3,80,153,61,92
050,18,027,"Indiana","Daviess County",3,81,135,59,76
050,18,027,"Indiana","Daviess County",3,82,132,46,86
050,18,027,"Indiana","Daviess County",3,83,121,50,71
050,18,027,"Indiana","Daviess County",3,84,96,40,56
050,18,027,"Indiana","Daviess County",3,85,605,170,435
050,18,027,"Indiana","Daviess County",4,0,533,267,266
050,18,027,"Indiana","Daviess County",4,1,519,248,271
050,18,027,"Indiana","Daviess County",4,2,502,258,244
050,18,027,"Indiana","Daviess County",4,3,572,309,263
050,18,027,"Indiana","Daviess County",4,4,566,295,271
050,18,027,"Indiana","Daviess County",4,5,548,290,258
050,18,027,"Indiana","Daviess County",4,6,559,282,277
050,18,027,"Indiana","Daviess County",4,7,560,278,282
050,18,027,"Indiana","Daviess County",4,8,537,279,258
050,18,027,"Indiana","Daviess County",4,9,512,272,240
050,18,027,"Indiana","Daviess County",4,10,542,278,264
050,18,027,"Indiana","Daviess County",4,11,565,281,284
050,18,027,"Indiana","Daviess County",4,12,558,277,281
050,18,027,"Indiana","Daviess County",4,13,585,306,279
050,18,027,"Indiana","Daviess County",4,14,601,308,293
050,18,027,"Indiana","Daviess County",4,15,566,285,281
050,18,027,"Indiana","Daviess County",4,16,560,277,283
050,18,027,"Indiana","Daviess County",4,17,557,274,283
050,18,027,"Indiana","Daviess County",4,18,463,254,209
050,18,027,"Indiana","Daviess County",4,19,368,199,169
050,18,027,"Indiana","Daviess County",4,20,383,208,175
050,18,027,"Indiana","Daviess County",4,21,380,203,177
050,18,027,"Indiana","Daviess County",4,22,415,198,217
050,18,027,"Indiana","Daviess County",4,23,405,207,198
050,18,027,"Indiana","Daviess County",4,24,401,204,197
050,18,027,"Indiana","Daviess County",4,25,380,202,178
050,18,027,"Indiana","Daviess County",4,26,413,225,188
050,18,027,"Indiana","Daviess County",4,27,422,222,200
050,18,027,"Indiana","Daviess County",4,28,419,220,199
050,18,027,"Indiana","Daviess County",4,29,401,202,199
050,18,027,"Indiana","Daviess County",4,30,440,233,207
050,18,027,"Indiana","Daviess County",4,31,425,229,196
050,18,027,"Indiana","Daviess County",4,32,415,212,203
050,18,027,"Indiana","Daviess County",4,33,406,200,206
050,18,027,"Indiana","Daviess County",4,34,383,186,197
050,18,027,"Indiana","Daviess County",4,35,364,182,182
050,18,027,"Indiana","Daviess County",4,36,399,202,197
050,18,027,"Indiana","Daviess County",4,37,405,220,185
050,18,027,"Indiana","Daviess County",4,38,392,207,185
050,18,027,"Indiana","Daviess County",4,39,395,204,191
050,18,027,"Indiana","Daviess County",4,40,407,216,191
050,18,027,"Indiana","Daviess County",4,41,417,225,192
050,18,027,"Indiana","Daviess County",4,42,375,204,171
050,18,027,"Indiana","Daviess County",4,43,357,184,173
050,18,027,"Indiana","Daviess County",4,44,353,174,179
050,18,027,"Indiana","Daviess County",4,45,336,151,185
050,18,027,"Indiana","Daviess County",4,46,365,167,198
050,18,027,"Indiana","Daviess County",4,47,375,199,176
050,18,027,"Indiana","Daviess County",4,48,356,194,162
050,18,027,"Indiana","Daviess County",4,49,326,167,159
050,18,027,"Indiana","Daviess County",4,50,334,158,176
050,18,027,"Indiana","Daviess County",4,51,380,194,186
050,18,027,"Indiana","Daviess County",4,52,356,191,165
050,18,027,"Indiana","Daviess County",4,53,352,185,167
050,18,027,"Indiana","Daviess County",4,54,333,156,177
050,18,027,"Indiana","Daviess County",4,55,346,172,174
050,18,027,"Indiana","Daviess County",4,56,339,170,169
050,18,027,"Indiana","Daviess County",4,57,392,199,193
050,18,027,"Indiana","Daviess County",4,58,421,218,203
050,18,027,"Indiana","Daviess County",4,59,409,205,204
050,18,027,"Indiana","Daviess County",4,60,411,200,211
050,18,027,"Indiana","Daviess County",4,61,399,201,198
050,18,027,"Indiana","Daviess County",4,62,403,214,189
050,18,027,"Indiana","Daviess County",4,63,389,202,187
050,18,027,"Indiana","Daviess County",4,64,398,197,201
050,18,027,"Indiana","Daviess County",4,65,380,180,200
050,18,027,"Indiana","Daviess County",4,66,355,176,179
050,18,027,"Indiana","Daviess County",4,67,318,162,156
050,18,027,"Indiana","Daviess County",4,68,329,156,173
050,18,027,"Indiana","Daviess County",4,69,325,169,156
050,18,027,"Indiana","Daviess County",4,70,317,150,167
050,18,027,"Indiana","Daviess County",4,71,293,141,152
050,18,027,"Indiana","Daviess County",4,72,274,139,135
050,18,027,"Indiana","Daviess County",4,73,265,134,131
050,18,027,"Indiana","Daviess County",4,74,246,118,128
050,18,027,"Indiana","Daviess County",4,75,251,124,127
050,18,027,"Indiana","Daviess County",4,76,178,87,91
050,18,027,"Indiana","Daviess County",4,77,188,88,100
050,18,027,"Indiana","Daviess County",4,78,205,86,119
050,18,027,"Indiana","Daviess County",4,79,178,87,91
050,18,027,"Indiana","Daviess County",4,80,142,69,73
050,18,027,"Indiana","Daviess County",4,81,141,56,85
050,18,027,"Indiana","Daviess County",4,82,139,53,86
050,18,027,"Indiana","Daviess County",4,83,112,42,70
050,18,027,"Indiana","Daviess County",4,84,104,45,59
050,18,027,"Indiana","Daviess County",4,85,611,174,437
050,18,027,"Indiana","Daviess County",5,0,530,266,264
050,18,027,"Indiana","Daviess County",5,1,549,273,276
050,18,027,"Indiana","Daviess County",5,2,508,247,261
050,18,027,"Indiana","Daviess County",5,3,493,252,241
050,18,027,"Indiana","Daviess County",5,4,561,308,253
050,18,027,"Indiana","Daviess County",5,5,565,299,266
050,18,027,"Indiana","Daviess County",5,6,560,293,267
050,18,027,"Indiana","Daviess County",5,7,564,273,291
050,18,027,"Indiana","Daviess County",5,8,566,280,286
050,18,027,"Indiana","Daviess County",5,9,545,282,263
050,18,027,"Indiana","Daviess County",5,10,519,275,244
050,18,027,"Indiana","Daviess County",5,11,561,290,271
050,18,027,"Indiana","Daviess County",5,12,563,284,279
050,18,027,"Indiana","Daviess County",5,13,576,291,285
050,18,027,"Indiana","Daviess County",5,14,580,293,287
050,18,027,"Indiana","Daviess County",5,15,584,300,284
050,18,027,"Indiana","Daviess County",5,16,565,286,279
050,18,027,"Indiana","Daviess County",5,17,567,282,285
050,18,027,"Indiana","Daviess County",5,18,461,238,223
050,18,027,"Indiana","Daviess County",5,19,360,200,160
050,18,027,"Indiana","Daviess County",5,20,388,205,183
050,18,027,"Indiana","Daviess County",5,21,401,216,185
050,18,027,"Indiana","Daviess County",5,22,396,215,181
050,18,027,"Indiana","Daviess County",5,23,455,225,230
050,18,027,"Indiana","Daviess County",5,24,411,210,201
050,18,027,"Indiana","Daviess County",5,25,391,195,196
050,18,027,"Indiana","Daviess County",5,26,385,208,177
050,18,027,"Indiana","Daviess County",5,27,399,213,186
050,18,027,"Indiana","Daviess County",5,28,419,218,201
050,18,027,"Indiana","Daviess County",5,29,425,228,197
050,18,027,"Indiana","Daviess County",5,30,387,194,193
050,18,027,"Indiana","Daviess County",5,31,445,234,211
050,18,027,"Indiana","Daviess County",5,32,444,239,205
050,18,027,"Indiana","Daviess County",5,33,422,211,211
050,18,027,"Indiana","Daviess County",5,34,407,200,207
050,18,027,"Indiana","Daviess County",5,35,386,190,196
050,18,027,"Indiana","Daviess County",5,36,361,182,179
050,18,027,"Indiana","Daviess County",5,37,408,209,199
050,18,027,"Indiana","Daviess County",5,38,392,210,182
050,18,027,"Indiana","Daviess County",5,39,390,206,184
050,18,027,"Indiana","Daviess County",5,40,404,206,198
050,18,027,"Indiana","Daviess County",5,41,412,212,200
050,18,027,"Indiana","Daviess County",5,42,412,222,190
050,18,027,"Indiana","Daviess County",5,43,375,211,164
050,18,027,"Indiana","Daviess County",5,44,357,188,169
050,18,027,"Indiana","Daviess County",5,45,333,164,169
050,18,027,"Indiana","Daviess County",5,46,345,157,188
050,18,027,"Indiana","Daviess County",5,47,374,163,211
050,18,027,"Indiana","Daviess County",5,48,375,200,175
050,18,027,"Indiana","Daviess County",5,49,356,188,168
050,18,027,"Indiana","Daviess County",5,50,325,164,161
050,18,027,"Indiana","Daviess County",5,51,330,154,176
050,18,027,"Indiana","Daviess County",5,52,383,195,188
050,18,027,"Indiana","Daviess County",5,53,350,192,158
050,18,027,"Indiana","Daviess County",5,54,342,177,165
050,18,027,"Indiana","Daviess County",5,55,327,159,168
050,18,027,"Indiana","Daviess County",5,56,340,161,179
050,18,027,"Indiana","Daviess County",5,57,339,173,166
050,18,027,"Indiana","Daviess County",5,58,399,201,198
050,18,027,"Indiana","Daviess County",5,59,414,212,202
050,18,027,"Indiana","Daviess County",5,60,406,212,194
050,18,027,"Indiana","Daviess County",5,61,404,192,212
050,18,027,"Indiana","Daviess County",5,62,395,200,195
050,18,027,"Indiana","Daviess County",5,63,390,205,185
050,18,027,"Indiana","Daviess County",5,64,372,194,178
050,18,027,"Indiana","Daviess County",5,65,394,188,206
050,18,027,"Indiana","Daviess County",5,66,379,180,199
050,18,027,"Indiana","Daviess County",5,67,343,172,171
050,18,027,"Indiana","Daviess County",5,68,311,152,159
050,18,027,"Indiana","Daviess County",5,69,328,157,171
050,18,027,"Indiana","Daviess County",5,70,308,159,149
050,18,027,"Indiana","Daviess County",5,71,313,147,166
050,18,027,"Indiana","Daviess County",5,72,294,145,149
050,18,027,"Indiana","Daviess County",5,73,261,129,132
050,18,027,"Indiana","Daviess County",5,74,252,127,125
050,18,027,"Indiana","Daviess County",5,75,238,113,125
050,18,027,"Indiana","Daviess County",5,76,234,119,115
050,18,027,"Indiana","Daviess County",5,77,179,90,89
050,18,027,"Indiana","Daviess County",5,78,186,79,107
050,18,027,"Indiana","Daviess County",5,79,184,78,106
050,18,027,"Indiana","Daviess County",5,80,174,86,88
050,18,027,"Indiana","Daviess County",5,81,131,64,67
050,18,027,"Indiana","Daviess County",5,82,145,50,95
050,18,027,"Indiana","Daviess County",5,83,125,51,74
050,18,027,"Indiana","Daviess County",5,84,92,36,56
050,18,027,"Indiana","Daviess County",5,85,637,183,454
050,18,029,"Indiana","Dearborn County",1,0,530,273,257
050,18,029,"Indiana","Dearborn County",1,1,547,300,247
050,18,029,"Indiana","Dearborn County",1,2,558,286,272
050,18,029,"Indiana","Dearborn County",1,3,560,287,273
050,18,029,"Indiana","Dearborn County",1,4,577,284,293
050,18,029,"Indiana","Dearborn County",1,5,551,279,272
050,18,029,"Indiana","Dearborn County",1,6,543,274,269
050,18,029,"Indiana","Dearborn County",1,7,564,284,280
050,18,029,"Indiana","Dearborn County",1,8,610,331,279
050,18,029,"Indiana","Dearborn County",1,9,611,305,306
050,18,029,"Indiana","Dearborn County",1,10,636,329,307
050,18,029,"Indiana","Dearborn County",1,11,708,370,338
050,18,029,"Indiana","Dearborn County",1,12,715,365,350
050,18,029,"Indiana","Dearborn County",1,13,675,336,339
050,18,029,"Indiana","Dearborn County",1,14,738,391,347
050,18,029,"Indiana","Dearborn County",1,15,750,386,364
050,18,029,"Indiana","Dearborn County",1,16,766,368,398
050,18,029,"Indiana","Dearborn County",1,17,723,375,348
050,18,029,"Indiana","Dearborn County",1,18,614,315,299
050,18,029,"Indiana","Dearborn County",1,19,507,253,254
050,18,029,"Indiana","Dearborn County",1,20,557,286,271
050,18,029,"Indiana","Dearborn County",1,21,556,294,262
050,18,029,"Indiana","Dearborn County",1,22,588,284,304
050,18,029,"Indiana","Dearborn County",1,23,546,284,262
050,18,029,"Indiana","Dearborn County",1,24,535,282,253
050,18,029,"Indiana","Dearborn County",1,25,514,266,248
050,18,029,"Indiana","Dearborn County",1,26,532,273,259
050,18,029,"Indiana","Dearborn County",1,27,552,287,265
050,18,029,"Indiana","Dearborn County",1,28,615,328,287
050,18,029,"Indiana","Dearborn County",1,29,564,280,284
050,18,029,"Indiana","Dearborn County",1,30,531,254,277
050,18,029,"Indiana","Dearborn County",1,31,559,290,269
050,18,029,"Indiana","Dearborn County",1,32,532,265,267
050,18,029,"Indiana","Dearborn County",1,33,585,308,277
050,18,029,"Indiana","Dearborn County",1,34,601,313,288
050,18,029,"Indiana","Dearborn County",1,35,571,282,289
050,18,029,"Indiana","Dearborn County",1,36,570,286,284
050,18,029,"Indiana","Dearborn County",1,37,568,278,290
050,18,029,"Indiana","Dearborn County",1,38,602,302,300
050,18,029,"Indiana","Dearborn County",1,39,635,329,306
050,18,029,"Indiana","Dearborn County",1,40,622,311,311
050,18,029,"Indiana","Dearborn County",1,41,633,323,310
050,18,029,"Indiana","Dearborn County",1,42,659,329,330
050,18,029,"Indiana","Dearborn County",1,43,611,298,313
050,18,029,"Indiana","Dearborn County",1,44,614,321,293
050,18,029,"Indiana","Dearborn County",1,45,596,311,285
050,18,029,"Indiana","Dearborn County",1,46,617,323,294
050,18,029,"Indiana","Dearborn County",1,47,647,330,317
050,18,029,"Indiana","Dearborn County",1,48,706,359,347
050,18,029,"Indiana","Dearborn County",1,49,740,375,365
050,18,029,"Indiana","Dearborn County",1,50,716,365,351
050,18,029,"Indiana","Dearborn County",1,51,695,362,333
050,18,029,"Indiana","Dearborn County",1,52,726,358,368
050,18,029,"Indiana","Dearborn County",1,53,722,358,364
050,18,029,"Indiana","Dearborn County",1,54,717,358,359
050,18,029,"Indiana","Dearborn County",1,55,743,381,362
050,18,029,"Indiana","Dearborn County",1,56,799,410,389
050,18,029,"Indiana","Dearborn County",1,57,781,378,403
050,18,029,"Indiana","Dearborn County",1,58,815,403,412
050,18,029,"Indiana","Dearborn County",1,59,842,430,412
050,18,029,"Indiana","Dearborn County",1,60,836,424,412
050,18,029,"Indiana","Dearborn County",1,61,724,342,382
050,18,029,"Indiana","Dearborn County",1,62,713,343,370
050,18,029,"Indiana","Dearborn County",1,63,727,379,348
050,18,029,"Indiana","Dearborn County",1,64,708,364,344
050,18,029,"Indiana","Dearborn County",1,65,685,323,362
050,18,029,"Indiana","Dearborn County",1,66,647,314,333
050,18,029,"Indiana","Dearborn County",1,67,663,325,338
050,18,029,"Indiana","Dearborn County",1,68,665,336,329
050,18,029,"Indiana","Dearborn County",1,69,570,290,280
050,18,029,"Indiana","Dearborn County",1,70,544,284,260
050,18,029,"Indiana","Dearborn County",1,71,568,274,294
050,18,029,"Indiana","Dearborn County",1,72,516,245,271
050,18,029,"Indiana","Dearborn County",1,73,512,259,253
050,18,029,"Indiana","Dearborn County",1,74,324,162,162
050,18,029,"Indiana","Dearborn County",1,75,340,159,181
050,18,029,"Indiana","Dearborn County",1,76,350,172,178
050,18,029,"Indiana","Dearborn County",1,77,338,161,177
050,18,029,"Indiana","Dearborn County",1,78,292,120,172
050,18,029,"Indiana","Dearborn County",1,79,254,111,143
050,18,029,"Indiana","Dearborn County",1,80,257,126,131
050,18,029,"Indiana","Dearborn County",1,81,243,122,121
050,18,029,"Indiana","Dearborn County",1,82,205,92,113
050,18,029,"Indiana","Dearborn County",1,83,187,83,104
050,18,029,"Indiana","Dearborn County",1,84,160,68,92
050,18,029,"Indiana","Dearborn County",1,85,851,275,576
050,18,029,"Indiana","Dearborn County",2,0,538,277,261
050,18,029,"Indiana","Dearborn County",2,1,542,293,249
050,18,029,"Indiana","Dearborn County",2,2,563,294,269
050,18,029,"Indiana","Dearborn County",2,3,561,287,274
050,18,029,"Indiana","Dearborn County",2,4,575,286,289
050,18,029,"Indiana","Dearborn County",2,5,559,280,279
050,18,029,"Indiana","Dearborn County",2,6,551,277,274
050,18,029,"Indiana","Dearborn County",2,7,560,284,276
050,18,029,"Indiana","Dearborn County",2,8,598,317,281
050,18,029,"Indiana","Dearborn County",2,9,612,312,300
050,18,029,"Indiana","Dearborn County",2,10,633,325,308
050,18,029,"Indiana","Dearborn County",2,11,693,362,331
050,18,029,"Indiana","Dearborn County",2,12,718,367,351
050,18,029,"Indiana","Dearborn County",2,13,690,345,345
050,18,029,"Indiana","Dearborn County",2,14,726,378,348
050,18,029,"Indiana","Dearborn County",2,15,751,387,364
050,18,029,"Indiana","Dearborn County",2,16,762,374,388
050,18,029,"Indiana","Dearborn County",2,17,736,375,361
050,18,029,"Indiana","Dearborn County",2,18,607,314,293
050,18,029,"Indiana","Dearborn County",2,19,504,254,250
050,18,029,"Indiana","Dearborn County",2,20,559,286,273
050,18,029,"Indiana","Dearborn County",2,21,563,296,267
050,18,029,"Indiana","Dearborn County",2,22,586,290,296
050,18,029,"Indiana","Dearborn County",2,23,559,284,275
050,18,029,"Indiana","Dearborn County",2,24,543,286,257
050,18,029,"Indiana","Dearborn County",2,25,523,272,251
050,18,029,"Indiana","Dearborn County",2,26,528,273,255
050,18,029,"Indiana","Dearborn County",2,27,548,285,263
050,18,029,"Indiana","Dearborn County",2,28,600,320,280
050,18,029,"Indiana","Dearborn County",2,29,574,290,284
050,18,029,"Indiana","Dearborn County",2,30,546,264,282
050,18,029,"Indiana","Dearborn County",2,31,554,280,274
050,18,029,"Indiana","Dearborn County",2,32,543,271,272
050,18,029,"Indiana","Dearborn County",2,33,577,299,278
050,18,029,"Indiana","Dearborn County",2,34,602,314,288
050,18,029,"Indiana","Dearborn County",2,35,584,293,291
050,18,029,"Indiana","Dearborn County",2,36,569,284,285
050,18,029,"Indiana","Dearborn County",2,37,572,281,291
050,18,029,"Indiana","Dearborn County",2,38,599,300,299
050,18,029,"Indiana","Dearborn County",2,39,628,322,306
050,18,029,"Indiana","Dearborn County",2,40,633,319,314
050,18,029,"Indiana","Dearborn County",2,41,633,321,312
050,18,029,"Indiana","Dearborn County",2,42,651,327,324
050,18,029,"Indiana","Dearborn County",2,43,629,310,319
050,18,029,"Indiana","Dearborn County",2,44,608,312,296
050,18,029,"Indiana","Dearborn County",2,45,605,315,290
050,18,029,"Indiana","Dearborn County",2,46,607,317,290
050,18,029,"Indiana","Dearborn County",2,47,636,326,310
050,18,029,"Indiana","Dearborn County",2,48,690,353,337
050,18,029,"Indiana","Dearborn County",2,49,735,372,363
050,18,029,"Indiana","Dearborn County",2,50,725,370,355
050,18,029,"Indiana","Dearborn County",2,51,701,365,336
050,18,029,"Indiana","Dearborn County",2,52,712,358,354
050,18,029,"Indiana","Dearborn County",2,53,724,360,364
050,18,029,"Indiana","Dearborn County",2,54,712,356,356
050,18,029,"Indiana","Dearborn County",2,55,734,375,359
050,18,029,"Indiana","Dearborn County",2,56,788,403,385
050,18,029,"Indiana","Dearborn County",2,57,785,385,400
050,18,029,"Indiana","Dearborn County",2,58,805,394,411
050,18,029,"Indiana","Dearborn County",2,59,841,425,416
050,18,029,"Indiana","Dearborn County",2,60,835,424,411
050,18,029,"Indiana","Dearborn County",2,61,746,361,385
050,18,029,"Indiana","Dearborn County",2,62,716,342,374
050,18,029,"Indiana","Dearborn County",2,63,728,373,355
050,18,029,"Indiana","Dearborn County",2,64,710,367,343
050,18,029,"Indiana","Dearborn County",2,65,685,329,356
050,18,029,"Indiana","Dearborn County",2,66,655,314,341
050,18,029,"Indiana","Dearborn County",2,67,657,321,336
050,18,029,"Indiana","Dearborn County",2,68,659,330,329
050,18,029,"Indiana","Dearborn County",2,69,595,302,293
050,18,029,"Indiana","Dearborn County",2,70,547,284,263
050,18,029,"Indiana","Dearborn County",2,71,558,274,284
050,18,029,"Indiana","Dearborn County",2,72,515,246,269
050,18,029,"Indiana","Dearborn County",2,73,541,269,272
050,18,029,"Indiana","Dearborn County",2,74,339,170,169
050,18,029,"Indiana","Dearborn County",2,75,335,158,177
050,18,029,"Indiana","Dearborn County",2,76,342,166,176
050,18,029,"Indiana","Dearborn County",2,77,349,168,181
050,18,029,"Indiana","Dearborn County",2,78,295,125,170
050,18,029,"Indiana","Dearborn County",2,79,259,110,149
050,18,029,"Indiana","Dearborn County",2,80,254,120,134
050,18,029,"Indiana","Dearborn County",2,81,240,120,120
050,18,029,"Indiana","Dearborn County",2,82,209,96,113
050,18,029,"Indiana","Dearborn County",2,83,187,83,104
050,18,029,"Indiana","Dearborn County",2,84,160,69,91
050,18,029,"Indiana","Dearborn County",2,85,844,271,573
050,18,029,"Indiana","Dearborn County",3,0,491,258,233
050,18,029,"Indiana","Dearborn County",3,1,552,279,273
050,18,029,"Indiana","Dearborn County",3,2,555,305,250
050,18,029,"Indiana","Dearborn County",3,3,570,292,278
050,18,029,"Indiana","Dearborn County",3,4,565,289,276
050,18,029,"Indiana","Dearborn County",3,5,586,291,295
050,18,029,"Indiana","Dearborn County",3,6,563,287,276
050,18,029,"Indiana","Dearborn County",3,7,557,281,276
050,18,029,"Indiana","Dearborn County",3,8,552,284,268
050,18,029,"Indiana","Dearborn County",3,9,613,309,304
050,18,029,"Indiana","Dearborn County",3,10,630,326,304
050,18,029,"Indiana","Dearborn County",3,11,629,313,316
050,18,029,"Indiana","Dearborn County",3,12,708,377,331
050,18,029,"Indiana","Dearborn County",3,13,714,352,362
050,18,029,"Indiana","Dearborn County",3,14,716,362,354
050,18,029,"Indiana","Dearborn County",3,15,744,397,347
050,18,029,"Indiana","Dearborn County",3,16,775,409,366
050,18,029,"Indiana","Dearborn County",3,17,769,382,387
050,18,029,"Indiana","Dearborn County",3,18,635,329,306
050,18,029,"Indiana","Dearborn County",3,19,492,258,234
050,18,029,"Indiana","Dearborn County",3,20,554,281,273
050,18,029,"Indiana","Dearborn County",3,21,583,291,292
050,18,029,"Indiana","Dearborn County",3,22,580,304,276
050,18,029,"Indiana","Dearborn County",3,23,603,303,300
050,18,029,"Indiana","Dearborn County",3,24,543,276,267
050,18,029,"Indiana","Dearborn County",3,25,521,264,257
050,18,029,"Indiana","Dearborn County",3,26,513,267,246
050,18,029,"Indiana","Dearborn County",3,27,538,284,254
050,18,029,"Indiana","Dearborn County",3,28,550,284,266
050,18,029,"Indiana","Dearborn County",3,29,584,319,265
050,18,029,"Indiana","Dearborn County",3,30,577,294,283
050,18,029,"Indiana","Dearborn County",3,31,549,264,285
050,18,029,"Indiana","Dearborn County",3,32,569,283,286
050,18,029,"Indiana","Dearborn County",3,33,554,275,279
050,18,029,"Indiana","Dearborn County",3,34,589,294,295
050,18,029,"Indiana","Dearborn County",3,35,616,323,293
050,18,029,"Indiana","Dearborn County",3,36,598,300,298
050,18,029,"Indiana","Dearborn County",3,37,588,302,286
050,18,029,"Indiana","Dearborn County",3,38,586,292,294
050,18,029,"Indiana","Dearborn County",3,39,591,295,296
050,18,029,"Indiana","Dearborn County",3,40,642,330,312
050,18,029,"Indiana","Dearborn County",3,41,648,323,325
050,18,029,"Indiana","Dearborn County",3,42,635,330,305
050,18,029,"Indiana","Dearborn County",3,43,640,318,322
050,18,029,"Indiana","Dearborn County",3,44,624,314,310
050,18,029,"Indiana","Dearborn County",3,45,605,309,296
050,18,029,"Indiana","Dearborn County",3,46,602,310,292
050,18,029,"Indiana","Dearborn County",3,47,610,319,291
050,18,029,"Indiana","Dearborn County",3,48,656,339,317
050,18,029,"Indiana","Dearborn County",3,49,693,348,345
050,18,029,"Indiana","Dearborn County",3,50,728,374,354
050,18,029,"Indiana","Dearborn County",3,51,729,370,359
050,18,029,"Indiana","Dearborn County",3,52,700,365,335
050,18,029,"Indiana","Dearborn County",3,53,718,363,355
050,18,029,"Indiana","Dearborn County",3,54,715,351,364
050,18,029,"Indiana","Dearborn County",3,55,708,358,350
050,18,029,"Indiana","Dearborn County",3,56,736,383,353
050,18,029,"Indiana","Dearborn County",3,57,785,398,387
050,18,029,"Indiana","Dearborn County",3,58,780,383,397
050,18,029,"Indiana","Dearborn County",3,59,805,398,407
050,18,029,"Indiana","Dearborn County",3,60,839,427,412
050,18,029,"Indiana","Dearborn County",3,61,814,414,400
050,18,029,"Indiana","Dearborn County",3,62,732,347,385
050,18,029,"Indiana","Dearborn County",3,63,704,332,372
050,18,029,"Indiana","Dearborn County",3,64,699,356,343
050,18,029,"Indiana","Dearborn County",3,65,688,355,333
050,18,029,"Indiana","Dearborn County",3,66,682,331,351
050,18,029,"Indiana","Dearborn County",3,67,650,312,338
050,18,029,"Indiana","Dearborn County",3,68,662,322,340
050,18,029,"Indiana","Dearborn County",3,69,643,317,326
050,18,029,"Indiana","Dearborn County",3,70,576,290,286
050,18,029,"Indiana","Dearborn County",3,71,532,274,258
050,18,029,"Indiana","Dearborn County",3,72,541,259,282
050,18,029,"Indiana","Dearborn County",3,73,501,234,267
050,18,029,"Indiana","Dearborn County",3,74,523,262,261
050,18,029,"Indiana","Dearborn County",3,75,331,160,171
050,18,029,"Indiana","Dearborn County",3,76,314,147,167
050,18,029,"Indiana","Dearborn County",3,77,325,155,170
050,18,029,"Indiana","Dearborn County",3,78,341,165,176
050,18,029,"Indiana","Dearborn County",3,79,277,120,157
050,18,029,"Indiana","Dearborn County",3,80,253,105,148
050,18,029,"Indiana","Dearborn County",3,81,238,117,121
050,18,029,"Indiana","Dearborn County",3,82,215,101,114
050,18,029,"Indiana","Dearborn County",3,83,193,93,100
050,18,029,"Indiana","Dearborn County",3,84,159,76,83
050,18,029,"Indiana","Dearborn County",3,85,882,286,596
050,18,029,"Indiana","Dearborn County",4,0,453,236,217
050,18,029,"Indiana","Dearborn County",4,1,505,257,248
050,18,029,"Indiana","Dearborn County",4,2,571,292,279
050,18,029,"Indiana","Dearborn County",4,3,569,311,258
050,18,029,"Indiana","Dearborn County",4,4,578,301,277
050,18,029,"Indiana","Dearborn County",4,5,581,299,282
050,18,029,"Indiana","Dearborn County",4,6,603,289,314
050,18,029,"Indiana","Dearborn County",4,7,588,290,298
050,18,029,"Indiana","Dearborn County",4,8,573,297,276
050,18,029,"Indiana","Dearborn County",4,9,558,286,272
050,18,029,"Indiana","Dearborn County",4,10,619,312,307
050,18,029,"Indiana","Dearborn County",4,11,631,319,312
050,18,029,"Indiana","Dearborn County",4,12,628,314,314
050,18,029,"Indiana","Dearborn County",4,13,707,378,329
050,18,029,"Indiana","Dearborn County",4,14,713,340,373
050,18,029,"Indiana","Dearborn County",4,15,732,377,355
050,18,029,"Indiana","Dearborn County",4,16,731,386,345
050,18,029,"Indiana","Dearborn County",4,17,764,395,369
050,18,029,"Indiana","Dearborn County",4,18,630,320,310
050,18,029,"Indiana","Dearborn County",4,19,487,255,232
050,18,029,"Indiana","Dearborn County",4,20,518,271,247
050,18,029,"Indiana","Dearborn County",4,21,571,291,280
050,18,029,"Indiana","Dearborn County",4,22,605,306,299
050,18,029,"Indiana","Dearborn County",4,23,572,303,269
050,18,029,"Indiana","Dearborn County",4,24,612,316,296
050,18,029,"Indiana","Dearborn County",4,25,543,276,267
050,18,029,"Indiana","Dearborn County",4,26,528,272,256
050,18,029,"Indiana","Dearborn County",4,27,528,282,246
050,18,029,"Indiana","Dearborn County",4,28,558,307,251
050,18,029,"Indiana","Dearborn County",4,29,554,282,272
050,18,029,"Indiana","Dearborn County",4,30,589,325,264
050,18,029,"Indiana","Dearborn County",4,31,597,291,306
050,18,029,"Indiana","Dearborn County",4,32,563,265,298
050,18,029,"Indiana","Dearborn County",4,33,586,296,290
050,18,029,"Indiana","Dearborn County",4,34,571,287,284
050,18,029,"Indiana","Dearborn County",4,35,582,292,290
050,18,029,"Indiana","Dearborn County",4,36,619,324,295
050,18,029,"Indiana","Dearborn County",4,37,606,310,296
050,18,029,"Indiana","Dearborn County",4,38,607,321,286
050,18,029,"Indiana","Dearborn County",4,39,582,293,289
050,18,029,"Indiana","Dearborn County",4,40,596,293,303
050,18,029,"Indiana","Dearborn County",4,41,654,344,310
050,18,029,"Indiana","Dearborn County",4,42,663,337,326
050,18,029,"Indiana","Dearborn County",4,43,639,321,318
050,18,029,"Indiana","Dearborn County",4,44,638,321,317
050,18,029,"Indiana","Dearborn County",4,45,631,317,314
050,18,029,"Indiana","Dearborn County",4,46,590,297,293
050,18,029,"Indiana","Dearborn County",4,47,614,315,299
050,18,029,"Indiana","Dearborn County",4,48,617,321,296
050,18,029,"Indiana","Dearborn County",4,49,652,341,311
050,18,029,"Indiana","Dearborn County",4,50,674,346,328
050,18,029,"Indiana","Dearborn County",4,51,718,360,358
050,18,029,"Indiana","Dearborn County",4,52,739,372,367
050,18,029,"Indiana","Dearborn County",4,53,700,373,327
050,18,029,"Indiana","Dearborn County",4,54,709,348,361
050,18,029,"Indiana","Dearborn County",4,55,713,351,362
050,18,029,"Indiana","Dearborn County",4,56,715,357,358
050,18,029,"Indiana","Dearborn County",4,57,740,381,359
050,18,029,"Indiana","Dearborn County",4,58,780,397,383
050,18,029,"Indiana","Dearborn County",4,59,776,386,390
050,18,029,"Indiana","Dearborn County",4,60,807,397,410
050,18,029,"Indiana","Dearborn County",4,61,814,414,400
050,18,029,"Indiana","Dearborn County",4,62,820,411,409
050,18,029,"Indiana","Dearborn County",4,63,733,352,381
050,18,029,"Indiana","Dearborn County",4,64,684,315,369
050,18,029,"Indiana","Dearborn County",4,65,693,357,336
050,18,029,"Indiana","Dearborn County",4,66,686,348,338
050,18,029,"Indiana","Dearborn County",4,67,661,321,340
050,18,029,"Indiana","Dearborn County",4,68,647,306,341
050,18,029,"Indiana","Dearborn County",4,69,632,306,326
050,18,029,"Indiana","Dearborn County",4,70,632,315,317
050,18,029,"Indiana","Dearborn County",4,71,557,278,279
050,18,029,"Indiana","Dearborn County",4,72,504,260,244
050,18,029,"Indiana","Dearborn County",4,73,518,243,275
050,18,029,"Indiana","Dearborn County",4,74,474,223,251
050,18,029,"Indiana","Dearborn County",4,75,522,256,266
050,18,029,"Indiana","Dearborn County",4,76,320,155,165
050,18,029,"Indiana","Dearborn County",4,77,297,133,164
050,18,029,"Indiana","Dearborn County",4,78,314,150,164
050,18,029,"Indiana","Dearborn County",4,79,305,152,153
050,18,029,"Indiana","Dearborn County",4,80,274,114,160
050,18,029,"Indiana","Dearborn County",4,81,236,97,139
050,18,029,"Indiana","Dearborn County",4,82,226,104,122
050,18,029,"Indiana","Dearborn County",4,83,192,88,104
050,18,029,"Indiana","Dearborn County",4,84,172,93,79
050,18,029,"Indiana","Dearborn County",4,85,910,300,610
050,18,029,"Indiana","Dearborn County",5,0,385,202,183
050,18,029,"Indiana","Dearborn County",5,1,472,246,226
050,18,029,"Indiana","Dearborn County",5,2,515,261,254
050,18,029,"Indiana","Dearborn County",5,3,586,293,293
050,18,029,"Indiana","Dearborn County",5,4,579,311,268
050,18,029,"Indiana","Dearborn County",5,5,596,310,286
050,18,029,"Indiana","Dearborn County",5,6,594,303,291
050,18,029,"Indiana","Dearborn County",5,7,621,301,320
050,18,029,"Indiana","Dearborn County",5,8,602,301,301
050,18,029,"Indiana","Dearborn County",5,9,593,307,286
050,18,029,"Indiana","Dearborn County",5,10,577,295,282
050,18,029,"Indiana","Dearborn County",5,11,624,310,314
050,18,029,"Indiana","Dearborn County",5,12,640,323,317
050,18,029,"Indiana","Dearborn County",5,13,639,325,314
050,18,029,"Indiana","Dearborn County",5,14,724,387,337
050,18,029,"Indiana","Dearborn County",5,15,727,349,378
050,18,029,"Indiana","Dearborn County",5,16,741,373,368
050,18,029,"Indiana","Dearborn County",5,17,758,398,360
050,18,029,"Indiana","Dearborn County",5,18,639,344,295
050,18,029,"Indiana","Dearborn County",5,19,493,257,236
050,18,029,"Indiana","Dearborn County",5,20,520,277,243
050,18,029,"Indiana","Dearborn County",5,21,539,281,258
050,18,029,"Indiana","Dearborn County",5,22,614,314,300
050,18,029,"Indiana","Dearborn County",5,23,605,311,294
050,18,029,"Indiana","Dearborn County",5,24,569,309,260
050,18,029,"Indiana","Dearborn County",5,25,626,318,308
050,18,029,"Indiana","Dearborn County",5,26,549,283,266
050,18,029,"Indiana","Dearborn County",5,27,509,264,245
050,18,029,"Indiana","Dearborn County",5,28,551,287,264
050,18,029,"Indiana","Dearborn County",5,29,559,304,255
050,18,029,"Indiana","Dearborn County",5,30,573,291,282
050,18,029,"Indiana","Dearborn County",5,31,626,340,286
050,18,029,"Indiana","Dearborn County",5,32,606,281,325
050,18,029,"Indiana","Dearborn County",5,33,583,274,309
050,18,029,"Indiana","Dearborn County",5,34,601,306,295
050,18,029,"Indiana","Dearborn County",5,35,573,278,295
050,18,029,"Indiana","Dearborn County",5,36,596,309,287
050,18,029,"Indiana","Dearborn County",5,37,618,314,304
050,18,029,"Indiana","Dearborn County",5,38,634,326,308
050,18,029,"Indiana","Dearborn County",5,39,610,322,288
050,18,029,"Indiana","Dearborn County",5,40,599,301,298
050,18,029,"Indiana","Dearborn County",5,41,594,292,302
050,18,029,"Indiana","Dearborn County",5,42,652,336,316
050,18,029,"Indiana","Dearborn County",5,43,663,334,329
050,18,029,"Indiana","Dearborn County",5,44,625,308,317
050,18,029,"Indiana","Dearborn County",5,45,636,321,315
050,18,029,"Indiana","Dearborn County",5,46,632,312,320
050,18,029,"Indiana","Dearborn County",5,47,595,296,299
050,18,029,"Indiana","Dearborn County",5,48,625,317,308
050,18,029,"Indiana","Dearborn County",5,49,623,317,306
050,18,029,"Indiana","Dearborn County",5,50,653,344,309
050,18,029,"Indiana","Dearborn County",5,51,679,355,324
050,18,029,"Indiana","Dearborn County",5,52,721,364,357
050,18,029,"Indiana","Dearborn County",5,53,758,382,376
050,18,029,"Indiana","Dearborn County",5,54,702,371,331
050,18,029,"Indiana","Dearborn County",5,55,715,358,357
050,18,029,"Indiana","Dearborn County",5,56,729,362,367
050,18,029,"Indiana","Dearborn County",5,57,716,352,364
050,18,029,"Indiana","Dearborn County",5,58,751,385,366
050,18,029,"Indiana","Dearborn County",5,59,778,392,386
050,18,029,"Indiana","Dearborn County",5,60,779,378,401
050,18,029,"Indiana","Dearborn County",5,61,816,400,416
050,18,029,"Indiana","Dearborn County",5,62,818,407,411
050,18,029,"Indiana","Dearborn County",5,63,813,407,406
050,18,029,"Indiana","Dearborn County",5,64,730,349,381
050,18,029,"Indiana","Dearborn County",5,65,673,312,361
050,18,029,"Indiana","Dearborn County",5,66,698,355,343
050,18,029,"Indiana","Dearborn County",5,67,680,344,336
050,18,029,"Indiana","Dearborn County",5,68,658,316,342
050,18,029,"Indiana","Dearborn County",5,69,628,291,337
050,18,029,"Indiana","Dearborn County",5,70,623,303,320
050,18,029,"Indiana","Dearborn County",5,71,610,295,315
050,18,029,"Indiana","Dearborn County",5,72,536,262,274
050,18,029,"Indiana","Dearborn County",5,73,492,247,245
050,18,029,"Indiana","Dearborn County",5,74,492,234,258
050,18,029,"Indiana","Dearborn County",5,75,463,214,249
050,18,029,"Indiana","Dearborn County",5,76,485,237,248
050,18,029,"Indiana","Dearborn County",5,77,305,143,162
050,18,029,"Indiana","Dearborn County",5,78,288,126,162
050,18,029,"Indiana","Dearborn County",5,79,285,138,147
050,18,029,"Indiana","Dearborn County",5,80,305,147,158
050,18,029,"Indiana","Dearborn County",5,81,258,112,146
050,18,029,"Indiana","Dearborn County",5,82,222,88,134
050,18,029,"Indiana","Dearborn County",5,83,209,94,115
050,18,029,"Indiana","Dearborn County",5,84,169,86,83
050,18,029,"Indiana","Dearborn County",5,85,968,345,623
050,18,031,"Indiana","Decatur County",1,0,309,160,149
050,18,031,"Indiana","Decatur County",1,1,329,180,149
050,18,031,"Indiana","Decatur County",1,2,332,169,163
050,18,031,"Indiana","Decatur County",1,3,364,174,190
050,18,031,"Indiana","Decatur County",1,4,331,176,155
050,18,031,"Indiana","Decatur County",1,5,342,168,174
050,18,031,"Indiana","Decatur County",1,6,359,189,170
050,18,031,"Indiana","Decatur County",1,7,353,174,179
050,18,031,"Indiana","Decatur County",1,8,314,160,154
050,18,031,"Indiana","Decatur County",1,9,336,171,165
050,18,031,"Indiana","Decatur County",1,10,360,157,203
050,18,031,"Indiana","Decatur County",1,11,370,199,171
050,18,031,"Indiana","Decatur County",1,12,353,189,164
050,18,031,"Indiana","Decatur County",1,13,372,193,179
050,18,031,"Indiana","Decatur County",1,14,364,182,182
050,18,031,"Indiana","Decatur County",1,15,364,169,195
050,18,031,"Indiana","Decatur County",1,16,408,195,213
050,18,031,"Indiana","Decatur County",1,17,383,191,192
050,18,031,"Indiana","Decatur County",1,18,316,169,147
050,18,031,"Indiana","Decatur County",1,19,263,146,117
050,18,031,"Indiana","Decatur County",1,20,293,159,134
050,18,031,"Indiana","Decatur County",1,21,306,171,135
050,18,031,"Indiana","Decatur County",1,22,331,180,151
050,18,031,"Indiana","Decatur County",1,23,328,187,141
050,18,031,"Indiana","Decatur County",1,24,314,170,144
050,18,031,"Indiana","Decatur County",1,25,323,167,156
050,18,031,"Indiana","Decatur County",1,26,333,165,168
050,18,031,"Indiana","Decatur County",1,27,342,157,185
050,18,031,"Indiana","Decatur County",1,28,331,167,164
050,18,031,"Indiana","Decatur County",1,29,323,160,163
050,18,031,"Indiana","Decatur County",1,30,349,179,170
050,18,031,"Indiana","Decatur County",1,31,346,185,161
050,18,031,"Indiana","Decatur County",1,32,309,168,141
050,18,031,"Indiana","Decatur County",1,33,292,145,147
050,18,031,"Indiana","Decatur County",1,34,302,157,145
050,18,031,"Indiana","Decatur County",1,35,298,149,149
050,18,031,"Indiana","Decatur County",1,36,302,152,150
050,18,031,"Indiana","Decatur County",1,37,313,161,152
050,18,031,"Indiana","Decatur County",1,38,337,166,171
050,18,031,"Indiana","Decatur County",1,39,319,151,168
050,18,031,"Indiana","Decatur County",1,40,316,166,150
050,18,031,"Indiana","Decatur County",1,41,326,170,156
050,18,031,"Indiana","Decatur County",1,42,344,176,168
050,18,031,"Indiana","Decatur County",1,43,315,154,161
050,18,031,"Indiana","Decatur County",1,44,296,147,149
050,18,031,"Indiana","Decatur County",1,45,315,164,151
050,18,031,"Indiana","Decatur County",1,46,331,172,159
050,18,031,"Indiana","Decatur County",1,47,318,170,148
050,18,031,"Indiana","Decatur County",1,48,356,188,168
050,18,031,"Indiana","Decatur County",1,49,360,181,179
050,18,031,"Indiana","Decatur County",1,50,321,173,148
050,18,031,"Indiana","Decatur County",1,51,324,173,151
050,18,031,"Indiana","Decatur County",1,52,333,171,162
050,18,031,"Indiana","Decatur County",1,53,349,174,175
050,18,031,"Indiana","Decatur County",1,54,348,173,175
050,18,031,"Indiana","Decatur County",1,55,368,198,170
050,18,031,"Indiana","Decatur County",1,56,391,190,201
050,18,031,"Indiana","Decatur County",1,57,388,192,196
050,18,031,"Indiana","Decatur County",1,58,370,194,176
050,18,031,"Indiana","Decatur County",1,59,364,192,172
050,18,031,"Indiana","Decatur County",1,60,389,201,188
050,18,031,"Indiana","Decatur County",1,61,396,213,183
050,18,031,"Indiana","Decatur County",1,62,374,193,181
050,18,031,"Indiana","Decatur County",1,63,353,172,181
050,18,031,"Indiana","Decatur County",1,64,330,163,167
050,18,031,"Indiana","Decatur County",1,65,324,154,170
050,18,031,"Indiana","Decatur County",1,66,313,147,166
050,18,031,"Indiana","Decatur County",1,67,299,150,149
050,18,031,"Indiana","Decatur County",1,68,303,153,150
050,18,031,"Indiana","Decatur County",1,69,262,128,134
050,18,031,"Indiana","Decatur County",1,70,242,121,121
050,18,031,"Indiana","Decatur County",1,71,246,118,128
050,18,031,"Indiana","Decatur County",1,72,248,112,136
050,18,031,"Indiana","Decatur County",1,73,233,109,124
050,18,031,"Indiana","Decatur County",1,74,166,78,88
050,18,031,"Indiana","Decatur County",1,75,161,74,87
050,18,031,"Indiana","Decatur County",1,76,160,79,81
050,18,031,"Indiana","Decatur County",1,77,157,66,91
050,18,031,"Indiana","Decatur County",1,78,138,61,77
050,18,031,"Indiana","Decatur County",1,79,133,60,73
050,18,031,"Indiana","Decatur County",1,80,124,45,79
050,18,031,"Indiana","Decatur County",1,81,134,58,76
050,18,031,"Indiana","Decatur County",1,82,112,43,69
050,18,031,"Indiana","Decatur County",1,83,116,50,66
050,18,031,"Indiana","Decatur County",1,84,97,41,56
050,18,031,"Indiana","Decatur County",1,85,519,169,350
050,18,031,"Indiana","Decatur County",2,0,313,166,147
050,18,031,"Indiana","Decatur County",2,1,326,176,150
050,18,031,"Indiana","Decatur County",2,2,333,171,162
050,18,031,"Indiana","Decatur County",2,3,351,171,180
050,18,031,"Indiana","Decatur County",2,4,338,175,163
050,18,031,"Indiana","Decatur County",2,5,342,170,172
050,18,031,"Indiana","Decatur County",2,6,357,184,173
050,18,031,"Indiana","Decatur County",2,7,352,177,175
050,18,031,"Indiana","Decatur County",2,8,323,165,158
050,18,031,"Indiana","Decatur County",2,9,331,166,165
050,18,031,"Indiana","Decatur County",2,10,356,160,196
050,18,031,"Indiana","Decatur County",2,11,364,186,178
050,18,031,"Indiana","Decatur County",2,12,360,193,167
050,18,031,"Indiana","Decatur County",2,13,367,192,175
050,18,031,"Indiana","Decatur County",2,14,365,184,181
050,18,031,"Indiana","Decatur County",2,15,367,172,195
050,18,031,"Indiana","Decatur County",2,16,400,190,210
050,18,031,"Indiana","Decatur County",2,17,387,191,196
050,18,031,"Indiana","Decatur County",2,18,318,169,149
050,18,031,"Indiana","Decatur County",2,19,260,142,118
050,18,031,"Indiana","Decatur County",2,20,294,160,134
050,18,031,"Indiana","Decatur County",2,21,310,172,138
050,18,031,"Indiana","Decatur County",2,22,328,179,149
050,18,031,"Indiana","Decatur County",2,23,334,187,147
050,18,031,"Indiana","Decatur County",2,24,318,173,145
050,18,031,"Indiana","Decatur County",2,25,323,167,156
050,18,031,"Indiana","Decatur County",2,26,330,164,166
050,18,031,"Indiana","Decatur County",2,27,338,157,181
050,18,031,"Indiana","Decatur County",2,28,334,165,169
050,18,031,"Indiana","Decatur County",2,29,327,162,165
050,18,031,"Indiana","Decatur County",2,30,348,175,173
050,18,031,"Indiana","Decatur County",2,31,345,184,161
050,18,031,"Indiana","Decatur County",2,32,317,171,146
050,18,031,"Indiana","Decatur County",2,33,294,148,146
050,18,031,"Indiana","Decatur County",2,34,297,153,144
050,18,031,"Indiana","Decatur County",2,35,299,151,148
050,18,031,"Indiana","Decatur County",2,36,300,152,148
050,18,031,"Indiana","Decatur County",2,37,311,160,151
050,18,031,"Indiana","Decatur County",2,38,335,167,168
050,18,031,"Indiana","Decatur County",2,39,323,154,169
050,18,031,"Indiana","Decatur County",2,40,319,164,155
050,18,031,"Indiana","Decatur County",2,41,322,169,153
050,18,031,"Indiana","Decatur County",2,42,339,175,164
050,18,031,"Indiana","Decatur County",2,43,324,160,164
050,18,031,"Indiana","Decatur County",2,44,298,149,149
050,18,031,"Indiana","Decatur County",2,45,313,162,151
050,18,031,"Indiana","Decatur County",2,46,328,170,158
050,18,031,"Indiana","Decatur County",2,47,322,171,151
050,18,031,"Indiana","Decatur County",2,48,352,186,166
050,18,031,"Indiana","Decatur County",2,49,363,183,180
050,18,031,"Indiana","Decatur County",2,50,336,178,158
050,18,031,"Indiana","Decatur County",2,51,321,170,151
050,18,031,"Indiana","Decatur County",2,52,331,172,159
050,18,031,"Indiana","Decatur County",2,53,348,176,172
050,18,031,"Indiana","Decatur County",2,54,348,173,175
050,18,031,"Indiana","Decatur County",2,55,361,192,169
050,18,031,"Indiana","Decatur County",2,56,387,192,195
050,18,031,"Indiana","Decatur County",2,57,390,191,199
050,18,031,"Indiana","Decatur County",2,58,367,191,176
050,18,031,"Indiana","Decatur County",2,59,366,192,174
050,18,031,"Indiana","Decatur County",2,60,381,198,183
050,18,031,"Indiana","Decatur County",2,61,389,207,182
050,18,031,"Indiana","Decatur County",2,62,377,194,183
050,18,031,"Indiana","Decatur County",2,63,357,178,179
050,18,031,"Indiana","Decatur County",2,64,333,164,169
050,18,031,"Indiana","Decatur County",2,65,324,156,168
050,18,031,"Indiana","Decatur County",2,66,316,149,167
050,18,031,"Indiana","Decatur County",2,67,299,148,151
050,18,031,"Indiana","Decatur County",2,68,300,151,149
050,18,031,"Indiana","Decatur County",2,69,274,133,141
050,18,031,"Indiana","Decatur County",2,70,246,123,123
050,18,031,"Indiana","Decatur County",2,71,245,119,126
050,18,031,"Indiana","Decatur County",2,72,239,109,130
050,18,031,"Indiana","Decatur County",2,73,247,115,132
050,18,031,"Indiana","Decatur County",2,74,168,79,89
050,18,031,"Indiana","Decatur County",2,75,160,73,87
050,18,031,"Indiana","Decatur County",2,76,158,76,82
050,18,031,"Indiana","Decatur County",2,77,157,69,88
050,18,031,"Indiana","Decatur County",2,78,140,61,79
050,18,031,"Indiana","Decatur County",2,79,128,58,70
050,18,031,"Indiana","Decatur County",2,80,125,49,76
050,18,031,"Indiana","Decatur County",2,81,124,52,72
050,18,031,"Indiana","Decatur County",2,82,113,42,71
050,18,031,"Indiana","Decatur County",2,83,112,48,64
050,18,031,"Indiana","Decatur County",2,84,99,43,56
050,18,031,"Indiana","Decatur County",2,85,513,168,345
050,18,031,"Indiana","Decatur County",3,0,303,173,130
050,18,031,"Indiana","Decatur County",3,1,315,154,161
050,18,031,"Indiana","Decatur County",3,2,320,174,146
050,18,031,"Indiana","Decatur County",3,3,338,170,168
050,18,031,"Indiana","Decatur County",3,4,364,183,181
050,18,031,"Indiana","Decatur County",3,5,345,175,170
050,18,031,"Indiana","Decatur County",3,6,343,175,168
050,18,031,"Indiana","Decatur County",3,7,359,182,177
050,18,031,"Indiana","Decatur County",3,8,348,171,177
050,18,031,"Indiana","Decatur County",3,9,318,151,167
050,18,031,"Indiana","Decatur County",3,10,332,165,167
050,18,031,"Indiana","Decatur County",3,11,359,174,185
050,18,031,"Indiana","Decatur County",3,12,367,186,181
050,18,031,"Indiana","Decatur County",3,13,355,193,162
050,18,031,"Indiana","Decatur County",3,14,353,180,173
050,18,031,"Indiana","Decatur County",3,15,366,186,180
050,18,031,"Indiana","Decatur County",3,16,366,170,196
050,18,031,"Indiana","Decatur County",3,17,392,196,196
050,18,031,"Indiana","Decatur County",3,18,328,165,163
050,18,031,"Indiana","Decatur County",3,19,252,135,117
050,18,031,"Indiana","Decatur County",3,20,280,154,126
050,18,031,"Indiana","Decatur County",3,21,308,170,138
050,18,031,"Indiana","Decatur County",3,22,341,185,156
050,18,031,"Indiana","Decatur County",3,23,342,182,160
050,18,031,"Indiana","Decatur County",3,24,335,189,146
050,18,031,"Indiana","Decatur County",3,25,330,179,151
050,18,031,"Indiana","Decatur County",3,26,302,157,145
050,18,031,"Indiana","Decatur County",3,27,310,148,162
050,18,031,"Indiana","Decatur County",3,28,350,163,187
050,18,031,"Indiana","Decatur County",3,29,342,168,174
050,18,031,"Indiana","Decatur County",3,30,309,153,156
050,18,031,"Indiana","Decatur County",3,31,356,183,173
050,18,031,"Indiana","Decatur County",3,32,341,175,166
050,18,031,"Indiana","Decatur County",3,33,312,166,146
050,18,031,"Indiana","Decatur County",3,34,292,146,146
050,18,031,"Indiana","Decatur County",3,35,294,152,142
050,18,031,"Indiana","Decatur County",3,36,319,162,157
050,18,031,"Indiana","Decatur County",3,37,299,152,147
050,18,031,"Indiana","Decatur County",3,38,321,163,158
050,18,031,"Indiana","Decatur County",3,39,329,163,166
050,18,031,"Indiana","Decatur County",3,40,322,157,165
050,18,031,"Indiana","Decatur County",3,41,309,158,151
050,18,031,"Indiana","Decatur County",3,42,329,175,154
050,18,031,"Indiana","Decatur County",3,43,335,169,166
050,18,031,"Indiana","Decatur County",3,44,328,160,168
050,18,031,"Indiana","Decatur County",3,45,292,149,143
050,18,031,"Indiana","Decatur County",3,46,301,154,147
050,18,031,"Indiana","Decatur County",3,47,324,167,157
050,18,031,"Indiana","Decatur County",3,48,318,168,150
050,18,031,"Indiana","Decatur County",3,49,351,183,168
050,18,031,"Indiana","Decatur County",3,50,353,180,173
050,18,031,"Indiana","Decatur County",3,51,329,171,158
050,18,031,"Indiana","Decatur County",3,52,320,171,149
050,18,031,"Indiana","Decatur County",3,53,344,176,168
050,18,031,"Indiana","Decatur County",3,54,347,178,169
050,18,031,"Indiana","Decatur County",3,55,349,177,172
050,18,031,"Indiana","Decatur County",3,56,353,186,167
050,18,031,"Indiana","Decatur County",3,57,381,185,196
050,18,031,"Indiana","Decatur County",3,58,367,179,188
050,18,031,"Indiana","Decatur County",3,59,367,193,174
050,18,031,"Indiana","Decatur County",3,60,370,196,174
050,18,031,"Indiana","Decatur County",3,61,362,183,179
050,18,031,"Indiana","Decatur County",3,62,388,199,189
050,18,031,"Indiana","Decatur County",3,63,360,192,168
050,18,031,"Indiana","Decatur County",3,64,359,176,183
050,18,031,"Indiana","Decatur County",3,65,317,155,162
050,18,031,"Indiana","Decatur County",3,66,316,146,170
050,18,031,"Indiana","Decatur County",3,67,301,145,156
050,18,031,"Indiana","Decatur County",3,68,299,151,148
050,18,031,"Indiana","Decatur County",3,69,286,138,148
050,18,031,"Indiana","Decatur County",3,70,262,130,132
050,18,031,"Indiana","Decatur County",3,71,243,119,124
050,18,031,"Indiana","Decatur County",3,72,241,115,126
050,18,031,"Indiana","Decatur County",3,73,229,104,125
050,18,031,"Indiana","Decatur County",3,74,243,112,131
050,18,031,"Indiana","Decatur County",3,75,159,74,85
050,18,031,"Indiana","Decatur County",3,76,152,64,88
050,18,031,"Indiana","Decatur County",3,77,151,76,75
050,18,031,"Indiana","Decatur County",3,78,149,65,84
050,18,031,"Indiana","Decatur County",3,79,128,52,76
050,18,031,"Indiana","Decatur County",3,80,124,57,67
050,18,031,"Indiana","Decatur County",3,81,107,43,64
050,18,031,"Indiana","Decatur County",3,82,117,43,74
050,18,031,"Indiana","Decatur County",3,83,102,38,64
050,18,031,"Indiana","Decatur County",3,84,108,49,59
050,18,031,"Indiana","Decatur County",3,85,526,176,350
050,18,031,"Indiana","Decatur County",4,0,305,167,138
050,18,031,"Indiana","Decatur County",4,1,312,177,135
050,18,031,"Indiana","Decatur County",4,2,323,156,167
050,18,031,"Indiana","Decatur County",4,3,327,175,152
050,18,031,"Indiana","Decatur County",4,4,354,176,178
050,18,031,"Indiana","Decatur County",4,5,360,180,180
050,18,031,"Indiana","Decatur County",4,6,346,175,171
050,18,031,"Indiana","Decatur County",4,7,346,180,166
050,18,031,"Indiana","Decatur County",4,8,357,184,173
050,18,031,"Indiana","Decatur County",4,9,348,169,179
050,18,031,"Indiana","Decatur County",4,10,315,156,159
050,18,031,"Indiana","Decatur County",4,11,336,170,166
050,18,031,"Indiana","Decatur County",4,12,366,176,190
050,18,031,"Indiana","Decatur County",4,13,378,189,189
050,18,031,"Indiana","Decatur County",4,14,350,196,154
050,18,031,"Indiana","Decatur County",4,15,363,191,172
050,18,031,"Indiana","Decatur County",4,16,375,189,186
050,18,031,"Indiana","Decatur County",4,17,354,166,188
050,18,031,"Indiana","Decatur County",4,18,340,175,165
050,18,031,"Indiana","Decatur County",4,19,247,129,118
050,18,031,"Indiana","Decatur County",4,20,270,149,121
050,18,031,"Indiana","Decatur County",4,21,303,171,132
050,18,031,"Indiana","Decatur County",4,22,319,168,151
050,18,031,"Indiana","Decatur County",4,23,361,194,167
050,18,031,"Indiana","Decatur County",4,24,334,195,139
050,18,031,"Indiana","Decatur County",4,25,325,178,147
050,18,031,"Indiana","Decatur County",4,26,320,166,154
050,18,031,"Indiana","Decatur County",4,27,310,157,153
050,18,031,"Indiana","Decatur County",4,28,310,154,156
050,18,031,"Indiana","Decatur County",4,29,350,151,199
050,18,031,"Indiana","Decatur County",4,30,342,166,176
050,18,031,"Indiana","Decatur County",4,31,323,160,163
050,18,031,"Indiana","Decatur County",4,32,371,191,180
050,18,031,"Indiana","Decatur County",4,33,333,170,163
050,18,031,"Indiana","Decatur County",4,34,332,167,165
050,18,031,"Indiana","Decatur County",4,35,290,150,140
050,18,031,"Indiana","Decatur County",4,36,299,154,145
050,18,031,"Indiana","Decatur County",4,37,312,160,152
050,18,031,"Indiana","Decatur County",4,38,306,157,149
050,18,031,"Indiana","Decatur County",4,39,314,157,157
050,18,031,"Indiana","Decatur County",4,40,325,160,165
050,18,031,"Indiana","Decatur County",4,41,323,156,167
050,18,031,"Indiana","Decatur County",4,42,321,162,159
050,18,031,"Indiana","Decatur County",4,43,323,163,160
050,18,031,"Indiana","Decatur County",4,44,331,167,164
050,18,031,"Indiana","Decatur County",4,45,329,157,172
050,18,031,"Indiana","Decatur County",4,46,291,142,149
050,18,031,"Indiana","Decatur County",4,47,291,149,142
050,18,031,"Indiana","Decatur County",4,48,325,172,153
050,18,031,"Indiana","Decatur County",4,49,329,173,156
050,18,031,"Indiana","Decatur County",4,50,355,186,169
050,18,031,"Indiana","Decatur County",4,51,353,180,173
050,18,031,"Indiana","Decatur County",4,52,339,176,163
050,18,031,"Indiana","Decatur County",4,53,330,179,151
050,18,031,"Indiana","Decatur County",4,54,342,174,168
050,18,031,"Indiana","Decatur County",4,55,351,184,167
050,18,031,"Indiana","Decatur County",4,56,354,185,169
050,18,031,"Indiana","Decatur County",4,57,368,192,176
050,18,031,"Indiana","Decatur County",4,58,375,177,198
050,18,031,"Indiana","Decatur County",4,59,366,178,188
050,18,031,"Indiana","Decatur County",4,60,367,197,170
050,18,031,"Indiana","Decatur County",4,61,348,188,160
050,18,031,"Indiana","Decatur County",4,62,358,177,181
050,18,031,"Indiana","Decatur County",4,63,384,194,190
050,18,031,"Indiana","Decatur County",4,64,361,193,168
050,18,031,"Indiana","Decatur County",4,65,347,166,181
050,18,031,"Indiana","Decatur County",4,66,316,152,164
050,18,031,"Indiana","Decatur County",4,67,306,143,163
050,18,031,"Indiana","Decatur County",4,68,300,147,153
050,18,031,"Indiana","Decatur County",4,69,285,132,153
050,18,031,"Indiana","Decatur County",4,70,282,139,143
050,18,031,"Indiana","Decatur County",4,71,253,126,127
050,18,031,"Indiana","Decatur County",4,72,239,115,124
050,18,031,"Indiana","Decatur County",4,73,233,112,121
050,18,031,"Indiana","Decatur County",4,74,225,100,125
050,18,031,"Indiana","Decatur County",4,75,235,107,128
050,18,031,"Indiana","Decatur County",4,76,152,67,85
050,18,031,"Indiana","Decatur County",4,77,145,62,83
050,18,031,"Indiana","Decatur County",4,78,140,68,72
050,18,031,"Indiana","Decatur County",4,79,144,60,84
050,18,031,"Indiana","Decatur County",4,80,119,49,70
050,18,031,"Indiana","Decatur County",4,81,104,48,56
050,18,031,"Indiana","Decatur County",4,82,107,38,69
050,18,031,"Indiana","Decatur County",4,83,109,41,68
050,18,031,"Indiana","Decatur County",4,84,96,38,58
050,18,031,"Indiana","Decatur County",4,85,552,185,367
050,18,031,"Indiana","Decatur County",5,0,304,167,137
050,18,031,"Indiana","Decatur County",5,1,329,171,158
050,18,031,"Indiana","Decatur County",5,2,309,176,133
050,18,031,"Indiana","Decatur County",5,3,312,153,159
050,18,031,"Indiana","Decatur County",5,4,330,175,155
050,18,031,"Indiana","Decatur County",5,5,339,174,165
050,18,031,"Indiana","Decatur County",5,6,364,185,179
050,18,031,"Indiana","Decatur County",5,7,351,183,168
050,18,031,"Indiana","Decatur County",5,8,330,166,164
050,18,031,"Indiana","Decatur County",5,9,350,186,164
050,18,031,"Indiana","Decatur County",5,10,350,169,181
050,18,031,"Indiana","Decatur County",5,11,310,152,158
050,18,031,"Indiana","Decatur County",5,12,329,164,165
050,18,031,"Indiana","Decatur County",5,13,357,173,184
050,18,031,"Indiana","Decatur County",5,14,362,183,179
050,18,031,"Indiana","Decatur County",5,15,362,198,164
050,18,031,"Indiana","Decatur County",5,16,359,186,173
050,18,031,"Indiana","Decatur County",5,17,374,191,183
050,18,031,"Indiana","Decatur County",5,18,290,145,145
050,18,031,"Indiana","Decatur County",5,19,253,132,121
050,18,031,"Indiana","Decatur County",5,20,294,148,146
050,18,031,"Indiana","Decatur County",5,21,302,169,133
050,18,031,"Indiana","Decatur County",5,22,320,185,135
050,18,031,"Indiana","Decatur County",5,23,341,177,164
050,18,031,"Indiana","Decatur County",5,24,346,195,151
050,18,031,"Indiana","Decatur County",5,25,344,193,151
050,18,031,"Indiana","Decatur County",5,26,336,184,152
050,18,031,"Indiana","Decatur County",5,27,304,155,149
050,18,031,"Indiana","Decatur County",5,28,330,169,161
050,18,031,"Indiana","Decatur County",5,29,309,162,147
050,18,031,"Indiana","Decatur County",5,30,343,152,191
050,18,031,"Indiana","Decatur County",5,31,353,170,183
050,18,031,"Indiana","Decatur County",5,32,333,166,167
050,18,031,"Indiana","Decatur County",5,33,350,173,177
050,18,031,"Indiana","Decatur County",5,34,327,165,162
050,18,031,"Indiana","Decatur County",5,35,322,170,152
050,18,031,"Indiana","Decatur County",5,36,297,154,143
050,18,031,"Indiana","Decatur County",5,37,302,156,146
050,18,031,"Indiana","Decatur County",5,38,313,156,157
050,18,031,"Indiana","Decatur County",5,39,294,149,145
050,18,031,"Indiana","Decatur County",5,40,307,157,150
050,18,031,"Indiana","Decatur County",5,41,329,161,168
050,18,031,"Indiana","Decatur County",5,42,316,157,159
050,18,031,"Indiana","Decatur County",5,43,325,163,162
050,18,031,"Indiana","Decatur County",5,44,322,171,151
050,18,031,"Indiana","Decatur County",5,45,337,172,165
050,18,031,"Indiana","Decatur County",5,46,331,160,171
050,18,031,"Indiana","Decatur County",5,47,282,141,141
050,18,031,"Indiana","Decatur County",5,48,290,152,138
050,18,031,"Indiana","Decatur County",5,49,320,167,153
050,18,031,"Indiana","Decatur County",5,50,338,186,152
050,18,031,"Indiana","Decatur County",5,51,345,177,168
050,18,031,"Indiana","Decatur County",5,52,360,187,173
050,18,031,"Indiana","Decatur County",5,53,340,178,162
050,18,031,"Indiana","Decatur County",5,54,319,168,151
050,18,031,"Indiana","Decatur County",5,55,338,177,161
050,18,031,"Indiana","Decatur County",5,56,349,180,169
050,18,031,"Indiana","Decatur County",5,57,364,185,179
050,18,031,"Indiana","Decatur County",5,58,342,175,167
050,18,031,"Indiana","Decatur County",5,59,366,175,191
050,18,031,"Indiana","Decatur County",5,60,372,185,187
050,18,031,"Indiana","Decatur County",5,61,360,191,169
050,18,031,"Indiana","Decatur County",5,62,347,184,163
050,18,031,"Indiana","Decatur County",5,63,353,174,179
050,18,031,"Indiana","Decatur County",5,64,393,203,190
050,18,031,"Indiana","Decatur County",5,65,363,197,166
050,18,031,"Indiana","Decatur County",5,66,340,157,183
050,18,031,"Indiana","Decatur County",5,67,307,150,157
050,18,031,"Indiana","Decatur County",5,68,309,148,161
050,18,031,"Indiana","Decatur County",5,69,293,137,156
050,18,031,"Indiana","Decatur County",5,70,274,129,145
050,18,031,"Indiana","Decatur County",5,71,274,134,140
050,18,031,"Indiana","Decatur County",5,72,241,119,122
050,18,031,"Indiana","Decatur County",5,73,239,116,123
050,18,031,"Indiana","Decatur County",5,74,228,109,119
050,18,031,"Indiana","Decatur County",5,75,210,94,116
050,18,031,"Indiana","Decatur County",5,76,226,103,123
050,18,031,"Indiana","Decatur County",5,77,146,67,79
050,18,031,"Indiana","Decatur County",5,78,136,55,81
050,18,031,"Indiana","Decatur County",5,79,130,60,70
050,18,031,"Indiana","Decatur County",5,80,133,54,79
050,18,031,"Indiana","Decatur County",5,81,96,39,57
050,18,031,"Indiana","Decatur County",5,82,104,41,63
050,18,031,"Indiana","Decatur County",5,83,101,39,62
050,18,031,"Indiana","Decatur County",5,84,100,41,59
050,18,031,"Indiana","Decatur County",5,85,580,191,389
050,18,033,"Indiana","DeKalb County",1,0,531,272,259
050,18,033,"Indiana","DeKalb County",1,1,553,272,281
050,18,033,"Indiana","DeKalb County",1,2,551,269,282
050,18,033,"Indiana","DeKalb County",1,3,561,286,275
050,18,033,"Indiana","DeKalb County",1,4,592,293,299
050,18,033,"Indiana","DeKalb County",1,5,587,293,294
050,18,033,"Indiana","DeKalb County",1,6,547,270,277
050,18,033,"Indiana","DeKalb County",1,7,562,284,278
050,18,033,"Indiana","DeKalb County",1,8,572,296,276
050,18,033,"Indiana","DeKalb County",1,9,544,275,269
050,18,033,"Indiana","DeKalb County",1,10,598,291,307
050,18,033,"Indiana","DeKalb County",1,11,594,281,313
050,18,033,"Indiana","DeKalb County",1,12,628,325,303
050,18,033,"Indiana","DeKalb County",1,13,617,307,310
050,18,033,"Indiana","DeKalb County",1,14,614,312,302
050,18,033,"Indiana","DeKalb County",1,15,662,326,336
050,18,033,"Indiana","DeKalb County",1,16,634,326,308
050,18,033,"Indiana","DeKalb County",1,17,626,342,284
050,18,033,"Indiana","DeKalb County",1,18,533,290,243
050,18,033,"Indiana","DeKalb County",1,19,414,220,194
050,18,033,"Indiana","DeKalb County",1,20,442,236,206
050,18,033,"Indiana","DeKalb County",1,21,483,251,232
050,18,033,"Indiana","DeKalb County",1,22,500,256,244
050,18,033,"Indiana","DeKalb County",1,23,530,266,264
050,18,033,"Indiana","DeKalb County",1,24,513,260,253
050,18,033,"Indiana","DeKalb County",1,25,544,284,260
050,18,033,"Indiana","DeKalb County",1,26,571,304,267
050,18,033,"Indiana","DeKalb County",1,27,553,294,259
050,18,033,"Indiana","DeKalb County",1,28,563,292,271
050,18,033,"Indiana","DeKalb County",1,29,573,287,286
050,18,033,"Indiana","DeKalb County",1,30,571,272,299
050,18,033,"Indiana","DeKalb County",1,31,519,269,250
050,18,033,"Indiana","DeKalb County",1,32,522,267,255
050,18,033,"Indiana","DeKalb County",1,33,522,262,260
050,18,033,"Indiana","DeKalb County",1,34,536,272,264
050,18,033,"Indiana","DeKalb County",1,35,527,257,270
050,18,033,"Indiana","DeKalb County",1,36,494,241,253
050,18,033,"Indiana","DeKalb County",1,37,520,268,252
050,18,033,"Indiana","DeKalb County",1,38,501,238,263
050,18,033,"Indiana","DeKalb County",1,39,520,252,268
050,18,033,"Indiana","DeKalb County",1,40,534,268,266
050,18,033,"Indiana","DeKalb County",1,41,539,273,266
050,18,033,"Indiana","DeKalb County",1,42,544,292,252
050,18,033,"Indiana","DeKalb County",1,43,517,261,256
050,18,033,"Indiana","DeKalb County",1,44,491,250,241
050,18,033,"Indiana","DeKalb County",1,45,506,262,244
050,18,033,"Indiana","DeKalb County",1,46,529,265,264
050,18,033,"Indiana","DeKalb County",1,47,503,247,256
050,18,033,"Indiana","DeKalb County",1,48,565,275,290
050,18,033,"Indiana","DeKalb County",1,49,568,297,271
050,18,033,"Indiana","DeKalb County",1,50,552,284,268
050,18,033,"Indiana","DeKalb County",1,51,545,291,254
050,18,033,"Indiana","DeKalb County",1,52,521,265,256
050,18,033,"Indiana","DeKalb County",1,53,546,276,270
050,18,033,"Indiana","DeKalb County",1,54,595,318,277
050,18,033,"Indiana","DeKalb County",1,55,618,322,296
050,18,033,"Indiana","DeKalb County",1,56,631,322,309
050,18,033,"Indiana","DeKalb County",1,57,650,340,310
050,18,033,"Indiana","DeKalb County",1,58,625,319,306
050,18,033,"Indiana","DeKalb County",1,59,626,310,316
050,18,033,"Indiana","DeKalb County",1,60,586,284,302
050,18,033,"Indiana","DeKalb County",1,61,583,308,275
050,18,033,"Indiana","DeKalb County",1,62,608,303,305
050,18,033,"Indiana","DeKalb County",1,63,572,281,291
050,18,033,"Indiana","DeKalb County",1,64,546,281,265
050,18,033,"Indiana","DeKalb County",1,65,505,262,243
050,18,033,"Indiana","DeKalb County",1,66,502,242,260
050,18,033,"Indiana","DeKalb County",1,67,513,245,268
050,18,033,"Indiana","DeKalb County",1,68,485,238,247
050,18,033,"Indiana","DeKalb County",1,69,440,208,232
050,18,033,"Indiana","DeKalb County",1,70,423,206,217
050,18,033,"Indiana","DeKalb County",1,71,413,198,215
050,18,033,"Indiana","DeKalb County",1,72,399,177,222
050,18,033,"Indiana","DeKalb County",1,73,399,186,213
050,18,033,"Indiana","DeKalb County",1,74,274,134,140
050,18,033,"Indiana","DeKalb County",1,75,292,140,152
050,18,033,"Indiana","DeKalb County",1,76,268,121,147
050,18,033,"Indiana","DeKalb County",1,77,253,105,148
050,18,033,"Indiana","DeKalb County",1,78,246,114,132
050,18,033,"Indiana","DeKalb County",1,79,198,89,109
050,18,033,"Indiana","DeKalb County",1,80,175,68,107
050,18,033,"Indiana","DeKalb County",1,81,178,64,114
050,18,033,"Indiana","DeKalb County",1,82,165,75,90
050,18,033,"Indiana","DeKalb County",1,83,138,57,81
050,18,033,"Indiana","DeKalb County",1,84,141,62,79
050,18,033,"Indiana","DeKalb County",1,85,729,233,496
050,18,033,"Indiana","DeKalb County",2,0,531,264,267
050,18,033,"Indiana","DeKalb County",2,1,542,269,273
050,18,033,"Indiana","DeKalb County",2,2,557,274,283
050,18,033,"Indiana","DeKalb County",2,3,564,284,280
050,18,033,"Indiana","DeKalb County",2,4,590,295,295
050,18,033,"Indiana","DeKalb County",2,5,593,294,299
050,18,033,"Indiana","DeKalb County",2,6,559,276,283
050,18,033,"Indiana","DeKalb County",2,7,559,280,279
050,18,033,"Indiana","DeKalb County",2,8,566,290,276
050,18,033,"Indiana","DeKalb County",2,9,554,280,274
050,18,033,"Indiana","DeKalb County",2,10,582,286,296
050,18,033,"Indiana","DeKalb County",2,11,593,284,309
050,18,033,"Indiana","DeKalb County",2,12,623,316,307
050,18,033,"Indiana","DeKalb County",2,13,620,312,308
050,18,033,"Indiana","DeKalb County",2,14,619,311,308
050,18,033,"Indiana","DeKalb County",2,15,652,323,329
050,18,033,"Indiana","DeKalb County",2,16,643,329,314
050,18,033,"Indiana","DeKalb County",2,17,630,340,290
050,18,033,"Indiana","DeKalb County",2,18,527,289,238
050,18,033,"Indiana","DeKalb County",2,19,420,223,197
050,18,033,"Indiana","DeKalb County",2,20,449,239,210
050,18,033,"Indiana","DeKalb County",2,21,472,246,226
050,18,033,"Indiana","DeKalb County",2,22,502,256,246
050,18,033,"Indiana","DeKalb County",2,23,524,266,258
050,18,033,"Indiana","DeKalb County",2,24,515,260,255
050,18,033,"Indiana","DeKalb County",2,25,539,283,256
050,18,033,"Indiana","DeKalb County",2,26,560,298,262
050,18,033,"Indiana","DeKalb County",2,27,556,294,262
050,18,033,"Indiana","DeKalb County",2,28,562,293,269
050,18,033,"Indiana","DeKalb County",2,29,567,284,283
050,18,033,"Indiana","DeKalb County",2,30,576,278,298
050,18,033,"Indiana","DeKalb County",2,31,532,268,264
050,18,033,"Indiana","DeKalb County",2,32,526,269,257
050,18,033,"Indiana","DeKalb County",2,33,524,265,259
050,18,033,"Indiana","DeKalb County",2,34,535,271,264
050,18,033,"Indiana","DeKalb County",2,35,534,261,273
050,18,033,"Indiana","DeKalb County",2,36,498,241,257
050,18,033,"Indiana","DeKalb County",2,37,516,262,254
050,18,033,"Indiana","DeKalb County",2,38,510,248,262
050,18,033,"Indiana","DeKalb County",2,39,518,250,268
050,18,033,"Indiana","DeKalb County",2,40,533,265,268
050,18,033,"Indiana","DeKalb County",2,41,540,273,267
050,18,033,"Indiana","DeKalb County",2,42,539,284,255
050,18,033,"Indiana","DeKalb County",2,43,528,272,256
050,18,033,"Indiana","DeKalb County",2,44,491,249,242
050,18,033,"Indiana","DeKalb County",2,45,505,260,245
050,18,033,"Indiana","DeKalb County",2,46,521,264,257
050,18,033,"Indiana","DeKalb County",2,47,507,250,257
050,18,033,"Indiana","DeKalb County",2,48,549,268,281
050,18,033,"Indiana","DeKalb County",2,49,569,293,276
050,18,033,"Indiana","DeKalb County",2,50,553,285,268
050,18,033,"Indiana","DeKalb County",2,51,541,284,257
050,18,033,"Indiana","DeKalb County",2,52,518,268,250
050,18,033,"Indiana","DeKalb County",2,53,540,272,268
050,18,033,"Indiana","DeKalb County",2,54,585,308,277
050,18,033,"Indiana","DeKalb County",2,55,611,319,292
050,18,033,"Indiana","DeKalb County",2,56,629,322,307
050,18,033,"Indiana","DeKalb County",2,57,645,337,308
050,18,033,"Indiana","DeKalb County",2,58,630,323,307
050,18,033,"Indiana","DeKalb County",2,59,630,314,316
050,18,033,"Indiana","DeKalb County",2,60,592,291,301
050,18,033,"Indiana","DeKalb County",2,61,579,300,279
050,18,033,"Indiana","DeKalb County",2,62,596,302,294
050,18,033,"Indiana","DeKalb County",2,63,579,285,294
050,18,033,"Indiana","DeKalb County",2,64,548,279,269
050,18,033,"Indiana","DeKalb County",2,65,514,264,250
050,18,033,"Indiana","DeKalb County",2,66,506,247,259
050,18,033,"Indiana","DeKalb County",2,67,507,242,265
050,18,033,"Indiana","DeKalb County",2,68,486,237,249
050,18,033,"Indiana","DeKalb County",2,69,457,218,239
050,18,033,"Indiana","DeKalb County",2,70,422,204,218
050,18,033,"Indiana","DeKalb County",2,71,411,196,215
050,18,033,"Indiana","DeKalb County",2,72,396,178,218
050,18,033,"Indiana","DeKalb County",2,73,414,191,223
050,18,033,"Indiana","DeKalb County",2,74,285,136,149
050,18,033,"Indiana","DeKalb County",2,75,288,139,149
050,18,033,"Indiana","DeKalb County",2,76,270,124,146
050,18,033,"Indiana","DeKalb County",2,77,262,110,152
050,18,033,"Indiana","DeKalb County",2,78,240,108,132
050,18,033,"Indiana","DeKalb County",2,79,206,93,113
050,18,033,"Indiana","DeKalb County",2,80,182,73,109
050,18,033,"Indiana","DeKalb County",2,81,173,62,111
050,18,033,"Indiana","DeKalb County",2,82,168,73,95
050,18,033,"Indiana","DeKalb County",2,83,142,60,82
050,18,033,"Indiana","DeKalb County",2,84,140,62,78
050,18,033,"Indiana","DeKalb County",2,85,726,237,489
050,18,033,"Indiana","DeKalb County",3,0,544,295,249
050,18,033,"Indiana","DeKalb County",3,1,530,248,282
050,18,033,"Indiana","DeKalb County",3,2,547,277,270
050,18,033,"Indiana","DeKalb County",3,3,573,287,286
050,18,033,"Indiana","DeKalb County",3,4,569,283,286
050,18,033,"Indiana","DeKalb County",3,5,612,304,308
050,18,033,"Indiana","DeKalb County",3,6,585,281,304
050,18,033,"Indiana","DeKalb County",3,7,578,290,288
050,18,033,"Indiana","DeKalb County",3,8,545,282,263
050,18,033,"Indiana","DeKalb County",3,9,548,286,262
050,18,033,"Indiana","DeKalb County",3,10,560,285,275
050,18,033,"Indiana","DeKalb County",3,11,584,289,295
050,18,033,"Indiana","DeKalb County",3,12,612,299,313
050,18,033,"Indiana","DeKalb County",3,13,621,313,308
050,18,033,"Indiana","DeKalb County",3,14,633,319,314
050,18,033,"Indiana","DeKalb County",3,15,622,309,313
050,18,033,"Indiana","DeKalb County",3,16,648,323,325
050,18,033,"Indiana","DeKalb County",3,17,636,323,313
050,18,033,"Indiana","DeKalb County",3,18,531,296,235
050,18,033,"Indiana","DeKalb County",3,19,423,231,192
050,18,033,"Indiana","DeKalb County",3,20,434,232,202
050,18,033,"Indiana","DeKalb County",3,21,475,257,218
050,18,033,"Indiana","DeKalb County",3,22,508,257,251
050,18,033,"Indiana","DeKalb County",3,23,521,271,250
050,18,033,"Indiana","DeKalb County",3,24,522,262,260
050,18,033,"Indiana","DeKalb County",3,25,509,252,257
050,18,033,"Indiana","DeKalb County",3,26,530,280,250
050,18,033,"Indiana","DeKalb County",3,27,556,294,262
050,18,033,"Indiana","DeKalb County",3,28,565,294,271
050,18,033,"Indiana","DeKalb County",3,29,572,299,273
050,18,033,"Indiana","DeKalb County",3,30,580,287,293
050,18,033,"Indiana","DeKalb County",3,31,566,267,299
050,18,033,"Indiana","DeKalb County",3,32,536,274,262
050,18,033,"Indiana","DeKalb County",3,33,537,277,260
050,18,033,"Indiana","DeKalb County",3,34,529,273,256
050,18,033,"Indiana","DeKalb County",3,35,530,270,260
050,18,033,"Indiana","DeKalb County",3,36,540,265,275
050,18,033,"Indiana","DeKalb County",3,37,503,240,263
050,18,033,"Indiana","DeKalb County",3,38,512,264,248
050,18,033,"Indiana","DeKalb County",3,39,520,261,259
050,18,033,"Indiana","DeKalb County",3,40,517,242,275
050,18,033,"Indiana","DeKalb County",3,41,555,278,277
050,18,033,"Indiana","DeKalb County",3,42,528,267,261
050,18,033,"Indiana","DeKalb County",3,43,569,305,264
050,18,033,"Indiana","DeKalb County",3,44,543,282,261
050,18,033,"Indiana","DeKalb County",3,45,500,250,250
050,18,033,"Indiana","DeKalb County",3,46,515,267,248
050,18,033,"Indiana","DeKalb County",3,47,525,264,261
050,18,033,"Indiana","DeKalb County",3,48,496,235,261
050,18,033,"Indiana","DeKalb County",3,49,540,273,267
050,18,033,"Indiana","DeKalb County",3,50,569,292,277
050,18,033,"Indiana","DeKalb County",3,51,567,292,275
050,18,033,"Indiana","DeKalb County",3,52,532,275,257
050,18,033,"Indiana","DeKalb County",3,53,525,266,259
050,18,033,"Indiana","DeKalb County",3,54,551,281,270
050,18,033,"Indiana","DeKalb County",3,55,575,298,277
050,18,033,"Indiana","DeKalb County",3,56,603,314,289
050,18,033,"Indiana","DeKalb County",3,57,616,315,301
050,18,033,"Indiana","DeKalb County",3,58,644,337,307
050,18,033,"Indiana","DeKalb County",3,59,614,310,304
050,18,033,"Indiana","DeKalb County",3,60,619,306,313
050,18,033,"Indiana","DeKalb County",3,61,596,288,308
050,18,033,"Indiana","DeKalb County",3,62,567,294,273
050,18,033,"Indiana","DeKalb County",3,63,575,299,276
050,18,033,"Indiana","DeKalb County",3,64,569,282,287
050,18,033,"Indiana","DeKalb County",3,65,546,282,264
050,18,033,"Indiana","DeKalb County",3,66,499,260,239
050,18,033,"Indiana","DeKalb County",3,67,493,233,260
050,18,033,"Indiana","DeKalb County",3,68,496,235,261
050,18,033,"Indiana","DeKalb County",3,69,474,228,246
050,18,033,"Indiana","DeKalb County",3,70,442,209,233
050,18,033,"Indiana","DeKalb County",3,71,403,195,208
050,18,033,"Indiana","DeKalb County",3,72,396,183,213
050,18,033,"Indiana","DeKalb County",3,73,375,175,200
050,18,033,"Indiana","DeKalb County",3,74,394,172,222
050,18,033,"Indiana","DeKalb County",3,75,272,127,145
050,18,033,"Indiana","DeKalb County",3,76,278,139,139
050,18,033,"Indiana","DeKalb County",3,77,267,124,143
050,18,033,"Indiana","DeKalb County",3,78,250,100,150
050,18,033,"Indiana","DeKalb County",3,79,226,100,126
050,18,033,"Indiana","DeKalb County",3,80,193,84,109
050,18,033,"Indiana","DeKalb County",3,81,161,63,98
050,18,033,"Indiana","DeKalb County",3,82,162,58,104
050,18,033,"Indiana","DeKalb County",3,83,149,63,86
050,18,033,"Indiana","DeKalb County",3,84,128,59,69
050,18,033,"Indiana","DeKalb County",3,85,735,251,484
050,18,033,"Indiana","DeKalb County",4,0,553,296,257
050,18,033,"Indiana","DeKalb County",4,1,557,300,257
050,18,033,"Indiana","DeKalb County",4,2,537,263,274
050,18,033,"Indiana","DeKalb County",4,3,570,293,277
050,18,033,"Indiana","DeKalb County",4,4,577,276,301
050,18,033,"Indiana","DeKalb County",4,5,574,271,303
050,18,033,"Indiana","DeKalb County",4,6,616,294,322
050,18,033,"Indiana","DeKalb County",4,7,605,289,316
050,18,033,"Indiana","DeKalb County",4,8,569,281,288
050,18,033,"Indiana","DeKalb County",4,9,570,294,276
050,18,033,"Indiana","DeKalb County",4,10,566,289,277
050,18,033,"Indiana","DeKalb County",4,11,542,265,277
050,18,033,"Indiana","DeKalb County",4,12,594,293,301
050,18,033,"Indiana","DeKalb County",4,13,617,302,315
050,18,033,"Indiana","DeKalb County",4,14,639,321,318
050,18,033,"Indiana","DeKalb County",4,15,632,313,319
050,18,033,"Indiana","DeKalb County",4,16,631,317,314
050,18,033,"Indiana","DeKalb County",4,17,654,322,332
050,18,033,"Indiana","DeKalb County",4,18,528,278,250
050,18,033,"Indiana","DeKalb County",4,19,413,229,184
050,18,033,"Indiana","DeKalb County",4,20,453,256,197
050,18,033,"Indiana","DeKalb County",4,21,463,249,214
050,18,033,"Indiana","DeKalb County",4,22,504,269,235
050,18,033,"Indiana","DeKalb County",4,23,519,269,250
050,18,033,"Indiana","DeKalb County",4,24,538,278,260
050,18,033,"Indiana","DeKalb County",4,25,551,292,259
050,18,033,"Indiana","DeKalb County",4,26,510,255,255
050,18,033,"Indiana","DeKalb County",4,27,547,285,262
050,18,033,"Indiana","DeKalb County",4,28,551,287,264
050,18,033,"Indiana","DeKalb County",4,29,574,292,282
050,18,033,"Indiana","DeKalb County",4,30,606,324,282
050,18,033,"Indiana","DeKalb County",4,31,591,295,296
050,18,033,"Indiana","DeKalb County",4,32,576,266,310
050,18,033,"Indiana","DeKalb County",4,33,548,278,270
050,18,033,"Indiana","DeKalb County",4,34,550,290,260
050,18,033,"Indiana","DeKalb County",4,35,533,277,256
050,18,033,"Indiana","DeKalb County",4,36,541,275,266
050,18,033,"Indiana","DeKalb County",4,37,559,282,277
050,18,033,"Indiana","DeKalb County",4,38,506,239,267
050,18,033,"Indiana","DeKalb County",4,39,531,280,251
050,18,033,"Indiana","DeKalb County",4,40,517,255,262
050,18,033,"Indiana","DeKalb County",4,41,532,250,282
050,18,033,"Indiana","DeKalb County",4,42,554,278,276
050,18,033,"Indiana","DeKalb County",4,43,535,270,265
050,18,033,"Indiana","DeKalb County",4,44,567,304,263
050,18,033,"Indiana","DeKalb County",4,45,544,286,258
050,18,033,"Indiana","DeKalb County",4,46,485,245,240
050,18,033,"Indiana","DeKalb County",4,47,533,277,256
050,18,033,"Indiana","DeKalb County",4,48,538,269,269
050,18,033,"Indiana","DeKalb County",4,49,509,237,272
050,18,033,"Indiana","DeKalb County",4,50,531,267,264
050,18,033,"Indiana","DeKalb County",4,51,590,303,287
050,18,033,"Indiana","DeKalb County",4,52,553,283,270
050,18,033,"Indiana","DeKalb County",4,53,547,277,270
050,18,033,"Indiana","DeKalb County",4,54,532,273,259
050,18,033,"Indiana","DeKalb County",4,55,551,289,262
050,18,033,"Indiana","DeKalb County",4,56,562,290,272
050,18,033,"Indiana","DeKalb County",4,57,597,309,288
050,18,033,"Indiana","DeKalb County",4,58,599,299,300
050,18,033,"Indiana","DeKalb County",4,59,625,322,303
050,18,033,"Indiana","DeKalb County",4,60,609,314,295
050,18,033,"Indiana","DeKalb County",4,61,618,297,321
050,18,033,"Indiana","DeKalb County",4,62,585,288,297
050,18,033,"Indiana","DeKalb County",4,63,557,292,265
050,18,033,"Indiana","DeKalb County",4,64,567,297,270
050,18,033,"Indiana","DeKalb County",4,65,567,284,283
050,18,033,"Indiana","DeKalb County",4,66,534,276,258
050,18,033,"Indiana","DeKalb County",4,67,479,243,236
050,18,033,"Indiana","DeKalb County",4,68,482,228,254
050,18,033,"Indiana","DeKalb County",4,69,491,232,259
050,18,033,"Indiana","DeKalb County",4,70,473,230,243
050,18,033,"Indiana","DeKalb County",4,71,422,200,222
050,18,033,"Indiana","DeKalb County",4,72,405,189,216
050,18,033,"Indiana","DeKalb County",4,73,382,181,201
050,18,033,"Indiana","DeKalb County",4,74,363,171,192
050,18,033,"Indiana","DeKalb County",4,75,380,163,217
050,18,033,"Indiana","DeKalb County",4,76,264,123,141
050,18,033,"Indiana","DeKalb County",4,77,268,132,136
050,18,033,"Indiana","DeKalb County",4,78,256,116,140
050,18,033,"Indiana","DeKalb County",4,79,237,94,143
050,18,033,"Indiana","DeKalb County",4,80,212,94,118
050,18,033,"Indiana","DeKalb County",4,81,174,74,100
050,18,033,"Indiana","DeKalb County",4,82,152,61,91
050,18,033,"Indiana","DeKalb County",4,83,153,52,101
050,18,033,"Indiana","DeKalb County",4,84,137,63,74
050,18,033,"Indiana","DeKalb County",4,85,750,269,481
050,18,033,"Indiana","DeKalb County",5,0,540,289,251
050,18,033,"Indiana","DeKalb County",5,1,568,313,255
050,18,033,"Indiana","DeKalb County",5,2,567,299,268
050,18,033,"Indiana","DeKalb County",5,3,539,275,264
050,18,033,"Indiana","DeKalb County",5,4,584,296,288
050,18,033,"Indiana","DeKalb County",5,5,578,284,294
050,18,033,"Indiana","DeKalb County",5,6,590,288,302
050,18,033,"Indiana","DeKalb County",5,7,638,303,335
050,18,033,"Indiana","DeKalb County",5,8,605,288,317
050,18,033,"Indiana","DeKalb County",5,9,582,283,299
050,18,033,"Indiana","DeKalb County",5,10,581,301,280
050,18,033,"Indiana","DeKalb County",5,11,574,296,278
050,18,033,"Indiana","DeKalb County",5,12,564,280,284
050,18,033,"Indiana","DeKalb County",5,13,612,309,303
050,18,033,"Indiana","DeKalb County",5,14,618,296,322
050,18,033,"Indiana","DeKalb County",5,15,615,308,307
050,18,033,"Indiana","DeKalb County",5,16,634,313,321
050,18,033,"Indiana","DeKalb County",5,17,629,314,315
050,18,033,"Indiana","DeKalb County",5,18,546,285,261
050,18,033,"Indiana","DeKalb County",5,19,397,211,186
050,18,033,"Indiana","DeKalb County",5,20,452,246,206
050,18,033,"Indiana","DeKalb County",5,21,499,272,227
050,18,033,"Indiana","DeKalb County",5,22,500,261,239
050,18,033,"Indiana","DeKalb County",5,23,514,278,236
050,18,033,"Indiana","DeKalb County",5,24,533,275,258
050,18,033,"Indiana","DeKalb County",5,25,575,310,265
050,18,033,"Indiana","DeKalb County",5,26,570,292,278
050,18,033,"Indiana","DeKalb County",5,27,532,266,266
050,18,033,"Indiana","DeKalb County",5,28,546,286,260
050,18,033,"Indiana","DeKalb County",5,29,557,295,262
050,18,033,"Indiana","DeKalb County",5,30,600,307,293
050,18,033,"Indiana","DeKalb County",5,31,622,326,296
050,18,033,"Indiana","DeKalb County",5,32,584,285,299
050,18,033,"Indiana","DeKalb County",5,33,581,270,311
050,18,033,"Indiana","DeKalb County",5,34,541,286,255
050,18,033,"Indiana","DeKalb County",5,35,556,292,264
050,18,033,"Indiana","DeKalb County",5,36,541,279,262
050,18,033,"Indiana","DeKalb County",5,37,566,293,273
050,18,033,"Indiana","DeKalb County",5,38,565,289,276
050,18,033,"Indiana","DeKalb County",5,39,506,235,271
050,18,033,"Indiana","DeKalb County",5,40,542,288,254
050,18,033,"Indiana","DeKalb County",5,41,540,263,277
050,18,033,"Indiana","DeKalb County",5,42,519,237,282
050,18,033,"Indiana","DeKalb County",5,43,548,278,270
050,18,033,"Indiana","DeKalb County",5,44,540,270,270
050,18,033,"Indiana","DeKalb County",5,45,567,307,260
050,18,033,"Indiana","DeKalb County",5,46,538,279,259
050,18,033,"Indiana","DeKalb County",5,47,484,248,236
050,18,033,"Indiana","DeKalb County",5,48,527,267,260
050,18,033,"Indiana","DeKalb County",5,49,541,272,269
050,18,033,"Indiana","DeKalb County",5,50,507,243,264
050,18,033,"Indiana","DeKalb County",5,51,539,276,263
050,18,033,"Indiana","DeKalb County",5,52,572,297,275
050,18,033,"Indiana","DeKalb County",5,53,548,276,272
050,18,033,"Indiana","DeKalb County",5,54,553,278,275
050,18,033,"Indiana","DeKalb County",5,55,536,276,260
050,18,033,"Indiana","DeKalb County",5,56,548,293,255
050,18,033,"Indiana","DeKalb County",5,57,574,297,277
050,18,033,"Indiana","DeKalb County",5,58,593,312,281
050,18,033,"Indiana","DeKalb County",5,59,595,293,302
050,18,033,"Indiana","DeKalb County",5,60,618,312,306
050,18,033,"Indiana","DeKalb County",5,61,601,310,291
050,18,033,"Indiana","DeKalb County",5,62,608,290,318
050,18,033,"Indiana","DeKalb County",5,63,589,290,299
050,18,033,"Indiana","DeKalb County",5,64,548,290,258
050,18,033,"Indiana","DeKalb County",5,65,561,289,272
050,18,033,"Indiana","DeKalb County",5,66,568,287,281
050,18,033,"Indiana","DeKalb County",5,67,512,261,251
050,18,033,"Indiana","DeKalb County",5,68,467,235,232
050,18,033,"Indiana","DeKalb County",5,69,473,223,250
050,18,033,"Indiana","DeKalb County",5,70,485,226,259
050,18,033,"Indiana","DeKalb County",5,71,452,221,231
050,18,033,"Indiana","DeKalb County",5,72,422,194,228
050,18,033,"Indiana","DeKalb County",5,73,391,190,201
050,18,033,"Indiana","DeKalb County",5,74,371,174,197
050,18,033,"Indiana","DeKalb County",5,75,336,159,177
050,18,033,"Indiana","DeKalb County",5,76,364,158,206
050,18,033,"Indiana","DeKalb County",5,77,257,114,143
050,18,033,"Indiana","DeKalb County",5,78,257,123,134
050,18,033,"Indiana","DeKalb County",5,79,249,117,132
050,18,033,"Indiana","DeKalb County",5,80,228,88,140
050,18,033,"Indiana","DeKalb County",5,81,194,85,109
050,18,033,"Indiana","DeKalb County",5,82,165,70,95
050,18,033,"Indiana","DeKalb County",5,83,136,54,82
050,18,033,"Indiana","DeKalb County",5,84,150,55,95
050,18,033,"Indiana","DeKalb County",5,85,784,291,493
050,18,035,"Indiana","Delaware County",1,0,1025,530,495
050,18,035,"Indiana","Delaware County",1,1,1048,563,485
050,18,035,"Indiana","Delaware County",1,2,1084,560,524
050,18,035,"Indiana","Delaware County",1,3,1105,546,559
050,18,035,"Indiana","Delaware County",1,4,1088,535,553
050,18,035,"Indiana","Delaware County",1,5,1118,585,533
050,18,035,"Indiana","Delaware County",1,6,1145,566,579
050,18,035,"Indiana","Delaware County",1,7,1187,604,583
050,18,035,"Indiana","Delaware County",1,8,1126,597,529
050,18,035,"Indiana","Delaware County",1,9,1102,590,512
050,18,035,"Indiana","Delaware County",1,10,1136,577,559
050,18,035,"Indiana","Delaware County",1,11,1148,578,570
050,18,035,"Indiana","Delaware County",1,12,1178,585,593
050,18,035,"Indiana","Delaware County",1,13,1168,588,580
050,18,035,"Indiana","Delaware County",1,14,1153,591,562
050,18,035,"Indiana","Delaware County",1,15,1172,610,562
050,18,035,"Indiana","Delaware County",1,16,1226,645,581
050,18,035,"Indiana","Delaware County",1,17,1288,651,637
050,18,035,"Indiana","Delaware County",1,18,1828,811,1017
050,18,035,"Indiana","Delaware County",1,19,4099,1858,2241
050,18,035,"Indiana","Delaware County",1,20,4042,1847,2195
050,18,035,"Indiana","Delaware County",1,21,3690,1594,2096
050,18,035,"Indiana","Delaware County",1,22,3308,1655,1653
050,18,035,"Indiana","Delaware County",1,23,2566,1413,1153
050,18,035,"Indiana","Delaware County",1,24,1784,883,901
050,18,035,"Indiana","Delaware County",1,25,1557,775,782
050,18,035,"Indiana","Delaware County",1,26,1476,740,736
050,18,035,"Indiana","Delaware County",1,27,1375,685,690
050,18,035,"Indiana","Delaware County",1,28,1355,691,664
050,18,035,"Indiana","Delaware County",1,29,1275,628,647
050,18,035,"Indiana","Delaware County",1,30,1252,643,609
050,18,035,"Indiana","Delaware County",1,31,1257,629,628
050,18,035,"Indiana","Delaware County",1,32,1183,599,584
050,18,035,"Indiana","Delaware County",1,33,1126,560,566
050,18,035,"Indiana","Delaware County",1,34,1166,592,574
050,18,035,"Indiana","Delaware County",1,35,1157,586,571
050,18,035,"Indiana","Delaware County",1,36,1161,568,593
050,18,035,"Indiana","Delaware County",1,37,1185,580,605
050,18,035,"Indiana","Delaware County",1,38,1133,549,584
050,18,035,"Indiana","Delaware County",1,39,1200,586,614
050,18,035,"Indiana","Delaware County",1,40,1203,607,596
050,18,035,"Indiana","Delaware County",1,41,1191,588,603
050,18,035,"Indiana","Delaware County",1,42,1127,543,584
050,18,035,"Indiana","Delaware County",1,43,1043,518,525
050,18,035,"Indiana","Delaware County",1,44,1120,556,564
050,18,035,"Indiana","Delaware County",1,45,1185,587,598
050,18,035,"Indiana","Delaware County",1,46,1114,543,571
050,18,035,"Indiana","Delaware County",1,47,1161,583,578
050,18,035,"Indiana","Delaware County",1,48,1313,666,647
050,18,035,"Indiana","Delaware County",1,49,1353,682,671
050,18,035,"Indiana","Delaware County",1,50,1328,665,663
050,18,035,"Indiana","Delaware County",1,51,1233,599,634
050,18,035,"Indiana","Delaware County",1,52,1247,618,629
050,18,035,"Indiana","Delaware County",1,53,1288,635,653
050,18,035,"Indiana","Delaware County",1,54,1281,636,645
050,18,035,"Indiana","Delaware County",1,55,1408,688,720
050,18,035,"Indiana","Delaware County",1,56,1365,660,705
050,18,035,"Indiana","Delaware County",1,57,1336,654,682
050,18,035,"Indiana","Delaware County",1,58,1421,700,721
050,18,035,"Indiana","Delaware County",1,59,1397,690,707
050,18,035,"Indiana","Delaware County",1,60,1416,707,709
050,18,035,"Indiana","Delaware County",1,61,1366,663,703
050,18,035,"Indiana","Delaware County",1,62,1426,690,736
050,18,035,"Indiana","Delaware County",1,63,1364,660,704
050,18,035,"Indiana","Delaware County",1,64,1293,601,692
050,18,035,"Indiana","Delaware County",1,65,1310,611,699
050,18,035,"Indiana","Delaware County",1,66,1210,558,652
050,18,035,"Indiana","Delaware County",1,67,1164,524,640
050,18,035,"Indiana","Delaware County",1,68,1155,516,639
050,18,035,"Indiana","Delaware County",1,69,1062,503,559
050,18,035,"Indiana","Delaware County",1,70,1067,501,566
050,18,035,"Indiana","Delaware County",1,71,1075,486,589
050,18,035,"Indiana","Delaware County",1,72,1089,487,602
050,18,035,"Indiana","Delaware County",1,73,1034,454,580
050,18,035,"Indiana","Delaware County",1,74,756,323,433
050,18,035,"Indiana","Delaware County",1,75,802,356,446
050,18,035,"Indiana","Delaware County",1,76,788,355,433
050,18,035,"Indiana","Delaware County",1,77,781,342,439
050,18,035,"Indiana","Delaware County",1,78,642,280,362
050,18,035,"Indiana","Delaware County",1,79,648,287,361
050,18,035,"Indiana","Delaware County",1,80,544,237,307
050,18,035,"Indiana","Delaware County",1,81,531,240,291
050,18,035,"Indiana","Delaware County",1,82,485,216,269
050,18,035,"Indiana","Delaware County",1,83,409,173,236
050,18,035,"Indiana","Delaware County",1,84,400,174,226
050,18,035,"Indiana","Delaware County",1,85,2306,813,1493
050,18,035,"Indiana","Delaware County",2,0,1043,545,498
050,18,035,"Indiana","Delaware County",2,1,1041,557,484
050,18,035,"Indiana","Delaware County",2,2,1074,561,513
050,18,035,"Indiana","Delaware County",2,3,1091,544,547
050,18,035,"Indiana","Delaware County",2,4,1093,540,553
050,18,035,"Indiana","Delaware County",2,5,1109,571,538
050,18,035,"Indiana","Delaware County",2,6,1137,571,566
050,18,035,"Indiana","Delaware County",2,7,1171,592,579
050,18,035,"Indiana","Delaware County",2,8,1135,595,540
050,18,035,"Indiana","Delaware County",2,9,1103,587,516
050,18,035,"Indiana","Delaware County",2,10,1124,577,547
050,18,035,"Indiana","Delaware County",2,11,1136,573,563
050,18,035,"Indiana","Delaware County",2,12,1172,584,588
050,18,035,"Indiana","Delaware County",2,13,1170,587,583
050,18,035,"Indiana","Delaware County",2,14,1155,589,566
050,18,035,"Indiana","Delaware County",2,15,1173,607,566
050,18,035,"Indiana","Delaware County",2,16,1217,639,578
050,18,035,"Indiana","Delaware County",2,17,1295,654,641
050,18,035,"Indiana","Delaware County",2,18,1819,808,1011
050,18,035,"Indiana","Delaware County",2,19,4090,1850,2240
050,18,035,"Indiana","Delaware County",2,20,4065,1850,2215
050,18,035,"Indiana","Delaware County",2,21,3668,1589,2079
050,18,035,"Indiana","Delaware County",2,22,3296,1651,1645
050,18,035,"Indiana","Delaware County",2,23,2572,1406,1166
050,18,035,"Indiana","Delaware County",2,24,1769,877,892
050,18,035,"Indiana","Delaware County",2,25,1559,773,786
050,18,035,"Indiana","Delaware County",2,26,1464,730,734
050,18,035,"Indiana","Delaware County",2,27,1366,685,681
050,18,035,"Indiana","Delaware County",2,28,1352,680,672
050,18,035,"Indiana","Delaware County",2,29,1292,642,650
050,18,035,"Indiana","Delaware County",2,30,1262,640,622
050,18,035,"Indiana","Delaware County",2,31,1249,628,621
050,18,035,"Indiana","Delaware County",2,32,1201,605,596
050,18,035,"Indiana","Delaware County",2,33,1136,568,568
050,18,035,"Indiana","Delaware County",2,34,1156,586,570
050,18,035,"Indiana","Delaware County",2,35,1168,592,576
050,18,035,"Indiana","Delaware County",2,36,1150,565,585
050,18,035,"Indiana","Delaware County",2,37,1180,578,602
050,18,035,"Indiana","Delaware County",2,38,1155,560,595
050,18,035,"Indiana","Delaware County",2,39,1185,581,604
050,18,035,"Indiana","Delaware County",2,40,1209,605,604
050,18,035,"Indiana","Delaware County",2,41,1189,591,598
050,18,035,"Indiana","Delaware County",2,42,1137,551,586
050,18,035,"Indiana","Delaware County",2,43,1075,531,544
050,18,035,"Indiana","Delaware County",2,44,1090,542,548
050,18,035,"Indiana","Delaware County",2,45,1171,581,590
050,18,035,"Indiana","Delaware County",2,46,1124,550,574
050,18,035,"Indiana","Delaware County",2,47,1148,572,576
050,18,035,"Indiana","Delaware County",2,48,1272,646,626
050,18,035,"Indiana","Delaware County",2,49,1351,684,667
050,18,035,"Indiana","Delaware County",2,50,1339,671,668
050,18,035,"Indiana","Delaware County",2,51,1251,612,639
050,18,035,"Indiana","Delaware County",2,52,1241,611,630
050,18,035,"Indiana","Delaware County",2,53,1276,629,647
050,18,035,"Indiana","Delaware County",2,54,1277,635,642
050,18,035,"Indiana","Delaware County",2,55,1376,675,701
050,18,035,"Indiana","Delaware County",2,56,1376,665,711
050,18,035,"Indiana","Delaware County",2,57,1345,657,688
050,18,035,"Indiana","Delaware County",2,58,1392,687,705
050,18,035,"Indiana","Delaware County",2,59,1410,696,714
050,18,035,"Indiana","Delaware County",2,60,1407,700,707
050,18,035,"Indiana","Delaware County",2,61,1370,668,702
050,18,035,"Indiana","Delaware County",2,62,1406,680,726
050,18,035,"Indiana","Delaware County",2,63,1388,670,718
050,18,035,"Indiana","Delaware County",2,64,1297,606,691
050,18,035,"Indiana","Delaware County",2,65,1308,609,699
050,18,035,"Indiana","Delaware County",2,66,1229,568,661
050,18,035,"Indiana","Delaware County",2,67,1165,529,636
050,18,035,"Indiana","Delaware County",2,68,1141,509,632
050,18,035,"Indiana","Delaware County",2,69,1084,507,577
050,18,035,"Indiana","Delaware County",2,70,1061,497,564
050,18,035,"Indiana","Delaware County",2,71,1069,490,579
050,18,035,"Indiana","Delaware County",2,72,1055,469,586
050,18,035,"Indiana","Delaware County",2,73,1089,481,608
050,18,035,"Indiana","Delaware County",2,74,753,320,433
050,18,035,"Indiana","Delaware County",2,75,780,347,433
050,18,035,"Indiana","Delaware County",2,76,776,351,425
050,18,035,"Indiana","Delaware County",2,77,795,349,446
050,18,035,"Indiana","Delaware County",2,78,651,283,368
050,18,035,"Indiana","Delaware County",2,79,632,277,355
050,18,035,"Indiana","Delaware County",2,80,561,242,319
050,18,035,"Indiana","Delaware County",2,81,520,233,287
050,18,035,"Indiana","Delaware County",2,82,478,216,262
050,18,035,"Indiana","Delaware County",2,83,418,177,241
050,18,035,"Indiana","Delaware County",2,84,395,171,224
050,18,035,"Indiana","Delaware County",2,85,2292,818,1474
050,18,035,"Indiana","Delaware County",3,0,1035,547,488
050,18,035,"Indiana","Delaware County",3,1,1037,527,510
050,18,035,"Indiana","Delaware County",3,2,1029,544,485
050,18,035,"Indiana","Delaware County",3,3,1085,567,518
050,18,035,"Indiana","Delaware County",3,4,1096,558,538
050,18,035,"Indiana","Delaware County",3,5,1094,550,544
050,18,035,"Indiana","Delaware County",3,6,1124,580,544
050,18,035,"Indiana","Delaware County",3,7,1123,556,567
050,18,035,"Indiana","Delaware County",3,8,1204,615,589
050,18,035,"Indiana","Delaware County",3,9,1132,597,535
050,18,035,"Indiana","Delaware County",3,10,1131,595,536
050,18,035,"Indiana","Delaware County",3,11,1125,582,543
050,18,035,"Indiana","Delaware County",3,12,1158,583,575
050,18,035,"Indiana","Delaware County",3,13,1216,604,612
050,18,035,"Indiana","Delaware County",3,14,1183,592,591
050,18,035,"Indiana","Delaware County",3,15,1173,592,581
050,18,035,"Indiana","Delaware County",3,16,1201,616,585
050,18,035,"Indiana","Delaware County",3,17,1318,680,638
050,18,035,"Indiana","Delaware County",3,18,1828,818,1010
050,18,035,"Indiana","Delaware County",3,19,4053,1841,2212
050,18,035,"Indiana","Delaware County",3,20,4067,1843,2224
050,18,035,"Indiana","Delaware County",3,21,3657,1571,2086
050,18,035,"Indiana","Delaware County",3,22,3369,1671,1698
050,18,035,"Indiana","Delaware County",3,23,2631,1407,1224
050,18,035,"Indiana","Delaware County",3,24,1751,889,862
050,18,035,"Indiana","Delaware County",3,25,1557,772,785
050,18,035,"Indiana","Delaware County",3,26,1412,706,706
050,18,035,"Indiana","Delaware County",3,27,1369,690,679
050,18,035,"Indiana","Delaware County",3,28,1331,655,676
050,18,035,"Indiana","Delaware County",3,29,1382,691,691
050,18,035,"Indiana","Delaware County",3,30,1267,633,634
050,18,035,"Indiana","Delaware County",3,31,1272,647,625
050,18,035,"Indiana","Delaware County",3,32,1240,627,613
050,18,035,"Indiana","Delaware County",3,33,1199,605,594
050,18,035,"Indiana","Delaware County",3,34,1163,571,592
050,18,035,"Indiana","Delaware County",3,35,1172,593,579
050,18,035,"Indiana","Delaware County",3,36,1175,591,584
050,18,035,"Indiana","Delaware County",3,37,1145,576,569
050,18,035,"Indiana","Delaware County",3,38,1173,573,600
050,18,035,"Indiana","Delaware County",3,39,1166,559,607
050,18,035,"Indiana","Delaware County",3,40,1182,579,603
050,18,035,"Indiana","Delaware County",3,41,1195,596,599
050,18,035,"Indiana","Delaware County",3,42,1199,601,598
050,18,035,"Indiana","Delaware County",3,43,1160,566,594
050,18,035,"Indiana","Delaware County",3,44,1097,539,558
050,18,035,"Indiana","Delaware County",3,45,1116,560,556
050,18,035,"Indiana","Delaware County",3,46,1171,572,599
050,18,035,"Indiana","Delaware County",3,47,1133,548,585
050,18,035,"Indiana","Delaware County",3,48,1164,567,597
050,18,035,"Indiana","Delaware County",3,49,1261,644,617
050,18,035,"Indiana","Delaware County",3,50,1372,695,677
050,18,035,"Indiana","Delaware County",3,51,1351,676,675
050,18,035,"Indiana","Delaware County",3,52,1252,611,641
050,18,035,"Indiana","Delaware County",3,53,1255,614,641
050,18,035,"Indiana","Delaware County",3,54,1252,622,630
050,18,035,"Indiana","Delaware County",3,55,1287,638,649
050,18,035,"Indiana","Delaware County",3,56,1357,665,692
050,18,035,"Indiana","Delaware County",3,57,1355,657,698
050,18,035,"Indiana","Delaware County",3,58,1336,649,687
050,18,035,"Indiana","Delaware County",3,59,1355,676,679
050,18,035,"Indiana","Delaware County",3,60,1396,694,702
050,18,035,"Indiana","Delaware County",3,61,1391,691,700
050,18,035,"Indiana","Delaware County",3,62,1361,669,692
050,18,035,"Indiana","Delaware County",3,63,1392,657,735
050,18,035,"Indiana","Delaware County",3,64,1358,659,699
050,18,035,"Indiana","Delaware County",3,65,1283,592,691
050,18,035,"Indiana","Delaware County",3,66,1279,593,686
050,18,035,"Indiana","Delaware County",3,67,1218,566,652
050,18,035,"Indiana","Delaware County",3,68,1164,522,642
050,18,035,"Indiana","Delaware County",3,69,1111,496,615
050,18,035,"Indiana","Delaware County",3,70,1078,504,574
050,18,035,"Indiana","Delaware County",3,71,1020,486,534
050,18,035,"Indiana","Delaware County",3,72,1028,472,556
050,18,035,"Indiana","Delaware County",3,73,1007,442,565
050,18,035,"Indiana","Delaware County",3,74,1041,446,595
050,18,035,"Indiana","Delaware County",3,75,721,300,421
050,18,035,"Indiana","Delaware County",3,76,735,331,404
050,18,035,"Indiana","Delaware County",3,77,748,328,420
050,18,035,"Indiana","Delaware County",3,78,722,321,401
050,18,035,"Indiana","Delaware County",3,79,628,274,354
050,18,035,"Indiana","Delaware County",3,80,596,260,336
050,18,035,"Indiana","Delaware County",3,81,512,225,287
050,18,035,"Indiana","Delaware County",3,82,460,203,257
050,18,035,"Indiana","Delaware County",3,83,459,196,263
050,18,035,"Indiana","Delaware County",3,84,380,155,225
050,18,035,"Indiana","Delaware County",3,85,2276,818,1458
050,18,035,"Indiana","Delaware County",4,0,1102,565,537
050,18,035,"Indiana","Delaware County",4,1,1033,552,481
050,18,035,"Indiana","Delaware County",4,2,1052,527,525
050,18,035,"Indiana","Delaware County",4,3,1021,530,491
050,18,035,"Indiana","Delaware County",4,4,1074,564,510
050,18,035,"Indiana","Delaware County",4,5,1096,546,550
050,18,035,"Indiana","Delaware County",4,6,1099,548,551
050,18,035,"Indiana","Delaware County",4,7,1144,585,559
050,18,035,"Indiana","Delaware County",4,8,1139,580,559
050,18,035,"Indiana","Delaware County",4,9,1182,603,579
050,18,035,"Indiana","Delaware County",4,10,1117,583,534
050,18,035,"Indiana","Delaware County",4,11,1127,600,527
050,18,035,"Indiana","Delaware County",4,12,1110,581,529
050,18,035,"Indiana","Delaware County",4,13,1155,579,576
050,18,035,"Indiana","Delaware County",4,14,1243,633,610
050,18,035,"Indiana","Delaware County",4,15,1183,577,606
050,18,035,"Indiana","Delaware County",4,16,1207,611,596
050,18,035,"Indiana","Delaware County",4,17,1314,653,661
050,18,035,"Indiana","Delaware County",4,18,1836,831,1005
050,18,035,"Indiana","Delaware County",4,19,4048,1837,2211
050,18,035,"Indiana","Delaware County",4,20,3991,1810,2181
050,18,035,"Indiana","Delaware County",4,21,3737,1606,2131
050,18,035,"Indiana","Delaware County",4,22,3392,1655,1737
050,18,035,"Indiana","Delaware County",4,23,2606,1395,1211
050,18,035,"Indiana","Delaware County",4,24,1799,899,900
050,18,035,"Indiana","Delaware County",4,25,1588,810,778
050,18,035,"Indiana","Delaware County",4,26,1410,698,712
050,18,035,"Indiana","Delaware County",4,27,1294,659,635
050,18,035,"Indiana","Delaware County",4,28,1308,662,646
050,18,035,"Indiana","Delaware County",4,29,1335,663,672
050,18,035,"Indiana","Delaware County",4,30,1379,685,694
050,18,035,"Indiana","Delaware County",4,31,1268,636,632
050,18,035,"Indiana","Delaware County",4,32,1308,677,631
050,18,035,"Indiana","Delaware County",4,33,1225,618,607
050,18,035,"Indiana","Delaware County",4,34,1231,628,603
050,18,035,"Indiana","Delaware County",4,35,1150,559,591
050,18,035,"Indiana","Delaware County",4,36,1186,597,589
050,18,035,"Indiana","Delaware County",4,37,1170,589,581
050,18,035,"Indiana","Delaware County",4,38,1158,577,581
050,18,035,"Indiana","Delaware County",4,39,1177,574,603
050,18,035,"Indiana","Delaware County",4,40,1183,554,629
050,18,035,"Indiana","Delaware County",4,41,1193,602,591
050,18,035,"Indiana","Delaware County",4,42,1192,597,595
050,18,035,"Indiana","Delaware County",4,43,1243,617,626
050,18,035,"Indiana","Delaware County",4,44,1167,568,599
050,18,035,"Indiana","Delaware County",4,45,1085,537,548
050,18,035,"Indiana","Delaware County",4,46,1106,560,546
050,18,035,"Indiana","Delaware County",4,47,1171,563,608
050,18,035,"Indiana","Delaware County",4,48,1136,540,596
050,18,035,"Indiana","Delaware County",4,49,1143,557,586
050,18,035,"Indiana","Delaware County",4,50,1259,645,614
050,18,035,"Indiana","Delaware County",4,51,1358,687,671
050,18,035,"Indiana","Delaware County",4,52,1349,673,676
050,18,035,"Indiana","Delaware County",4,53,1244,599,645
050,18,035,"Indiana","Delaware County",4,54,1249,610,639
050,18,035,"Indiana","Delaware County",4,55,1242,628,614
050,18,035,"Indiana","Delaware County",4,56,1290,635,655
050,18,035,"Indiana","Delaware County",4,57,1366,664,702
050,18,035,"Indiana","Delaware County",4,58,1349,649,700
050,18,035,"Indiana","Delaware County",4,59,1322,636,686
050,18,035,"Indiana","Delaware County",4,60,1323,665,658
050,18,035,"Indiana","Delaware County",4,61,1383,686,697
050,18,035,"Indiana","Delaware County",4,62,1384,689,695
050,18,035,"Indiana","Delaware County",4,63,1341,664,677
050,18,035,"Indiana","Delaware County",4,64,1370,650,720
050,18,035,"Indiana","Delaware County",4,65,1337,643,694
050,18,035,"Indiana","Delaware County",4,66,1234,564,670
050,18,035,"Indiana","Delaware County",4,67,1257,594,663
050,18,035,"Indiana","Delaware County",4,68,1202,554,648
050,18,035,"Indiana","Delaware County",4,69,1125,502,623
050,18,035,"Indiana","Delaware County",4,70,1092,487,605
050,18,035,"Indiana","Delaware County",4,71,1026,481,545
050,18,035,"Indiana","Delaware County",4,72,984,472,512
050,18,035,"Indiana","Delaware County",4,73,1001,454,547
050,18,035,"Indiana","Delaware County",4,74,956,406,550
050,18,035,"Indiana","Delaware County",4,75,985,418,567
050,18,035,"Indiana","Delaware County",4,76,695,286,409
050,18,035,"Indiana","Delaware County",4,77,718,317,401
050,18,035,"Indiana","Delaware County",4,78,687,309,378
050,18,035,"Indiana","Delaware County",4,79,696,311,385
050,18,035,"Indiana","Delaware County",4,80,591,252,339
050,18,035,"Indiana","Delaware County",4,81,546,242,304
050,18,035,"Indiana","Delaware County",4,82,471,206,265
050,18,035,"Indiana","Delaware County",4,83,438,181,257
050,18,035,"Indiana","Delaware County",4,84,417,180,237
050,18,035,"Indiana","Delaware County",4,85,2263,818,1445
050,18,035,"Indiana","Delaware County",5,0,1095,568,527
050,18,035,"Indiana","Delaware County",5,1,1134,597,537
050,18,035,"Indiana","Delaware County",5,2,1017,533,484
050,18,035,"Indiana","Delaware County",5,3,1062,528,534
050,18,035,"Indiana","Delaware County",5,4,1024,535,489
050,18,035,"Indiana","Delaware County",5,5,1084,559,525
050,18,035,"Indiana","Delaware County",5,6,1116,552,564
050,18,035,"Indiana","Delaware County",5,7,1121,565,556
050,18,035,"Indiana","Delaware County",5,8,1149,583,566
050,18,035,"Indiana","Delaware County",5,9,1126,570,556
050,18,035,"Indiana","Delaware County",5,10,1174,595,579
050,18,035,"Indiana","Delaware County",5,11,1115,578,537
050,18,035,"Indiana","Delaware County",5,12,1137,605,532
050,18,035,"Indiana","Delaware County",5,13,1121,592,529
050,18,035,"Indiana","Delaware County",5,14,1160,588,572
050,18,035,"Indiana","Delaware County",5,15,1235,627,608
050,18,035,"Indiana","Delaware County",5,16,1203,595,608
050,18,035,"Indiana","Delaware County",5,17,1292,641,651
050,18,035,"Indiana","Delaware County",5,18,1800,807,993
050,18,035,"Indiana","Delaware County",5,19,4072,1854,2218
050,18,035,"Indiana","Delaware County",5,20,3954,1792,2162
050,18,035,"Indiana","Delaware County",5,21,3570,1550,2020
050,18,035,"Indiana","Delaware County",5,22,3415,1653,1762
050,18,035,"Indiana","Delaware County",5,23,2693,1424,1269
050,18,035,"Indiana","Delaware County",5,24,1786,893,893
050,18,035,"Indiana","Delaware County",5,25,1600,805,795
050,18,035,"Indiana","Delaware County",5,26,1481,740,741
050,18,035,"Indiana","Delaware County",5,27,1315,649,666
050,18,035,"Indiana","Delaware County",5,28,1299,656,643
050,18,035,"Indiana","Delaware County",5,29,1304,664,640
050,18,035,"Indiana","Delaware County",5,30,1306,636,670
050,18,035,"Indiana","Delaware County",5,31,1336,671,665
050,18,035,"Indiana","Delaware County",5,32,1290,651,639
050,18,035,"Indiana","Delaware County",5,33,1331,700,631
050,18,035,"Indiana","Delaware County",5,34,1218,608,610
050,18,035,"Indiana","Delaware County",5,35,1218,610,608
050,18,035,"Indiana","Delaware County",5,36,1155,552,603
050,18,035,"Indiana","Delaware County",5,37,1192,608,584
050,18,035,"Indiana","Delaware County",5,38,1181,590,591
050,18,035,"Indiana","Delaware County",5,39,1176,587,589
050,18,035,"Indiana","Delaware County",5,40,1187,576,611
050,18,035,"Indiana","Delaware County",5,41,1181,558,623
050,18,035,"Indiana","Delaware County",5,42,1188,602,586
050,18,035,"Indiana","Delaware County",5,43,1181,588,593
050,18,035,"Indiana","Delaware County",5,44,1234,604,630
050,18,035,"Indiana","Delaware County",5,45,1196,582,614
050,18,035,"Indiana","Delaware County",5,46,1083,542,541
050,18,035,"Indiana","Delaware County",5,47,1109,565,544
050,18,035,"Indiana","Delaware County",5,48,1176,558,618
050,18,035,"Indiana","Delaware County",5,49,1116,537,579
050,18,035,"Indiana","Delaware County",5,50,1170,579,591
050,18,035,"Indiana","Delaware County",5,51,1255,632,623
050,18,035,"Indiana","Delaware County",5,52,1365,685,680
050,18,035,"Indiana","Delaware County",5,53,1336,657,679
050,18,035,"Indiana","Delaware County",5,54,1252,610,642
050,18,035,"Indiana","Delaware County",5,55,1258,613,645
050,18,035,"Indiana","Delaware County",5,56,1248,628,620
050,18,035,"Indiana","Delaware County",5,57,1286,625,661
050,18,035,"Indiana","Delaware County",5,58,1330,645,685
050,18,035,"Indiana","Delaware County",5,59,1330,632,698
050,18,035,"Indiana","Delaware County",5,60,1317,635,682
050,18,035,"Indiana","Delaware County",5,61,1325,665,660
050,18,035,"Indiana","Delaware County",5,62,1367,677,690
050,18,035,"Indiana","Delaware County",5,63,1370,675,695
050,18,035,"Indiana","Delaware County",5,64,1321,663,658
050,18,035,"Indiana","Delaware County",5,65,1358,637,721
050,18,035,"Indiana","Delaware County",5,66,1292,615,677
050,18,035,"Indiana","Delaware County",5,67,1223,557,666
050,18,035,"Indiana","Delaware County",5,68,1239,577,662
050,18,035,"Indiana","Delaware County",5,69,1174,539,635
050,18,035,"Indiana","Delaware County",5,70,1109,490,619
050,18,035,"Indiana","Delaware County",5,71,1042,470,572
050,18,035,"Indiana","Delaware County",5,72,989,467,522
050,18,035,"Indiana","Delaware County",5,73,967,462,505
050,18,035,"Indiana","Delaware County",5,74,970,427,543
050,18,035,"Indiana","Delaware County",5,75,910,377,533
050,18,035,"Indiana","Delaware County",5,76,941,401,540
050,18,035,"Indiana","Delaware County",5,77,678,272,406
050,18,035,"Indiana","Delaware County",5,78,656,297,359
050,18,035,"Indiana","Delaware County",5,79,678,307,371
050,18,035,"Indiana","Delaware County",5,80,667,296,371
050,18,035,"Indiana","Delaware County",5,81,545,237,308
050,18,035,"Indiana","Delaware County",5,82,498,225,273
050,18,035,"Indiana","Delaware County",5,83,446,179,267
050,18,035,"Indiana","Delaware County",5,84,403,166,237
050,18,035,"Indiana","Delaware County",5,85,2298,837,1461
050,18,037,"Indiana","Dubois County",1,0,518,265,253
050,18,037,"Indiana","Dubois County",1,1,552,268,284
050,18,037,"Indiana","Dubois County",1,2,553,277,276
050,18,037,"Indiana","Dubois County",1,3,586,291,295
050,18,037,"Indiana","Dubois County",1,4,609,320,289
050,18,037,"Indiana","Dubois County",1,5,620,318,302
050,18,037,"Indiana","Dubois County",1,6,571,314,257
050,18,037,"Indiana","Dubois County",1,7,586,305,281
050,18,037,"Indiana","Dubois County",1,8,581,303,278
050,18,037,"Indiana","Dubois County",1,9,568,296,272
050,18,037,"Indiana","Dubois County",1,10,603,299,304
050,18,037,"Indiana","Dubois County",1,11,637,324,313
050,18,037,"Indiana","Dubois County",1,12,651,340,311
050,18,037,"Indiana","Dubois County",1,13,659,355,304
050,18,037,"Indiana","Dubois County",1,14,623,323,300
050,18,037,"Indiana","Dubois County",1,15,600,327,273
050,18,037,"Indiana","Dubois County",1,16,636,333,303
050,18,037,"Indiana","Dubois County",1,17,637,332,305
050,18,037,"Indiana","Dubois County",1,18,546,292,254
050,18,037,"Indiana","Dubois County",1,19,451,236,215
050,18,037,"Indiana","Dubois County",1,20,457,238,219
050,18,037,"Indiana","Dubois County",1,21,455,226,229
050,18,037,"Indiana","Dubois County",1,22,506,238,268
050,18,037,"Indiana","Dubois County",1,23,512,266,246
050,18,037,"Indiana","Dubois County",1,24,517,258,259
050,18,037,"Indiana","Dubois County",1,25,491,254,237
050,18,037,"Indiana","Dubois County",1,26,490,244,246
050,18,037,"Indiana","Dubois County",1,27,528,273,255
050,18,037,"Indiana","Dubois County",1,28,490,243,247
050,18,037,"Indiana","Dubois County",1,29,472,246,226
050,18,037,"Indiana","Dubois County",1,30,435,223,212
050,18,037,"Indiana","Dubois County",1,31,436,214,222
050,18,037,"Indiana","Dubois County",1,32,492,254,238
050,18,037,"Indiana","Dubois County",1,33,451,236,215
050,18,037,"Indiana","Dubois County",1,34,491,271,220
050,18,037,"Indiana","Dubois County",1,35,527,276,251
050,18,037,"Indiana","Dubois County",1,36,519,279,240
050,18,037,"Indiana","Dubois County",1,37,515,285,230
050,18,037,"Indiana","Dubois County",1,38,519,270,249
050,18,037,"Indiana","Dubois County",1,39,522,266,256
050,18,037,"Indiana","Dubois County",1,40,520,277,243
050,18,037,"Indiana","Dubois County",1,41,519,263,256
050,18,037,"Indiana","Dubois County",1,42,516,275,241
050,18,037,"Indiana","Dubois County",1,43,508,275,233
050,18,037,"Indiana","Dubois County",1,44,491,252,239
050,18,037,"Indiana","Dubois County",1,45,497,259,238
050,18,037,"Indiana","Dubois County",1,46,477,250,227
050,18,037,"Indiana","Dubois County",1,47,458,236,222
050,18,037,"Indiana","Dubois County",1,48,516,260,256
050,18,037,"Indiana","Dubois County",1,49,577,300,277
050,18,037,"Indiana","Dubois County",1,50,534,289,245
050,18,037,"Indiana","Dubois County",1,51,528,268,260
050,18,037,"Indiana","Dubois County",1,52,547,290,257
050,18,037,"Indiana","Dubois County",1,53,597,312,285
050,18,037,"Indiana","Dubois County",1,54,607,295,312
050,18,037,"Indiana","Dubois County",1,55,637,332,305
050,18,037,"Indiana","Dubois County",1,56,665,362,303
050,18,037,"Indiana","Dubois County",1,57,674,350,324
050,18,037,"Indiana","Dubois County",1,58,692,357,335
050,18,037,"Indiana","Dubois County",1,59,660,325,335
050,18,037,"Indiana","Dubois County",1,60,666,330,336
050,18,037,"Indiana","Dubois County",1,61,629,313,316
050,18,037,"Indiana","Dubois County",1,62,615,306,309
050,18,037,"Indiana","Dubois County",1,63,621,322,299
050,18,037,"Indiana","Dubois County",1,64,615,317,298
050,18,037,"Indiana","Dubois County",1,65,566,289,277
050,18,037,"Indiana","Dubois County",1,66,519,250,269
050,18,037,"Indiana","Dubois County",1,67,515,258,257
050,18,037,"Indiana","Dubois County",1,68,511,267,244
050,18,037,"Indiana","Dubois County",1,69,422,207,215
050,18,037,"Indiana","Dubois County",1,70,440,218,222
050,18,037,"Indiana","Dubois County",1,71,436,209,227
050,18,037,"Indiana","Dubois County",1,72,406,182,224
050,18,037,"Indiana","Dubois County",1,73,416,194,222
050,18,037,"Indiana","Dubois County",1,74,273,130,143
050,18,037,"Indiana","Dubois County",1,75,263,129,134
050,18,037,"Indiana","Dubois County",1,76,274,118,156
050,18,037,"Indiana","Dubois County",1,77,275,123,152
050,18,037,"Indiana","Dubois County",1,78,237,105,132
050,18,037,"Indiana","Dubois County",1,79,241,91,150
050,18,037,"Indiana","Dubois County",1,80,217,87,130
050,18,037,"Indiana","Dubois County",1,81,201,80,121
050,18,037,"Indiana","Dubois County",1,82,193,80,113
050,18,037,"Indiana","Dubois County",1,83,154,68,86
050,18,037,"Indiana","Dubois County",1,84,172,69,103
050,18,037,"Indiana","Dubois County",1,85,922,292,630
050,18,037,"Indiana","Dubois County",2,0,525,267,258
050,18,037,"Indiana","Dubois County",2,1,543,268,275
050,18,037,"Indiana","Dubois County",2,2,551,274,277
050,18,037,"Indiana","Dubois County",2,3,575,287,288
050,18,037,"Indiana","Dubois County",2,4,605,314,291
050,18,037,"Indiana","Dubois County",2,5,617,320,297
050,18,037,"Indiana","Dubois County",2,6,582,315,267
050,18,037,"Indiana","Dubois County",2,7,581,307,274
050,18,037,"Indiana","Dubois County",2,8,581,303,278
050,18,037,"Indiana","Dubois County",2,9,573,300,273
050,18,037,"Indiana","Dubois County",2,10,598,299,299
050,18,037,"Indiana","Dubois County",2,11,631,319,312
050,18,037,"Indiana","Dubois County",2,12,650,338,312
050,18,037,"Indiana","Dubois County",2,13,653,348,305
050,18,037,"Indiana","Dubois County",2,14,630,329,301
050,18,037,"Indiana","Dubois County",2,15,608,326,282
050,18,037,"Indiana","Dubois County",2,16,626,331,295
050,18,037,"Indiana","Dubois County",2,17,640,332,308
050,18,037,"Indiana","Dubois County",2,18,542,290,252
050,18,037,"Indiana","Dubois County",2,19,453,236,217
050,18,037,"Indiana","Dubois County",2,20,464,241,223
050,18,037,"Indiana","Dubois County",2,21,462,231,231
050,18,037,"Indiana","Dubois County",2,22,498,236,262
050,18,037,"Indiana","Dubois County",2,23,514,259,255
050,18,037,"Indiana","Dubois County",2,24,509,258,251
050,18,037,"Indiana","Dubois County",2,25,497,256,241
050,18,037,"Indiana","Dubois County",2,26,495,250,245
050,18,037,"Indiana","Dubois County",2,27,514,262,252
050,18,037,"Indiana","Dubois County",2,28,499,251,248
050,18,037,"Indiana","Dubois County",2,29,477,246,231
050,18,037,"Indiana","Dubois County",2,30,444,227,217
050,18,037,"Indiana","Dubois County",2,31,434,215,219
050,18,037,"Indiana","Dubois County",2,32,476,243,233
050,18,037,"Indiana","Dubois County",2,33,460,240,220
050,18,037,"Indiana","Dubois County",2,34,481,263,218
050,18,037,"Indiana","Dubois County",2,35,527,280,247
050,18,037,"Indiana","Dubois County",2,36,520,279,241
050,18,037,"Indiana","Dubois County",2,37,518,285,233
050,18,037,"Indiana","Dubois County",2,38,523,277,246
050,18,037,"Indiana","Dubois County",2,39,520,267,253
050,18,037,"Indiana","Dubois County",2,40,526,277,249
050,18,037,"Indiana","Dubois County",2,41,514,261,253
050,18,037,"Indiana","Dubois County",2,42,512,269,243
050,18,037,"Indiana","Dubois County",2,43,512,277,235
050,18,037,"Indiana","Dubois County",2,44,489,255,234
050,18,037,"Indiana","Dubois County",2,45,498,258,240
050,18,037,"Indiana","Dubois County",2,46,478,250,228
050,18,037,"Indiana","Dubois County",2,47,462,239,223
050,18,037,"Indiana","Dubois County",2,48,504,254,250
050,18,037,"Indiana","Dubois County",2,49,564,292,272
050,18,037,"Indiana","Dubois County",2,50,544,292,252
050,18,037,"Indiana","Dubois County",2,51,526,270,256
050,18,037,"Indiana","Dubois County",2,52,543,286,257
050,18,037,"Indiana","Dubois County",2,53,582,304,278
050,18,037,"Indiana","Dubois County",2,54,601,298,303
050,18,037,"Indiana","Dubois County",2,55,629,323,306
050,18,037,"Indiana","Dubois County",2,56,660,355,305
050,18,037,"Indiana","Dubois County",2,57,668,351,317
050,18,037,"Indiana","Dubois County",2,58,686,355,331
050,18,037,"Indiana","Dubois County",2,59,668,331,337
050,18,037,"Indiana","Dubois County",2,60,661,328,333
050,18,037,"Indiana","Dubois County",2,61,636,316,320
050,18,037,"Indiana","Dubois County",2,62,619,309,310
050,18,037,"Indiana","Dubois County",2,63,624,320,304
050,18,037,"Indiana","Dubois County",2,64,612,315,297
050,18,037,"Indiana","Dubois County",2,65,575,295,280
050,18,037,"Indiana","Dubois County",2,66,525,253,272
050,18,037,"Indiana","Dubois County",2,67,511,254,257
050,18,037,"Indiana","Dubois County",2,68,509,263,246
050,18,037,"Indiana","Dubois County",2,69,448,224,224
050,18,037,"Indiana","Dubois County",2,70,433,214,219
050,18,037,"Indiana","Dubois County",2,71,435,210,225
050,18,037,"Indiana","Dubois County",2,72,407,186,221
050,18,037,"Indiana","Dubois County",2,73,434,199,235
050,18,037,"Indiana","Dubois County",2,74,288,136,152
050,18,037,"Indiana","Dubois County",2,75,263,128,135
050,18,037,"Indiana","Dubois County",2,76,265,115,150
050,18,037,"Indiana","Dubois County",2,77,278,124,154
050,18,037,"Indiana","Dubois County",2,78,238,106,132
050,18,037,"Indiana","Dubois County",2,79,237,91,146
050,18,037,"Indiana","Dubois County",2,80,220,87,133
050,18,037,"Indiana","Dubois County",2,81,204,82,122
050,18,037,"Indiana","Dubois County",2,82,195,80,115
050,18,037,"Indiana","Dubois County",2,83,160,71,89
050,18,037,"Indiana","Dubois County",2,84,166,66,100
050,18,037,"Indiana","Dubois County",2,85,937,301,636
050,18,037,"Indiana","Dubois County",3,0,479,249,230
050,18,037,"Indiana","Dubois County",3,1,537,280,257
050,18,037,"Indiana","Dubois County",3,2,558,276,282
050,18,037,"Indiana","Dubois County",3,3,558,276,282
050,18,037,"Indiana","Dubois County",3,4,581,294,287
050,18,037,"Indiana","Dubois County",3,5,598,309,289
050,18,037,"Indiana","Dubois County",3,6,622,333,289
050,18,037,"Indiana","Dubois County",3,7,593,315,278
050,18,037,"Indiana","Dubois County",3,8,600,323,277
050,18,037,"Indiana","Dubois County",3,9,585,300,285
050,18,037,"Indiana","Dubois County",3,10,584,305,279
050,18,037,"Indiana","Dubois County",3,11,586,284,302
050,18,037,"Indiana","Dubois County",3,12,642,333,309
050,18,037,"Indiana","Dubois County",3,13,642,335,307
050,18,037,"Indiana","Dubois County",3,14,651,348,303
050,18,037,"Indiana","Dubois County",3,15,626,326,300
050,18,037,"Indiana","Dubois County",3,16,621,334,287
050,18,037,"Indiana","Dubois County",3,17,619,324,295
050,18,037,"Indiana","Dubois County",3,18,539,294,245
050,18,037,"Indiana","Dubois County",3,19,435,231,204
050,18,037,"Indiana","Dubois County",3,20,483,249,234
050,18,037,"Indiana","Dubois County",3,21,486,246,240
050,18,037,"Indiana","Dubois County",3,22,496,238,258
050,18,037,"Indiana","Dubois County",3,23,510,240,270
050,18,037,"Indiana","Dubois County",3,24,507,257,250
050,18,037,"Indiana","Dubois County",3,25,494,257,237
050,18,037,"Indiana","Dubois County",3,26,493,242,251
050,18,037,"Indiana","Dubois County",3,27,475,246,229
050,18,037,"Indiana","Dubois County",3,28,509,259,250
050,18,037,"Indiana","Dubois County",3,29,498,246,252
050,18,037,"Indiana","Dubois County",3,30,472,242,230
050,18,037,"Indiana","Dubois County",3,31,460,245,215
050,18,037,"Indiana","Dubois County",3,32,445,225,220
050,18,037,"Indiana","Dubois County",3,33,497,249,248
050,18,037,"Indiana","Dubois County",3,34,465,235,230
050,18,037,"Indiana","Dubois County",3,35,492,262,230
050,18,037,"Indiana","Dubois County",3,36,532,285,247
050,18,037,"Indiana","Dubois County",3,37,518,279,239
050,18,037,"Indiana","Dubois County",3,38,519,286,233
050,18,037,"Indiana","Dubois County",3,39,513,269,244
050,18,037,"Indiana","Dubois County",3,40,518,260,258
050,18,037,"Indiana","Dubois County",3,41,519,278,241
050,18,037,"Indiana","Dubois County",3,42,516,263,253
050,18,037,"Indiana","Dubois County",3,43,509,263,246
050,18,037,"Indiana","Dubois County",3,44,508,277,231
050,18,037,"Indiana","Dubois County",3,45,484,255,229
050,18,037,"Indiana","Dubois County",3,46,495,261,234
050,18,037,"Indiana","Dubois County",3,47,474,250,224
050,18,037,"Indiana","Dubois County",3,48,458,234,224
050,18,037,"Indiana","Dubois County",3,49,513,260,253
050,18,037,"Indiana","Dubois County",3,50,564,293,271
050,18,037,"Indiana","Dubois County",3,51,535,282,253
050,18,037,"Indiana","Dubois County",3,52,523,267,256
050,18,037,"Indiana","Dubois County",3,53,541,281,260
050,18,037,"Indiana","Dubois County",3,54,569,292,277
050,18,037,"Indiana","Dubois County",3,55,608,303,305
050,18,037,"Indiana","Dubois County",3,56,623,323,300
050,18,037,"Indiana","Dubois County",3,57,652,351,301
050,18,037,"Indiana","Dubois County",3,58,656,347,309
050,18,037,"Indiana","Dubois County",3,59,687,353,334
050,18,037,"Indiana","Dubois County",3,60,659,325,334
050,18,037,"Indiana","Dubois County",3,61,662,327,335
050,18,037,"Indiana","Dubois County",3,62,636,323,313
050,18,037,"Indiana","Dubois County",3,63,612,299,313
050,18,037,"Indiana","Dubois County",3,64,618,317,301
050,18,037,"Indiana","Dubois County",3,65,601,309,292
050,18,037,"Indiana","Dubois County",3,66,549,279,270
050,18,037,"Indiana","Dubois County",3,67,519,250,269
050,18,037,"Indiana","Dubois County",3,68,505,245,260
050,18,037,"Indiana","Dubois County",3,69,496,255,241
050,18,037,"Indiana","Dubois County",3,70,439,220,219
050,18,037,"Indiana","Dubois County",3,71,411,204,207
050,18,037,"Indiana","Dubois County",3,72,430,203,227
050,18,037,"Indiana","Dubois County",3,73,394,178,216
050,18,037,"Indiana","Dubois County",3,74,423,199,224
050,18,037,"Indiana","Dubois County",3,75,276,130,146
050,18,037,"Indiana","Dubois County",3,76,258,124,134
050,18,037,"Indiana","Dubois County",3,77,254,112,142
050,18,037,"Indiana","Dubois County",3,78,256,109,147
050,18,037,"Indiana","Dubois County",3,79,238,100,138
050,18,037,"Indiana","Dubois County",3,80,224,90,134
050,18,037,"Indiana","Dubois County",3,81,198,75,123
050,18,037,"Indiana","Dubois County",3,82,197,80,117
050,18,037,"Indiana","Dubois County",3,83,167,71,96
050,18,037,"Indiana","Dubois County",3,84,153,60,93
050,18,037,"Indiana","Dubois County",3,85,918,287,631
050,18,037,"Indiana","Dubois County",4,0,498,255,243
050,18,037,"Indiana","Dubois County",4,1,492,252,240
050,18,037,"Indiana","Dubois County",4,2,539,279,260
050,18,037,"Indiana","Dubois County",4,3,566,284,282
050,18,037,"Indiana","Dubois County",4,4,561,279,282
050,18,037,"Indiana","Dubois County",4,5,599,305,294
050,18,037,"Indiana","Dubois County",4,6,597,310,287
050,18,037,"Indiana","Dubois County",4,7,624,326,298
050,18,037,"Indiana","Dubois County",4,8,603,324,279
050,18,037,"Indiana","Dubois County",4,9,582,319,263
050,18,037,"Indiana","Dubois County",4,10,580,298,282
050,18,037,"Indiana","Dubois County",4,11,578,301,277
050,18,037,"Indiana","Dubois County",4,12,598,293,305
050,18,037,"Indiana","Dubois County",4,13,629,317,312
050,18,037,"Indiana","Dubois County",4,14,638,325,313
050,18,037,"Indiana","Dubois County",4,15,646,344,302
050,18,037,"Indiana","Dubois County",4,16,618,317,301
050,18,037,"Indiana","Dubois County",4,17,611,327,284
050,18,037,"Indiana","Dubois County",4,18,524,286,238
050,18,037,"Indiana","Dubois County",4,19,427,241,186
050,18,037,"Indiana","Dubois County",4,20,447,235,212
050,18,037,"Indiana","Dubois County",4,21,495,250,245
050,18,037,"Indiana","Dubois County",4,22,526,262,264
050,18,037,"Indiana","Dubois County",4,23,477,235,242
050,18,037,"Indiana","Dubois County",4,24,512,249,263
050,18,037,"Indiana","Dubois County",4,25,475,242,233
050,18,037,"Indiana","Dubois County",4,26,490,260,230
050,18,037,"Indiana","Dubois County",4,27,478,227,251
050,18,037,"Indiana","Dubois County",4,28,474,244,230
050,18,037,"Indiana","Dubois County",4,29,521,270,251
050,18,037,"Indiana","Dubois County",4,30,495,241,254
050,18,037,"Indiana","Dubois County",4,31,471,244,227
050,18,037,"Indiana","Dubois County",4,32,458,239,219
050,18,037,"Indiana","Dubois County",4,33,481,242,239
050,18,037,"Indiana","Dubois County",4,34,501,253,248
050,18,037,"Indiana","Dubois County",4,35,458,222,236
050,18,037,"Indiana","Dubois County",4,36,505,263,242
050,18,037,"Indiana","Dubois County",4,37,539,297,242
050,18,037,"Indiana","Dubois County",4,38,511,268,243
050,18,037,"Indiana","Dubois County",4,39,522,289,233
050,18,037,"Indiana","Dubois County",4,40,519,277,242
050,18,037,"Indiana","Dubois County",4,41,526,262,264
050,18,037,"Indiana","Dubois County",4,42,524,281,243
050,18,037,"Indiana","Dubois County",4,43,527,268,259
050,18,037,"Indiana","Dubois County",4,44,520,269,251
050,18,037,"Indiana","Dubois County",4,45,499,268,231
050,18,037,"Indiana","Dubois County",4,46,471,248,223
050,18,037,"Indiana","Dubois County",4,47,489,266,223
050,18,037,"Indiana","Dubois County",4,48,461,245,216
050,18,037,"Indiana","Dubois County",4,49,459,234,225
050,18,037,"Indiana","Dubois County",4,50,515,265,250
050,18,037,"Indiana","Dubois County",4,51,556,286,270
050,18,037,"Indiana","Dubois County",4,52,539,285,254
050,18,037,"Indiana","Dubois County",4,53,515,260,255
050,18,037,"Indiana","Dubois County",4,54,537,274,263
050,18,037,"Indiana","Dubois County",4,55,570,295,275
050,18,037,"Indiana","Dubois County",4,56,600,295,305
050,18,037,"Indiana","Dubois County",4,57,610,320,290
050,18,037,"Indiana","Dubois County",4,58,649,352,297
050,18,037,"Indiana","Dubois County",4,59,659,348,311
050,18,037,"Indiana","Dubois County",4,60,676,346,330
050,18,037,"Indiana","Dubois County",4,61,654,324,330
050,18,037,"Indiana","Dubois County",4,62,663,327,336
050,18,037,"Indiana","Dubois County",4,63,627,316,311
050,18,037,"Indiana","Dubois County",4,64,607,298,309
050,18,037,"Indiana","Dubois County",4,65,612,311,301
050,18,037,"Indiana","Dubois County",4,66,583,299,284
050,18,037,"Indiana","Dubois County",4,67,539,272,267
050,18,037,"Indiana","Dubois County",4,68,521,245,276
050,18,037,"Indiana","Dubois County",4,69,492,236,256
050,18,037,"Indiana","Dubois County",4,70,490,254,236
050,18,037,"Indiana","Dubois County",4,71,421,206,215
050,18,037,"Indiana","Dubois County",4,72,406,199,207
050,18,037,"Indiana","Dubois County",4,73,428,200,228
050,18,037,"Indiana","Dubois County",4,74,390,178,212
050,18,037,"Indiana","Dubois County",4,75,411,196,215
050,18,037,"Indiana","Dubois County",4,76,273,127,146
050,18,037,"Indiana","Dubois County",4,77,252,123,129
050,18,037,"Indiana","Dubois County",4,78,221,99,122
050,18,037,"Indiana","Dubois County",4,79,254,101,153
050,18,037,"Indiana","Dubois County",4,80,233,100,133
050,18,037,"Indiana","Dubois County",4,81,202,81,121
050,18,037,"Indiana","Dubois County",4,82,184,68,116
050,18,037,"Indiana","Dubois County",4,83,175,75,100
050,18,037,"Indiana","Dubois County",4,84,168,66,102
050,18,037,"Indiana","Dubois County",4,85,919,285,634
050,18,037,"Indiana","Dubois County",5,0,496,254,242
050,18,037,"Indiana","Dubois County",5,1,509,266,243
050,18,037,"Indiana","Dubois County",5,2,502,255,247
050,18,037,"Indiana","Dubois County",5,3,545,281,264
050,18,037,"Indiana","Dubois County",5,4,557,271,286
050,18,037,"Indiana","Dubois County",5,5,562,277,285
050,18,037,"Indiana","Dubois County",5,6,618,316,302
050,18,037,"Indiana","Dubois County",5,7,608,326,282
050,18,037,"Indiana","Dubois County",5,8,625,333,292
050,18,037,"Indiana","Dubois County",5,9,595,324,271
050,18,037,"Indiana","Dubois County",5,10,587,318,269
050,18,037,"Indiana","Dubois County",5,11,587,300,287
050,18,037,"Indiana","Dubois County",5,12,586,306,280
050,18,037,"Indiana","Dubois County",5,13,593,287,306
050,18,037,"Indiana","Dubois County",5,14,636,330,306
050,18,037,"Indiana","Dubois County",5,15,641,325,316
050,18,037,"Indiana","Dubois County",5,16,652,345,307
050,18,037,"Indiana","Dubois County",5,17,630,321,309
050,18,037,"Indiana","Dubois County",5,18,522,288,234
050,18,037,"Indiana","Dubois County",5,19,414,230,184
050,18,037,"Indiana","Dubois County",5,20,455,254,201
050,18,037,"Indiana","Dubois County",5,21,485,255,230
050,18,037,"Indiana","Dubois County",5,22,517,250,267
050,18,037,"Indiana","Dubois County",5,23,511,266,245
050,18,037,"Indiana","Dubois County",5,24,460,231,229
050,18,037,"Indiana","Dubois County",5,25,490,249,241
050,18,037,"Indiana","Dubois County",5,26,465,238,227
050,18,037,"Indiana","Dubois County",5,27,483,254,229
050,18,037,"Indiana","Dubois County",5,28,478,228,250
050,18,037,"Indiana","Dubois County",5,29,475,242,233
050,18,037,"Indiana","Dubois County",5,30,526,277,249
050,18,037,"Indiana","Dubois County",5,31,497,240,257
050,18,037,"Indiana","Dubois County",5,32,479,244,235
050,18,037,"Indiana","Dubois County",5,33,485,262,223
050,18,037,"Indiana","Dubois County",5,34,487,240,247
050,18,037,"Indiana","Dubois County",5,35,495,243,252
050,18,037,"Indiana","Dubois County",5,36,465,226,239
050,18,037,"Indiana","Dubois County",5,37,507,265,242
050,18,037,"Indiana","Dubois County",5,38,531,297,234
050,18,037,"Indiana","Dubois County",5,39,517,277,240
050,18,037,"Indiana","Dubois County",5,40,526,294,232
050,18,037,"Indiana","Dubois County",5,41,517,274,243
050,18,037,"Indiana","Dubois County",5,42,524,260,264
050,18,037,"Indiana","Dubois County",5,43,522,285,237
050,18,037,"Indiana","Dubois County",5,44,538,275,263
050,18,037,"Indiana","Dubois County",5,45,519,271,248
050,18,037,"Indiana","Dubois County",5,46,498,272,226
050,18,037,"Indiana","Dubois County",5,47,473,249,224
050,18,037,"Indiana","Dubois County",5,48,487,257,230
050,18,037,"Indiana","Dubois County",5,49,458,238,220
050,18,037,"Indiana","Dubois County",5,50,457,232,225
050,18,037,"Indiana","Dubois County",5,51,517,268,249
050,18,037,"Indiana","Dubois County",5,52,545,284,261
050,18,037,"Indiana","Dubois County",5,53,540,279,261
050,18,037,"Indiana","Dubois County",5,54,493,248,245
050,18,037,"Indiana","Dubois County",5,55,540,273,267
050,18,037,"Indiana","Dubois County",5,56,586,297,289
050,18,037,"Indiana","Dubois County",5,57,588,294,294
050,18,037,"Indiana","Dubois County",5,58,614,320,294
050,18,037,"Indiana","Dubois County",5,59,644,341,303
050,18,037,"Indiana","Dubois County",5,60,649,338,311
050,18,037,"Indiana","Dubois County",5,61,673,353,320
050,18,037,"Indiana","Dubois County",5,62,662,335,327
050,18,037,"Indiana","Dubois County",5,63,655,322,333
050,18,037,"Indiana","Dubois County",5,64,619,308,311
050,18,037,"Indiana","Dubois County",5,65,600,293,307
050,18,037,"Indiana","Dubois County",5,66,597,303,294
050,18,037,"Indiana","Dubois County",5,67,571,292,279
050,18,037,"Indiana","Dubois County",5,68,533,263,270
050,18,037,"Indiana","Dubois County",5,69,510,241,269
050,18,037,"Indiana","Dubois County",5,70,480,232,248
050,18,037,"Indiana","Dubois County",5,71,472,241,231
050,18,037,"Indiana","Dubois County",5,72,425,206,219
050,18,037,"Indiana","Dubois County",5,73,394,194,200
050,18,037,"Indiana","Dubois County",5,74,420,204,216
050,18,037,"Indiana","Dubois County",5,75,381,175,206
050,18,037,"Indiana","Dubois County",5,76,405,192,213
050,18,037,"Indiana","Dubois County",5,77,266,126,140
050,18,037,"Indiana","Dubois County",5,78,225,111,114
050,18,037,"Indiana","Dubois County",5,79,219,90,129
050,18,037,"Indiana","Dubois County",5,80,245,98,147
050,18,037,"Indiana","Dubois County",5,81,214,94,120
050,18,037,"Indiana","Dubois County",5,82,193,77,116
050,18,037,"Indiana","Dubois County",5,83,160,61,99
050,18,037,"Indiana","Dubois County",5,84,175,69,106
050,18,037,"Indiana","Dubois County",5,85,944,301,643
050,18,039,"Indiana","Elkhart County",1,0,3095,1586,1509
050,18,039,"Indiana","Elkhart County",1,1,3097,1595,1502
050,18,039,"Indiana","Elkhart County",1,2,3126,1607,1519
050,18,039,"Indiana","Elkhart County",1,3,3086,1599,1487
050,18,039,"Indiana","Elkhart County",1,4,3126,1611,1515
050,18,039,"Indiana","Elkhart County",1,5,3210,1609,1601
050,18,039,"Indiana","Elkhart County",1,6,3087,1564,1523
050,18,039,"Indiana","Elkhart County",1,7,3093,1551,1542
050,18,039,"Indiana","Elkhart County",1,8,3095,1571,1524
050,18,039,"Indiana","Elkhart County",1,9,3101,1589,1512
050,18,039,"Indiana","Elkhart County",1,10,3222,1680,1542
050,18,039,"Indiana","Elkhart County",1,11,3308,1663,1645
050,18,039,"Indiana","Elkhart County",1,12,3516,1763,1753
050,18,039,"Indiana","Elkhart County",1,13,3582,1808,1774
050,18,039,"Indiana","Elkhart County",1,14,3458,1764,1694
050,18,039,"Indiana","Elkhart County",1,15,3363,1688,1675
050,18,039,"Indiana","Elkhart County",1,16,3320,1658,1662
050,18,039,"Indiana","Elkhart County",1,17,3238,1653,1585
050,18,039,"Indiana","Elkhart County",1,18,2793,1443,1350
050,18,039,"Indiana","Elkhart County",1,19,2563,1341,1222
050,18,039,"Indiana","Elkhart County",1,20,2610,1376,1234
050,18,039,"Indiana","Elkhart County",1,21,2635,1332,1303
050,18,039,"Indiana","Elkhart County",1,22,2652,1304,1348
050,18,039,"Indiana","Elkhart County",1,23,2584,1339,1245
050,18,039,"Indiana","Elkhart County",1,24,2573,1283,1290
050,18,039,"Indiana","Elkhart County",1,25,2627,1322,1305
050,18,039,"Indiana","Elkhart County",1,26,2629,1319,1310
050,18,039,"Indiana","Elkhart County",1,27,2730,1354,1376
050,18,039,"Indiana","Elkhart County",1,28,2778,1393,1385
050,18,039,"Indiana","Elkhart County",1,29,2755,1383,1372
050,18,039,"Indiana","Elkhart County",1,30,2620,1294,1326
050,18,039,"Indiana","Elkhart County",1,31,2535,1275,1260
050,18,039,"Indiana","Elkhart County",1,32,2558,1264,1294
050,18,039,"Indiana","Elkhart County",1,33,2507,1237,1270
050,18,039,"Indiana","Elkhart County",1,34,2534,1289,1245
050,18,039,"Indiana","Elkhart County",1,35,2478,1288,1190
050,18,039,"Indiana","Elkhart County",1,36,2403,1212,1191
050,18,039,"Indiana","Elkhart County",1,37,2548,1236,1312
050,18,039,"Indiana","Elkhart County",1,38,2606,1292,1314
050,18,039,"Indiana","Elkhart County",1,39,2575,1291,1284
050,18,039,"Indiana","Elkhart County",1,40,2559,1262,1297
050,18,039,"Indiana","Elkhart County",1,41,2454,1198,1256
050,18,039,"Indiana","Elkhart County",1,42,2508,1226,1282
050,18,039,"Indiana","Elkhart County",1,43,2465,1228,1237
050,18,039,"Indiana","Elkhart County",1,44,2350,1179,1171
050,18,039,"Indiana","Elkhart County",1,45,2387,1183,1204
050,18,039,"Indiana","Elkhart County",1,46,2361,1141,1220
050,18,039,"Indiana","Elkhart County",1,47,2386,1164,1222
050,18,039,"Indiana","Elkhart County",1,48,2484,1263,1221
050,18,039,"Indiana","Elkhart County",1,49,2636,1350,1286
050,18,039,"Indiana","Elkhart County",1,50,2542,1300,1242
050,18,039,"Indiana","Elkhart County",1,51,2477,1247,1230
050,18,039,"Indiana","Elkhart County",1,52,2377,1177,1200
050,18,039,"Indiana","Elkhart County",1,53,2419,1235,1184
050,18,039,"Indiana","Elkhart County",1,54,2431,1236,1195
050,18,039,"Indiana","Elkhart County",1,55,2561,1299,1262
050,18,039,"Indiana","Elkhart County",1,56,2546,1307,1239
050,18,039,"Indiana","Elkhart County",1,57,2517,1278,1239
050,18,039,"Indiana","Elkhart County",1,58,2568,1275,1293
050,18,039,"Indiana","Elkhart County",1,59,2453,1228,1225
050,18,039,"Indiana","Elkhart County",1,60,2407,1215,1192
050,18,039,"Indiana","Elkhart County",1,61,2373,1162,1211
050,18,039,"Indiana","Elkhart County",1,62,2337,1150,1187
050,18,039,"Indiana","Elkhart County",1,63,2264,1120,1144
050,18,039,"Indiana","Elkhart County",1,64,2201,1044,1157
050,18,039,"Indiana","Elkhart County",1,65,2148,1046,1102
050,18,039,"Indiana","Elkhart County",1,66,2099,1029,1070
050,18,039,"Indiana","Elkhart County",1,67,2034,991,1043
050,18,039,"Indiana","Elkhart County",1,68,1947,945,1002
050,18,039,"Indiana","Elkhart County",1,69,1790,822,968
050,18,039,"Indiana","Elkhart County",1,70,1778,832,946
050,18,039,"Indiana","Elkhart County",1,71,1717,783,934
050,18,039,"Indiana","Elkhart County",1,72,1651,765,886
050,18,039,"Indiana","Elkhart County",1,73,1589,743,846
050,18,039,"Indiana","Elkhart County",1,74,1174,522,652
050,18,039,"Indiana","Elkhart County",1,75,1184,558,626
050,18,039,"Indiana","Elkhart County",1,76,1200,569,631
050,18,039,"Indiana","Elkhart County",1,77,1180,539,641
050,18,039,"Indiana","Elkhart County",1,78,967,426,541
050,18,039,"Indiana","Elkhart County",1,79,857,375,482
050,18,039,"Indiana","Elkhart County",1,80,780,332,448
050,18,039,"Indiana","Elkhart County",1,81,766,322,444
050,18,039,"Indiana","Elkhart County",1,82,777,335,442
050,18,039,"Indiana","Elkhart County",1,83,675,281,394
050,18,039,"Indiana","Elkhart County",1,84,585,230,355
050,18,039,"Indiana","Elkhart County",1,85,3669,1229,2440
050,18,039,"Indiana","Elkhart County",2,0,3020,1527,1493
050,18,039,"Indiana","Elkhart County",2,1,3093,1595,1498
050,18,039,"Indiana","Elkhart County",2,2,3122,1606,1516
050,18,039,"Indiana","Elkhart County",2,3,3083,1593,1490
050,18,039,"Indiana","Elkhart County",2,4,3129,1614,1515
050,18,039,"Indiana","Elkhart County",2,5,3183,1609,1574
050,18,039,"Indiana","Elkhart County",2,6,3122,1580,1542
050,18,039,"Indiana","Elkhart County",2,7,3092,1561,1531
050,18,039,"Indiana","Elkhart County",2,8,3088,1564,1524
050,18,039,"Indiana","Elkhart County",2,9,3093,1583,1510
050,18,039,"Indiana","Elkhart County",2,10,3184,1652,1532
050,18,039,"Indiana","Elkhart County",2,11,3272,1660,1612
050,18,039,"Indiana","Elkhart County",2,12,3476,1746,1730
050,18,039,"Indiana","Elkhart County",2,13,3555,1793,1762
050,18,039,"Indiana","Elkhart County",2,14,3475,1767,1708
050,18,039,"Indiana","Elkhart County",2,15,3386,1706,1680
050,18,039,"Indiana","Elkhart County",2,16,3337,1668,1669
050,18,039,"Indiana","Elkhart County",2,17,3252,1650,1602
050,18,039,"Indiana","Elkhart County",2,18,2799,1446,1353
050,18,039,"Indiana","Elkhart County",2,19,2550,1327,1223
050,18,039,"Indiana","Elkhart County",2,20,2651,1388,1263
050,18,039,"Indiana","Elkhart County",2,21,2649,1344,1305
050,18,039,"Indiana","Elkhart County",2,22,2663,1316,1347
050,18,039,"Indiana","Elkhart County",2,23,2603,1330,1273
050,18,039,"Indiana","Elkhart County",2,24,2567,1291,1276
050,18,039,"Indiana","Elkhart County",2,25,2605,1308,1297
050,18,039,"Indiana","Elkhart County",2,26,2627,1321,1306
050,18,039,"Indiana","Elkhart County",2,27,2704,1347,1357
050,18,039,"Indiana","Elkhart County",2,28,2769,1388,1381
050,18,039,"Indiana","Elkhart County",2,29,2763,1389,1374
050,18,039,"Indiana","Elkhart County",2,30,2664,1322,1342
050,18,039,"Indiana","Elkhart County",2,31,2549,1272,1277
050,18,039,"Indiana","Elkhart County",2,32,2556,1266,1290
050,18,039,"Indiana","Elkhart County",2,33,2520,1243,1277
050,18,039,"Indiana","Elkhart County",2,34,2529,1281,1248
050,18,039,"Indiana","Elkhart County",2,35,2505,1300,1205
050,18,039,"Indiana","Elkhart County",2,36,2404,1220,1184
050,18,039,"Indiana","Elkhart County",2,37,2512,1231,1281
050,18,039,"Indiana","Elkhart County",2,38,2590,1275,1315
050,18,039,"Indiana","Elkhart County",2,39,2577,1290,1287
050,18,039,"Indiana","Elkhart County",2,40,2572,1272,1300
050,18,039,"Indiana","Elkhart County",2,41,2472,1210,1262
050,18,039,"Indiana","Elkhart County",2,42,2482,1215,1267
050,18,039,"Indiana","Elkhart County",2,43,2480,1229,1251
050,18,039,"Indiana","Elkhart County",2,44,2359,1181,1178
050,18,039,"Indiana","Elkhart County",2,45,2383,1188,1195
050,18,039,"Indiana","Elkhart County",2,46,2358,1147,1211
050,18,039,"Indiana","Elkhart County",2,47,2367,1152,1215
050,18,039,"Indiana","Elkhart County",2,48,2447,1229,1218
050,18,039,"Indiana","Elkhart County",2,49,2598,1333,1265
050,18,039,"Indiana","Elkhart County",2,50,2559,1309,1250
050,18,039,"Indiana","Elkhart County",2,51,2481,1252,1229
050,18,039,"Indiana","Elkhart County",2,52,2389,1187,1202
050,18,039,"Indiana","Elkhart County",2,53,2401,1218,1183
050,18,039,"Indiana","Elkhart County",2,54,2416,1226,1190
050,18,039,"Indiana","Elkhart County",2,55,2525,1280,1245
050,18,039,"Indiana","Elkhart County",2,56,2549,1308,1241
050,18,039,"Indiana","Elkhart County",2,57,2514,1280,1234
050,18,039,"Indiana","Elkhart County",2,58,2543,1268,1275
050,18,039,"Indiana","Elkhart County",2,59,2474,1236,1238
050,18,039,"Indiana","Elkhart County",2,60,2401,1208,1193
050,18,039,"Indiana","Elkhart County",2,61,2363,1165,1198
050,18,039,"Indiana","Elkhart County",2,62,2331,1144,1187
050,18,039,"Indiana","Elkhart County",2,63,2294,1131,1163
050,18,039,"Indiana","Elkhart County",2,64,2200,1050,1150
050,18,039,"Indiana","Elkhart County",2,65,2142,1035,1107
050,18,039,"Indiana","Elkhart County",2,66,2102,1032,1070
050,18,039,"Indiana","Elkhart County",2,67,2026,988,1038
050,18,039,"Indiana","Elkhart County",2,68,1948,946,1002
050,18,039,"Indiana","Elkhart County",2,69,1832,851,981
050,18,039,"Indiana","Elkhart County",2,70,1773,823,950
050,18,039,"Indiana","Elkhart County",2,71,1719,788,931
050,18,039,"Indiana","Elkhart County",2,72,1631,751,880
050,18,039,"Indiana","Elkhart County",2,73,1674,778,896
050,18,039,"Indiana","Elkhart County",2,74,1185,531,654
050,18,039,"Indiana","Elkhart County",2,75,1176,547,629
050,18,039,"Indiana","Elkhart County",2,76,1176,559,617
050,18,039,"Indiana","Elkhart County",2,77,1205,556,649
050,18,039,"Indiana","Elkhart County",2,78,989,440,549
050,18,039,"Indiana","Elkhart County",2,79,874,383,491
050,18,039,"Indiana","Elkhart County",2,80,788,339,449
050,18,039,"Indiana","Elkhart County",2,81,756,318,438
050,18,039,"Indiana","Elkhart County",2,82,772,330,442
050,18,039,"Indiana","Elkhart County",2,83,689,290,399
050,18,039,"Indiana","Elkhart County",2,84,601,238,363
050,18,039,"Indiana","Elkhart County",2,85,3657,1225,2432
050,18,039,"Indiana","Elkhart County",3,0,2821,1457,1364
050,18,039,"Indiana","Elkhart County",3,1,3049,1567,1482
050,18,039,"Indiana","Elkhart County",3,2,3138,1599,1539
050,18,039,"Indiana","Elkhart County",3,3,3113,1594,1519
050,18,039,"Indiana","Elkhart County",3,4,3063,1581,1482
050,18,039,"Indiana","Elkhart County",3,5,3129,1605,1524
050,18,039,"Indiana","Elkhart County",3,6,3139,1589,1550
050,18,039,"Indiana","Elkhart County",3,7,3101,1556,1545
050,18,039,"Indiana","Elkhart County",3,8,3090,1536,1554
050,18,039,"Indiana","Elkhart County",3,9,3057,1529,1528
050,18,039,"Indiana","Elkhart County",3,10,3094,1596,1498
050,18,039,"Indiana","Elkhart County",3,11,3192,1667,1525
050,18,039,"Indiana","Elkhart County",3,12,3246,1642,1604
050,18,039,"Indiana","Elkhart County",3,13,3448,1742,1706
050,18,039,"Indiana","Elkhart County",3,14,3566,1788,1778
050,18,039,"Indiana","Elkhart County",3,15,3418,1740,1678
050,18,039,"Indiana","Elkhart County",3,16,3383,1703,1680
050,18,039,"Indiana","Elkhart County",3,17,3331,1668,1663
050,18,039,"Indiana","Elkhart County",3,18,2852,1478,1374
050,18,039,"Indiana","Elkhart County",3,19,2492,1279,1213
050,18,039,"Indiana","Elkhart County",3,20,2715,1401,1314
050,18,039,"Indiana","Elkhart County",3,21,2755,1420,1335
050,18,039,"Indiana","Elkhart County",3,22,2753,1383,1370
050,18,039,"Indiana","Elkhart County",3,23,2711,1362,1349
050,18,039,"Indiana","Elkhart County",3,24,2616,1338,1278
050,18,039,"Indiana","Elkhart County",3,25,2581,1315,1266
050,18,039,"Indiana","Elkhart County",3,26,2581,1298,1283
050,18,039,"Indiana","Elkhart County",3,27,2659,1351,1308
050,18,039,"Indiana","Elkhart County",3,28,2726,1358,1368
050,18,039,"Indiana","Elkhart County",3,29,2774,1391,1383
050,18,039,"Indiana","Elkhart County",3,30,2731,1370,1361
050,18,039,"Indiana","Elkhart County",3,31,2624,1298,1326
050,18,039,"Indiana","Elkhart County",3,32,2587,1293,1294
050,18,039,"Indiana","Elkhart County",3,33,2542,1275,1267
050,18,039,"Indiana","Elkhart County",3,34,2524,1235,1289
050,18,039,"Indiana","Elkhart County",3,35,2518,1263,1255
050,18,039,"Indiana","Elkhart County",3,36,2504,1297,1207
050,18,039,"Indiana","Elkhart County",3,37,2406,1227,1179
050,18,039,"Indiana","Elkhart County",3,38,2502,1225,1277
050,18,039,"Indiana","Elkhart County",3,39,2608,1282,1326
050,18,039,"Indiana","Elkhart County",3,40,2539,1272,1267
050,18,039,"Indiana","Elkhart County",3,41,2554,1283,1271
050,18,039,"Indiana","Elkhart County",3,42,2431,1191,1240
050,18,039,"Indiana","Elkhart County",3,43,2452,1192,1260
050,18,039,"Indiana","Elkhart County",3,44,2496,1244,1252
050,18,039,"Indiana","Elkhart County",3,45,2343,1179,1164
050,18,039,"Indiana","Elkhart County",3,46,2346,1166,1180
050,18,039,"Indiana","Elkhart County",3,47,2336,1133,1203
050,18,039,"Indiana","Elkhart County",3,48,2361,1145,1216
050,18,039,"Indiana","Elkhart County",3,49,2421,1220,1201
050,18,039,"Indiana","Elkhart County",3,50,2588,1327,1261
050,18,039,"Indiana","Elkhart County",3,51,2535,1297,1238
050,18,039,"Indiana","Elkhart County",3,52,2436,1229,1207
050,18,039,"Indiana","Elkhart County",3,53,2401,1194,1207
050,18,039,"Indiana","Elkhart County",3,54,2385,1200,1185
050,18,039,"Indiana","Elkhart County",3,55,2399,1224,1175
050,18,039,"Indiana","Elkhart County",3,56,2484,1272,1212
050,18,039,"Indiana","Elkhart County",3,57,2498,1291,1207
050,18,039,"Indiana","Elkhart County",3,58,2482,1258,1224
050,18,039,"Indiana","Elkhart County",3,59,2498,1241,1257
050,18,039,"Indiana","Elkhart County",3,60,2425,1200,1225
050,18,039,"Indiana","Elkhart County",3,61,2361,1182,1179
050,18,039,"Indiana","Elkhart County",3,62,2310,1136,1174
050,18,039,"Indiana","Elkhart County",3,63,2288,1127,1161
050,18,039,"Indiana","Elkhart County",3,64,2213,1084,1129
050,18,039,"Indiana","Elkhart County",3,65,2140,1024,1116
050,18,039,"Indiana","Elkhart County",3,66,2094,1009,1085
050,18,039,"Indiana","Elkhart County",3,67,2044,994,1050
050,18,039,"Indiana","Elkhart County",3,68,1980,956,1024
050,18,039,"Indiana","Elkhart County",3,69,1894,911,983
050,18,039,"Indiana","Elkhart County",3,70,1800,832,968
050,18,039,"Indiana","Elkhart County",3,71,1722,803,919
050,18,039,"Indiana","Elkhart County",3,72,1680,759,921
050,18,039,"Indiana","Elkhart County",3,73,1574,719,855
050,18,039,"Indiana","Elkhart County",3,74,1641,751,890
050,18,039,"Indiana","Elkhart County",3,75,1134,511,623
050,18,039,"Indiana","Elkhart County",3,76,1126,519,607
050,18,039,"Indiana","Elkhart County",3,77,1159,542,617
050,18,039,"Indiana","Elkhart County",3,78,1140,517,623
050,18,039,"Indiana","Elkhart County",3,79,963,423,540
050,18,039,"Indiana","Elkhart County",3,80,824,352,472
050,18,039,"Indiana","Elkhart County",3,81,737,312,425
050,18,039,"Indiana","Elkhart County",3,82,730,298,432
050,18,039,"Indiana","Elkhart County",3,83,715,312,403
050,18,039,"Indiana","Elkhart County",3,84,640,261,379
050,18,039,"Indiana","Elkhart County",3,85,3596,1213,2383
050,18,039,"Indiana","Elkhart County",4,0,2875,1542,1333
050,18,039,"Indiana","Elkhart County",4,1,2802,1465,1337
050,18,039,"Indiana","Elkhart County",4,2,3031,1549,1482
050,18,039,"Indiana","Elkhart County",4,3,3107,1570,1537
050,18,039,"Indiana","Elkhart County",4,4,3078,1566,1512
050,18,039,"Indiana","Elkhart County",4,5,3073,1571,1502
050,18,039,"Indiana","Elkhart County",4,6,3089,1582,1507
050,18,039,"Indiana","Elkhart County",4,7,3110,1586,1524
050,18,039,"Indiana","Elkhart County",4,8,3093,1563,1530
050,18,039,"Indiana","Elkhart County",4,9,3085,1543,1542
050,18,039,"Indiana","Elkhart County",4,10,3044,1536,1508
050,18,039,"Indiana","Elkhart County",4,11,3068,1580,1488
050,18,039,"Indiana","Elkhart County",4,12,3194,1664,1530
050,18,039,"Indiana","Elkhart County",4,13,3237,1652,1585
050,18,039,"Indiana","Elkhart County",4,14,3484,1780,1704
050,18,039,"Indiana","Elkhart County",4,15,3542,1768,1774
050,18,039,"Indiana","Elkhart County",4,16,3399,1735,1664
050,18,039,"Indiana","Elkhart County",4,17,3373,1684,1689
050,18,039,"Indiana","Elkhart County",4,18,2910,1489,1421
050,18,039,"Indiana","Elkhart County",4,19,2475,1280,1195
050,18,039,"Indiana","Elkhart County",4,20,2551,1304,1247
050,18,039,"Indiana","Elkhart County",4,21,2781,1420,1361
050,18,039,"Indiana","Elkhart County",4,22,2886,1495,1391
050,18,039,"Indiana","Elkhart County",4,23,2779,1389,1390
050,18,039,"Indiana","Elkhart County",4,24,2713,1392,1321
050,18,039,"Indiana","Elkhart County",4,25,2551,1333,1218
050,18,039,"Indiana","Elkhart County",4,26,2615,1348,1267
050,18,039,"Indiana","Elkhart County",4,27,2605,1315,1290
050,18,039,"Indiana","Elkhart County",4,28,2632,1337,1295
050,18,039,"Indiana","Elkhart County",4,29,2737,1376,1361
050,18,039,"Indiana","Elkhart County",4,30,2758,1368,1390
050,18,039,"Indiana","Elkhart County",4,31,2704,1378,1326
050,18,039,"Indiana","Elkhart County",4,32,2610,1308,1302
050,18,039,"Indiana","Elkhart County",4,33,2564,1285,1279
050,18,039,"Indiana","Elkhart County",4,34,2542,1291,1251
050,18,039,"Indiana","Elkhart County",4,35,2513,1256,1257
050,18,039,"Indiana","Elkhart County",4,36,2542,1296,1246
050,18,039,"Indiana","Elkhart County",4,37,2542,1349,1193
050,18,039,"Indiana","Elkhart County",4,38,2371,1222,1149
050,18,039,"Indiana","Elkhart County",4,39,2463,1211,1252
050,18,039,"Indiana","Elkhart County",4,40,2607,1271,1336
050,18,039,"Indiana","Elkhart County",4,41,2515,1266,1249
050,18,039,"Indiana","Elkhart County",4,42,2555,1301,1254
050,18,039,"Indiana","Elkhart County",4,43,2429,1180,1249
050,18,039,"Indiana","Elkhart County",4,44,2427,1179,1248
050,18,039,"Indiana","Elkhart County",4,45,2483,1251,1232
050,18,039,"Indiana","Elkhart County",4,46,2331,1159,1172
050,18,039,"Indiana","Elkhart County",4,47,2322,1161,1161
050,18,039,"Indiana","Elkhart County",4,48,2345,1148,1197
050,18,039,"Indiana","Elkhart County",4,49,2343,1145,1198
050,18,039,"Indiana","Elkhart County",4,50,2412,1225,1187
050,18,039,"Indiana","Elkhart County",4,51,2572,1318,1254
050,18,039,"Indiana","Elkhart County",4,52,2488,1264,1224
050,18,039,"Indiana","Elkhart County",4,53,2432,1221,1211
050,18,039,"Indiana","Elkhart County",4,54,2383,1181,1202
050,18,039,"Indiana","Elkhart County",4,55,2356,1187,1169
050,18,039,"Indiana","Elkhart County",4,56,2405,1239,1166
050,18,039,"Indiana","Elkhart County",4,57,2454,1252,1202
050,18,039,"Indiana","Elkhart County",4,58,2482,1277,1205
050,18,039,"Indiana","Elkhart County",4,59,2430,1232,1198
050,18,039,"Indiana","Elkhart County",4,60,2454,1215,1239
050,18,039,"Indiana","Elkhart County",4,61,2380,1159,1221
050,18,039,"Indiana","Elkhart County",4,62,2323,1160,1163
050,18,039,"Indiana","Elkhart County",4,63,2258,1121,1137
050,18,039,"Indiana","Elkhart County",4,64,2229,1091,1138
050,18,039,"Indiana","Elkhart County",4,65,2138,1045,1093
050,18,039,"Indiana","Elkhart County",4,66,2089,992,1097
050,18,039,"Indiana","Elkhart County",4,67,2037,973,1064
050,18,039,"Indiana","Elkhart County",4,68,1979,953,1026
050,18,039,"Indiana","Elkhart County",4,69,1927,919,1008
050,18,039,"Indiana","Elkhart County",4,70,1854,885,969
050,18,039,"Indiana","Elkhart County",4,71,1721,798,923
050,18,039,"Indiana","Elkhart County",4,72,1680,773,907
050,18,039,"Indiana","Elkhart County",4,73,1626,725,901
050,18,039,"Indiana","Elkhart County",4,74,1546,690,856
050,18,039,"Indiana","Elkhart County",4,75,1585,726,859
050,18,039,"Indiana","Elkhart County",4,76,1087,494,593
050,18,039,"Indiana","Elkhart County",4,77,1095,494,601
050,18,039,"Indiana","Elkhart County",4,78,1089,501,588
050,18,039,"Indiana","Elkhart County",4,79,1097,488,609
050,18,039,"Indiana","Elkhart County",4,80,922,402,520
050,18,039,"Indiana","Elkhart County",4,81,776,321,455
050,18,039,"Indiana","Elkhart County",4,82,714,293,421
050,18,039,"Indiana","Elkhart County",4,83,669,289,380
050,18,039,"Indiana","Elkhart County",4,84,675,285,390
050,18,039,"Indiana","Elkhart County",4,85,3624,1250,2374
050,18,039,"Indiana","Elkhart County",5,0,2840,1527,1313
050,18,039,"Indiana","Elkhart County",5,1,2863,1510,1353
050,18,039,"Indiana","Elkhart County",5,2,2778,1454,1324
050,18,039,"Indiana","Elkhart County",5,3,3025,1560,1465
050,18,039,"Indiana","Elkhart County",5,4,3046,1524,1522
050,18,039,"Indiana","Elkhart County",5,5,3053,1546,1507
050,18,039,"Indiana","Elkhart County",5,6,3058,1556,1502
050,18,039,"Indiana","Elkhart County",5,7,3075,1576,1499
050,18,039,"Indiana","Elkhart County",5,8,3046,1565,1481
050,18,039,"Indiana","Elkhart County",5,9,3050,1554,1496
050,18,039,"Indiana","Elkhart County",5,10,3064,1539,1525
050,18,039,"Indiana","Elkhart County",5,11,3009,1495,1514
050,18,039,"Indiana","Elkhart County",5,12,3090,1600,1490
050,18,039,"Indiana","Elkhart County",5,13,3179,1664,1515
050,18,039,"Indiana","Elkhart County",5,14,3290,1699,1591
050,18,039,"Indiana","Elkhart County",5,15,3436,1754,1682
050,18,039,"Indiana","Elkhart County",5,16,3537,1757,1780
050,18,039,"Indiana","Elkhart County",5,17,3370,1711,1659
050,18,039,"Indiana","Elkhart County",5,18,2958,1503,1455
050,18,039,"Indiana","Elkhart County",5,19,2564,1303,1261
050,18,039,"Indiana","Elkhart County",5,20,2583,1337,1246
050,18,039,"Indiana","Elkhart County",5,21,2643,1343,1300
050,18,039,"Indiana","Elkhart County",5,22,2889,1486,1403
050,18,039,"Indiana","Elkhart County",5,23,2855,1470,1385
050,18,039,"Indiana","Elkhart County",5,24,2723,1386,1337
050,18,039,"Indiana","Elkhart County",5,25,2692,1379,1313
050,18,039,"Indiana","Elkhart County",5,26,2526,1308,1218
050,18,039,"Indiana","Elkhart County",5,27,2636,1369,1267
050,18,039,"Indiana","Elkhart County",5,28,2598,1301,1297
050,18,039,"Indiana","Elkhart County",5,29,2578,1312,1266
050,18,039,"Indiana","Elkhart County",5,30,2660,1329,1331
050,18,039,"Indiana","Elkhart County",5,31,2727,1345,1382
050,18,039,"Indiana","Elkhart County",5,32,2680,1360,1320
050,18,039,"Indiana","Elkhart County",5,33,2588,1291,1297
050,18,039,"Indiana","Elkhart County",5,34,2547,1281,1266
050,18,039,"Indiana","Elkhart County",5,35,2517,1272,1245
050,18,039,"Indiana","Elkhart County",5,36,2515,1263,1252
050,18,039,"Indiana","Elkhart County",5,37,2539,1309,1230
050,18,039,"Indiana","Elkhart County",5,38,2532,1344,1188
050,18,039,"Indiana","Elkhart County",5,39,2362,1223,1139
050,18,039,"Indiana","Elkhart County",5,40,2439,1192,1247
050,18,039,"Indiana","Elkhart County",5,41,2579,1256,1323
050,18,039,"Indiana","Elkhart County",5,42,2516,1264,1252
050,18,039,"Indiana","Elkhart County",5,43,2550,1284,1266
050,18,039,"Indiana","Elkhart County",5,44,2425,1187,1238
050,18,039,"Indiana","Elkhart County",5,45,2419,1178,1241
050,18,039,"Indiana","Elkhart County",5,46,2454,1235,1219
050,18,039,"Indiana","Elkhart County",5,47,2273,1141,1132
050,18,039,"Indiana","Elkhart County",5,48,2326,1160,1166
050,18,039,"Indiana","Elkhart County",5,49,2325,1151,1174
050,18,039,"Indiana","Elkhart County",5,50,2361,1162,1199
050,18,039,"Indiana","Elkhart County",5,51,2405,1216,1189
050,18,039,"Indiana","Elkhart County",5,52,2539,1297,1242
050,18,039,"Indiana","Elkhart County",5,53,2467,1257,1210
050,18,039,"Indiana","Elkhart County",5,54,2406,1202,1204
050,18,039,"Indiana","Elkhart County",5,55,2343,1163,1180
050,18,039,"Indiana","Elkhart County",5,56,2326,1183,1143
050,18,039,"Indiana","Elkhart County",5,57,2361,1210,1151
050,18,039,"Indiana","Elkhart County",5,58,2444,1245,1199
050,18,039,"Indiana","Elkhart County",5,59,2426,1261,1165
050,18,039,"Indiana","Elkhart County",5,60,2401,1213,1188
050,18,039,"Indiana","Elkhart County",5,61,2426,1193,1233
050,18,039,"Indiana","Elkhart County",5,62,2330,1132,1198
050,18,039,"Indiana","Elkhart County",5,63,2275,1133,1142
050,18,039,"Indiana","Elkhart County",5,64,2214,1082,1132
050,18,039,"Indiana","Elkhart County",5,65,2156,1053,1103
050,18,039,"Indiana","Elkhart County",5,66,2098,1018,1080
050,18,039,"Indiana","Elkhart County",5,67,2037,965,1072
050,18,039,"Indiana","Elkhart County",5,68,1994,950,1044
050,18,039,"Indiana","Elkhart County",5,69,1929,911,1018
050,18,039,"Indiana","Elkhart County",5,70,1891,903,988
050,18,039,"Indiana","Elkhart County",5,71,1781,842,939
050,18,039,"Indiana","Elkhart County",5,72,1690,773,917
050,18,039,"Indiana","Elkhart County",5,73,1628,742,886
050,18,039,"Indiana","Elkhart County",5,74,1593,699,894
050,18,039,"Indiana","Elkhart County",5,75,1505,672,833
050,18,039,"Indiana","Elkhart County",5,76,1528,704,824
050,18,039,"Indiana","Elkhart County",5,77,1056,468,588
050,18,039,"Indiana","Elkhart County",5,78,1038,461,577
050,18,039,"Indiana","Elkhart County",5,79,1054,476,578
050,18,039,"Indiana","Elkhart County",5,80,1052,458,594
050,18,039,"Indiana","Elkhart County",5,81,881,375,506
050,18,039,"Indiana","Elkhart County",5,82,755,303,452
050,18,039,"Indiana","Elkhart County",5,83,662,285,377
050,18,039,"Indiana","Elkhart County",5,84,631,267,364
050,18,039,"Indiana","Elkhart County",5,85,3699,1312,2387
050,18,041,"Indiana","Fayette County",1,0,273,141,132
050,18,041,"Indiana","Fayette County",1,1,282,148,134
050,18,041,"Indiana","Fayette County",1,2,279,134,145
050,18,041,"Indiana","Fayette County",1,3,248,133,115
050,18,041,"Indiana","Fayette County",1,4,246,126,120
050,18,041,"Indiana","Fayette County",1,5,247,125,122
050,18,041,"Indiana","Fayette County",1,6,261,136,125
050,18,041,"Indiana","Fayette County",1,7,270,148,122
050,18,041,"Indiana","Fayette County",1,8,251,136,115
050,18,041,"Indiana","Fayette County",1,9,275,143,132
050,18,041,"Indiana","Fayette County",1,10,299,148,151
050,18,041,"Indiana","Fayette County",1,11,303,156,147
050,18,041,"Indiana","Fayette County",1,12,314,153,161
050,18,041,"Indiana","Fayette County",1,13,314,151,163
050,18,041,"Indiana","Fayette County",1,14,332,161,171
050,18,041,"Indiana","Fayette County",1,15,317,171,146
050,18,041,"Indiana","Fayette County",1,16,340,171,169
050,18,041,"Indiana","Fayette County",1,17,325,164,161
050,18,041,"Indiana","Fayette County",1,18,290,160,130
050,18,041,"Indiana","Fayette County",1,19,230,121,109
050,18,041,"Indiana","Fayette County",1,20,247,133,114
050,18,041,"Indiana","Fayette County",1,21,249,133,116
050,18,041,"Indiana","Fayette County",1,22,249,127,122
050,18,041,"Indiana","Fayette County",1,23,254,123,131
050,18,041,"Indiana","Fayette County",1,24,256,132,124
050,18,041,"Indiana","Fayette County",1,25,257,130,127
050,18,041,"Indiana","Fayette County",1,26,273,135,138
050,18,041,"Indiana","Fayette County",1,27,300,157,143
050,18,041,"Indiana","Fayette County",1,28,296,143,153
050,18,041,"Indiana","Fayette County",1,29,258,133,125
050,18,041,"Indiana","Fayette County",1,30,249,124,125
050,18,041,"Indiana","Fayette County",1,31,263,127,136
050,18,041,"Indiana","Fayette County",1,32,244,110,134
050,18,041,"Indiana","Fayette County",1,33,244,122,122
050,18,041,"Indiana","Fayette County",1,34,247,123,124
050,18,041,"Indiana","Fayette County",1,35,213,111,102
050,18,041,"Indiana","Fayette County",1,36,226,103,123
050,18,041,"Indiana","Fayette County",1,37,248,119,129
050,18,041,"Indiana","Fayette County",1,38,247,124,123
050,18,041,"Indiana","Fayette County",1,39,284,133,151
050,18,041,"Indiana","Fayette County",1,40,277,129,148
050,18,041,"Indiana","Fayette County",1,41,311,155,156
050,18,041,"Indiana","Fayette County",1,42,289,152,137
050,18,041,"Indiana","Fayette County",1,43,290,146,144
050,18,041,"Indiana","Fayette County",1,44,312,148,164
050,18,041,"Indiana","Fayette County",1,45,335,169,166
050,18,041,"Indiana","Fayette County",1,46,296,147,149
050,18,041,"Indiana","Fayette County",1,47,265,139,126
050,18,041,"Indiana","Fayette County",1,48,316,170,146
050,18,041,"Indiana","Fayette County",1,49,327,178,149
050,18,041,"Indiana","Fayette County",1,50,307,162,145
050,18,041,"Indiana","Fayette County",1,51,301,161,140
050,18,041,"Indiana","Fayette County",1,52,294,153,141
050,18,041,"Indiana","Fayette County",1,53,304,158,146
050,18,041,"Indiana","Fayette County",1,54,331,174,157
050,18,041,"Indiana","Fayette County",1,55,350,173,177
050,18,041,"Indiana","Fayette County",1,56,341,177,164
050,18,041,"Indiana","Fayette County",1,57,330,164,166
050,18,041,"Indiana","Fayette County",1,58,317,154,163
050,18,041,"Indiana","Fayette County",1,59,323,147,176
050,18,041,"Indiana","Fayette County",1,60,314,151,163
050,18,041,"Indiana","Fayette County",1,61,303,156,147
050,18,041,"Indiana","Fayette County",1,62,329,153,176
050,18,041,"Indiana","Fayette County",1,63,341,152,189
050,18,041,"Indiana","Fayette County",1,64,333,158,175
050,18,041,"Indiana","Fayette County",1,65,332,164,168
050,18,041,"Indiana","Fayette County",1,66,320,155,165
050,18,041,"Indiana","Fayette County",1,67,332,170,162
050,18,041,"Indiana","Fayette County",1,68,331,160,171
050,18,041,"Indiana","Fayette County",1,69,300,143,157
050,18,041,"Indiana","Fayette County",1,70,278,138,140
050,18,041,"Indiana","Fayette County",1,71,251,121,130
050,18,041,"Indiana","Fayette County",1,72,269,114,155
050,18,041,"Indiana","Fayette County",1,73,280,137,143
050,18,041,"Indiana","Fayette County",1,74,189,91,98
050,18,041,"Indiana","Fayette County",1,75,193,83,110
050,18,041,"Indiana","Fayette County",1,76,175,77,98
050,18,041,"Indiana","Fayette County",1,77,177,82,95
050,18,041,"Indiana","Fayette County",1,78,161,79,82
050,18,041,"Indiana","Fayette County",1,79,157,79,78
050,18,041,"Indiana","Fayette County",1,80,122,48,74
050,18,041,"Indiana","Fayette County",1,81,115,51,64
050,18,041,"Indiana","Fayette County",1,82,107,48,59
050,18,041,"Indiana","Fayette County",1,83,92,46,46
050,18,041,"Indiana","Fayette County",1,84,85,38,47
050,18,041,"Indiana","Fayette County",1,85,496,189,307
050,18,041,"Indiana","Fayette County",2,0,275,144,131
050,18,041,"Indiana","Fayette County",2,1,279,144,135
050,18,041,"Indiana","Fayette County",2,2,280,139,141
050,18,041,"Indiana","Fayette County",2,3,253,133,120
050,18,041,"Indiana","Fayette County",2,4,248,130,118
050,18,041,"Indiana","Fayette County",2,5,247,125,122
050,18,041,"Indiana","Fayette County",2,6,256,132,124
050,18,041,"Indiana","Fayette County",2,7,269,145,124
050,18,041,"Indiana","Fayette County",2,8,256,140,116
050,18,041,"Indiana","Fayette County",2,9,272,142,130
050,18,041,"Indiana","Fayette County",2,10,298,149,149
050,18,041,"Indiana","Fayette County",2,11,303,154,149
050,18,041,"Indiana","Fayette County",2,12,312,154,158
050,18,041,"Indiana","Fayette County",2,13,314,151,163
050,18,041,"Indiana","Fayette County",2,14,325,159,166
050,18,041,"Indiana","Fayette County",2,15,324,170,154
050,18,041,"Indiana","Fayette County",2,16,336,172,164
050,18,041,"Indiana","Fayette County",2,17,330,167,163
050,18,041,"Indiana","Fayette County",2,18,280,151,129
050,18,041,"Indiana","Fayette County",2,19,229,121,108
050,18,041,"Indiana","Fayette County",2,20,250,134,116
050,18,041,"Indiana","Fayette County",2,21,251,134,117
050,18,041,"Indiana","Fayette County",2,22,251,127,124
050,18,041,"Indiana","Fayette County",2,23,252,124,128
050,18,041,"Indiana","Fayette County",2,24,254,129,125
050,18,041,"Indiana","Fayette County",2,25,260,132,128
050,18,041,"Indiana","Fayette County",2,26,267,133,134
050,18,041,"Indiana","Fayette County",2,27,291,150,141
050,18,041,"Indiana","Fayette County",2,28,294,146,148
050,18,041,"Indiana","Fayette County",2,29,271,137,134
050,18,041,"Indiana","Fayette County",2,30,252,126,126
050,18,041,"Indiana","Fayette County",2,31,257,124,133
050,18,041,"Indiana","Fayette County",2,32,248,113,135
050,18,041,"Indiana","Fayette County",2,33,243,119,124
050,18,041,"Indiana","Fayette County",2,34,243,120,123
050,18,041,"Indiana","Fayette County",2,35,223,115,108
050,18,041,"Indiana","Fayette County",2,36,220,103,117
050,18,041,"Indiana","Fayette County",2,37,242,115,127
050,18,041,"Indiana","Fayette County",2,38,249,124,125
050,18,041,"Indiana","Fayette County",2,39,273,128,145
050,18,041,"Indiana","Fayette County",2,40,282,132,150
050,18,041,"Indiana","Fayette County",2,41,301,147,154
050,18,041,"Indiana","Fayette County",2,42,292,150,142
050,18,041,"Indiana","Fayette County",2,43,292,148,144
050,18,041,"Indiana","Fayette County",2,44,304,146,158
050,18,041,"Indiana","Fayette County",2,45,329,165,164
050,18,041,"Indiana","Fayette County",2,46,301,149,152
050,18,041,"Indiana","Fayette County",2,47,271,140,131
050,18,041,"Indiana","Fayette County",2,48,306,163,143
050,18,041,"Indiana","Fayette County",2,49,325,176,149
050,18,041,"Indiana","Fayette County",2,50,310,164,146
050,18,041,"Indiana","Fayette County",2,51,301,162,139
050,18,041,"Indiana","Fayette County",2,52,293,154,139
050,18,041,"Indiana","Fayette County",2,53,303,157,146
050,18,041,"Indiana","Fayette County",2,54,323,169,154
050,18,041,"Indiana","Fayette County",2,55,346,172,174
050,18,041,"Indiana","Fayette County",2,56,341,175,166
050,18,041,"Indiana","Fayette County",2,57,334,169,165
050,18,041,"Indiana","Fayette County",2,58,320,156,164
050,18,041,"Indiana","Fayette County",2,59,322,149,173
050,18,041,"Indiana","Fayette County",2,60,312,149,163
050,18,041,"Indiana","Fayette County",2,61,302,151,151
050,18,041,"Indiana","Fayette County",2,62,322,153,169
050,18,041,"Indiana","Fayette County",2,63,339,152,187
050,18,041,"Indiana","Fayette County",2,64,332,155,177
050,18,041,"Indiana","Fayette County",2,65,330,162,168
050,18,041,"Indiana","Fayette County",2,66,323,157,166
050,18,041,"Indiana","Fayette County",2,67,328,165,163
050,18,041,"Indiana","Fayette County",2,68,323,158,165
050,18,041,"Indiana","Fayette County",2,69,307,148,159
050,18,041,"Indiana","Fayette County",2,70,281,140,141
050,18,041,"Indiana","Fayette County",2,71,258,125,133
050,18,041,"Indiana","Fayette County",2,72,260,113,147
050,18,041,"Indiana","Fayette County",2,73,290,136,154
050,18,041,"Indiana","Fayette County",2,74,195,93,102
050,18,041,"Indiana","Fayette County",2,75,187,82,105
050,18,041,"Indiana","Fayette County",2,76,176,76,100
050,18,041,"Indiana","Fayette County",2,77,182,83,99
050,18,041,"Indiana","Fayette County",2,78,160,78,82
050,18,041,"Indiana","Fayette County",2,79,156,76,80
050,18,041,"Indiana","Fayette County",2,80,129,55,74
050,18,041,"Indiana","Fayette County",2,81,114,49,65
050,18,041,"Indiana","Fayette County",2,82,106,48,58
050,18,041,"Indiana","Fayette County",2,83,93,45,48
050,18,041,"Indiana","Fayette County",2,84,86,39,47
050,18,041,"Indiana","Fayette County",2,85,495,190,305
050,18,041,"Indiana","Fayette County",3,0,230,117,113
050,18,041,"Indiana","Fayette County",3,1,280,132,148
050,18,041,"Indiana","Fayette County",3,2,288,148,140
050,18,041,"Indiana","Fayette County",3,3,276,142,134
050,18,041,"Indiana","Fayette County",3,4,258,128,130
050,18,041,"Indiana","Fayette County",3,5,243,128,115
050,18,041,"Indiana","Fayette County",3,6,262,134,128
050,18,041,"Indiana","Fayette County",3,7,265,137,128
050,18,041,"Indiana","Fayette County",3,8,281,153,128
050,18,041,"Indiana","Fayette County",3,9,256,137,119
050,18,041,"Indiana","Fayette County",3,10,262,134,128
050,18,041,"Indiana","Fayette County",3,11,309,154,155
050,18,041,"Indiana","Fayette County",3,12,304,152,152
050,18,041,"Indiana","Fayette County",3,13,308,159,149
050,18,041,"Indiana","Fayette County",3,14,331,162,169
050,18,041,"Indiana","Fayette County",3,15,326,161,165
050,18,041,"Indiana","Fayette County",3,16,334,164,170
050,18,041,"Indiana","Fayette County",3,17,342,177,165
050,18,041,"Indiana","Fayette County",3,18,278,143,135
050,18,041,"Indiana","Fayette County",3,19,225,116,109
050,18,041,"Indiana","Fayette County",3,20,253,129,124
050,18,041,"Indiana","Fayette County",3,21,257,142,115
050,18,041,"Indiana","Fayette County",3,22,260,134,126
050,18,041,"Indiana","Fayette County",3,23,242,124,118
050,18,041,"Indiana","Fayette County",3,24,261,127,134
050,18,041,"Indiana","Fayette County",3,25,265,130,135
050,18,041,"Indiana","Fayette County",3,26,242,124,118
050,18,041,"Indiana","Fayette County",3,27,265,134,131
050,18,041,"Indiana","Fayette County",3,28,295,151,144
050,18,041,"Indiana","Fayette County",3,29,301,151,150
050,18,041,"Indiana","Fayette County",3,30,279,139,140
050,18,041,"Indiana","Fayette County",3,31,257,131,126
050,18,041,"Indiana","Fayette County",3,32,258,128,130
050,18,041,"Indiana","Fayette County",3,33,256,118,138
050,18,041,"Indiana","Fayette County",3,34,255,125,130
050,18,041,"Indiana","Fayette County",3,35,247,128,119
050,18,041,"Indiana","Fayette County",3,36,234,119,115
050,18,041,"Indiana","Fayette County",3,37,228,105,123
050,18,041,"Indiana","Fayette County",3,38,244,116,128
050,18,041,"Indiana","Fayette County",3,39,256,123,133
050,18,041,"Indiana","Fayette County",3,40,274,127,147
050,18,041,"Indiana","Fayette County",3,41,286,134,152
050,18,041,"Indiana","Fayette County",3,42,302,143,159
050,18,041,"Indiana","Fayette County",3,43,302,157,145
050,18,041,"Indiana","Fayette County",3,44,297,152,145
050,18,041,"Indiana","Fayette County",3,45,304,148,156
050,18,041,"Indiana","Fayette County",3,46,332,161,171
050,18,041,"Indiana","Fayette County",3,47,303,150,153
050,18,041,"Indiana","Fayette County",3,48,285,153,132
050,18,041,"Indiana","Fayette County",3,49,298,165,133
050,18,041,"Indiana","Fayette County",3,50,333,180,153
050,18,041,"Indiana","Fayette County",3,51,306,163,143
050,18,041,"Indiana","Fayette County",3,52,310,168,142
050,18,041,"Indiana","Fayette County",3,53,285,147,138
050,18,041,"Indiana","Fayette County",3,54,291,147,144
050,18,041,"Indiana","Fayette County",3,55,329,171,158
050,18,041,"Indiana","Fayette County",3,56,347,177,170
050,18,041,"Indiana","Fayette County",3,57,350,181,169
050,18,041,"Indiana","Fayette County",3,58,327,163,164
050,18,041,"Indiana","Fayette County",3,59,310,149,161
050,18,041,"Indiana","Fayette County",3,60,315,147,168
050,18,041,"Indiana","Fayette County",3,61,304,145,159
050,18,041,"Indiana","Fayette County",3,62,305,152,153
050,18,041,"Indiana","Fayette County",3,63,309,151,158
050,18,041,"Indiana","Fayette County",3,64,321,145,176
050,18,041,"Indiana","Fayette County",3,65,319,145,174
050,18,041,"Indiana","Fayette County",3,66,326,159,167
050,18,041,"Indiana","Fayette County",3,67,316,149,167
050,18,041,"Indiana","Fayette County",3,68,318,160,158
050,18,041,"Indiana","Fayette County",3,69,318,156,162
050,18,041,"Indiana","Fayette County",3,70,298,146,152
050,18,041,"Indiana","Fayette County",3,71,270,131,139
050,18,041,"Indiana","Fayette County",3,72,254,126,128
050,18,041,"Indiana","Fayette County",3,73,256,110,146
050,18,041,"Indiana","Fayette County",3,74,279,132,147
050,18,041,"Indiana","Fayette County",3,75,181,85,96
050,18,041,"Indiana","Fayette County",3,76,174,76,98
050,18,041,"Indiana","Fayette County",3,77,166,70,96
050,18,041,"Indiana","Fayette County",3,78,169,77,92
050,18,041,"Indiana","Fayette County",3,79,150,71,79
050,18,041,"Indiana","Fayette County",3,80,145,69,76
050,18,041,"Indiana","Fayette County",3,81,120,51,69
050,18,041,"Indiana","Fayette County",3,82,106,43,63
050,18,041,"Indiana","Fayette County",3,83,92,47,45
050,18,041,"Indiana","Fayette County",3,84,85,36,49
050,18,041,"Indiana","Fayette County",3,85,501,197,304
050,18,041,"Indiana","Fayette County",4,0,264,122,142
050,18,041,"Indiana","Fayette County",4,1,262,140,122
050,18,041,"Indiana","Fayette County",4,2,285,142,143
050,18,041,"Indiana","Fayette County",4,3,284,145,139
050,18,041,"Indiana","Fayette County",4,4,276,147,129
050,18,041,"Indiana","Fayette County",4,5,268,135,133
050,18,041,"Indiana","Fayette County",4,6,262,138,124
050,18,041,"Indiana","Fayette County",4,7,260,133,127
050,18,041,"Indiana","Fayette County",4,8,268,139,129
050,18,041,"Indiana","Fayette County",4,9,280,159,121
050,18,041,"Indiana","Fayette County",4,10,251,134,117
050,18,041,"Indiana","Fayette County",4,11,264,135,129
050,18,041,"Indiana","Fayette County",4,12,320,160,160
050,18,041,"Indiana","Fayette County",4,13,310,160,150
050,18,041,"Indiana","Fayette County",4,14,312,157,155
050,18,041,"Indiana","Fayette County",4,15,332,162,170
050,18,041,"Indiana","Fayette County",4,16,333,159,174
050,18,041,"Indiana","Fayette County",4,17,332,162,170
050,18,041,"Indiana","Fayette County",4,18,291,159,132
050,18,041,"Indiana","Fayette County",4,19,210,107,103
050,18,041,"Indiana","Fayette County",4,20,248,125,123
050,18,041,"Indiana","Fayette County",4,21,277,136,141
050,18,041,"Indiana","Fayette County",4,22,268,140,128
050,18,041,"Indiana","Fayette County",4,23,275,140,135
050,18,041,"Indiana","Fayette County",4,24,275,149,126
050,18,041,"Indiana","Fayette County",4,25,281,133,148
050,18,041,"Indiana","Fayette County",4,26,258,124,134
050,18,041,"Indiana","Fayette County",4,27,257,131,126
050,18,041,"Indiana","Fayette County",4,28,262,133,129
050,18,041,"Indiana","Fayette County",4,29,307,160,147
050,18,041,"Indiana","Fayette County",4,30,301,151,150
050,18,041,"Indiana","Fayette County",4,31,274,134,140
050,18,041,"Indiana","Fayette County",4,32,255,130,125
050,18,041,"Indiana","Fayette County",4,33,271,135,136
050,18,041,"Indiana","Fayette County",4,34,249,117,132
050,18,041,"Indiana","Fayette County",4,35,260,126,134
050,18,041,"Indiana","Fayette County",4,36,239,124,115
050,18,041,"Indiana","Fayette County",4,37,231,117,114
050,18,041,"Indiana","Fayette County",4,38,232,111,121
050,18,041,"Indiana","Fayette County",4,39,249,116,133
050,18,041,"Indiana","Fayette County",4,40,253,120,133
050,18,041,"Indiana","Fayette County",4,41,272,126,146
050,18,041,"Indiana","Fayette County",4,42,283,132,151
050,18,041,"Indiana","Fayette County",4,43,302,143,159
050,18,041,"Indiana","Fayette County",4,44,298,161,137
050,18,041,"Indiana","Fayette County",4,45,300,154,146
050,18,041,"Indiana","Fayette County",4,46,302,145,157
050,18,041,"Indiana","Fayette County",4,47,317,153,164
050,18,041,"Indiana","Fayette County",4,48,306,151,155
050,18,041,"Indiana","Fayette County",4,49,290,153,137
050,18,041,"Indiana","Fayette County",4,50,296,160,136
050,18,041,"Indiana","Fayette County",4,51,339,185,154
050,18,041,"Indiana","Fayette County",4,52,309,163,146
050,18,041,"Indiana","Fayette County",4,53,309,167,142
050,18,041,"Indiana","Fayette County",4,54,277,141,136
050,18,041,"Indiana","Fayette County",4,55,283,145,138
050,18,041,"Indiana","Fayette County",4,56,319,167,152
050,18,041,"Indiana","Fayette County",4,57,345,178,167
050,18,041,"Indiana","Fayette County",4,58,340,173,167
050,18,041,"Indiana","Fayette County",4,59,315,158,157
050,18,041,"Indiana","Fayette County",4,60,300,148,152
050,18,041,"Indiana","Fayette County",4,61,315,144,171
050,18,041,"Indiana","Fayette County",4,62,303,145,158
050,18,041,"Indiana","Fayette County",4,63,309,153,156
050,18,041,"Indiana","Fayette County",4,64,296,138,158
050,18,041,"Indiana","Fayette County",4,65,317,147,170
050,18,041,"Indiana","Fayette County",4,66,315,140,175
050,18,041,"Indiana","Fayette County",4,67,321,155,166
050,18,041,"Indiana","Fayette County",4,68,301,144,157
050,18,041,"Indiana","Fayette County",4,69,318,157,161
050,18,041,"Indiana","Fayette County",4,70,304,149,155
050,18,041,"Indiana","Fayette County",4,71,287,138,149
050,18,041,"Indiana","Fayette County",4,72,262,126,136
050,18,041,"Indiana","Fayette County",4,73,244,119,125
050,18,041,"Indiana","Fayette County",4,74,242,101,141
050,18,041,"Indiana","Fayette County",4,75,261,119,142
050,18,041,"Indiana","Fayette County",4,76,167,77,90
050,18,041,"Indiana","Fayette County",4,77,168,76,92
050,18,041,"Indiana","Fayette County",4,78,158,68,90
050,18,041,"Indiana","Fayette County",4,79,161,74,87
050,18,041,"Indiana","Fayette County",4,80,138,65,73
050,18,041,"Indiana","Fayette County",4,81,139,66,73
050,18,041,"Indiana","Fayette County",4,82,105,44,61
050,18,041,"Indiana","Fayette County",4,83,91,42,49
050,18,041,"Indiana","Fayette County",4,84,86,42,44
050,18,041,"Indiana","Fayette County",4,85,493,190,303
050,18,041,"Indiana","Fayette County",5,0,241,116,125
050,18,041,"Indiana","Fayette County",5,1,256,110,146
050,18,041,"Indiana","Fayette County",5,2,265,143,122
050,18,041,"Indiana","Fayette County",5,3,288,142,146
050,18,041,"Indiana","Fayette County",5,4,284,146,138
050,18,041,"Indiana","Fayette County",5,5,282,146,136
050,18,041,"Indiana","Fayette County",5,6,283,141,142
050,18,041,"Indiana","Fayette County",5,7,251,126,125
050,18,041,"Indiana","Fayette County",5,8,270,140,130
050,18,041,"Indiana","Fayette County",5,9,281,145,136
050,18,041,"Indiana","Fayette County",5,10,289,167,122
050,18,041,"Indiana","Fayette County",5,11,258,136,122
050,18,041,"Indiana","Fayette County",5,12,267,141,126
050,18,041,"Indiana","Fayette County",5,13,315,155,160
050,18,041,"Indiana","Fayette County",5,14,305,152,153
050,18,041,"Indiana","Fayette County",5,15,313,151,162
050,18,041,"Indiana","Fayette County",5,16,340,162,178
050,18,041,"Indiana","Fayette County",5,17,331,161,170
050,18,041,"Indiana","Fayette County",5,18,289,142,147
050,18,041,"Indiana","Fayette County",5,19,223,125,98
050,18,041,"Indiana","Fayette County",5,20,221,117,104
050,18,041,"Indiana","Fayette County",5,21,258,135,123
050,18,041,"Indiana","Fayette County",5,22,297,140,157
050,18,041,"Indiana","Fayette County",5,23,291,152,139
050,18,041,"Indiana","Fayette County",5,24,287,152,135
050,18,041,"Indiana","Fayette County",5,25,288,154,134
050,18,041,"Indiana","Fayette County",5,26,284,140,144
050,18,041,"Indiana","Fayette County",5,27,255,123,132
050,18,041,"Indiana","Fayette County",5,28,238,118,120
050,18,041,"Indiana","Fayette County",5,29,281,141,140
050,18,041,"Indiana","Fayette County",5,30,313,166,147
050,18,041,"Indiana","Fayette County",5,31,309,153,156
050,18,041,"Indiana","Fayette County",5,32,280,138,142
050,18,041,"Indiana","Fayette County",5,33,270,138,132
050,18,041,"Indiana","Fayette County",5,34,250,125,125
050,18,041,"Indiana","Fayette County",5,35,257,121,136
050,18,041,"Indiana","Fayette County",5,36,253,119,134
050,18,041,"Indiana","Fayette County",5,37,220,112,108
050,18,041,"Indiana","Fayette County",5,38,228,118,110
050,18,041,"Indiana","Fayette County",5,39,234,104,130
050,18,041,"Indiana","Fayette County",5,40,244,116,128
050,18,041,"Indiana","Fayette County",5,41,252,119,133
050,18,041,"Indiana","Fayette County",5,42,268,126,142
050,18,041,"Indiana","Fayette County",5,43,275,126,149
050,18,041,"Indiana","Fayette County",5,44,296,139,157
050,18,041,"Indiana","Fayette County",5,45,303,160,143
050,18,041,"Indiana","Fayette County",5,46,293,149,144
050,18,041,"Indiana","Fayette County",5,47,305,148,157
050,18,041,"Indiana","Fayette County",5,48,326,158,168
050,18,041,"Indiana","Fayette County",5,49,317,159,158
050,18,041,"Indiana","Fayette County",5,50,298,156,142
050,18,041,"Indiana","Fayette County",5,51,283,153,130
050,18,041,"Indiana","Fayette County",5,52,339,185,154
050,18,041,"Indiana","Fayette County",5,53,313,163,150
050,18,041,"Indiana","Fayette County",5,54,296,158,138
050,18,041,"Indiana","Fayette County",5,55,270,141,129
050,18,041,"Indiana","Fayette County",5,56,285,149,136
050,18,041,"Indiana","Fayette County",5,57,327,175,152
050,18,041,"Indiana","Fayette County",5,58,337,169,168
050,18,041,"Indiana","Fayette County",5,59,330,169,161
050,18,041,"Indiana","Fayette County",5,60,310,156,154
050,18,041,"Indiana","Fayette County",5,61,299,147,152
050,18,041,"Indiana","Fayette County",5,62,316,143,173
050,18,041,"Indiana","Fayette County",5,63,304,145,159
050,18,041,"Indiana","Fayette County",5,64,300,149,151
050,18,041,"Indiana","Fayette County",5,65,289,137,152
050,18,041,"Indiana","Fayette County",5,66,310,146,164
050,18,041,"Indiana","Fayette County",5,67,319,142,177
050,18,041,"Indiana","Fayette County",5,68,311,147,164
050,18,041,"Indiana","Fayette County",5,69,303,148,155
050,18,041,"Indiana","Fayette County",5,70,309,153,156
050,18,041,"Indiana","Fayette County",5,71,293,141,152
050,18,041,"Indiana","Fayette County",5,72,285,137,148
050,18,041,"Indiana","Fayette County",5,73,253,121,132
050,18,041,"Indiana","Fayette County",5,74,237,112,125
050,18,041,"Indiana","Fayette County",5,75,229,96,133
050,18,041,"Indiana","Fayette County",5,76,243,107,136
050,18,041,"Indiana","Fayette County",5,77,160,77,83
050,18,041,"Indiana","Fayette County",5,78,156,69,87
050,18,041,"Indiana","Fayette County",5,79,149,64,85
050,18,041,"Indiana","Fayette County",5,80,145,67,78
050,18,041,"Indiana","Fayette County",5,81,134,62,72
050,18,041,"Indiana","Fayette County",5,82,124,59,65
050,18,041,"Indiana","Fayette County",5,83,94,44,50
050,18,041,"Indiana","Fayette County",5,84,86,36,50
050,18,041,"Indiana","Fayette County",5,85,502,200,302
050,18,043,"Indiana","Floyd County",1,0,854,438,416
050,18,043,"Indiana","Floyd County",1,1,904,470,434
050,18,043,"Indiana","Floyd County",1,2,949,502,447
050,18,043,"Indiana","Floyd County",1,3,977,525,452
050,18,043,"Indiana","Floyd County",1,4,1002,517,485
050,18,043,"Indiana","Floyd County",1,5,973,506,467
050,18,043,"Indiana","Floyd County",1,6,1013,517,496
050,18,043,"Indiana","Floyd County",1,7,945,489,456
050,18,043,"Indiana","Floyd County",1,8,1039,536,503
050,18,043,"Indiana","Floyd County",1,9,1021,527,494
050,18,043,"Indiana","Floyd County",1,10,1024,534,490
050,18,043,"Indiana","Floyd County",1,11,1054,534,520
050,18,043,"Indiana","Floyd County",1,12,1057,528,529
050,18,043,"Indiana","Floyd County",1,13,1073,568,505
050,18,043,"Indiana","Floyd County",1,14,1117,582,535
050,18,043,"Indiana","Floyd County",1,15,1118,539,579
050,18,043,"Indiana","Floyd County",1,16,1118,553,565
050,18,043,"Indiana","Floyd County",1,17,1081,570,511
050,18,043,"Indiana","Floyd County",1,18,956,501,455
050,18,043,"Indiana","Floyd County",1,19,932,453,479
050,18,043,"Indiana","Floyd County",1,20,888,420,468
050,18,043,"Indiana","Floyd County",1,21,904,458,446
050,18,043,"Indiana","Floyd County",1,22,914,437,477
050,18,043,"Indiana","Floyd County",1,23,965,477,488
050,18,043,"Indiana","Floyd County",1,24,986,490,496
050,18,043,"Indiana","Floyd County",1,25,999,525,474
050,18,043,"Indiana","Floyd County",1,26,1031,501,530
050,18,043,"Indiana","Floyd County",1,27,1016,513,503
050,18,043,"Indiana","Floyd County",1,28,1041,519,522
050,18,043,"Indiana","Floyd County",1,29,1083,521,562
050,18,043,"Indiana","Floyd County",1,30,1039,500,539
050,18,043,"Indiana","Floyd County",1,31,1027,515,512
050,18,043,"Indiana","Floyd County",1,32,970,486,484
050,18,043,"Indiana","Floyd County",1,33,945,480,465
050,18,043,"Indiana","Floyd County",1,34,1009,482,527
050,18,043,"Indiana","Floyd County",1,35,1023,468,555
050,18,043,"Indiana","Floyd County",1,36,1060,523,537
050,18,043,"Indiana","Floyd County",1,37,1083,523,560
050,18,043,"Indiana","Floyd County",1,38,1103,531,572
050,18,043,"Indiana","Floyd County",1,39,1096,528,568
050,18,043,"Indiana","Floyd County",1,40,1063,521,542
050,18,043,"Indiana","Floyd County",1,41,1033,502,531
050,18,043,"Indiana","Floyd County",1,42,1013,497,516
050,18,043,"Indiana","Floyd County",1,43,949,472,477
050,18,043,"Indiana","Floyd County",1,44,961,473,488
050,18,043,"Indiana","Floyd County",1,45,950,480,470
050,18,043,"Indiana","Floyd County",1,46,928,467,461
050,18,043,"Indiana","Floyd County",1,47,986,481,505
050,18,043,"Indiana","Floyd County",1,48,1084,545,539
050,18,043,"Indiana","Floyd County",1,49,1173,589,584
050,18,043,"Indiana","Floyd County",1,50,1095,528,567
050,18,043,"Indiana","Floyd County",1,51,1032,515,517
050,18,043,"Indiana","Floyd County",1,52,985,482,503
050,18,043,"Indiana","Floyd County",1,53,990,494,496
050,18,043,"Indiana","Floyd County",1,54,1062,524,538
050,18,043,"Indiana","Floyd County",1,55,1139,558,581
050,18,043,"Indiana","Floyd County",1,56,1159,580,579
050,18,043,"Indiana","Floyd County",1,57,1194,582,612
050,18,043,"Indiana","Floyd County",1,58,1179,583,596
050,18,043,"Indiana","Floyd County",1,59,1189,582,607
050,18,043,"Indiana","Floyd County",1,60,1145,572,573
050,18,043,"Indiana","Floyd County",1,61,1147,562,585
050,18,043,"Indiana","Floyd County",1,62,1114,557,557
050,18,043,"Indiana","Floyd County",1,63,1042,500,542
050,18,043,"Indiana","Floyd County",1,64,1040,499,541
050,18,043,"Indiana","Floyd County",1,65,1010,483,527
050,18,043,"Indiana","Floyd County",1,66,944,455,489
050,18,043,"Indiana","Floyd County",1,67,934,438,496
050,18,043,"Indiana","Floyd County",1,68,933,435,498
050,18,043,"Indiana","Floyd County",1,69,846,385,461
050,18,043,"Indiana","Floyd County",1,70,810,368,442
050,18,043,"Indiana","Floyd County",1,71,822,384,438
050,18,043,"Indiana","Floyd County",1,72,772,354,418
050,18,043,"Indiana","Floyd County",1,73,725,339,386
050,18,043,"Indiana","Floyd County",1,74,480,204,276
050,18,043,"Indiana","Floyd County",1,75,470,214,256
050,18,043,"Indiana","Floyd County",1,76,489,212,277
050,18,043,"Indiana","Floyd County",1,77,479,227,252
050,18,043,"Indiana","Floyd County",1,78,427,191,236
050,18,043,"Indiana","Floyd County",1,79,392,162,230
050,18,043,"Indiana","Floyd County",1,80,357,144,213
050,18,043,"Indiana","Floyd County",1,81,319,125,194
050,18,043,"Indiana","Floyd County",1,82,271,97,174
050,18,043,"Indiana","Floyd County",1,83,260,93,167
050,18,043,"Indiana","Floyd County",1,84,238,91,147
050,18,043,"Indiana","Floyd County",1,85,1460,470,990
050,18,043,"Indiana","Floyd County",2,0,831,422,409
050,18,043,"Indiana","Floyd County",2,1,898,468,430
050,18,043,"Indiana","Floyd County",2,2,942,502,440
050,18,043,"Indiana","Floyd County",2,3,971,521,450
050,18,043,"Indiana","Floyd County",2,4,1002,523,479
050,18,043,"Indiana","Floyd County",2,5,985,509,476
050,18,043,"Indiana","Floyd County",2,6,1010,516,494
050,18,043,"Indiana","Floyd County",2,7,966,498,468
050,18,043,"Indiana","Floyd County",2,8,1016,525,491
050,18,043,"Indiana","Floyd County",2,9,1030,533,497
050,18,043,"Indiana","Floyd County",2,10,1027,534,493
050,18,043,"Indiana","Floyd County",2,11,1043,532,511
050,18,043,"Indiana","Floyd County",2,12,1066,533,533
050,18,043,"Indiana","Floyd County",2,13,1077,565,512
050,18,043,"Indiana","Floyd County",2,14,1108,579,529
050,18,043,"Indiana","Floyd County",2,15,1126,549,577
050,18,043,"Indiana","Floyd County",2,16,1119,549,570
050,18,043,"Indiana","Floyd County",2,17,1089,564,525
050,18,043,"Indiana","Floyd County",2,18,953,496,457
050,18,043,"Indiana","Floyd County",2,19,935,460,475
050,18,043,"Indiana","Floyd County",2,20,900,425,475
050,18,043,"Indiana","Floyd County",2,21,894,449,445
050,18,043,"Indiana","Floyd County",2,22,915,441,474
050,18,043,"Indiana","Floyd County",2,23,964,476,488
050,18,043,"Indiana","Floyd County",2,24,978,487,491
050,18,043,"Indiana","Floyd County",2,25,993,514,479
050,18,043,"Indiana","Floyd County",2,26,1022,506,516
050,18,043,"Indiana","Floyd County",2,27,1016,509,507
050,18,043,"Indiana","Floyd County",2,28,1039,520,519
050,18,043,"Indiana","Floyd County",2,29,1072,519,553
050,18,043,"Indiana","Floyd County",2,30,1064,513,551
050,18,043,"Indiana","Floyd County",2,31,1034,517,517
050,18,043,"Indiana","Floyd County",2,32,977,490,487
050,18,043,"Indiana","Floyd County",2,33,951,481,470
050,18,043,"Indiana","Floyd County",2,34,996,480,516
050,18,043,"Indiana","Floyd County",2,35,1036,480,556
050,18,043,"Indiana","Floyd County",2,36,1051,510,541
050,18,043,"Indiana","Floyd County",2,37,1082,526,556
050,18,043,"Indiana","Floyd County",2,38,1107,535,572
050,18,043,"Indiana","Floyd County",2,39,1095,527,568
050,18,043,"Indiana","Floyd County",2,40,1079,527,552
050,18,043,"Indiana","Floyd County",2,41,1043,510,533
050,18,043,"Indiana","Floyd County",2,42,1014,496,518
050,18,043,"Indiana","Floyd County",2,43,981,487,494
050,18,043,"Indiana","Floyd County",2,44,949,469,480
050,18,043,"Indiana","Floyd County",2,45,957,481,476
050,18,043,"Indiana","Floyd County",2,46,924,467,457
050,18,043,"Indiana","Floyd County",2,47,970,479,491
050,18,043,"Indiana","Floyd County",2,48,1056,526,530
050,18,043,"Indiana","Floyd County",2,49,1148,576,572
050,18,043,"Indiana","Floyd County",2,50,1118,544,574
050,18,043,"Indiana","Floyd County",2,51,1042,516,526
050,18,043,"Indiana","Floyd County",2,52,988,484,504
050,18,043,"Indiana","Floyd County",2,53,995,495,500
050,18,043,"Indiana","Floyd County",2,54,1036,513,523
050,18,043,"Indiana","Floyd County",2,55,1124,554,570
050,18,043,"Indiana","Floyd County",2,56,1151,575,576
050,18,043,"Indiana","Floyd County",2,57,1184,583,601
050,18,043,"Indiana","Floyd County",2,58,1177,580,597
050,18,043,"Indiana","Floyd County",2,59,1188,581,607
050,18,043,"Indiana","Floyd County",2,60,1149,572,577
050,18,043,"Indiana","Floyd County",2,61,1139,560,579
050,18,043,"Indiana","Floyd County",2,62,1118,556,562
050,18,043,"Indiana","Floyd County",2,63,1067,519,548
050,18,043,"Indiana","Floyd County",2,64,1035,498,537
050,18,043,"Indiana","Floyd County",2,65,1013,484,529
050,18,043,"Indiana","Floyd County",2,66,957,460,497
050,18,043,"Indiana","Floyd County",2,67,922,434,488
050,18,043,"Indiana","Floyd County",2,68,919,429,490
050,18,043,"Indiana","Floyd County",2,69,872,399,473
050,18,043,"Indiana","Floyd County",2,70,813,371,442
050,18,043,"Indiana","Floyd County",2,71,816,378,438
050,18,043,"Indiana","Floyd County",2,72,759,348,411
050,18,043,"Indiana","Floyd County",2,73,756,353,403
050,18,043,"Indiana","Floyd County",2,74,510,224,286
050,18,043,"Indiana","Floyd County",2,75,466,207,259
050,18,043,"Indiana","Floyd County",2,76,477,208,269
050,18,043,"Indiana","Floyd County",2,77,484,226,258
050,18,043,"Indiana","Floyd County",2,78,426,190,236
050,18,043,"Indiana","Floyd County",2,79,396,162,234
050,18,043,"Indiana","Floyd County",2,80,356,144,212
050,18,043,"Indiana","Floyd County",2,81,328,130,198
050,18,043,"Indiana","Floyd County",2,82,282,104,178
050,18,043,"Indiana","Floyd County",2,83,257,90,167
050,18,043,"Indiana","Floyd County",2,84,236,87,149
050,18,043,"Indiana","Floyd County",2,85,1462,469,993
050,18,043,"Indiana","Floyd County",3,0,811,403,408
050,18,043,"Indiana","Floyd County",3,1,875,438,437
050,18,043,"Indiana","Floyd County",3,2,899,472,427
050,18,043,"Indiana","Floyd County",3,3,950,502,448
050,18,043,"Indiana","Floyd County",3,4,979,519,460
050,18,043,"Indiana","Floyd County",3,5,1041,530,511
050,18,043,"Indiana","Floyd County",3,6,980,503,477
050,18,043,"Indiana","Floyd County",3,7,1044,537,507
050,18,043,"Indiana","Floyd County",3,8,971,496,475
050,18,043,"Indiana","Floyd County",3,9,1020,519,501
050,18,043,"Indiana","Floyd County",3,10,1037,540,497
050,18,043,"Indiana","Floyd County",3,11,1023,523,500
050,18,043,"Indiana","Floyd County",3,12,1054,551,503
050,18,043,"Indiana","Floyd County",3,13,1102,559,543
050,18,043,"Indiana","Floyd County",3,14,1088,562,526
050,18,043,"Indiana","Floyd County",3,15,1130,579,551
050,18,043,"Indiana","Floyd County",3,16,1120,547,573
050,18,043,"Indiana","Floyd County",3,17,1100,542,558
050,18,043,"Indiana","Floyd County",3,18,978,500,478
050,18,043,"Indiana","Floyd County",3,19,922,472,450
050,18,043,"Indiana","Floyd County",3,20,886,426,460
050,18,043,"Indiana","Floyd County",3,21,917,437,480
050,18,043,"Indiana","Floyd County",3,22,916,447,469
050,18,043,"Indiana","Floyd County",3,23,940,479,461
050,18,043,"Indiana","Floyd County",3,24,967,485,482
050,18,043,"Indiana","Floyd County",3,25,983,511,472
050,18,043,"Indiana","Floyd County",3,26,1006,522,484
050,18,043,"Indiana","Floyd County",3,27,1003,493,510
050,18,043,"Indiana","Floyd County",3,28,1027,511,516
050,18,043,"Indiana","Floyd County",3,29,1045,534,511
050,18,043,"Indiana","Floyd County",3,30,1080,528,552
050,18,043,"Indiana","Floyd County",3,31,1083,512,571
050,18,043,"Indiana","Floyd County",3,32,1006,507,499
050,18,043,"Indiana","Floyd County",3,33,1005,511,494
050,18,043,"Indiana","Floyd County",3,34,963,488,475
050,18,043,"Indiana","Floyd County",3,35,1009,477,532
050,18,043,"Indiana","Floyd County",3,36,1040,489,551
050,18,043,"Indiana","Floyd County",3,37,1074,522,552
050,18,043,"Indiana","Floyd County",3,38,1097,540,557
050,18,043,"Indiana","Floyd County",3,39,1109,531,578
050,18,043,"Indiana","Floyd County",3,40,1089,529,560
050,18,043,"Indiana","Floyd County",3,41,1091,535,556
050,18,043,"Indiana","Floyd County",3,42,1045,508,537
050,18,043,"Indiana","Floyd County",3,43,1024,489,535
050,18,043,"Indiana","Floyd County",3,44,1002,499,503
050,18,043,"Indiana","Floyd County",3,45,950,467,483
050,18,043,"Indiana","Floyd County",3,46,960,489,471
050,18,043,"Indiana","Floyd County",3,47,940,482,458
050,18,043,"Indiana","Floyd County",3,48,975,482,493
050,18,043,"Indiana","Floyd County",3,49,1052,517,535
050,18,043,"Indiana","Floyd County",3,50,1126,553,573
050,18,043,"Indiana","Floyd County",3,51,1104,541,563
050,18,043,"Indiana","Floyd County",3,52,1041,510,531
050,18,043,"Indiana","Floyd County",3,53,985,480,505
050,18,043,"Indiana","Floyd County",3,54,990,503,487
050,18,043,"Indiana","Floyd County",3,55,1020,507,513
050,18,043,"Indiana","Floyd County",3,56,1111,543,568
050,18,043,"Indiana","Floyd County",3,57,1122,563,559
050,18,043,"Indiana","Floyd County",3,58,1161,569,592
050,18,043,"Indiana","Floyd County",3,59,1166,565,601
050,18,043,"Indiana","Floyd County",3,60,1173,577,596
050,18,043,"Indiana","Floyd County",3,61,1131,563,568
050,18,043,"Indiana","Floyd County",3,62,1107,541,566
050,18,043,"Indiana","Floyd County",3,63,1090,529,561
050,18,043,"Indiana","Floyd County",3,64,1056,508,548
050,18,043,"Indiana","Floyd County",3,65,1007,473,534
050,18,043,"Indiana","Floyd County",3,66,991,469,522
050,18,043,"Indiana","Floyd County",3,67,916,430,486
050,18,043,"Indiana","Floyd County",3,68,893,418,475
050,18,043,"Indiana","Floyd County",3,69,888,404,484
050,18,043,"Indiana","Floyd County",3,70,836,380,456
050,18,043,"Indiana","Floyd County",3,71,803,365,438
050,18,043,"Indiana","Floyd County",3,72,786,363,423
050,18,043,"Indiana","Floyd County",3,73,714,322,392
050,18,043,"Indiana","Floyd County",3,74,744,340,404
050,18,043,"Indiana","Floyd County",3,75,487,213,274
050,18,043,"Indiana","Floyd County",3,76,468,201,267
050,18,043,"Indiana","Floyd County",3,77,447,199,248
050,18,043,"Indiana","Floyd County",3,78,449,198,251
050,18,043,"Indiana","Floyd County",3,79,426,177,249
050,18,043,"Indiana","Floyd County",3,80,352,143,209
050,18,043,"Indiana","Floyd County",3,81,337,131,206
050,18,043,"Indiana","Floyd County",3,82,306,123,183
050,18,043,"Indiana","Floyd County",3,83,268,98,170
050,18,043,"Indiana","Floyd County",3,84,238,84,154
050,18,043,"Indiana","Floyd County",3,85,1448,465,983
050,18,043,"Indiana","Floyd County",4,0,774,400,374
050,18,043,"Indiana","Floyd County",4,1,790,415,375
050,18,043,"Indiana","Floyd County",4,2,920,452,468
050,18,043,"Indiana","Floyd County",4,3,904,459,445
050,18,043,"Indiana","Floyd County",4,4,943,500,443
050,18,043,"Indiana","Floyd County",4,5,1006,523,483
050,18,043,"Indiana","Floyd County",4,6,1051,532,519
050,18,043,"Indiana","Floyd County",4,7,1044,534,510
050,18,043,"Indiana","Floyd County",4,8,1057,537,520
050,18,043,"Indiana","Floyd County",4,9,994,514,480
050,18,043,"Indiana","Floyd County",4,10,1050,529,521
050,18,043,"Indiana","Floyd County",4,11,1048,541,507
050,18,043,"Indiana","Floyd County",4,12,1042,534,508
050,18,043,"Indiana","Floyd County",4,13,1049,560,489
050,18,043,"Indiana","Floyd County",4,14,1098,555,543
050,18,043,"Indiana","Floyd County",4,15,1087,560,527
050,18,043,"Indiana","Floyd County",4,16,1125,578,547
050,18,043,"Indiana","Floyd County",4,17,1136,571,565
050,18,043,"Indiana","Floyd County",4,18,953,473,480
050,18,043,"Indiana","Floyd County",4,19,894,447,447
050,18,043,"Indiana","Floyd County",4,20,872,446,426
050,18,043,"Indiana","Floyd County",4,21,894,455,439
050,18,043,"Indiana","Floyd County",4,22,974,454,520
050,18,043,"Indiana","Floyd County",4,23,927,457,470
050,18,043,"Indiana","Floyd County",4,24,949,478,471
050,18,043,"Indiana","Floyd County",4,25,968,496,472
050,18,043,"Indiana","Floyd County",4,26,944,491,453
050,18,043,"Indiana","Floyd County",4,27,964,498,466
050,18,043,"Indiana","Floyd County",4,28,997,483,514
050,18,043,"Indiana","Floyd County",4,29,1008,504,504
050,18,043,"Indiana","Floyd County",4,30,1092,561,531
050,18,043,"Indiana","Floyd County",4,31,1087,539,548
050,18,043,"Indiana","Floyd County",4,32,1087,515,572
050,18,043,"Indiana","Floyd County",4,33,1028,522,506
050,18,043,"Indiana","Floyd County",4,34,1034,524,510
050,18,043,"Indiana","Floyd County",4,35,967,486,481
050,18,043,"Indiana","Floyd County",4,36,1035,489,546
050,18,043,"Indiana","Floyd County",4,37,1062,504,558
050,18,043,"Indiana","Floyd County",4,38,1098,535,563
050,18,043,"Indiana","Floyd County",4,39,1102,547,555
050,18,043,"Indiana","Floyd County",4,40,1119,540,579
050,18,043,"Indiana","Floyd County",4,41,1112,555,557
050,18,043,"Indiana","Floyd County",4,42,1080,521,559
050,18,043,"Indiana","Floyd County",4,43,1081,529,552
050,18,043,"Indiana","Floyd County",4,44,1014,491,523
050,18,043,"Indiana","Floyd County",4,45,986,489,497
050,18,043,"Indiana","Floyd County",4,46,958,479,479
050,18,043,"Indiana","Floyd County",4,47,966,490,476
050,18,043,"Indiana","Floyd County",4,48,931,472,459
050,18,043,"Indiana","Floyd County",4,49,953,463,490
050,18,043,"Indiana","Floyd County",4,50,1056,515,541
050,18,043,"Indiana","Floyd County",4,51,1128,557,571
050,18,043,"Indiana","Floyd County",4,52,1067,519,548
050,18,043,"Indiana","Floyd County",4,53,1045,519,526
050,18,043,"Indiana","Floyd County",4,54,955,470,485
050,18,043,"Indiana","Floyd County",4,55,1010,508,502
050,18,043,"Indiana","Floyd County",4,56,1005,505,500
050,18,043,"Indiana","Floyd County",4,57,1083,529,554
050,18,043,"Indiana","Floyd County",4,58,1105,551,554
050,18,043,"Indiana","Floyd County",4,59,1167,568,599
050,18,043,"Indiana","Floyd County",4,60,1147,556,591
050,18,043,"Indiana","Floyd County",4,61,1142,561,581
050,18,043,"Indiana","Floyd County",4,62,1125,552,573
050,18,043,"Indiana","Floyd County",4,63,1087,532,555
050,18,043,"Indiana","Floyd County",4,64,1099,534,565
050,18,043,"Indiana","Floyd County",4,65,1009,481,528
050,18,043,"Indiana","Floyd County",4,66,991,471,520
050,18,043,"Indiana","Floyd County",4,67,955,449,506
050,18,043,"Indiana","Floyd County",4,68,879,415,464
050,18,043,"Indiana","Floyd County",4,69,878,404,474
050,18,043,"Indiana","Floyd County",4,70,856,389,467
050,18,043,"Indiana","Floyd County",4,71,817,368,449
050,18,043,"Indiana","Floyd County",4,72,780,356,424
050,18,043,"Indiana","Floyd County",4,73,748,342,406
050,18,043,"Indiana","Floyd County",4,74,708,313,395
050,18,043,"Indiana","Floyd County",4,75,726,327,399
050,18,043,"Indiana","Floyd County",4,76,493,213,280
050,18,043,"Indiana","Floyd County",4,77,442,202,240
050,18,043,"Indiana","Floyd County",4,78,419,179,240
050,18,043,"Indiana","Floyd County",4,79,438,186,252
050,18,043,"Indiana","Floyd County",4,80,384,159,225
050,18,043,"Indiana","Floyd County",4,81,338,132,206
050,18,043,"Indiana","Floyd County",4,82,311,126,185
050,18,043,"Indiana","Floyd County",4,83,283,112,171
050,18,043,"Indiana","Floyd County",4,84,250,89,161
050,18,043,"Indiana","Floyd County",4,85,1441,454,987
050,18,043,"Indiana","Floyd County",5,0,704,361,343
050,18,043,"Indiana","Floyd County",5,1,818,421,397
050,18,043,"Indiana","Floyd County",5,2,800,404,396
050,18,043,"Indiana","Floyd County",5,3,936,448,488
050,18,043,"Indiana","Floyd County",5,4,930,491,439
050,18,043,"Indiana","Floyd County",5,5,952,481,471
050,18,043,"Indiana","Floyd County",5,6,1044,536,508
050,18,043,"Indiana","Floyd County",5,7,1038,520,518
050,18,043,"Indiana","Floyd County",5,8,1049,538,511
050,18,043,"Indiana","Floyd County",5,9,1045,517,528
050,18,043,"Indiana","Floyd County",5,10,1000,532,468
050,18,043,"Indiana","Floyd County",5,11,1033,520,513
050,18,043,"Indiana","Floyd County",5,12,1041,542,499
050,18,043,"Indiana","Floyd County",5,13,1041,540,501
050,18,043,"Indiana","Floyd County",5,14,1079,574,505
050,18,043,"Indiana","Floyd County",5,15,1117,557,560
050,18,043,"Indiana","Floyd County",5,16,1096,565,531
050,18,043,"Indiana","Floyd County",5,17,1114,584,530
050,18,043,"Indiana","Floyd County",5,18,998,503,495
050,18,043,"Indiana","Floyd County",5,19,924,460,464
050,18,043,"Indiana","Floyd County",5,20,823,409,414
050,18,043,"Indiana","Floyd County",5,21,902,467,435
050,18,043,"Indiana","Floyd County",5,22,961,471,490
050,18,043,"Indiana","Floyd County",5,23,988,463,525
050,18,043,"Indiana","Floyd County",5,24,951,465,486
050,18,043,"Indiana","Floyd County",5,25,1014,528,486
050,18,043,"Indiana","Floyd County",5,26,983,504,479
050,18,043,"Indiana","Floyd County",5,27,921,485,436
050,18,043,"Indiana","Floyd County",5,28,992,520,472
050,18,043,"Indiana","Floyd County",5,29,1003,478,525
050,18,043,"Indiana","Floyd County",5,30,1034,517,517
050,18,043,"Indiana","Floyd County",5,31,1088,548,540
050,18,043,"Indiana","Floyd County",5,32,1052,518,534
050,18,043,"Indiana","Floyd County",5,33,1088,525,563
050,18,043,"Indiana","Floyd County",5,34,1061,546,515
050,18,043,"Indiana","Floyd County",5,35,1048,527,521
050,18,043,"Indiana","Floyd County",5,36,990,503,487
050,18,043,"Indiana","Floyd County",5,37,1053,491,562
050,18,043,"Indiana","Floyd County",5,38,1057,502,555
050,18,043,"Indiana","Floyd County",5,39,1107,539,568
050,18,043,"Indiana","Floyd County",5,40,1105,538,567
050,18,043,"Indiana","Floyd County",5,41,1148,556,592
050,18,043,"Indiana","Floyd County",5,42,1120,549,571
050,18,043,"Indiana","Floyd County",5,43,1074,524,550
050,18,043,"Indiana","Floyd County",5,44,1081,532,549
050,18,043,"Indiana","Floyd County",5,45,1020,493,527
050,18,043,"Indiana","Floyd County",5,46,1003,507,496
050,18,043,"Indiana","Floyd County",5,47,951,474,477
050,18,043,"Indiana","Floyd County",5,48,946,474,472
050,18,043,"Indiana","Floyd County",5,49,936,463,473
050,18,043,"Indiana","Floyd County",5,50,960,469,491
050,18,043,"Indiana","Floyd County",5,51,1044,511,533
050,18,043,"Indiana","Floyd County",5,52,1143,567,576
050,18,043,"Indiana","Floyd County",5,53,1074,523,551
050,18,043,"Indiana","Floyd County",5,54,1007,509,498
050,18,043,"Indiana","Floyd County",5,55,947,462,485
050,18,043,"Indiana","Floyd County",5,56,998,509,489
050,18,043,"Indiana","Floyd County",5,57,1000,502,498
050,18,043,"Indiana","Floyd County",5,58,1077,528,549
050,18,043,"Indiana","Floyd County",5,59,1091,537,554
050,18,043,"Indiana","Floyd County",5,60,1154,571,583
050,18,043,"Indiana","Floyd County",5,61,1135,554,581
050,18,043,"Indiana","Floyd County",5,62,1128,549,579
050,18,043,"Indiana","Floyd County",5,63,1104,540,564
050,18,043,"Indiana","Floyd County",5,64,1076,526,550
050,18,043,"Indiana","Floyd County",5,65,1068,514,554
050,18,043,"Indiana","Floyd County",5,66,989,467,522
050,18,043,"Indiana","Floyd County",5,67,982,456,526
050,18,043,"Indiana","Floyd County",5,68,932,437,495
050,18,043,"Indiana","Floyd County",5,69,863,399,464
050,18,043,"Indiana","Floyd County",5,70,852,394,458
050,18,043,"Indiana","Floyd County",5,71,848,379,469
050,18,043,"Indiana","Floyd County",5,72,786,351,435
050,18,043,"Indiana","Floyd County",5,73,736,329,407
050,18,043,"Indiana","Floyd County",5,74,746,334,412
050,18,043,"Indiana","Floyd County",5,75,678,291,387
050,18,043,"Indiana","Floyd County",5,76,731,325,406
050,18,043,"Indiana","Floyd County",5,77,469,210,259
050,18,043,"Indiana","Floyd County",5,78,420,188,232
050,18,043,"Indiana","Floyd County",5,79,419,168,251
050,18,043,"Indiana","Floyd County",5,80,392,169,223
050,18,043,"Indiana","Floyd County",5,81,365,149,216
050,18,043,"Indiana","Floyd County",5,82,323,132,191
050,18,043,"Indiana","Floyd County",5,83,296,117,179
050,18,043,"Indiana","Floyd County",5,84,263,101,162
050,18,043,"Indiana","Floyd County",5,85,1454,457,997
050,18,045,"Indiana","Fountain County",1,0,197,100,97
050,18,045,"Indiana","Fountain County",1,1,208,107,101
050,18,045,"Indiana","Fountain County",1,2,196,100,96
050,18,045,"Indiana","Fountain County",1,3,163,84,79
050,18,045,"Indiana","Fountain County",1,4,188,99,89
050,18,045,"Indiana","Fountain County",1,5,207,119,88
050,18,045,"Indiana","Fountain County",1,6,194,108,86
050,18,045,"Indiana","Fountain County",1,7,185,103,82
050,18,045,"Indiana","Fountain County",1,8,197,104,93
050,18,045,"Indiana","Fountain County",1,9,194,103,91
050,18,045,"Indiana","Fountain County",1,10,230,130,100
050,18,045,"Indiana","Fountain County",1,11,206,102,104
050,18,045,"Indiana","Fountain County",1,12,206,111,95
050,18,045,"Indiana","Fountain County",1,13,195,104,91
050,18,045,"Indiana","Fountain County",1,14,210,112,98
050,18,045,"Indiana","Fountain County",1,15,202,103,99
050,18,045,"Indiana","Fountain County",1,16,227,115,112
050,18,045,"Indiana","Fountain County",1,17,222,119,103
050,18,045,"Indiana","Fountain County",1,18,186,97,89
050,18,045,"Indiana","Fountain County",1,19,145,74,71
050,18,045,"Indiana","Fountain County",1,20,173,85,88
050,18,045,"Indiana","Fountain County",1,21,190,101,89
050,18,045,"Indiana","Fountain County",1,22,189,90,99
050,18,045,"Indiana","Fountain County",1,23,198,94,104
050,18,045,"Indiana","Fountain County",1,24,198,107,91
050,18,045,"Indiana","Fountain County",1,25,206,111,95
050,18,045,"Indiana","Fountain County",1,26,206,107,99
050,18,045,"Indiana","Fountain County",1,27,209,105,104
050,18,045,"Indiana","Fountain County",1,28,199,98,101
050,18,045,"Indiana","Fountain County",1,29,183,93,90
050,18,045,"Indiana","Fountain County",1,30,189,93,96
050,18,045,"Indiana","Fountain County",1,31,185,88,97
050,18,045,"Indiana","Fountain County",1,32,176,84,92
050,18,045,"Indiana","Fountain County",1,33,157,80,77
050,18,045,"Indiana","Fountain County",1,34,173,83,90
050,18,045,"Indiana","Fountain County",1,35,180,99,81
050,18,045,"Indiana","Fountain County",1,36,177,98,79
050,18,045,"Indiana","Fountain County",1,37,212,105,107
050,18,045,"Indiana","Fountain County",1,38,189,96,93
050,18,045,"Indiana","Fountain County",1,39,174,84,90
050,18,045,"Indiana","Fountain County",1,40,180,88,92
050,18,045,"Indiana","Fountain County",1,41,182,100,82
050,18,045,"Indiana","Fountain County",1,42,185,94,91
050,18,045,"Indiana","Fountain County",1,43,177,94,83
050,18,045,"Indiana","Fountain County",1,44,198,93,105
050,18,045,"Indiana","Fountain County",1,45,182,84,98
050,18,045,"Indiana","Fountain County",1,46,178,87,91
050,18,045,"Indiana","Fountain County",1,47,185,88,97
050,18,045,"Indiana","Fountain County",1,48,221,107,114
050,18,045,"Indiana","Fountain County",1,49,241,124,117
050,18,045,"Indiana","Fountain County",1,50,239,124,115
050,18,045,"Indiana","Fountain County",1,51,231,114,117
050,18,045,"Indiana","Fountain County",1,52,218,109,109
050,18,045,"Indiana","Fountain County",1,53,219,114,105
050,18,045,"Indiana","Fountain County",1,54,224,117,107
050,18,045,"Indiana","Fountain County",1,55,238,118,120
050,18,045,"Indiana","Fountain County",1,56,243,116,127
050,18,045,"Indiana","Fountain County",1,57,262,135,127
050,18,045,"Indiana","Fountain County",1,58,258,132,126
050,18,045,"Indiana","Fountain County",1,59,242,123,119
050,18,045,"Indiana","Fountain County",1,60,254,130,124
050,18,045,"Indiana","Fountain County",1,61,252,128,124
050,18,045,"Indiana","Fountain County",1,62,226,109,117
050,18,045,"Indiana","Fountain County",1,63,220,109,111
050,18,045,"Indiana","Fountain County",1,64,238,127,111
050,18,045,"Indiana","Fountain County",1,65,213,100,113
050,18,045,"Indiana","Fountain County",1,66,194,86,108
050,18,045,"Indiana","Fountain County",1,67,194,91,103
050,18,045,"Indiana","Fountain County",1,68,199,96,103
050,18,045,"Indiana","Fountain County",1,69,183,99,84
050,18,045,"Indiana","Fountain County",1,70,182,99,83
050,18,045,"Indiana","Fountain County",1,71,167,89,78
050,18,045,"Indiana","Fountain County",1,72,185,82,103
050,18,045,"Indiana","Fountain County",1,73,187,89,98
050,18,045,"Indiana","Fountain County",1,74,145,66,79
050,18,045,"Indiana","Fountain County",1,75,146,68,78
050,18,045,"Indiana","Fountain County",1,76,140,67,73
050,18,045,"Indiana","Fountain County",1,77,129,65,64
050,18,045,"Indiana","Fountain County",1,78,110,53,57
050,18,045,"Indiana","Fountain County",1,79,109,49,60
050,18,045,"Indiana","Fountain County",1,80,89,36,53
050,18,045,"Indiana","Fountain County",1,81,93,41,52
050,18,045,"Indiana","Fountain County",1,82,89,35,54
050,18,045,"Indiana","Fountain County",1,83,68,34,34
050,18,045,"Indiana","Fountain County",1,84,64,27,37
050,18,045,"Indiana","Fountain County",1,85,380,131,249
050,18,045,"Indiana","Fountain County",2,0,189,98,91
050,18,045,"Indiana","Fountain County",2,1,205,106,99
050,18,045,"Indiana","Fountain County",2,2,198,102,96
050,18,045,"Indiana","Fountain County",2,3,173,88,85
050,18,045,"Indiana","Fountain County",2,4,185,97,88
050,18,045,"Indiana","Fountain County",2,5,203,116,87
050,18,045,"Indiana","Fountain County",2,6,198,111,87
050,18,045,"Indiana","Fountain County",2,7,188,104,84
050,18,045,"Indiana","Fountain County",2,8,195,103,92
050,18,045,"Indiana","Fountain County",2,9,196,104,92
050,18,045,"Indiana","Fountain County",2,10,220,121,99
050,18,045,"Indiana","Fountain County",2,11,208,107,101
050,18,045,"Indiana","Fountain County",2,12,205,108,97
050,18,045,"Indiana","Fountain County",2,13,196,105,91
050,18,045,"Indiana","Fountain County",2,14,207,110,97
050,18,045,"Indiana","Fountain County",2,15,205,106,99
050,18,045,"Indiana","Fountain County",2,16,222,113,109
050,18,045,"Indiana","Fountain County",2,17,221,117,104
050,18,045,"Indiana","Fountain County",2,18,182,96,86
050,18,045,"Indiana","Fountain County",2,19,146,75,71
050,18,045,"Indiana","Fountain County",2,20,172,84,88
050,18,045,"Indiana","Fountain County",2,21,190,99,91
050,18,045,"Indiana","Fountain County",2,22,198,97,101
050,18,045,"Indiana","Fountain County",2,23,200,96,104
050,18,045,"Indiana","Fountain County",2,24,205,107,98
050,18,045,"Indiana","Fountain County",2,25,205,111,94
050,18,045,"Indiana","Fountain County",2,26,208,109,99
050,18,045,"Indiana","Fountain County",2,27,211,108,103
050,18,045,"Indiana","Fountain County",2,28,203,101,102
050,18,045,"Indiana","Fountain County",2,29,188,94,94
050,18,045,"Indiana","Fountain County",2,30,189,94,95
050,18,045,"Indiana","Fountain County",2,31,189,91,98
050,18,045,"Indiana","Fountain County",2,32,178,86,92
050,18,045,"Indiana","Fountain County",2,33,159,79,80
050,18,045,"Indiana","Fountain County",2,34,171,84,87
050,18,045,"Indiana","Fountain County",2,35,179,96,83
050,18,045,"Indiana","Fountain County",2,36,174,95,79
050,18,045,"Indiana","Fountain County",2,37,204,103,101
050,18,045,"Indiana","Fountain County",2,38,195,100,95
050,18,045,"Indiana","Fountain County",2,39,177,87,90
050,18,045,"Indiana","Fountain County",2,40,180,87,93
050,18,045,"Indiana","Fountain County",2,41,181,97,84
050,18,045,"Indiana","Fountain County",2,42,181,95,86
050,18,045,"Indiana","Fountain County",2,43,182,96,86
050,18,045,"Indiana","Fountain County",2,44,189,93,96
050,18,045,"Indiana","Fountain County",2,45,188,88,100
050,18,045,"Indiana","Fountain County",2,46,178,86,92
050,18,045,"Indiana","Fountain County",2,47,184,88,96
050,18,045,"Indiana","Fountain County",2,48,214,103,111
050,18,045,"Indiana","Fountain County",2,49,236,122,114
050,18,045,"Indiana","Fountain County",2,50,241,124,117
050,18,045,"Indiana","Fountain County",2,51,233,116,117
050,18,045,"Indiana","Fountain County",2,52,221,110,111
050,18,045,"Indiana","Fountain County",2,53,218,112,106
050,18,045,"Indiana","Fountain County",2,54,224,117,107
050,18,045,"Indiana","Fountain County",2,55,233,117,116
050,18,045,"Indiana","Fountain County",2,56,245,118,127
050,18,045,"Indiana","Fountain County",2,57,257,129,128
050,18,045,"Indiana","Fountain County",2,58,258,131,127
050,18,045,"Indiana","Fountain County",2,59,248,126,122
050,18,045,"Indiana","Fountain County",2,60,250,129,121
050,18,045,"Indiana","Fountain County",2,61,252,129,123
050,18,045,"Indiana","Fountain County",2,62,231,112,119
050,18,045,"Indiana","Fountain County",2,63,220,110,110
050,18,045,"Indiana","Fountain County",2,64,232,121,111
050,18,045,"Indiana","Fountain County",2,65,220,107,113
050,18,045,"Indiana","Fountain County",2,66,196,87,109
050,18,045,"Indiana","Fountain County",2,67,189,86,103
050,18,045,"Indiana","Fountain County",2,68,194,93,101
050,18,045,"Indiana","Fountain County",2,69,187,98,89
050,18,045,"Indiana","Fountain County",2,70,182,99,83
050,18,045,"Indiana","Fountain County",2,71,170,91,79
050,18,045,"Indiana","Fountain County",2,72,177,81,96
050,18,045,"Indiana","Fountain County",2,73,196,91,105
050,18,045,"Indiana","Fountain County",2,74,144,66,78
050,18,045,"Indiana","Fountain County",2,75,143,67,76
050,18,045,"Indiana","Fountain County",2,76,141,66,75
050,18,045,"Indiana","Fountain County",2,77,132,66,66
050,18,045,"Indiana","Fountain County",2,78,113,55,58
050,18,045,"Indiana","Fountain County",2,79,107,49,58
050,18,045,"Indiana","Fountain County",2,80,94,39,55
050,18,045,"Indiana","Fountain County",2,81,94,41,53
050,18,045,"Indiana","Fountain County",2,82,90,36,54
050,18,045,"Indiana","Fountain County",2,83,71,33,38
050,18,045,"Indiana","Fountain County",2,84,62,25,37
050,18,045,"Indiana","Fountain County",2,85,377,129,248
050,18,045,"Indiana","Fountain County",3,0,183,95,88
050,18,045,"Indiana","Fountain County",3,1,192,94,98
050,18,045,"Indiana","Fountain County",3,2,205,110,95
050,18,045,"Indiana","Fountain County",3,3,190,96,94
050,18,045,"Indiana","Fountain County",3,4,163,83,80
050,18,045,"Indiana","Fountain County",3,5,181,93,88
050,18,045,"Indiana","Fountain County",3,6,199,108,91
050,18,045,"Indiana","Fountain County",3,7,201,111,90
050,18,045,"Indiana","Fountain County",3,8,196,111,85
050,18,045,"Indiana","Fountain County",3,9,191,103,88
050,18,045,"Indiana","Fountain County",3,10,188,102,86
050,18,045,"Indiana","Fountain County",3,11,223,124,99
050,18,045,"Indiana","Fountain County",3,12,204,108,96
050,18,045,"Indiana","Fountain County",3,13,214,111,103
050,18,045,"Indiana","Fountain County",3,14,194,100,94
050,18,045,"Indiana","Fountain County",3,15,218,111,107
050,18,045,"Indiana","Fountain County",3,16,201,104,97
050,18,045,"Indiana","Fountain County",3,17,232,114,118
050,18,045,"Indiana","Fountain County",3,18,182,99,83
050,18,045,"Indiana","Fountain County",3,19,145,74,71
050,18,045,"Indiana","Fountain County",3,20,167,85,82
050,18,045,"Indiana","Fountain County",3,21,176,87,89
050,18,045,"Indiana","Fountain County",3,22,196,100,96
050,18,045,"Indiana","Fountain County",3,23,188,97,91
050,18,045,"Indiana","Fountain County",3,24,201,99,102
050,18,045,"Indiana","Fountain County",3,25,184,92,92
050,18,045,"Indiana","Fountain County",3,26,202,109,93
050,18,045,"Indiana","Fountain County",3,27,219,116,103
050,18,045,"Indiana","Fountain County",3,28,218,111,107
050,18,045,"Indiana","Fountain County",3,29,207,105,102
050,18,045,"Indiana","Fountain County",3,30,189,96,93
050,18,045,"Indiana","Fountain County",3,31,195,95,100
050,18,045,"Indiana","Fountain County",3,32,195,98,97
050,18,045,"Indiana","Fountain County",3,33,169,84,85
050,18,045,"Indiana","Fountain County",3,34,154,77,77
050,18,045,"Indiana","Fountain County",3,35,180,88,92
050,18,045,"Indiana","Fountain County",3,36,178,94,84
050,18,045,"Indiana","Fountain County",3,37,171,95,76
050,18,045,"Indiana","Fountain County",3,38,201,100,101
050,18,045,"Indiana","Fountain County",3,39,193,101,92
050,18,045,"Indiana","Fountain County",3,40,178,91,87
050,18,045,"Indiana","Fountain County",3,41,181,87,94
050,18,045,"Indiana","Fountain County",3,42,185,99,86
050,18,045,"Indiana","Fountain County",3,43,188,98,90
050,18,045,"Indiana","Fountain County",3,44,180,92,88
050,18,045,"Indiana","Fountain County",3,45,193,93,100
050,18,045,"Indiana","Fountain County",3,46,190,84,106
050,18,045,"Indiana","Fountain County",3,47,194,96,98
050,18,045,"Indiana","Fountain County",3,48,192,94,98
050,18,045,"Indiana","Fountain County",3,49,217,109,108
050,18,045,"Indiana","Fountain County",3,50,233,116,117
050,18,045,"Indiana","Fountain County",3,51,250,127,123
050,18,045,"Indiana","Fountain County",3,52,238,117,121
050,18,045,"Indiana","Fountain County",3,53,222,116,106
050,18,045,"Indiana","Fountain County",3,54,219,115,104
050,18,045,"Indiana","Fountain County",3,55,227,118,109
050,18,045,"Indiana","Fountain County",3,56,228,114,114
050,18,045,"Indiana","Fountain County",3,57,253,125,128
050,18,045,"Indiana","Fountain County",3,58,250,125,125
050,18,045,"Indiana","Fountain County",3,59,260,131,129
050,18,045,"Indiana","Fountain County",3,60,247,122,125
050,18,045,"Indiana","Fountain County",3,61,246,127,119
050,18,045,"Indiana","Fountain County",3,62,260,130,130
050,18,045,"Indiana","Fountain County",3,63,232,115,117
050,18,045,"Indiana","Fountain County",3,64,217,107,110
050,18,045,"Indiana","Fountain County",3,65,226,115,111
050,18,045,"Indiana","Fountain County",3,66,222,110,112
050,18,045,"Indiana","Fountain County",3,67,197,87,110
050,18,045,"Indiana","Fountain County",3,68,188,86,102
050,18,045,"Indiana","Fountain County",3,69,188,90,98
050,18,045,"Indiana","Fountain County",3,70,179,91,88
050,18,045,"Indiana","Fountain County",3,71,182,100,82
050,18,045,"Indiana","Fountain County",3,72,165,87,78
050,18,045,"Indiana","Fountain County",3,73,171,80,91
050,18,045,"Indiana","Fountain County",3,74,186,88,98
050,18,045,"Indiana","Fountain County",3,75,136,62,74
050,18,045,"Indiana","Fountain County",3,76,140,64,76
050,18,045,"Indiana","Fountain County",3,77,125,57,68
050,18,045,"Indiana","Fountain County",3,78,126,61,65
050,18,045,"Indiana","Fountain County",3,79,98,48,50
050,18,045,"Indiana","Fountain County",3,80,105,49,56
050,18,045,"Indiana","Fountain County",3,81,86,35,51
050,18,045,"Indiana","Fountain County",3,82,90,41,49
050,18,045,"Indiana","Fountain County",3,83,80,30,50
050,18,045,"Indiana","Fountain County",3,84,62,29,33
050,18,045,"Indiana","Fountain County",3,85,363,122,241
050,18,045,"Indiana","Fountain County",4,0,215,108,107
050,18,045,"Indiana","Fountain County",4,1,196,107,89
050,18,045,"Indiana","Fountain County",4,2,201,101,100
050,18,045,"Indiana","Fountain County",4,3,202,116,86
050,18,045,"Indiana","Fountain County",4,4,188,99,89
050,18,045,"Indiana","Fountain County",4,5,180,96,84
050,18,045,"Indiana","Fountain County",4,6,183,89,94
050,18,045,"Indiana","Fountain County",4,7,191,104,87
050,18,045,"Indiana","Fountain County",4,8,206,114,92
050,18,045,"Indiana","Fountain County",4,9,197,108,89
050,18,045,"Indiana","Fountain County",4,10,204,111,93
050,18,045,"Indiana","Fountain County",4,11,194,100,94
050,18,045,"Indiana","Fountain County",4,12,228,120,108
050,18,045,"Indiana","Fountain County",4,13,213,105,108
050,18,045,"Indiana","Fountain County",4,14,204,104,100
050,18,045,"Indiana","Fountain County",4,15,198,104,94
050,18,045,"Indiana","Fountain County",4,16,225,118,107
050,18,045,"Indiana","Fountain County",4,17,204,110,94
050,18,045,"Indiana","Fountain County",4,18,192,100,92
050,18,045,"Indiana","Fountain County",4,19,148,75,73
050,18,045,"Indiana","Fountain County",4,20,144,79,65
050,18,045,"Indiana","Fountain County",4,21,162,81,81
050,18,045,"Indiana","Fountain County",4,22,186,97,89
050,18,045,"Indiana","Fountain County",4,23,210,94,116
050,18,045,"Indiana","Fountain County",4,24,203,97,106
050,18,045,"Indiana","Fountain County",4,25,197,106,91
050,18,045,"Indiana","Fountain County",4,26,194,98,96
050,18,045,"Indiana","Fountain County",4,27,193,102,91
050,18,045,"Indiana","Fountain County",4,28,223,116,107
050,18,045,"Indiana","Fountain County",4,29,217,101,116
050,18,045,"Indiana","Fountain County",4,30,202,99,103
050,18,045,"Indiana","Fountain County",4,31,201,105,96
050,18,045,"Indiana","Fountain County",4,32,216,101,115
050,18,045,"Indiana","Fountain County",4,33,189,95,94
050,18,045,"Indiana","Fountain County",4,34,181,90,91
050,18,045,"Indiana","Fountain County",4,35,165,82,83
050,18,045,"Indiana","Fountain County",4,36,184,91,93
050,18,045,"Indiana","Fountain County",4,37,188,99,89
050,18,045,"Indiana","Fountain County",4,38,166,93,73
050,18,045,"Indiana","Fountain County",4,39,201,102,99
050,18,045,"Indiana","Fountain County",4,40,200,103,97
050,18,045,"Indiana","Fountain County",4,41,186,97,89
050,18,045,"Indiana","Fountain County",4,42,183,90,93
050,18,045,"Indiana","Fountain County",4,43,185,98,87
050,18,045,"Indiana","Fountain County",4,44,192,99,93
050,18,045,"Indiana","Fountain County",4,45,185,93,92
050,18,045,"Indiana","Fountain County",4,46,191,88,103
050,18,045,"Indiana","Fountain County",4,47,177,82,95
050,18,045,"Indiana","Fountain County",4,48,192,96,96
050,18,045,"Indiana","Fountain County",4,49,189,90,99
050,18,045,"Indiana","Fountain County",4,50,216,111,105
050,18,045,"Indiana","Fountain County",4,51,231,112,119
050,18,045,"Indiana","Fountain County",4,52,252,129,123
050,18,045,"Indiana","Fountain County",4,53,239,118,121
050,18,045,"Indiana","Fountain County",4,54,225,117,108
050,18,045,"Indiana","Fountain County",4,55,220,116,104
050,18,045,"Indiana","Fountain County",4,56,228,121,107
050,18,045,"Indiana","Fountain County",4,57,229,112,117
050,18,045,"Indiana","Fountain County",4,58,247,120,127
050,18,045,"Indiana","Fountain County",4,59,249,127,122
050,18,045,"Indiana","Fountain County",4,60,257,133,124
050,18,045,"Indiana","Fountain County",4,61,242,117,125
050,18,045,"Indiana","Fountain County",4,62,253,132,121
050,18,045,"Indiana","Fountain County",4,63,255,131,124
050,18,045,"Indiana","Fountain County",4,64,239,119,120
050,18,045,"Indiana","Fountain County",4,65,217,103,114
050,18,045,"Indiana","Fountain County",4,66,226,115,111
050,18,045,"Indiana","Fountain County",4,67,213,108,105
050,18,045,"Indiana","Fountain County",4,68,197,88,109
050,18,045,"Indiana","Fountain County",4,69,180,83,97
050,18,045,"Indiana","Fountain County",4,70,189,91,98
050,18,045,"Indiana","Fountain County",4,71,173,88,85
050,18,045,"Indiana","Fountain County",4,72,181,96,85
050,18,045,"Indiana","Fountain County",4,73,155,81,74
050,18,045,"Indiana","Fountain County",4,74,164,74,90
050,18,045,"Indiana","Fountain County",4,75,176,80,96
050,18,045,"Indiana","Fountain County",4,76,132,58,74
050,18,045,"Indiana","Fountain County",4,77,129,61,68
050,18,045,"Indiana","Fountain County",4,78,121,53,68
050,18,045,"Indiana","Fountain County",4,79,119,63,56
050,18,045,"Indiana","Fountain County",4,80,99,47,52
050,18,045,"Indiana","Fountain County",4,81,101,45,56
050,18,045,"Indiana","Fountain County",4,82,89,38,51
050,18,045,"Indiana","Fountain County",4,83,79,36,43
050,18,045,"Indiana","Fountain County",4,84,71,24,47
050,18,045,"Indiana","Fountain County",4,85,356,117,239
050,18,045,"Indiana","Fountain County",5,0,220,109,111
050,18,045,"Indiana","Fountain County",5,1,230,113,117
050,18,045,"Indiana","Fountain County",5,2,191,102,89
050,18,045,"Indiana","Fountain County",5,3,196,98,98
050,18,045,"Indiana","Fountain County",5,4,208,115,93
050,18,045,"Indiana","Fountain County",5,5,199,112,87
050,18,045,"Indiana","Fountain County",5,6,180,88,92
050,18,045,"Indiana","Fountain County",5,7,189,90,99
050,18,045,"Indiana","Fountain County",5,8,204,112,92
050,18,045,"Indiana","Fountain County",5,9,216,119,97
050,18,045,"Indiana","Fountain County",5,10,203,116,87
050,18,045,"Indiana","Fountain County",5,11,198,108,90
050,18,045,"Indiana","Fountain County",5,12,198,100,98
050,18,045,"Indiana","Fountain County",5,13,234,126,108
050,18,045,"Indiana","Fountain County",5,14,216,109,107
050,18,045,"Indiana","Fountain County",5,15,211,112,99
050,18,045,"Indiana","Fountain County",5,16,196,102,94
050,18,045,"Indiana","Fountain County",5,17,224,119,105
050,18,045,"Indiana","Fountain County",5,18,167,91,76
050,18,045,"Indiana","Fountain County",5,19,153,80,73
050,18,045,"Indiana","Fountain County",5,20,148,77,71
050,18,045,"Indiana","Fountain County",5,21,161,81,80
050,18,045,"Indiana","Fountain County",5,22,158,78,80
050,18,045,"Indiana","Fountain County",5,23,198,105,93
050,18,045,"Indiana","Fountain County",5,24,205,104,101
050,18,045,"Indiana","Fountain County",5,25,204,102,102
050,18,045,"Indiana","Fountain County",5,26,188,103,85
050,18,045,"Indiana","Fountain County",5,27,194,96,98
050,18,045,"Indiana","Fountain County",5,28,196,98,98
050,18,045,"Indiana","Fountain County",5,29,232,124,108
050,18,045,"Indiana","Fountain County",5,30,230,112,118
050,18,045,"Indiana","Fountain County",5,31,215,108,107
050,18,045,"Indiana","Fountain County",5,32,213,105,108
050,18,045,"Indiana","Fountain County",5,33,220,102,118
050,18,045,"Indiana","Fountain County",5,34,190,93,97
050,18,045,"Indiana","Fountain County",5,35,181,91,90
050,18,045,"Indiana","Fountain County",5,36,178,89,89
050,18,045,"Indiana","Fountain County",5,37,189,95,94
050,18,045,"Indiana","Fountain County",5,38,184,97,87
050,18,045,"Indiana","Fountain County",5,39,176,100,76
050,18,045,"Indiana","Fountain County",5,40,201,99,102
050,18,045,"Indiana","Fountain County",5,41,203,103,100
050,18,045,"Indiana","Fountain County",5,42,190,93,97
050,18,045,"Indiana","Fountain County",5,43,185,92,93
050,18,045,"Indiana","Fountain County",5,44,188,100,88
050,18,045,"Indiana","Fountain County",5,45,195,103,92
050,18,045,"Indiana","Fountain County",5,46,178,90,88
050,18,045,"Indiana","Fountain County",5,47,194,89,105
050,18,045,"Indiana","Fountain County",5,48,175,80,95
050,18,045,"Indiana","Fountain County",5,49,190,97,93
050,18,045,"Indiana","Fountain County",5,50,194,92,102
050,18,045,"Indiana","Fountain County",5,51,224,115,109
050,18,045,"Indiana","Fountain County",5,52,239,113,126
050,18,045,"Indiana","Fountain County",5,53,250,127,123
050,18,045,"Indiana","Fountain County",5,54,236,119,117
050,18,045,"Indiana","Fountain County",5,55,223,115,108
050,18,045,"Indiana","Fountain County",5,56,217,113,104
050,18,045,"Indiana","Fountain County",5,57,231,120,111
050,18,045,"Indiana","Fountain County",5,58,228,110,118
050,18,045,"Indiana","Fountain County",5,59,242,115,127
050,18,045,"Indiana","Fountain County",5,60,248,126,122
050,18,045,"Indiana","Fountain County",5,61,253,130,123
050,18,045,"Indiana","Fountain County",5,62,247,122,125
050,18,045,"Indiana","Fountain County",5,63,246,129,117
050,18,045,"Indiana","Fountain County",5,64,252,128,124
050,18,045,"Indiana","Fountain County",5,65,241,119,122
050,18,045,"Indiana","Fountain County",5,66,216,100,116
050,18,045,"Indiana","Fountain County",5,67,224,118,106
050,18,045,"Indiana","Fountain County",5,68,208,103,105
050,18,045,"Indiana","Fountain County",5,69,188,82,106
050,18,045,"Indiana","Fountain County",5,70,178,79,99
050,18,045,"Indiana","Fountain County",5,71,185,91,94
050,18,045,"Indiana","Fountain County",5,72,167,85,82
050,18,045,"Indiana","Fountain County",5,73,172,95,77
050,18,045,"Indiana","Fountain County",5,74,150,77,73
050,18,045,"Indiana","Fountain County",5,75,161,70,91
050,18,045,"Indiana","Fountain County",5,76,161,74,87
050,18,045,"Indiana","Fountain County",5,77,120,54,66
050,18,045,"Indiana","Fountain County",5,78,121,57,64
050,18,045,"Indiana","Fountain County",5,79,111,51,60
050,18,045,"Indiana","Fountain County",5,80,112,61,51
050,18,045,"Indiana","Fountain County",5,81,91,41,50
050,18,045,"Indiana","Fountain County",5,82,100,44,56
050,18,045,"Indiana","Fountain County",5,83,79,36,43
050,18,045,"Indiana","Fountain County",5,84,67,27,40
050,18,045,"Indiana","Fountain County",5,85,357,110,247
050,18,047,"Indiana","Franklin County",1,0,255,130,125
050,18,047,"Indiana","Franklin County",1,1,276,137,139
050,18,047,"Indiana","Franklin County",1,2,312,148,164
050,18,047,"Indiana","Franklin County",1,3,270,132,138
050,18,047,"Indiana","Franklin County",1,4,272,130,142
050,18,047,"Indiana","Franklin County",1,5,266,128,138
050,18,047,"Indiana","Franklin County",1,6,275,142,133
050,18,047,"Indiana","Franklin County",1,7,287,147,140
050,18,047,"Indiana","Franklin County",1,8,279,141,138
050,18,047,"Indiana","Franklin County",1,9,262,137,125
050,18,047,"Indiana","Franklin County",1,10,264,128,136
050,18,047,"Indiana","Franklin County",1,11,273,131,142
050,18,047,"Indiana","Franklin County",1,12,306,148,158
050,18,047,"Indiana","Franklin County",1,13,323,151,172
050,18,047,"Indiana","Franklin County",1,14,325,164,161
050,18,047,"Indiana","Franklin County",1,15,332,174,158
050,18,047,"Indiana","Franklin County",1,16,346,192,154
050,18,047,"Indiana","Franklin County",1,17,342,183,159
050,18,047,"Indiana","Franklin County",1,18,277,149,128
050,18,047,"Indiana","Franklin County",1,19,221,117,104
050,18,047,"Indiana","Franklin County",1,20,226,127,99
050,18,047,"Indiana","Franklin County",1,21,258,137,121
050,18,047,"Indiana","Franklin County",1,22,249,123,126
050,18,047,"Indiana","Franklin County",1,23,242,127,115
050,18,047,"Indiana","Franklin County",1,24,246,131,115
050,18,047,"Indiana","Franklin County",1,25,252,132,120
050,18,047,"Indiana","Franklin County",1,26,249,128,121
050,18,047,"Indiana","Franklin County",1,27,255,139,116
050,18,047,"Indiana","Franklin County",1,28,248,132,116
050,18,047,"Indiana","Franklin County",1,29,223,118,105
050,18,047,"Indiana","Franklin County",1,30,224,115,109
050,18,047,"Indiana","Franklin County",1,31,222,109,113
050,18,047,"Indiana","Franklin County",1,32,250,119,131
050,18,047,"Indiana","Franklin County",1,33,234,106,128
050,18,047,"Indiana","Franklin County",1,34,238,110,128
050,18,047,"Indiana","Franklin County",1,35,255,129,126
050,18,047,"Indiana","Franklin County",1,36,260,135,125
050,18,047,"Indiana","Franklin County",1,37,253,127,126
050,18,047,"Indiana","Franklin County",1,38,281,150,131
050,18,047,"Indiana","Franklin County",1,39,271,126,145
050,18,047,"Indiana","Franklin County",1,40,252,121,131
050,18,047,"Indiana","Franklin County",1,41,269,140,129
050,18,047,"Indiana","Franklin County",1,42,280,136,144
050,18,047,"Indiana","Franklin County",1,43,254,126,128
050,18,047,"Indiana","Franklin County",1,44,262,132,130
050,18,047,"Indiana","Franklin County",1,45,287,139,148
050,18,047,"Indiana","Franklin County",1,46,278,141,137
050,18,047,"Indiana","Franklin County",1,47,273,146,127
050,18,047,"Indiana","Franklin County",1,48,311,155,156
050,18,047,"Indiana","Franklin County",1,49,335,180,155
050,18,047,"Indiana","Franklin County",1,50,320,173,147
050,18,047,"Indiana","Franklin County",1,51,299,148,151
050,18,047,"Indiana","Franklin County",1,52,287,134,153
050,18,047,"Indiana","Franklin County",1,53,313,157,156
050,18,047,"Indiana","Franklin County",1,54,333,174,159
050,18,047,"Indiana","Franklin County",1,55,361,184,177
050,18,047,"Indiana","Franklin County",1,56,349,196,153
050,18,047,"Indiana","Franklin County",1,57,336,179,157
050,18,047,"Indiana","Franklin County",1,58,340,170,170
050,18,047,"Indiana","Franklin County",1,59,346,178,168
050,18,047,"Indiana","Franklin County",1,60,353,193,160
050,18,047,"Indiana","Franklin County",1,61,354,175,179
050,18,047,"Indiana","Franklin County",1,62,356,180,176
050,18,047,"Indiana","Franklin County",1,63,319,163,156
050,18,047,"Indiana","Franklin County",1,64,323,160,163
050,18,047,"Indiana","Franklin County",1,65,312,161,151
050,18,047,"Indiana","Franklin County",1,66,314,162,152
050,18,047,"Indiana","Franklin County",1,67,324,158,166
050,18,047,"Indiana","Franklin County",1,68,311,153,158
050,18,047,"Indiana","Franklin County",1,69,271,139,132
050,18,047,"Indiana","Franklin County",1,70,247,122,125
050,18,047,"Indiana","Franklin County",1,71,229,105,124
050,18,047,"Indiana","Franklin County",1,72,222,108,114
050,18,047,"Indiana","Franklin County",1,73,218,115,103
050,18,047,"Indiana","Franklin County",1,74,145,71,74
050,18,047,"Indiana","Franklin County",1,75,172,86,86
050,18,047,"Indiana","Franklin County",1,76,169,84,85
050,18,047,"Indiana","Franklin County",1,77,165,84,81
050,18,047,"Indiana","Franklin County",1,78,150,71,79
050,18,047,"Indiana","Franklin County",1,79,128,58,70
050,18,047,"Indiana","Franklin County",1,80,113,47,66
050,18,047,"Indiana","Franklin County",1,81,105,45,60
050,18,047,"Indiana","Franklin County",1,82,96,36,60
050,18,047,"Indiana","Franklin County",1,83,84,38,46
050,18,047,"Indiana","Franklin County",1,84,92,34,58
050,18,047,"Indiana","Franklin County",1,85,435,144,291
050,18,047,"Indiana","Franklin County",2,0,252,127,125
050,18,047,"Indiana","Franklin County",2,1,272,134,138
050,18,047,"Indiana","Franklin County",2,2,301,144,157
050,18,047,"Indiana","Franklin County",2,3,279,135,144
050,18,047,"Indiana","Franklin County",2,4,273,131,142
050,18,047,"Indiana","Franklin County",2,5,268,128,140
050,18,047,"Indiana","Franklin County",2,6,277,141,136
050,18,047,"Indiana","Franklin County",2,7,287,146,141
050,18,047,"Indiana","Franklin County",2,8,282,143,139
050,18,047,"Indiana","Franklin County",2,9,268,139,129
050,18,047,"Indiana","Franklin County",2,10,263,130,133
050,18,047,"Indiana","Franklin County",2,11,270,131,139
050,18,047,"Indiana","Franklin County",2,12,299,143,156
050,18,047,"Indiana","Franklin County",2,13,316,149,167
050,18,047,"Indiana","Franklin County",2,14,324,160,164
050,18,047,"Indiana","Franklin County",2,15,329,170,159
050,18,047,"Indiana","Franklin County",2,16,343,187,156
050,18,047,"Indiana","Franklin County",2,17,338,182,156
050,18,047,"Indiana","Franklin County",2,18,276,149,127
050,18,047,"Indiana","Franklin County",2,19,219,116,103
050,18,047,"Indiana","Franklin County",2,20,232,128,104
050,18,047,"Indiana","Franklin County",2,21,252,135,117
050,18,047,"Indiana","Franklin County",2,22,253,128,125
050,18,047,"Indiana","Franklin County",2,23,245,126,119
050,18,047,"Indiana","Franklin County",2,24,245,130,115
050,18,047,"Indiana","Franklin County",2,25,252,132,120
050,18,047,"Indiana","Franklin County",2,26,252,131,121
050,18,047,"Indiana","Franklin County",2,27,253,136,117
050,18,047,"Indiana","Franklin County",2,28,250,134,116
050,18,047,"Indiana","Franklin County",2,29,230,122,108
050,18,047,"Indiana","Franklin County",2,30,226,118,108
050,18,047,"Indiana","Franklin County",2,31,223,111,112
050,18,047,"Indiana","Franklin County",2,32,245,117,128
050,18,047,"Indiana","Franklin County",2,33,237,109,128
050,18,047,"Indiana","Franklin County",2,34,240,112,128
050,18,047,"Indiana","Franklin County",2,35,255,127,128
050,18,047,"Indiana","Franklin County",2,36,258,133,125
050,18,047,"Indiana","Franklin County",2,37,255,129,126
050,18,047,"Indiana","Franklin County",2,38,275,143,132
050,18,047,"Indiana","Franklin County",2,39,270,129,141
050,18,047,"Indiana","Franklin County",2,40,257,123,134
050,18,047,"Indiana","Franklin County",2,41,265,136,129
050,18,047,"Indiana","Franklin County",2,42,276,138,138
050,18,047,"Indiana","Franklin County",2,43,263,131,132
050,18,047,"Indiana","Franklin County",2,44,258,129,129
050,18,047,"Indiana","Franklin County",2,45,280,137,143
050,18,047,"Indiana","Franklin County",2,46,280,141,139
050,18,047,"Indiana","Franklin County",2,47,273,144,129
050,18,047,"Indiana","Franklin County",2,48,302,153,149
050,18,047,"Indiana","Franklin County",2,49,331,174,157
050,18,047,"Indiana","Franklin County",2,50,327,176,151
050,18,047,"Indiana","Franklin County",2,51,304,154,150
050,18,047,"Indiana","Franklin County",2,52,290,138,152
050,18,047,"Indiana","Franklin County",2,53,308,153,155
050,18,047,"Indiana","Franklin County",2,54,327,169,158
050,18,047,"Indiana","Franklin County",2,55,354,182,172
050,18,047,"Indiana","Franklin County",2,56,354,195,159
050,18,047,"Indiana","Franklin County",2,57,338,182,156
050,18,047,"Indiana","Franklin County",2,58,338,171,167
050,18,047,"Indiana","Franklin County",2,59,343,175,168
050,18,047,"Indiana","Franklin County",2,60,347,186,161
050,18,047,"Indiana","Franklin County",2,61,348,176,172
050,18,047,"Indiana","Franklin County",2,62,354,179,175
050,18,047,"Indiana","Franklin County",2,63,332,170,162
050,18,047,"Indiana","Franklin County",2,64,320,159,161
050,18,047,"Indiana","Franklin County",2,65,315,162,153
050,18,047,"Indiana","Franklin County",2,66,313,161,152
050,18,047,"Indiana","Franklin County",2,67,322,158,164
050,18,047,"Indiana","Franklin County",2,68,310,153,157
050,18,047,"Indiana","Franklin County",2,69,280,141,139
050,18,047,"Indiana","Franklin County",2,70,252,126,126
050,18,047,"Indiana","Franklin County",2,71,232,109,123
050,18,047,"Indiana","Franklin County",2,72,219,106,113
050,18,047,"Indiana","Franklin County",2,73,228,118,110
050,18,047,"Indiana","Franklin County",2,74,152,76,76
050,18,047,"Indiana","Franklin County",2,75,165,81,84
050,18,047,"Indiana","Franklin County",2,76,165,81,84
050,18,047,"Indiana","Franklin County",2,77,168,85,83
050,18,047,"Indiana","Franklin County",2,78,150,72,78
050,18,047,"Indiana","Franklin County",2,79,128,57,71
050,18,047,"Indiana","Franklin County",2,80,116,49,67
050,18,047,"Indiana","Franklin County",2,81,107,45,62
050,18,047,"Indiana","Franklin County",2,82,98,38,60
050,18,047,"Indiana","Franklin County",2,83,84,36,48
050,18,047,"Indiana","Franklin County",2,84,90,35,55
050,18,047,"Indiana","Franklin County",2,85,441,149,292
050,18,047,"Indiana","Franklin County",3,0,253,116,137
050,18,047,"Indiana","Franklin County",3,1,259,132,127
050,18,047,"Indiana","Franklin County",3,2,284,139,145
050,18,047,"Indiana","Franklin County",3,3,307,151,156
050,18,047,"Indiana","Franklin County",3,4,297,140,157
050,18,047,"Indiana","Franklin County",3,5,280,138,142
050,18,047,"Indiana","Franklin County",3,6,264,127,137
050,18,047,"Indiana","Franklin County",3,7,277,140,137
050,18,047,"Indiana","Franklin County",3,8,280,140,140
050,18,047,"Indiana","Franklin County",3,9,277,141,136
050,18,047,"Indiana","Franklin County",3,10,259,133,126
050,18,047,"Indiana","Franklin County",3,11,267,133,134
050,18,047,"Indiana","Franklin County",3,12,274,130,144
050,18,047,"Indiana","Franklin County",3,13,309,144,165
050,18,047,"Indiana","Franklin County",3,14,318,149,169
050,18,047,"Indiana","Franklin County",3,15,340,173,167
050,18,047,"Indiana","Franklin County",3,16,331,170,161
050,18,047,"Indiana","Franklin County",3,17,336,185,151
050,18,047,"Indiana","Franklin County",3,18,282,159,123
050,18,047,"Indiana","Franklin County",3,19,199,108,91
050,18,047,"Indiana","Franklin County",3,20,231,122,109
050,18,047,"Indiana","Franklin County",3,21,241,133,108
050,18,047,"Indiana","Franklin County",3,22,263,144,119
050,18,047,"Indiana","Franklin County",3,23,253,130,123
050,18,047,"Indiana","Franklin County",3,24,252,136,116
050,18,047,"Indiana","Franklin County",3,25,257,135,122
050,18,047,"Indiana","Franklin County",3,26,258,129,129
050,18,047,"Indiana","Franklin County",3,27,258,130,128
050,18,047,"Indiana","Franklin County",3,28,252,132,120
050,18,047,"Indiana","Franklin County",3,29,269,137,132
050,18,047,"Indiana","Franklin County",3,30,247,133,114
050,18,047,"Indiana","Franklin County",3,31,228,123,105
050,18,047,"Indiana","Franklin County",3,32,232,117,115
050,18,047,"Indiana","Franklin County",3,33,252,119,133
050,18,047,"Indiana","Franklin County",3,34,241,108,133
050,18,047,"Indiana","Franklin County",3,35,244,113,131
050,18,047,"Indiana","Franklin County",3,36,244,121,123
050,18,047,"Indiana","Franklin County",3,37,267,133,134
050,18,047,"Indiana","Franklin County",3,38,256,128,128
050,18,047,"Indiana","Franklin County",3,39,271,140,131
050,18,047,"Indiana","Franklin County",3,40,277,131,146
050,18,047,"Indiana","Franklin County",3,41,260,124,136
050,18,047,"Indiana","Franklin County",3,42,265,135,130
050,18,047,"Indiana","Franklin County",3,43,268,134,134
050,18,047,"Indiana","Franklin County",3,44,268,136,132
050,18,047,"Indiana","Franklin County",3,45,259,129,130
050,18,047,"Indiana","Franklin County",3,46,284,143,141
050,18,047,"Indiana","Franklin County",3,47,281,142,139
050,18,047,"Indiana","Franklin County",3,48,270,142,128
050,18,047,"Indiana","Franklin County",3,49,296,150,146
050,18,047,"Indiana","Franklin County",3,50,331,176,155
050,18,047,"Indiana","Franklin County",3,51,331,174,157
050,18,047,"Indiana","Franklin County",3,52,309,154,155
050,18,047,"Indiana","Franklin County",3,53,291,140,151
050,18,047,"Indiana","Franklin County",3,54,314,153,161
050,18,047,"Indiana","Franklin County",3,55,321,168,153
050,18,047,"Indiana","Franklin County",3,56,351,183,168
050,18,047,"Indiana","Franklin County",3,57,353,196,157
050,18,047,"Indiana","Franklin County",3,58,338,183,155
050,18,047,"Indiana","Franklin County",3,59,333,163,170
050,18,047,"Indiana","Franklin County",3,60,340,175,165
050,18,047,"Indiana","Franklin County",3,61,346,183,163
050,18,047,"Indiana","Franklin County",3,62,341,172,169
050,18,047,"Indiana","Franklin County",3,63,361,181,180
050,18,047,"Indiana","Franklin County",3,64,337,170,167
050,18,047,"Indiana","Franklin County",3,65,325,163,162
050,18,047,"Indiana","Franklin County",3,66,317,167,150
050,18,047,"Indiana","Franklin County",3,67,314,154,160
050,18,047,"Indiana","Franklin County",3,68,314,156,158
050,18,047,"Indiana","Franklin County",3,69,300,148,152
050,18,047,"Indiana","Franklin County",3,70,278,139,139
050,18,047,"Indiana","Franklin County",3,71,251,122,129
050,18,047,"Indiana","Franklin County",3,72,222,106,116
050,18,047,"Indiana","Franklin County",3,73,210,100,110
050,18,047,"Indiana","Franklin County",3,74,219,115,104
050,18,047,"Indiana","Franklin County",3,75,135,65,70
050,18,047,"Indiana","Franklin County",3,76,149,72,77
050,18,047,"Indiana","Franklin County",3,77,163,75,88
050,18,047,"Indiana","Franklin County",3,78,158,81,77
050,18,047,"Indiana","Franklin County",3,79,144,66,78
050,18,047,"Indiana","Franklin County",3,80,123,55,68
050,18,047,"Indiana","Franklin County",3,81,110,47,63
050,18,047,"Indiana","Franklin County",3,82,95,37,58
050,18,047,"Indiana","Franklin County",3,83,89,37,52
050,18,047,"Indiana","Franklin County",3,84,85,33,52
050,18,047,"Indiana","Franklin County",3,85,454,151,303
050,18,047,"Indiana","Franklin County",4,0,232,104,128
050,18,047,"Indiana","Franklin County",4,1,264,123,141
050,18,047,"Indiana","Franklin County",4,2,256,135,121
050,18,047,"Indiana","Franklin County",4,3,278,136,142
050,18,047,"Indiana","Franklin County",4,4,320,157,163
050,18,047,"Indiana","Franklin County",4,5,294,136,158
050,18,047,"Indiana","Franklin County",4,6,286,141,145
050,18,047,"Indiana","Franklin County",4,7,284,143,141
050,18,047,"Indiana","Franklin County",4,8,291,146,145
050,18,047,"Indiana","Franklin County",4,9,291,146,145
050,18,047,"Indiana","Franklin County",4,10,282,143,139
050,18,047,"Indiana","Franklin County",4,11,276,146,130
050,18,047,"Indiana","Franklin County",4,12,276,135,141
050,18,047,"Indiana","Franklin County",4,13,280,135,145
050,18,047,"Indiana","Franklin County",4,14,313,151,162
050,18,047,"Indiana","Franklin County",4,15,311,144,167
050,18,047,"Indiana","Franklin County",4,16,326,167,159
050,18,047,"Indiana","Franklin County",4,17,340,175,165
050,18,047,"Indiana","Franklin County",4,18,271,156,115
050,18,047,"Indiana","Franklin County",4,19,205,117,88
050,18,047,"Indiana","Franklin County",4,20,207,109,98
050,18,047,"Indiana","Franklin County",4,21,242,124,118
050,18,047,"Indiana","Franklin County",4,22,260,146,114
050,18,047,"Indiana","Franklin County",4,23,286,153,133
050,18,047,"Indiana","Franklin County",4,24,260,137,123
050,18,047,"Indiana","Franklin County",4,25,262,143,119
050,18,047,"Indiana","Franklin County",4,26,254,141,113
050,18,047,"Indiana","Franklin County",4,27,253,124,129
050,18,047,"Indiana","Franklin County",4,28,270,135,135
050,18,047,"Indiana","Franklin County",4,29,256,130,126
050,18,047,"Indiana","Franklin County",4,30,262,137,125
050,18,047,"Indiana","Franklin County",4,31,254,134,120
050,18,047,"Indiana","Franklin County",4,32,245,138,107
050,18,047,"Indiana","Franklin County",4,33,242,122,120
050,18,047,"Indiana","Franklin County",4,34,257,122,135
050,18,047,"Indiana","Franklin County",4,35,253,113,140
050,18,047,"Indiana","Franklin County",4,36,241,115,126
050,18,047,"Indiana","Franklin County",4,37,253,128,125
050,18,047,"Indiana","Franklin County",4,38,286,138,148
050,18,047,"Indiana","Franklin County",4,39,264,130,134
050,18,047,"Indiana","Franklin County",4,40,271,141,130
050,18,047,"Indiana","Franklin County",4,41,281,147,134
050,18,047,"Indiana","Franklin County",4,42,267,124,143
050,18,047,"Indiana","Franklin County",4,43,258,133,125
050,18,047,"Indiana","Franklin County",4,44,284,141,143
050,18,047,"Indiana","Franklin County",4,45,258,129,129
050,18,047,"Indiana","Franklin County",4,46,258,125,133
050,18,047,"Indiana","Franklin County",4,47,280,141,139
050,18,047,"Indiana","Franklin County",4,48,285,145,140
050,18,047,"Indiana","Franklin County",4,49,275,144,131
050,18,047,"Indiana","Franklin County",4,50,302,153,149
050,18,047,"Indiana","Franklin County",4,51,328,173,155
050,18,047,"Indiana","Franklin County",4,52,338,176,162
050,18,047,"Indiana","Franklin County",4,53,310,160,150
050,18,047,"Indiana","Franklin County",4,54,298,143,155
050,18,047,"Indiana","Franklin County",4,55,318,157,161
050,18,047,"Indiana","Franklin County",4,56,328,172,156
050,18,047,"Indiana","Franklin County",4,57,343,182,161
050,18,047,"Indiana","Franklin County",4,58,355,195,160
050,18,047,"Indiana","Franklin County",4,59,346,182,164
050,18,047,"Indiana","Franklin County",4,60,330,159,171
050,18,047,"Indiana","Franklin County",4,61,357,188,169
050,18,047,"Indiana","Franklin County",4,62,350,189,161
050,18,047,"Indiana","Franklin County",4,63,340,172,168
050,18,047,"Indiana","Franklin County",4,64,354,172,182
050,18,047,"Indiana","Franklin County",4,65,328,167,161
050,18,047,"Indiana","Franklin County",4,66,324,164,160
050,18,047,"Indiana","Franklin County",4,67,320,164,156
050,18,047,"Indiana","Franklin County",4,68,306,151,155
050,18,047,"Indiana","Franklin County",4,69,304,150,154
050,18,047,"Indiana","Franklin County",4,70,296,146,150
050,18,047,"Indiana","Franklin County",4,71,268,131,137
050,18,047,"Indiana","Franklin County",4,72,243,118,125
050,18,047,"Indiana","Franklin County",4,73,217,103,114
050,18,047,"Indiana","Franklin County",4,74,204,99,105
050,18,047,"Indiana","Franklin County",4,75,216,112,104
050,18,047,"Indiana","Franklin County",4,76,130,63,67
050,18,047,"Indiana","Franklin County",4,77,144,67,77
050,18,047,"Indiana","Franklin County",4,78,155,72,83
050,18,047,"Indiana","Franklin County",4,79,151,74,77
050,18,047,"Indiana","Franklin County",4,80,138,62,76
050,18,047,"Indiana","Franklin County",4,81,117,53,64
050,18,047,"Indiana","Franklin County",4,82,101,40,61
050,18,047,"Indiana","Franklin County",4,83,82,33,49
050,18,047,"Indiana","Franklin County",4,84,87,32,55
050,18,047,"Indiana","Franklin County",4,85,455,150,305
050,18,047,"Indiana","Franklin County",5,0,196,85,111
050,18,047,"Indiana","Franklin County",5,1,245,108,137
050,18,047,"Indiana","Franklin County",5,2,264,122,142
050,18,047,"Indiana","Franklin County",5,3,256,132,124
050,18,047,"Indiana","Franklin County",5,4,287,142,145
050,18,047,"Indiana","Franklin County",5,5,314,156,158
050,18,047,"Indiana","Franklin County",5,6,301,140,161
050,18,047,"Indiana","Franklin County",5,7,299,149,150
050,18,047,"Indiana","Franklin County",5,8,293,146,147
050,18,047,"Indiana","Franklin County",5,9,287,146,141
050,18,047,"Indiana","Franklin County",5,10,303,149,154
050,18,047,"Indiana","Franklin County",5,11,281,146,135
050,18,047,"Indiana","Franklin County",5,12,281,144,137
050,18,047,"Indiana","Franklin County",5,13,274,134,140
050,18,047,"Indiana","Franklin County",5,14,281,138,143
050,18,047,"Indiana","Franklin County",5,15,322,150,172
050,18,047,"Indiana","Franklin County",5,16,319,155,164
050,18,047,"Indiana","Franklin County",5,17,329,171,158
050,18,047,"Indiana","Franklin County",5,18,276,149,127
050,18,047,"Indiana","Franklin County",5,19,202,113,89
050,18,047,"Indiana","Franklin County",5,20,213,116,97
050,18,047,"Indiana","Franklin County",5,21,225,120,105
050,18,047,"Indiana","Franklin County",5,22,244,122,122
050,18,047,"Indiana","Franklin County",5,23,268,154,114
050,18,047,"Indiana","Franklin County",5,24,276,150,126
050,18,047,"Indiana","Franklin County",5,25,251,128,123
050,18,047,"Indiana","Franklin County",5,26,256,136,120
050,18,047,"Indiana","Franklin County",5,27,254,136,118
050,18,047,"Indiana","Franklin County",5,28,251,121,130
050,18,047,"Indiana","Franklin County",5,29,275,135,140
050,18,047,"Indiana","Franklin County",5,30,255,129,126
050,18,047,"Indiana","Franklin County",5,31,262,135,127
050,18,047,"Indiana","Franklin County",5,32,257,135,122
050,18,047,"Indiana","Franklin County",5,33,257,144,113
050,18,047,"Indiana","Franklin County",5,34,253,125,128
050,18,047,"Indiana","Franklin County",5,35,259,124,135
050,18,047,"Indiana","Franklin County",5,36,251,112,139
050,18,047,"Indiana","Franklin County",5,37,250,120,130
050,18,047,"Indiana","Franklin County",5,38,255,130,125
050,18,047,"Indiana","Franklin County",5,39,285,138,147
050,18,047,"Indiana","Franklin County",5,40,263,126,137
050,18,047,"Indiana","Franklin County",5,41,271,143,128
050,18,047,"Indiana","Franklin County",5,42,281,146,135
050,18,047,"Indiana","Franklin County",5,43,273,127,146
050,18,047,"Indiana","Franklin County",5,44,265,132,133
050,18,047,"Indiana","Franklin County",5,45,283,141,142
050,18,047,"Indiana","Franklin County",5,46,252,131,121
050,18,047,"Indiana","Franklin County",5,47,256,122,134
050,18,047,"Indiana","Franklin County",5,48,279,142,137
050,18,047,"Indiana","Franklin County",5,49,286,145,141
050,18,047,"Indiana","Franklin County",5,50,277,145,132
050,18,047,"Indiana","Franklin County",5,51,307,154,153
050,18,047,"Indiana","Franklin County",5,52,330,175,155
050,18,047,"Indiana","Franklin County",5,53,338,170,168
050,18,047,"Indiana","Franklin County",5,54,317,163,154
050,18,047,"Indiana","Franklin County",5,55,296,142,154
050,18,047,"Indiana","Franklin County",5,56,318,159,159
050,18,047,"Indiana","Franklin County",5,57,327,168,159
050,18,047,"Indiana","Franklin County",5,58,349,182,167
050,18,047,"Indiana","Franklin County",5,59,353,190,163
050,18,047,"Indiana","Franklin County",5,60,341,177,164
050,18,047,"Indiana","Franklin County",5,61,336,168,168
050,18,047,"Indiana","Franklin County",5,62,366,193,173
050,18,047,"Indiana","Franklin County",5,63,345,190,155
050,18,047,"Indiana","Franklin County",5,64,342,168,174
050,18,047,"Indiana","Franklin County",5,65,352,172,180
050,18,047,"Indiana","Franklin County",5,66,317,164,153
050,18,047,"Indiana","Franklin County",5,67,326,162,164
050,18,047,"Indiana","Franklin County",5,68,310,162,148
050,18,047,"Indiana","Franklin County",5,69,293,145,148
050,18,047,"Indiana","Franklin County",5,70,304,149,155
050,18,047,"Indiana","Franklin County",5,71,292,145,147
050,18,047,"Indiana","Franklin County",5,72,262,125,137
050,18,047,"Indiana","Franklin County",5,73,235,114,121
050,18,047,"Indiana","Franklin County",5,74,208,100,108
050,18,047,"Indiana","Franklin County",5,75,201,97,104
050,18,047,"Indiana","Franklin County",5,76,206,107,99
050,18,047,"Indiana","Franklin County",5,77,125,58,67
050,18,047,"Indiana","Franklin County",5,78,136,63,73
050,18,047,"Indiana","Franklin County",5,79,149,67,82
050,18,047,"Indiana","Franklin County",5,80,142,67,75
050,18,047,"Indiana","Franklin County",5,81,134,59,75
050,18,047,"Indiana","Franklin County",5,82,110,48,62
050,18,047,"Indiana","Franklin County",5,83,90,36,54
050,18,047,"Indiana","Franklin County",5,84,81,30,51
050,18,047,"Indiana","Franklin County",5,85,465,153,312
050,18,049,"Indiana","Fulton County",1,0,241,126,115
050,18,049,"Indiana","Fulton County",1,1,242,128,114
050,18,049,"Indiana","Fulton County",1,2,253,131,122
050,18,049,"Indiana","Fulton County",1,3,246,136,110
050,18,049,"Indiana","Fulton County",1,4,305,158,147
050,18,049,"Indiana","Fulton County",1,5,275,146,129
050,18,049,"Indiana","Fulton County",1,6,282,142,140
050,18,049,"Indiana","Fulton County",1,7,257,117,140
050,18,049,"Indiana","Fulton County",1,8,250,124,126
050,18,049,"Indiana","Fulton County",1,9,253,125,128
050,18,049,"Indiana","Fulton County",1,10,269,133,136
050,18,049,"Indiana","Fulton County",1,11,287,147,140
050,18,049,"Indiana","Fulton County",1,12,310,171,139
050,18,049,"Indiana","Fulton County",1,13,285,145,140
050,18,049,"Indiana","Fulton County",1,14,293,143,150
050,18,049,"Indiana","Fulton County",1,15,299,149,150
050,18,049,"Indiana","Fulton County",1,16,292,151,141
050,18,049,"Indiana","Fulton County",1,17,259,137,122
050,18,049,"Indiana","Fulton County",1,18,223,124,99
050,18,049,"Indiana","Fulton County",1,19,185,102,83
050,18,049,"Indiana","Fulton County",1,20,223,113,110
050,18,049,"Indiana","Fulton County",1,21,198,110,88
050,18,049,"Indiana","Fulton County",1,22,215,117,98
050,18,049,"Indiana","Fulton County",1,23,227,107,120
050,18,049,"Indiana","Fulton County",1,24,221,112,109
050,18,049,"Indiana","Fulton County",1,25,204,112,92
050,18,049,"Indiana","Fulton County",1,26,223,118,105
050,18,049,"Indiana","Fulton County",1,27,234,114,120
050,18,049,"Indiana","Fulton County",1,28,227,122,105
050,18,049,"Indiana","Fulton County",1,29,264,129,135
050,18,049,"Indiana","Fulton County",1,30,248,120,128
050,18,049,"Indiana","Fulton County",1,31,241,124,117
050,18,049,"Indiana","Fulton County",1,32,233,119,114
050,18,049,"Indiana","Fulton County",1,33,206,109,97
050,18,049,"Indiana","Fulton County",1,34,220,120,100
050,18,049,"Indiana","Fulton County",1,35,221,116,105
050,18,049,"Indiana","Fulton County",1,36,247,118,129
050,18,049,"Indiana","Fulton County",1,37,241,123,118
050,18,049,"Indiana","Fulton County",1,38,240,130,110
050,18,049,"Indiana","Fulton County",1,39,258,135,123
050,18,049,"Indiana","Fulton County",1,40,249,131,118
050,18,049,"Indiana","Fulton County",1,41,246,118,128
050,18,049,"Indiana","Fulton County",1,42,267,128,139
050,18,049,"Indiana","Fulton County",1,43,233,118,115
050,18,049,"Indiana","Fulton County",1,44,228,110,118
050,18,049,"Indiana","Fulton County",1,45,231,119,112
050,18,049,"Indiana","Fulton County",1,46,230,115,115
050,18,049,"Indiana","Fulton County",1,47,244,129,115
050,18,049,"Indiana","Fulton County",1,48,277,147,130
050,18,049,"Indiana","Fulton County",1,49,279,152,127
050,18,049,"Indiana","Fulton County",1,50,250,127,123
050,18,049,"Indiana","Fulton County",1,51,218,116,102
050,18,049,"Indiana","Fulton County",1,52,219,112,107
050,18,049,"Indiana","Fulton County",1,53,244,130,114
050,18,049,"Indiana","Fulton County",1,54,252,128,124
050,18,049,"Indiana","Fulton County",1,55,248,121,127
050,18,049,"Indiana","Fulton County",1,56,280,140,140
050,18,049,"Indiana","Fulton County",1,57,306,141,165
050,18,049,"Indiana","Fulton County",1,58,308,160,148
050,18,049,"Indiana","Fulton County",1,59,315,159,156
050,18,049,"Indiana","Fulton County",1,60,301,150,151
050,18,049,"Indiana","Fulton County",1,61,307,157,150
050,18,049,"Indiana","Fulton County",1,62,291,152,139
050,18,049,"Indiana","Fulton County",1,63,264,140,124
050,18,049,"Indiana","Fulton County",1,64,271,140,131
050,18,049,"Indiana","Fulton County",1,65,280,137,143
050,18,049,"Indiana","Fulton County",1,66,277,144,133
050,18,049,"Indiana","Fulton County",1,67,265,141,124
050,18,049,"Indiana","Fulton County",1,68,274,141,133
050,18,049,"Indiana","Fulton County",1,69,245,117,128
050,18,049,"Indiana","Fulton County",1,70,229,114,115
050,18,049,"Indiana","Fulton County",1,71,220,104,116
050,18,049,"Indiana","Fulton County",1,72,233,112,121
050,18,049,"Indiana","Fulton County",1,73,217,104,113
050,18,049,"Indiana","Fulton County",1,74,154,76,78
050,18,049,"Indiana","Fulton County",1,75,147,68,79
050,18,049,"Indiana","Fulton County",1,76,151,69,82
050,18,049,"Indiana","Fulton County",1,77,158,62,96
050,18,049,"Indiana","Fulton County",1,78,144,72,72
050,18,049,"Indiana","Fulton County",1,79,127,57,70
050,18,049,"Indiana","Fulton County",1,80,114,48,66
050,18,049,"Indiana","Fulton County",1,81,106,41,65
050,18,049,"Indiana","Fulton County",1,82,89,34,55
050,18,049,"Indiana","Fulton County",1,83,88,37,51
050,18,049,"Indiana","Fulton County",1,84,78,26,52
050,18,049,"Indiana","Fulton County",1,85,428,156,272
050,18,049,"Indiana","Fulton County",2,0,234,121,113
050,18,049,"Indiana","Fulton County",2,1,242,128,114
050,18,049,"Indiana","Fulton County",2,2,252,131,121
050,18,049,"Indiana","Fulton County",2,3,250,136,114
050,18,049,"Indiana","Fulton County",2,4,295,155,140
050,18,049,"Indiana","Fulton County",2,5,287,150,137
050,18,049,"Indiana","Fulton County",2,6,281,144,137
050,18,049,"Indiana","Fulton County",2,7,261,123,138
050,18,049,"Indiana","Fulton County",2,8,251,121,130
050,18,049,"Indiana","Fulton County",2,9,253,125,128
050,18,049,"Indiana","Fulton County",2,10,267,132,135
050,18,049,"Indiana","Fulton County",2,11,280,142,138
050,18,049,"Indiana","Fulton County",2,12,304,164,140
050,18,049,"Indiana","Fulton County",2,13,292,152,140
050,18,049,"Indiana","Fulton County",2,14,290,144,146
050,18,049,"Indiana","Fulton County",2,15,299,149,150
050,18,049,"Indiana","Fulton County",2,16,293,151,142
050,18,049,"Indiana","Fulton County",2,17,264,139,125
050,18,049,"Indiana","Fulton County",2,18,216,120,96
050,18,049,"Indiana","Fulton County",2,19,185,102,83
050,18,049,"Indiana","Fulton County",2,20,217,113,104
050,18,049,"Indiana","Fulton County",2,21,204,110,94
050,18,049,"Indiana","Fulton County",2,22,208,112,96
050,18,049,"Indiana","Fulton County",2,23,223,109,114
050,18,049,"Indiana","Fulton County",2,24,221,112,109
050,18,049,"Indiana","Fulton County",2,25,210,114,96
050,18,049,"Indiana","Fulton County",2,26,218,115,103
050,18,049,"Indiana","Fulton County",2,27,232,115,117
050,18,049,"Indiana","Fulton County",2,28,231,123,108
050,18,049,"Indiana","Fulton County",2,29,257,129,128
050,18,049,"Indiana","Fulton County",2,30,254,124,130
050,18,049,"Indiana","Fulton County",2,31,242,121,121
050,18,049,"Indiana","Fulton County",2,32,237,122,115
050,18,049,"Indiana","Fulton County",2,33,213,112,101
050,18,049,"Indiana","Fulton County",2,34,218,119,99
050,18,049,"Indiana","Fulton County",2,35,222,116,106
050,18,049,"Indiana","Fulton County",2,36,240,116,124
050,18,049,"Indiana","Fulton County",2,37,247,125,122
050,18,049,"Indiana","Fulton County",2,38,243,130,113
050,18,049,"Indiana","Fulton County",2,39,254,134,120
050,18,049,"Indiana","Fulton County",2,40,253,132,121
050,18,049,"Indiana","Fulton County",2,41,247,121,126
050,18,049,"Indiana","Fulton County",2,42,262,126,136
050,18,049,"Indiana","Fulton County",2,43,242,122,120
050,18,049,"Indiana","Fulton County",2,44,225,109,116
050,18,049,"Indiana","Fulton County",2,45,230,116,114
050,18,049,"Indiana","Fulton County",2,46,227,114,113
050,18,049,"Indiana","Fulton County",2,47,242,127,115
050,18,049,"Indiana","Fulton County",2,48,270,144,126
050,18,049,"Indiana","Fulton County",2,49,279,150,129
050,18,049,"Indiana","Fulton County",2,50,260,135,125
050,18,049,"Indiana","Fulton County",2,51,224,117,107
050,18,049,"Indiana","Fulton County",2,52,215,112,103
050,18,049,"Indiana","Fulton County",2,53,238,126,112
050,18,049,"Indiana","Fulton County",2,54,247,126,121
050,18,049,"Indiana","Fulton County",2,55,250,124,126
050,18,049,"Indiana","Fulton County",2,56,275,136,139
050,18,049,"Indiana","Fulton County",2,57,299,140,159
050,18,049,"Indiana","Fulton County",2,58,307,154,153
050,18,049,"Indiana","Fulton County",2,59,314,159,155
050,18,049,"Indiana","Fulton County",2,60,303,152,151
050,18,049,"Indiana","Fulton County",2,61,302,153,149
050,18,049,"Indiana","Fulton County",2,62,293,151,142
050,18,049,"Indiana","Fulton County",2,63,271,143,128
050,18,049,"Indiana","Fulton County",2,64,265,137,128
050,18,049,"Indiana","Fulton County",2,65,276,139,137
050,18,049,"Indiana","Fulton County",2,66,278,143,135
050,18,049,"Indiana","Fulton County",2,67,267,141,126
050,18,049,"Indiana","Fulton County",2,68,271,141,130
050,18,049,"Indiana","Fulton County",2,69,253,123,130
050,18,049,"Indiana","Fulton County",2,70,232,114,118
050,18,049,"Indiana","Fulton County",2,71,220,105,115
050,18,049,"Indiana","Fulton County",2,72,225,109,116
050,18,049,"Indiana","Fulton County",2,73,230,111,119
050,18,049,"Indiana","Fulton County",2,74,158,77,81
050,18,049,"Indiana","Fulton County",2,75,146,67,79
050,18,049,"Indiana","Fulton County",2,76,150,68,82
050,18,049,"Indiana","Fulton County",2,77,161,65,96
050,18,049,"Indiana","Fulton County",2,78,143,68,75
050,18,049,"Indiana","Fulton County",2,79,129,59,70
050,18,049,"Indiana","Fulton County",2,80,115,48,67
050,18,049,"Indiana","Fulton County",2,81,104,41,63
050,18,049,"Indiana","Fulton County",2,82,92,34,58
050,18,049,"Indiana","Fulton County",2,83,85,35,50
050,18,049,"Indiana","Fulton County",2,84,79,28,51
050,18,049,"Indiana","Fulton County",2,85,428,157,271
050,18,049,"Indiana","Fulton County",3,0,220,112,108
050,18,049,"Indiana","Fulton County",3,1,215,113,102
050,18,049,"Indiana","Fulton County",3,2,234,126,108
050,18,049,"Indiana","Fulton County",3,3,252,125,127
050,18,049,"Indiana","Fulton County",3,4,242,135,107
050,18,049,"Indiana","Fulton County",3,5,295,146,149
050,18,049,"Indiana","Fulton County",3,6,288,154,134
050,18,049,"Indiana","Fulton County",3,7,268,142,126
050,18,049,"Indiana","Fulton County",3,8,262,128,134
050,18,049,"Indiana","Fulton County",3,9,262,125,137
050,18,049,"Indiana","Fulton County",3,10,256,120,136
050,18,049,"Indiana","Fulton County",3,11,271,130,141
050,18,049,"Indiana","Fulton County",3,12,279,143,136
050,18,049,"Indiana","Fulton County",3,13,301,164,137
050,18,049,"Indiana","Fulton County",3,14,291,157,134
050,18,049,"Indiana","Fulton County",3,15,277,140,137
050,18,049,"Indiana","Fulton County",3,16,305,153,152
050,18,049,"Indiana","Fulton County",3,17,299,155,144
050,18,049,"Indiana","Fulton County",3,18,236,131,105
050,18,049,"Indiana","Fulton County",3,19,175,94,81
050,18,049,"Indiana","Fulton County",3,20,211,109,102
050,18,049,"Indiana","Fulton County",3,21,219,126,93
050,18,049,"Indiana","Fulton County",3,22,216,114,102
050,18,049,"Indiana","Fulton County",3,23,221,116,105
050,18,049,"Indiana","Fulton County",3,24,228,122,106
050,18,049,"Indiana","Fulton County",3,25,219,117,102
050,18,049,"Indiana","Fulton County",3,26,196,108,88
050,18,049,"Indiana","Fulton County",3,27,233,123,110
050,18,049,"Indiana","Fulton County",3,28,231,114,117
050,18,049,"Indiana","Fulton County",3,29,231,119,112
050,18,049,"Indiana","Fulton County",3,30,251,125,126
050,18,049,"Indiana","Fulton County",3,31,259,130,129
050,18,049,"Indiana","Fulton County",3,32,239,122,117
050,18,049,"Indiana","Fulton County",3,33,236,128,108
050,18,049,"Indiana","Fulton County",3,34,200,105,95
050,18,049,"Indiana","Fulton County",3,35,229,120,109
050,18,049,"Indiana","Fulton County",3,36,218,113,105
050,18,049,"Indiana","Fulton County",3,37,245,119,126
050,18,049,"Indiana","Fulton County",3,38,242,123,119
050,18,049,"Indiana","Fulton County",3,39,246,127,119
050,18,049,"Indiana","Fulton County",3,40,255,135,120
050,18,049,"Indiana","Fulton County",3,41,251,128,123
050,18,049,"Indiana","Fulton County",3,42,246,122,124
050,18,049,"Indiana","Fulton County",3,43,252,123,129
050,18,049,"Indiana","Fulton County",3,44,244,127,117
050,18,049,"Indiana","Fulton County",3,45,239,117,122
050,18,049,"Indiana","Fulton County",3,46,227,112,115
050,18,049,"Indiana","Fulton County",3,47,236,121,115
050,18,049,"Indiana","Fulton County",3,48,246,127,119
050,18,049,"Indiana","Fulton County",3,49,280,151,129
050,18,049,"Indiana","Fulton County",3,50,269,144,125
050,18,049,"Indiana","Fulton County",3,51,261,135,126
050,18,049,"Indiana","Fulton County",3,52,228,114,114
050,18,049,"Indiana","Fulton County",3,53,208,107,101
050,18,049,"Indiana","Fulton County",3,54,238,125,113
050,18,049,"Indiana","Fulton County",3,55,246,128,118
050,18,049,"Indiana","Fulton County",3,56,249,126,123
050,18,049,"Indiana","Fulton County",3,57,269,131,138
050,18,049,"Indiana","Fulton County",3,58,299,140,159
050,18,049,"Indiana","Fulton County",3,59,302,154,148
050,18,049,"Indiana","Fulton County",3,60,311,156,155
050,18,049,"Indiana","Fulton County",3,61,306,155,151
050,18,049,"Indiana","Fulton County",3,62,298,149,149
050,18,049,"Indiana","Fulton County",3,63,289,148,141
050,18,049,"Indiana","Fulton County",3,64,264,137,127
050,18,049,"Indiana","Fulton County",3,65,268,140,128
050,18,049,"Indiana","Fulton County",3,66,277,140,137
050,18,049,"Indiana","Fulton County",3,67,268,140,128
050,18,049,"Indiana","Fulton County",3,68,261,137,124
050,18,049,"Indiana","Fulton County",3,69,261,136,125
050,18,049,"Indiana","Fulton County",3,70,249,120,129
050,18,049,"Indiana","Fulton County",3,71,222,109,113
050,18,049,"Indiana","Fulton County",3,72,213,102,111
050,18,049,"Indiana","Fulton County",3,73,218,107,111
050,18,049,"Indiana","Fulton County",3,74,226,109,117
050,18,049,"Indiana","Fulton County",3,75,156,75,81
050,18,049,"Indiana","Fulton County",3,76,142,65,77
050,18,049,"Indiana","Fulton County",3,77,142,64,78
050,18,049,"Indiana","Fulton County",3,78,152,64,88
050,18,049,"Indiana","Fulton County",3,79,138,64,74
050,18,049,"Indiana","Fulton County",3,80,117,55,62
050,18,049,"Indiana","Fulton County",3,81,110,47,63
050,18,049,"Indiana","Fulton County",3,82,98,37,61
050,18,049,"Indiana","Fulton County",3,83,84,33,51
050,18,049,"Indiana","Fulton County",3,84,79,30,49
050,18,049,"Indiana","Fulton County",3,85,420,156,264
050,18,049,"Indiana","Fulton County",4,0,235,122,113
050,18,049,"Indiana","Fulton County",4,1,210,112,98
050,18,049,"Indiana","Fulton County",4,2,227,118,109
050,18,049,"Indiana","Fulton County",4,3,244,129,115
050,18,049,"Indiana","Fulton County",4,4,251,122,129
050,18,049,"Indiana","Fulton County",4,5,256,139,117
050,18,049,"Indiana","Fulton County",4,6,290,144,146
050,18,049,"Indiana","Fulton County",4,7,292,159,133
050,18,049,"Indiana","Fulton County",4,8,284,151,133
050,18,049,"Indiana","Fulton County",4,9,267,134,133
050,18,049,"Indiana","Fulton County",4,10,262,131,131
050,18,049,"Indiana","Fulton County",4,11,254,117,137
050,18,049,"Indiana","Fulton County",4,12,263,131,132
050,18,049,"Indiana","Fulton County",4,13,298,154,144
050,18,049,"Indiana","Fulton County",4,14,295,156,139
050,18,049,"Indiana","Fulton County",4,15,290,151,139
050,18,049,"Indiana","Fulton County",4,16,276,142,134
050,18,049,"Indiana","Fulton County",4,17,306,150,156
050,18,049,"Indiana","Fulton County",4,18,249,136,113
050,18,049,"Indiana","Fulton County",4,19,177,99,78
050,18,049,"Indiana","Fulton County",4,20,175,87,88
050,18,049,"Indiana","Fulton County",4,21,201,101,100
050,18,049,"Indiana","Fulton County",4,22,204,113,91
050,18,049,"Indiana","Fulton County",4,23,221,119,102
050,18,049,"Indiana","Fulton County",4,24,225,123,102
050,18,049,"Indiana","Fulton County",4,25,228,120,108
050,18,049,"Indiana","Fulton County",4,26,231,120,111
050,18,049,"Indiana","Fulton County",4,27,219,124,95
050,18,049,"Indiana","Fulton County",4,28,240,127,113
050,18,049,"Indiana","Fulton County",4,29,231,113,118
050,18,049,"Indiana","Fulton County",4,30,213,111,102
050,18,049,"Indiana","Fulton County",4,31,263,132,131
050,18,049,"Indiana","Fulton County",4,32,262,133,129
050,18,049,"Indiana","Fulton County",4,33,242,123,119
050,18,049,"Indiana","Fulton County",4,34,237,128,109
050,18,049,"Indiana","Fulton County",4,35,199,103,96
050,18,049,"Indiana","Fulton County",4,36,230,124,106
050,18,049,"Indiana","Fulton County",4,37,221,119,102
050,18,049,"Indiana","Fulton County",4,38,239,121,118
050,18,049,"Indiana","Fulton County",4,39,239,122,117
050,18,049,"Indiana","Fulton County",4,40,254,127,127
050,18,049,"Indiana","Fulton County",4,41,260,139,121
050,18,049,"Indiana","Fulton County",4,42,254,132,122
050,18,049,"Indiana","Fulton County",4,43,242,117,125
050,18,049,"Indiana","Fulton County",4,44,251,123,128
050,18,049,"Indiana","Fulton County",4,45,245,123,122
050,18,049,"Indiana","Fulton County",4,46,235,116,119
050,18,049,"Indiana","Fulton County",4,47,221,112,109
050,18,049,"Indiana","Fulton County",4,48,232,118,114
050,18,049,"Indiana","Fulton County",4,49,238,123,115
050,18,049,"Indiana","Fulton County",4,50,272,148,124
050,18,049,"Indiana","Fulton County",4,51,270,146,124
050,18,049,"Indiana","Fulton County",4,52,249,127,122
050,18,049,"Indiana","Fulton County",4,53,219,111,108
050,18,049,"Indiana","Fulton County",4,54,206,102,104
050,18,049,"Indiana","Fulton County",4,55,236,121,115
050,18,049,"Indiana","Fulton County",4,56,252,133,119
050,18,049,"Indiana","Fulton County",4,57,245,119,126
050,18,049,"Indiana","Fulton County",4,58,263,127,136
050,18,049,"Indiana","Fulton County",4,59,301,145,156
050,18,049,"Indiana","Fulton County",4,60,299,155,144
050,18,049,"Indiana","Fulton County",4,61,311,159,152
050,18,049,"Indiana","Fulton County",4,62,302,151,151
050,18,049,"Indiana","Fulton County",4,63,309,158,151
050,18,049,"Indiana","Fulton County",4,64,287,145,142
050,18,049,"Indiana","Fulton County",4,65,262,138,124
050,18,049,"Indiana","Fulton County",4,66,269,138,131
050,18,049,"Indiana","Fulton County",4,67,267,134,133
050,18,049,"Indiana","Fulton County",4,68,254,137,117
050,18,049,"Indiana","Fulton County",4,69,260,135,125
050,18,049,"Indiana","Fulton County",4,70,263,134,129
050,18,049,"Indiana","Fulton County",4,71,246,117,129
050,18,049,"Indiana","Fulton County",4,72,217,107,110
050,18,049,"Indiana","Fulton County",4,73,202,89,113
050,18,049,"Indiana","Fulton County",4,74,204,98,106
050,18,049,"Indiana","Fulton County",4,75,214,103,111
050,18,049,"Indiana","Fulton County",4,76,150,75,75
050,18,049,"Indiana","Fulton County",4,77,138,60,78
050,18,049,"Indiana","Fulton County",4,78,134,61,73
050,18,049,"Indiana","Fulton County",4,79,153,62,91
050,18,049,"Indiana","Fulton County",4,80,121,61,60
050,18,049,"Indiana","Fulton County",4,81,115,58,57
050,18,049,"Indiana","Fulton County",4,82,106,42,64
050,18,049,"Indiana","Fulton County",4,83,86,32,54
050,18,049,"Indiana","Fulton County",4,84,83,31,52
050,18,049,"Indiana","Fulton County",4,85,425,161,264
050,18,049,"Indiana","Fulton County",5,0,230,120,110
050,18,049,"Indiana","Fulton County",5,1,237,130,107
050,18,049,"Indiana","Fulton County",5,2,216,109,107
050,18,049,"Indiana","Fulton County",5,3,238,120,118
050,18,049,"Indiana","Fulton County",5,4,248,130,118
050,18,049,"Indiana","Fulton County",5,5,255,125,130
050,18,049,"Indiana","Fulton County",5,6,268,137,131
050,18,049,"Indiana","Fulton County",5,7,284,143,141
050,18,049,"Indiana","Fulton County",5,8,280,156,124
050,18,049,"Indiana","Fulton County",5,9,266,144,122
050,18,049,"Indiana","Fulton County",5,10,262,133,129
050,18,049,"Indiana","Fulton County",5,11,253,126,127
050,18,049,"Indiana","Fulton County",5,12,257,120,137
050,18,049,"Indiana","Fulton County",5,13,262,128,134
050,18,049,"Indiana","Fulton County",5,14,298,155,143
050,18,049,"Indiana","Fulton County",5,15,305,158,147
050,18,049,"Indiana","Fulton County",5,16,291,150,141
050,18,049,"Indiana","Fulton County",5,17,282,144,138
050,18,049,"Indiana","Fulton County",5,18,253,126,127
050,18,049,"Indiana","Fulton County",5,19,189,101,88
050,18,049,"Indiana","Fulton County",5,20,182,105,77
050,18,049,"Indiana","Fulton County",5,21,187,96,91
050,18,049,"Indiana","Fulton County",5,22,206,103,103
050,18,049,"Indiana","Fulton County",5,23,196,107,89
050,18,049,"Indiana","Fulton County",5,24,229,119,110
050,18,049,"Indiana","Fulton County",5,25,233,130,103
050,18,049,"Indiana","Fulton County",5,26,231,119,112
050,18,049,"Indiana","Fulton County",5,27,253,136,117
050,18,049,"Indiana","Fulton County",5,28,216,126,90
050,18,049,"Indiana","Fulton County",5,29,242,130,112
050,18,049,"Indiana","Fulton County",5,30,226,105,121
050,18,049,"Indiana","Fulton County",5,31,217,111,106
050,18,049,"Indiana","Fulton County",5,32,253,121,132
050,18,049,"Indiana","Fulton County",5,33,267,132,135
050,18,049,"Indiana","Fulton County",5,34,239,121,118
050,18,049,"Indiana","Fulton County",5,35,243,134,109
050,18,049,"Indiana","Fulton County",5,36,198,104,94
050,18,049,"Indiana","Fulton County",5,37,238,128,110
050,18,049,"Indiana","Fulton County",5,38,222,118,104
050,18,049,"Indiana","Fulton County",5,39,237,118,119
050,18,049,"Indiana","Fulton County",5,40,233,118,115
050,18,049,"Indiana","Fulton County",5,41,246,123,123
050,18,049,"Indiana","Fulton County",5,42,265,141,124
050,18,049,"Indiana","Fulton County",5,43,246,130,116
050,18,049,"Indiana","Fulton County",5,44,240,116,124
050,18,049,"Indiana","Fulton County",5,45,256,129,127
050,18,049,"Indiana","Fulton County",5,46,239,118,121
050,18,049,"Indiana","Fulton County",5,47,230,111,119
050,18,049,"Indiana","Fulton County",5,48,228,112,116
050,18,049,"Indiana","Fulton County",5,49,233,120,113
050,18,049,"Indiana","Fulton County",5,50,237,120,117
050,18,049,"Indiana","Fulton County",5,51,273,150,123
050,18,049,"Indiana","Fulton County",5,52,262,138,124
050,18,049,"Indiana","Fulton County",5,53,257,132,125
050,18,049,"Indiana","Fulton County",5,54,217,111,106
050,18,049,"Indiana","Fulton County",5,55,208,101,107
050,18,049,"Indiana","Fulton County",5,56,238,127,111
050,18,049,"Indiana","Fulton County",5,57,242,123,119
050,18,049,"Indiana","Fulton County",5,58,237,116,121
050,18,049,"Indiana","Fulton County",5,59,264,128,136
050,18,049,"Indiana","Fulton County",5,60,305,145,160
050,18,049,"Indiana","Fulton County",5,61,297,154,143
050,18,049,"Indiana","Fulton County",5,62,311,159,152
050,18,049,"Indiana","Fulton County",5,63,307,155,152
050,18,049,"Indiana","Fulton County",5,64,305,154,151
050,18,049,"Indiana","Fulton County",5,65,283,140,143
050,18,049,"Indiana","Fulton County",5,66,268,140,128
050,18,049,"Indiana","Fulton County",5,67,268,136,132
050,18,049,"Indiana","Fulton County",5,68,261,134,127
050,18,049,"Indiana","Fulton County",5,69,252,135,117
050,18,049,"Indiana","Fulton County",5,70,254,131,123
050,18,049,"Indiana","Fulton County",5,71,255,129,126
050,18,049,"Indiana","Fulton County",5,72,239,111,128
050,18,049,"Indiana","Fulton County",5,73,208,102,106
050,18,049,"Indiana","Fulton County",5,74,194,84,110
050,18,049,"Indiana","Fulton County",5,75,194,92,102
050,18,049,"Indiana","Fulton County",5,76,208,97,111
050,18,049,"Indiana","Fulton County",5,77,145,70,75
050,18,049,"Indiana","Fulton County",5,78,134,58,76
050,18,049,"Indiana","Fulton County",5,79,134,58,76
050,18,049,"Indiana","Fulton County",5,80,140,61,79
050,18,049,"Indiana","Fulton County",5,81,118,63,55
050,18,049,"Indiana","Fulton County",5,82,109,52,57
050,18,049,"Indiana","Fulton County",5,83,97,40,57
050,18,049,"Indiana","Fulton County",5,84,82,29,53
050,18,049,"Indiana","Fulton County",5,85,450,173,277
050,18,051,"Indiana","Gibson County",1,0,391,200,191
050,18,051,"Indiana","Gibson County",1,1,392,198,194
050,18,051,"Indiana","Gibson County",1,2,422,213,209
050,18,051,"Indiana","Gibson County",1,3,432,239,193
050,18,051,"Indiana","Gibson County",1,4,446,243,203
050,18,051,"Indiana","Gibson County",1,5,452,231,221
050,18,051,"Indiana","Gibson County",1,6,435,228,207
050,18,051,"Indiana","Gibson County",1,7,431,227,204
050,18,051,"Indiana","Gibson County",1,8,441,235,206
050,18,051,"Indiana","Gibson County",1,9,425,224,201
050,18,051,"Indiana","Gibson County",1,10,449,243,206
050,18,051,"Indiana","Gibson County",1,11,459,242,217
050,18,051,"Indiana","Gibson County",1,12,479,246,233
050,18,051,"Indiana","Gibson County",1,13,465,247,218
050,18,051,"Indiana","Gibson County",1,14,473,245,228
050,18,051,"Indiana","Gibson County",1,15,482,242,240
050,18,051,"Indiana","Gibson County",1,16,478,246,232
050,18,051,"Indiana","Gibson County",1,17,470,227,243
050,18,051,"Indiana","Gibson County",1,18,391,209,182
050,18,051,"Indiana","Gibson County",1,19,338,177,161
050,18,051,"Indiana","Gibson County",1,20,359,198,161
050,18,051,"Indiana","Gibson County",1,21,400,215,185
050,18,051,"Indiana","Gibson County",1,22,370,181,189
050,18,051,"Indiana","Gibson County",1,23,340,163,177
050,18,051,"Indiana","Gibson County",1,24,362,186,176
050,18,051,"Indiana","Gibson County",1,25,400,208,192
050,18,051,"Indiana","Gibson County",1,26,383,199,184
050,18,051,"Indiana","Gibson County",1,27,385,202,183
050,18,051,"Indiana","Gibson County",1,28,433,209,224
050,18,051,"Indiana","Gibson County",1,29,412,189,223
050,18,051,"Indiana","Gibson County",1,30,407,198,209
050,18,051,"Indiana","Gibson County",1,31,379,202,177
050,18,051,"Indiana","Gibson County",1,32,400,194,206
050,18,051,"Indiana","Gibson County",1,33,364,184,180
050,18,051,"Indiana","Gibson County",1,34,366,184,182
050,18,051,"Indiana","Gibson County",1,35,395,198,197
050,18,051,"Indiana","Gibson County",1,36,378,200,178
050,18,051,"Indiana","Gibson County",1,37,437,227,210
050,18,051,"Indiana","Gibson County",1,38,449,244,205
050,18,051,"Indiana","Gibson County",1,39,417,222,195
050,18,051,"Indiana","Gibson County",1,40,384,196,188
050,18,051,"Indiana","Gibson County",1,41,389,199,190
050,18,051,"Indiana","Gibson County",1,42,412,213,199
050,18,051,"Indiana","Gibson County",1,43,383,202,181
050,18,051,"Indiana","Gibson County",1,44,344,176,168
050,18,051,"Indiana","Gibson County",1,45,361,178,183
050,18,051,"Indiana","Gibson County",1,46,371,181,190
050,18,051,"Indiana","Gibson County",1,47,407,206,201
050,18,051,"Indiana","Gibson County",1,48,418,223,195
050,18,051,"Indiana","Gibson County",1,49,444,225,219
050,18,051,"Indiana","Gibson County",1,50,427,214,213
050,18,051,"Indiana","Gibson County",1,51,417,217,200
050,18,051,"Indiana","Gibson County",1,52,397,207,190
050,18,051,"Indiana","Gibson County",1,53,421,208,213
050,18,051,"Indiana","Gibson County",1,54,426,216,210
050,18,051,"Indiana","Gibson County",1,55,464,254,210
050,18,051,"Indiana","Gibson County",1,56,457,234,223
050,18,051,"Indiana","Gibson County",1,57,473,249,224
050,18,051,"Indiana","Gibson County",1,58,460,242,218
050,18,051,"Indiana","Gibson County",1,59,480,254,226
050,18,051,"Indiana","Gibson County",1,60,474,236,238
050,18,051,"Indiana","Gibson County",1,61,509,247,262
050,18,051,"Indiana","Gibson County",1,62,485,242,243
050,18,051,"Indiana","Gibson County",1,63,458,236,222
050,18,051,"Indiana","Gibson County",1,64,427,219,208
050,18,051,"Indiana","Gibson County",1,65,401,189,212
050,18,051,"Indiana","Gibson County",1,66,397,196,201
050,18,051,"Indiana","Gibson County",1,67,387,201,186
050,18,051,"Indiana","Gibson County",1,68,420,211,209
050,18,051,"Indiana","Gibson County",1,69,329,162,167
050,18,051,"Indiana","Gibson County",1,70,313,150,163
050,18,051,"Indiana","Gibson County",1,71,315,147,168
050,18,051,"Indiana","Gibson County",1,72,305,147,158
050,18,051,"Indiana","Gibson County",1,73,306,141,165
050,18,051,"Indiana","Gibson County",1,74,215,96,119
050,18,051,"Indiana","Gibson County",1,75,206,85,121
050,18,051,"Indiana","Gibson County",1,76,220,104,116
050,18,051,"Indiana","Gibson County",1,77,206,98,108
050,18,051,"Indiana","Gibson County",1,78,186,88,98
050,18,051,"Indiana","Gibson County",1,79,175,75,100
050,18,051,"Indiana","Gibson County",1,80,149,62,87
050,18,051,"Indiana","Gibson County",1,81,156,68,88
050,18,051,"Indiana","Gibson County",1,82,135,59,76
050,18,051,"Indiana","Gibson County",1,83,117,45,72
050,18,051,"Indiana","Gibson County",1,84,108,40,68
050,18,051,"Indiana","Gibson County",1,85,687,236,451
050,18,051,"Indiana","Gibson County",2,0,393,204,189
050,18,051,"Indiana","Gibson County",2,1,392,200,192
050,18,051,"Indiana","Gibson County",2,2,418,212,206
050,18,051,"Indiana","Gibson County",2,3,428,231,197
050,18,051,"Indiana","Gibson County",2,4,448,244,204
050,18,051,"Indiana","Gibson County",2,5,452,233,219
050,18,051,"Indiana","Gibson County",2,6,441,231,210
050,18,051,"Indiana","Gibson County",2,7,432,227,205
050,18,051,"Indiana","Gibson County",2,8,436,233,203
050,18,051,"Indiana","Gibson County",2,9,431,229,202
050,18,051,"Indiana","Gibson County",2,10,443,238,205
050,18,051,"Indiana","Gibson County",2,11,456,241,215
050,18,051,"Indiana","Gibson County",2,12,477,247,230
050,18,051,"Indiana","Gibson County",2,13,467,244,223
050,18,051,"Indiana","Gibson County",2,14,470,244,226
050,18,051,"Indiana","Gibson County",2,15,478,242,236
050,18,051,"Indiana","Gibson County",2,16,483,245,238
050,18,051,"Indiana","Gibson County",2,17,473,232,241
050,18,051,"Indiana","Gibson County",2,18,394,206,188
050,18,051,"Indiana","Gibson County",2,19,344,181,163
050,18,051,"Indiana","Gibson County",2,20,365,199,166
050,18,051,"Indiana","Gibson County",2,21,392,214,178
050,18,051,"Indiana","Gibson County",2,22,376,184,192
050,18,051,"Indiana","Gibson County",2,23,348,170,178
050,18,051,"Indiana","Gibson County",2,24,363,183,180
050,18,051,"Indiana","Gibson County",2,25,395,205,190
050,18,051,"Indiana","Gibson County",2,26,391,205,186
050,18,051,"Indiana","Gibson County",2,27,388,205,183
050,18,051,"Indiana","Gibson County",2,28,422,207,215
050,18,051,"Indiana","Gibson County",2,29,423,197,226
050,18,051,"Indiana","Gibson County",2,30,414,199,215
050,18,051,"Indiana","Gibson County",2,31,389,203,186
050,18,051,"Indiana","Gibson County",2,32,396,197,199
050,18,051,"Indiana","Gibson County",2,33,372,185,187
050,18,051,"Indiana","Gibson County",2,34,368,186,182
050,18,051,"Indiana","Gibson County",2,35,392,198,194
050,18,051,"Indiana","Gibson County",2,36,380,198,182
050,18,051,"Indiana","Gibson County",2,37,424,222,202
050,18,051,"Indiana","Gibson County",2,38,448,241,207
050,18,051,"Indiana","Gibson County",2,39,421,226,195
050,18,051,"Indiana","Gibson County",2,40,395,205,190
050,18,051,"Indiana","Gibson County",2,41,386,197,189
050,18,051,"Indiana","Gibson County",2,42,407,210,197
050,18,051,"Indiana","Gibson County",2,43,391,205,186
050,18,051,"Indiana","Gibson County",2,44,351,182,169
050,18,051,"Indiana","Gibson County",2,45,358,179,179
050,18,051,"Indiana","Gibson County",2,46,366,180,186
050,18,051,"Indiana","Gibson County",2,47,393,198,195
050,18,051,"Indiana","Gibson County",2,48,417,219,198
050,18,051,"Indiana","Gibson County",2,49,438,225,213
050,18,051,"Indiana","Gibson County",2,50,432,218,214
050,18,051,"Indiana","Gibson County",2,51,417,215,202
050,18,051,"Indiana","Gibson County",2,52,399,209,190
050,18,051,"Indiana","Gibson County",2,53,416,208,208
050,18,051,"Indiana","Gibson County",2,54,421,213,208
050,18,051,"Indiana","Gibson County",2,55,454,245,209
050,18,051,"Indiana","Gibson County",2,56,461,240,221
050,18,051,"Indiana","Gibson County",2,57,468,245,223
050,18,051,"Indiana","Gibson County",2,58,463,245,218
050,18,051,"Indiana","Gibson County",2,59,478,252,226
050,18,051,"Indiana","Gibson County",2,60,475,241,234
050,18,051,"Indiana","Gibson County",2,61,496,240,256
050,18,051,"Indiana","Gibson County",2,62,488,243,245
050,18,051,"Indiana","Gibson County",2,63,468,238,230
050,18,051,"Indiana","Gibson County",2,64,431,222,209
050,18,051,"Indiana","Gibson County",2,65,407,195,212
050,18,051,"Indiana","Gibson County",2,66,398,194,204
050,18,051,"Indiana","Gibson County",2,67,389,200,189
050,18,051,"Indiana","Gibson County",2,68,405,205,200
050,18,051,"Indiana","Gibson County",2,69,355,176,179
050,18,051,"Indiana","Gibson County",2,70,316,152,164
050,18,051,"Indiana","Gibson County",2,71,314,146,168
050,18,051,"Indiana","Gibson County",2,72,299,144,155
050,18,051,"Indiana","Gibson County",2,73,316,147,169
050,18,051,"Indiana","Gibson County",2,74,222,100,122
050,18,051,"Indiana","Gibson County",2,75,205,85,120
050,18,051,"Indiana","Gibson County",2,76,215,99,116
050,18,051,"Indiana","Gibson County",2,77,215,102,113
050,18,051,"Indiana","Gibson County",2,78,181,85,96
050,18,051,"Indiana","Gibson County",2,79,173,77,96
050,18,051,"Indiana","Gibson County",2,80,152,64,88
050,18,051,"Indiana","Gibson County",2,81,152,64,88
050,18,051,"Indiana","Gibson County",2,82,138,59,79
050,18,051,"Indiana","Gibson County",2,83,118,49,69
050,18,051,"Indiana","Gibson County",2,84,107,38,69
050,18,051,"Indiana","Gibson County",2,85,680,231,449
050,18,051,"Indiana","Gibson County",3,0,374,192,182
050,18,051,"Indiana","Gibson County",3,1,406,205,201
050,18,051,"Indiana","Gibson County",3,2,404,213,191
050,18,051,"Indiana","Gibson County",3,3,426,213,213
050,18,051,"Indiana","Gibson County",3,4,444,238,206
050,18,051,"Indiana","Gibson County",3,5,443,239,204
050,18,051,"Indiana","Gibson County",3,6,444,223,221
050,18,051,"Indiana","Gibson County",3,7,432,222,210
050,18,051,"Indiana","Gibson County",3,8,441,231,210
050,18,051,"Indiana","Gibson County",3,9,425,228,197
050,18,051,"Indiana","Gibson County",3,10,431,227,204
050,18,051,"Indiana","Gibson County",3,11,446,242,204
050,18,051,"Indiana","Gibson County",3,12,453,243,210
050,18,051,"Indiana","Gibson County",3,13,478,245,233
050,18,051,"Indiana","Gibson County",3,14,468,243,225
050,18,051,"Indiana","Gibson County",3,15,492,258,234
050,18,051,"Indiana","Gibson County",3,16,470,236,234
050,18,051,"Indiana","Gibson County",3,17,489,252,237
050,18,051,"Indiana","Gibson County",3,18,419,210,209
050,18,051,"Indiana","Gibson County",3,19,359,180,179
050,18,051,"Indiana","Gibson County",3,20,367,195,172
050,18,051,"Indiana","Gibson County",3,21,381,211,170
050,18,051,"Indiana","Gibson County",3,22,388,199,189
050,18,051,"Indiana","Gibson County",3,23,386,198,188
050,18,051,"Indiana","Gibson County",3,24,339,156,183
050,18,051,"Indiana","Gibson County",3,25,368,182,186
050,18,051,"Indiana","Gibson County",3,26,389,204,185
050,18,051,"Indiana","Gibson County",3,27,388,209,179
050,18,051,"Indiana","Gibson County",3,28,390,207,183
050,18,051,"Indiana","Gibson County",3,29,414,200,214
050,18,051,"Indiana","Gibson County",3,30,425,191,234
050,18,051,"Indiana","Gibson County",3,31,419,200,219
050,18,051,"Indiana","Gibson County",3,32,386,198,188
050,18,051,"Indiana","Gibson County",3,33,394,197,197
050,18,051,"Indiana","Gibson County",3,34,371,178,193
050,18,051,"Indiana","Gibson County",3,35,373,189,184
050,18,051,"Indiana","Gibson County",3,36,396,203,193
050,18,051,"Indiana","Gibson County",3,37,384,198,186
050,18,051,"Indiana","Gibson County",3,38,435,234,201
050,18,051,"Indiana","Gibson County",3,39,431,231,200
050,18,051,"Indiana","Gibson County",3,40,433,234,199
050,18,051,"Indiana","Gibson County",3,41,397,206,191
050,18,051,"Indiana","Gibson County",3,42,385,197,188
050,18,051,"Indiana","Gibson County",3,43,402,210,192
050,18,051,"Indiana","Gibson County",3,44,391,210,181
050,18,051,"Indiana","Gibson County",3,45,351,179,172
050,18,051,"Indiana","Gibson County",3,46,362,183,179
050,18,051,"Indiana","Gibson County",3,47,365,184,181
050,18,051,"Indiana","Gibson County",3,48,374,197,177
050,18,051,"Indiana","Gibson County",3,49,423,218,205
050,18,051,"Indiana","Gibson County",3,50,423,214,209
050,18,051,"Indiana","Gibson County",3,51,432,220,212
050,18,051,"Indiana","Gibson County",3,52,423,219,204
050,18,051,"Indiana","Gibson County",3,53,401,213,188
050,18,051,"Indiana","Gibson County",3,54,402,197,205
050,18,051,"Indiana","Gibson County",3,55,412,208,204
050,18,051,"Indiana","Gibson County",3,56,447,241,206
050,18,051,"Indiana","Gibson County",3,57,463,242,221
050,18,051,"Indiana","Gibson County",3,58,465,243,222
050,18,051,"Indiana","Gibson County",3,59,459,240,219
050,18,051,"Indiana","Gibson County",3,60,464,248,216
050,18,051,"Indiana","Gibson County",3,61,468,237,231
050,18,051,"Indiana","Gibson County",3,62,481,235,246
050,18,051,"Indiana","Gibson County",3,63,481,239,242
050,18,051,"Indiana","Gibson County",3,64,444,224,220
050,18,051,"Indiana","Gibson County",3,65,413,214,199
050,18,051,"Indiana","Gibson County",3,66,400,190,210
050,18,051,"Indiana","Gibson County",3,67,392,192,200
050,18,051,"Indiana","Gibson County",3,68,377,193,184
050,18,051,"Indiana","Gibson County",3,69,392,202,190
050,18,051,"Indiana","Gibson County",3,70,347,172,175
050,18,051,"Indiana","Gibson County",3,71,310,145,165
050,18,051,"Indiana","Gibson County",3,72,308,142,166
050,18,051,"Indiana","Gibson County",3,73,292,142,150
050,18,051,"Indiana","Gibson County",3,74,308,146,162
050,18,051,"Indiana","Gibson County",3,75,206,90,116
050,18,051,"Indiana","Gibson County",3,76,191,76,115
050,18,051,"Indiana","Gibson County",3,77,196,88,108
050,18,051,"Indiana","Gibson County",3,78,203,94,109
050,18,051,"Indiana","Gibson County",3,79,175,80,95
050,18,051,"Indiana","Gibson County",3,80,158,69,89
050,18,051,"Indiana","Gibson County",3,81,145,60,85
050,18,051,"Indiana","Gibson County",3,82,149,61,88
050,18,051,"Indiana","Gibson County",3,83,121,52,69
050,18,051,"Indiana","Gibson County",3,84,105,44,61
050,18,051,"Indiana","Gibson County",3,85,661,224,437
050,18,051,"Indiana","Gibson County",4,0,369,191,178
050,18,051,"Indiana","Gibson County",4,1,385,191,194
050,18,051,"Indiana","Gibson County",4,2,410,215,195
050,18,051,"Indiana","Gibson County",4,3,397,208,189
050,18,051,"Indiana","Gibson County",4,4,419,219,200
050,18,051,"Indiana","Gibson County",4,5,445,237,208
050,18,051,"Indiana","Gibson County",4,6,445,247,198
050,18,051,"Indiana","Gibson County",4,7,429,220,209
050,18,051,"Indiana","Gibson County",4,8,441,238,203
050,18,051,"Indiana","Gibson County",4,9,434,235,199
050,18,051,"Indiana","Gibson County",4,10,440,239,201
050,18,051,"Indiana","Gibson County",4,11,432,230,202
050,18,051,"Indiana","Gibson County",4,12,440,237,203
050,18,051,"Indiana","Gibson County",4,13,458,244,214
050,18,051,"Indiana","Gibson County",4,14,483,251,232
050,18,051,"Indiana","Gibson County",4,15,465,246,219
050,18,051,"Indiana","Gibson County",4,16,471,243,228
050,18,051,"Indiana","Gibson County",4,17,472,236,236
050,18,051,"Indiana","Gibson County",4,18,433,233,200
050,18,051,"Indiana","Gibson County",4,19,361,177,184
050,18,051,"Indiana","Gibson County",4,20,392,202,190
050,18,051,"Indiana","Gibson County",4,21,398,222,176
050,18,051,"Indiana","Gibson County",4,22,387,197,190
050,18,051,"Indiana","Gibson County",4,23,389,213,176
050,18,051,"Indiana","Gibson County",4,24,378,198,180
050,18,051,"Indiana","Gibson County",4,25,345,164,181
050,18,051,"Indiana","Gibson County",4,26,364,178,186
050,18,051,"Indiana","Gibson County",4,27,390,208,182
050,18,051,"Indiana","Gibson County",4,28,408,213,195
050,18,051,"Indiana","Gibson County",4,29,394,209,185
050,18,051,"Indiana","Gibson County",4,30,419,207,212
050,18,051,"Indiana","Gibson County",4,31,425,198,227
050,18,051,"Indiana","Gibson County",4,32,421,204,217
050,18,051,"Indiana","Gibson County",4,33,381,199,182
050,18,051,"Indiana","Gibson County",4,34,406,198,208
050,18,051,"Indiana","Gibson County",4,35,386,191,195
050,18,051,"Indiana","Gibson County",4,36,382,200,182
050,18,051,"Indiana","Gibson County",4,37,397,199,198
050,18,051,"Indiana","Gibson County",4,38,386,202,184
050,18,051,"Indiana","Gibson County",4,39,430,227,203
050,18,051,"Indiana","Gibson County",4,40,425,230,195
050,18,051,"Indiana","Gibson County",4,41,441,238,203
050,18,051,"Indiana","Gibson County",4,42,398,206,192
050,18,051,"Indiana","Gibson County",4,43,388,196,192
050,18,051,"Indiana","Gibson County",4,44,410,214,196
050,18,051,"Indiana","Gibson County",4,45,394,216,178
050,18,051,"Indiana","Gibson County",4,46,354,179,175
050,18,051,"Indiana","Gibson County",4,47,373,186,187
050,18,051,"Indiana","Gibson County",4,48,371,181,190
050,18,051,"Indiana","Gibson County",4,49,374,196,178
050,18,051,"Indiana","Gibson County",4,50,429,223,206
050,18,051,"Indiana","Gibson County",4,51,424,210,214
050,18,051,"Indiana","Gibson County",4,52,426,222,204
050,18,051,"Indiana","Gibson County",4,53,423,222,201
050,18,051,"Indiana","Gibson County",4,54,403,214,189
050,18,051,"Indiana","Gibson County",4,55,399,198,201
050,18,051,"Indiana","Gibson County",4,56,397,201,196
050,18,051,"Indiana","Gibson County",4,57,443,234,209
050,18,051,"Indiana","Gibson County",4,58,464,245,219
050,18,051,"Indiana","Gibson County",4,59,459,233,226
050,18,051,"Indiana","Gibson County",4,60,443,236,207
050,18,051,"Indiana","Gibson County",4,61,461,247,214
050,18,051,"Indiana","Gibson County",4,62,456,235,221
050,18,051,"Indiana","Gibson County",4,63,464,226,238
050,18,051,"Indiana","Gibson County",4,64,477,237,240
050,18,051,"Indiana","Gibson County",4,65,446,224,222
050,18,051,"Indiana","Gibson County",4,66,412,212,200
050,18,051,"Indiana","Gibson County",4,67,387,178,209
050,18,051,"Indiana","Gibson County",4,68,382,185,197
050,18,051,"Indiana","Gibson County",4,69,371,193,178
050,18,051,"Indiana","Gibson County",4,70,390,201,189
050,18,051,"Indiana","Gibson County",4,71,341,170,171
050,18,051,"Indiana","Gibson County",4,72,295,137,158
050,18,051,"Indiana","Gibson County",4,73,300,141,159
050,18,051,"Indiana","Gibson County",4,74,279,137,142
050,18,051,"Indiana","Gibson County",4,75,286,134,152
050,18,051,"Indiana","Gibson County",4,76,201,86,115
050,18,051,"Indiana","Gibson County",4,77,170,70,100
050,18,051,"Indiana","Gibson County",4,78,185,80,105
050,18,051,"Indiana","Gibson County",4,79,195,87,108
050,18,051,"Indiana","Gibson County",4,80,158,76,82
050,18,051,"Indiana","Gibson County",4,81,151,67,84
050,18,051,"Indiana","Gibson County",4,82,141,53,88
050,18,051,"Indiana","Gibson County",4,83,135,56,79
050,18,051,"Indiana","Gibson County",4,84,112,46,66
050,18,051,"Indiana","Gibson County",4,85,662,226,436
050,18,051,"Indiana","Gibson County",5,0,369,191,178
050,18,051,"Indiana","Gibson County",5,1,365,179,186
050,18,051,"Indiana","Gibson County",5,2,380,196,184
050,18,051,"Indiana","Gibson County",5,3,400,208,192
050,18,051,"Indiana","Gibson County",5,4,387,203,184
050,18,051,"Indiana","Gibson County",5,5,415,212,203
050,18,051,"Indiana","Gibson County",5,6,437,236,201
050,18,051,"Indiana","Gibson County",5,7,438,247,191
050,18,051,"Indiana","Gibson County",5,8,445,226,219
050,18,051,"Indiana","Gibson County",5,9,430,229,201
050,18,051,"Indiana","Gibson County",5,10,432,231,201
050,18,051,"Indiana","Gibson County",5,11,427,232,195
050,18,051,"Indiana","Gibson County",5,12,434,233,201
050,18,051,"Indiana","Gibson County",5,13,448,241,207
050,18,051,"Indiana","Gibson County",5,14,461,249,212
050,18,051,"Indiana","Gibson County",5,15,496,258,238
050,18,051,"Indiana","Gibson County",5,16,473,247,226
050,18,051,"Indiana","Gibson County",5,17,470,240,230
050,18,051,"Indiana","Gibson County",5,18,408,215,193
050,18,051,"Indiana","Gibson County",5,19,374,198,176
050,18,051,"Indiana","Gibson County",5,20,410,203,207
050,18,051,"Indiana","Gibson County",5,21,406,222,184
050,18,051,"Indiana","Gibson County",5,22,388,201,187
050,18,051,"Indiana","Gibson County",5,23,387,207,180
050,18,051,"Indiana","Gibson County",5,24,382,218,164
050,18,051,"Indiana","Gibson County",5,25,409,222,187
050,18,051,"Indiana","Gibson County",5,26,336,167,169
050,18,051,"Indiana","Gibson County",5,27,372,184,188
050,18,051,"Indiana","Gibson County",5,28,387,213,174
050,18,051,"Indiana","Gibson County",5,29,405,214,191
050,18,051,"Indiana","Gibson County",5,30,392,206,186
050,18,051,"Indiana","Gibson County",5,31,419,208,211
050,18,051,"Indiana","Gibson County",5,32,413,199,214
050,18,051,"Indiana","Gibson County",5,33,416,201,215
050,18,051,"Indiana","Gibson County",5,34,377,197,180
050,18,051,"Indiana","Gibson County",5,35,391,192,199
050,18,051,"Indiana","Gibson County",5,36,379,191,188
050,18,051,"Indiana","Gibson County",5,37,384,204,180
050,18,051,"Indiana","Gibson County",5,38,398,198,200
050,18,051,"Indiana","Gibson County",5,39,390,203,187
050,18,051,"Indiana","Gibson County",5,40,427,231,196
050,18,051,"Indiana","Gibson County",5,41,431,232,199
050,18,051,"Indiana","Gibson County",5,42,446,236,210
050,18,051,"Indiana","Gibson County",5,43,387,198,189
050,18,051,"Indiana","Gibson County",5,44,396,199,197
050,18,051,"Indiana","Gibson County",5,45,415,214,201
050,18,051,"Indiana","Gibson County",5,46,407,226,181
050,18,051,"Indiana","Gibson County",5,47,358,184,174
050,18,051,"Indiana","Gibson County",5,48,374,182,192
050,18,051,"Indiana","Gibson County",5,49,362,173,189
050,18,051,"Indiana","Gibson County",5,50,382,197,185
050,18,051,"Indiana","Gibson County",5,51,424,219,205
050,18,051,"Indiana","Gibson County",5,52,424,212,212
050,18,051,"Indiana","Gibson County",5,53,436,231,205
050,18,051,"Indiana","Gibson County",5,54,420,221,199
050,18,051,"Indiana","Gibson County",5,55,400,207,193
050,18,051,"Indiana","Gibson County",5,56,395,190,205
050,18,051,"Indiana","Gibson County",5,57,398,202,196
050,18,051,"Indiana","Gibson County",5,58,435,236,199
050,18,051,"Indiana","Gibson County",5,59,452,236,216
050,18,051,"Indiana","Gibson County",5,60,447,233,214
050,18,051,"Indiana","Gibson County",5,61,443,239,204
050,18,051,"Indiana","Gibson County",5,62,454,245,209
050,18,051,"Indiana","Gibson County",5,63,452,233,219
050,18,051,"Indiana","Gibson County",5,64,448,218,230
050,18,051,"Indiana","Gibson County",5,65,471,234,237
050,18,051,"Indiana","Gibson County",5,66,431,215,216
050,18,051,"Indiana","Gibson County",5,67,413,208,205
050,18,051,"Indiana","Gibson County",5,68,376,173,203
050,18,051,"Indiana","Gibson County",5,69,372,178,194
050,18,051,"Indiana","Gibson County",5,70,362,191,171
050,18,051,"Indiana","Gibson County",5,71,383,197,186
050,18,051,"Indiana","Gibson County",5,72,322,161,161
050,18,051,"Indiana","Gibson County",5,73,284,133,151
050,18,051,"Indiana","Gibson County",5,74,291,139,152
050,18,051,"Indiana","Gibson County",5,75,263,127,136
050,18,051,"Indiana","Gibson County",5,76,275,128,147
050,18,051,"Indiana","Gibson County",5,77,181,80,101
050,18,051,"Indiana","Gibson County",5,78,157,64,93
050,18,051,"Indiana","Gibson County",5,79,173,73,100
050,18,051,"Indiana","Gibson County",5,80,181,82,99
050,18,051,"Indiana","Gibson County",5,81,154,75,79
050,18,051,"Indiana","Gibson County",5,82,146,60,86
050,18,051,"Indiana","Gibson County",5,83,125,48,77
050,18,051,"Indiana","Gibson County",5,84,121,48,73
050,18,051,"Indiana","Gibson County",5,85,680,234,446
050,18,053,"Indiana","Grant County",1,0,770,398,372
050,18,053,"Indiana","Grant County",1,1,769,406,363
050,18,053,"Indiana","Grant County",1,2,802,389,413
050,18,053,"Indiana","Grant County",1,3,751,366,385
050,18,053,"Indiana","Grant County",1,4,755,375,380
050,18,053,"Indiana","Grant County",1,5,756,379,377
050,18,053,"Indiana","Grant County",1,6,740,382,358
050,18,053,"Indiana","Grant County",1,7,748,368,380
050,18,053,"Indiana","Grant County",1,8,723,372,351
050,18,053,"Indiana","Grant County",1,9,780,402,378
050,18,053,"Indiana","Grant County",1,10,806,434,372
050,18,053,"Indiana","Grant County",1,11,828,429,399
050,18,053,"Indiana","Grant County",1,12,852,429,423
050,18,053,"Indiana","Grant County",1,13,881,451,430
050,18,053,"Indiana","Grant County",1,14,850,446,404
050,18,053,"Indiana","Grant County",1,15,769,397,372
050,18,053,"Indiana","Grant County",1,16,829,418,411
050,18,053,"Indiana","Grant County",1,17,800,385,415
050,18,053,"Indiana","Grant County",1,18,1038,498,540
050,18,053,"Indiana","Grant County",1,19,1638,720,918
050,18,053,"Indiana","Grant County",1,20,1603,710,893
050,18,053,"Indiana","Grant County",1,21,1491,694,797
050,18,053,"Indiana","Grant County",1,22,1104,539,565
050,18,053,"Indiana","Grant County",1,23,764,400,364
050,18,053,"Indiana","Grant County",1,24,740,372,368
050,18,053,"Indiana","Grant County",1,25,743,372,371
050,18,053,"Indiana","Grant County",1,26,740,374,366
050,18,053,"Indiana","Grant County",1,27,766,380,386
050,18,053,"Indiana","Grant County",1,28,790,386,404
050,18,053,"Indiana","Grant County",1,29,756,354,402
050,18,053,"Indiana","Grant County",1,30,730,357,373
050,18,053,"Indiana","Grant County",1,31,729,359,370
050,18,053,"Indiana","Grant County",1,32,677,331,346
050,18,053,"Indiana","Grant County",1,33,677,312,365
050,18,053,"Indiana","Grant County",1,34,694,336,358
050,18,053,"Indiana","Grant County",1,35,652,303,349
050,18,053,"Indiana","Grant County",1,36,653,297,356
050,18,053,"Indiana","Grant County",1,37,694,324,370
050,18,053,"Indiana","Grant County",1,38,680,324,356
050,18,053,"Indiana","Grant County",1,39,715,335,380
050,18,053,"Indiana","Grant County",1,40,733,359,374
050,18,053,"Indiana","Grant County",1,41,723,362,361
050,18,053,"Indiana","Grant County",1,42,738,378,360
050,18,053,"Indiana","Grant County",1,43,695,342,353
050,18,053,"Indiana","Grant County",1,44,684,347,337
050,18,053,"Indiana","Grant County",1,45,713,367,346
050,18,053,"Indiana","Grant County",1,46,701,340,361
050,18,053,"Indiana","Grant County",1,47,727,347,380
050,18,053,"Indiana","Grant County",1,48,787,382,405
050,18,053,"Indiana","Grant County",1,49,855,423,432
050,18,053,"Indiana","Grant County",1,50,817,427,390
050,18,053,"Indiana","Grant County",1,51,794,402,392
050,18,053,"Indiana","Grant County",1,52,782,391,391
050,18,053,"Indiana","Grant County",1,53,788,400,388
050,18,053,"Indiana","Grant County",1,54,807,402,405
050,18,053,"Indiana","Grant County",1,55,868,427,441
050,18,053,"Indiana","Grant County",1,56,934,449,485
050,18,053,"Indiana","Grant County",1,57,943,465,478
050,18,053,"Indiana","Grant County",1,58,931,460,471
050,18,053,"Indiana","Grant County",1,59,961,457,504
050,18,053,"Indiana","Grant County",1,60,931,437,494
050,18,053,"Indiana","Grant County",1,61,951,448,503
050,18,053,"Indiana","Grant County",1,62,988,479,509
050,18,053,"Indiana","Grant County",1,63,926,452,474
050,18,053,"Indiana","Grant County",1,64,916,446,470
050,18,053,"Indiana","Grant County",1,65,874,412,462
050,18,053,"Indiana","Grant County",1,66,822,394,428
050,18,053,"Indiana","Grant County",1,67,830,394,436
050,18,053,"Indiana","Grant County",1,68,769,376,393
050,18,053,"Indiana","Grant County",1,69,704,323,381
050,18,053,"Indiana","Grant County",1,70,729,356,373
050,18,053,"Indiana","Grant County",1,71,685,325,360
050,18,053,"Indiana","Grant County",1,72,713,335,378
050,18,053,"Indiana","Grant County",1,73,718,331,387
050,18,053,"Indiana","Grant County",1,74,509,235,274
050,18,053,"Indiana","Grant County",1,75,481,219,262
050,18,053,"Indiana","Grant County",1,76,466,204,262
050,18,053,"Indiana","Grant County",1,77,485,202,283
050,18,053,"Indiana","Grant County",1,78,451,194,257
050,18,053,"Indiana","Grant County",1,79,405,167,238
050,18,053,"Indiana","Grant County",1,80,381,157,224
050,18,053,"Indiana","Grant County",1,81,345,135,210
050,18,053,"Indiana","Grant County",1,82,324,125,199
050,18,053,"Indiana","Grant County",1,83,277,112,165
050,18,053,"Indiana","Grant County",1,84,270,116,154
050,18,053,"Indiana","Grant County",1,85,1466,514,952
050,18,053,"Indiana","Grant County",2,0,760,400,360
050,18,053,"Indiana","Grant County",2,1,762,400,362
050,18,053,"Indiana","Grant County",2,2,794,393,401
050,18,053,"Indiana","Grant County",2,3,759,369,390
050,18,053,"Indiana","Grant County",2,4,755,373,382
050,18,053,"Indiana","Grant County",2,5,755,379,376
050,18,053,"Indiana","Grant County",2,6,744,383,361
050,18,053,"Indiana","Grant County",2,7,746,371,375
050,18,053,"Indiana","Grant County",2,8,727,369,358
050,18,053,"Indiana","Grant County",2,9,766,396,370
050,18,053,"Indiana","Grant County",2,10,798,427,371
050,18,053,"Indiana","Grant County",2,11,822,430,392
050,18,053,"Indiana","Grant County",2,12,852,434,418
050,18,053,"Indiana","Grant County",2,13,877,451,426
050,18,053,"Indiana","Grant County",2,14,854,446,408
050,18,053,"Indiana","Grant County",2,15,788,408,380
050,18,053,"Indiana","Grant County",2,16,815,412,403
050,18,053,"Indiana","Grant County",2,17,809,392,417
050,18,053,"Indiana","Grant County",2,18,1018,480,538
050,18,053,"Indiana","Grant County",2,19,1634,718,916
050,18,053,"Indiana","Grant County",2,20,1618,717,901
050,18,053,"Indiana","Grant County",2,21,1492,693,799
050,18,053,"Indiana","Grant County",2,22,1104,540,564
050,18,053,"Indiana","Grant County",2,23,759,395,364
050,18,053,"Indiana","Grant County",2,24,736,375,361
050,18,053,"Indiana","Grant County",2,25,740,371,369
050,18,053,"Indiana","Grant County",2,26,739,373,366
050,18,053,"Indiana","Grant County",2,27,753,375,378
050,18,053,"Indiana","Grant County",2,28,783,384,399
050,18,053,"Indiana","Grant County",2,29,759,359,400
050,18,053,"Indiana","Grant County",2,30,738,358,380
050,18,053,"Indiana","Grant County",2,31,722,356,366
050,18,053,"Indiana","Grant County",2,32,686,334,352
050,18,053,"Indiana","Grant County",2,33,672,315,357
050,18,053,"Indiana","Grant County",2,34,689,329,360
050,18,053,"Indiana","Grant County",2,35,669,313,356
050,18,053,"Indiana","Grant County",2,36,649,297,352
050,18,053,"Indiana","Grant County",2,37,681,315,366
050,18,053,"Indiana","Grant County",2,38,683,324,359
050,18,053,"Indiana","Grant County",2,39,698,329,369
050,18,053,"Indiana","Grant County",2,40,729,355,374
050,18,053,"Indiana","Grant County",2,41,721,360,361
050,18,053,"Indiana","Grant County",2,42,729,373,356
050,18,053,"Indiana","Grant County",2,43,707,351,356
050,18,053,"Indiana","Grant County",2,44,679,342,337
050,18,053,"Indiana","Grant County",2,45,710,362,348
050,18,053,"Indiana","Grant County",2,46,696,339,357
050,18,053,"Indiana","Grant County",2,47,718,345,373
050,18,053,"Indiana","Grant County",2,48,768,369,399
050,18,053,"Indiana","Grant County",2,49,840,414,426
050,18,053,"Indiana","Grant County",2,50,823,424,399
050,18,053,"Indiana","Grant County",2,51,800,410,390
050,18,053,"Indiana","Grant County",2,52,778,390,388
050,18,053,"Indiana","Grant County",2,53,787,398,389
050,18,053,"Indiana","Grant County",2,54,797,400,397
050,18,053,"Indiana","Grant County",2,55,854,421,433
050,18,053,"Indiana","Grant County",2,56,921,444,477
050,18,053,"Indiana","Grant County",2,57,940,461,479
050,18,053,"Indiana","Grant County",2,58,930,458,472
050,18,053,"Indiana","Grant County",2,59,957,460,497
050,18,053,"Indiana","Grant County",2,60,933,438,495
050,18,053,"Indiana","Grant County",2,61,945,445,500
050,18,053,"Indiana","Grant County",2,62,976,470,506
050,18,053,"Indiana","Grant County",2,63,941,457,484
050,18,053,"Indiana","Grant County",2,64,913,445,468
050,18,053,"Indiana","Grant County",2,65,881,417,464
050,18,053,"Indiana","Grant County",2,66,832,396,436
050,18,053,"Indiana","Grant County",2,67,819,388,431
050,18,053,"Indiana","Grant County",2,68,772,374,398
050,18,053,"Indiana","Grant County",2,69,720,334,386
050,18,053,"Indiana","Grant County",2,70,717,345,372
050,18,053,"Indiana","Grant County",2,71,690,327,363
050,18,053,"Indiana","Grant County",2,72,688,323,365
050,18,053,"Indiana","Grant County",2,73,742,343,399
050,18,053,"Indiana","Grant County",2,74,519,240,279
050,18,053,"Indiana","Grant County",2,75,485,222,263
050,18,053,"Indiana","Grant County",2,76,462,203,259
050,18,053,"Indiana","Grant County",2,77,488,207,281
050,18,053,"Indiana","Grant County",2,78,444,189,255
050,18,053,"Indiana","Grant County",2,79,407,171,236
050,18,053,"Indiana","Grant County",2,80,382,156,226
050,18,053,"Indiana","Grant County",2,81,344,136,208
050,18,053,"Indiana","Grant County",2,82,324,125,199
050,18,053,"Indiana","Grant County",2,83,280,112,168
050,18,053,"Indiana","Grant County",2,84,265,114,151
050,18,053,"Indiana","Grant County",2,85,1449,509,940
050,18,053,"Indiana","Grant County",3,0,700,357,343
050,18,053,"Indiana","Grant County",3,1,734,400,334
050,18,053,"Indiana","Grant County",3,2,773,404,369
050,18,053,"Indiana","Grant County",3,3,799,404,395
050,18,053,"Indiana","Grant County",3,4,737,358,379
050,18,053,"Indiana","Grant County",3,5,771,379,392
050,18,053,"Indiana","Grant County",3,6,757,380,377
050,18,053,"Indiana","Grant County",3,7,765,389,376
050,18,053,"Indiana","Grant County",3,8,738,365,373
050,18,053,"Indiana","Grant County",3,9,744,379,365
050,18,053,"Indiana","Grant County",3,10,770,400,370
050,18,053,"Indiana","Grant County",3,11,793,424,369
050,18,053,"Indiana","Grant County",3,12,846,454,392
050,18,053,"Indiana","Grant County",3,13,854,436,418
050,18,053,"Indiana","Grant County",3,14,883,456,427
050,18,053,"Indiana","Grant County",3,15,844,443,401
050,18,053,"Indiana","Grant County",3,16,797,416,381
050,18,053,"Indiana","Grant County",3,17,828,413,415
050,18,053,"Indiana","Grant County",3,18,994,451,543
050,18,053,"Indiana","Grant County",3,19,1618,699,919
050,18,053,"Indiana","Grant County",3,20,1615,720,895
050,18,053,"Indiana","Grant County",3,21,1489,698,791
050,18,053,"Indiana","Grant County",3,22,1099,549,550
050,18,053,"Indiana","Grant County",3,23,784,413,371
050,18,053,"Indiana","Grant County",3,24,734,376,358
050,18,053,"Indiana","Grant County",3,25,754,377,377
050,18,053,"Indiana","Grant County",3,26,734,365,369
050,18,053,"Indiana","Grant County",3,27,712,345,367
050,18,053,"Indiana","Grant County",3,28,771,386,385
050,18,053,"Indiana","Grant County",3,29,797,388,409
050,18,053,"Indiana","Grant County",3,30,771,361,410
050,18,053,"Indiana","Grant County",3,31,719,348,371
050,18,053,"Indiana","Grant County",3,32,728,363,365
050,18,053,"Indiana","Grant County",3,33,694,332,362
050,18,053,"Indiana","Grant County",3,34,670,311,359
050,18,053,"Indiana","Grant County",3,35,690,331,359
050,18,053,"Indiana","Grant County",3,36,661,313,348
050,18,053,"Indiana","Grant County",3,37,631,289,342
050,18,053,"Indiana","Grant County",3,38,690,325,365
050,18,053,"Indiana","Grant County",3,39,679,333,346
050,18,053,"Indiana","Grant County",3,40,711,344,367
050,18,053,"Indiana","Grant County",3,41,715,345,370
050,18,053,"Indiana","Grant County",3,42,742,361,381
050,18,053,"Indiana","Grant County",3,43,729,365,364
050,18,053,"Indiana","Grant County",3,44,702,348,354
050,18,053,"Indiana","Grant County",3,45,681,345,336
050,18,053,"Indiana","Grant County",3,46,709,356,353
050,18,053,"Indiana","Grant County",3,47,689,346,343
050,18,053,"Indiana","Grant County",3,48,708,340,368
050,18,053,"Indiana","Grant County",3,49,778,377,401
050,18,053,"Indiana","Grant County",3,50,836,407,429
050,18,053,"Indiana","Grant County",3,51,831,430,401
050,18,053,"Indiana","Grant County",3,52,793,403,390
050,18,053,"Indiana","Grant County",3,53,776,389,387
050,18,053,"Indiana","Grant County",3,54,803,404,399
050,18,053,"Indiana","Grant County",3,55,788,398,390
050,18,053,"Indiana","Grant County",3,56,847,417,430
050,18,053,"Indiana","Grant County",3,57,917,443,474
050,18,053,"Indiana","Grant County",3,58,918,444,474
050,18,053,"Indiana","Grant County",3,59,929,463,466
050,18,053,"Indiana","Grant County",3,60,938,433,505
050,18,053,"Indiana","Grant County",3,61,920,443,477
050,18,053,"Indiana","Grant County",3,62,929,435,494
050,18,053,"Indiana","Grant County",3,63,930,440,490
050,18,053,"Indiana","Grant County",3,64,912,439,473
050,18,053,"Indiana","Grant County",3,65,898,442,456
050,18,053,"Indiana","Grant County",3,66,864,409,455
050,18,053,"Indiana","Grant County",3,67,823,392,431
050,18,053,"Indiana","Grant County",3,68,796,372,424
050,18,053,"Indiana","Grant County",3,69,749,358,391
050,18,053,"Indiana","Grant County",3,70,694,318,376
050,18,053,"Indiana","Grant County",3,71,695,332,363
050,18,053,"Indiana","Grant County",3,72,667,312,355
050,18,053,"Indiana","Grant County",3,73,634,289,345
050,18,053,"Indiana","Grant County",3,74,726,331,395
050,18,053,"Indiana","Grant County",3,75,496,223,273
050,18,053,"Indiana","Grant County",3,76,464,216,248
050,18,053,"Indiana","Grant County",3,77,434,187,247
050,18,053,"Indiana","Grant County",3,78,453,193,260
050,18,053,"Indiana","Grant County",3,79,404,170,234
050,18,053,"Indiana","Grant County",3,80,374,156,218
050,18,053,"Indiana","Grant County",3,81,344,138,206
050,18,053,"Indiana","Grant County",3,82,322,125,197
050,18,053,"Indiana","Grant County",3,83,296,116,180
050,18,053,"Indiana","Grant County",3,84,255,100,155
050,18,053,"Indiana","Grant County",3,85,1402,513,889
050,18,053,"Indiana","Grant County",4,0,746,364,382
050,18,053,"Indiana","Grant County",4,1,704,357,347
050,18,053,"Indiana","Grant County",4,2,751,416,335
050,18,053,"Indiana","Grant County",4,3,797,411,386
050,18,053,"Indiana","Grant County",4,4,807,404,403
050,18,053,"Indiana","Grant County",4,5,757,377,380
050,18,053,"Indiana","Grant County",4,6,782,394,388
050,18,053,"Indiana","Grant County",4,7,759,375,384
050,18,053,"Indiana","Grant County",4,8,771,392,379
050,18,053,"Indiana","Grant County",4,9,762,384,378
050,18,053,"Indiana","Grant County",4,10,742,370,372
050,18,053,"Indiana","Grant County",4,11,780,400,380
050,18,053,"Indiana","Grant County",4,12,795,417,378
050,18,053,"Indiana","Grant County",4,13,832,437,395
050,18,053,"Indiana","Grant County",4,14,860,436,424
050,18,053,"Indiana","Grant County",4,15,881,443,438
050,18,053,"Indiana","Grant County",4,16,855,439,416
050,18,053,"Indiana","Grant County",4,17,804,419,385
050,18,053,"Indiana","Grant County",4,18,1020,473,547
050,18,053,"Indiana","Grant County",4,19,1587,674,913
050,18,053,"Indiana","Grant County",4,20,1597,701,896
050,18,053,"Indiana","Grant County",4,21,1520,714,806
050,18,053,"Indiana","Grant County",4,22,1133,567,566
050,18,053,"Indiana","Grant County",4,23,764,408,356
050,18,053,"Indiana","Grant County",4,24,728,382,346
050,18,053,"Indiana","Grant County",4,25,735,359,376
050,18,053,"Indiana","Grant County",4,26,745,378,367
050,18,053,"Indiana","Grant County",4,27,717,357,360
050,18,053,"Indiana","Grant County",4,28,728,353,375
050,18,053,"Indiana","Grant County",4,29,769,382,387
050,18,053,"Indiana","Grant County",4,30,802,397,405
050,18,053,"Indiana","Grant County",4,31,765,350,415
050,18,053,"Indiana","Grant County",4,32,726,356,370
050,18,053,"Indiana","Grant County",4,33,738,371,367
050,18,053,"Indiana","Grant County",4,34,700,343,357
050,18,053,"Indiana","Grant County",4,35,669,319,350
050,18,053,"Indiana","Grant County",4,36,699,343,356
050,18,053,"Indiana","Grant County",4,37,666,309,357
050,18,053,"Indiana","Grant County",4,38,622,283,339
050,18,053,"Indiana","Grant County",4,39,694,330,364
050,18,053,"Indiana","Grant County",4,40,677,335,342
050,18,053,"Indiana","Grant County",4,41,713,342,371
050,18,053,"Indiana","Grant County",4,42,725,351,374
050,18,053,"Indiana","Grant County",4,43,741,360,381
050,18,053,"Indiana","Grant County",4,44,746,379,367
050,18,053,"Indiana","Grant County",4,45,711,356,355
050,18,053,"Indiana","Grant County",4,46,671,327,344
050,18,053,"Indiana","Grant County",4,47,701,359,342
050,18,053,"Indiana","Grant County",4,48,688,347,341
050,18,053,"Indiana","Grant County",4,49,709,339,370
050,18,053,"Indiana","Grant County",4,50,766,380,386
050,18,053,"Indiana","Grant County",4,51,855,419,436
050,18,053,"Indiana","Grant County",4,52,816,416,400
050,18,053,"Indiana","Grant County",4,53,776,387,389
050,18,053,"Indiana","Grant County",4,54,785,399,386
050,18,053,"Indiana","Grant County",4,55,802,405,397
050,18,053,"Indiana","Grant County",4,56,793,408,385
050,18,053,"Indiana","Grant County",4,57,841,416,425
050,18,053,"Indiana","Grant County",4,58,901,436,465
050,18,053,"Indiana","Grant County",4,59,922,446,476
050,18,053,"Indiana","Grant County",4,60,894,438,456
050,18,053,"Indiana","Grant County",4,61,939,442,497
050,18,053,"Indiana","Grant County",4,62,914,444,470
050,18,053,"Indiana","Grant County",4,63,893,413,480
050,18,053,"Indiana","Grant County",4,64,893,413,480
050,18,053,"Indiana","Grant County",4,65,889,424,465
050,18,053,"Indiana","Grant County",4,66,877,433,444
050,18,053,"Indiana","Grant County",4,67,847,401,446
050,18,053,"Indiana","Grant County",4,68,800,382,418
050,18,053,"Indiana","Grant County",4,69,764,356,408
050,18,053,"Indiana","Grant County",4,70,725,343,382
050,18,053,"Indiana","Grant County",4,71,661,298,363
050,18,053,"Indiana","Grant County",4,72,666,321,345
050,18,053,"Indiana","Grant County",4,73,622,284,338
050,18,053,"Indiana","Grant County",4,74,603,270,333
050,18,053,"Indiana","Grant County",4,75,693,309,384
050,18,053,"Indiana","Grant County",4,76,477,212,265
050,18,053,"Indiana","Grant County",4,77,442,205,237
050,18,053,"Indiana","Grant County",4,78,406,177,229
050,18,053,"Indiana","Grant County",4,79,423,187,236
050,18,053,"Indiana","Grant County",4,80,362,154,208
050,18,053,"Indiana","Grant County",4,81,339,139,200
050,18,053,"Indiana","Grant County",4,82,320,119,201
050,18,053,"Indiana","Grant County",4,83,287,116,171
050,18,053,"Indiana","Grant County",4,84,262,97,165
050,18,053,"Indiana","Grant County",4,85,1347,500,847
050,18,053,"Indiana","Grant County",5,0,735,359,376
050,18,053,"Indiana","Grant County",5,1,713,344,369
050,18,053,"Indiana","Grant County",5,2,711,359,352
050,18,053,"Indiana","Grant County",5,3,765,423,342
050,18,053,"Indiana","Grant County",5,4,807,415,392
050,18,053,"Indiana","Grant County",5,5,844,431,413
050,18,053,"Indiana","Grant County",5,6,763,395,368
050,18,053,"Indiana","Grant County",5,7,780,394,386
050,18,053,"Indiana","Grant County",5,8,760,379,381
050,18,053,"Indiana","Grant County",5,9,769,389,380
050,18,053,"Indiana","Grant County",5,10,754,375,379
050,18,053,"Indiana","Grant County",5,11,770,389,381
050,18,053,"Indiana","Grant County",5,12,794,415,379
050,18,053,"Indiana","Grant County",5,13,799,428,371
050,18,053,"Indiana","Grant County",5,14,853,454,399
050,18,053,"Indiana","Grant County",5,15,863,436,427
050,18,053,"Indiana","Grant County",5,16,898,463,435
050,18,053,"Indiana","Grant County",5,17,880,452,428
050,18,053,"Indiana","Grant County",5,18,1009,474,535
050,18,053,"Indiana","Grant County",5,19,1620,694,926
050,18,053,"Indiana","Grant County",5,20,1602,682,920
050,18,053,"Indiana","Grant County",5,21,1503,690,813
050,18,053,"Indiana","Grant County",5,22,1129,564,565
050,18,053,"Indiana","Grant County",5,23,835,441,394
050,18,053,"Indiana","Grant County",5,24,754,389,365
050,18,053,"Indiana","Grant County",5,25,745,374,371
050,18,053,"Indiana","Grant County",5,26,726,366,360
050,18,053,"Indiana","Grant County",5,27,752,376,376
050,18,053,"Indiana","Grant County",5,28,695,345,350
050,18,053,"Indiana","Grant County",5,29,733,351,382
050,18,053,"Indiana","Grant County",5,30,785,400,385
050,18,053,"Indiana","Grant County",5,31,797,384,413
050,18,053,"Indiana","Grant County",5,32,767,359,408
050,18,053,"Indiana","Grant County",5,33,715,350,365
050,18,053,"Indiana","Grant County",5,34,741,373,368
050,18,053,"Indiana","Grant County",5,35,705,347,358
050,18,053,"Indiana","Grant County",5,36,680,332,348
050,18,053,"Indiana","Grant County",5,37,707,343,364
050,18,053,"Indiana","Grant County",5,38,682,310,372
050,18,053,"Indiana","Grant County",5,39,624,284,340
050,18,053,"Indiana","Grant County",5,40,704,346,358
050,18,053,"Indiana","Grant County",5,41,680,329,351
050,18,053,"Indiana","Grant County",5,42,717,343,374
050,18,053,"Indiana","Grant County",5,43,725,350,375
050,18,053,"Indiana","Grant County",5,44,767,370,397
050,18,053,"Indiana","Grant County",5,45,749,383,366
050,18,053,"Indiana","Grant County",5,46,697,343,354
050,18,053,"Indiana","Grant County",5,47,679,341,338
050,18,053,"Indiana","Grant County",5,48,703,359,344
050,18,053,"Indiana","Grant County",5,49,693,351,342
050,18,053,"Indiana","Grant County",5,50,723,351,372
050,18,053,"Indiana","Grant County",5,51,780,388,392
050,18,053,"Indiana","Grant County",5,52,847,420,427
050,18,053,"Indiana","Grant County",5,53,811,405,406
050,18,053,"Indiana","Grant County",5,54,777,383,394
050,18,053,"Indiana","Grant County",5,55,775,397,378
050,18,053,"Indiana","Grant County",5,56,812,412,400
050,18,053,"Indiana","Grant County",5,57,795,404,391
050,18,053,"Indiana","Grant County",5,58,838,426,412
050,18,053,"Indiana","Grant County",5,59,914,439,475
050,18,053,"Indiana","Grant County",5,60,895,423,472
050,18,053,"Indiana","Grant County",5,61,909,452,457
050,18,053,"Indiana","Grant County",5,62,940,446,494
050,18,053,"Indiana","Grant County",5,63,885,423,462
050,18,053,"Indiana","Grant County",5,64,878,398,480
050,18,053,"Indiana","Grant County",5,65,894,416,478
050,18,053,"Indiana","Grant County",5,66,866,419,447
050,18,053,"Indiana","Grant County",5,67,863,425,438
050,18,053,"Indiana","Grant County",5,68,832,401,431
050,18,053,"Indiana","Grant County",5,69,780,369,411
050,18,053,"Indiana","Grant County",5,70,741,345,396
050,18,053,"Indiana","Grant County",5,71,705,329,376
050,18,053,"Indiana","Grant County",5,72,644,289,355
050,18,053,"Indiana","Grant County",5,73,628,298,330
050,18,053,"Indiana","Grant County",5,74,608,274,334
050,18,053,"Indiana","Grant County",5,75,570,249,321
050,18,053,"Indiana","Grant County",5,76,674,302,372
050,18,053,"Indiana","Grant County",5,77,448,197,251
050,18,053,"Indiana","Grant County",5,78,421,198,223
050,18,053,"Indiana","Grant County",5,79,391,170,221
050,18,053,"Indiana","Grant County",5,80,377,172,205
050,18,053,"Indiana","Grant County",5,81,324,132,192
050,18,053,"Indiana","Grant County",5,82,314,124,190
050,18,053,"Indiana","Grant County",5,83,284,110,174
050,18,053,"Indiana","Grant County",5,84,253,99,154
050,18,053,"Indiana","Grant County",5,85,1326,507,819
050,18,055,"Indiana","Greene County",1,0,341,176,165
050,18,055,"Indiana","Greene County",1,1,380,194,186
050,18,055,"Indiana","Greene County",1,2,324,172,152
050,18,055,"Indiana","Greene County",1,3,321,171,150
050,18,055,"Indiana","Greene County",1,4,330,171,159
050,18,055,"Indiana","Greene County",1,5,351,167,184
050,18,055,"Indiana","Greene County",1,6,340,178,162
050,18,055,"Indiana","Greene County",1,7,355,168,187
050,18,055,"Indiana","Greene County",1,8,334,145,189
050,18,055,"Indiana","Greene County",1,9,360,178,182
050,18,055,"Indiana","Greene County",1,10,384,196,188
050,18,055,"Indiana","Greene County",1,11,395,193,202
050,18,055,"Indiana","Greene County",1,12,414,209,205
050,18,055,"Indiana","Greene County",1,13,416,205,211
050,18,055,"Indiana","Greene County",1,14,410,218,192
050,18,055,"Indiana","Greene County",1,15,399,211,188
050,18,055,"Indiana","Greene County",1,16,443,234,209
050,18,055,"Indiana","Greene County",1,17,449,243,206
050,18,055,"Indiana","Greene County",1,18,357,204,153
050,18,055,"Indiana","Greene County",1,19,288,162,126
050,18,055,"Indiana","Greene County",1,20,296,166,130
050,18,055,"Indiana","Greene County",1,21,288,155,133
050,18,055,"Indiana","Greene County",1,22,302,151,151
050,18,055,"Indiana","Greene County",1,23,316,173,143
050,18,055,"Indiana","Greene County",1,24,332,181,151
050,18,055,"Indiana","Greene County",1,25,356,186,170
050,18,055,"Indiana","Greene County",1,26,349,181,168
050,18,055,"Indiana","Greene County",1,27,354,179,175
050,18,055,"Indiana","Greene County",1,28,371,186,185
050,18,055,"Indiana","Greene County",1,29,371,189,182
050,18,055,"Indiana","Greene County",1,30,370,185,185
050,18,055,"Indiana","Greene County",1,31,350,175,175
050,18,055,"Indiana","Greene County",1,32,340,173,167
050,18,055,"Indiana","Greene County",1,33,353,175,178
050,18,055,"Indiana","Greene County",1,34,308,158,150
050,18,055,"Indiana","Greene County",1,35,324,159,165
050,18,055,"Indiana","Greene County",1,36,335,155,180
050,18,055,"Indiana","Greene County",1,37,345,175,170
050,18,055,"Indiana","Greene County",1,38,355,176,179
050,18,055,"Indiana","Greene County",1,39,347,184,163
050,18,055,"Indiana","Greene County",1,40,380,194,186
050,18,055,"Indiana","Greene County",1,41,360,181,179
050,18,055,"Indiana","Greene County",1,42,366,203,163
050,18,055,"Indiana","Greene County",1,43,347,179,168
050,18,055,"Indiana","Greene County",1,44,353,176,177
050,18,055,"Indiana","Greene County",1,45,360,179,181
050,18,055,"Indiana","Greene County",1,46,402,204,198
050,18,055,"Indiana","Greene County",1,47,421,209,212
050,18,055,"Indiana","Greene County",1,48,396,196,200
050,18,055,"Indiana","Greene County",1,49,438,215,223
050,18,055,"Indiana","Greene County",1,50,404,208,196
050,18,055,"Indiana","Greene County",1,51,416,222,194
050,18,055,"Indiana","Greene County",1,52,400,208,192
050,18,055,"Indiana","Greene County",1,53,430,218,212
050,18,055,"Indiana","Greene County",1,54,430,220,210
050,18,055,"Indiana","Greene County",1,55,488,255,233
050,18,055,"Indiana","Greene County",1,56,516,261,255
050,18,055,"Indiana","Greene County",1,57,487,253,234
050,18,055,"Indiana","Greene County",1,58,465,245,220
050,18,055,"Indiana","Greene County",1,59,468,245,223
050,18,055,"Indiana","Greene County",1,60,465,232,233
050,18,055,"Indiana","Greene County",1,61,467,233,234
050,18,055,"Indiana","Greene County",1,62,446,228,218
050,18,055,"Indiana","Greene County",1,63,439,226,213
050,18,055,"Indiana","Greene County",1,64,441,228,213
050,18,055,"Indiana","Greene County",1,65,432,217,215
050,18,055,"Indiana","Greene County",1,66,416,202,214
050,18,055,"Indiana","Greene County",1,67,395,194,201
050,18,055,"Indiana","Greene County",1,68,383,189,194
050,18,055,"Indiana","Greene County",1,69,353,170,183
050,18,055,"Indiana","Greene County",1,70,360,194,166
050,18,055,"Indiana","Greene County",1,71,315,154,161
050,18,055,"Indiana","Greene County",1,72,315,150,165
050,18,055,"Indiana","Greene County",1,73,347,166,181
050,18,055,"Indiana","Greene County",1,74,230,104,126
050,18,055,"Indiana","Greene County",1,75,246,121,125
050,18,055,"Indiana","Greene County",1,76,265,124,141
050,18,055,"Indiana","Greene County",1,77,249,126,123
050,18,055,"Indiana","Greene County",1,78,209,95,114
050,18,055,"Indiana","Greene County",1,79,199,88,111
050,18,055,"Indiana","Greene County",1,80,176,79,97
050,18,055,"Indiana","Greene County",1,81,155,71,84
050,18,055,"Indiana","Greene County",1,82,126,66,60
050,18,055,"Indiana","Greene County",1,83,137,59,78
050,18,055,"Indiana","Greene County",1,84,127,53,74
050,18,055,"Indiana","Greene County",1,85,623,220,403
050,18,055,"Indiana","Greene County",2,0,338,164,174
050,18,055,"Indiana","Greene County",2,1,366,186,180
050,18,055,"Indiana","Greene County",2,2,335,176,159
050,18,055,"Indiana","Greene County",2,3,321,170,151
050,18,055,"Indiana","Greene County",2,4,331,170,161
050,18,055,"Indiana","Greene County",2,5,346,169,177
050,18,055,"Indiana","Greene County",2,6,347,178,169
050,18,055,"Indiana","Greene County",2,7,352,169,183
050,18,055,"Indiana","Greene County",2,8,341,151,190
050,18,055,"Indiana","Greene County",2,9,353,169,184
050,18,055,"Indiana","Greene County",2,10,381,192,189
050,18,055,"Indiana","Greene County",2,11,393,195,198
050,18,055,"Indiana","Greene County",2,12,411,206,205
050,18,055,"Indiana","Greene County",2,13,416,206,210
050,18,055,"Indiana","Greene County",2,14,412,215,197
050,18,055,"Indiana","Greene County",2,15,404,213,191
050,18,055,"Indiana","Greene County",2,16,436,230,206
050,18,055,"Indiana","Greene County",2,17,449,242,207
050,18,055,"Indiana","Greene County",2,18,359,204,155
050,18,055,"Indiana","Greene County",2,19,287,162,125
050,18,055,"Indiana","Greene County",2,20,303,170,133
050,18,055,"Indiana","Greene County",2,21,291,156,135
050,18,055,"Indiana","Greene County",2,22,304,155,149
050,18,055,"Indiana","Greene County",2,23,315,169,146
050,18,055,"Indiana","Greene County",2,24,329,179,150
050,18,055,"Indiana","Greene County",2,25,350,186,164
050,18,055,"Indiana","Greene County",2,26,352,182,170
050,18,055,"Indiana","Greene County",2,27,358,182,176
050,18,055,"Indiana","Greene County",2,28,368,185,183
050,18,055,"Indiana","Greene County",2,29,372,189,183
050,18,055,"Indiana","Greene County",2,30,374,189,185
050,18,055,"Indiana","Greene County",2,31,359,181,178
050,18,055,"Indiana","Greene County",2,32,345,173,172
050,18,055,"Indiana","Greene County",2,33,350,172,178
050,18,055,"Indiana","Greene County",2,34,319,163,156
050,18,055,"Indiana","Greene County",2,35,323,161,162
050,18,055,"Indiana","Greene County",2,36,330,153,177
050,18,055,"Indiana","Greene County",2,37,344,171,173
050,18,055,"Indiana","Greene County",2,38,354,176,178
050,18,055,"Indiana","Greene County",2,39,350,184,166
050,18,055,"Indiana","Greene County",2,40,376,194,182
050,18,055,"Indiana","Greene County",2,41,366,185,181
050,18,055,"Indiana","Greene County",2,42,364,197,167
050,18,055,"Indiana","Greene County",2,43,356,187,169
050,18,055,"Indiana","Greene County",2,44,351,177,174
050,18,055,"Indiana","Greene County",2,45,364,182,182
050,18,055,"Indiana","Greene County",2,46,393,199,194
050,18,055,"Indiana","Greene County",2,47,413,207,206
050,18,055,"Indiana","Greene County",2,48,405,201,204
050,18,055,"Indiana","Greene County",2,49,427,210,217
050,18,055,"Indiana","Greene County",2,50,416,213,203
050,18,055,"Indiana","Greene County",2,51,411,217,194
050,18,055,"Indiana","Greene County",2,52,403,210,193
050,18,055,"Indiana","Greene County",2,53,422,216,206
050,18,055,"Indiana","Greene County",2,54,428,219,209
050,18,055,"Indiana","Greene County",2,55,470,243,227
050,18,055,"Indiana","Greene County",2,56,510,261,249
050,18,055,"Indiana","Greene County",2,57,495,256,239
050,18,055,"Indiana","Greene County",2,58,469,246,223
050,18,055,"Indiana","Greene County",2,59,472,248,224
050,18,055,"Indiana","Greene County",2,60,462,233,229
050,18,055,"Indiana","Greene County",2,61,465,233,232
050,18,055,"Indiana","Greene County",2,62,450,229,221
050,18,055,"Indiana","Greene County",2,63,443,227,216
050,18,055,"Indiana","Greene County",2,64,436,223,213
050,18,055,"Indiana","Greene County",2,65,430,215,215
050,18,055,"Indiana","Greene County",2,66,421,206,215
050,18,055,"Indiana","Greene County",2,67,393,193,200
050,18,055,"Indiana","Greene County",2,68,382,189,193
050,18,055,"Indiana","Greene County",2,69,363,175,188
050,18,055,"Indiana","Greene County",2,70,359,189,170
050,18,055,"Indiana","Greene County",2,71,326,162,164
050,18,055,"Indiana","Greene County",2,72,309,149,160
050,18,055,"Indiana","Greene County",2,73,352,166,186
050,18,055,"Indiana","Greene County",2,74,241,112,129
050,18,055,"Indiana","Greene County",2,75,239,117,122
050,18,055,"Indiana","Greene County",2,76,247,117,130
050,18,055,"Indiana","Greene County",2,77,256,126,130
050,18,055,"Indiana","Greene County",2,78,207,93,114
050,18,055,"Indiana","Greene County",2,79,197,87,110
050,18,055,"Indiana","Greene County",2,80,181,80,101
050,18,055,"Indiana","Greene County",2,81,150,70,80
050,18,055,"Indiana","Greene County",2,82,132,67,65
050,18,055,"Indiana","Greene County",2,83,131,59,72
050,18,055,"Indiana","Greene County",2,84,125,53,72
050,18,055,"Indiana","Greene County",2,85,617,222,395
050,18,055,"Indiana","Greene County",3,0,323,173,150
050,18,055,"Indiana","Greene County",3,1,344,166,178
050,18,055,"Indiana","Greene County",3,2,391,212,179
050,18,055,"Indiana","Greene County",3,3,358,183,175
050,18,055,"Indiana","Greene County",3,4,331,172,159
050,18,055,"Indiana","Greene County",3,5,333,161,172
050,18,055,"Indiana","Greene County",3,6,369,187,182
050,18,055,"Indiana","Greene County",3,7,357,184,173
050,18,055,"Indiana","Greene County",3,8,361,172,189
050,18,055,"Indiana","Greene County",3,9,337,149,188
050,18,055,"Indiana","Greene County",3,10,351,167,184
050,18,055,"Indiana","Greene County",3,11,388,194,194
050,18,055,"Indiana","Greene County",3,12,394,195,199
050,18,055,"Indiana","Greene County",3,13,409,201,208
050,18,055,"Indiana","Greene County",3,14,417,210,207
050,18,055,"Indiana","Greene County",3,15,399,207,192
050,18,055,"Indiana","Greene County",3,16,404,209,195
050,18,055,"Indiana","Greene County",3,17,424,225,199
050,18,055,"Indiana","Greene County",3,18,383,211,172
050,18,055,"Indiana","Greene County",3,19,273,156,117
050,18,055,"Indiana","Greene County",3,20,302,168,134
050,18,055,"Indiana","Greene County",3,21,306,166,140
050,18,055,"Indiana","Greene County",3,22,303,160,143
050,18,055,"Indiana","Greene County",3,23,323,169,154
050,18,055,"Indiana","Greene County",3,24,324,171,153
050,18,055,"Indiana","Greene County",3,25,325,167,158
050,18,055,"Indiana","Greene County",3,26,361,192,169
050,18,055,"Indiana","Greene County",3,27,366,188,178
050,18,055,"Indiana","Greene County",3,28,364,185,179
050,18,055,"Indiana","Greene County",3,29,395,201,194
050,18,055,"Indiana","Greene County",3,30,390,196,194
050,18,055,"Indiana","Greene County",3,31,392,198,194
050,18,055,"Indiana","Greene County",3,32,364,187,177
050,18,055,"Indiana","Greene County",3,33,351,180,171
050,18,055,"Indiana","Greene County",3,34,346,173,173
050,18,055,"Indiana","Greene County",3,35,324,170,154
050,18,055,"Indiana","Greene County",3,36,332,164,168
050,18,055,"Indiana","Greene County",3,37,332,157,175
050,18,055,"Indiana","Greene County",3,38,354,180,174
050,18,055,"Indiana","Greene County",3,39,359,178,181
050,18,055,"Indiana","Greene County",3,40,353,185,168
050,18,055,"Indiana","Greene County",3,41,372,193,179
050,18,055,"Indiana","Greene County",3,42,365,184,181
050,18,055,"Indiana","Greene County",3,43,355,189,166
050,18,055,"Indiana","Greene County",3,44,361,189,172
050,18,055,"Indiana","Greene County",3,45,339,174,165
050,18,055,"Indiana","Greene County",3,46,349,173,176
050,18,055,"Indiana","Greene County",3,47,378,194,184
050,18,055,"Indiana","Greene County",3,48,404,204,200
050,18,055,"Indiana","Greene County",3,49,413,200,213
050,18,055,"Indiana","Greene County",3,50,431,213,218
050,18,055,"Indiana","Greene County",3,51,418,216,202
050,18,055,"Indiana","Greene County",3,52,409,214,195
050,18,055,"Indiana","Greene County",3,53,405,216,189
050,18,055,"Indiana","Greene County",3,54,419,212,207
050,18,055,"Indiana","Greene County",3,55,431,221,210
050,18,055,"Indiana","Greene County",3,56,471,243,228
050,18,055,"Indiana","Greene County",3,57,529,268,261
050,18,055,"Indiana","Greene County",3,58,495,260,235
050,18,055,"Indiana","Greene County",3,59,477,255,222
050,18,055,"Indiana","Greene County",3,60,462,237,225
050,18,055,"Indiana","Greene County",3,61,459,231,228
050,18,055,"Indiana","Greene County",3,62,448,227,221
050,18,055,"Indiana","Greene County",3,63,452,234,218
050,18,055,"Indiana","Greene County",3,64,436,216,220
050,18,055,"Indiana","Greene County",3,65,425,221,204
050,18,055,"Indiana","Greene County",3,66,429,214,215
050,18,055,"Indiana","Greene County",3,67,409,199,210
050,18,055,"Indiana","Greene County",3,68,387,190,197
050,18,055,"Indiana","Greene County",3,69,373,184,189
050,18,055,"Indiana","Greene County",3,70,363,180,183
050,18,055,"Indiana","Greene County",3,71,346,178,168
050,18,055,"Indiana","Greene County",3,72,317,157,160
050,18,055,"Indiana","Greene County",3,73,303,143,160
050,18,055,"Indiana","Greene County",3,74,342,161,181
050,18,055,"Indiana","Greene County",3,75,240,111,129
050,18,055,"Indiana","Greene County",3,76,223,113,110
050,18,055,"Indiana","Greene County",3,77,236,108,128
050,18,055,"Indiana","Greene County",3,78,250,119,131
050,18,055,"Indiana","Greene County",3,79,195,85,110
050,18,055,"Indiana","Greene County",3,80,186,82,104
050,18,055,"Indiana","Greene County",3,81,161,71,90
050,18,055,"Indiana","Greene County",3,82,143,68,75
050,18,055,"Indiana","Greene County",3,83,112,52,60
050,18,055,"Indiana","Greene County",3,84,125,54,71
050,18,055,"Indiana","Greene County",3,85,607,221,386
050,18,055,"Indiana","Greene County",4,0,331,159,172
050,18,055,"Indiana","Greene County",4,1,329,184,145
050,18,055,"Indiana","Greene County",4,2,349,173,176
050,18,055,"Indiana","Greene County",4,3,387,204,183
050,18,055,"Indiana","Greene County",4,4,352,182,170
050,18,055,"Indiana","Greene County",4,5,361,188,173
050,18,055,"Indiana","Greene County",4,6,342,173,169
050,18,055,"Indiana","Greene County",4,7,387,201,186
050,18,055,"Indiana","Greene County",4,8,364,197,167
050,18,055,"Indiana","Greene County",4,9,383,185,198
050,18,055,"Indiana","Greene County",4,10,349,168,181
050,18,055,"Indiana","Greene County",4,11,356,167,189
050,18,055,"Indiana","Greene County",4,12,404,202,202
050,18,055,"Indiana","Greene County",4,13,384,192,192
050,18,055,"Indiana","Greene County",4,14,416,205,211
050,18,055,"Indiana","Greene County",4,15,425,210,215
050,18,055,"Indiana","Greene County",4,16,398,210,188
050,18,055,"Indiana","Greene County",4,17,416,221,195
050,18,055,"Indiana","Greene County",4,18,346,191,155
050,18,055,"Indiana","Greene County",4,19,294,158,136
050,18,055,"Indiana","Greene County",4,20,288,159,129
050,18,055,"Indiana","Greene County",4,21,323,177,146
050,18,055,"Indiana","Greene County",4,22,346,187,159
050,18,055,"Indiana","Greene County",4,23,302,165,137
050,18,055,"Indiana","Greene County",4,24,331,185,146
050,18,055,"Indiana","Greene County",4,25,332,175,157
050,18,055,"Indiana","Greene County",4,26,337,167,170
050,18,055,"Indiana","Greene County",4,27,369,185,184
050,18,055,"Indiana","Greene County",4,28,370,188,182
050,18,055,"Indiana","Greene County",4,29,395,206,189
050,18,055,"Indiana","Greene County",4,30,381,182,199
050,18,055,"Indiana","Greene County",4,31,412,204,208
050,18,055,"Indiana","Greene County",4,32,396,197,199
050,18,055,"Indiana","Greene County",4,33,379,196,183
050,18,055,"Indiana","Greene County",4,34,370,184,186
050,18,055,"Indiana","Greene County",4,35,343,172,171
050,18,055,"Indiana","Greene County",4,36,334,174,160
050,18,055,"Indiana","Greene County",4,37,332,161,171
050,18,055,"Indiana","Greene County",4,38,332,156,176
050,18,055,"Indiana","Greene County",4,39,361,181,180
050,18,055,"Indiana","Greene County",4,40,370,186,184
050,18,055,"Indiana","Greene County",4,41,347,182,165
050,18,055,"Indiana","Greene County",4,42,368,188,180
050,18,055,"Indiana","Greene County",4,43,369,191,178
050,18,055,"Indiana","Greene County",4,44,346,181,165
050,18,055,"Indiana","Greene County",4,45,382,200,182
050,18,055,"Indiana","Greene County",4,46,352,177,175
050,18,055,"Indiana","Greene County",4,47,355,175,180
050,18,055,"Indiana","Greene County",4,48,387,199,188
050,18,055,"Indiana","Greene County",4,49,409,199,210
050,18,055,"Indiana","Greene County",4,50,419,203,216
050,18,055,"Indiana","Greene County",4,51,435,221,214
050,18,055,"Indiana","Greene County",4,52,421,211,210
050,18,055,"Indiana","Greene County",4,53,424,226,198
050,18,055,"Indiana","Greene County",4,54,414,217,197
050,18,055,"Indiana","Greene County",4,55,414,210,204
050,18,055,"Indiana","Greene County",4,56,425,219,206
050,18,055,"Indiana","Greene County",4,57,471,246,225
050,18,055,"Indiana","Greene County",4,58,514,263,251
050,18,055,"Indiana","Greene County",4,59,490,255,235
050,18,055,"Indiana","Greene County",4,60,475,249,226
050,18,055,"Indiana","Greene County",4,61,457,237,220
050,18,055,"Indiana","Greene County",4,62,447,230,217
050,18,055,"Indiana","Greene County",4,63,454,230,224
050,18,055,"Indiana","Greene County",4,64,448,229,219
050,18,055,"Indiana","Greene County",4,65,434,213,221
050,18,055,"Indiana","Greene County",4,66,417,218,199
050,18,055,"Indiana","Greene County",4,67,420,208,212
050,18,055,"Indiana","Greene County",4,68,409,198,211
050,18,055,"Indiana","Greene County",4,69,371,182,189
050,18,055,"Indiana","Greene County",4,70,371,184,187
050,18,055,"Indiana","Greene County",4,71,352,174,178
050,18,055,"Indiana","Greene County",4,72,340,177,163
050,18,055,"Indiana","Greene County",4,73,312,157,155
050,18,055,"Indiana","Greene County",4,74,286,136,150
050,18,055,"Indiana","Greene County",4,75,331,151,180
050,18,055,"Indiana","Greene County",4,76,231,106,125
050,18,055,"Indiana","Greene County",4,77,208,106,102
050,18,055,"Indiana","Greene County",4,78,217,98,119
050,18,055,"Indiana","Greene County",4,79,231,105,126
050,18,055,"Indiana","Greene County",4,80,191,81,110
050,18,055,"Indiana","Greene County",4,81,174,72,102
050,18,055,"Indiana","Greene County",4,82,161,70,91
050,18,055,"Indiana","Greene County",4,83,131,62,69
050,18,055,"Indiana","Greene County",4,84,104,49,55
050,18,055,"Indiana","Greene County",4,85,581,216,365
050,18,055,"Indiana","Greene County",5,0,339,165,174
050,18,055,"Indiana","Greene County",5,1,350,171,179
050,18,055,"Indiana","Greene County",5,2,333,185,148
050,18,055,"Indiana","Greene County",5,3,338,169,169
050,18,055,"Indiana","Greene County",5,4,391,212,179
050,18,055,"Indiana","Greene County",5,5,358,186,172
050,18,055,"Indiana","Greene County",5,6,363,185,178
050,18,055,"Indiana","Greene County",5,7,362,182,180
050,18,055,"Indiana","Greene County",5,8,368,189,179
050,18,055,"Indiana","Greene County",5,9,373,204,169
050,18,055,"Indiana","Greene County",5,10,382,190,192
050,18,055,"Indiana","Greene County",5,11,365,169,196
050,18,055,"Indiana","Greene County",5,12,368,172,196
050,18,055,"Indiana","Greene County",5,13,400,196,204
050,18,055,"Indiana","Greene County",5,14,375,190,185
050,18,055,"Indiana","Greene County",5,15,421,211,210
050,18,055,"Indiana","Greene County",5,16,422,211,211
050,18,055,"Indiana","Greene County",5,17,396,212,184
050,18,055,"Indiana","Greene County",5,18,342,183,159
050,18,055,"Indiana","Greene County",5,19,263,147,116
050,18,055,"Indiana","Greene County",5,20,304,164,140
050,18,055,"Indiana","Greene County",5,21,297,161,136
050,18,055,"Indiana","Greene County",5,22,363,190,173
050,18,055,"Indiana","Greene County",5,23,363,199,164
050,18,055,"Indiana","Greene County",5,24,314,165,149
050,18,055,"Indiana","Greene County",5,25,333,188,145
050,18,055,"Indiana","Greene County",5,26,337,167,170
050,18,055,"Indiana","Greene County",5,27,353,179,174
050,18,055,"Indiana","Greene County",5,28,385,193,192
050,18,055,"Indiana","Greene County",5,29,394,206,188
050,18,055,"Indiana","Greene County",5,30,405,205,200
050,18,055,"Indiana","Greene County",5,31,392,186,206
050,18,055,"Indiana","Greene County",5,32,417,201,216
050,18,055,"Indiana","Greene County",5,33,392,194,198
050,18,055,"Indiana","Greene County",5,34,392,206,186
050,18,055,"Indiana","Greene County",5,35,367,189,178
050,18,055,"Indiana","Greene County",5,36,357,179,178
050,18,055,"Indiana","Greene County",5,37,327,169,158
050,18,055,"Indiana","Greene County",5,38,338,160,178
050,18,055,"Indiana","Greene County",5,39,336,163,173
050,18,055,"Indiana","Greene County",5,40,364,184,180
050,18,055,"Indiana","Greene County",5,41,362,183,179
050,18,055,"Indiana","Greene County",5,42,349,182,167
050,18,055,"Indiana","Greene County",5,43,361,181,180
050,18,055,"Indiana","Greene County",5,44,379,192,187
050,18,055,"Indiana","Greene County",5,45,362,191,171
050,18,055,"Indiana","Greene County",5,46,382,198,184
050,18,055,"Indiana","Greene County",5,47,350,177,173
050,18,055,"Indiana","Greene County",5,48,360,175,185
050,18,055,"Indiana","Greene County",5,49,374,189,185
050,18,055,"Indiana","Greene County",5,50,413,202,211
050,18,055,"Indiana","Greene County",5,51,423,205,218
050,18,055,"Indiana","Greene County",5,52,428,216,212
050,18,055,"Indiana","Greene County",5,53,429,212,217
050,18,055,"Indiana","Greene County",5,54,430,230,200
050,18,055,"Indiana","Greene County",5,55,408,214,194
050,18,055,"Indiana","Greene County",5,56,418,212,206
050,18,055,"Indiana","Greene County",5,57,413,213,200
050,18,055,"Indiana","Greene County",5,58,459,239,220
050,18,055,"Indiana","Greene County",5,59,517,269,248
050,18,055,"Indiana","Greene County",5,60,493,253,240
050,18,055,"Indiana","Greene County",5,61,473,253,220
050,18,055,"Indiana","Greene County",5,62,460,238,222
050,18,055,"Indiana","Greene County",5,63,442,225,217
050,18,055,"Indiana","Greene County",5,64,446,222,224
050,18,055,"Indiana","Greene County",5,65,452,236,216
050,18,055,"Indiana","Greene County",5,66,426,210,216
050,18,055,"Indiana","Greene County",5,67,402,205,197
050,18,055,"Indiana","Greene County",5,68,419,210,209
050,18,055,"Indiana","Greene County",5,69,395,191,204
050,18,055,"Indiana","Greene County",5,70,371,182,189
050,18,055,"Indiana","Greene County",5,71,365,182,183
050,18,055,"Indiana","Greene County",5,72,337,171,166
050,18,055,"Indiana","Greene County",5,73,331,173,158
050,18,055,"Indiana","Greene County",5,74,300,152,148
050,18,055,"Indiana","Greene County",5,75,285,132,153
050,18,055,"Indiana","Greene County",5,76,319,147,172
050,18,055,"Indiana","Greene County",5,77,220,98,122
050,18,055,"Indiana","Greene County",5,78,192,93,99
050,18,055,"Indiana","Greene County",5,79,210,95,115
050,18,055,"Indiana","Greene County",5,80,221,96,125
050,18,055,"Indiana","Greene County",5,81,180,75,105
050,18,055,"Indiana","Greene County",5,82,171,70,101
050,18,055,"Indiana","Greene County",5,83,148,61,87
050,18,055,"Indiana","Greene County",5,84,121,55,66
050,18,055,"Indiana","Greene County",5,85,561,215,346
050,18,057,"Indiana","Hamilton County",1,0,3754,1916,1838
050,18,057,"Indiana","Hamilton County",1,1,3986,2020,1966
050,18,057,"Indiana","Hamilton County",1,2,4292,2187,2105
050,18,057,"Indiana","Hamilton County",1,3,4537,2295,2242
050,18,057,"Indiana","Hamilton County",1,4,4784,2401,2383
050,18,057,"Indiana","Hamilton County",1,5,4913,2473,2440
050,18,057,"Indiana","Hamilton County",1,6,5127,2626,2501
050,18,057,"Indiana","Hamilton County",1,7,4952,2556,2396
050,18,057,"Indiana","Hamilton County",1,8,5234,2692,2542
050,18,057,"Indiana","Hamilton County",1,9,5296,2763,2533
050,18,057,"Indiana","Hamilton County",1,10,5499,2812,2687
050,18,057,"Indiana","Hamilton County",1,11,5657,2893,2764
050,18,057,"Indiana","Hamilton County",1,12,5763,2962,2801
050,18,057,"Indiana","Hamilton County",1,13,5790,2939,2851
050,18,057,"Indiana","Hamilton County",1,14,5680,2896,2784
050,18,057,"Indiana","Hamilton County",1,15,5638,2865,2773
050,18,057,"Indiana","Hamilton County",1,16,5760,2911,2849
050,18,057,"Indiana","Hamilton County",1,17,5565,2833,2732
050,18,057,"Indiana","Hamilton County",1,18,4559,2396,2163
050,18,057,"Indiana","Hamilton County",1,19,3528,1831,1697
050,18,057,"Indiana","Hamilton County",1,20,3711,1884,1827
050,18,057,"Indiana","Hamilton County",1,21,3747,1910,1837
050,18,057,"Indiana","Hamilton County",1,22,3771,1845,1926
050,18,057,"Indiana","Hamilton County",1,23,3740,1823,1917
050,18,057,"Indiana","Hamilton County",1,24,3715,1885,1830
050,18,057,"Indiana","Hamilton County",1,25,3743,1857,1886
050,18,057,"Indiana","Hamilton County",1,26,3716,1851,1865
050,18,057,"Indiana","Hamilton County",1,27,3693,1831,1862
050,18,057,"Indiana","Hamilton County",1,28,3834,1846,1988
050,18,057,"Indiana","Hamilton County",1,29,3862,1875,1987
050,18,057,"Indiana","Hamilton County",1,30,3864,1874,1990
050,18,057,"Indiana","Hamilton County",1,31,4055,1920,2135
050,18,057,"Indiana","Hamilton County",1,32,4251,2041,2210
050,18,057,"Indiana","Hamilton County",1,33,4676,2258,2418
050,18,057,"Indiana","Hamilton County",1,34,4941,2390,2551
050,18,057,"Indiana","Hamilton County",1,35,5088,2440,2648
050,18,057,"Indiana","Hamilton County",1,36,5306,2575,2731
050,18,057,"Indiana","Hamilton County",1,37,5391,2628,2763
050,18,057,"Indiana","Hamilton County",1,38,5405,2606,2799
050,18,057,"Indiana","Hamilton County",1,39,5540,2681,2859
050,18,057,"Indiana","Hamilton County",1,40,5471,2701,2770
050,18,057,"Indiana","Hamilton County",1,41,5251,2562,2689
050,18,057,"Indiana","Hamilton County",1,42,5093,2468,2625
050,18,057,"Indiana","Hamilton County",1,43,4985,2438,2547
050,18,057,"Indiana","Hamilton County",1,44,4828,2375,2453
050,18,057,"Indiana","Hamilton County",1,45,4952,2468,2484
050,18,057,"Indiana","Hamilton County",1,46,4859,2441,2418
050,18,057,"Indiana","Hamilton County",1,47,4913,2462,2451
050,18,057,"Indiana","Hamilton County",1,48,5225,2616,2609
050,18,057,"Indiana","Hamilton County",1,49,5489,2734,2755
050,18,057,"Indiana","Hamilton County",1,50,5084,2515,2569
050,18,057,"Indiana","Hamilton County",1,51,4949,2484,2465
050,18,057,"Indiana","Hamilton County",1,52,4696,2393,2303
050,18,057,"Indiana","Hamilton County",1,53,4668,2314,2354
050,18,057,"Indiana","Hamilton County",1,54,4602,2296,2306
050,18,057,"Indiana","Hamilton County",1,55,4723,2356,2367
050,18,057,"Indiana","Hamilton County",1,56,4636,2318,2318
050,18,057,"Indiana","Hamilton County",1,57,4444,2180,2264
050,18,057,"Indiana","Hamilton County",1,58,4412,2153,2259
050,18,057,"Indiana","Hamilton County",1,59,4248,2079,2169
050,18,057,"Indiana","Hamilton County",1,60,4075,1997,2078
050,18,057,"Indiana","Hamilton County",1,61,3892,1900,1992
050,18,057,"Indiana","Hamilton County",1,62,3900,1911,1989
050,18,057,"Indiana","Hamilton County",1,63,3626,1786,1840
050,18,057,"Indiana","Hamilton County",1,64,3425,1640,1785
050,18,057,"Indiana","Hamilton County",1,65,3313,1549,1764
050,18,057,"Indiana","Hamilton County",1,66,3251,1523,1728
050,18,057,"Indiana","Hamilton County",1,67,3115,1454,1661
050,18,057,"Indiana","Hamilton County",1,68,3069,1454,1615
050,18,057,"Indiana","Hamilton County",1,69,2770,1287,1483
050,18,057,"Indiana","Hamilton County",1,70,2701,1234,1467
050,18,057,"Indiana","Hamilton County",1,71,2611,1227,1384
050,18,057,"Indiana","Hamilton County",1,72,2564,1246,1318
050,18,057,"Indiana","Hamilton County",1,73,2497,1223,1274
050,18,057,"Indiana","Hamilton County",1,74,1749,809,940
050,18,057,"Indiana","Hamilton County",1,75,1753,784,969
050,18,057,"Indiana","Hamilton County",1,76,1666,719,947
050,18,057,"Indiana","Hamilton County",1,77,1634,728,906
050,18,057,"Indiana","Hamilton County",1,78,1381,601,780
050,18,057,"Indiana","Hamilton County",1,79,1208,539,669
050,18,057,"Indiana","Hamilton County",1,80,1088,485,603
050,18,057,"Indiana","Hamilton County",1,81,1033,427,606
050,18,057,"Indiana","Hamilton County",1,82,926,376,550
050,18,057,"Indiana","Hamilton County",1,83,850,358,492
050,18,057,"Indiana","Hamilton County",1,84,776,320,456
050,18,057,"Indiana","Hamilton County",1,85,4705,1627,3078
050,18,057,"Indiana","Hamilton County",2,0,3764,1916,1848
050,18,057,"Indiana","Hamilton County",2,1,3961,2011,1950
050,18,057,"Indiana","Hamilton County",2,2,4260,2166,2094
050,18,057,"Indiana","Hamilton County",2,3,4500,2279,2221
050,18,057,"Indiana","Hamilton County",2,4,4758,2387,2371
050,18,057,"Indiana","Hamilton County",2,5,4920,2473,2447
050,18,057,"Indiana","Hamilton County",2,6,5116,2613,2503
050,18,057,"Indiana","Hamilton County",2,7,5017,2578,2439
050,18,057,"Indiana","Hamilton County",2,8,5173,2659,2514
050,18,057,"Indiana","Hamilton County",2,9,5285,2745,2540
050,18,057,"Indiana","Hamilton County",2,10,5469,2806,2663
050,18,057,"Indiana","Hamilton County",2,11,5624,2873,2751
050,18,057,"Indiana","Hamilton County",2,12,5772,2961,2811
050,18,057,"Indiana","Hamilton County",2,13,5787,2948,2839
050,18,057,"Indiana","Hamilton County",2,14,5717,2913,2804
050,18,057,"Indiana","Hamilton County",2,15,5666,2886,2780
050,18,057,"Indiana","Hamilton County",2,16,5745,2909,2836
050,18,057,"Indiana","Hamilton County",2,17,5622,2860,2762
050,18,057,"Indiana","Hamilton County",2,18,4571,2398,2173
050,18,057,"Indiana","Hamilton County",2,19,3600,1871,1729
050,18,057,"Indiana","Hamilton County",2,20,3781,1923,1858
050,18,057,"Indiana","Hamilton County",2,21,3789,1921,1868
050,18,057,"Indiana","Hamilton County",2,22,3801,1865,1936
050,18,057,"Indiana","Hamilton County",2,23,3778,1847,1931
050,18,057,"Indiana","Hamilton County",2,24,3731,1881,1850
050,18,057,"Indiana","Hamilton County",2,25,3749,1872,1877
050,18,057,"Indiana","Hamilton County",2,26,3751,1865,1886
050,18,057,"Indiana","Hamilton County",2,27,3713,1840,1873
050,18,057,"Indiana","Hamilton County",2,28,3845,1861,1984
050,18,057,"Indiana","Hamilton County",2,29,3905,1887,2018
050,18,057,"Indiana","Hamilton County",2,30,3945,1918,2027
050,18,057,"Indiana","Hamilton County",2,31,4050,1935,2115
050,18,057,"Indiana","Hamilton County",2,32,4258,2042,2216
050,18,057,"Indiana","Hamilton County",2,33,4627,2237,2390
050,18,057,"Indiana","Hamilton County",2,34,4917,2376,2541
050,18,057,"Indiana","Hamilton County",2,35,5110,2458,2652
050,18,057,"Indiana","Hamilton County",2,36,5244,2546,2698
050,18,057,"Indiana","Hamilton County",2,37,5409,2635,2774
050,18,057,"Indiana","Hamilton County",2,38,5442,2632,2810
050,18,057,"Indiana","Hamilton County",2,39,5537,2676,2861
050,18,057,"Indiana","Hamilton County",2,40,5538,2722,2816
050,18,057,"Indiana","Hamilton County",2,41,5329,2608,2721
050,18,057,"Indiana","Hamilton County",2,42,5131,2492,2639
050,18,057,"Indiana","Hamilton County",2,43,5054,2468,2586
050,18,057,"Indiana","Hamilton County",2,44,4845,2383,2462
050,18,057,"Indiana","Hamilton County",2,45,4953,2462,2491
050,18,057,"Indiana","Hamilton County",2,46,4874,2440,2434
050,18,057,"Indiana","Hamilton County",2,47,4900,2453,2447
050,18,057,"Indiana","Hamilton County",2,48,5150,2574,2576
050,18,057,"Indiana","Hamilton County",2,49,5449,2719,2730
050,18,057,"Indiana","Hamilton County",2,50,5194,2572,2622
050,18,057,"Indiana","Hamilton County",2,51,4973,2491,2482
050,18,057,"Indiana","Hamilton County",2,52,4751,2411,2340
050,18,057,"Indiana","Hamilton County",2,53,4679,2338,2341
050,18,057,"Indiana","Hamilton County",2,54,4606,2301,2305
050,18,057,"Indiana","Hamilton County",2,55,4695,2346,2349
050,18,057,"Indiana","Hamilton County",2,56,4661,2327,2334
050,18,057,"Indiana","Hamilton County",2,57,4504,2221,2283
050,18,057,"Indiana","Hamilton County",2,58,4413,2151,2262
050,18,057,"Indiana","Hamilton County",2,59,4305,2104,2201
050,18,057,"Indiana","Hamilton County",2,60,4098,2003,2095
050,18,057,"Indiana","Hamilton County",2,61,3921,1919,2002
050,18,057,"Indiana","Hamilton County",2,62,3899,1912,1987
050,18,057,"Indiana","Hamilton County",2,63,3727,1833,1894
050,18,057,"Indiana","Hamilton County",2,64,3473,1674,1799
050,18,057,"Indiana","Hamilton County",2,65,3337,1565,1772
050,18,057,"Indiana","Hamilton County",2,66,3271,1530,1741
050,18,057,"Indiana","Hamilton County",2,67,3135,1467,1668
050,18,057,"Indiana","Hamilton County",2,68,3076,1452,1624
050,18,057,"Indiana","Hamilton County",2,69,2856,1331,1525
050,18,057,"Indiana","Hamilton County",2,70,2703,1242,1461
050,18,057,"Indiana","Hamilton County",2,71,2631,1226,1405
050,18,057,"Indiana","Hamilton County",2,72,2533,1218,1315
050,18,057,"Indiana","Hamilton County",2,73,2636,1285,1351
050,18,057,"Indiana","Hamilton County",2,74,1813,851,962
050,18,057,"Indiana","Hamilton County",2,75,1750,788,962
050,18,057,"Indiana","Hamilton County",2,76,1666,727,939
050,18,057,"Indiana","Hamilton County",2,77,1676,735,941
050,18,057,"Indiana","Hamilton County",2,78,1408,615,793
050,18,057,"Indiana","Hamilton County",2,79,1238,550,688
050,18,057,"Indiana","Hamilton County",2,80,1118,496,622
050,18,057,"Indiana","Hamilton County",2,81,1032,434,598
050,18,057,"Indiana","Hamilton County",2,82,938,376,562
050,18,057,"Indiana","Hamilton County",2,83,865,357,508
050,18,057,"Indiana","Hamilton County",2,84,771,321,450
050,18,057,"Indiana","Hamilton County",2,85,4712,1624,3088
050,18,057,"Indiana","Hamilton County",3,0,3729,1939,1790
050,18,057,"Indiana","Hamilton County",3,1,4054,2063,1991
050,18,057,"Indiana","Hamilton County",3,2,4202,2131,2071
050,18,057,"Indiana","Hamilton County",3,3,4504,2283,2221
050,18,057,"Indiana","Hamilton County",3,4,4717,2385,2332
050,18,057,"Indiana","Hamilton County",3,5,4971,2489,2482
050,18,057,"Indiana","Hamilton County",3,6,5080,2557,2523
050,18,057,"Indiana","Hamilton County",3,7,5246,2677,2569
050,18,057,"Indiana","Hamilton County",3,8,5123,2631,2492
050,18,057,"Indiana","Hamilton County",3,9,5276,2716,2560
050,18,057,"Indiana","Hamilton County",3,10,5357,2770,2587
050,18,057,"Indiana","Hamilton County",3,11,5574,2880,2694
050,18,057,"Indiana","Hamilton County",3,12,5711,2904,2807
050,18,057,"Indiana","Hamilton County",3,13,5815,3003,2812
050,18,057,"Indiana","Hamilton County",3,14,5867,2998,2869
050,18,057,"Indiana","Hamilton County",3,15,5745,2923,2822
050,18,057,"Indiana","Hamilton County",3,16,5654,2884,2770
050,18,057,"Indiana","Hamilton County",3,17,5718,2865,2853
050,18,057,"Indiana","Hamilton County",3,18,4785,2506,2279
050,18,057,"Indiana","Hamilton County",3,19,3646,1904,1742
050,18,057,"Indiana","Hamilton County",3,20,3861,2003,1858
050,18,057,"Indiana","Hamilton County",3,21,3998,2026,1972
050,18,057,"Indiana","Hamilton County",3,22,4090,1991,2099
050,18,057,"Indiana","Hamilton County",3,23,4083,1972,2111
050,18,057,"Indiana","Hamilton County",3,24,3944,1955,1989
050,18,057,"Indiana","Hamilton County",3,25,4031,2005,2026
050,18,057,"Indiana","Hamilton County",3,26,4024,2038,1986
050,18,057,"Indiana","Hamilton County",3,27,4051,1991,2060
050,18,057,"Indiana","Hamilton County",3,28,4002,2010,1992
050,18,057,"Indiana","Hamilton County",3,29,4122,1981,2141
050,18,057,"Indiana","Hamilton County",3,30,4176,2045,2131
050,18,057,"Indiana","Hamilton County",3,31,4294,2119,2175
050,18,057,"Indiana","Hamilton County",3,32,4374,2127,2247
050,18,057,"Indiana","Hamilton County",3,33,4577,2201,2376
050,18,057,"Indiana","Hamilton County",3,34,4853,2349,2504
050,18,057,"Indiana","Hamilton County",3,35,5112,2466,2646
050,18,057,"Indiana","Hamilton County",3,36,5353,2587,2766
050,18,057,"Indiana","Hamilton County",3,37,5420,2619,2801
050,18,057,"Indiana","Hamilton County",3,38,5521,2712,2809
050,18,057,"Indiana","Hamilton County",3,39,5612,2696,2916
050,18,057,"Indiana","Hamilton County",3,40,5650,2743,2907
050,18,057,"Indiana","Hamilton County",3,41,5700,2840,2860
050,18,057,"Indiana","Hamilton County",3,42,5411,2660,2751
050,18,057,"Indiana","Hamilton County",3,43,5225,2548,2677
050,18,057,"Indiana","Hamilton County",3,44,5105,2491,2614
050,18,057,"Indiana","Hamilton County",3,45,4846,2407,2439
050,18,057,"Indiana","Hamilton County",3,46,4942,2475,2467
050,18,057,"Indiana","Hamilton County",3,47,4972,2511,2461
050,18,057,"Indiana","Hamilton County",3,48,4899,2460,2439
050,18,057,"Indiana","Hamilton County",3,49,5172,2576,2596
050,18,057,"Indiana","Hamilton County",3,50,5462,2746,2716
050,18,057,"Indiana","Hamilton County",3,51,5206,2581,2625
050,18,057,"Indiana","Hamilton County",3,52,4939,2489,2450
050,18,057,"Indiana","Hamilton County",3,53,4705,2384,2321
050,18,057,"Indiana","Hamilton County",3,54,4682,2342,2340
050,18,057,"Indiana","Hamilton County",3,55,4577,2274,2303
050,18,057,"Indiana","Hamilton County",3,56,4684,2334,2350
050,18,057,"Indiana","Hamilton County",3,57,4676,2333,2343
050,18,057,"Indiana","Hamilton County",3,58,4542,2236,2306
050,18,057,"Indiana","Hamilton County",3,59,4404,2152,2252
050,18,057,"Indiana","Hamilton County",3,60,4295,2089,2206
050,18,057,"Indiana","Hamilton County",3,61,4112,2032,2080
050,18,057,"Indiana","Hamilton County",3,62,3959,1924,2035
050,18,057,"Indiana","Hamilton County",3,63,3929,1919,2010
050,18,057,"Indiana","Hamilton County",3,64,3730,1814,1916
050,18,057,"Indiana","Hamilton County",3,65,3473,1673,1800
050,18,057,"Indiana","Hamilton County",3,66,3319,1550,1769
050,18,057,"Indiana","Hamilton County",3,67,3272,1519,1753
050,18,057,"Indiana","Hamilton County",3,68,3133,1466,1667
050,18,057,"Indiana","Hamilton County",3,69,3056,1423,1633
050,18,057,"Indiana","Hamilton County",3,70,2848,1326,1522
050,18,057,"Indiana","Hamilton County",3,71,2731,1247,1484
050,18,057,"Indiana","Hamilton County",3,72,2618,1209,1409
050,18,057,"Indiana","Hamilton County",3,73,2513,1200,1313
050,18,057,"Indiana","Hamilton County",3,74,2616,1262,1354
050,18,057,"Indiana","Hamilton County",3,75,1796,853,943
050,18,057,"Indiana","Hamilton County",3,76,1730,768,962
050,18,057,"Indiana","Hamilton County",3,77,1619,690,929
050,18,057,"Indiana","Hamilton County",3,78,1632,704,928
050,18,057,"Indiana","Hamilton County",3,79,1372,602,770
050,18,057,"Indiana","Hamilton County",3,80,1215,536,679
050,18,057,"Indiana","Hamilton County",3,81,1053,455,598
050,18,057,"Indiana","Hamilton County",3,82,968,388,580
050,18,057,"Indiana","Hamilton County",3,83,935,369,566
050,18,057,"Indiana","Hamilton County",3,84,786,327,459
050,18,057,"Indiana","Hamilton County",3,85,4839,1687,3152
050,18,057,"Indiana","Hamilton County",4,0,4044,2044,2000
050,18,057,"Indiana","Hamilton County",4,1,4055,2119,1936
050,18,057,"Indiana","Hamilton County",4,2,4316,2201,2115
050,18,057,"Indiana","Hamilton County",4,3,4408,2239,2169
050,18,057,"Indiana","Hamilton County",4,4,4737,2439,2298
050,18,057,"Indiana","Hamilton County",4,5,4882,2456,2426
050,18,057,"Indiana","Hamilton County",4,6,5157,2605,2552
050,18,057,"Indiana","Hamilton County",4,7,5212,2647,2565
050,18,057,"Indiana","Hamilton County",4,8,5351,2732,2619
050,18,057,"Indiana","Hamilton County",4,9,5234,2696,2538
050,18,057,"Indiana","Hamilton County",4,10,5434,2781,2653
050,18,057,"Indiana","Hamilton County",4,11,5433,2849,2584
050,18,057,"Indiana","Hamilton County",4,12,5672,2923,2749
050,18,057,"Indiana","Hamilton County",4,13,5794,2951,2843
050,18,057,"Indiana","Hamilton County",4,14,5863,3033,2830
050,18,057,"Indiana","Hamilton County",4,15,5912,3009,2903
050,18,057,"Indiana","Hamilton County",4,16,5742,2908,2834
050,18,057,"Indiana","Hamilton County",4,17,5700,2905,2795
050,18,057,"Indiana","Hamilton County",4,18,4801,2486,2315
050,18,057,"Indiana","Hamilton County",4,19,3680,1946,1734
050,18,057,"Indiana","Hamilton County",4,20,3841,1983,1858
050,18,057,"Indiana","Hamilton County",4,21,4041,2086,1955
050,18,057,"Indiana","Hamilton County",4,22,4272,2114,2158
050,18,057,"Indiana","Hamilton County",4,23,4170,2079,2091
050,18,057,"Indiana","Hamilton County",4,24,4050,1968,2082
050,18,057,"Indiana","Hamilton County",4,25,3962,1946,2016
050,18,057,"Indiana","Hamilton County",4,26,4182,2053,2129
050,18,057,"Indiana","Hamilton County",4,27,4127,2065,2062
050,18,057,"Indiana","Hamilton County",4,28,4203,2069,2134
050,18,057,"Indiana","Hamilton County",4,29,4162,2062,2100
050,18,057,"Indiana","Hamilton County",4,30,4331,2097,2234
050,18,057,"Indiana","Hamilton County",4,31,4476,2172,2304
050,18,057,"Indiana","Hamilton County",4,32,4495,2175,2320
050,18,057,"Indiana","Hamilton County",4,33,4670,2265,2405
050,18,057,"Indiana","Hamilton County",4,34,4833,2330,2503
050,18,057,"Indiana","Hamilton County",4,35,5142,2491,2651
050,18,057,"Indiana","Hamilton County",4,36,5310,2538,2772
050,18,057,"Indiana","Hamilton County",4,37,5566,2679,2887
050,18,057,"Indiana","Hamilton County",4,38,5518,2699,2819
050,18,057,"Indiana","Hamilton County",4,39,5662,2780,2882
050,18,057,"Indiana","Hamilton County",4,40,5716,2756,2960
050,18,057,"Indiana","Hamilton County",4,41,5814,2821,2993
050,18,057,"Indiana","Hamilton County",4,42,5798,2900,2898
050,18,057,"Indiana","Hamilton County",4,43,5508,2710,2798
050,18,057,"Indiana","Hamilton County",4,44,5316,2612,2704
050,18,057,"Indiana","Hamilton County",4,45,5113,2515,2598
050,18,057,"Indiana","Hamilton County",4,46,4910,2420,2490
050,18,057,"Indiana","Hamilton County",4,47,5023,2548,2475
050,18,057,"Indiana","Hamilton County",4,48,5008,2522,2486
050,18,057,"Indiana","Hamilton County",4,49,4934,2484,2450
050,18,057,"Indiana","Hamilton County",4,50,5180,2593,2587
050,18,057,"Indiana","Hamilton County",4,51,5447,2725,2722
050,18,057,"Indiana","Hamilton County",4,52,5239,2602,2637
050,18,057,"Indiana","Hamilton County",4,53,4947,2510,2437
050,18,057,"Indiana","Hamilton County",4,54,4722,2385,2337
050,18,057,"Indiana","Hamilton County",4,55,4669,2321,2348
050,18,057,"Indiana","Hamilton County",4,56,4517,2229,2288
050,18,057,"Indiana","Hamilton County",4,57,4639,2303,2336
050,18,057,"Indiana","Hamilton County",4,58,4688,2343,2345
050,18,057,"Indiana","Hamilton County",4,59,4537,2219,2318
050,18,057,"Indiana","Hamilton County",4,60,4386,2160,2226
050,18,057,"Indiana","Hamilton County",4,61,4283,2078,2205
050,18,057,"Indiana","Hamilton County",4,62,4108,2002,2106
050,18,057,"Indiana","Hamilton County",4,63,4004,1916,2088
050,18,057,"Indiana","Hamilton County",4,64,3914,1904,2010
050,18,057,"Indiana","Hamilton County",4,65,3753,1805,1948
050,18,057,"Indiana","Hamilton County",4,66,3530,1681,1849
050,18,057,"Indiana","Hamilton County",4,67,3308,1529,1779
050,18,057,"Indiana","Hamilton County",4,68,3323,1555,1768
050,18,057,"Indiana","Hamilton County",4,69,3134,1454,1680
050,18,057,"Indiana","Hamilton County",4,70,3061,1420,1641
050,18,057,"Indiana","Hamilton County",4,71,2838,1309,1529
050,18,057,"Indiana","Hamilton County",4,72,2743,1247,1496
050,18,057,"Indiana","Hamilton County",4,73,2617,1200,1417
050,18,057,"Indiana","Hamilton County",4,74,2518,1183,1335
050,18,057,"Indiana","Hamilton County",4,75,2620,1263,1357
050,18,057,"Indiana","Hamilton County",4,76,1785,849,936
050,18,057,"Indiana","Hamilton County",4,77,1704,757,947
050,18,057,"Indiana","Hamilton County",4,78,1592,669,923
050,18,057,"Indiana","Hamilton County",4,79,1602,695,907
050,18,057,"Indiana","Hamilton County",4,80,1363,598,765
050,18,057,"Indiana","Hamilton County",4,81,1174,494,680
050,18,057,"Indiana","Hamilton County",4,82,1000,419,581
050,18,057,"Indiana","Hamilton County",4,83,970,381,589
050,18,057,"Indiana","Hamilton County",4,84,907,349,558
050,18,057,"Indiana","Hamilton County",4,85,5061,1769,3292
050,18,057,"Indiana","Hamilton County",5,0,3996,2021,1975
050,18,057,"Indiana","Hamilton County",5,1,4161,2136,2025
050,18,057,"Indiana","Hamilton County",5,2,4254,2213,2041
050,18,057,"Indiana","Hamilton County",5,3,4461,2288,2173
050,18,057,"Indiana","Hamilton County",5,4,4509,2293,2216
050,18,057,"Indiana","Hamilton County",5,5,4847,2499,2348
050,18,057,"Indiana","Hamilton County",5,6,4941,2463,2478
050,18,057,"Indiana","Hamilton County",5,7,5253,2647,2606
050,18,057,"Indiana","Hamilton County",5,8,5377,2740,2637
050,18,057,"Indiana","Hamilton County",5,9,5372,2739,2633
050,18,057,"Indiana","Hamilton County",5,10,5360,2772,2588
050,18,057,"Indiana","Hamilton County",5,11,5475,2837,2638
050,18,057,"Indiana","Hamilton County",5,12,5493,2865,2628
050,18,057,"Indiana","Hamilton County",5,13,5787,2972,2815
050,18,057,"Indiana","Hamilton County",5,14,5875,3001,2874
050,18,057,"Indiana","Hamilton County",5,15,5915,3033,2882
050,18,057,"Indiana","Hamilton County",5,16,5939,3032,2907
050,18,057,"Indiana","Hamilton County",5,17,5745,2895,2850
050,18,057,"Indiana","Hamilton County",5,18,4732,2490,2242
050,18,057,"Indiana","Hamilton County",5,19,3767,1942,1825
050,18,057,"Indiana","Hamilton County",5,20,4042,2101,1941
050,18,057,"Indiana","Hamilton County",5,21,4072,2080,1992
050,18,057,"Indiana","Hamilton County",5,22,4318,2170,2148
050,18,057,"Indiana","Hamilton County",5,23,4308,2138,2170
050,18,057,"Indiana","Hamilton County",5,24,4252,2168,2084
050,18,057,"Indiana","Hamilton County",5,25,4049,1941,2108
050,18,057,"Indiana","Hamilton County",5,26,4070,1962,2108
050,18,057,"Indiana","Hamilton County",5,27,4251,2065,2186
050,18,057,"Indiana","Hamilton County",5,28,4212,2124,2088
050,18,057,"Indiana","Hamilton County",5,29,4251,2118,2133
050,18,057,"Indiana","Hamilton County",5,30,4289,2144,2145
050,18,057,"Indiana","Hamilton County",5,31,4558,2218,2340
050,18,057,"Indiana","Hamilton County",5,32,4656,2266,2390
050,18,057,"Indiana","Hamilton County",5,33,4731,2285,2446
050,18,057,"Indiana","Hamilton County",5,34,4822,2367,2455
050,18,057,"Indiana","Hamilton County",5,35,4998,2427,2571
050,18,057,"Indiana","Hamilton County",5,36,5381,2591,2790
050,18,057,"Indiana","Hamilton County",5,37,5539,2639,2900
050,18,057,"Indiana","Hamilton County",5,38,5671,2752,2919
050,18,057,"Indiana","Hamilton County",5,39,5654,2745,2909
050,18,057,"Indiana","Hamilton County",5,40,5765,2846,2919
050,18,057,"Indiana","Hamilton County",5,41,5867,2853,3014
050,18,057,"Indiana","Hamilton County",5,42,5918,2851,3067
050,18,057,"Indiana","Hamilton County",5,43,5887,2918,2969
050,18,057,"Indiana","Hamilton County",5,44,5559,2757,2802
050,18,057,"Indiana","Hamilton County",5,45,5294,2601,2693
050,18,057,"Indiana","Hamilton County",5,46,5139,2526,2613
050,18,057,"Indiana","Hamilton County",5,47,5012,2477,2535
050,18,057,"Indiana","Hamilton County",5,48,5040,2547,2493
050,18,057,"Indiana","Hamilton County",5,49,4982,2510,2472
050,18,057,"Indiana","Hamilton County",5,50,4986,2516,2470
050,18,057,"Indiana","Hamilton County",5,51,5166,2602,2564
050,18,057,"Indiana","Hamilton County",5,52,5425,2721,2704
050,18,057,"Indiana","Hamilton County",5,53,5219,2626,2593
050,18,057,"Indiana","Hamilton County",5,54,4934,2510,2424
050,18,057,"Indiana","Hamilton County",5,55,4690,2370,2320
050,18,057,"Indiana","Hamilton County",5,56,4644,2312,2332
050,18,057,"Indiana","Hamilton County",5,57,4450,2198,2252
050,18,057,"Indiana","Hamilton County",5,58,4616,2272,2344
050,18,057,"Indiana","Hamilton County",5,59,4648,2329,2319
050,18,057,"Indiana","Hamilton County",5,60,4496,2199,2297
050,18,057,"Indiana","Hamilton County",5,61,4381,2166,2215
050,18,057,"Indiana","Hamilton County",5,62,4308,2081,2227
050,18,057,"Indiana","Hamilton County",5,63,4130,1995,2135
050,18,057,"Indiana","Hamilton County",5,64,4013,1919,2094
050,18,057,"Indiana","Hamilton County",5,65,3908,1890,2018
050,18,057,"Indiana","Hamilton County",5,66,3707,1757,1950
050,18,057,"Indiana","Hamilton County",5,67,3522,1677,1845
050,18,057,"Indiana","Hamilton County",5,68,3362,1538,1824
050,18,057,"Indiana","Hamilton County",5,69,3336,1550,1786
050,18,057,"Indiana","Hamilton County",5,70,3129,1443,1686
050,18,057,"Indiana","Hamilton County",5,71,3044,1397,1647
050,18,057,"Indiana","Hamilton County",5,72,2823,1295,1528
050,18,057,"Indiana","Hamilton County",5,73,2707,1226,1481
050,18,057,"Indiana","Hamilton County",5,74,2620,1188,1432
050,18,057,"Indiana","Hamilton County",5,75,2485,1178,1307
050,18,057,"Indiana","Hamilton County",5,76,2614,1247,1367
050,18,057,"Indiana","Hamilton County",5,77,1782,829,953
050,18,057,"Indiana","Hamilton County",5,78,1677,746,931
050,18,057,"Indiana","Hamilton County",5,79,1559,656,903
050,18,057,"Indiana","Hamilton County",5,80,1587,690,897
050,18,057,"Indiana","Hamilton County",5,81,1296,552,744
050,18,057,"Indiana","Hamilton County",5,82,1136,468,668
050,18,057,"Indiana","Hamilton County",5,83,1010,412,598
050,18,057,"Indiana","Hamilton County",5,84,913,352,561
050,18,057,"Indiana","Hamilton County",5,85,5476,1912,3564
050,18,059,"Indiana","Hancock County",1,0,787,403,384
050,18,059,"Indiana","Hancock County",1,1,862,435,427
050,18,059,"Indiana","Hancock County",1,2,911,480,431
050,18,059,"Indiana","Hancock County",1,3,969,513,456
050,18,059,"Indiana","Hancock County",1,4,1006,520,486
050,18,059,"Indiana","Hancock County",1,5,1019,520,499
050,18,059,"Indiana","Hancock County",1,6,992,528,464
050,18,059,"Indiana","Hancock County",1,7,1001,503,498
050,18,059,"Indiana","Hancock County",1,8,1041,536,505
050,18,059,"Indiana","Hancock County",1,9,1079,558,521
050,18,059,"Indiana","Hancock County",1,10,1050,527,523
050,18,059,"Indiana","Hancock County",1,11,1085,548,537
050,18,059,"Indiana","Hancock County",1,12,1161,592,569
050,18,059,"Indiana","Hancock County",1,13,1168,605,563
050,18,059,"Indiana","Hancock County",1,14,1164,599,565
050,18,059,"Indiana","Hancock County",1,15,1104,560,544
050,18,059,"Indiana","Hancock County",1,16,1160,590,570
050,18,059,"Indiana","Hancock County",1,17,1132,583,549
050,18,059,"Indiana","Hancock County",1,18,935,473,462
050,18,059,"Indiana","Hancock County",1,19,771,409,362
050,18,059,"Indiana","Hancock County",1,20,795,409,386
050,18,059,"Indiana","Hancock County",1,21,841,428,413
050,18,059,"Indiana","Hancock County",1,22,860,459,401
050,18,059,"Indiana","Hancock County",1,23,876,440,436
050,18,059,"Indiana","Hancock County",1,24,879,437,442
050,18,059,"Indiana","Hancock County",1,25,877,452,425
050,18,059,"Indiana","Hancock County",1,26,857,437,420
050,18,059,"Indiana","Hancock County",1,27,907,437,470
050,18,059,"Indiana","Hancock County",1,28,949,468,481
050,18,059,"Indiana","Hancock County",1,29,988,501,487
050,18,059,"Indiana","Hancock County",1,30,991,488,503
050,18,059,"Indiana","Hancock County",1,31,940,483,457
050,18,059,"Indiana","Hancock County",1,32,1000,490,510
050,18,059,"Indiana","Hancock County",1,33,1024,504,520
050,18,059,"Indiana","Hancock County",1,34,1036,491,545
050,18,059,"Indiana","Hancock County",1,35,1085,518,567
050,18,059,"Indiana","Hancock County",1,36,1087,528,559
050,18,059,"Indiana","Hancock County",1,37,1109,549,560
050,18,059,"Indiana","Hancock County",1,38,1142,593,549
050,18,059,"Indiana","Hancock County",1,39,1106,574,532
050,18,059,"Indiana","Hancock County",1,40,1101,533,568
050,18,059,"Indiana","Hancock County",1,41,1042,517,525
050,18,059,"Indiana","Hancock County",1,42,988,516,472
050,18,059,"Indiana","Hancock County",1,43,983,497,486
050,18,059,"Indiana","Hancock County",1,44,977,490,487
050,18,059,"Indiana","Hancock County",1,45,1017,500,517
050,18,059,"Indiana","Hancock County",1,46,999,489,510
050,18,059,"Indiana","Hancock County",1,47,1075,530,545
050,18,059,"Indiana","Hancock County",1,48,1099,554,545
050,18,059,"Indiana","Hancock County",1,49,1185,597,588
050,18,059,"Indiana","Hancock County",1,50,1107,581,526
050,18,059,"Indiana","Hancock County",1,51,1085,547,538
050,18,059,"Indiana","Hancock County",1,52,1044,512,532
050,18,059,"Indiana","Hancock County",1,53,1078,527,551
050,18,059,"Indiana","Hancock County",1,54,1118,548,570
050,18,059,"Indiana","Hancock County",1,55,1134,551,583
050,18,059,"Indiana","Hancock County",1,56,1205,588,617
050,18,059,"Indiana","Hancock County",1,57,1183,563,620
050,18,059,"Indiana","Hancock County",1,58,1163,570,593
050,18,059,"Indiana","Hancock County",1,59,1152,575,577
050,18,059,"Indiana","Hancock County",1,60,1070,546,524
050,18,059,"Indiana","Hancock County",1,61,1090,533,557
050,18,059,"Indiana","Hancock County",1,62,1019,499,520
050,18,059,"Indiana","Hancock County",1,63,1001,496,505
050,18,059,"Indiana","Hancock County",1,64,970,495,475
050,18,059,"Indiana","Hancock County",1,65,891,446,445
050,18,059,"Indiana","Hancock County",1,66,895,430,465
050,18,059,"Indiana","Hancock County",1,67,867,424,443
050,18,059,"Indiana","Hancock County",1,68,831,392,439
050,18,059,"Indiana","Hancock County",1,69,759,338,421
050,18,059,"Indiana","Hancock County",1,70,808,356,452
050,18,059,"Indiana","Hancock County",1,71,817,377,440
050,18,059,"Indiana","Hancock County",1,72,799,381,418
050,18,059,"Indiana","Hancock County",1,73,800,374,426
050,18,059,"Indiana","Hancock County",1,74,539,248,291
050,18,059,"Indiana","Hancock County",1,75,513,231,282
050,18,059,"Indiana","Hancock County",1,76,508,237,271
050,18,059,"Indiana","Hancock County",1,77,509,236,273
050,18,059,"Indiana","Hancock County",1,78,439,191,248
050,18,059,"Indiana","Hancock County",1,79,427,189,238
050,18,059,"Indiana","Hancock County",1,80,379,174,205
050,18,059,"Indiana","Hancock County",1,81,323,150,173
050,18,059,"Indiana","Hancock County",1,82,283,127,156
050,18,059,"Indiana","Hancock County",1,83,249,99,150
050,18,059,"Indiana","Hancock County",1,84,240,92,148
050,18,059,"Indiana","Hancock County",1,85,1331,516,815
050,18,059,"Indiana","Hancock County",2,0,792,393,399
050,18,059,"Indiana","Hancock County",2,1,854,431,423
050,18,059,"Indiana","Hancock County",2,2,911,474,437
050,18,059,"Indiana","Hancock County",2,3,963,510,453
050,18,059,"Indiana","Hancock County",2,4,1006,526,480
050,18,059,"Indiana","Hancock County",2,5,1025,524,501
050,18,059,"Indiana","Hancock County",2,6,1010,533,477
050,18,059,"Indiana","Hancock County",2,7,1008,513,495
050,18,059,"Indiana","Hancock County",2,8,1038,529,509
050,18,059,"Indiana","Hancock County",2,9,1075,551,524
050,18,059,"Indiana","Hancock County",2,10,1066,540,526
050,18,059,"Indiana","Hancock County",2,11,1073,541,532
050,18,059,"Indiana","Hancock County",2,12,1151,586,565
050,18,059,"Indiana","Hancock County",2,13,1175,603,572
050,18,059,"Indiana","Hancock County",2,14,1165,597,568
050,18,059,"Indiana","Hancock County",2,15,1118,570,548
050,18,059,"Indiana","Hancock County",2,16,1150,585,565
050,18,059,"Indiana","Hancock County",2,17,1138,582,556
050,18,059,"Indiana","Hancock County",2,18,937,481,456
050,18,059,"Indiana","Hancock County",2,19,768,402,366
050,18,059,"Indiana","Hancock County",2,20,816,416,400
050,18,059,"Indiana","Hancock County",2,21,837,428,409
050,18,059,"Indiana","Hancock County",2,22,861,453,408
050,18,059,"Indiana","Hancock County",2,23,872,445,427
050,18,059,"Indiana","Hancock County",2,24,886,443,443
050,18,059,"Indiana","Hancock County",2,25,883,451,432
050,18,059,"Indiana","Hancock County",2,26,867,441,426
050,18,059,"Indiana","Hancock County",2,27,898,437,461
050,18,059,"Indiana","Hancock County",2,28,954,470,484
050,18,059,"Indiana","Hancock County",2,29,999,501,498
050,18,059,"Indiana","Hancock County",2,30,1006,499,507
050,18,059,"Indiana","Hancock County",2,31,964,489,475
050,18,059,"Indiana","Hancock County",2,32,1001,496,505
050,18,059,"Indiana","Hancock County",2,33,1025,503,522
050,18,059,"Indiana","Hancock County",2,34,1039,494,545
050,18,059,"Indiana","Hancock County",2,35,1090,517,573
050,18,059,"Indiana","Hancock County",2,36,1092,527,565
050,18,059,"Indiana","Hancock County",2,37,1113,550,563
050,18,059,"Indiana","Hancock County",2,38,1145,591,554
050,18,059,"Indiana","Hancock County",2,39,1119,580,539
050,18,059,"Indiana","Hancock County",2,40,1111,544,567
050,18,059,"Indiana","Hancock County",2,41,1058,523,535
050,18,059,"Indiana","Hancock County",2,42,999,515,484
050,18,059,"Indiana","Hancock County",2,43,991,504,487
050,18,059,"Indiana","Hancock County",2,44,974,490,484
050,18,059,"Indiana","Hancock County",2,45,1018,503,515
050,18,059,"Indiana","Hancock County",2,46,1002,491,511
050,18,059,"Indiana","Hancock County",2,47,1058,521,537
050,18,059,"Indiana","Hancock County",2,48,1097,550,547
050,18,059,"Indiana","Hancock County",2,49,1169,594,575
050,18,059,"Indiana","Hancock County",2,50,1128,583,545
050,18,059,"Indiana","Hancock County",2,51,1089,552,537
050,18,059,"Indiana","Hancock County",2,52,1056,522,534
050,18,059,"Indiana","Hancock County",2,53,1073,523,550
050,18,059,"Indiana","Hancock County",2,54,1099,536,563
050,18,059,"Indiana","Hancock County",2,55,1137,554,583
050,18,059,"Indiana","Hancock County",2,56,1189,578,611
050,18,059,"Indiana","Hancock County",2,57,1185,569,616
050,18,059,"Indiana","Hancock County",2,58,1161,566,595
050,18,059,"Indiana","Hancock County",2,59,1163,579,584
050,18,059,"Indiana","Hancock County",2,60,1087,552,535
050,18,059,"Indiana","Hancock County",2,61,1083,535,548
050,18,059,"Indiana","Hancock County",2,62,1035,506,529
050,18,059,"Indiana","Hancock County",2,63,1012,499,513
050,18,059,"Indiana","Hancock County",2,64,974,493,481
050,18,059,"Indiana","Hancock County",2,65,913,458,455
050,18,059,"Indiana","Hancock County",2,66,901,438,463
050,18,059,"Indiana","Hancock County",2,67,869,424,445
050,18,059,"Indiana","Hancock County",2,68,835,398,437
050,18,059,"Indiana","Hancock County",2,69,781,351,430
050,18,059,"Indiana","Hancock County",2,70,794,351,443
050,18,059,"Indiana","Hancock County",2,71,816,371,445
050,18,059,"Indiana","Hancock County",2,72,790,371,419
050,18,059,"Indiana","Hancock County",2,73,835,392,443
050,18,059,"Indiana","Hancock County",2,74,567,263,304
050,18,059,"Indiana","Hancock County",2,75,518,233,285
050,18,059,"Indiana","Hancock County",2,76,501,231,270
050,18,059,"Indiana","Hancock County",2,77,519,242,277
050,18,059,"Indiana","Hancock County",2,78,445,199,246
050,18,059,"Indiana","Hancock County",2,79,428,191,237
050,18,059,"Indiana","Hancock County",2,80,390,175,215
050,18,059,"Indiana","Hancock County",2,81,325,153,172
050,18,059,"Indiana","Hancock County",2,82,293,130,163
050,18,059,"Indiana","Hancock County",2,83,248,102,146
050,18,059,"Indiana","Hancock County",2,84,238,91,147
050,18,059,"Indiana","Hancock County",2,85,1336,520,816
050,18,059,"Indiana","Hancock County",3,0,803,408,395
050,18,059,"Indiana","Hancock County",3,1,866,444,422
050,18,059,"Indiana","Hancock County",3,2,909,462,447
050,18,059,"Indiana","Hancock County",3,3,971,504,467
050,18,059,"Indiana","Hancock County",3,4,999,525,474
050,18,059,"Indiana","Hancock County",3,5,1045,530,515
050,18,059,"Indiana","Hancock County",3,6,1101,562,539
050,18,059,"Indiana","Hancock County",3,7,1092,580,512
050,18,059,"Indiana","Hancock County",3,8,1036,527,509
050,18,059,"Indiana","Hancock County",3,9,1084,576,508
050,18,059,"Indiana","Hancock County",3,10,1120,571,549
050,18,059,"Indiana","Hancock County",3,11,1108,574,534
050,18,059,"Indiana","Hancock County",3,12,1113,563,550
050,18,059,"Indiana","Hancock County",3,13,1172,604,568
050,18,059,"Indiana","Hancock County",3,14,1198,622,576
050,18,059,"Indiana","Hancock County",3,15,1158,591,567
050,18,059,"Indiana","Hancock County",3,16,1150,601,549
050,18,059,"Indiana","Hancock County",3,17,1160,586,574
050,18,059,"Indiana","Hancock County",3,18,960,507,453
050,18,059,"Indiana","Hancock County",3,19,761,394,367
050,18,059,"Indiana","Hancock County",3,20,832,420,412
050,18,059,"Indiana","Hancock County",3,21,837,434,403
050,18,059,"Indiana","Hancock County",3,22,840,428,412
050,18,059,"Indiana","Hancock County",3,23,900,479,421
050,18,059,"Indiana","Hancock County",3,24,849,432,417
050,18,059,"Indiana","Hancock County",3,25,909,451,458
050,18,059,"Indiana","Hancock County",3,26,911,453,458
050,18,059,"Indiana","Hancock County",3,27,899,453,446
050,18,059,"Indiana","Hancock County",3,28,966,465,501
050,18,059,"Indiana","Hancock County",3,29,1058,525,533
050,18,059,"Indiana","Hancock County",3,30,1047,533,514
050,18,059,"Indiana","Hancock County",3,31,1057,506,551
050,18,059,"Indiana","Hancock County",3,32,1001,503,498
050,18,059,"Indiana","Hancock County",3,33,1044,520,524
050,18,059,"Indiana","Hancock County",3,34,1054,529,525
050,18,059,"Indiana","Hancock County",3,35,1090,517,573
050,18,059,"Indiana","Hancock County",3,36,1176,562,614
050,18,059,"Indiana","Hancock County",3,37,1133,545,588
050,18,059,"Indiana","Hancock County",3,38,1162,582,580
050,18,059,"Indiana","Hancock County",3,39,1187,612,575
050,18,059,"Indiana","Hancock County",3,40,1135,580,555
050,18,059,"Indiana","Hancock County",3,41,1142,566,576
050,18,059,"Indiana","Hancock County",3,42,1076,543,533
050,18,059,"Indiana","Hancock County",3,43,1034,534,500
050,18,059,"Indiana","Hancock County",3,44,1004,512,492
050,18,059,"Indiana","Hancock County",3,45,1004,498,506
050,18,059,"Indiana","Hancock County",3,46,1039,513,526
050,18,059,"Indiana","Hancock County",3,47,1008,488,520
050,18,059,"Indiana","Hancock County",3,48,1046,521,525
050,18,059,"Indiana","Hancock County",3,49,1121,578,543
050,18,059,"Indiana","Hancock County",3,50,1183,594,589
050,18,059,"Indiana","Hancock County",3,51,1123,577,546
050,18,059,"Indiana","Hancock County",3,52,1119,578,541
050,18,059,"Indiana","Hancock County",3,53,1077,526,551
050,18,059,"Indiana","Hancock County",3,54,1087,514,573
050,18,059,"Indiana","Hancock County",3,55,1094,543,551
050,18,059,"Indiana","Hancock County",3,56,1164,556,608
050,18,059,"Indiana","Hancock County",3,57,1181,574,607
050,18,059,"Indiana","Hancock County",3,58,1189,577,612
050,18,059,"Indiana","Hancock County",3,59,1201,590,611
050,18,059,"Indiana","Hancock County",3,60,1155,573,582
050,18,059,"Indiana","Hancock County",3,61,1083,536,547
050,18,059,"Indiana","Hancock County",3,62,1067,523,544
050,18,059,"Indiana","Hancock County",3,63,1041,513,528
050,18,059,"Indiana","Hancock County",3,64,996,493,503
050,18,059,"Indiana","Hancock County",3,65,969,494,475
050,18,059,"Indiana","Hancock County",3,66,911,457,454
050,18,059,"Indiana","Hancock County",3,67,891,426,465
050,18,059,"Indiana","Hancock County",3,68,846,411,435
050,18,059,"Indiana","Hancock County",3,69,817,388,429
050,18,059,"Indiana","Hancock County",3,70,770,340,430
050,18,059,"Indiana","Hancock County",3,71,758,337,421
050,18,059,"Indiana","Hancock County",3,72,801,359,442
050,18,059,"Indiana","Hancock County",3,73,769,360,409
050,18,059,"Indiana","Hancock County",3,74,810,380,430
050,18,059,"Indiana","Hancock County",3,75,545,248,297
050,18,059,"Indiana","Hancock County",3,76,515,231,284
050,18,059,"Indiana","Hancock County",3,77,469,218,251
050,18,059,"Indiana","Hancock County",3,78,500,231,269
050,18,059,"Indiana","Hancock County",3,79,425,185,240
050,18,059,"Indiana","Hancock County",3,80,401,177,224
050,18,059,"Indiana","Hancock County",3,81,365,168,197
050,18,059,"Indiana","Hancock County",3,82,309,129,180
050,18,059,"Indiana","Hancock County",3,83,281,121,160
050,18,059,"Indiana","Hancock County",3,84,235,93,142
050,18,059,"Indiana","Hancock County",3,85,1377,530,847
050,18,059,"Indiana","Hancock County",4,0,875,435,440
050,18,059,"Indiana","Hancock County",4,1,872,453,419
050,18,059,"Indiana","Hancock County",4,2,923,475,448
050,18,059,"Indiana","Hancock County",4,3,964,482,482
050,18,059,"Indiana","Hancock County",4,4,1000,510,490
050,18,059,"Indiana","Hancock County",4,5,1054,564,490
050,18,059,"Indiana","Hancock County",4,6,1049,540,509
050,18,059,"Indiana","Hancock County",4,7,1123,563,560
050,18,059,"Indiana","Hancock County",4,8,1153,630,523
050,18,059,"Indiana","Hancock County",4,9,1050,522,528
050,18,059,"Indiana","Hancock County",4,10,1117,595,522
050,18,059,"Indiana","Hancock County",4,11,1150,582,568
050,18,059,"Indiana","Hancock County",4,12,1131,576,555
050,18,059,"Indiana","Hancock County",4,13,1120,564,556
050,18,059,"Indiana","Hancock County",4,14,1191,607,584
050,18,059,"Indiana","Hancock County",4,15,1230,628,602
050,18,059,"Indiana","Hancock County",4,16,1172,604,568
050,18,059,"Indiana","Hancock County",4,17,1142,597,545
050,18,059,"Indiana","Hancock County",4,18,983,524,459
050,18,059,"Indiana","Hancock County",4,19,752,401,351
050,18,059,"Indiana","Hancock County",4,20,768,395,373
050,18,059,"Indiana","Hancock County",4,21,841,420,421
050,18,059,"Indiana","Hancock County",4,22,887,430,457
050,18,059,"Indiana","Hancock County",4,23,895,453,442
050,18,059,"Indiana","Hancock County",4,24,907,477,430
050,18,059,"Indiana","Hancock County",4,25,865,440,425
050,18,059,"Indiana","Hancock County",4,26,906,450,456
050,18,059,"Indiana","Hancock County",4,27,915,466,449
050,18,059,"Indiana","Hancock County",4,28,948,468,480
050,18,059,"Indiana","Hancock County",4,29,991,473,518
050,18,059,"Indiana","Hancock County",4,30,1093,539,554
050,18,059,"Indiana","Hancock County",4,31,1086,547,539
050,18,059,"Indiana","Hancock County",4,32,1141,566,575
050,18,059,"Indiana","Hancock County",4,33,1047,520,527
050,18,059,"Indiana","Hancock County",4,34,1106,537,569
050,18,059,"Indiana","Hancock County",4,35,1094,541,553
050,18,059,"Indiana","Hancock County",4,36,1145,560,585
050,18,059,"Indiana","Hancock County",4,37,1199,586,613
050,18,059,"Indiana","Hancock County",4,38,1166,559,607
050,18,059,"Indiana","Hancock County",4,39,1200,600,600
050,18,059,"Indiana","Hancock County",4,40,1205,607,598
050,18,059,"Indiana","Hancock County",4,41,1126,567,559
050,18,059,"Indiana","Hancock County",4,42,1166,581,585
050,18,059,"Indiana","Hancock County",4,43,1078,537,541
050,18,059,"Indiana","Hancock County",4,44,1048,546,502
050,18,059,"Indiana","Hancock County",4,45,1042,526,516
050,18,059,"Indiana","Hancock County",4,46,1010,498,512
050,18,059,"Indiana","Hancock County",4,47,1043,527,516
050,18,059,"Indiana","Hancock County",4,48,1015,486,529
050,18,059,"Indiana","Hancock County",4,49,1061,525,536
050,18,059,"Indiana","Hancock County",4,50,1113,567,546
050,18,059,"Indiana","Hancock County",4,51,1178,590,588
050,18,059,"Indiana","Hancock County",4,52,1149,591,558
050,18,059,"Indiana","Hancock County",4,53,1106,559,547
050,18,059,"Indiana","Hancock County",4,54,1070,527,543
050,18,059,"Indiana","Hancock County",4,55,1089,523,566
050,18,059,"Indiana","Hancock County",4,56,1107,555,552
050,18,059,"Indiana","Hancock County",4,57,1155,556,599
050,18,059,"Indiana","Hancock County",4,58,1169,581,588
050,18,059,"Indiana","Hancock County",4,59,1193,579,614
050,18,059,"Indiana","Hancock County",4,60,1185,579,606
050,18,059,"Indiana","Hancock County",4,61,1144,562,582
050,18,059,"Indiana","Hancock County",4,62,1103,543,560
050,18,059,"Indiana","Hancock County",4,63,1056,506,550
050,18,059,"Indiana","Hancock County",4,64,1033,510,523
050,18,059,"Indiana","Hancock County",4,65,986,482,504
050,18,059,"Indiana","Hancock County",4,66,977,493,484
050,18,059,"Indiana","Hancock County",4,67,916,445,471
050,18,059,"Indiana","Hancock County",4,68,885,425,460
050,18,059,"Indiana","Hancock County",4,69,839,395,444
050,18,059,"Indiana","Hancock County",4,70,809,378,431
050,18,059,"Indiana","Hancock County",4,71,725,320,405
050,18,059,"Indiana","Hancock County",4,72,735,320,415
050,18,059,"Indiana","Hancock County",4,73,774,339,435
050,18,059,"Indiana","Hancock County",4,74,756,356,400
050,18,059,"Indiana","Hancock County",4,75,782,367,415
050,18,059,"Indiana","Hancock County",4,76,542,238,304
050,18,059,"Indiana","Hancock County",4,77,484,216,268
050,18,059,"Indiana","Hancock County",4,78,455,207,248
050,18,059,"Indiana","Hancock County",4,79,482,226,256
050,18,059,"Indiana","Hancock County",4,80,399,178,221
050,18,059,"Indiana","Hancock County",4,81,373,169,204
050,18,059,"Indiana","Hancock County",4,82,358,157,201
050,18,059,"Indiana","Hancock County",4,83,278,111,167
050,18,059,"Indiana","Hancock County",4,84,264,111,153
050,18,059,"Indiana","Hancock County",4,85,1403,534,869
050,18,059,"Indiana","Hancock County",5,0,864,431,433
050,18,059,"Indiana","Hancock County",5,1,1024,505,519
050,18,059,"Indiana","Hancock County",5,2,965,495,470
050,18,059,"Indiana","Hancock County",5,3,1010,520,490
050,18,059,"Indiana","Hancock County",5,4,1052,530,522
050,18,059,"Indiana","Hancock County",5,5,1043,525,518
050,18,059,"Indiana","Hancock County",5,6,1112,594,518
050,18,059,"Indiana","Hancock County",5,7,1080,545,535
050,18,059,"Indiana","Hancock County",5,8,1145,569,576
050,18,059,"Indiana","Hancock County",5,9,1190,650,540
050,18,059,"Indiana","Hancock County",5,10,1118,558,560
050,18,059,"Indiana","Hancock County",5,11,1127,591,536
050,18,059,"Indiana","Hancock County",5,12,1194,621,573
050,18,059,"Indiana","Hancock County",5,13,1133,585,548
050,18,059,"Indiana","Hancock County",5,14,1204,608,596
050,18,059,"Indiana","Hancock County",5,15,1232,624,608
050,18,059,"Indiana","Hancock County",5,16,1240,639,601
050,18,059,"Indiana","Hancock County",5,17,1187,599,588
050,18,059,"Indiana","Hancock County",5,18,985,534,451
050,18,059,"Indiana","Hancock County",5,19,800,428,372
050,18,059,"Indiana","Hancock County",5,20,844,440,404
050,18,059,"Indiana","Hancock County",5,21,838,432,406
050,18,059,"Indiana","Hancock County",5,22,944,467,477
050,18,059,"Indiana","Hancock County",5,23,929,476,453
050,18,059,"Indiana","Hancock County",5,24,973,491,482
050,18,059,"Indiana","Hancock County",5,25,903,477,426
050,18,059,"Indiana","Hancock County",5,26,925,475,450
050,18,059,"Indiana","Hancock County",5,27,957,485,472
050,18,059,"Indiana","Hancock County",5,28,993,509,484
050,18,059,"Indiana","Hancock County",5,29,1051,534,517
050,18,059,"Indiana","Hancock County",5,30,1063,505,558
050,18,059,"Indiana","Hancock County",5,31,1176,577,599
050,18,059,"Indiana","Hancock County",5,32,1195,620,575
050,18,059,"Indiana","Hancock County",5,33,1255,604,651
050,18,059,"Indiana","Hancock County",5,34,1161,574,587
050,18,059,"Indiana","Hancock County",5,35,1172,561,611
050,18,059,"Indiana","Hancock County",5,36,1132,578,554
050,18,059,"Indiana","Hancock County",5,37,1198,575,623
050,18,059,"Indiana","Hancock County",5,38,1280,634,646
050,18,059,"Indiana","Hancock County",5,39,1220,592,628
050,18,059,"Indiana","Hancock County",5,40,1242,615,627
050,18,059,"Indiana","Hancock County",5,41,1251,614,637
050,18,059,"Indiana","Hancock County",5,42,1197,613,584
050,18,059,"Indiana","Hancock County",5,43,1186,582,604
050,18,059,"Indiana","Hancock County",5,44,1126,557,569
050,18,059,"Indiana","Hancock County",5,45,1093,577,516
050,18,059,"Indiana","Hancock County",5,46,1097,560,537
050,18,059,"Indiana","Hancock County",5,47,1019,494,525
050,18,059,"Indiana","Hancock County",5,48,1068,542,526
050,18,059,"Indiana","Hancock County",5,49,1031,509,522
050,18,059,"Indiana","Hancock County",5,50,1071,530,541
050,18,059,"Indiana","Hancock County",5,51,1117,555,562
050,18,059,"Indiana","Hancock County",5,52,1206,607,599
050,18,059,"Indiana","Hancock County",5,53,1156,582,574
050,18,059,"Indiana","Hancock County",5,54,1100,562,538
050,18,059,"Indiana","Hancock County",5,55,1073,528,545
050,18,059,"Indiana","Hancock County",5,56,1097,531,566
050,18,059,"Indiana","Hancock County",5,57,1115,555,560
050,18,059,"Indiana","Hancock County",5,58,1159,557,602
050,18,059,"Indiana","Hancock County",5,59,1194,594,600
050,18,059,"Indiana","Hancock County",5,60,1207,584,623
050,18,059,"Indiana","Hancock County",5,61,1186,573,613
050,18,059,"Indiana","Hancock County",5,62,1146,567,579
050,18,059,"Indiana","Hancock County",5,63,1113,541,572
050,18,059,"Indiana","Hancock County",5,64,1056,506,550
050,18,059,"Indiana","Hancock County",5,65,1049,524,525
050,18,059,"Indiana","Hancock County",5,66,1008,490,518
050,18,059,"Indiana","Hancock County",5,67,974,487,487
050,18,059,"Indiana","Hancock County",5,68,917,451,466
050,18,059,"Indiana","Hancock County",5,69,881,426,455
050,18,059,"Indiana","Hancock County",5,70,836,389,447
050,18,059,"Indiana","Hancock County",5,71,810,381,429
050,18,059,"Indiana","Hancock County",5,72,710,310,400
050,18,059,"Indiana","Hancock County",5,73,726,314,412
050,18,059,"Indiana","Hancock County",5,74,775,336,439
050,18,059,"Indiana","Hancock County",5,75,740,348,392
050,18,059,"Indiana","Hancock County",5,76,788,364,424
050,18,059,"Indiana","Hancock County",5,77,517,221,296
050,18,059,"Indiana","Hancock County",5,78,481,208,273
050,18,059,"Indiana","Hancock County",5,79,446,203,243
050,18,059,"Indiana","Hancock County",5,80,470,225,245
050,18,059,"Indiana","Hancock County",5,81,376,170,206
050,18,059,"Indiana","Hancock County",5,82,366,157,209
050,18,059,"Indiana","Hancock County",5,83,338,143,195
050,18,059,"Indiana","Hancock County",5,84,271,100,171
050,18,059,"Indiana","Hancock County",5,85,1467,572,895
050,18,061,"Indiana","Harrison County",1,0,395,203,192
050,18,061,"Indiana","Harrison County",1,1,402,212,190
050,18,061,"Indiana","Harrison County",1,2,449,239,210
050,18,061,"Indiana","Harrison County",1,3,450,245,205
050,18,061,"Indiana","Harrison County",1,4,472,253,219
050,18,061,"Indiana","Harrison County",1,5,515,272,243
050,18,061,"Indiana","Harrison County",1,6,472,256,216
050,18,061,"Indiana","Harrison County",1,7,490,268,222
050,18,061,"Indiana","Harrison County",1,8,511,260,251
050,18,061,"Indiana","Harrison County",1,9,472,244,228
050,18,061,"Indiana","Harrison County",1,10,485,250,235
050,18,061,"Indiana","Harrison County",1,11,498,266,232
050,18,061,"Indiana","Harrison County",1,12,545,268,277
050,18,061,"Indiana","Harrison County",1,13,558,289,269
050,18,061,"Indiana","Harrison County",1,14,557,287,270
050,18,061,"Indiana","Harrison County",1,15,538,272,266
050,18,061,"Indiana","Harrison County",1,16,564,284,280
050,18,061,"Indiana","Harrison County",1,17,539,260,279
050,18,061,"Indiana","Harrison County",1,18,445,227,218
050,18,061,"Indiana","Harrison County",1,19,348,188,160
050,18,061,"Indiana","Harrison County",1,20,366,196,170
050,18,061,"Indiana","Harrison County",1,21,411,218,193
050,18,061,"Indiana","Harrison County",1,22,390,197,193
050,18,061,"Indiana","Harrison County",1,23,379,197,182
050,18,061,"Indiana","Harrison County",1,24,410,218,192
050,18,061,"Indiana","Harrison County",1,25,411,216,195
050,18,061,"Indiana","Harrison County",1,26,427,215,212
050,18,061,"Indiana","Harrison County",1,27,431,227,204
050,18,061,"Indiana","Harrison County",1,28,455,225,230
050,18,061,"Indiana","Harrison County",1,29,449,217,232
050,18,061,"Indiana","Harrison County",1,30,475,227,248
050,18,061,"Indiana","Harrison County",1,31,465,248,217
050,18,061,"Indiana","Harrison County",1,32,446,225,221
050,18,061,"Indiana","Harrison County",1,33,446,217,229
050,18,061,"Indiana","Harrison County",1,34,459,228,231
050,18,061,"Indiana","Harrison County",1,35,493,248,245
050,18,061,"Indiana","Harrison County",1,36,494,243,251
050,18,061,"Indiana","Harrison County",1,37,536,270,266
050,18,061,"Indiana","Harrison County",1,38,535,268,267
050,18,061,"Indiana","Harrison County",1,39,562,295,267
050,18,061,"Indiana","Harrison County",1,40,506,257,249
050,18,061,"Indiana","Harrison County",1,41,522,256,266
050,18,061,"Indiana","Harrison County",1,42,519,279,240
050,18,061,"Indiana","Harrison County",1,43,489,259,230
050,18,061,"Indiana","Harrison County",1,44,462,228,234
050,18,061,"Indiana","Harrison County",1,45,465,222,243
050,18,061,"Indiana","Harrison County",1,46,463,231,232
050,18,061,"Indiana","Harrison County",1,47,479,245,234
050,18,061,"Indiana","Harrison County",1,48,533,259,274
050,18,061,"Indiana","Harrison County",1,49,578,297,281
050,18,061,"Indiana","Harrison County",1,50,512,260,252
050,18,061,"Indiana","Harrison County",1,51,508,267,241
050,18,061,"Indiana","Harrison County",1,52,508,269,239
050,18,061,"Indiana","Harrison County",1,53,541,280,261
050,18,061,"Indiana","Harrison County",1,54,530,261,269
050,18,061,"Indiana","Harrison County",1,55,611,305,306
050,18,061,"Indiana","Harrison County",1,56,650,323,327
050,18,061,"Indiana","Harrison County",1,57,640,314,326
050,18,061,"Indiana","Harrison County",1,58,638,326,312
050,18,061,"Indiana","Harrison County",1,59,607,318,289
050,18,061,"Indiana","Harrison County",1,60,590,292,298
050,18,061,"Indiana","Harrison County",1,61,574,272,302
050,18,061,"Indiana","Harrison County",1,62,587,289,298
050,18,061,"Indiana","Harrison County",1,63,579,286,293
050,18,061,"Indiana","Harrison County",1,64,549,265,284
050,18,061,"Indiana","Harrison County",1,65,532,280,252
050,18,061,"Indiana","Harrison County",1,66,499,229,270
050,18,061,"Indiana","Harrison County",1,67,483,228,255
050,18,061,"Indiana","Harrison County",1,68,497,245,252
050,18,061,"Indiana","Harrison County",1,69,464,225,239
050,18,061,"Indiana","Harrison County",1,70,437,218,219
050,18,061,"Indiana","Harrison County",1,71,430,203,227
050,18,061,"Indiana","Harrison County",1,72,413,204,209
050,18,061,"Indiana","Harrison County",1,73,420,208,212
050,18,061,"Indiana","Harrison County",1,74,272,130,142
050,18,061,"Indiana","Harrison County",1,75,298,136,162
050,18,061,"Indiana","Harrison County",1,76,292,142,150
050,18,061,"Indiana","Harrison County",1,77,294,140,154
050,18,061,"Indiana","Harrison County",1,78,245,112,133
050,18,061,"Indiana","Harrison County",1,79,195,91,104
050,18,061,"Indiana","Harrison County",1,80,187,87,100
050,18,061,"Indiana","Harrison County",1,81,182,85,97
050,18,061,"Indiana","Harrison County",1,82,150,62,88
050,18,061,"Indiana","Harrison County",1,83,133,55,78
050,18,061,"Indiana","Harrison County",1,84,121,50,71
050,18,061,"Indiana","Harrison County",1,85,727,242,485
050,18,061,"Indiana","Harrison County",2,0,388,214,174
050,18,061,"Indiana","Harrison County",2,1,395,207,188
050,18,061,"Indiana","Harrison County",2,2,436,231,205
050,18,061,"Indiana","Harrison County",2,3,447,241,206
050,18,061,"Indiana","Harrison County",2,4,472,254,218
050,18,061,"Indiana","Harrison County",2,5,504,267,237
050,18,061,"Indiana","Harrison County",2,6,480,259,221
050,18,061,"Indiana","Harrison County",2,7,489,266,223
050,18,061,"Indiana","Harrison County",2,8,506,261,245
050,18,061,"Indiana","Harrison County",2,9,484,247,237
050,18,061,"Indiana","Harrison County",2,10,482,246,236
050,18,061,"Indiana","Harrison County",2,11,494,261,233
050,18,061,"Indiana","Harrison County",2,12,538,269,269
050,18,061,"Indiana","Harrison County",2,13,556,285,271
050,18,061,"Indiana","Harrison County",2,14,559,288,271
050,18,061,"Indiana","Harrison County",2,15,545,278,267
050,18,061,"Indiana","Harrison County",2,16,561,282,279
050,18,061,"Indiana","Harrison County",2,17,548,268,280
050,18,061,"Indiana","Harrison County",2,18,445,225,220
050,18,061,"Indiana","Harrison County",2,19,352,188,164
050,18,061,"Indiana","Harrison County",2,20,370,198,172
050,18,061,"Indiana","Harrison County",2,21,406,217,189
050,18,061,"Indiana","Harrison County",2,22,397,201,196
050,18,061,"Indiana","Harrison County",2,23,388,202,186
050,18,061,"Indiana","Harrison County",2,24,406,215,191
050,18,061,"Indiana","Harrison County",2,25,416,219,197
050,18,061,"Indiana","Harrison County",2,26,428,218,210
050,18,061,"Indiana","Harrison County",2,27,431,226,205
050,18,061,"Indiana","Harrison County",2,28,444,222,222
050,18,061,"Indiana","Harrison County",2,29,451,219,232
050,18,061,"Indiana","Harrison County",2,30,475,227,248
050,18,061,"Indiana","Harrison County",2,31,468,244,224
050,18,061,"Indiana","Harrison County",2,32,446,229,217
050,18,061,"Indiana","Harrison County",2,33,446,219,227
050,18,061,"Indiana","Harrison County",2,34,456,227,229
050,18,061,"Indiana","Harrison County",2,35,491,245,246
050,18,061,"Indiana","Harrison County",2,36,492,242,250
050,18,061,"Indiana","Harrison County",2,37,529,264,265
050,18,061,"Indiana","Harrison County",2,38,535,268,267
050,18,061,"Indiana","Harrison County",2,39,553,287,266
050,18,061,"Indiana","Harrison County",2,40,524,270,254
050,18,061,"Indiana","Harrison County",2,41,517,256,261
050,18,061,"Indiana","Harrison County",2,42,520,272,248
050,18,061,"Indiana","Harrison County",2,43,501,265,236
050,18,061,"Indiana","Harrison County",2,44,466,234,232
050,18,061,"Indiana","Harrison County",2,45,469,225,244
050,18,061,"Indiana","Harrison County",2,46,462,227,235
050,18,061,"Indiana","Harrison County",2,47,474,240,234
050,18,061,"Indiana","Harrison County",2,48,521,257,264
050,18,061,"Indiana","Harrison County",2,49,571,290,281
050,18,061,"Indiana","Harrison County",2,50,529,269,260
050,18,061,"Indiana","Harrison County",2,51,508,263,245
050,18,061,"Indiana","Harrison County",2,52,506,267,239
050,18,061,"Indiana","Harrison County",2,53,534,278,256
050,18,061,"Indiana","Harrison County",2,54,529,264,265
050,18,061,"Indiana","Harrison County",2,55,590,294,296
050,18,061,"Indiana","Harrison County",2,56,643,319,324
050,18,061,"Indiana","Harrison County",2,57,642,318,324
050,18,061,"Indiana","Harrison County",2,58,636,322,314
050,18,061,"Indiana","Harrison County",2,59,615,319,296
050,18,061,"Indiana","Harrison County",2,60,589,295,294
050,18,061,"Indiana","Harrison County",2,61,577,277,300
050,18,061,"Indiana","Harrison County",2,62,578,280,298
050,18,061,"Indiana","Harrison County",2,63,585,288,297
050,18,061,"Indiana","Harrison County",2,64,551,266,285
050,18,061,"Indiana","Harrison County",2,65,536,274,262
050,18,061,"Indiana","Harrison County",2,66,509,241,268
050,18,061,"Indiana","Harrison County",2,67,480,227,253
050,18,061,"Indiana","Harrison County",2,68,490,238,252
050,18,061,"Indiana","Harrison County",2,69,473,230,243
050,18,061,"Indiana","Harrison County",2,70,440,219,221
050,18,061,"Indiana","Harrison County",2,71,431,204,227
050,18,061,"Indiana","Harrison County",2,72,408,200,208
050,18,061,"Indiana","Harrison County",2,73,441,218,223
050,18,061,"Indiana","Harrison County",2,74,285,137,148
050,18,061,"Indiana","Harrison County",2,75,293,135,158
050,18,061,"Indiana","Harrison County",2,76,287,137,150
050,18,061,"Indiana","Harrison County",2,77,302,144,158
050,18,061,"Indiana","Harrison County",2,78,250,117,133
050,18,061,"Indiana","Harrison County",2,79,205,94,111
050,18,061,"Indiana","Harrison County",2,80,188,87,101
050,18,061,"Indiana","Harrison County",2,81,176,83,93
050,18,061,"Indiana","Harrison County",2,82,153,66,87
050,18,061,"Indiana","Harrison County",2,83,135,54,81
050,18,061,"Indiana","Harrison County",2,84,124,52,72
050,18,061,"Indiana","Harrison County",2,85,724,241,483
050,18,061,"Indiana","Harrison County",3,0,390,198,192
050,18,061,"Indiana","Harrison County",3,1,421,234,187
050,18,061,"Indiana","Harrison County",3,2,408,221,187
050,18,061,"Indiana","Harrison County",3,3,459,250,209
050,18,061,"Indiana","Harrison County",3,4,446,239,207
050,18,061,"Indiana","Harrison County",3,5,474,258,216
050,18,061,"Indiana","Harrison County",3,6,520,280,240
050,18,061,"Indiana","Harrison County",3,7,483,255,228
050,18,061,"Indiana","Harrison County",3,8,499,275,224
050,18,061,"Indiana","Harrison County",3,9,523,270,253
050,18,061,"Indiana","Harrison County",3,10,488,242,246
050,18,061,"Indiana","Harrison County",3,11,482,254,228
050,18,061,"Indiana","Harrison County",3,12,505,267,238
050,18,061,"Indiana","Harrison County",3,13,531,263,268
050,18,061,"Indiana","Harrison County",3,14,557,285,272
050,18,061,"Indiana","Harrison County",3,15,551,279,272
050,18,061,"Indiana","Harrison County",3,16,529,274,255
050,18,061,"Indiana","Harrison County",3,17,548,265,283
050,18,061,"Indiana","Harrison County",3,18,453,233,220
050,18,061,"Indiana","Harrison County",3,19,339,170,169
050,18,061,"Indiana","Harrison County",3,20,387,196,191
050,18,061,"Indiana","Harrison County",3,21,399,216,183
050,18,061,"Indiana","Harrison County",3,22,412,211,201
050,18,061,"Indiana","Harrison County",3,23,404,206,198
050,18,061,"Indiana","Harrison County",3,24,402,213,189
050,18,061,"Indiana","Harrison County",3,25,400,211,189
050,18,061,"Indiana","Harrison County",3,26,431,222,209
050,18,061,"Indiana","Harrison County",3,27,439,233,206
050,18,061,"Indiana","Harrison County",3,28,424,224,200
050,18,061,"Indiana","Harrison County",3,29,447,225,222
050,18,061,"Indiana","Harrison County",3,30,482,233,249
050,18,061,"Indiana","Harrison County",3,31,476,237,239
050,18,061,"Indiana","Harrison County",3,32,487,253,234
050,18,061,"Indiana","Harrison County",3,33,453,223,230
050,18,061,"Indiana","Harrison County",3,34,464,229,235
050,18,061,"Indiana","Harrison County",3,35,476,243,233
050,18,061,"Indiana","Harrison County",3,36,500,249,251
050,18,061,"Indiana","Harrison County",3,37,498,246,252
050,18,061,"Indiana","Harrison County",3,38,527,260,267
050,18,061,"Indiana","Harrison County",3,39,528,265,263
050,18,061,"Indiana","Harrison County",3,40,571,301,270
050,18,061,"Indiana","Harrison County",3,41,528,272,256
050,18,061,"Indiana","Harrison County",3,42,526,265,261
050,18,061,"Indiana","Harrison County",3,43,515,272,243
050,18,061,"Indiana","Harrison County",3,44,497,259,238
050,18,061,"Indiana","Harrison County",3,45,481,245,236
050,18,061,"Indiana","Harrison County",3,46,470,233,237
050,18,061,"Indiana","Harrison County",3,47,470,227,243
050,18,061,"Indiana","Harrison County",3,48,462,230,232
050,18,061,"Indiana","Harrison County",3,49,528,264,264
050,18,061,"Indiana","Harrison County",3,50,576,290,286
050,18,061,"Indiana","Harrison County",3,51,519,263,256
050,18,061,"Indiana","Harrison County",3,52,510,264,246
050,18,061,"Indiana","Harrison County",3,53,493,263,230
050,18,061,"Indiana","Harrison County",3,54,538,276,262
050,18,061,"Indiana","Harrison County",3,55,524,261,263
050,18,061,"Indiana","Harrison County",3,56,583,294,289
050,18,061,"Indiana","Harrison County",3,57,636,320,316
050,18,061,"Indiana","Harrison County",3,58,639,319,320
050,18,061,"Indiana","Harrison County",3,59,632,321,311
050,18,061,"Indiana","Harrison County",3,60,609,311,298
050,18,061,"Indiana","Harrison County",3,61,588,298,290
050,18,061,"Indiana","Harrison County",3,62,570,273,297
050,18,061,"Indiana","Harrison County",3,63,578,284,294
050,18,061,"Indiana","Harrison County",3,64,588,297,291
050,18,061,"Indiana","Harrison County",3,65,546,271,275
050,18,061,"Indiana","Harrison County",3,66,548,274,274
050,18,061,"Indiana","Harrison County",3,67,492,233,259
050,18,061,"Indiana","Harrison County",3,68,471,221,250
050,18,061,"Indiana","Harrison County",3,69,482,234,248
050,18,061,"Indiana","Harrison County",3,70,449,222,227
050,18,061,"Indiana","Harrison County",3,71,433,213,220
050,18,061,"Indiana","Harrison County",3,72,417,196,221
050,18,061,"Indiana","Harrison County",3,73,389,191,198
050,18,061,"Indiana","Harrison County",3,74,426,212,214
050,18,061,"Indiana","Harrison County",3,75,275,127,148
050,18,061,"Indiana","Harrison County",3,76,281,128,153
050,18,061,"Indiana","Harrison County",3,77,274,131,143
050,18,061,"Indiana","Harrison County",3,78,283,134,149
050,18,061,"Indiana","Harrison County",3,79,240,111,129
050,18,061,"Indiana","Harrison County",3,80,198,87,111
050,18,061,"Indiana","Harrison County",3,81,171,83,88
050,18,061,"Indiana","Harrison County",3,82,159,78,81
050,18,061,"Indiana","Harrison County",3,83,148,57,91
050,18,061,"Indiana","Harrison County",3,84,132,56,76
050,18,061,"Indiana","Harrison County",3,85,718,244,474
050,18,061,"Indiana","Harrison County",4,0,403,212,191
050,18,061,"Indiana","Harrison County",4,1,394,194,200
050,18,061,"Indiana","Harrison County",4,2,426,232,194
050,18,061,"Indiana","Harrison County",4,3,432,233,199
050,18,061,"Indiana","Harrison County",4,4,469,260,209
050,18,061,"Indiana","Harrison County",4,5,453,245,208
050,18,061,"Indiana","Harrison County",4,6,483,262,221
050,18,061,"Indiana","Harrison County",4,7,533,284,249
050,18,061,"Indiana","Harrison County",4,8,487,250,237
050,18,061,"Indiana","Harrison County",4,9,503,275,228
050,18,061,"Indiana","Harrison County",4,10,521,266,255
050,18,061,"Indiana","Harrison County",4,11,496,241,255
050,18,061,"Indiana","Harrison County",4,12,493,261,232
050,18,061,"Indiana","Harrison County",4,13,508,263,245
050,18,061,"Indiana","Harrison County",4,14,550,281,269
050,18,061,"Indiana","Harrison County",4,15,566,290,276
050,18,061,"Indiana","Harrison County",4,16,558,288,270
050,18,061,"Indiana","Harrison County",4,17,518,258,260
050,18,061,"Indiana","Harrison County",4,18,455,232,223
050,18,061,"Indiana","Harrison County",4,19,338,178,160
050,18,061,"Indiana","Harrison County",4,20,347,172,175
050,18,061,"Indiana","Harrison County",4,21,380,203,177
050,18,061,"Indiana","Harrison County",4,22,417,222,195
050,18,061,"Indiana","Harrison County",4,23,403,211,192
050,18,061,"Indiana","Harrison County",4,24,410,220,190
050,18,061,"Indiana","Harrison County",4,25,394,208,186
050,18,061,"Indiana","Harrison County",4,26,417,201,216
050,18,061,"Indiana","Harrison County",4,27,421,217,204
050,18,061,"Indiana","Harrison County",4,28,445,229,216
050,18,061,"Indiana","Harrison County",4,29,434,230,204
050,18,061,"Indiana","Harrison County",4,30,466,223,243
050,18,061,"Indiana","Harrison County",4,31,479,227,252
050,18,061,"Indiana","Harrison County",4,32,476,235,241
050,18,061,"Indiana","Harrison County",4,33,514,270,244
050,18,061,"Indiana","Harrison County",4,34,456,224,232
050,18,061,"Indiana","Harrison County",4,35,484,243,241
050,18,061,"Indiana","Harrison County",4,36,487,248,239
050,18,061,"Indiana","Harrison County",4,37,495,252,243
050,18,061,"Indiana","Harrison County",4,38,497,254,243
050,18,061,"Indiana","Harrison County",4,39,543,271,272
050,18,061,"Indiana","Harrison County",4,40,523,263,260
050,18,061,"Indiana","Harrison County",4,41,587,309,278
050,18,061,"Indiana","Harrison County",4,42,550,291,259
050,18,061,"Indiana","Harrison County",4,43,517,259,258
050,18,061,"Indiana","Harrison County",4,44,519,275,244
050,18,061,"Indiana","Harrison County",4,45,496,263,233
050,18,061,"Indiana","Harrison County",4,46,476,236,240
050,18,061,"Indiana","Harrison County",4,47,470,232,238
050,18,061,"Indiana","Harrison County",4,48,462,223,239
050,18,061,"Indiana","Harrison County",4,49,458,229,229
050,18,061,"Indiana","Harrison County",4,50,525,263,262
050,18,061,"Indiana","Harrison County",4,51,568,287,281
050,18,061,"Indiana","Harrison County",4,52,519,267,252
050,18,061,"Indiana","Harrison County",4,53,495,257,238
050,18,061,"Indiana","Harrison County",4,54,476,256,220
050,18,061,"Indiana","Harrison County",4,55,532,280,252
050,18,061,"Indiana","Harrison County",4,56,526,257,269
050,18,061,"Indiana","Harrison County",4,57,582,293,289
050,18,061,"Indiana","Harrison County",4,58,634,315,319
050,18,061,"Indiana","Harrison County",4,59,635,313,322
050,18,061,"Indiana","Harrison County",4,60,629,314,315
050,18,061,"Indiana","Harrison County",4,61,609,312,297
050,18,061,"Indiana","Harrison County",4,62,583,292,291
050,18,061,"Indiana","Harrison County",4,63,565,268,297
050,18,061,"Indiana","Harrison County",4,64,570,284,286
050,18,061,"Indiana","Harrison County",4,65,583,300,283
050,18,061,"Indiana","Harrison County",4,66,536,258,278
050,18,061,"Indiana","Harrison County",4,67,529,260,269
050,18,061,"Indiana","Harrison County",4,68,485,229,256
050,18,061,"Indiana","Harrison County",4,69,463,210,253
050,18,061,"Indiana","Harrison County",4,70,460,225,235
050,18,061,"Indiana","Harrison County",4,71,430,210,220
050,18,061,"Indiana","Harrison County",4,72,418,207,211
050,18,061,"Indiana","Harrison County",4,73,407,186,221
050,18,061,"Indiana","Harrison County",4,74,369,181,188
050,18,061,"Indiana","Harrison County",4,75,419,205,214
050,18,061,"Indiana","Harrison County",4,76,255,117,138
050,18,061,"Indiana","Harrison County",4,77,271,119,152
050,18,061,"Indiana","Harrison County",4,78,266,128,138
050,18,061,"Indiana","Harrison County",4,79,271,126,145
050,18,061,"Indiana","Harrison County",4,80,234,106,128
050,18,061,"Indiana","Harrison County",4,81,176,82,94
050,18,061,"Indiana","Harrison County",4,82,151,78,73
050,18,061,"Indiana","Harrison County",4,83,150,71,79
050,18,061,"Indiana","Harrison County",4,84,142,60,82
050,18,061,"Indiana","Harrison County",4,85,718,246,472
050,18,061,"Indiana","Harrison County",5,0,375,199,176
050,18,061,"Indiana","Harrison County",5,1,420,222,198
050,18,061,"Indiana","Harrison County",5,2,399,202,197
050,18,061,"Indiana","Harrison County",5,3,439,235,204
050,18,061,"Indiana","Harrison County",5,4,434,228,206
050,18,061,"Indiana","Harrison County",5,5,486,262,224
050,18,061,"Indiana","Harrison County",5,6,452,247,205
050,18,061,"Indiana","Harrison County",5,7,507,269,238
050,18,061,"Indiana","Harrison County",5,8,546,295,251
050,18,061,"Indiana","Harrison County",5,9,505,250,255
050,18,061,"Indiana","Harrison County",5,10,501,264,237
050,18,061,"Indiana","Harrison County",5,11,540,280,260
050,18,061,"Indiana","Harrison County",5,12,516,261,255
050,18,061,"Indiana","Harrison County",5,13,494,264,230
050,18,061,"Indiana","Harrison County",5,14,506,267,239
050,18,061,"Indiana","Harrison County",5,15,550,274,276
050,18,061,"Indiana","Harrison County",5,16,563,300,263
050,18,061,"Indiana","Harrison County",5,17,560,291,269
050,18,061,"Indiana","Harrison County",5,18,439,230,209
050,18,061,"Indiana","Harrison County",5,19,340,174,166
050,18,061,"Indiana","Harrison County",5,20,371,188,183
050,18,061,"Indiana","Harrison County",5,21,378,189,189
050,18,061,"Indiana","Harrison County",5,22,397,205,192
050,18,061,"Indiana","Harrison County",5,23,447,235,212
050,18,061,"Indiana","Harrison County",5,24,427,219,208
050,18,061,"Indiana","Harrison County",5,25,415,214,201
050,18,061,"Indiana","Harrison County",5,26,386,185,201
050,18,061,"Indiana","Harrison County",5,27,429,220,209
050,18,061,"Indiana","Harrison County",5,28,419,219,200
050,18,061,"Indiana","Harrison County",5,29,452,231,221
050,18,061,"Indiana","Harrison County",5,30,442,229,213
050,18,061,"Indiana","Harrison County",5,31,468,219,249
050,18,061,"Indiana","Harrison County",5,32,486,229,257
050,18,061,"Indiana","Harrison County",5,33,480,230,250
050,18,061,"Indiana","Harrison County",5,34,515,270,245
050,18,061,"Indiana","Harrison County",5,35,468,229,239
050,18,061,"Indiana","Harrison County",5,36,480,228,252
050,18,061,"Indiana","Harrison County",5,37,491,254,237
050,18,061,"Indiana","Harrison County",5,38,519,269,250
050,18,061,"Indiana","Harrison County",5,39,482,240,242
050,18,061,"Indiana","Harrison County",5,40,543,272,271
050,18,061,"Indiana","Harrison County",5,41,531,271,260
050,18,061,"Indiana","Harrison County",5,42,599,317,282
050,18,061,"Indiana","Harrison County",5,43,543,284,259
050,18,061,"Indiana","Harrison County",5,44,520,259,261
050,18,061,"Indiana","Harrison County",5,45,535,284,251
050,18,061,"Indiana","Harrison County",5,46,501,263,238
050,18,061,"Indiana","Harrison County",5,47,482,243,239
050,18,061,"Indiana","Harrison County",5,48,457,223,234
050,18,061,"Indiana","Harrison County",5,49,466,223,243
050,18,061,"Indiana","Harrison County",5,50,466,236,230
050,18,061,"Indiana","Harrison County",5,51,534,267,267
050,18,061,"Indiana","Harrison County",5,52,562,287,275
050,18,061,"Indiana","Harrison County",5,53,510,269,241
050,18,061,"Indiana","Harrison County",5,54,498,253,245
050,18,061,"Indiana","Harrison County",5,55,480,258,222
050,18,061,"Indiana","Harrison County",5,56,524,278,246
050,18,061,"Indiana","Harrison County",5,57,525,251,274
050,18,061,"Indiana","Harrison County",5,58,582,285,297
050,18,061,"Indiana","Harrison County",5,59,634,313,321
050,18,061,"Indiana","Harrison County",5,60,626,308,318
050,18,061,"Indiana","Harrison County",5,61,635,320,315
050,18,061,"Indiana","Harrison County",5,62,600,302,298
050,18,061,"Indiana","Harrison County",5,63,582,287,295
050,18,061,"Indiana","Harrison County",5,64,553,267,286
050,18,061,"Indiana","Harrison County",5,65,571,292,279
050,18,061,"Indiana","Harrison County",5,66,577,295,282
050,18,061,"Indiana","Harrison County",5,67,531,253,278
050,18,061,"Indiana","Harrison County",5,68,520,253,267
050,18,061,"Indiana","Harrison County",5,69,475,218,257
050,18,061,"Indiana","Harrison County",5,70,444,200,244
050,18,061,"Indiana","Harrison County",5,71,454,219,235
050,18,061,"Indiana","Harrison County",5,72,420,204,216
050,18,061,"Indiana","Harrison County",5,73,417,202,215
050,18,061,"Indiana","Harrison County",5,74,395,181,214
050,18,061,"Indiana","Harrison County",5,75,358,171,187
050,18,061,"Indiana","Harrison County",5,76,397,195,202
050,18,061,"Indiana","Harrison County",5,77,247,112,135
050,18,061,"Indiana","Harrison County",5,78,259,117,142
050,18,061,"Indiana","Harrison County",5,79,256,119,137
050,18,061,"Indiana","Harrison County",5,80,263,122,141
050,18,061,"Indiana","Harrison County",5,81,214,99,115
050,18,061,"Indiana","Harrison County",5,82,162,76,86
050,18,061,"Indiana","Harrison County",5,83,143,67,76
050,18,061,"Indiana","Harrison County",5,84,145,73,72
050,18,061,"Indiana","Harrison County",5,85,746,262,484
050,18,063,"Indiana","Hendricks County",1,0,1630,840,790
050,18,063,"Indiana","Hendricks County",1,1,1765,915,850
050,18,063,"Indiana","Hendricks County",1,2,1940,987,953
050,18,063,"Indiana","Hendricks County",1,3,2104,1024,1080
050,18,063,"Indiana","Hendricks County",1,4,2273,1132,1141
050,18,063,"Indiana","Hendricks County",1,5,2249,1175,1074
050,18,063,"Indiana","Hendricks County",1,6,2346,1217,1129
050,18,063,"Indiana","Hendricks County",1,7,2363,1249,1114
050,18,063,"Indiana","Hendricks County",1,8,2451,1279,1172
050,18,063,"Indiana","Hendricks County",1,9,2547,1273,1274
050,18,063,"Indiana","Hendricks County",1,10,2583,1282,1301
050,18,063,"Indiana","Hendricks County",1,11,2756,1424,1332
050,18,063,"Indiana","Hendricks County",1,12,2790,1461,1329
050,18,063,"Indiana","Hendricks County",1,13,2750,1435,1315
050,18,063,"Indiana","Hendricks County",1,14,2748,1464,1284
050,18,063,"Indiana","Hendricks County",1,15,2720,1424,1296
050,18,063,"Indiana","Hendricks County",1,16,2746,1410,1336
050,18,063,"Indiana","Hendricks County",1,17,2625,1355,1270
050,18,063,"Indiana","Hendricks County",1,18,2274,1211,1063
050,18,063,"Indiana","Hendricks County",1,19,1823,991,832
050,18,063,"Indiana","Hendricks County",1,20,1888,1013,875
050,18,063,"Indiana","Hendricks County",1,21,1900,998,902
050,18,063,"Indiana","Hendricks County",1,22,1988,1029,959
050,18,063,"Indiana","Hendricks County",1,23,2026,1055,971
050,18,063,"Indiana","Hendricks County",1,24,2049,1090,959
050,18,063,"Indiana","Hendricks County",1,25,1956,1019,937
050,18,063,"Indiana","Hendricks County",1,26,2018,1071,947
050,18,063,"Indiana","Hendricks County",1,27,2092,1095,997
050,18,063,"Indiana","Hendricks County",1,28,2084,1075,1009
050,18,063,"Indiana","Hendricks County",1,29,2141,1076,1065
050,18,063,"Indiana","Hendricks County",1,30,2203,1124,1079
050,18,063,"Indiana","Hendricks County",1,31,2254,1162,1092
050,18,063,"Indiana","Hendricks County",1,32,2253,1098,1155
050,18,063,"Indiana","Hendricks County",1,33,2263,1147,1116
050,18,063,"Indiana","Hendricks County",1,34,2448,1263,1185
050,18,063,"Indiana","Hendricks County",1,35,2443,1217,1226
050,18,063,"Indiana","Hendricks County",1,36,2508,1268,1240
050,18,063,"Indiana","Hendricks County",1,37,2621,1282,1339
050,18,063,"Indiana","Hendricks County",1,38,2632,1324,1308
050,18,063,"Indiana","Hendricks County",1,39,2578,1318,1260
050,18,063,"Indiana","Hendricks County",1,40,2658,1359,1299
050,18,063,"Indiana","Hendricks County",1,41,2621,1303,1318
050,18,063,"Indiana","Hendricks County",1,42,2555,1282,1273
050,18,063,"Indiana","Hendricks County",1,43,2397,1205,1192
050,18,063,"Indiana","Hendricks County",1,44,2394,1214,1180
050,18,063,"Indiana","Hendricks County",1,45,2367,1205,1162
050,18,063,"Indiana","Hendricks County",1,46,2311,1182,1129
050,18,063,"Indiana","Hendricks County",1,47,2419,1272,1147
050,18,063,"Indiana","Hendricks County",1,48,2509,1281,1228
050,18,063,"Indiana","Hendricks County",1,49,2641,1378,1263
050,18,063,"Indiana","Hendricks County",1,50,2385,1225,1160
050,18,063,"Indiana","Hendricks County",1,51,2261,1157,1104
050,18,063,"Indiana","Hendricks County",1,52,2172,1093,1079
050,18,063,"Indiana","Hendricks County",1,53,2215,1115,1100
050,18,063,"Indiana","Hendricks County",1,54,2175,1077,1098
050,18,063,"Indiana","Hendricks County",1,55,2286,1113,1173
050,18,063,"Indiana","Hendricks County",1,56,2376,1179,1197
050,18,063,"Indiana","Hendricks County",1,57,2291,1140,1151
050,18,063,"Indiana","Hendricks County",1,58,2301,1138,1163
050,18,063,"Indiana","Hendricks County",1,59,2270,1147,1123
050,18,063,"Indiana","Hendricks County",1,60,2181,1089,1092
050,18,063,"Indiana","Hendricks County",1,61,2139,1078,1061
050,18,063,"Indiana","Hendricks County",1,62,2064,975,1089
050,18,063,"Indiana","Hendricks County",1,63,1978,937,1041
050,18,063,"Indiana","Hendricks County",1,64,1931,931,1000
050,18,063,"Indiana","Hendricks County",1,65,1936,936,1000
050,18,063,"Indiana","Hendricks County",1,66,1804,867,937
050,18,063,"Indiana","Hendricks County",1,67,1702,799,903
050,18,063,"Indiana","Hendricks County",1,68,1682,797,885
050,18,063,"Indiana","Hendricks County",1,69,1586,736,850
050,18,063,"Indiana","Hendricks County",1,70,1516,700,816
050,18,063,"Indiana","Hendricks County",1,71,1439,664,775
050,18,063,"Indiana","Hendricks County",1,72,1448,663,785
050,18,063,"Indiana","Hendricks County",1,73,1405,668,737
050,18,063,"Indiana","Hendricks County",1,74,997,473,524
050,18,063,"Indiana","Hendricks County",1,75,958,428,530
050,18,063,"Indiana","Hendricks County",1,76,990,450,540
050,18,063,"Indiana","Hendricks County",1,77,934,426,508
050,18,063,"Indiana","Hendricks County",1,78,806,354,452
050,18,063,"Indiana","Hendricks County",1,79,737,323,414
050,18,063,"Indiana","Hendricks County",1,80,630,268,362
050,18,063,"Indiana","Hendricks County",1,81,602,251,351
050,18,063,"Indiana","Hendricks County",1,82,541,213,328
050,18,063,"Indiana","Hendricks County",1,83,488,198,290
050,18,063,"Indiana","Hendricks County",1,84,463,173,290
050,18,063,"Indiana","Hendricks County",1,85,2389,826,1563
050,18,063,"Indiana","Hendricks County",2,0,1677,857,820
050,18,063,"Indiana","Hendricks County",2,1,1757,911,846
050,18,063,"Indiana","Hendricks County",2,2,1922,980,942
050,18,063,"Indiana","Hendricks County",2,3,2083,1025,1058
050,18,063,"Indiana","Hendricks County",2,4,2256,1119,1137
050,18,063,"Indiana","Hendricks County",2,5,2278,1177,1101
050,18,063,"Indiana","Hendricks County",2,6,2349,1221,1128
050,18,063,"Indiana","Hendricks County",2,7,2374,1248,1126
050,18,063,"Indiana","Hendricks County",2,8,2442,1276,1166
050,18,063,"Indiana","Hendricks County",2,9,2535,1284,1251
050,18,063,"Indiana","Hendricks County",2,10,2587,1286,1301
050,18,063,"Indiana","Hendricks County",2,11,2724,1393,1331
050,18,063,"Indiana","Hendricks County",2,12,2807,1466,1341
050,18,063,"Indiana","Hendricks County",2,13,2773,1448,1325
050,18,063,"Indiana","Hendricks County",2,14,2756,1459,1297
050,18,063,"Indiana","Hendricks County",2,15,2741,1442,1299
050,18,063,"Indiana","Hendricks County",2,16,2751,1421,1330
050,18,063,"Indiana","Hendricks County",2,17,2674,1381,1293
050,18,063,"Indiana","Hendricks County",2,18,2259,1208,1051
050,18,063,"Indiana","Hendricks County",2,19,1847,1003,844
050,18,063,"Indiana","Hendricks County",2,20,1921,1033,888
050,18,063,"Indiana","Hendricks County",2,21,1925,1015,910
050,18,063,"Indiana","Hendricks County",2,22,1990,1032,958
050,18,063,"Indiana","Hendricks County",2,23,2042,1064,978
050,18,063,"Indiana","Hendricks County",2,24,2055,1090,965
050,18,063,"Indiana","Hendricks County",2,25,1997,1052,945
050,18,063,"Indiana","Hendricks County",2,26,2038,1078,960
050,18,063,"Indiana","Hendricks County",2,27,2091,1100,991
050,18,063,"Indiana","Hendricks County",2,28,2105,1087,1018
050,18,063,"Indiana","Hendricks County",2,29,2159,1091,1068
050,18,063,"Indiana","Hendricks County",2,30,2218,1124,1094
050,18,063,"Indiana","Hendricks County",2,31,2268,1166,1102
050,18,063,"Indiana","Hendricks County",2,32,2269,1125,1144
050,18,063,"Indiana","Hendricks County",2,33,2289,1150,1139
050,18,063,"Indiana","Hendricks County",2,34,2425,1246,1179
050,18,063,"Indiana","Hendricks County",2,35,2471,1235,1236
050,18,063,"Indiana","Hendricks County",2,36,2497,1258,1239
050,18,063,"Indiana","Hendricks County",2,37,2612,1282,1330
050,18,063,"Indiana","Hendricks County",2,38,2655,1327,1328
050,18,063,"Indiana","Hendricks County",2,39,2596,1320,1276
050,18,063,"Indiana","Hendricks County",2,40,2663,1362,1301
050,18,063,"Indiana","Hendricks County",2,41,2643,1325,1318
050,18,063,"Indiana","Hendricks County",2,42,2569,1285,1284
050,18,063,"Indiana","Hendricks County",2,43,2460,1242,1218
050,18,063,"Indiana","Hendricks County",2,44,2373,1203,1170
050,18,063,"Indiana","Hendricks County",2,45,2385,1211,1174
050,18,063,"Indiana","Hendricks County",2,46,2329,1193,1136
050,18,063,"Indiana","Hendricks County",2,47,2391,1249,1142
050,18,063,"Indiana","Hendricks County",2,48,2493,1279,1214
050,18,063,"Indiana","Hendricks County",2,49,2625,1369,1256
050,18,063,"Indiana","Hendricks County",2,50,2444,1257,1187
050,18,063,"Indiana","Hendricks County",2,51,2284,1171,1113
050,18,063,"Indiana","Hendricks County",2,52,2188,1109,1079
050,18,063,"Indiana","Hendricks County",2,53,2200,1108,1092
050,18,063,"Indiana","Hendricks County",2,54,2174,1081,1093
050,18,063,"Indiana","Hendricks County",2,55,2256,1104,1152
050,18,063,"Indiana","Hendricks County",2,56,2365,1170,1195
050,18,063,"Indiana","Hendricks County",2,57,2312,1149,1163
050,18,063,"Indiana","Hendricks County",2,58,2298,1136,1162
050,18,063,"Indiana","Hendricks County",2,59,2292,1149,1143
050,18,063,"Indiana","Hendricks County",2,60,2199,1102,1097
050,18,063,"Indiana","Hendricks County",2,61,2141,1074,1067
050,18,063,"Indiana","Hendricks County",2,62,2076,998,1078
050,18,063,"Indiana","Hendricks County",2,63,2019,956,1063
050,18,063,"Indiana","Hendricks County",2,64,1932,925,1007
050,18,063,"Indiana","Hendricks County",2,65,1930,932,998
050,18,063,"Indiana","Hendricks County",2,66,1839,883,956
050,18,063,"Indiana","Hendricks County",2,67,1721,810,911
050,18,063,"Indiana","Hendricks County",2,68,1675,791,884
050,18,063,"Indiana","Hendricks County",2,69,1616,754,862
050,18,063,"Indiana","Hendricks County",2,70,1528,704,824
050,18,063,"Indiana","Hendricks County",2,71,1454,673,781
050,18,063,"Indiana","Hendricks County",2,72,1419,653,766
050,18,063,"Indiana","Hendricks County",2,73,1479,698,781
050,18,063,"Indiana","Hendricks County",2,74,1024,486,538
050,18,063,"Indiana","Hendricks County",2,75,971,437,534
050,18,063,"Indiana","Hendricks County",2,76,962,433,529
050,18,063,"Indiana","Hendricks County",2,77,961,443,518
050,18,063,"Indiana","Hendricks County",2,78,825,361,464
050,18,063,"Indiana","Hendricks County",2,79,747,324,423
050,18,063,"Indiana","Hendricks County",2,80,650,279,371
050,18,063,"Indiana","Hendricks County",2,81,586,244,342
050,18,063,"Indiana","Hendricks County",2,82,553,221,332
050,18,063,"Indiana","Hendricks County",2,83,487,191,296
050,18,063,"Indiana","Hendricks County",2,84,464,176,288
050,18,063,"Indiana","Hendricks County",2,85,2379,827,1552
050,18,063,"Indiana","Hendricks County",3,0,1829,953,876
050,18,063,"Indiana","Hendricks County",3,1,1812,933,879
050,18,063,"Indiana","Hendricks County",3,2,1909,1015,894
050,18,063,"Indiana","Hendricks County",3,3,2078,1052,1026
050,18,063,"Indiana","Hendricks County",3,4,2186,1079,1107
050,18,063,"Indiana","Hendricks County",3,5,2371,1209,1162
050,18,063,"Indiana","Hendricks County",3,6,2402,1235,1167
050,18,063,"Indiana","Hendricks County",3,7,2430,1254,1176
050,18,063,"Indiana","Hendricks County",3,8,2449,1299,1150
050,18,063,"Indiana","Hendricks County",3,9,2557,1333,1224
050,18,063,"Indiana","Hendricks County",3,10,2614,1360,1254
050,18,063,"Indiana","Hendricks County",3,11,2684,1334,1350
050,18,063,"Indiana","Hendricks County",3,12,2774,1424,1350
050,18,063,"Indiana","Hendricks County",3,13,2857,1492,1365
050,18,063,"Indiana","Hendricks County",3,14,2818,1485,1333
050,18,063,"Indiana","Hendricks County",3,15,2779,1469,1310
050,18,063,"Indiana","Hendricks County",3,16,2805,1484,1321
050,18,063,"Indiana","Hendricks County",3,17,2764,1416,1348
050,18,063,"Indiana","Hendricks County",3,18,2306,1239,1067
050,18,063,"Indiana","Hendricks County",3,19,1839,1002,837
050,18,063,"Indiana","Hendricks County",3,20,1989,1066,923
050,18,063,"Indiana","Hendricks County",3,21,2041,1086,955
050,18,063,"Indiana","Hendricks County",3,22,2112,1104,1008
050,18,063,"Indiana","Hendricks County",3,23,2091,1083,1008
050,18,063,"Indiana","Hendricks County",3,24,2134,1126,1008
050,18,063,"Indiana","Hendricks County",3,25,2112,1132,980
050,18,063,"Indiana","Hendricks County",3,26,2092,1115,977
050,18,063,"Indiana","Hendricks County",3,27,2133,1115,1018
050,18,063,"Indiana","Hendricks County",3,28,2123,1140,983
050,18,063,"Indiana","Hendricks County",3,29,2247,1154,1093
050,18,063,"Indiana","Hendricks County",3,30,2276,1127,1149
050,18,063,"Indiana","Hendricks County",3,31,2365,1192,1173
050,18,063,"Indiana","Hendricks County",3,32,2406,1235,1171
050,18,063,"Indiana","Hendricks County",3,33,2323,1132,1191
050,18,063,"Indiana","Hendricks County",3,34,2425,1237,1188
050,18,063,"Indiana","Hendricks County",3,35,2493,1293,1200
050,18,063,"Indiana","Hendricks County",3,36,2569,1291,1278
050,18,063,"Indiana","Hendricks County",3,37,2589,1274,1315
050,18,063,"Indiana","Hendricks County",3,38,2708,1348,1360
050,18,063,"Indiana","Hendricks County",3,39,2764,1379,1385
050,18,063,"Indiana","Hendricks County",3,40,2712,1374,1338
050,18,063,"Indiana","Hendricks County",3,41,2749,1424,1325
050,18,063,"Indiana","Hendricks County",3,42,2696,1361,1335
050,18,063,"Indiana","Hendricks County",3,43,2616,1322,1294
050,18,063,"Indiana","Hendricks County",3,44,2496,1257,1239
050,18,063,"Indiana","Hendricks County",3,45,2405,1236,1169
050,18,063,"Indiana","Hendricks County",3,46,2436,1232,1204
050,18,063,"Indiana","Hendricks County",3,47,2348,1199,1149
050,18,063,"Indiana","Hendricks County",3,48,2430,1271,1159
050,18,063,"Indiana","Hendricks County",3,49,2546,1334,1212
050,18,063,"Indiana","Hendricks County",3,50,2612,1350,1262
050,18,063,"Indiana","Hendricks County",3,51,2465,1260,1205
050,18,063,"Indiana","Hendricks County",3,52,2314,1205,1109
050,18,063,"Indiana","Hendricks County",3,53,2185,1116,1069
050,18,063,"Indiana","Hendricks County",3,54,2211,1102,1109
050,18,063,"Indiana","Hendricks County",3,55,2169,1078,1091
050,18,063,"Indiana","Hendricks County",3,56,2247,1113,1134
050,18,063,"Indiana","Hendricks County",3,57,2336,1158,1178
050,18,063,"Indiana","Hendricks County",3,58,2293,1137,1156
050,18,063,"Indiana","Hendricks County",3,59,2305,1125,1180
050,18,063,"Indiana","Hendricks County",3,60,2272,1137,1135
050,18,063,"Indiana","Hendricks County",3,61,2188,1094,1094
050,18,063,"Indiana","Hendricks County",3,62,2128,1076,1052
050,18,063,"Indiana","Hendricks County",3,63,2072,995,1077
050,18,063,"Indiana","Hendricks County",3,64,2010,955,1055
050,18,063,"Indiana","Hendricks County",3,65,1943,935,1008
050,18,063,"Indiana","Hendricks County",3,66,1896,916,980
050,18,063,"Indiana","Hendricks County",3,67,1819,863,956
050,18,063,"Indiana","Hendricks County",3,68,1708,799,909
050,18,063,"Indiana","Hendricks County",3,69,1656,773,883
050,18,063,"Indiana","Hendricks County",3,70,1590,732,858
050,18,063,"Indiana","Hendricks County",3,71,1486,681,805
050,18,063,"Indiana","Hendricks County",3,72,1429,640,789
050,18,063,"Indiana","Hendricks County",3,73,1400,647,753
050,18,063,"Indiana","Hendricks County",3,74,1441,675,766
050,18,063,"Indiana","Hendricks County",3,75,1020,467,553
050,18,063,"Indiana","Hendricks County",3,76,939,410,529
050,18,063,"Indiana","Hendricks County",3,77,934,432,502
050,18,063,"Indiana","Hendricks County",3,78,946,424,522
050,18,063,"Indiana","Hendricks County",3,79,802,346,456
050,18,063,"Indiana","Hendricks County",3,80,712,309,403
050,18,063,"Indiana","Hendricks County",3,81,614,257,357
050,18,063,"Indiana","Hendricks County",3,82,559,230,329
050,18,063,"Indiana","Hendricks County",3,83,501,200,301
050,18,063,"Indiana","Hendricks County",3,84,455,164,291
050,18,063,"Indiana","Hendricks County",3,85,2454,859,1595
050,18,063,"Indiana","Hendricks County",4,0,1869,1011,858
050,18,063,"Indiana","Hendricks County",4,1,1930,993,937
050,18,063,"Indiana","Hendricks County",4,2,1959,1021,938
050,18,063,"Indiana","Hendricks County",4,3,2069,1054,1015
050,18,063,"Indiana","Hendricks County",4,4,2244,1124,1120
050,18,063,"Indiana","Hendricks County",4,5,2348,1159,1189
050,18,063,"Indiana","Hendricks County",4,6,2483,1262,1221
050,18,063,"Indiana","Hendricks County",4,7,2502,1283,1219
050,18,063,"Indiana","Hendricks County",4,8,2528,1323,1205
050,18,063,"Indiana","Hendricks County",4,9,2565,1365,1200
050,18,063,"Indiana","Hendricks County",4,10,2643,1389,1254
050,18,063,"Indiana","Hendricks County",4,11,2736,1446,1290
050,18,063,"Indiana","Hendricks County",4,12,2748,1379,1369
050,18,063,"Indiana","Hendricks County",4,13,2839,1459,1380
050,18,063,"Indiana","Hendricks County",4,14,2935,1561,1374
050,18,063,"Indiana","Hendricks County",4,15,2876,1511,1365
050,18,063,"Indiana","Hendricks County",4,16,2842,1498,1344
050,18,063,"Indiana","Hendricks County",4,17,2799,1485,1314
050,18,063,"Indiana","Hendricks County",4,18,2380,1259,1121
050,18,063,"Indiana","Hendricks County",4,19,1845,1021,824
050,18,063,"Indiana","Hendricks County",4,20,1942,1036,906
050,18,063,"Indiana","Hendricks County",4,21,2011,1058,953
050,18,063,"Indiana","Hendricks County",4,22,2126,1120,1006
050,18,063,"Indiana","Hendricks County",4,23,2168,1131,1037
050,18,063,"Indiana","Hendricks County",4,24,2083,1070,1013
050,18,063,"Indiana","Hendricks County",4,25,2093,1083,1010
050,18,063,"Indiana","Hendricks County",4,26,2131,1142,989
050,18,063,"Indiana","Hendricks County",4,27,2144,1156,988
050,18,063,"Indiana","Hendricks County",4,28,2153,1104,1049
050,18,063,"Indiana","Hendricks County",4,29,2186,1153,1033
050,18,063,"Indiana","Hendricks County",4,30,2287,1172,1115
050,18,063,"Indiana","Hendricks County",4,31,2410,1178,1232
050,18,063,"Indiana","Hendricks County",4,32,2423,1210,1213
050,18,063,"Indiana","Hendricks County",4,33,2520,1282,1238
050,18,063,"Indiana","Hendricks County",4,34,2436,1194,1242
050,18,063,"Indiana","Hendricks County",4,35,2467,1249,1218
050,18,063,"Indiana","Hendricks County",4,36,2571,1314,1257
050,18,063,"Indiana","Hendricks County",4,37,2670,1337,1333
050,18,063,"Indiana","Hendricks County",4,38,2717,1346,1371
050,18,063,"Indiana","Hendricks County",4,39,2797,1383,1414
050,18,063,"Indiana","Hendricks County",4,40,2803,1420,1383
050,18,063,"Indiana","Hendricks County",4,41,2750,1384,1366
050,18,063,"Indiana","Hendricks County",4,42,2820,1443,1377
050,18,063,"Indiana","Hendricks County",4,43,2765,1400,1365
050,18,063,"Indiana","Hendricks County",4,44,2664,1358,1306
050,18,063,"Indiana","Hendricks County",4,45,2504,1256,1248
050,18,063,"Indiana","Hendricks County",4,46,2407,1233,1174
050,18,063,"Indiana","Hendricks County",4,47,2451,1248,1203
050,18,063,"Indiana","Hendricks County",4,48,2376,1225,1151
050,18,063,"Indiana","Hendricks County",4,49,2453,1293,1160
050,18,063,"Indiana","Hendricks County",4,50,2527,1316,1211
050,18,063,"Indiana","Hendricks County",4,51,2602,1352,1250
050,18,063,"Indiana","Hendricks County",4,52,2478,1269,1209
050,18,063,"Indiana","Hendricks County",4,53,2324,1211,1113
050,18,063,"Indiana","Hendricks County",4,54,2183,1101,1082
050,18,063,"Indiana","Hendricks County",4,55,2160,1081,1079
050,18,063,"Indiana","Hendricks County",4,56,2154,1066,1088
050,18,063,"Indiana","Hendricks County",4,57,2227,1082,1145
050,18,063,"Indiana","Hendricks County",4,58,2318,1138,1180
050,18,063,"Indiana","Hendricks County",4,59,2260,1128,1132
050,18,063,"Indiana","Hendricks County",4,60,2313,1123,1190
050,18,063,"Indiana","Hendricks County",4,61,2263,1128,1135
050,18,063,"Indiana","Hendricks County",4,62,2170,1078,1092
050,18,063,"Indiana","Hendricks County",4,63,2074,1045,1029
050,18,063,"Indiana","Hendricks County",4,64,2044,963,1081
050,18,063,"Indiana","Hendricks County",4,65,2032,956,1076
050,18,063,"Indiana","Hendricks County",4,66,1938,921,1017
050,18,063,"Indiana","Hendricks County",4,67,1887,888,999
050,18,063,"Indiana","Hendricks County",4,68,1821,854,967
050,18,063,"Indiana","Hendricks County",4,69,1674,784,890
050,18,063,"Indiana","Hendricks County",4,70,1647,757,890
050,18,063,"Indiana","Hendricks County",4,71,1539,716,823
050,18,063,"Indiana","Hendricks County",4,72,1478,666,812
050,18,063,"Indiana","Hendricks County",4,73,1415,639,776
050,18,063,"Indiana","Hendricks County",4,74,1359,628,731
050,18,063,"Indiana","Hendricks County",4,75,1444,653,791
050,18,063,"Indiana","Hendricks County",4,76,982,442,540
050,18,063,"Indiana","Hendricks County",4,77,889,392,497
050,18,063,"Indiana","Hendricks County",4,78,923,424,499
050,18,063,"Indiana","Hendricks County",4,79,933,409,524
050,18,063,"Indiana","Hendricks County",4,80,770,329,441
050,18,063,"Indiana","Hendricks County",4,81,666,285,381
050,18,063,"Indiana","Hendricks County",4,82,598,249,349
050,18,063,"Indiana","Hendricks County",4,83,536,218,318
050,18,063,"Indiana","Hendricks County",4,84,465,176,289
050,18,063,"Indiana","Hendricks County",4,85,2558,899,1659
050,18,063,"Indiana","Hendricks County",5,0,1815,982,833
050,18,063,"Indiana","Hendricks County",5,1,2057,1116,941
050,18,063,"Indiana","Hendricks County",5,2,2015,1022,993
050,18,063,"Indiana","Hendricks County",5,3,2092,1086,1006
050,18,063,"Indiana","Hendricks County",5,4,2201,1117,1084
050,18,063,"Indiana","Hendricks County",5,5,2396,1203,1193
050,18,063,"Indiana","Hendricks County",5,6,2456,1208,1248
050,18,063,"Indiana","Hendricks County",5,7,2550,1302,1248
050,18,063,"Indiana","Hendricks County",5,8,2583,1301,1282
050,18,063,"Indiana","Hendricks County",5,9,2657,1381,1276
050,18,063,"Indiana","Hendricks County",5,10,2678,1448,1230
050,18,063,"Indiana","Hendricks County",5,11,2746,1447,1299
050,18,063,"Indiana","Hendricks County",5,12,2812,1483,1329
050,18,063,"Indiana","Hendricks County",5,13,2791,1392,1399
050,18,063,"Indiana","Hendricks County",5,14,2872,1490,1382
050,18,063,"Indiana","Hendricks County",5,15,2980,1587,1393
050,18,063,"Indiana","Hendricks County",5,16,2934,1546,1388
050,18,063,"Indiana","Hendricks County",5,17,2869,1522,1347
050,18,063,"Indiana","Hendricks County",5,18,2366,1301,1065
050,18,063,"Indiana","Hendricks County",5,19,1927,1044,883
050,18,063,"Indiana","Hendricks County",5,20,1987,1080,907
050,18,063,"Indiana","Hendricks County",5,21,2018,1085,933
050,18,063,"Indiana","Hendricks County",5,22,2149,1134,1015
050,18,063,"Indiana","Hendricks County",5,23,2161,1134,1027
050,18,063,"Indiana","Hendricks County",5,24,2165,1159,1006
050,18,063,"Indiana","Hendricks County",5,25,2044,1052,992
050,18,063,"Indiana","Hendricks County",5,26,2043,1074,969
050,18,063,"Indiana","Hendricks County",5,27,2140,1157,983
050,18,063,"Indiana","Hendricks County",5,28,2118,1106,1012
050,18,063,"Indiana","Hendricks County",5,29,2243,1152,1091
050,18,063,"Indiana","Hendricks County",5,30,2219,1143,1076
050,18,063,"Indiana","Hendricks County",5,31,2362,1233,1129
050,18,063,"Indiana","Hendricks County",5,32,2455,1226,1229
050,18,063,"Indiana","Hendricks County",5,33,2520,1247,1273
050,18,063,"Indiana","Hendricks County",5,34,2624,1348,1276
050,18,063,"Indiana","Hendricks County",5,35,2501,1232,1269
050,18,063,"Indiana","Hendricks County",5,36,2566,1289,1277
050,18,063,"Indiana","Hendricks County",5,37,2689,1343,1346
050,18,063,"Indiana","Hendricks County",5,38,2789,1408,1381
050,18,063,"Indiana","Hendricks County",5,39,2841,1446,1395
050,18,063,"Indiana","Hendricks County",5,40,2882,1433,1449
050,18,063,"Indiana","Hendricks County",5,41,2877,1473,1404
050,18,063,"Indiana","Hendricks County",5,42,2819,1426,1393
050,18,063,"Indiana","Hendricks County",5,43,2912,1509,1403
050,18,063,"Indiana","Hendricks County",5,44,2842,1450,1392
050,18,063,"Indiana","Hendricks County",5,45,2674,1369,1305
050,18,063,"Indiana","Hendricks County",5,46,2544,1290,1254
050,18,063,"Indiana","Hendricks County",5,47,2461,1261,1200
050,18,063,"Indiana","Hendricks County",5,48,2451,1250,1201
050,18,063,"Indiana","Hendricks County",5,49,2380,1225,1155
050,18,063,"Indiana","Hendricks County",5,50,2423,1255,1168
050,18,063,"Indiana","Hendricks County",5,51,2500,1306,1194
050,18,063,"Indiana","Hendricks County",5,52,2600,1358,1242
050,18,063,"Indiana","Hendricks County",5,53,2495,1288,1207
050,18,063,"Indiana","Hendricks County",5,54,2274,1184,1090
050,18,063,"Indiana","Hendricks County",5,55,2163,1098,1065
050,18,063,"Indiana","Hendricks County",5,56,2167,1076,1091
050,18,063,"Indiana","Hendricks County",5,57,2151,1058,1093
050,18,063,"Indiana","Hendricks County",5,58,2222,1087,1135
050,18,063,"Indiana","Hendricks County",5,59,2282,1118,1164
050,18,063,"Indiana","Hendricks County",5,60,2256,1117,1139
050,18,063,"Indiana","Hendricks County",5,61,2278,1110,1168
050,18,063,"Indiana","Hendricks County",5,62,2252,1113,1139
050,18,063,"Indiana","Hendricks County",5,63,2160,1070,1090
050,18,063,"Indiana","Hendricks County",5,64,2049,1021,1028
050,18,063,"Indiana","Hendricks County",5,65,2051,967,1084
050,18,063,"Indiana","Hendricks County",5,66,2013,942,1071
050,18,063,"Indiana","Hendricks County",5,67,1938,920,1018
050,18,063,"Indiana","Hendricks County",5,68,1851,868,983
050,18,063,"Indiana","Hendricks County",5,69,1807,843,964
050,18,063,"Indiana","Hendricks County",5,70,1665,774,891
050,18,063,"Indiana","Hendricks County",5,71,1610,747,863
050,18,063,"Indiana","Hendricks County",5,72,1535,710,825
050,18,063,"Indiana","Hendricks County",5,73,1445,654,791
050,18,063,"Indiana","Hendricks County",5,74,1390,626,764
050,18,063,"Indiana","Hendricks County",5,75,1353,603,750
050,18,063,"Indiana","Hendricks County",5,76,1408,630,778
050,18,063,"Indiana","Hendricks County",5,77,936,434,502
050,18,063,"Indiana","Hendricks County",5,78,888,384,504
050,18,063,"Indiana","Hendricks County",5,79,915,407,508
050,18,063,"Indiana","Hendricks County",5,80,894,393,501
050,18,063,"Indiana","Hendricks County",5,81,742,322,420
050,18,063,"Indiana","Hendricks County",5,82,651,280,371
050,18,063,"Indiana","Hendricks County",5,83,563,237,326
050,18,063,"Indiana","Hendricks County",5,84,509,191,318
050,18,063,"Indiana","Hendricks County",5,85,2678,944,1734
050,18,065,"Indiana","Henry County",1,0,476,247,229
050,18,065,"Indiana","Henry County",1,1,487,253,234
050,18,065,"Indiana","Henry County",1,2,509,268,241
050,18,065,"Indiana","Henry County",1,3,496,256,240
050,18,065,"Indiana","Henry County",1,4,483,238,245
050,18,065,"Indiana","Henry County",1,5,508,272,236
050,18,065,"Indiana","Henry County",1,6,564,293,271
050,18,065,"Indiana","Henry County",1,7,566,294,272
050,18,065,"Indiana","Henry County",1,8,524,275,249
050,18,065,"Indiana","Henry County",1,9,526,289,237
050,18,065,"Indiana","Henry County",1,10,541,284,257
050,18,065,"Indiana","Henry County",1,11,604,318,286
050,18,065,"Indiana","Henry County",1,12,621,318,303
050,18,065,"Indiana","Henry County",1,13,583,280,303
050,18,065,"Indiana","Henry County",1,14,606,323,283
050,18,065,"Indiana","Henry County",1,15,638,324,314
050,18,065,"Indiana","Henry County",1,16,645,327,318
050,18,065,"Indiana","Henry County",1,17,650,347,303
050,18,065,"Indiana","Henry County",1,18,541,296,245
050,18,065,"Indiana","Henry County",1,19,471,282,189
050,18,065,"Indiana","Henry County",1,20,530,319,211
050,18,065,"Indiana","Henry County",1,21,582,334,248
050,18,065,"Indiana","Henry County",1,22,571,327,244
050,18,065,"Indiana","Henry County",1,23,552,311,241
050,18,065,"Indiana","Henry County",1,24,608,351,257
050,18,065,"Indiana","Henry County",1,25,624,365,259
050,18,065,"Indiana","Henry County",1,26,623,366,257
050,18,065,"Indiana","Henry County",1,27,633,358,275
050,18,065,"Indiana","Henry County",1,28,691,407,284
050,18,065,"Indiana","Henry County",1,29,669,380,289
050,18,065,"Indiana","Henry County",1,30,620,347,273
050,18,065,"Indiana","Henry County",1,31,622,357,265
050,18,065,"Indiana","Henry County",1,32,594,338,256
050,18,065,"Indiana","Henry County",1,33,554,323,231
050,18,065,"Indiana","Henry County",1,34,535,301,234
050,18,065,"Indiana","Henry County",1,35,563,316,247
050,18,065,"Indiana","Henry County",1,36,554,314,240
050,18,065,"Indiana","Henry County",1,37,576,310,266
050,18,065,"Indiana","Henry County",1,38,595,354,241
050,18,065,"Indiana","Henry County",1,39,598,337,261
050,18,065,"Indiana","Henry County",1,40,604,332,272
050,18,065,"Indiana","Henry County",1,41,586,327,259
050,18,065,"Indiana","Henry County",1,42,629,371,258
050,18,065,"Indiana","Henry County",1,43,611,337,274
050,18,065,"Indiana","Henry County",1,44,599,317,282
050,18,065,"Indiana","Henry County",1,45,649,341,308
050,18,065,"Indiana","Henry County",1,46,624,343,281
050,18,065,"Indiana","Henry County",1,47,648,378,270
050,18,065,"Indiana","Henry County",1,48,683,405,278
050,18,065,"Indiana","Henry County",1,49,692,409,283
050,18,065,"Indiana","Henry County",1,50,627,346,281
050,18,065,"Indiana","Henry County",1,51,640,349,291
050,18,065,"Indiana","Henry County",1,52,659,340,319
050,18,065,"Indiana","Henry County",1,53,687,364,323
050,18,065,"Indiana","Henry County",1,54,711,376,335
050,18,065,"Indiana","Henry County",1,55,709,351,358
050,18,065,"Indiana","Henry County",1,56,768,398,370
050,18,065,"Indiana","Henry County",1,57,749,397,352
050,18,065,"Indiana","Henry County",1,58,740,372,368
050,18,065,"Indiana","Henry County",1,59,708,355,353
050,18,065,"Indiana","Henry County",1,60,660,341,319
050,18,065,"Indiana","Henry County",1,61,667,328,339
050,18,065,"Indiana","Henry County",1,62,681,349,332
050,18,065,"Indiana","Henry County",1,63,648,329,319
050,18,065,"Indiana","Henry County",1,64,644,314,330
050,18,065,"Indiana","Henry County",1,65,658,323,335
050,18,065,"Indiana","Henry County",1,66,628,313,315
050,18,065,"Indiana","Henry County",1,67,564,272,292
050,18,065,"Indiana","Henry County",1,68,576,272,304
050,18,065,"Indiana","Henry County",1,69,527,261,266
050,18,065,"Indiana","Henry County",1,70,530,273,257
050,18,065,"Indiana","Henry County",1,71,561,285,276
050,18,065,"Indiana","Henry County",1,72,524,245,279
050,18,065,"Indiana","Henry County",1,73,519,242,277
050,18,065,"Indiana","Henry County",1,74,379,179,200
050,18,065,"Indiana","Henry County",1,75,377,167,210
050,18,065,"Indiana","Henry County",1,76,383,166,217
050,18,065,"Indiana","Henry County",1,77,380,163,217
050,18,065,"Indiana","Henry County",1,78,343,145,198
050,18,065,"Indiana","Henry County",1,79,294,130,164
050,18,065,"Indiana","Henry County",1,80,261,117,144
050,18,065,"Indiana","Henry County",1,81,256,120,136
050,18,065,"Indiana","Henry County",1,82,220,96,124
050,18,065,"Indiana","Henry County",1,83,188,75,113
050,18,065,"Indiana","Henry County",1,84,180,73,107
050,18,065,"Indiana","Henry County",1,85,1006,367,639
050,18,065,"Indiana","Henry County",2,0,487,244,243
050,18,065,"Indiana","Henry County",2,1,484,250,234
050,18,065,"Indiana","Henry County",2,2,506,266,240
050,18,065,"Indiana","Henry County",2,3,498,257,241
050,18,065,"Indiana","Henry County",2,4,492,248,244
050,18,065,"Indiana","Henry County",2,5,506,266,240
050,18,065,"Indiana","Henry County",2,6,557,291,266
050,18,065,"Indiana","Henry County",2,7,567,295,272
050,18,065,"Indiana","Henry County",2,8,534,278,256
050,18,065,"Indiana","Henry County",2,9,522,283,239
050,18,065,"Indiana","Henry County",2,10,535,284,251
050,18,065,"Indiana","Henry County",2,11,592,311,281
050,18,065,"Indiana","Henry County",2,12,620,319,301
050,18,065,"Indiana","Henry County",2,13,593,292,301
050,18,065,"Indiana","Henry County",2,14,599,310,289
050,18,065,"Indiana","Henry County",2,15,627,321,306
050,18,065,"Indiana","Henry County",2,16,644,326,318
050,18,065,"Indiana","Henry County",2,17,648,343,305
050,18,065,"Indiana","Henry County",2,18,540,297,243
050,18,065,"Indiana","Henry County",2,19,468,277,191
050,18,065,"Indiana","Henry County",2,20,536,323,213
050,18,065,"Indiana","Henry County",2,21,581,341,240
050,18,065,"Indiana","Henry County",2,22,576,329,247
050,18,065,"Indiana","Henry County",2,23,565,319,246
050,18,065,"Indiana","Henry County",2,24,597,344,253
050,18,065,"Indiana","Henry County",2,25,627,367,260
050,18,065,"Indiana","Henry County",2,26,631,371,260
050,18,065,"Indiana","Henry County",2,27,631,359,272
050,18,065,"Indiana","Henry County",2,28,684,402,282
050,18,065,"Indiana","Henry County",2,29,674,386,288
050,18,065,"Indiana","Henry County",2,30,630,348,282
050,18,065,"Indiana","Henry County",2,31,626,360,266
050,18,065,"Indiana","Henry County",2,32,600,343,257
050,18,065,"Indiana","Henry County",2,33,561,325,236
050,18,065,"Indiana","Henry County",2,34,543,307,236
050,18,065,"Indiana","Henry County",2,35,561,316,245
050,18,065,"Indiana","Henry County",2,36,551,311,240
050,18,065,"Indiana","Henry County",2,37,572,312,260
050,18,065,"Indiana","Henry County",2,38,595,347,248
050,18,065,"Indiana","Henry County",2,39,594,340,254
050,18,065,"Indiana","Henry County",2,40,606,337,269
050,18,065,"Indiana","Henry County",2,41,583,325,258
050,18,065,"Indiana","Henry County",2,42,628,370,258
050,18,065,"Indiana","Henry County",2,43,619,347,272
050,18,065,"Indiana","Henry County",2,44,601,322,279
050,18,065,"Indiana","Henry County",2,45,639,336,303
050,18,065,"Indiana","Henry County",2,46,624,340,284
050,18,065,"Indiana","Henry County",2,47,646,373,273
050,18,065,"Indiana","Henry County",2,48,662,389,273
050,18,065,"Indiana","Henry County",2,49,696,413,283
050,18,065,"Indiana","Henry County",2,50,633,350,283
050,18,065,"Indiana","Henry County",2,51,641,354,287
050,18,065,"Indiana","Henry County",2,52,649,339,310
050,18,065,"Indiana","Henry County",2,53,680,358,322
050,18,065,"Indiana","Henry County",2,54,700,371,329
050,18,065,"Indiana","Henry County",2,55,699,351,348
050,18,065,"Indiana","Henry County",2,56,765,394,371
050,18,065,"Indiana","Henry County",2,57,748,391,357
050,18,065,"Indiana","Henry County",2,58,737,374,363
050,18,065,"Indiana","Henry County",2,59,711,358,353
050,18,065,"Indiana","Henry County",2,60,668,340,328
050,18,065,"Indiana","Henry County",2,61,663,331,332
050,18,065,"Indiana","Henry County",2,62,676,342,334
050,18,065,"Indiana","Henry County",2,63,658,335,323
050,18,065,"Indiana","Henry County",2,64,636,314,322
050,18,065,"Indiana","Henry County",2,65,652,320,332
050,18,065,"Indiana","Henry County",2,66,632,316,316
050,18,065,"Indiana","Henry County",2,67,576,280,296
050,18,065,"Indiana","Henry County",2,68,564,267,297
050,18,065,"Indiana","Henry County",2,69,541,265,276
050,18,065,"Indiana","Henry County",2,70,526,268,258
050,18,065,"Indiana","Henry County",2,71,553,282,271
050,18,065,"Indiana","Henry County",2,72,520,248,272
050,18,065,"Indiana","Henry County",2,73,547,257,290
050,18,065,"Indiana","Henry County",2,74,385,180,205
050,18,065,"Indiana","Henry County",2,75,376,171,205
050,18,065,"Indiana","Henry County",2,76,377,164,213
050,18,065,"Indiana","Henry County",2,77,381,163,218
050,18,065,"Indiana","Henry County",2,78,342,144,198
050,18,065,"Indiana","Henry County",2,79,301,132,169
050,18,065,"Indiana","Henry County",2,80,264,116,148
050,18,065,"Indiana","Henry County",2,81,251,117,134
050,18,065,"Indiana","Henry County",2,82,224,99,125
050,18,065,"Indiana","Henry County",2,83,194,78,116
050,18,065,"Indiana","Henry County",2,84,179,73,106
050,18,065,"Indiana","Henry County",2,85,996,365,631
050,18,065,"Indiana","Henry County",3,0,449,237,212
050,18,065,"Indiana","Henry County",3,1,515,265,250
050,18,065,"Indiana","Henry County",3,2,499,246,253
050,18,065,"Indiana","Henry County",3,3,547,288,259
050,18,065,"Indiana","Henry County",3,4,508,258,250
050,18,065,"Indiana","Henry County",3,5,518,263,255
050,18,065,"Indiana","Henry County",3,6,510,264,246
050,18,065,"Indiana","Henry County",3,7,555,293,262
050,18,065,"Indiana","Henry County",3,8,559,291,268
050,18,065,"Indiana","Henry County",3,9,536,284,252
050,18,065,"Indiana","Henry County",3,10,509,277,232
050,18,065,"Indiana","Henry County",3,11,552,299,253
050,18,065,"Indiana","Henry County",3,12,591,309,282
050,18,065,"Indiana","Henry County",3,13,611,317,294
050,18,065,"Indiana","Henry County",3,14,601,294,307
050,18,065,"Indiana","Henry County",3,15,595,308,287
050,18,065,"Indiana","Henry County",3,16,629,325,304
050,18,065,"Indiana","Henry County",3,17,656,336,320
050,18,065,"Indiana","Henry County",3,18,569,331,238
050,18,065,"Indiana","Henry County",3,19,455,270,185
050,18,065,"Indiana","Henry County",3,20,531,309,222
050,18,065,"Indiana","Henry County",3,21,589,367,222
050,18,065,"Indiana","Henry County",3,22,615,351,264
050,18,065,"Indiana","Henry County",3,23,599,342,257
050,18,065,"Indiana","Henry County",3,24,576,321,255
050,18,065,"Indiana","Henry County",3,25,616,372,244
050,18,065,"Indiana","Henry County",3,26,627,371,256
050,18,065,"Indiana","Henry County",3,27,631,361,270
050,18,065,"Indiana","Henry County",3,28,666,399,267
050,18,065,"Indiana","Henry County",3,29,699,408,291
050,18,065,"Indiana","Henry County",3,30,659,365,294
050,18,065,"Indiana","Henry County",3,31,646,362,284
050,18,065,"Indiana","Henry County",3,32,627,364,263
050,18,065,"Indiana","Henry County",3,33,612,348,264
050,18,065,"Indiana","Henry County",3,34,580,344,236
050,18,065,"Indiana","Henry County",3,35,550,308,242
050,18,065,"Indiana","Henry County",3,36,561,319,242
050,18,065,"Indiana","Henry County",3,37,562,319,243
050,18,065,"Indiana","Henry County",3,38,601,333,268
050,18,065,"Indiana","Henry County",3,39,585,335,250
050,18,065,"Indiana","Henry County",3,40,615,358,257
050,18,065,"Indiana","Henry County",3,41,589,318,271
050,18,065,"Indiana","Henry County",3,42,625,356,269
050,18,065,"Indiana","Henry County",3,43,603,350,253
050,18,065,"Indiana","Henry County",3,44,616,349,267
050,18,065,"Indiana","Henry County",3,45,607,333,274
050,18,065,"Indiana","Henry County",3,46,640,343,297
050,18,065,"Indiana","Henry County",3,47,632,345,287
050,18,065,"Indiana","Henry County",3,48,632,336,296
050,18,065,"Indiana","Henry County",3,49,678,407,271
050,18,065,"Indiana","Henry County",3,50,663,367,296
050,18,065,"Indiana","Henry County",3,51,670,388,282
050,18,065,"Indiana","Henry County",3,52,619,332,287
050,18,065,"Indiana","Henry County",3,53,652,345,307
050,18,065,"Indiana","Henry County",3,54,690,372,318
050,18,065,"Indiana","Henry County",3,55,665,345,320
050,18,065,"Indiana","Henry County",3,56,722,368,354
050,18,065,"Indiana","Henry County",3,57,748,382,366
050,18,065,"Indiana","Henry County",3,58,723,369,354
050,18,065,"Indiana","Henry County",3,59,724,372,352
050,18,065,"Indiana","Henry County",3,60,702,343,359
050,18,065,"Indiana","Henry County",3,61,648,328,320
050,18,065,"Indiana","Henry County",3,62,670,339,331
050,18,065,"Indiana","Henry County",3,63,662,340,322
050,18,065,"Indiana","Henry County",3,64,638,317,321
050,18,065,"Indiana","Henry County",3,65,624,303,321
050,18,065,"Indiana","Henry County",3,66,634,312,322
050,18,065,"Indiana","Henry County",3,67,609,301,308
050,18,065,"Indiana","Henry County",3,68,557,263,294
050,18,065,"Indiana","Henry County",3,69,548,262,286
050,18,065,"Indiana","Henry County",3,70,533,257,276
050,18,065,"Indiana","Henry County",3,71,509,255,254
050,18,065,"Indiana","Henry County",3,72,531,266,265
050,18,065,"Indiana","Henry County",3,73,486,232,254
050,18,065,"Indiana","Henry County",3,74,534,246,288
050,18,065,"Indiana","Henry County",3,75,371,172,199
050,18,065,"Indiana","Henry County",3,76,375,169,206
050,18,065,"Indiana","Henry County",3,77,354,155,199
050,18,065,"Indiana","Henry County",3,78,363,157,206
050,18,065,"Indiana","Henry County",3,79,329,140,189
050,18,065,"Indiana","Henry County",3,80,277,113,164
050,18,065,"Indiana","Henry County",3,81,254,108,146
050,18,065,"Indiana","Henry County",3,82,239,110,129
050,18,065,"Indiana","Henry County",3,83,218,93,125
050,18,065,"Indiana","Henry County",3,84,174,76,98
050,18,065,"Indiana","Henry County",3,85,976,354,622
050,18,065,"Indiana","Henry County",4,0,419,203,216
050,18,065,"Indiana","Henry County",4,1,453,248,205
050,18,065,"Indiana","Henry County",4,2,537,271,266
050,18,065,"Indiana","Henry County",4,3,511,254,257
050,18,065,"Indiana","Henry County",4,4,563,293,270
050,18,065,"Indiana","Henry County",4,5,497,253,244
050,18,065,"Indiana","Henry County",4,6,524,266,258
050,18,065,"Indiana","Henry County",4,7,544,293,251
050,18,065,"Indiana","Henry County",4,8,566,289,277
050,18,065,"Indiana","Henry County",4,9,556,284,272
050,18,065,"Indiana","Henry County",4,10,555,291,264
050,18,065,"Indiana","Henry County",4,11,528,289,239
050,18,065,"Indiana","Henry County",4,12,559,299,260
050,18,065,"Indiana","Henry County",4,13,606,319,287
050,18,065,"Indiana","Henry County",4,14,613,313,300
050,18,065,"Indiana","Henry County",4,15,629,307,322
050,18,065,"Indiana","Henry County",4,16,600,314,286
050,18,065,"Indiana","Henry County",4,17,636,326,310
050,18,065,"Indiana","Henry County",4,18,556,303,253
050,18,065,"Indiana","Henry County",4,19,454,281,173
050,18,065,"Indiana","Henry County",4,20,479,289,190
050,18,065,"Indiana","Henry County",4,21,601,355,246
050,18,065,"Indiana","Henry County",4,22,612,376,236
050,18,065,"Indiana","Henry County",4,23,634,360,274
050,18,065,"Indiana","Henry County",4,24,617,358,259
050,18,065,"Indiana","Henry County",4,25,570,322,248
050,18,065,"Indiana","Henry County",4,26,622,364,258
050,18,065,"Indiana","Henry County",4,27,634,364,270
050,18,065,"Indiana","Henry County",4,28,639,369,270
050,18,065,"Indiana","Henry County",4,29,659,390,269
050,18,065,"Indiana","Henry County",4,30,643,355,288
050,18,065,"Indiana","Henry County",4,31,668,367,301
050,18,065,"Indiana","Henry County",4,32,655,366,289
050,18,065,"Indiana","Henry County",4,33,622,363,259
050,18,065,"Indiana","Henry County",4,34,611,337,274
050,18,065,"Indiana","Henry County",4,35,589,348,241
050,18,065,"Indiana","Henry County",4,36,554,306,248
050,18,065,"Indiana","Henry County",4,37,570,323,247
050,18,065,"Indiana","Henry County",4,38,571,325,246
050,18,065,"Indiana","Henry County",4,39,586,327,259
050,18,065,"Indiana","Henry County",4,40,575,330,245
050,18,065,"Indiana","Henry County",4,41,597,340,257
050,18,065,"Indiana","Henry County",4,42,613,344,269
050,18,065,"Indiana","Henry County",4,43,601,335,266
050,18,065,"Indiana","Henry County",4,44,592,337,255
050,18,065,"Indiana","Henry County",4,45,618,352,266
050,18,065,"Indiana","Henry County",4,46,605,334,271
050,18,065,"Indiana","Henry County",4,47,661,359,302
050,18,065,"Indiana","Henry County",4,48,599,310,289
050,18,065,"Indiana","Henry County",4,49,638,353,285
050,18,065,"Indiana","Henry County",4,50,646,373,273
050,18,065,"Indiana","Henry County",4,51,693,398,295
050,18,065,"Indiana","Henry County",4,52,643,369,274
050,18,065,"Indiana","Henry County",4,53,620,324,296
050,18,065,"Indiana","Henry County",4,54,647,349,298
050,18,065,"Indiana","Henry County",4,55,668,349,319
050,18,065,"Indiana","Henry County",4,56,687,365,322
050,18,065,"Indiana","Henry County",4,57,689,341,348
050,18,065,"Indiana","Henry County",4,58,726,366,360
050,18,065,"Indiana","Henry County",4,59,710,361,349
050,18,065,"Indiana","Henry County",4,60,714,356,358
050,18,065,"Indiana","Henry County",4,61,691,334,357
050,18,065,"Indiana","Henry County",4,62,661,333,328
050,18,065,"Indiana","Henry County",4,63,654,332,322
050,18,065,"Indiana","Henry County",4,64,646,331,315
050,18,065,"Indiana","Henry County",4,65,623,304,319
050,18,065,"Indiana","Henry County",4,66,612,299,313
050,18,065,"Indiana","Henry County",4,67,617,302,315
050,18,065,"Indiana","Henry County",4,68,592,288,304
050,18,065,"Indiana","Henry County",4,69,536,252,284
050,18,065,"Indiana","Henry County",4,70,529,250,279
050,18,065,"Indiana","Henry County",4,71,517,243,274
050,18,065,"Indiana","Henry County",4,72,489,239,250
050,18,065,"Indiana","Henry County",4,73,514,258,256
050,18,065,"Indiana","Henry County",4,74,472,222,250
050,18,065,"Indiana","Henry County",4,75,511,230,281
050,18,065,"Indiana","Henry County",4,76,374,170,204
050,18,065,"Indiana","Henry County",4,77,344,151,193
050,18,065,"Indiana","Henry County",4,78,335,150,185
050,18,065,"Indiana","Henry County",4,79,347,151,196
050,18,065,"Indiana","Henry County",4,80,303,120,183
050,18,065,"Indiana","Henry County",4,81,267,112,155
050,18,065,"Indiana","Henry County",4,82,232,92,140
050,18,065,"Indiana","Henry County",4,83,219,96,123
050,18,065,"Indiana","Henry County",4,84,190,85,105
050,18,065,"Indiana","Henry County",4,85,956,338,618
050,18,065,"Indiana","Henry County",5,0,414,200,214
050,18,065,"Indiana","Henry County",5,1,459,211,248
050,18,065,"Indiana","Henry County",5,2,460,249,211
050,18,065,"Indiana","Henry County",5,3,547,273,274
050,18,065,"Indiana","Henry County",5,4,522,259,263
050,18,065,"Indiana","Henry County",5,5,571,300,271
050,18,065,"Indiana","Henry County",5,6,511,269,242
050,18,065,"Indiana","Henry County",5,7,530,270,260
050,18,065,"Indiana","Henry County",5,8,555,295,260
050,18,065,"Indiana","Henry County",5,9,576,298,278
050,18,065,"Indiana","Henry County",5,10,557,288,269
050,18,065,"Indiana","Henry County",5,11,548,291,257
050,18,065,"Indiana","Henry County",5,12,543,293,250
050,18,065,"Indiana","Henry County",5,13,564,291,273
050,18,065,"Indiana","Henry County",5,14,610,328,282
050,18,065,"Indiana","Henry County",5,15,618,320,298
050,18,065,"Indiana","Henry County",5,16,610,300,310
050,18,065,"Indiana","Henry County",5,17,620,319,301
050,18,065,"Indiana","Henry County",5,18,527,290,237
050,18,065,"Indiana","Henry County",5,19,462,265,197
050,18,065,"Indiana","Henry County",5,20,516,315,201
050,18,065,"Indiana","Henry County",5,21,548,332,216
050,18,065,"Indiana","Henry County",5,22,632,361,271
050,18,065,"Indiana","Henry County",5,23,620,376,244
050,18,065,"Indiana","Henry County",5,24,648,361,287
050,18,065,"Indiana","Henry County",5,25,643,379,264
050,18,065,"Indiana","Henry County",5,26,600,342,258
050,18,065,"Indiana","Henry County",5,27,609,350,259
050,18,065,"Indiana","Henry County",5,28,685,402,283
050,18,065,"Indiana","Henry County",5,29,681,392,289
050,18,065,"Indiana","Henry County",5,30,631,354,277
050,18,065,"Indiana","Henry County",5,31,671,374,297
050,18,065,"Indiana","Henry County",5,32,689,386,303
050,18,065,"Indiana","Henry County",5,33,649,364,285
050,18,065,"Indiana","Henry County",5,34,633,369,264
050,18,065,"Indiana","Henry County",5,35,605,333,272
050,18,065,"Indiana","Henry County",5,36,582,343,239
050,18,065,"Indiana","Henry County",5,37,565,306,259
050,18,065,"Indiana","Henry County",5,38,581,328,253
050,18,065,"Indiana","Henry County",5,39,573,329,244
050,18,065,"Indiana","Henry County",5,40,587,325,262
050,18,065,"Indiana","Henry County",5,41,557,314,243
050,18,065,"Indiana","Henry County",5,42,637,369,268
050,18,065,"Indiana","Henry County",5,43,585,323,262
050,18,065,"Indiana","Henry County",5,44,619,341,278
050,18,065,"Indiana","Henry County",5,45,587,338,249
050,18,065,"Indiana","Henry County",5,46,625,355,270
050,18,065,"Indiana","Henry County",5,47,615,343,272
050,18,065,"Indiana","Henry County",5,48,625,325,300
050,18,065,"Indiana","Henry County",5,49,618,329,289
050,18,065,"Indiana","Henry County",5,50,610,314,296
050,18,065,"Indiana","Henry County",5,51,677,405,272
050,18,065,"Indiana","Henry County",5,52,666,379,287
050,18,065,"Indiana","Henry County",5,53,637,368,269
050,18,065,"Indiana","Henry County",5,54,623,330,293
050,18,065,"Indiana","Henry County",5,55,626,334,292
050,18,065,"Indiana","Henry County",5,56,696,374,322
050,18,065,"Indiana","Henry County",5,57,671,345,326
050,18,065,"Indiana","Henry County",5,58,699,346,353
050,18,065,"Indiana","Henry County",5,59,731,365,366
050,18,065,"Indiana","Henry County",5,60,683,337,346
050,18,065,"Indiana","Henry County",5,61,701,350,351
050,18,065,"Indiana","Henry County",5,62,699,334,365
050,18,065,"Indiana","Henry County",5,63,645,322,323
050,18,065,"Indiana","Henry County",5,64,647,322,325
050,18,065,"Indiana","Henry County",5,65,646,328,318
050,18,065,"Indiana","Henry County",5,66,615,302,313
050,18,065,"Indiana","Henry County",5,67,604,291,313
050,18,065,"Indiana","Henry County",5,68,599,290,309
050,18,065,"Indiana","Henry County",5,69,558,273,285
050,18,065,"Indiana","Henry County",5,70,521,245,276
050,18,065,"Indiana","Henry County",5,71,509,236,273
050,18,065,"Indiana","Henry County",5,72,503,228,275
050,18,065,"Indiana","Henry County",5,73,466,231,235
050,18,065,"Indiana","Henry County",5,74,498,245,253
050,18,065,"Indiana","Henry County",5,75,443,207,236
050,18,065,"Indiana","Henry County",5,76,508,227,281
050,18,065,"Indiana","Henry County",5,77,351,160,191
050,18,065,"Indiana","Henry County",5,78,324,143,181
050,18,065,"Indiana","Henry County",5,79,318,142,176
050,18,065,"Indiana","Henry County",5,80,318,131,187
050,18,065,"Indiana","Henry County",5,81,295,119,176
050,18,065,"Indiana","Henry County",5,82,246,97,149
050,18,065,"Indiana","Henry County",5,83,213,80,133
050,18,065,"Indiana","Henry County",5,84,193,90,103
050,18,065,"Indiana","Henry County",5,85,970,346,624
050,18,067,"Indiana","Howard County",1,0,1002,508,494
050,18,067,"Indiana","Howard County",1,1,1009,518,491
050,18,067,"Indiana","Howard County",1,2,1023,519,504
050,18,067,"Indiana","Howard County",1,3,1015,530,485
050,18,067,"Indiana","Howard County",1,4,1056,540,516
050,18,067,"Indiana","Howard County",1,5,1037,546,491
050,18,067,"Indiana","Howard County",1,6,1093,567,526
050,18,067,"Indiana","Howard County",1,7,1141,570,571
050,18,067,"Indiana","Howard County",1,8,1067,535,532
050,18,067,"Indiana","Howard County",1,9,1042,541,501
050,18,067,"Indiana","Howard County",1,10,1023,533,490
050,18,067,"Indiana","Howard County",1,11,1070,572,498
050,18,067,"Indiana","Howard County",1,12,1143,595,548
050,18,067,"Indiana","Howard County",1,13,1125,550,575
050,18,067,"Indiana","Howard County",1,14,1088,551,537
050,18,067,"Indiana","Howard County",1,15,1085,564,521
050,18,067,"Indiana","Howard County",1,16,1119,569,550
050,18,067,"Indiana","Howard County",1,17,1126,563,563
050,18,067,"Indiana","Howard County",1,18,951,508,443
050,18,067,"Indiana","Howard County",1,19,815,422,393
050,18,067,"Indiana","Howard County",1,20,863,435,428
050,18,067,"Indiana","Howard County",1,21,925,452,473
050,18,067,"Indiana","Howard County",1,22,1013,507,506
050,18,067,"Indiana","Howard County",1,23,1034,528,506
050,18,067,"Indiana","Howard County",1,24,1027,524,503
050,18,067,"Indiana","Howard County",1,25,1035,535,500
050,18,067,"Indiana","Howard County",1,26,1083,558,525
050,18,067,"Indiana","Howard County",1,27,1109,540,569
050,18,067,"Indiana","Howard County",1,28,1084,533,551
050,18,067,"Indiana","Howard County",1,29,1074,544,530
050,18,067,"Indiana","Howard County",1,30,1040,519,521
050,18,067,"Indiana","Howard County",1,31,981,478,503
050,18,067,"Indiana","Howard County",1,32,958,484,474
050,18,067,"Indiana","Howard County",1,33,950,474,476
050,18,067,"Indiana","Howard County",1,34,956,461,495
050,18,067,"Indiana","Howard County",1,35,956,467,489
050,18,067,"Indiana","Howard County",1,36,916,462,454
050,18,067,"Indiana","Howard County",1,37,953,457,496
050,18,067,"Indiana","Howard County",1,38,935,425,510
050,18,067,"Indiana","Howard County",1,39,935,431,504
050,18,067,"Indiana","Howard County",1,40,950,461,489
050,18,067,"Indiana","Howard County",1,41,944,460,484
050,18,067,"Indiana","Howard County",1,42,1001,464,537
050,18,067,"Indiana","Howard County",1,43,951,475,476
050,18,067,"Indiana","Howard County",1,44,906,459,447
050,18,067,"Indiana","Howard County",1,45,939,440,499
050,18,067,"Indiana","Howard County",1,46,955,461,494
050,18,067,"Indiana","Howard County",1,47,975,490,485
050,18,067,"Indiana","Howard County",1,48,1030,503,527
050,18,067,"Indiana","Howard County",1,49,1071,530,541
050,18,067,"Indiana","Howard County",1,50,1037,521,516
050,18,067,"Indiana","Howard County",1,51,1021,518,503
050,18,067,"Indiana","Howard County",1,52,1014,507,507
050,18,067,"Indiana","Howard County",1,53,1048,527,521
050,18,067,"Indiana","Howard County",1,54,1052,525,527
050,18,067,"Indiana","Howard County",1,55,1139,574,565
050,18,067,"Indiana","Howard County",1,56,1155,581,574
050,18,067,"Indiana","Howard County",1,57,1178,569,609
050,18,067,"Indiana","Howard County",1,58,1225,567,658
050,18,067,"Indiana","Howard County",1,59,1222,585,637
050,18,067,"Indiana","Howard County",1,60,1204,578,626
050,18,067,"Indiana","Howard County",1,61,1161,562,599
050,18,067,"Indiana","Howard County",1,62,1179,578,601
050,18,067,"Indiana","Howard County",1,63,1102,546,556
050,18,067,"Indiana","Howard County",1,64,1086,507,579
050,18,067,"Indiana","Howard County",1,65,1046,494,552
050,18,067,"Indiana","Howard County",1,66,1056,503,553
050,18,067,"Indiana","Howard County",1,67,1006,471,535
050,18,067,"Indiana","Howard County",1,68,984,453,531
050,18,067,"Indiana","Howard County",1,69,916,410,506
050,18,067,"Indiana","Howard County",1,70,912,386,526
050,18,067,"Indiana","Howard County",1,71,892,396,496
050,18,067,"Indiana","Howard County",1,72,906,415,491
050,18,067,"Indiana","Howard County",1,73,917,437,480
050,18,067,"Indiana","Howard County",1,74,650,300,350
050,18,067,"Indiana","Howard County",1,75,684,303,381
050,18,067,"Indiana","Howard County",1,76,688,300,388
050,18,067,"Indiana","Howard County",1,77,662,307,355
050,18,067,"Indiana","Howard County",1,78,611,273,338
050,18,067,"Indiana","Howard County",1,79,512,222,290
050,18,067,"Indiana","Howard County",1,80,474,201,273
050,18,067,"Indiana","Howard County",1,81,437,195,242
050,18,067,"Indiana","Howard County",1,82,396,176,220
050,18,067,"Indiana","Howard County",1,83,344,138,206
050,18,067,"Indiana","Howard County",1,84,304,130,174
050,18,067,"Indiana","Howard County",1,85,1865,696,1169
050,18,067,"Indiana","Howard County",2,0,986,498,488
050,18,067,"Indiana","Howard County",2,1,1008,517,491
050,18,067,"Indiana","Howard County",2,2,1020,520,500
050,18,067,"Indiana","Howard County",2,3,1013,523,490
050,18,067,"Indiana","Howard County",2,4,1052,537,515
050,18,067,"Indiana","Howard County",2,5,1039,545,494
050,18,067,"Indiana","Howard County",2,6,1081,563,518
050,18,067,"Indiana","Howard County",2,7,1129,568,561
050,18,067,"Indiana","Howard County",2,8,1083,541,542
050,18,067,"Indiana","Howard County",2,9,1045,537,508
050,18,067,"Indiana","Howard County",2,10,1026,536,490
050,18,067,"Indiana","Howard County",2,11,1054,561,493
050,18,067,"Indiana","Howard County",2,12,1131,591,540
050,18,067,"Indiana","Howard County",2,13,1125,558,567
050,18,067,"Indiana","Howard County",2,14,1094,548,546
050,18,067,"Indiana","Howard County",2,15,1084,558,526
050,18,067,"Indiana","Howard County",2,16,1112,568,544
050,18,067,"Indiana","Howard County",2,17,1124,563,561
050,18,067,"Indiana","Howard County",2,18,954,502,452
050,18,067,"Indiana","Howard County",2,19,814,424,390
050,18,067,"Indiana","Howard County",2,20,881,445,436
050,18,067,"Indiana","Howard County",2,21,927,455,472
050,18,067,"Indiana","Howard County",2,22,1008,502,506
050,18,067,"Indiana","Howard County",2,23,1043,530,513
050,18,067,"Indiana","Howard County",2,24,1037,530,507
050,18,067,"Indiana","Howard County",2,25,1038,541,497
050,18,067,"Indiana","Howard County",2,26,1076,553,523
050,18,067,"Indiana","Howard County",2,27,1103,544,559
050,18,067,"Indiana","Howard County",2,28,1086,531,555
050,18,067,"Indiana","Howard County",2,29,1083,542,541
050,18,067,"Indiana","Howard County",2,30,1049,524,525
050,18,067,"Indiana","Howard County",2,31,990,486,504
050,18,067,"Indiana","Howard County",2,32,967,487,480
050,18,067,"Indiana","Howard County",2,33,945,470,475
050,18,067,"Indiana","Howard County",2,34,956,465,491
050,18,067,"Indiana","Howard County",2,35,962,468,494
050,18,067,"Indiana","Howard County",2,36,918,459,459
050,18,067,"Indiana","Howard County",2,37,941,456,485
050,18,067,"Indiana","Howard County",2,38,944,435,509
050,18,067,"Indiana","Howard County",2,39,932,429,503
050,18,067,"Indiana","Howard County",2,40,953,457,496
050,18,067,"Indiana","Howard County",2,41,945,458,487
050,18,067,"Indiana","Howard County",2,42,985,462,523
050,18,067,"Indiana","Howard County",2,43,967,474,493
050,18,067,"Indiana","Howard County",2,44,910,463,447
050,18,067,"Indiana","Howard County",2,45,929,443,486
050,18,067,"Indiana","Howard County",2,46,952,458,494
050,18,067,"Indiana","Howard County",2,47,966,478,488
050,18,067,"Indiana","Howard County",2,48,1015,499,516
050,18,067,"Indiana","Howard County",2,49,1063,524,539
050,18,067,"Indiana","Howard County",2,50,1043,523,520
050,18,067,"Indiana","Howard County",2,51,1014,512,502
050,18,067,"Indiana","Howard County",2,52,1011,507,504
050,18,067,"Indiana","Howard County",2,53,1036,519,517
050,18,067,"Indiana","Howard County",2,54,1045,522,523
050,18,067,"Indiana","Howard County",2,55,1113,561,552
050,18,067,"Indiana","Howard County",2,56,1156,582,574
050,18,067,"Indiana","Howard County",2,57,1173,569,604
050,18,067,"Indiana","Howard County",2,58,1208,564,644
050,18,067,"Indiana","Howard County",2,59,1232,585,647
050,18,067,"Indiana","Howard County",2,60,1197,574,623
050,18,067,"Indiana","Howard County",2,61,1163,564,599
050,18,067,"Indiana","Howard County",2,62,1172,570,602
050,18,067,"Indiana","Howard County",2,63,1126,557,569
050,18,067,"Indiana","Howard County",2,64,1073,506,567
050,18,067,"Indiana","Howard County",2,65,1052,496,556
050,18,067,"Indiana","Howard County",2,66,1046,496,550
050,18,067,"Indiana","Howard County",2,67,1011,473,538
050,18,067,"Indiana","Howard County",2,68,976,449,527
050,18,067,"Indiana","Howard County",2,69,940,423,517
050,18,067,"Indiana","Howard County",2,70,903,390,513
050,18,067,"Indiana","Howard County",2,71,897,392,505
050,18,067,"Indiana","Howard County",2,72,882,399,483
050,18,067,"Indiana","Howard County",2,73,955,447,508
050,18,067,"Indiana","Howard County",2,74,669,310,359
050,18,067,"Indiana","Howard County",2,75,664,300,364
050,18,067,"Indiana","Howard County",2,76,673,296,377
050,18,067,"Indiana","Howard County",2,77,675,308,367
050,18,067,"Indiana","Howard County",2,78,606,269,337
050,18,067,"Indiana","Howard County",2,79,525,231,294
050,18,067,"Indiana","Howard County",2,80,479,205,274
050,18,067,"Indiana","Howard County",2,81,441,194,247
050,18,067,"Indiana","Howard County",2,82,401,179,222
050,18,067,"Indiana","Howard County",2,83,347,143,204
050,18,067,"Indiana","Howard County",2,84,299,127,172
050,18,067,"Indiana","Howard County",2,85,1841,687,1154
050,18,067,"Indiana","Howard County",3,0,910,454,456
050,18,067,"Indiana","Howard County",3,1,1030,537,493
050,18,067,"Indiana","Howard County",3,2,1036,534,502
050,18,067,"Indiana","Howard County",3,3,1049,542,507
050,18,067,"Indiana","Howard County",3,4,1039,540,499
050,18,067,"Indiana","Howard County",3,5,1068,544,524
050,18,067,"Indiana","Howard County",3,6,1047,553,494
050,18,067,"Indiana","Howard County",3,7,1069,562,507
050,18,067,"Indiana","Howard County",3,8,1143,577,566
050,18,067,"Indiana","Howard County",3,9,1090,540,550
050,18,067,"Indiana","Howard County",3,10,1065,542,523
050,18,067,"Indiana","Howard County",3,11,1023,531,492
050,18,067,"Indiana","Howard County",3,12,1055,559,496
050,18,067,"Indiana","Howard County",3,13,1113,585,528
050,18,067,"Indiana","Howard County",3,14,1143,568,575
050,18,067,"Indiana","Howard County",3,15,1098,558,540
050,18,067,"Indiana","Howard County",3,16,1095,567,528
050,18,067,"Indiana","Howard County",3,17,1095,541,554
050,18,067,"Indiana","Howard County",3,18,973,510,463
050,18,067,"Indiana","Howard County",3,19,799,413,386
050,18,067,"Indiana","Howard County",3,20,893,458,435
050,18,067,"Indiana","Howard County",3,21,960,485,475
050,18,067,"Indiana","Howard County",3,22,1025,504,521
050,18,067,"Indiana","Howard County",3,23,1060,523,537
050,18,067,"Indiana","Howard County",3,24,1049,508,541
050,18,067,"Indiana","Howard County",3,25,1075,548,527
050,18,067,"Indiana","Howard County",3,26,1038,525,513
050,18,067,"Indiana","Howard County",3,27,1091,575,516
050,18,067,"Indiana","Howard County",3,28,1095,518,577
050,18,067,"Indiana","Howard County",3,29,1133,574,559
050,18,067,"Indiana","Howard County",3,30,1059,528,531
050,18,067,"Indiana","Howard County",3,31,1026,502,524
050,18,067,"Indiana","Howard County",3,32,997,500,497
050,18,067,"Indiana","Howard County",3,33,955,472,483
050,18,067,"Indiana","Howard County",3,34,946,477,469
050,18,067,"Indiana","Howard County",3,35,968,468,500
050,18,067,"Indiana","Howard County",3,36,962,475,487
050,18,067,"Indiana","Howard County",3,37,919,465,454
050,18,067,"Indiana","Howard County",3,38,960,458,502
050,18,067,"Indiana","Howard County",3,39,944,437,507
050,18,067,"Indiana","Howard County",3,40,948,438,510
050,18,067,"Indiana","Howard County",3,41,967,454,513
050,18,067,"Indiana","Howard County",3,42,946,452,494
050,18,067,"Indiana","Howard County",3,43,964,459,505
050,18,067,"Indiana","Howard County",3,44,972,481,491
050,18,067,"Indiana","Howard County",3,45,918,466,452
050,18,067,"Indiana","Howard County",3,46,927,442,485
050,18,067,"Indiana","Howard County",3,47,958,447,511
050,18,067,"Indiana","Howard County",3,48,952,471,481
050,18,067,"Indiana","Howard County",3,49,1017,506,511
050,18,067,"Indiana","Howard County",3,50,1068,535,533
050,18,067,"Indiana","Howard County",3,51,1032,518,514
050,18,067,"Indiana","Howard County",3,52,1010,519,491
050,18,067,"Indiana","Howard County",3,53,1013,503,510
050,18,067,"Indiana","Howard County",3,54,1026,513,513
050,18,067,"Indiana","Howard County",3,55,1019,512,507
050,18,067,"Indiana","Howard County",3,56,1116,565,551
050,18,067,"Indiana","Howard County",3,57,1146,567,579
050,18,067,"Indiana","Howard County",3,58,1151,548,603
050,18,067,"Indiana","Howard County",3,59,1212,560,652
050,18,067,"Indiana","Howard County",3,60,1212,574,638
050,18,067,"Indiana","Howard County",3,61,1179,566,613
050,18,067,"Indiana","Howard County",3,62,1141,548,593
050,18,067,"Indiana","Howard County",3,63,1136,550,586
050,18,067,"Indiana","Howard County",3,64,1103,547,556
050,18,067,"Indiana","Howard County",3,65,1059,498,561
050,18,067,"Indiana","Howard County",3,66,1042,495,547
050,18,067,"Indiana","Howard County",3,67,1035,495,540
050,18,067,"Indiana","Howard County",3,68,995,462,533
050,18,067,"Indiana","Howard County",3,69,958,445,513
050,18,067,"Indiana","Howard County",3,70,908,403,505
050,18,067,"Indiana","Howard County",3,71,890,381,509
050,18,067,"Indiana","Howard County",3,72,858,362,496
050,18,067,"Indiana","Howard County",3,73,857,385,472
050,18,067,"Indiana","Howard County",3,74,925,426,499
050,18,067,"Indiana","Howard County",3,75,650,307,343
050,18,067,"Indiana","Howard County",3,76,626,274,352
050,18,067,"Indiana","Howard County",3,77,648,287,361
050,18,067,"Indiana","Howard County",3,78,642,281,361
050,18,067,"Indiana","Howard County",3,79,561,254,307
050,18,067,"Indiana","Howard County",3,80,474,201,273
050,18,067,"Indiana","Howard County",3,81,441,193,248
050,18,067,"Indiana","Howard County",3,82,402,172,230
050,18,067,"Indiana","Howard County",3,83,366,157,209
050,18,067,"Indiana","Howard County",3,84,298,123,175
050,18,067,"Indiana","Howard County",3,85,1787,656,1131
050,18,067,"Indiana","Howard County",4,0,984,491,493
050,18,067,"Indiana","Howard County",4,1,877,431,446
050,18,067,"Indiana","Howard County",4,2,1053,548,505
050,18,067,"Indiana","Howard County",4,3,1050,547,503
050,18,067,"Indiana","Howard County",4,4,1041,527,514
050,18,067,"Indiana","Howard County",4,5,1036,545,491
050,18,067,"Indiana","Howard County",4,6,1085,555,530
050,18,067,"Indiana","Howard County",4,7,1049,551,498
050,18,067,"Indiana","Howard County",4,8,1041,538,503
050,18,067,"Indiana","Howard County",4,9,1140,582,558
050,18,067,"Indiana","Howard County",4,10,1102,544,558
050,18,067,"Indiana","Howard County",4,11,1076,551,525
050,18,067,"Indiana","Howard County",4,12,1034,543,491
050,18,067,"Indiana","Howard County",4,13,1063,559,504
050,18,067,"Indiana","Howard County",4,14,1139,595,544
050,18,067,"Indiana","Howard County",4,15,1156,574,582
050,18,067,"Indiana","Howard County",4,16,1127,570,557
050,18,067,"Indiana","Howard County",4,17,1092,557,535
050,18,067,"Indiana","Howard County",4,18,947,483,464
050,18,067,"Indiana","Howard County",4,19,783,408,375
050,18,067,"Indiana","Howard County",4,20,870,450,420
050,18,067,"Indiana","Howard County",4,21,964,491,473
050,18,067,"Indiana","Howard County",4,22,1051,547,504
050,18,067,"Indiana","Howard County",4,23,1099,531,568
050,18,067,"Indiana","Howard County",4,24,1066,534,532
050,18,067,"Indiana","Howard County",4,25,1049,523,526
050,18,067,"Indiana","Howard County",4,26,1061,534,527
050,18,067,"Indiana","Howard County",4,27,1014,529,485
050,18,067,"Indiana","Howard County",4,28,1071,547,524
050,18,067,"Indiana","Howard County",4,29,1147,549,598
050,18,067,"Indiana","Howard County",4,30,1122,560,562
050,18,067,"Indiana","Howard County",4,31,1063,523,540
050,18,067,"Indiana","Howard County",4,32,1047,524,523
050,18,067,"Indiana","Howard County",4,33,977,477,500
050,18,067,"Indiana","Howard County",4,34,975,479,496
050,18,067,"Indiana","Howard County",4,35,937,467,470
050,18,067,"Indiana","Howard County",4,36,974,463,511
050,18,067,"Indiana","Howard County",4,37,979,490,489
050,18,067,"Indiana","Howard County",4,38,916,450,466
050,18,067,"Indiana","Howard County",4,39,973,470,503
050,18,067,"Indiana","Howard County",4,40,930,429,501
050,18,067,"Indiana","Howard County",4,41,951,442,509
050,18,067,"Indiana","Howard County",4,42,956,440,516
050,18,067,"Indiana","Howard County",4,43,966,471,495
050,18,067,"Indiana","Howard County",4,44,972,461,511
050,18,067,"Indiana","Howard County",4,45,955,466,489
050,18,067,"Indiana","Howard County",4,46,909,462,447
050,18,067,"Indiana","Howard County",4,47,918,429,489
050,18,067,"Indiana","Howard County",4,48,939,442,497
050,18,067,"Indiana","Howard County",4,49,958,472,486
050,18,067,"Indiana","Howard County",4,50,1004,495,509
050,18,067,"Indiana","Howard County",4,51,1044,516,528
050,18,067,"Indiana","Howard County",4,52,1047,534,513
050,18,067,"Indiana","Howard County",4,53,1014,521,493
050,18,067,"Indiana","Howard County",4,54,998,495,503
050,18,067,"Indiana","Howard County",4,55,1011,512,499
050,18,067,"Indiana","Howard County",4,56,1014,515,499
050,18,067,"Indiana","Howard County",4,57,1077,539,538
050,18,067,"Indiana","Howard County",4,58,1118,545,573
050,18,067,"Indiana","Howard County",4,59,1144,548,596
050,18,067,"Indiana","Howard County",4,60,1175,545,630
050,18,067,"Indiana","Howard County",4,61,1222,574,648
050,18,067,"Indiana","Howard County",4,62,1149,549,600
050,18,067,"Indiana","Howard County",4,63,1093,520,573
050,18,067,"Indiana","Howard County",4,64,1106,523,583
050,18,067,"Indiana","Howard County",4,65,1098,535,563
050,18,067,"Indiana","Howard County",4,66,1054,502,552
050,18,067,"Indiana","Howard County",4,67,1022,475,547
050,18,067,"Indiana","Howard County",4,68,1010,478,532
050,18,067,"Indiana","Howard County",4,69,978,459,519
050,18,067,"Indiana","Howard County",4,70,927,425,502
050,18,067,"Indiana","Howard County",4,71,890,391,499
050,18,067,"Indiana","Howard County",4,72,857,359,498
050,18,067,"Indiana","Howard County",4,73,833,350,483
050,18,067,"Indiana","Howard County",4,74,830,371,459
050,18,067,"Indiana","Howard County",4,75,892,412,480
050,18,067,"Indiana","Howard County",4,76,627,285,342
050,18,067,"Indiana","Howard County",4,77,598,261,337
050,18,067,"Indiana","Howard County",4,78,629,268,361
050,18,067,"Indiana","Howard County",4,79,605,255,350
050,18,067,"Indiana","Howard County",4,80,516,225,291
050,18,067,"Indiana","Howard County",4,81,418,183,235
050,18,067,"Indiana","Howard County",4,82,404,172,232
050,18,067,"Indiana","Howard County",4,83,380,161,219
050,18,067,"Indiana","Howard County",4,84,334,147,187
050,18,067,"Indiana","Howard County",4,85,1744,622,1122
050,18,067,"Indiana","Howard County",5,0,944,471,473
050,18,067,"Indiana","Howard County",5,1,999,510,489
050,18,067,"Indiana","Howard County",5,2,909,440,469
050,18,067,"Indiana","Howard County",5,3,1044,529,515
050,18,067,"Indiana","Howard County",5,4,1049,551,498
050,18,067,"Indiana","Howard County",5,5,1068,537,531
050,18,067,"Indiana","Howard County",5,6,1064,560,504
050,18,067,"Indiana","Howard County",5,7,1087,560,527
050,18,067,"Indiana","Howard County",5,8,1068,564,504
050,18,067,"Indiana","Howard County",5,9,1056,547,509
050,18,067,"Indiana","Howard County",5,10,1142,585,557
050,18,067,"Indiana","Howard County",5,11,1134,564,570
050,18,067,"Indiana","Howard County",5,12,1075,546,529
050,18,067,"Indiana","Howard County",5,13,1053,549,504
050,18,067,"Indiana","Howard County",5,14,1098,572,526
050,18,067,"Indiana","Howard County",5,15,1148,601,547
050,18,067,"Indiana","Howard County",5,16,1186,583,603
050,18,067,"Indiana","Howard County",5,17,1121,564,557
050,18,067,"Indiana","Howard County",5,18,914,490,424
050,18,067,"Indiana","Howard County",5,19,778,398,380
050,18,067,"Indiana","Howard County",5,20,872,440,432
050,18,067,"Indiana","Howard County",5,21,947,487,460
050,18,067,"Indiana","Howard County",5,22,1058,542,516
050,18,067,"Indiana","Howard County",5,23,1099,572,527
050,18,067,"Indiana","Howard County",5,24,1107,529,578
050,18,067,"Indiana","Howard County",5,25,1080,554,526
050,18,067,"Indiana","Howard County",5,26,1037,520,517
050,18,067,"Indiana","Howard County",5,27,1072,548,524
050,18,067,"Indiana","Howard County",5,28,1048,536,512
050,18,067,"Indiana","Howard County",5,29,1115,575,540
050,18,067,"Indiana","Howard County",5,30,1155,563,592
050,18,067,"Indiana","Howard County",5,31,1133,557,576
050,18,067,"Indiana","Howard County",5,32,1083,538,545
050,18,067,"Indiana","Howard County",5,33,1057,530,527
050,18,067,"Indiana","Howard County",5,34,985,485,500
050,18,067,"Indiana","Howard County",5,35,995,484,511
050,18,067,"Indiana","Howard County",5,36,945,480,465
050,18,067,"Indiana","Howard County",5,37,948,449,499
050,18,067,"Indiana","Howard County",5,38,997,499,498
050,18,067,"Indiana","Howard County",5,39,932,458,474
050,18,067,"Indiana","Howard County",5,40,951,461,490
050,18,067,"Indiana","Howard County",5,41,936,432,504
050,18,067,"Indiana","Howard County",5,42,954,447,507
050,18,067,"Indiana","Howard County",5,43,939,441,498
050,18,067,"Indiana","Howard County",5,44,952,466,486
050,18,067,"Indiana","Howard County",5,45,963,457,506
050,18,067,"Indiana","Howard County",5,46,961,472,489
050,18,067,"Indiana","Howard County",5,47,895,450,445
050,18,067,"Indiana","Howard County",5,48,909,431,478
050,18,067,"Indiana","Howard County",5,49,937,443,494
050,18,067,"Indiana","Howard County",5,50,961,465,496
050,18,067,"Indiana","Howard County",5,51,991,476,515
050,18,067,"Indiana","Howard County",5,52,1046,519,527
050,18,067,"Indiana","Howard County",5,53,1061,528,533
050,18,067,"Indiana","Howard County",5,54,1009,511,498
050,18,067,"Indiana","Howard County",5,55,1003,496,507
050,18,067,"Indiana","Howard County",5,56,1010,511,499
050,18,067,"Indiana","Howard County",5,57,1009,507,502
050,18,067,"Indiana","Howard County",5,58,1046,527,519
050,18,067,"Indiana","Howard County",5,59,1127,552,575
050,18,067,"Indiana","Howard County",5,60,1131,539,592
050,18,067,"Indiana","Howard County",5,61,1155,537,618
050,18,067,"Indiana","Howard County",5,62,1209,565,644
050,18,067,"Indiana","Howard County",5,63,1129,537,592
050,18,067,"Indiana","Howard County",5,64,1059,504,555
050,18,067,"Indiana","Howard County",5,65,1113,526,587
050,18,067,"Indiana","Howard County",5,66,1073,525,548
050,18,067,"Indiana","Howard County",5,67,1027,480,547
050,18,067,"Indiana","Howard County",5,68,989,461,528
050,18,067,"Indiana","Howard County",5,69,1000,474,526
050,18,067,"Indiana","Howard County",5,70,936,438,498
050,18,067,"Indiana","Howard County",5,71,899,411,488
050,18,067,"Indiana","Howard County",5,72,867,376,491
050,18,067,"Indiana","Howard County",5,73,823,336,487
050,18,067,"Indiana","Howard County",5,74,817,343,474
050,18,067,"Indiana","Howard County",5,75,800,356,444
050,18,067,"Indiana","Howard County",5,76,863,388,475
050,18,067,"Indiana","Howard County",5,77,600,274,326
050,18,067,"Indiana","Howard County",5,78,576,242,334
050,18,067,"Indiana","Howard County",5,79,592,249,343
050,18,067,"Indiana","Howard County",5,80,569,236,333
050,18,067,"Indiana","Howard County",5,81,465,208,257
050,18,067,"Indiana","Howard County",5,82,376,160,216
050,18,067,"Indiana","Howard County",5,83,385,159,226
050,18,067,"Indiana","Howard County",5,84,342,150,192
050,18,067,"Indiana","Howard County",5,85,1774,633,1141
050,18,069,"Indiana","Huntington County",1,0,417,213,204
050,18,069,"Indiana","Huntington County",1,1,418,217,201
050,18,069,"Indiana","Huntington County",1,2,399,203,196
050,18,069,"Indiana","Huntington County",1,3,440,228,212
050,18,069,"Indiana","Huntington County",1,4,416,221,195
050,18,069,"Indiana","Huntington County",1,5,418,212,206
050,18,069,"Indiana","Huntington County",1,6,420,211,209
050,18,069,"Indiana","Huntington County",1,7,437,218,219
050,18,069,"Indiana","Huntington County",1,8,447,223,224
050,18,069,"Indiana","Huntington County",1,9,442,221,221
050,18,069,"Indiana","Huntington County",1,10,468,250,218
050,18,069,"Indiana","Huntington County",1,11,458,242,216
050,18,069,"Indiana","Huntington County",1,12,493,245,248
050,18,069,"Indiana","Huntington County",1,13,482,236,246
050,18,069,"Indiana","Huntington County",1,14,471,230,241
050,18,069,"Indiana","Huntington County",1,15,485,256,229
050,18,069,"Indiana","Huntington County",1,16,479,254,225
050,18,069,"Indiana","Huntington County",1,17,484,245,239
050,18,069,"Indiana","Huntington County",1,18,422,211,211
050,18,069,"Indiana","Huntington County",1,19,497,264,233
050,18,069,"Indiana","Huntington County",1,20,522,269,253
050,18,069,"Indiana","Huntington County",1,21,518,262,256
050,18,069,"Indiana","Huntington County",1,22,476,251,225
050,18,069,"Indiana","Huntington County",1,23,412,210,202
050,18,069,"Indiana","Huntington County",1,24,429,230,199
050,18,069,"Indiana","Huntington County",1,25,414,214,200
050,18,069,"Indiana","Huntington County",1,26,466,230,236
050,18,069,"Indiana","Huntington County",1,27,429,222,207
050,18,069,"Indiana","Huntington County",1,28,414,208,206
050,18,069,"Indiana","Huntington County",1,29,459,226,233
050,18,069,"Indiana","Huntington County",1,30,454,232,222
050,18,069,"Indiana","Huntington County",1,31,439,231,208
050,18,069,"Indiana","Huntington County",1,32,425,215,210
050,18,069,"Indiana","Huntington County",1,33,444,235,209
050,18,069,"Indiana","Huntington County",1,34,452,220,232
050,18,069,"Indiana","Huntington County",1,35,435,220,215
050,18,069,"Indiana","Huntington County",1,36,432,229,203
050,18,069,"Indiana","Huntington County",1,37,417,224,193
050,18,069,"Indiana","Huntington County",1,38,416,210,206
050,18,069,"Indiana","Huntington County",1,39,456,236,220
050,18,069,"Indiana","Huntington County",1,40,460,246,214
050,18,069,"Indiana","Huntington County",1,41,448,225,223
050,18,069,"Indiana","Huntington County",1,42,462,238,224
050,18,069,"Indiana","Huntington County",1,43,436,220,216
050,18,069,"Indiana","Huntington County",1,44,420,199,221
050,18,069,"Indiana","Huntington County",1,45,436,216,220
050,18,069,"Indiana","Huntington County",1,46,421,222,199
050,18,069,"Indiana","Huntington County",1,47,435,209,226
050,18,069,"Indiana","Huntington County",1,48,455,231,224
050,18,069,"Indiana","Huntington County",1,49,482,259,223
050,18,069,"Indiana","Huntington County",1,50,462,248,214
050,18,069,"Indiana","Huntington County",1,51,455,237,218
050,18,069,"Indiana","Huntington County",1,52,458,221,237
050,18,069,"Indiana","Huntington County",1,53,471,234,237
050,18,069,"Indiana","Huntington County",1,54,486,234,252
050,18,069,"Indiana","Huntington County",1,55,513,254,259
050,18,069,"Indiana","Huntington County",1,56,521,262,259
050,18,069,"Indiana","Huntington County",1,57,553,264,289
050,18,069,"Indiana","Huntington County",1,58,569,278,291
050,18,069,"Indiana","Huntington County",1,59,571,299,272
050,18,069,"Indiana","Huntington County",1,60,551,277,274
050,18,069,"Indiana","Huntington County",1,61,576,296,280
050,18,069,"Indiana","Huntington County",1,62,556,274,282
050,18,069,"Indiana","Huntington County",1,63,532,267,265
050,18,069,"Indiana","Huntington County",1,64,530,277,253
050,18,069,"Indiana","Huntington County",1,65,507,249,258
050,18,069,"Indiana","Huntington County",1,66,478,239,239
050,18,069,"Indiana","Huntington County",1,67,434,222,212
050,18,069,"Indiana","Huntington County",1,68,400,191,209
050,18,069,"Indiana","Huntington County",1,69,363,179,184
050,18,069,"Indiana","Huntington County",1,70,343,159,184
050,18,069,"Indiana","Huntington County",1,71,333,154,179
050,18,069,"Indiana","Huntington County",1,72,338,158,180
050,18,069,"Indiana","Huntington County",1,73,357,172,185
050,18,069,"Indiana","Huntington County",1,74,238,102,136
050,18,069,"Indiana","Huntington County",1,75,234,106,128
050,18,069,"Indiana","Huntington County",1,76,226,99,127
050,18,069,"Indiana","Huntington County",1,77,233,101,132
050,18,069,"Indiana","Huntington County",1,78,205,90,115
050,18,069,"Indiana","Huntington County",1,79,184,74,110
050,18,069,"Indiana","Huntington County",1,80,187,77,110
050,18,069,"Indiana","Huntington County",1,81,174,78,96
050,18,069,"Indiana","Huntington County",1,82,168,65,103
050,18,069,"Indiana","Huntington County",1,83,157,59,98
050,18,069,"Indiana","Huntington County",1,84,136,49,87
050,18,069,"Indiana","Huntington County",1,85,813,247,566
050,18,069,"Indiana","Huntington County",2,0,417,214,203
050,18,069,"Indiana","Huntington County",2,1,416,214,202
050,18,069,"Indiana","Huntington County",2,2,403,207,196
050,18,069,"Indiana","Huntington County",2,3,426,222,204
050,18,069,"Indiana","Huntington County",2,4,422,222,200
050,18,069,"Indiana","Huntington County",2,5,416,213,203
050,18,069,"Indiana","Huntington County",2,6,422,214,208
050,18,069,"Indiana","Huntington County",2,7,432,216,216
050,18,069,"Indiana","Huntington County",2,8,440,219,221
050,18,069,"Indiana","Huntington County",2,9,441,221,220
050,18,069,"Indiana","Huntington County",2,10,460,241,219
050,18,069,"Indiana","Huntington County",2,11,458,242,216
050,18,069,"Indiana","Huntington County",2,12,488,247,241
050,18,069,"Indiana","Huntington County",2,13,485,237,248
050,18,069,"Indiana","Huntington County",2,14,476,232,244
050,18,069,"Indiana","Huntington County",2,15,483,249,234
050,18,069,"Indiana","Huntington County",2,16,481,255,226
050,18,069,"Indiana","Huntington County",2,17,483,248,235
050,18,069,"Indiana","Huntington County",2,18,428,217,211
050,18,069,"Indiana","Huntington County",2,19,495,258,237
050,18,069,"Indiana","Huntington County",2,20,517,271,246
050,18,069,"Indiana","Huntington County",2,21,519,264,255
050,18,069,"Indiana","Huntington County",2,22,476,247,229
050,18,069,"Indiana","Huntington County",2,23,419,218,201
050,18,069,"Indiana","Huntington County",2,24,421,222,199
050,18,069,"Indiana","Huntington County",2,25,423,220,203
050,18,069,"Indiana","Huntington County",2,26,452,226,226
050,18,069,"Indiana","Huntington County",2,27,434,222,212
050,18,069,"Indiana","Huntington County",2,28,419,212,207
050,18,069,"Indiana","Huntington County",2,29,447,222,225
050,18,069,"Indiana","Huntington County",2,30,457,233,224
050,18,069,"Indiana","Huntington County",2,31,440,230,210
050,18,069,"Indiana","Huntington County",2,32,425,217,208
050,18,069,"Indiana","Huntington County",2,33,442,231,211
050,18,069,"Indiana","Huntington County",2,34,451,223,228
050,18,069,"Indiana","Huntington County",2,35,440,221,219
050,18,069,"Indiana","Huntington County",2,36,433,227,206
050,18,069,"Indiana","Huntington County",2,37,421,225,196
050,18,069,"Indiana","Huntington County",2,38,419,216,203
050,18,069,"Indiana","Huntington County",2,39,444,228,216
050,18,069,"Indiana","Huntington County",2,40,461,243,218
050,18,069,"Indiana","Huntington County",2,41,451,232,219
050,18,069,"Indiana","Huntington County",2,42,457,235,222
050,18,069,"Indiana","Huntington County",2,43,444,225,219
050,18,069,"Indiana","Huntington County",2,44,420,199,221
050,18,069,"Indiana","Huntington County",2,45,432,214,218
050,18,069,"Indiana","Huntington County",2,46,424,218,206
050,18,069,"Indiana","Huntington County",2,47,429,209,220
050,18,069,"Indiana","Huntington County",2,48,449,226,223
050,18,069,"Indiana","Huntington County",2,49,478,254,224
050,18,069,"Indiana","Huntington County",2,50,465,250,215
050,18,069,"Indiana","Huntington County",2,51,453,238,215
050,18,069,"Indiana","Huntington County",2,52,452,223,229
050,18,069,"Indiana","Huntington County",2,53,470,233,237
050,18,069,"Indiana","Huntington County",2,54,479,231,248
050,18,069,"Indiana","Huntington County",2,55,504,246,258
050,18,069,"Indiana","Huntington County",2,56,518,260,258
050,18,069,"Indiana","Huntington County",2,57,548,265,283
050,18,069,"Indiana","Huntington County",2,58,560,273,287
050,18,069,"Indiana","Huntington County",2,59,574,297,277
050,18,069,"Indiana","Huntington County",2,60,553,280,273
050,18,069,"Indiana","Huntington County",2,61,566,289,277
050,18,069,"Indiana","Huntington County",2,62,558,279,279
050,18,069,"Indiana","Huntington County",2,63,540,269,271
050,18,069,"Indiana","Huntington County",2,64,526,271,255
050,18,069,"Indiana","Huntington County",2,65,510,253,257
050,18,069,"Indiana","Huntington County",2,66,482,238,244
050,18,069,"Indiana","Huntington County",2,67,440,222,218
050,18,069,"Indiana","Huntington County",2,68,406,198,208
050,18,069,"Indiana","Huntington County",2,69,371,181,190
050,18,069,"Indiana","Huntington County",2,70,345,162,183
050,18,069,"Indiana","Huntington County",2,71,333,154,179
050,18,069,"Indiana","Huntington County",2,72,330,154,176
050,18,069,"Indiana","Huntington County",2,73,368,177,191
050,18,069,"Indiana","Huntington County",2,74,248,111,137
050,18,069,"Indiana","Huntington County",2,75,234,104,130
050,18,069,"Indiana","Huntington County",2,76,220,94,126
050,18,069,"Indiana","Huntington County",2,77,234,102,132
050,18,069,"Indiana","Huntington County",2,78,208,91,117
050,18,069,"Indiana","Huntington County",2,79,186,75,111
050,18,069,"Indiana","Huntington County",2,80,185,77,108
050,18,069,"Indiana","Huntington County",2,81,177,79,98
050,18,069,"Indiana","Huntington County",2,82,168,67,101
050,18,069,"Indiana","Huntington County",2,83,158,59,99
050,18,069,"Indiana","Huntington County",2,84,138,49,89
050,18,069,"Indiana","Huntington County",2,85,823,253,570
050,18,069,"Indiana","Huntington County",3,0,400,216,184
050,18,069,"Indiana","Huntington County",3,1,440,240,200
050,18,069,"Indiana","Huntington County",3,2,424,218,206
050,18,069,"Indiana","Huntington County",3,3,412,210,202
050,18,069,"Indiana","Huntington County",3,4,447,233,214
050,18,069,"Indiana","Huntington County",3,5,432,231,201
050,18,069,"Indiana","Huntington County",3,6,443,214,229
050,18,069,"Indiana","Huntington County",3,7,426,218,208
050,18,069,"Indiana","Huntington County",3,8,422,209,213
050,18,069,"Indiana","Huntington County",3,9,442,224,218
050,18,069,"Indiana","Huntington County",3,10,453,224,229
050,18,069,"Indiana","Huntington County",3,11,463,235,228
050,18,069,"Indiana","Huntington County",3,12,463,246,217
050,18,069,"Indiana","Huntington County",3,13,489,247,242
050,18,069,"Indiana","Huntington County",3,14,483,237,246
050,18,069,"Indiana","Huntington County",3,15,479,241,238
050,18,069,"Indiana","Huntington County",3,16,478,247,231
050,18,069,"Indiana","Huntington County",3,17,473,246,227
050,18,069,"Indiana","Huntington County",3,18,450,236,214
050,18,069,"Indiana","Huntington County",3,19,481,243,238
050,18,069,"Indiana","Huntington County",3,20,480,247,233
050,18,069,"Indiana","Huntington County",3,21,525,275,250
050,18,069,"Indiana","Huntington County",3,22,509,257,252
050,18,069,"Indiana","Huntington County",3,23,434,233,201
050,18,069,"Indiana","Huntington County",3,24,423,219,204
050,18,069,"Indiana","Huntington County",3,25,433,229,204
050,18,069,"Indiana","Huntington County",3,26,442,236,206
050,18,069,"Indiana","Huntington County",3,27,473,234,239
050,18,069,"Indiana","Huntington County",3,28,442,230,212
050,18,069,"Indiana","Huntington County",3,29,438,220,218
050,18,069,"Indiana","Huntington County",3,30,460,234,226
050,18,069,"Indiana","Huntington County",3,31,462,233,229
050,18,069,"Indiana","Huntington County",3,32,448,232,216
050,18,069,"Indiana","Huntington County",3,33,439,224,215
050,18,069,"Indiana","Huntington County",3,34,428,226,202
050,18,069,"Indiana","Huntington County",3,35,451,221,230
050,18,069,"Indiana","Huntington County",3,36,443,231,212
050,18,069,"Indiana","Huntington County",3,37,442,229,213
050,18,069,"Indiana","Huntington County",3,38,424,224,200
050,18,069,"Indiana","Huntington County",3,39,415,211,204
050,18,069,"Indiana","Huntington County",3,40,436,224,212
050,18,069,"Indiana","Huntington County",3,41,466,243,223
050,18,069,"Indiana","Huntington County",3,42,448,231,217
050,18,069,"Indiana","Huntington County",3,43,455,235,220
050,18,069,"Indiana","Huntington County",3,44,450,227,223
050,18,069,"Indiana","Huntington County",3,45,422,203,219
050,18,069,"Indiana","Huntington County",3,46,435,213,222
050,18,069,"Indiana","Huntington County",3,47,415,215,200
050,18,069,"Indiana","Huntington County",3,48,428,214,214
050,18,069,"Indiana","Huntington County",3,49,448,220,228
050,18,069,"Indiana","Huntington County",3,50,482,252,230
050,18,069,"Indiana","Huntington County",3,51,461,254,207
050,18,069,"Indiana","Huntington County",3,52,448,232,216
050,18,069,"Indiana","Huntington County",3,53,466,235,231
050,18,069,"Indiana","Huntington County",3,54,465,226,239
050,18,069,"Indiana","Huntington County",3,55,484,234,250
050,18,069,"Indiana","Huntington County",3,56,509,247,262
050,18,069,"Indiana","Huntington County",3,57,523,258,265
050,18,069,"Indiana","Huntington County",3,58,550,269,281
050,18,069,"Indiana","Huntington County",3,59,548,269,279
050,18,069,"Indiana","Huntington County",3,60,568,296,272
050,18,069,"Indiana","Huntington County",3,61,526,272,254
050,18,069,"Indiana","Huntington County",3,62,563,285,278
050,18,069,"Indiana","Huntington County",3,63,561,278,283
050,18,069,"Indiana","Huntington County",3,64,536,270,266
050,18,069,"Indiana","Huntington County",3,65,518,267,251
050,18,069,"Indiana","Huntington County",3,66,503,243,260
050,18,069,"Indiana","Huntington County",3,67,467,226,241
050,18,069,"Indiana","Huntington County",3,68,437,220,217
050,18,069,"Indiana","Huntington County",3,69,387,185,202
050,18,069,"Indiana","Huntington County",3,70,360,174,186
050,18,069,"Indiana","Huntington County",3,71,343,163,180
050,18,069,"Indiana","Huntington County",3,72,320,145,175
050,18,069,"Indiana","Huntington County",3,73,314,150,164
050,18,069,"Indiana","Huntington County",3,74,356,170,186
050,18,069,"Indiana","Huntington County",3,75,238,108,130
050,18,069,"Indiana","Huntington County",3,76,228,98,130
050,18,069,"Indiana","Huntington County",3,77,205,87,118
050,18,069,"Indiana","Huntington County",3,78,218,97,121
050,18,069,"Indiana","Huntington County",3,79,198,80,118
050,18,069,"Indiana","Huntington County",3,80,167,68,99
050,18,069,"Indiana","Huntington County",3,81,182,80,102
050,18,069,"Indiana","Huntington County",3,82,164,67,97
050,18,069,"Indiana","Huntington County",3,83,145,58,87
050,18,069,"Indiana","Huntington County",3,84,142,51,91
050,18,069,"Indiana","Huntington County",3,85,792,233,559
050,18,069,"Indiana","Huntington County",4,0,404,212,192
050,18,069,"Indiana","Huntington County",4,1,396,211,185
050,18,069,"Indiana","Huntington County",4,2,443,251,192
050,18,069,"Indiana","Huntington County",4,3,420,215,205
050,18,069,"Indiana","Huntington County",4,4,401,208,193
050,18,069,"Indiana","Huntington County",4,5,449,234,215
050,18,069,"Indiana","Huntington County",4,6,427,225,202
050,18,069,"Indiana","Huntington County",4,7,453,220,233
050,18,069,"Indiana","Huntington County",4,8,434,218,216
050,18,069,"Indiana","Huntington County",4,9,444,224,220
050,18,069,"Indiana","Huntington County",4,10,451,228,223
050,18,069,"Indiana","Huntington County",4,11,451,218,233
050,18,069,"Indiana","Huntington County",4,12,469,239,230
050,18,069,"Indiana","Huntington County",4,13,466,242,224
050,18,069,"Indiana","Huntington County",4,14,482,244,238
050,18,069,"Indiana","Huntington County",4,15,502,249,253
050,18,069,"Indiana","Huntington County",4,16,470,227,243
050,18,069,"Indiana","Huntington County",4,17,475,256,219
050,18,069,"Indiana","Huntington County",4,18,436,240,196
050,18,069,"Indiana","Huntington County",4,19,481,245,236
050,18,069,"Indiana","Huntington County",4,20,466,233,233
050,18,069,"Indiana","Huntington County",4,21,488,253,235
050,18,069,"Indiana","Huntington County",4,22,528,276,252
050,18,069,"Indiana","Huntington County",4,23,468,241,227
050,18,069,"Indiana","Huntington County",4,24,420,226,194
050,18,069,"Indiana","Huntington County",4,25,424,223,201
050,18,069,"Indiana","Huntington County",4,26,440,234,206
050,18,069,"Indiana","Huntington County",4,27,432,221,211
050,18,069,"Indiana","Huntington County",4,28,482,246,236
050,18,069,"Indiana","Huntington County",4,29,465,249,216
050,18,069,"Indiana","Huntington County",4,30,439,221,218
050,18,069,"Indiana","Huntington County",4,31,462,239,223
050,18,069,"Indiana","Huntington County",4,32,458,232,226
050,18,069,"Indiana","Huntington County",4,33,446,232,214
050,18,069,"Indiana","Huntington County",4,34,439,225,214
050,18,069,"Indiana","Huntington County",4,35,424,230,194
050,18,069,"Indiana","Huntington County",4,36,459,220,239
050,18,069,"Indiana","Huntington County",4,37,442,220,222
050,18,069,"Indiana","Huntington County",4,38,443,237,206
050,18,069,"Indiana","Huntington County",4,39,441,231,210
050,18,069,"Indiana","Huntington County",4,40,411,202,209
050,18,069,"Indiana","Huntington County",4,41,454,238,216
050,18,069,"Indiana","Huntington County",4,42,472,238,234
050,18,069,"Indiana","Huntington County",4,43,445,228,217
050,18,069,"Indiana","Huntington County",4,44,467,241,226
050,18,069,"Indiana","Huntington County",4,45,437,218,219
050,18,069,"Indiana","Huntington County",4,46,428,204,224
050,18,069,"Indiana","Huntington County",4,47,431,215,216
050,18,069,"Indiana","Huntington County",4,48,424,216,208
050,18,069,"Indiana","Huntington County",4,49,432,214,218
050,18,069,"Indiana","Huntington County",4,50,459,220,239
050,18,069,"Indiana","Huntington County",4,51,479,253,226
050,18,069,"Indiana","Huntington County",4,52,447,249,198
050,18,069,"Indiana","Huntington County",4,53,448,239,209
050,18,069,"Indiana","Huntington County",4,54,460,233,227
050,18,069,"Indiana","Huntington County",4,55,463,226,237
050,18,069,"Indiana","Huntington County",4,56,479,230,249
050,18,069,"Indiana","Huntington County",4,57,505,243,262
050,18,069,"Indiana","Huntington County",4,58,540,264,276
050,18,069,"Indiana","Huntington County",4,59,545,268,277
050,18,069,"Indiana","Huntington County",4,60,543,269,274
050,18,069,"Indiana","Huntington County",4,61,570,298,272
050,18,069,"Indiana","Huntington County",4,62,522,272,250
050,18,069,"Indiana","Huntington County",4,63,544,271,273
050,18,069,"Indiana","Huntington County",4,64,549,272,277
050,18,069,"Indiana","Huntington County",4,65,521,262,259
050,18,069,"Indiana","Huntington County",4,66,507,257,250
050,18,069,"Indiana","Huntington County",4,67,479,233,246
050,18,069,"Indiana","Huntington County",4,68,460,225,235
050,18,069,"Indiana","Huntington County",4,69,420,206,214
050,18,069,"Indiana","Huntington County",4,70,375,178,197
050,18,069,"Indiana","Huntington County",4,71,350,170,180
050,18,069,"Indiana","Huntington County",4,72,336,156,180
050,18,069,"Indiana","Huntington County",4,73,298,135,163
050,18,069,"Indiana","Huntington County",4,74,287,135,152
050,18,069,"Indiana","Huntington County",4,75,341,158,183
050,18,069,"Indiana","Huntington County",4,76,234,106,128
050,18,069,"Indiana","Huntington County",4,77,222,99,123
050,18,069,"Indiana","Huntington County",4,78,186,82,104
050,18,069,"Indiana","Huntington County",4,79,215,89,126
050,18,069,"Indiana","Huntington County",4,80,189,77,112
050,18,069,"Indiana","Huntington County",4,81,161,62,99
050,18,069,"Indiana","Huntington County",4,82,168,65,103
050,18,069,"Indiana","Huntington County",4,83,149,61,88
050,18,069,"Indiana","Huntington County",4,84,130,51,79
050,18,069,"Indiana","Huntington County",4,85,798,220,578
050,18,069,"Indiana","Huntington County",5,0,407,216,191
050,18,069,"Indiana","Huntington County",5,1,408,210,198
050,18,069,"Indiana","Huntington County",5,2,392,211,181
050,18,069,"Indiana","Huntington County",5,3,444,252,192
050,18,069,"Indiana","Huntington County",5,4,415,210,205
050,18,069,"Indiana","Huntington County",5,5,389,201,188
050,18,069,"Indiana","Huntington County",5,6,461,240,221
050,18,069,"Indiana","Huntington County",5,7,440,233,207
050,18,069,"Indiana","Huntington County",5,8,451,218,233
050,18,069,"Indiana","Huntington County",5,9,433,217,216
050,18,069,"Indiana","Huntington County",5,10,437,221,216
050,18,069,"Indiana","Huntington County",5,11,462,218,244
050,18,069,"Indiana","Huntington County",5,12,441,206,235
050,18,069,"Indiana","Huntington County",5,13,460,223,237
050,18,069,"Indiana","Huntington County",5,14,456,235,221
050,18,069,"Indiana","Huntington County",5,15,483,239,244
050,18,069,"Indiana","Huntington County",5,16,486,245,241
050,18,069,"Indiana","Huntington County",5,17,474,231,243
050,18,069,"Indiana","Huntington County",5,18,433,233,200
050,18,069,"Indiana","Huntington County",5,19,493,259,234
050,18,069,"Indiana","Huntington County",5,20,458,237,221
050,18,069,"Indiana","Huntington County",5,21,477,234,243
050,18,069,"Indiana","Huntington County",5,22,479,253,226
050,18,069,"Indiana","Huntington County",5,23,486,262,224
050,18,069,"Indiana","Huntington County",5,24,478,247,231
050,18,069,"Indiana","Huntington County",5,25,416,223,193
050,18,069,"Indiana","Huntington County",5,26,414,221,193
050,18,069,"Indiana","Huntington County",5,27,452,231,221
050,18,069,"Indiana","Huntington County",5,28,450,235,215
050,18,069,"Indiana","Huntington County",5,29,509,264,245
050,18,069,"Indiana","Huntington County",5,30,469,251,218
050,18,069,"Indiana","Huntington County",5,31,450,227,223
050,18,069,"Indiana","Huntington County",5,32,460,236,224
050,18,069,"Indiana","Huntington County",5,33,443,231,212
050,18,069,"Indiana","Huntington County",5,34,470,241,229
050,18,069,"Indiana","Huntington County",5,35,444,231,213
050,18,069,"Indiana","Huntington County",5,36,426,228,198
050,18,069,"Indiana","Huntington County",5,37,468,226,242
050,18,069,"Indiana","Huntington County",5,38,444,222,222
050,18,069,"Indiana","Huntington County",5,39,452,242,210
050,18,069,"Indiana","Huntington County",5,40,428,219,209
050,18,069,"Indiana","Huntington County",5,41,417,196,221
050,18,069,"Indiana","Huntington County",5,42,455,234,221
050,18,069,"Indiana","Huntington County",5,43,467,238,229
050,18,069,"Indiana","Huntington County",5,44,453,233,220
050,18,069,"Indiana","Huntington County",5,45,468,248,220
050,18,069,"Indiana","Huntington County",5,46,427,214,213
050,18,069,"Indiana","Huntington County",5,47,431,200,231
050,18,069,"Indiana","Huntington County",5,48,441,221,220
050,18,069,"Indiana","Huntington County",5,49,410,213,197
050,18,069,"Indiana","Huntington County",5,50,425,207,218
050,18,069,"Indiana","Huntington County",5,51,451,216,235
050,18,069,"Indiana","Huntington County",5,52,468,249,219
050,18,069,"Indiana","Huntington County",5,53,456,260,196
050,18,069,"Indiana","Huntington County",5,54,432,228,204
050,18,069,"Indiana","Huntington County",5,55,459,234,225
050,18,069,"Indiana","Huntington County",5,56,461,224,237
050,18,069,"Indiana","Huntington County",5,57,476,228,248
050,18,069,"Indiana","Huntington County",5,58,495,236,259
050,18,069,"Indiana","Huntington County",5,59,547,261,286
050,18,069,"Indiana","Huntington County",5,60,548,269,279
050,18,069,"Indiana","Huntington County",5,61,526,264,262
050,18,069,"Indiana","Huntington County",5,62,556,289,267
050,18,069,"Indiana","Huntington County",5,63,519,267,252
050,18,069,"Indiana","Huntington County",5,64,535,266,269
050,18,069,"Indiana","Huntington County",5,65,533,262,271
050,18,069,"Indiana","Huntington County",5,66,511,251,260
050,18,069,"Indiana","Huntington County",5,67,485,241,244
050,18,069,"Indiana","Huntington County",5,68,474,230,244
050,18,069,"Indiana","Huntington County",5,69,446,217,229
050,18,069,"Indiana","Huntington County",5,70,411,197,214
050,18,069,"Indiana","Huntington County",5,71,366,178,188
050,18,069,"Indiana","Huntington County",5,72,346,169,177
050,18,069,"Indiana","Huntington County",5,73,323,150,173
050,18,069,"Indiana","Huntington County",5,74,275,123,152
050,18,069,"Indiana","Huntington County",5,75,278,130,148
050,18,069,"Indiana","Huntington County",5,76,332,152,180
050,18,069,"Indiana","Huntington County",5,77,220,102,118
050,18,069,"Indiana","Huntington County",5,78,211,96,115
050,18,069,"Indiana","Huntington County",5,79,181,74,107
050,18,069,"Indiana","Huntington County",5,80,206,85,121
050,18,069,"Indiana","Huntington County",5,81,184,74,110
050,18,069,"Indiana","Huntington County",5,82,153,53,100
050,18,069,"Indiana","Huntington County",5,83,155,59,96
050,18,069,"Indiana","Huntington County",5,84,136,55,81
050,18,069,"Indiana","Huntington County",5,85,794,211,583
050,18,071,"Indiana","Jackson County",1,0,686,350,336
050,18,071,"Indiana","Jackson County",1,1,680,352,328
050,18,071,"Indiana","Jackson County",1,2,688,334,354
050,18,071,"Indiana","Jackson County",1,3,697,364,333
050,18,071,"Indiana","Jackson County",1,4,633,330,303
050,18,071,"Indiana","Jackson County",1,5,661,344,317
050,18,071,"Indiana","Jackson County",1,6,676,350,326
050,18,071,"Indiana","Jackson County",1,7,681,352,329
050,18,071,"Indiana","Jackson County",1,8,607,319,288
050,18,071,"Indiana","Jackson County",1,9,648,339,309
050,18,071,"Indiana","Jackson County",1,10,641,341,300
050,18,071,"Indiana","Jackson County",1,11,657,338,319
050,18,071,"Indiana","Jackson County",1,12,704,345,359
050,18,071,"Indiana","Jackson County",1,13,718,375,343
050,18,071,"Indiana","Jackson County",1,14,705,378,327
050,18,071,"Indiana","Jackson County",1,15,664,343,321
050,18,071,"Indiana","Jackson County",1,16,674,346,328
050,18,071,"Indiana","Jackson County",1,17,685,348,337
050,18,071,"Indiana","Jackson County",1,18,587,307,280
050,18,071,"Indiana","Jackson County",1,19,470,246,224
050,18,071,"Indiana","Jackson County",1,20,474,247,227
050,18,071,"Indiana","Jackson County",1,21,481,248,233
050,18,071,"Indiana","Jackson County",1,22,505,263,242
050,18,071,"Indiana","Jackson County",1,23,510,278,232
050,18,071,"Indiana","Jackson County",1,24,568,288,280
050,18,071,"Indiana","Jackson County",1,25,559,285,274
050,18,071,"Indiana","Jackson County",1,26,535,271,264
050,18,071,"Indiana","Jackson County",1,27,561,275,286
050,18,071,"Indiana","Jackson County",1,28,557,285,272
050,18,071,"Indiana","Jackson County",1,29,566,284,282
050,18,071,"Indiana","Jackson County",1,30,547,278,269
050,18,071,"Indiana","Jackson County",1,31,553,260,293
050,18,071,"Indiana","Jackson County",1,32,559,282,277
050,18,071,"Indiana","Jackson County",1,33,533,268,265
050,18,071,"Indiana","Jackson County",1,34,573,310,263
050,18,071,"Indiana","Jackson County",1,35,575,315,260
050,18,071,"Indiana","Jackson County",1,36,592,329,263
050,18,071,"Indiana","Jackson County",1,37,547,293,254
050,18,071,"Indiana","Jackson County",1,38,601,320,281
050,18,071,"Indiana","Jackson County",1,39,640,340,300
050,18,071,"Indiana","Jackson County",1,40,670,355,315
050,18,071,"Indiana","Jackson County",1,41,644,333,311
050,18,071,"Indiana","Jackson County",1,42,599,289,310
050,18,071,"Indiana","Jackson County",1,43,535,274,261
050,18,071,"Indiana","Jackson County",1,44,574,298,276
050,18,071,"Indiana","Jackson County",1,45,559,302,257
050,18,071,"Indiana","Jackson County",1,46,581,316,265
050,18,071,"Indiana","Jackson County",1,47,616,326,290
050,18,071,"Indiana","Jackson County",1,48,593,307,286
050,18,071,"Indiana","Jackson County",1,49,633,341,292
050,18,071,"Indiana","Jackson County",1,50,612,337,275
050,18,071,"Indiana","Jackson County",1,51,576,322,254
050,18,071,"Indiana","Jackson County",1,52,554,290,264
050,18,071,"Indiana","Jackson County",1,53,552,270,282
050,18,071,"Indiana","Jackson County",1,54,605,301,304
050,18,071,"Indiana","Jackson County",1,55,622,316,306
050,18,071,"Indiana","Jackson County",1,56,637,329,308
050,18,071,"Indiana","Jackson County",1,57,608,305,303
050,18,071,"Indiana","Jackson County",1,58,606,295,311
050,18,071,"Indiana","Jackson County",1,59,632,319,313
050,18,071,"Indiana","Jackson County",1,60,578,290,288
050,18,071,"Indiana","Jackson County",1,61,587,289,298
050,18,071,"Indiana","Jackson County",1,62,619,303,316
050,18,071,"Indiana","Jackson County",1,63,568,279,289
050,18,071,"Indiana","Jackson County",1,64,551,258,293
050,18,071,"Indiana","Jackson County",1,65,530,256,274
050,18,071,"Indiana","Jackson County",1,66,490,244,246
050,18,071,"Indiana","Jackson County",1,67,452,227,225
050,18,071,"Indiana","Jackson County",1,68,446,219,227
050,18,071,"Indiana","Jackson County",1,69,426,196,230
050,18,071,"Indiana","Jackson County",1,70,395,189,206
050,18,071,"Indiana","Jackson County",1,71,385,181,204
050,18,071,"Indiana","Jackson County",1,72,395,177,218
050,18,071,"Indiana","Jackson County",1,73,428,194,234
050,18,071,"Indiana","Jackson County",1,74,312,139,173
050,18,071,"Indiana","Jackson County",1,75,279,121,158
050,18,071,"Indiana","Jackson County",1,76,308,136,172
050,18,071,"Indiana","Jackson County",1,77,291,140,151
050,18,071,"Indiana","Jackson County",1,78,243,112,131
050,18,071,"Indiana","Jackson County",1,79,224,97,127
050,18,071,"Indiana","Jackson County",1,80,209,99,110
050,18,071,"Indiana","Jackson County",1,81,198,84,114
050,18,071,"Indiana","Jackson County",1,82,186,85,101
050,18,071,"Indiana","Jackson County",1,83,154,53,101
050,18,071,"Indiana","Jackson County",1,84,141,49,92
050,18,071,"Indiana","Jackson County",1,85,835,289,546
050,18,071,"Indiana","Jackson County",2,0,687,367,320
050,18,071,"Indiana","Jackson County",2,1,680,352,328
050,18,071,"Indiana","Jackson County",2,2,682,338,344
050,18,071,"Indiana","Jackson County",2,3,688,352,336
050,18,071,"Indiana","Jackson County",2,4,651,339,312
050,18,071,"Indiana","Jackson County",2,5,656,342,314
050,18,071,"Indiana","Jackson County",2,6,676,351,325
050,18,071,"Indiana","Jackson County",2,7,679,350,329
050,18,071,"Indiana","Jackson County",2,8,628,327,301
050,18,071,"Indiana","Jackson County",2,9,645,338,307
050,18,071,"Indiana","Jackson County",2,10,640,338,302
050,18,071,"Indiana","Jackson County",2,11,649,337,312
050,18,071,"Indiana","Jackson County",2,12,698,346,352
050,18,071,"Indiana","Jackson County",2,13,716,369,347
050,18,071,"Indiana","Jackson County",2,14,708,376,332
050,18,071,"Indiana","Jackson County",2,15,675,351,324
050,18,071,"Indiana","Jackson County",2,16,672,346,326
050,18,071,"Indiana","Jackson County",2,17,683,348,335
050,18,071,"Indiana","Jackson County",2,18,581,303,278
050,18,071,"Indiana","Jackson County",2,19,475,248,227
050,18,071,"Indiana","Jackson County",2,20,487,250,237
050,18,071,"Indiana","Jackson County",2,21,487,251,236
050,18,071,"Indiana","Jackson County",2,22,504,262,242
050,18,071,"Indiana","Jackson County",2,23,519,278,241
050,18,071,"Indiana","Jackson County",2,24,557,289,268
050,18,071,"Indiana","Jackson County",2,25,555,284,271
050,18,071,"Indiana","Jackson County",2,26,536,269,267
050,18,071,"Indiana","Jackson County",2,27,547,272,275
050,18,071,"Indiana","Jackson County",2,28,552,279,273
050,18,071,"Indiana","Jackson County",2,29,564,284,280
050,18,071,"Indiana","Jackson County",2,30,554,278,276
050,18,071,"Indiana","Jackson County",2,31,551,266,285
050,18,071,"Indiana","Jackson County",2,32,557,276,281
050,18,071,"Indiana","Jackson County",2,33,541,272,269
050,18,071,"Indiana","Jackson County",2,34,559,298,261
050,18,071,"Indiana","Jackson County",2,35,575,312,263
050,18,071,"Indiana","Jackson County",2,36,580,319,261
050,18,071,"Indiana","Jackson County",2,37,559,302,257
050,18,071,"Indiana","Jackson County",2,38,590,317,273
050,18,071,"Indiana","Jackson County",2,39,626,332,294
050,18,071,"Indiana","Jackson County",2,40,671,356,315
050,18,071,"Indiana","Jackson County",2,41,645,336,309
050,18,071,"Indiana","Jackson County",2,42,604,299,305
050,18,071,"Indiana","Jackson County",2,43,554,277,277
050,18,071,"Indiana","Jackson County",2,44,557,288,269
050,18,071,"Indiana","Jackson County",2,45,564,301,263
050,18,071,"Indiana","Jackson County",2,46,575,313,262
050,18,071,"Indiana","Jackson County",2,47,607,323,284
050,18,071,"Indiana","Jackson County",2,48,602,314,288
050,18,071,"Indiana","Jackson County",2,49,629,336,293
050,18,071,"Indiana","Jackson County",2,50,618,337,281
050,18,071,"Indiana","Jackson County",2,51,582,324,258
050,18,071,"Indiana","Jackson County",2,52,558,299,259
050,18,071,"Indiana","Jackson County",2,53,551,272,279
050,18,071,"Indiana","Jackson County",2,54,593,295,298
050,18,071,"Indiana","Jackson County",2,55,619,314,305
050,18,071,"Indiana","Jackson County",2,56,635,327,308
050,18,071,"Indiana","Jackson County",2,57,619,312,307
050,18,071,"Indiana","Jackson County",2,58,604,295,309
050,18,071,"Indiana","Jackson County",2,59,625,311,314
050,18,071,"Indiana","Jackson County",2,60,590,297,293
050,18,071,"Indiana","Jackson County",2,61,583,288,295
050,18,071,"Indiana","Jackson County",2,62,608,299,309
050,18,071,"Indiana","Jackson County",2,63,586,287,299
050,18,071,"Indiana","Jackson County",2,64,548,261,287
050,18,071,"Indiana","Jackson County",2,65,535,256,279
050,18,071,"Indiana","Jackson County",2,66,499,246,253
050,18,071,"Indiana","Jackson County",2,67,457,229,228
050,18,071,"Indiana","Jackson County",2,68,444,219,225
050,18,071,"Indiana","Jackson County",2,69,431,200,231
050,18,071,"Indiana","Jackson County",2,70,400,189,211
050,18,071,"Indiana","Jackson County",2,71,386,180,206
050,18,071,"Indiana","Jackson County",2,72,383,174,209
050,18,071,"Indiana","Jackson County",2,73,441,200,241
050,18,071,"Indiana","Jackson County",2,74,320,143,177
050,18,071,"Indiana","Jackson County",2,75,283,122,161
050,18,071,"Indiana","Jackson County",2,76,298,132,166
050,18,071,"Indiana","Jackson County",2,77,302,143,159
050,18,071,"Indiana","Jackson County",2,78,249,115,134
050,18,071,"Indiana","Jackson County",2,79,224,100,124
050,18,071,"Indiana","Jackson County",2,80,210,96,114
050,18,071,"Indiana","Jackson County",2,81,193,84,109
050,18,071,"Indiana","Jackson County",2,82,186,83,103
050,18,071,"Indiana","Jackson County",2,83,160,59,101
050,18,071,"Indiana","Jackson County",2,84,140,49,91
050,18,071,"Indiana","Jackson County",2,85,842,291,551
050,18,071,"Indiana","Jackson County",3,0,600,325,275
050,18,071,"Indiana","Jackson County",3,1,710,374,336
050,18,071,"Indiana","Jackson County",3,2,659,347,312
050,18,071,"Indiana","Jackson County",3,3,678,348,330
050,18,071,"Indiana","Jackson County",3,4,675,350,325
050,18,071,"Indiana","Jackson County",3,5,625,319,306
050,18,071,"Indiana","Jackson County",3,6,639,337,302
050,18,071,"Indiana","Jackson County",3,7,647,345,302
050,18,071,"Indiana","Jackson County",3,8,662,339,323
050,18,071,"Indiana","Jackson County",3,9,621,320,301
050,18,071,"Indiana","Jackson County",3,10,645,332,313
050,18,071,"Indiana","Jackson County",3,11,635,331,304
050,18,071,"Indiana","Jackson County",3,12,653,344,309
050,18,071,"Indiana","Jackson County",3,13,726,360,366
050,18,071,"Indiana","Jackson County",3,14,714,358,356
050,18,071,"Indiana","Jackson County",3,15,722,392,330
050,18,071,"Indiana","Jackson County",3,16,665,348,317
050,18,071,"Indiana","Jackson County",3,17,668,345,323
050,18,071,"Indiana","Jackson County",3,18,567,300,267
050,18,071,"Indiana","Jackson County",3,19,457,250,207
050,18,071,"Indiana","Jackson County",3,20,493,260,233
050,18,071,"Indiana","Jackson County",3,21,522,264,258
050,18,071,"Indiana","Jackson County",3,22,497,248,249
050,18,071,"Indiana","Jackson County",3,23,511,265,246
050,18,071,"Indiana","Jackson County",3,24,524,292,232
050,18,071,"Indiana","Jackson County",3,25,544,284,260
050,18,071,"Indiana","Jackson County",3,26,543,265,278
050,18,071,"Indiana","Jackson County",3,27,542,279,263
050,18,071,"Indiana","Jackson County",3,28,528,259,269
050,18,071,"Indiana","Jackson County",3,29,606,316,290
050,18,071,"Indiana","Jackson County",3,30,545,277,268
050,18,071,"Indiana","Jackson County",3,31,546,270,276
050,18,071,"Indiana","Jackson County",3,32,552,268,284
050,18,071,"Indiana","Jackson County",3,33,572,289,283
050,18,071,"Indiana","Jackson County",3,34,521,257,264
050,18,071,"Indiana","Jackson County",3,35,552,294,258
050,18,071,"Indiana","Jackson County",3,36,571,308,263
050,18,071,"Indiana","Jackson County",3,37,566,316,250
050,18,071,"Indiana","Jackson County",3,38,571,306,265
050,18,071,"Indiana","Jackson County",3,39,581,314,267
050,18,071,"Indiana","Jackson County",3,40,623,333,290
050,18,071,"Indiana","Jackson County",3,41,660,352,308
050,18,071,"Indiana","Jackson County",3,42,645,342,303
050,18,071,"Indiana","Jackson County",3,43,593,286,307
050,18,071,"Indiana","Jackson County",3,44,548,274,274
050,18,071,"Indiana","Jackson County",3,45,529,271,258
050,18,071,"Indiana","Jackson County",3,46,567,306,261
050,18,071,"Indiana","Jackson County",3,47,559,298,261
050,18,071,"Indiana","Jackson County",3,48,600,322,278
050,18,071,"Indiana","Jackson County",3,49,585,305,280
050,18,071,"Indiana","Jackson County",3,50,642,338,304
050,18,071,"Indiana","Jackson County",3,51,620,341,279
050,18,071,"Indiana","Jackson County",3,52,586,317,269
050,18,071,"Indiana","Jackson County",3,53,564,305,259
050,18,071,"Indiana","Jackson County",3,54,549,276,273
050,18,071,"Indiana","Jackson County",3,55,583,293,290
050,18,071,"Indiana","Jackson County",3,56,624,313,311
050,18,071,"Indiana","Jackson County",3,57,628,321,307
050,18,071,"Indiana","Jackson County",3,58,600,303,297
050,18,071,"Indiana","Jackson County",3,59,598,287,311
050,18,071,"Indiana","Jackson County",3,60,622,316,306
050,18,071,"Indiana","Jackson County",3,61,579,296,283
050,18,071,"Indiana","Jackson County",3,62,569,276,293
050,18,071,"Indiana","Jackson County",3,63,599,293,306
050,18,071,"Indiana","Jackson County",3,64,586,290,296
050,18,071,"Indiana","Jackson County",3,65,540,249,291
050,18,071,"Indiana","Jackson County",3,66,530,247,283
050,18,071,"Indiana","Jackson County",3,67,482,235,247
050,18,071,"Indiana","Jackson County",3,68,453,230,223
050,18,071,"Indiana","Jackson County",3,69,428,204,224
050,18,071,"Indiana","Jackson County",3,70,424,197,227
050,18,071,"Indiana","Jackson County",3,71,391,182,209
050,18,071,"Indiana","Jackson County",3,72,369,172,197
050,18,071,"Indiana","Jackson County",3,73,362,159,203
050,18,071,"Indiana","Jackson County",3,74,427,193,234
050,18,071,"Indiana","Jackson County",3,75,304,135,169
050,18,071,"Indiana","Jackson County",3,76,268,117,151
050,18,071,"Indiana","Jackson County",3,77,292,135,157
050,18,071,"Indiana","Jackson County",3,78,294,132,162
050,18,071,"Indiana","Jackson County",3,79,228,110,118
050,18,071,"Indiana","Jackson County",3,80,212,88,124
050,18,071,"Indiana","Jackson County",3,81,194,85,109
050,18,071,"Indiana","Jackson County",3,82,170,76,94
050,18,071,"Indiana","Jackson County",3,83,158,65,93
050,18,071,"Indiana","Jackson County",3,84,146,57,89
050,18,071,"Indiana","Jackson County",3,85,839,283,556
050,18,071,"Indiana","Jackson County",4,0,630,332,298
050,18,071,"Indiana","Jackson County",4,1,612,326,286
050,18,071,"Indiana","Jackson County",4,2,720,387,333
050,18,071,"Indiana","Jackson County",4,3,674,375,299
050,18,071,"Indiana","Jackson County",4,4,700,363,337
050,18,071,"Indiana","Jackson County",4,5,687,356,331
050,18,071,"Indiana","Jackson County",4,6,639,322,317
050,18,071,"Indiana","Jackson County",4,7,639,337,302
050,18,071,"Indiana","Jackson County",4,8,641,322,319
050,18,071,"Indiana","Jackson County",4,9,660,348,312
050,18,071,"Indiana","Jackson County",4,10,615,311,304
050,18,071,"Indiana","Jackson County",4,11,636,324,312
050,18,071,"Indiana","Jackson County",4,12,631,331,300
050,18,071,"Indiana","Jackson County",4,13,660,347,313
050,18,071,"Indiana","Jackson County",4,14,707,354,353
050,18,071,"Indiana","Jackson County",4,15,685,354,331
050,18,071,"Indiana","Jackson County",4,16,710,381,329
050,18,071,"Indiana","Jackson County",4,17,669,351,318
050,18,071,"Indiana","Jackson County",4,18,575,305,270
050,18,071,"Indiana","Jackson County",4,19,456,242,214
050,18,071,"Indiana","Jackson County",4,20,464,252,212
050,18,071,"Indiana","Jackson County",4,21,519,271,248
050,18,071,"Indiana","Jackson County",4,22,542,259,283
050,18,071,"Indiana","Jackson County",4,23,497,259,238
050,18,071,"Indiana","Jackson County",4,24,526,276,250
050,18,071,"Indiana","Jackson County",4,25,532,284,248
050,18,071,"Indiana","Jackson County",4,26,527,276,251
050,18,071,"Indiana","Jackson County",4,27,583,294,289
050,18,071,"Indiana","Jackson County",4,28,521,267,254
050,18,071,"Indiana","Jackson County",4,29,524,259,265
050,18,071,"Indiana","Jackson County",4,30,595,299,296
050,18,071,"Indiana","Jackson County",4,31,554,280,274
050,18,071,"Indiana","Jackson County",4,32,550,277,273
050,18,071,"Indiana","Jackson County",4,33,565,279,286
050,18,071,"Indiana","Jackson County",4,34,569,286,283
050,18,071,"Indiana","Jackson County",4,35,515,251,264
050,18,071,"Indiana","Jackson County",4,36,559,300,259
050,18,071,"Indiana","Jackson County",4,37,565,309,256
050,18,071,"Indiana","Jackson County",4,38,569,325,244
050,18,071,"Indiana","Jackson County",4,39,556,290,266
050,18,071,"Indiana","Jackson County",4,40,589,320,269
050,18,071,"Indiana","Jackson County",4,41,631,334,297
050,18,071,"Indiana","Jackson County",4,42,662,353,309
050,18,071,"Indiana","Jackson County",4,43,631,333,298
050,18,071,"Indiana","Jackson County",4,44,584,287,297
050,18,071,"Indiana","Jackson County",4,45,560,279,281
050,18,071,"Indiana","Jackson County",4,46,534,271,263
050,18,071,"Indiana","Jackson County",4,47,566,301,265
050,18,071,"Indiana","Jackson County",4,48,539,282,257
050,18,071,"Indiana","Jackson County",4,49,572,307,265
050,18,071,"Indiana","Jackson County",4,50,589,302,287
050,18,071,"Indiana","Jackson County",4,51,633,326,307
050,18,071,"Indiana","Jackson County",4,52,621,345,276
050,18,071,"Indiana","Jackson County",4,53,559,311,248
050,18,071,"Indiana","Jackson County",4,54,580,305,275
050,18,071,"Indiana","Jackson County",4,55,541,269,272
050,18,071,"Indiana","Jackson County",4,56,581,292,289
050,18,071,"Indiana","Jackson County",4,57,628,318,310
050,18,071,"Indiana","Jackson County",4,58,620,316,304
050,18,071,"Indiana","Jackson County",4,59,600,303,297
050,18,071,"Indiana","Jackson County",4,60,580,286,294
050,18,071,"Indiana","Jackson County",4,61,610,308,302
050,18,071,"Indiana","Jackson County",4,62,562,285,277
050,18,071,"Indiana","Jackson County",4,63,567,276,291
050,18,071,"Indiana","Jackson County",4,64,595,291,304
050,18,071,"Indiana","Jackson County",4,65,554,269,285
050,18,071,"Indiana","Jackson County",4,66,533,238,295
050,18,071,"Indiana","Jackson County",4,67,509,236,273
050,18,071,"Indiana","Jackson County",4,68,470,233,237
050,18,071,"Indiana","Jackson County",4,69,437,217,220
050,18,071,"Indiana","Jackson County",4,70,426,204,222
050,18,071,"Indiana","Jackson County",4,71,418,189,229
050,18,071,"Indiana","Jackson County",4,72,374,176,198
050,18,071,"Indiana","Jackson County",4,73,356,163,193
050,18,071,"Indiana","Jackson County",4,74,362,159,203
050,18,071,"Indiana","Jackson County",4,75,420,187,233
050,18,071,"Indiana","Jackson County",4,76,292,133,159
050,18,071,"Indiana","Jackson County",4,77,262,121,141
050,18,071,"Indiana","Jackson County",4,78,279,123,156
050,18,071,"Indiana","Jackson County",4,79,283,131,152
050,18,071,"Indiana","Jackson County",4,80,215,102,113
050,18,071,"Indiana","Jackson County",4,81,202,80,122
050,18,071,"Indiana","Jackson County",4,82,171,80,91
050,18,071,"Indiana","Jackson County",4,83,144,56,88
050,18,071,"Indiana","Jackson County",4,84,147,64,83
050,18,071,"Indiana","Jackson County",4,85,864,294,570
050,18,071,"Indiana","Jackson County",5,0,634,337,297
050,18,071,"Indiana","Jackson County",5,1,625,320,305
050,18,071,"Indiana","Jackson County",5,2,623,339,284
050,18,071,"Indiana","Jackson County",5,3,763,410,353
050,18,071,"Indiana","Jackson County",5,4,698,381,317
050,18,071,"Indiana","Jackson County",5,5,696,364,332
050,18,071,"Indiana","Jackson County",5,6,683,352,331
050,18,071,"Indiana","Jackson County",5,7,647,328,319
050,18,071,"Indiana","Jackson County",5,8,624,333,291
050,18,071,"Indiana","Jackson County",5,9,643,325,318
050,18,071,"Indiana","Jackson County",5,10,647,341,306
050,18,071,"Indiana","Jackson County",5,11,605,318,287
050,18,071,"Indiana","Jackson County",5,12,648,338,310
050,18,071,"Indiana","Jackson County",5,13,617,330,287
050,18,071,"Indiana","Jackson County",5,14,655,345,310
050,18,071,"Indiana","Jackson County",5,15,706,355,351
050,18,071,"Indiana","Jackson County",5,16,690,354,336
050,18,071,"Indiana","Jackson County",5,17,710,388,322
050,18,071,"Indiana","Jackson County",5,18,587,327,260
050,18,071,"Indiana","Jackson County",5,19,465,240,225
050,18,071,"Indiana","Jackson County",5,20,493,256,237
050,18,071,"Indiana","Jackson County",5,21,499,267,232
050,18,071,"Indiana","Jackson County",5,22,568,284,284
050,18,071,"Indiana","Jackson County",5,23,541,265,276
050,18,071,"Indiana","Jackson County",5,24,541,275,266
050,18,071,"Indiana","Jackson County",5,25,546,283,263
050,18,071,"Indiana","Jackson County",5,26,524,280,244
050,18,071,"Indiana","Jackson County",5,27,556,300,256
050,18,071,"Indiana","Jackson County",5,28,542,270,272
050,18,071,"Indiana","Jackson County",5,29,540,277,263
050,18,071,"Indiana","Jackson County",5,30,526,252,274
050,18,071,"Indiana","Jackson County",5,31,563,285,278
050,18,071,"Indiana","Jackson County",5,32,558,277,281
050,18,071,"Indiana","Jackson County",5,33,574,280,294
050,18,071,"Indiana","Jackson County",5,34,550,267,283
050,18,071,"Indiana","Jackson County",5,35,569,283,286
050,18,071,"Indiana","Jackson County",5,36,520,258,262
050,18,071,"Indiana","Jackson County",5,37,578,312,266
050,18,071,"Indiana","Jackson County",5,38,570,320,250
050,18,071,"Indiana","Jackson County",5,39,569,325,244
050,18,071,"Indiana","Jackson County",5,40,552,293,259
050,18,071,"Indiana","Jackson County",5,41,584,313,271
050,18,071,"Indiana","Jackson County",5,42,632,341,291
050,18,071,"Indiana","Jackson County",5,43,665,350,315
050,18,071,"Indiana","Jackson County",5,44,648,349,299
050,18,071,"Indiana","Jackson County",5,45,575,281,294
050,18,071,"Indiana","Jackson County",5,46,564,282,282
050,18,071,"Indiana","Jackson County",5,47,516,257,259
050,18,071,"Indiana","Jackson County",5,48,560,294,266
050,18,071,"Indiana","Jackson County",5,49,543,283,260
050,18,071,"Indiana","Jackson County",5,50,567,299,268
050,18,071,"Indiana","Jackson County",5,51,567,284,283
050,18,071,"Indiana","Jackson County",5,52,648,340,308
050,18,071,"Indiana","Jackson County",5,53,609,342,267
050,18,071,"Indiana","Jackson County",5,54,567,312,255
050,18,071,"Indiana","Jackson County",5,55,583,302,281
050,18,071,"Indiana","Jackson County",5,56,528,261,267
050,18,071,"Indiana","Jackson County",5,57,584,292,292
050,18,071,"Indiana","Jackson County",5,58,620,308,312
050,18,071,"Indiana","Jackson County",5,59,611,310,301
050,18,071,"Indiana","Jackson County",5,60,589,298,291
050,18,071,"Indiana","Jackson County",5,61,579,285,294
050,18,071,"Indiana","Jackson County",5,62,602,301,301
050,18,071,"Indiana","Jackson County",5,63,559,279,280
050,18,071,"Indiana","Jackson County",5,64,562,279,283
050,18,071,"Indiana","Jackson County",5,65,571,276,295
050,18,071,"Indiana","Jackson County",5,66,553,266,287
050,18,071,"Indiana","Jackson County",5,67,517,231,286
050,18,071,"Indiana","Jackson County",5,68,504,237,267
050,18,071,"Indiana","Jackson County",5,69,464,222,242
050,18,071,"Indiana","Jackson County",5,70,431,215,216
050,18,071,"Indiana","Jackson County",5,71,423,195,228
050,18,071,"Indiana","Jackson County",5,72,397,179,218
050,18,071,"Indiana","Jackson County",5,73,364,167,197
050,18,071,"Indiana","Jackson County",5,74,343,156,187
050,18,071,"Indiana","Jackson County",5,75,349,152,197
050,18,071,"Indiana","Jackson County",5,76,405,184,221
050,18,071,"Indiana","Jackson County",5,77,281,133,148
050,18,071,"Indiana","Jackson County",5,78,256,110,146
050,18,071,"Indiana","Jackson County",5,79,262,119,143
050,18,071,"Indiana","Jackson County",5,80,269,125,144
050,18,071,"Indiana","Jackson County",5,81,205,94,111
050,18,071,"Indiana","Jackson County",5,82,184,79,105
050,18,071,"Indiana","Jackson County",5,83,149,66,83
050,18,071,"Indiana","Jackson County",5,84,127,53,74
050,18,071,"Indiana","Jackson County",5,85,899,321,578
050,18,073,"Indiana","Jasper County",1,0,359,182,177
050,18,073,"Indiana","Jasper County",1,1,352,188,164
050,18,073,"Indiana","Jasper County",1,2,357,207,150
050,18,073,"Indiana","Jasper County",1,3,396,220,176
050,18,073,"Indiana","Jasper County",1,4,408,221,187
050,18,073,"Indiana","Jasper County",1,5,409,209,200
050,18,073,"Indiana","Jasper County",1,6,387,198,189
050,18,073,"Indiana","Jasper County",1,7,422,207,215
050,18,073,"Indiana","Jasper County",1,8,449,230,219
050,18,073,"Indiana","Jasper County",1,9,406,199,207
050,18,073,"Indiana","Jasper County",1,10,432,216,216
050,18,073,"Indiana","Jasper County",1,11,437,222,215
050,18,073,"Indiana","Jasper County",1,12,476,239,237
050,18,073,"Indiana","Jasper County",1,13,503,250,253
050,18,073,"Indiana","Jasper County",1,14,463,242,221
050,18,073,"Indiana","Jasper County",1,15,503,260,243
050,18,073,"Indiana","Jasper County",1,16,501,250,251
050,18,073,"Indiana","Jasper County",1,17,498,242,256
050,18,073,"Indiana","Jasper County",1,18,400,209,191
050,18,073,"Indiana","Jasper County",1,19,316,164,152
050,18,073,"Indiana","Jasper County",1,20,365,193,172
050,18,073,"Indiana","Jasper County",1,21,374,201,173
050,18,073,"Indiana","Jasper County",1,22,347,176,171
050,18,073,"Indiana","Jasper County",1,23,356,182,174
050,18,073,"Indiana","Jasper County",1,24,367,189,178
050,18,073,"Indiana","Jasper County",1,25,381,203,178
050,18,073,"Indiana","Jasper County",1,26,364,197,167
050,18,073,"Indiana","Jasper County",1,27,400,198,202
050,18,073,"Indiana","Jasper County",1,28,412,204,208
050,18,073,"Indiana","Jasper County",1,29,383,189,194
050,18,073,"Indiana","Jasper County",1,30,376,183,193
050,18,073,"Indiana","Jasper County",1,31,363,183,180
050,18,073,"Indiana","Jasper County",1,32,367,195,172
050,18,073,"Indiana","Jasper County",1,33,354,173,181
050,18,073,"Indiana","Jasper County",1,34,360,173,187
050,18,073,"Indiana","Jasper County",1,35,338,168,170
050,18,073,"Indiana","Jasper County",1,36,373,183,190
050,18,073,"Indiana","Jasper County",1,37,400,202,198
050,18,073,"Indiana","Jasper County",1,38,417,211,206
050,18,073,"Indiana","Jasper County",1,39,439,224,215
050,18,073,"Indiana","Jasper County",1,40,406,211,195
050,18,073,"Indiana","Jasper County",1,41,423,225,198
050,18,073,"Indiana","Jasper County",1,42,426,216,210
050,18,073,"Indiana","Jasper County",1,43,430,220,210
050,18,073,"Indiana","Jasper County",1,44,416,197,219
050,18,073,"Indiana","Jasper County",1,45,423,220,203
050,18,073,"Indiana","Jasper County",1,46,395,208,187
050,18,073,"Indiana","Jasper County",1,47,416,205,211
050,18,073,"Indiana","Jasper County",1,48,421,202,219
050,18,073,"Indiana","Jasper County",1,49,442,227,215
050,18,073,"Indiana","Jasper County",1,50,417,215,202
050,18,073,"Indiana","Jasper County",1,51,397,202,195
050,18,073,"Indiana","Jasper County",1,52,406,216,190
050,18,073,"Indiana","Jasper County",1,53,410,219,191
050,18,073,"Indiana","Jasper County",1,54,413,205,208
050,18,073,"Indiana","Jasper County",1,55,441,211,230
050,18,073,"Indiana","Jasper County",1,56,457,221,236
050,18,073,"Indiana","Jasper County",1,57,474,231,243
050,18,073,"Indiana","Jasper County",1,58,496,240,256
050,18,073,"Indiana","Jasper County",1,59,532,274,258
050,18,073,"Indiana","Jasper County",1,60,503,255,248
050,18,073,"Indiana","Jasper County",1,61,479,255,224
050,18,073,"Indiana","Jasper County",1,62,460,229,231
050,18,073,"Indiana","Jasper County",1,63,463,240,223
050,18,073,"Indiana","Jasper County",1,64,432,217,215
050,18,073,"Indiana","Jasper County",1,65,425,203,222
050,18,073,"Indiana","Jasper County",1,66,411,194,217
050,18,073,"Indiana","Jasper County",1,67,385,184,201
050,18,073,"Indiana","Jasper County",1,68,386,195,191
050,18,073,"Indiana","Jasper County",1,69,368,182,186
050,18,073,"Indiana","Jasper County",1,70,331,172,159
050,18,073,"Indiana","Jasper County",1,71,345,166,179
050,18,073,"Indiana","Jasper County",1,72,342,164,178
050,18,073,"Indiana","Jasper County",1,73,337,151,186
050,18,073,"Indiana","Jasper County",1,74,236,115,121
050,18,073,"Indiana","Jasper County",1,75,240,117,123
050,18,073,"Indiana","Jasper County",1,76,233,112,121
050,18,073,"Indiana","Jasper County",1,77,239,120,119
050,18,073,"Indiana","Jasper County",1,78,201,96,105
050,18,073,"Indiana","Jasper County",1,79,172,74,98
050,18,073,"Indiana","Jasper County",1,80,152,74,78
050,18,073,"Indiana","Jasper County",1,81,155,65,90
050,18,073,"Indiana","Jasper County",1,82,152,64,88
050,18,073,"Indiana","Jasper County",1,83,127,46,81
050,18,073,"Indiana","Jasper County",1,84,118,45,73
050,18,073,"Indiana","Jasper County",1,85,583,226,357
050,18,073,"Indiana","Jasper County",2,0,357,183,174
050,18,073,"Indiana","Jasper County",2,1,350,185,165
050,18,073,"Indiana","Jasper County",2,2,357,203,154
050,18,073,"Indiana","Jasper County",2,3,387,216,171
050,18,073,"Indiana","Jasper County",2,4,404,221,183
050,18,073,"Indiana","Jasper County",2,5,406,211,195
050,18,073,"Indiana","Jasper County",2,6,394,200,194
050,18,073,"Indiana","Jasper County",2,7,413,205,208
050,18,073,"Indiana","Jasper County",2,8,441,223,218
050,18,073,"Indiana","Jasper County",2,9,418,207,211
050,18,073,"Indiana","Jasper County",2,10,426,211,215
050,18,073,"Indiana","Jasper County",2,11,430,218,212
050,18,073,"Indiana","Jasper County",2,12,470,236,234
050,18,073,"Indiana","Jasper County",2,13,494,245,249
050,18,073,"Indiana","Jasper County",2,14,474,244,230
050,18,073,"Indiana","Jasper County",2,15,495,256,239
050,18,073,"Indiana","Jasper County",2,16,503,254,249
050,18,073,"Indiana","Jasper County",2,17,498,244,254
050,18,073,"Indiana","Jasper County",2,18,402,207,195
050,18,073,"Indiana","Jasper County",2,19,317,164,153
050,18,073,"Indiana","Jasper County",2,20,361,190,171
050,18,073,"Indiana","Jasper County",2,21,375,201,174
050,18,073,"Indiana","Jasper County",2,22,356,183,173
050,18,073,"Indiana","Jasper County",2,23,356,184,172
050,18,073,"Indiana","Jasper County",2,24,366,188,178
050,18,073,"Indiana","Jasper County",2,25,372,198,174
050,18,073,"Indiana","Jasper County",2,26,369,199,170
050,18,073,"Indiana","Jasper County",2,27,393,199,194
050,18,073,"Indiana","Jasper County",2,28,408,202,206
050,18,073,"Indiana","Jasper County",2,29,391,191,200
050,18,073,"Indiana","Jasper County",2,30,384,187,197
050,18,073,"Indiana","Jasper County",2,31,368,184,184
050,18,073,"Indiana","Jasper County",2,32,368,193,175
050,18,073,"Indiana","Jasper County",2,33,357,178,179
050,18,073,"Indiana","Jasper County",2,34,355,172,183
050,18,073,"Indiana","Jasper County",2,35,346,171,175
050,18,073,"Indiana","Jasper County",2,36,361,178,183
050,18,073,"Indiana","Jasper County",2,37,394,196,198
050,18,073,"Indiana","Jasper County",2,38,412,209,203
050,18,073,"Indiana","Jasper County",2,39,433,220,213
050,18,073,"Indiana","Jasper County",2,40,416,216,200
050,18,073,"Indiana","Jasper County",2,41,421,222,199
050,18,073,"Indiana","Jasper County",2,42,426,219,207
050,18,073,"Indiana","Jasper County",2,43,434,220,214
050,18,073,"Indiana","Jasper County",2,44,415,202,213
050,18,073,"Indiana","Jasper County",2,45,426,217,209
050,18,073,"Indiana","Jasper County",2,46,401,211,190
050,18,073,"Indiana","Jasper County",2,47,408,204,204
050,18,073,"Indiana","Jasper County",2,48,417,201,216
050,18,073,"Indiana","Jasper County",2,49,439,223,216
050,18,073,"Indiana","Jasper County",2,50,426,220,206
050,18,073,"Indiana","Jasper County",2,51,402,207,195
050,18,073,"Indiana","Jasper County",2,52,398,210,188
050,18,073,"Indiana","Jasper County",2,53,405,217,188
050,18,073,"Indiana","Jasper County",2,54,411,210,201
050,18,073,"Indiana","Jasper County",2,55,434,210,224
050,18,073,"Indiana","Jasper County",2,56,451,219,232
050,18,073,"Indiana","Jasper County",2,57,470,230,240
050,18,073,"Indiana","Jasper County",2,58,490,237,253
050,18,073,"Indiana","Jasper County",2,59,525,267,258
050,18,073,"Indiana","Jasper County",2,60,509,260,249
050,18,073,"Indiana","Jasper County",2,61,483,254,229
050,18,073,"Indiana","Jasper County",2,62,465,236,229
050,18,073,"Indiana","Jasper County",2,63,467,240,227
050,18,073,"Indiana","Jasper County",2,64,436,220,216
050,18,073,"Indiana","Jasper County",2,65,424,206,218
050,18,073,"Indiana","Jasper County",2,66,416,197,219
050,18,073,"Indiana","Jasper County",2,67,388,184,204
050,18,073,"Indiana","Jasper County",2,68,381,190,191
050,18,073,"Indiana","Jasper County",2,69,375,187,188
050,18,073,"Indiana","Jasper County",2,70,337,174,163
050,18,073,"Indiana","Jasper County",2,71,340,166,174
050,18,073,"Indiana","Jasper County",2,72,336,163,173
050,18,073,"Indiana","Jasper County",2,73,354,162,192
050,18,073,"Indiana","Jasper County",2,74,240,114,126
050,18,073,"Indiana","Jasper County",2,75,238,115,123
050,18,073,"Indiana","Jasper County",2,76,232,112,120
050,18,073,"Indiana","Jasper County",2,77,243,121,122
050,18,073,"Indiana","Jasper County",2,78,206,100,106
050,18,073,"Indiana","Jasper County",2,79,177,78,99
050,18,073,"Indiana","Jasper County",2,80,154,75,79
050,18,073,"Indiana","Jasper County",2,81,152,66,86
050,18,073,"Indiana","Jasper County",2,82,149,62,87
050,18,073,"Indiana","Jasper County",2,83,124,43,81
050,18,073,"Indiana","Jasper County",2,84,117,43,74
050,18,073,"Indiana","Jasper County",2,85,589,230,359
050,18,073,"Indiana","Jasper County",3,0,358,164,194
050,18,073,"Indiana","Jasper County",3,1,351,177,174
050,18,073,"Indiana","Jasper County",3,2,346,178,168
050,18,073,"Indiana","Jasper County",3,3,370,212,158
050,18,073,"Indiana","Jasper County",3,4,402,220,182
050,18,073,"Indiana","Jasper County",3,5,418,230,188
050,18,073,"Indiana","Jasper County",3,6,414,205,209
050,18,073,"Indiana","Jasper County",3,7,393,204,189
050,18,073,"Indiana","Jasper County",3,8,415,201,214
050,18,073,"Indiana","Jasper County",3,9,441,228,213
050,18,073,"Indiana","Jasper County",3,10,430,216,214
050,18,073,"Indiana","Jasper County",3,11,432,215,217
050,18,073,"Indiana","Jasper County",3,12,433,214,219
050,18,073,"Indiana","Jasper County",3,13,486,243,243
050,18,073,"Indiana","Jasper County",3,14,496,256,240
050,18,073,"Indiana","Jasper County",3,15,488,256,232
050,18,073,"Indiana","Jasper County",3,16,489,247,242
050,18,073,"Indiana","Jasper County",3,17,503,251,252
050,18,073,"Indiana","Jasper County",3,18,431,220,211
050,18,073,"Indiana","Jasper County",3,19,312,163,149
050,18,073,"Indiana","Jasper County",3,20,346,180,166
050,18,073,"Indiana","Jasper County",3,21,404,209,195
050,18,073,"Indiana","Jasper County",3,22,396,206,190
050,18,073,"Indiana","Jasper County",3,23,358,186,172
050,18,073,"Indiana","Jasper County",3,24,368,185,183
050,18,073,"Indiana","Jasper County",3,25,355,186,169
050,18,073,"Indiana","Jasper County",3,26,364,203,161
050,18,073,"Indiana","Jasper County",3,27,372,194,178
050,18,073,"Indiana","Jasper County",3,28,393,196,197
050,18,073,"Indiana","Jasper County",3,29,418,211,207
050,18,073,"Indiana","Jasper County",3,30,401,197,204
050,18,073,"Indiana","Jasper County",3,31,400,194,206
050,18,073,"Indiana","Jasper County",3,32,384,190,194
050,18,073,"Indiana","Jasper County",3,33,373,193,180
050,18,073,"Indiana","Jasper County",3,34,370,191,179
050,18,073,"Indiana","Jasper County",3,35,366,180,186
050,18,073,"Indiana","Jasper County",3,36,342,165,177
050,18,073,"Indiana","Jasper County",3,37,365,181,184
050,18,073,"Indiana","Jasper County",3,38,392,194,198
050,18,073,"Indiana","Jasper County",3,39,423,219,204
050,18,073,"Indiana","Jasper County",3,40,446,230,216
050,18,073,"Indiana","Jasper County",3,41,428,221,207
050,18,073,"Indiana","Jasper County",3,42,423,226,197
050,18,073,"Indiana","Jasper County",3,43,432,222,210
050,18,073,"Indiana","Jasper County",3,44,430,221,209
050,18,073,"Indiana","Jasper County",3,45,419,204,215
050,18,073,"Indiana","Jasper County",3,46,433,221,212
050,18,073,"Indiana","Jasper County",3,47,392,201,191
050,18,073,"Indiana","Jasper County",3,48,419,207,212
050,18,073,"Indiana","Jasper County",3,49,420,201,219
050,18,073,"Indiana","Jasper County",3,50,460,232,228
050,18,073,"Indiana","Jasper County",3,51,436,228,208
050,18,073,"Indiana","Jasper County",3,52,396,209,187
050,18,073,"Indiana","Jasper County",3,53,402,213,189
050,18,073,"Indiana","Jasper County",3,54,409,220,189
050,18,073,"Indiana","Jasper County",3,55,414,206,208
050,18,073,"Indiana","Jasper County",3,56,443,209,234
050,18,073,"Indiana","Jasper County",3,57,452,221,231
050,18,073,"Indiana","Jasper County",3,58,478,233,245
050,18,073,"Indiana","Jasper County",3,59,486,229,257
050,18,073,"Indiana","Jasper County",3,60,517,259,258
050,18,073,"Indiana","Jasper County",3,61,501,258,243
050,18,073,"Indiana","Jasper County",3,62,483,256,227
050,18,073,"Indiana","Jasper County",3,63,459,225,234
050,18,073,"Indiana","Jasper County",3,64,455,234,221
050,18,073,"Indiana","Jasper County",3,65,437,221,216
050,18,073,"Indiana","Jasper County",3,66,411,195,216
050,18,073,"Indiana","Jasper County",3,67,414,195,219
050,18,073,"Indiana","Jasper County",3,68,388,183,205
050,18,073,"Indiana","Jasper County",3,69,375,183,192
050,18,073,"Indiana","Jasper County",3,70,359,179,180
050,18,073,"Indiana","Jasper County",3,71,332,168,164
050,18,073,"Indiana","Jasper County",3,72,333,165,168
050,18,073,"Indiana","Jasper County",3,73,321,148,173
050,18,073,"Indiana","Jasper County",3,74,340,157,183
050,18,073,"Indiana","Jasper County",3,75,234,110,124
050,18,073,"Indiana","Jasper County",3,76,237,112,125
050,18,073,"Indiana","Jasper County",3,77,222,106,116
050,18,073,"Indiana","Jasper County",3,78,233,113,120
050,18,073,"Indiana","Jasper County",3,79,194,91,103
050,18,073,"Indiana","Jasper County",3,80,167,76,91
050,18,073,"Indiana","Jasper County",3,81,148,69,79
050,18,073,"Indiana","Jasper County",3,82,147,66,81
050,18,073,"Indiana","Jasper County",3,83,140,59,81
050,18,073,"Indiana","Jasper County",3,84,111,36,75
050,18,073,"Indiana","Jasper County",3,85,591,230,361
050,18,073,"Indiana","Jasper County",4,0,376,204,172
050,18,073,"Indiana","Jasper County",4,1,365,184,181
050,18,073,"Indiana","Jasper County",4,2,363,188,175
050,18,073,"Indiana","Jasper County",4,3,346,179,167
050,18,073,"Indiana","Jasper County",4,4,378,222,156
050,18,073,"Indiana","Jasper County",4,5,417,229,188
050,18,073,"Indiana","Jasper County",4,6,425,223,202
050,18,073,"Indiana","Jasper County",4,7,430,210,220
050,18,073,"Indiana","Jasper County",4,8,397,206,191
050,18,073,"Indiana","Jasper County",4,9,421,210,211
050,18,073,"Indiana","Jasper County",4,10,449,230,219
050,18,073,"Indiana","Jasper County",4,11,439,214,225
050,18,073,"Indiana","Jasper County",4,12,437,222,215
050,18,073,"Indiana","Jasper County",4,13,434,217,217
050,18,073,"Indiana","Jasper County",4,14,489,246,243
050,18,073,"Indiana","Jasper County",4,15,504,259,245
050,18,073,"Indiana","Jasper County",4,16,480,239,241
050,18,073,"Indiana","Jasper County",4,17,500,257,243
050,18,073,"Indiana","Jasper County",4,18,431,234,197
050,18,073,"Indiana","Jasper County",4,19,340,177,163
050,18,073,"Indiana","Jasper County",4,20,334,170,164
050,18,073,"Indiana","Jasper County",4,21,359,187,172
050,18,073,"Indiana","Jasper County",4,22,420,212,208
050,18,073,"Indiana","Jasper County",4,23,393,208,185
050,18,073,"Indiana","Jasper County",4,24,363,188,175
050,18,073,"Indiana","Jasper County",4,25,368,190,178
050,18,073,"Indiana","Jasper County",4,26,367,197,170
050,18,073,"Indiana","Jasper County",4,27,354,192,162
050,18,073,"Indiana","Jasper County",4,28,381,193,188
050,18,073,"Indiana","Jasper County",4,29,400,201,199
050,18,073,"Indiana","Jasper County",4,30,417,203,214
050,18,073,"Indiana","Jasper County",4,31,399,198,201
050,18,073,"Indiana","Jasper County",4,32,407,193,214
050,18,073,"Indiana","Jasper County",4,33,394,200,194
050,18,073,"Indiana","Jasper County",4,34,371,185,186
050,18,073,"Indiana","Jasper County",4,35,375,190,185
050,18,073,"Indiana","Jasper County",4,36,372,184,188
050,18,073,"Indiana","Jasper County",4,37,356,172,184
050,18,073,"Indiana","Jasper County",4,38,371,180,191
050,18,073,"Indiana","Jasper County",4,39,411,208,203
050,18,073,"Indiana","Jasper County",4,40,430,228,202
050,18,073,"Indiana","Jasper County",4,41,448,224,224
050,18,073,"Indiana","Jasper County",4,42,428,213,215
050,18,073,"Indiana","Jasper County",4,43,417,225,192
050,18,073,"Indiana","Jasper County",4,44,429,223,206
050,18,073,"Indiana","Jasper County",4,45,437,228,209
050,18,073,"Indiana","Jasper County",4,46,412,200,212
050,18,073,"Indiana","Jasper County",4,47,435,223,212
050,18,073,"Indiana","Jasper County",4,48,395,200,195
050,18,073,"Indiana","Jasper County",4,49,420,209,211
050,18,073,"Indiana","Jasper County",4,50,415,204,211
050,18,073,"Indiana","Jasper County",4,51,474,239,235
050,18,073,"Indiana","Jasper County",4,52,442,230,212
050,18,073,"Indiana","Jasper County",4,53,396,206,190
050,18,073,"Indiana","Jasper County",4,54,405,213,192
050,18,073,"Indiana","Jasper County",4,55,419,224,195
050,18,073,"Indiana","Jasper County",4,56,423,208,215
050,18,073,"Indiana","Jasper County",4,57,439,205,234
050,18,073,"Indiana","Jasper County",4,58,460,226,234
050,18,073,"Indiana","Jasper County",4,59,483,238,245
050,18,073,"Indiana","Jasper County",4,60,478,223,255
050,18,073,"Indiana","Jasper County",4,61,508,254,254
050,18,073,"Indiana","Jasper County",4,62,493,249,244
050,18,073,"Indiana","Jasper County",4,63,480,256,224
050,18,073,"Indiana","Jasper County",4,64,449,216,233
050,18,073,"Indiana","Jasper County",4,65,445,226,219
050,18,073,"Indiana","Jasper County",4,66,429,214,215
050,18,073,"Indiana","Jasper County",4,67,411,194,217
050,18,073,"Indiana","Jasper County",4,68,422,202,220
050,18,073,"Indiana","Jasper County",4,69,382,181,201
050,18,073,"Indiana","Jasper County",4,70,364,177,187
050,18,073,"Indiana","Jasper County",4,71,345,171,174
050,18,073,"Indiana","Jasper County",4,72,329,165,164
050,18,073,"Indiana","Jasper County",4,73,321,157,164
050,18,073,"Indiana","Jasper County",4,74,310,140,170
050,18,073,"Indiana","Jasper County",4,75,325,152,173
050,18,073,"Indiana","Jasper County",4,76,231,111,120
050,18,073,"Indiana","Jasper County",4,77,222,104,118
050,18,073,"Indiana","Jasper County",4,78,211,101,110
050,18,073,"Indiana","Jasper County",4,79,221,105,116
050,18,073,"Indiana","Jasper County",4,80,185,90,95
050,18,073,"Indiana","Jasper County",4,81,157,72,85
050,18,073,"Indiana","Jasper County",4,82,142,65,77
050,18,073,"Indiana","Jasper County",4,83,132,56,76
050,18,073,"Indiana","Jasper County",4,84,124,50,74
050,18,073,"Indiana","Jasper County",4,85,589,211,378
050,18,073,"Indiana","Jasper County",5,0,378,205,173
050,18,073,"Indiana","Jasper County",5,1,384,205,179
050,18,073,"Indiana","Jasper County",5,2,379,192,187
050,18,073,"Indiana","Jasper County",5,3,362,194,168
050,18,073,"Indiana","Jasper County",5,4,349,180,169
050,18,073,"Indiana","Jasper County",5,5,388,225,163
050,18,073,"Indiana","Jasper County",5,6,405,221,184
050,18,073,"Indiana","Jasper County",5,7,437,226,211
050,18,073,"Indiana","Jasper County",5,8,443,213,230
050,18,073,"Indiana","Jasper County",5,9,401,201,200
050,18,073,"Indiana","Jasper County",5,10,424,205,219
050,18,073,"Indiana","Jasper County",5,11,444,230,214
050,18,073,"Indiana","Jasper County",5,12,452,220,232
050,18,073,"Indiana","Jasper County",5,13,445,224,221
050,18,073,"Indiana","Jasper County",5,14,448,218,230
050,18,073,"Indiana","Jasper County",5,15,499,251,248
050,18,073,"Indiana","Jasper County",5,16,499,257,242
050,18,073,"Indiana","Jasper County",5,17,477,238,239
050,18,073,"Indiana","Jasper County",5,18,423,221,202
050,18,073,"Indiana","Jasper County",5,19,342,189,153
050,18,073,"Indiana","Jasper County",5,20,358,183,175
050,18,073,"Indiana","Jasper County",5,21,347,180,167
050,18,073,"Indiana","Jasper County",5,22,376,190,186
050,18,073,"Indiana","Jasper County",5,23,410,207,203
050,18,073,"Indiana","Jasper County",5,24,388,205,183
050,18,073,"Indiana","Jasper County",5,25,357,191,166
050,18,073,"Indiana","Jasper County",5,26,384,202,182
050,18,073,"Indiana","Jasper County",5,27,388,207,181
050,18,073,"Indiana","Jasper County",5,28,362,198,164
050,18,073,"Indiana","Jasper County",5,29,389,198,191
050,18,073,"Indiana","Jasper County",5,30,386,190,196
050,18,073,"Indiana","Jasper County",5,31,429,205,224
050,18,073,"Indiana","Jasper County",5,32,405,202,203
050,18,073,"Indiana","Jasper County",5,33,403,195,208
050,18,073,"Indiana","Jasper County",5,34,399,200,199
050,18,073,"Indiana","Jasper County",5,35,392,196,196
050,18,073,"Indiana","Jasper County",5,36,378,190,188
050,18,073,"Indiana","Jasper County",5,37,377,191,186
050,18,073,"Indiana","Jasper County",5,38,368,184,184
050,18,073,"Indiana","Jasper County",5,39,373,181,192
050,18,073,"Indiana","Jasper County",5,40,403,208,195
050,18,073,"Indiana","Jasper County",5,41,429,227,202
050,18,073,"Indiana","Jasper County",5,42,448,226,222
050,18,073,"Indiana","Jasper County",5,43,458,231,227
050,18,073,"Indiana","Jasper County",5,44,421,225,196
050,18,073,"Indiana","Jasper County",5,45,446,233,213
050,18,073,"Indiana","Jasper County",5,46,438,225,213
050,18,073,"Indiana","Jasper County",5,47,404,200,204
050,18,073,"Indiana","Jasper County",5,48,430,211,219
050,18,073,"Indiana","Jasper County",5,49,400,205,195
050,18,073,"Indiana","Jasper County",5,50,431,217,214
050,18,073,"Indiana","Jasper County",5,51,417,203,214
050,18,073,"Indiana","Jasper County",5,52,462,234,228
050,18,073,"Indiana","Jasper County",5,53,443,229,214
050,18,073,"Indiana","Jasper County",5,54,407,209,198
050,18,073,"Indiana","Jasper County",5,55,407,212,195
050,18,073,"Indiana","Jasper County",5,56,430,229,201
050,18,073,"Indiana","Jasper County",5,57,428,213,215
050,18,073,"Indiana","Jasper County",5,58,433,203,230
050,18,073,"Indiana","Jasper County",5,59,466,226,240
050,18,073,"Indiana","Jasper County",5,60,491,244,247
050,18,073,"Indiana","Jasper County",5,61,478,225,253
050,18,073,"Indiana","Jasper County",5,62,501,251,250
050,18,073,"Indiana","Jasper County",5,63,496,252,244
050,18,073,"Indiana","Jasper County",5,64,474,251,223
050,18,073,"Indiana","Jasper County",5,65,447,205,242
050,18,073,"Indiana","Jasper County",5,66,428,213,215
050,18,073,"Indiana","Jasper County",5,67,428,211,217
050,18,073,"Indiana","Jasper County",5,68,407,192,215
050,18,073,"Indiana","Jasper County",5,69,417,205,212
050,18,073,"Indiana","Jasper County",5,70,371,172,199
050,18,073,"Indiana","Jasper County",5,71,353,169,184
050,18,073,"Indiana","Jasper County",5,72,339,168,171
050,18,073,"Indiana","Jasper County",5,73,311,152,159
050,18,073,"Indiana","Jasper County",5,74,317,155,162
050,18,073,"Indiana","Jasper County",5,75,293,136,157
050,18,073,"Indiana","Jasper County",5,76,320,148,172
050,18,073,"Indiana","Jasper County",5,77,218,103,115
050,18,073,"Indiana","Jasper County",5,78,218,101,117
050,18,073,"Indiana","Jasper County",5,79,207,94,113
050,18,073,"Indiana","Jasper County",5,80,205,102,103
050,18,073,"Indiana","Jasper County",5,81,175,83,92
050,18,073,"Indiana","Jasper County",5,82,149,65,84
050,18,073,"Indiana","Jasper County",5,83,126,56,70
050,18,073,"Indiana","Jasper County",5,84,113,47,66
050,18,073,"Indiana","Jasper County",5,85,604,214,390
050,18,075,"Indiana","Jay County",1,0,284,146,138
050,18,075,"Indiana","Jay County",1,1,294,153,141
050,18,075,"Indiana","Jay County",1,2,287,132,155
050,18,075,"Indiana","Jay County",1,3,282,139,143
050,18,075,"Indiana","Jay County",1,4,313,165,148
050,18,075,"Indiana","Jay County",1,5,313,151,162
050,18,075,"Indiana","Jay County",1,6,290,152,138
050,18,075,"Indiana","Jay County",1,7,270,148,122
050,18,075,"Indiana","Jay County",1,8,281,146,135
050,18,075,"Indiana","Jay County",1,9,303,156,147
050,18,075,"Indiana","Jay County",1,10,282,150,132
050,18,075,"Indiana","Jay County",1,11,306,165,141
050,18,075,"Indiana","Jay County",1,12,296,150,146
050,18,075,"Indiana","Jay County",1,13,291,144,147
050,18,075,"Indiana","Jay County",1,14,286,146,140
050,18,075,"Indiana","Jay County",1,15,300,165,135
050,18,075,"Indiana","Jay County",1,16,307,172,135
050,18,075,"Indiana","Jay County",1,17,306,162,144
050,18,075,"Indiana","Jay County",1,18,267,135,132
050,18,075,"Indiana","Jay County",1,19,206,114,92
050,18,075,"Indiana","Jay County",1,20,227,114,113
050,18,075,"Indiana","Jay County",1,21,242,116,126
050,18,075,"Indiana","Jay County",1,22,231,118,113
050,18,075,"Indiana","Jay County",1,23,224,114,110
050,18,075,"Indiana","Jay County",1,24,206,108,98
050,18,075,"Indiana","Jay County",1,25,249,135,114
050,18,075,"Indiana","Jay County",1,26,231,125,106
050,18,075,"Indiana","Jay County",1,27,243,126,117
050,18,075,"Indiana","Jay County",1,28,262,136,126
050,18,075,"Indiana","Jay County",1,29,269,136,133
050,18,075,"Indiana","Jay County",1,30,249,126,123
050,18,075,"Indiana","Jay County",1,31,229,125,104
050,18,075,"Indiana","Jay County",1,32,203,115,88
050,18,075,"Indiana","Jay County",1,33,215,116,99
050,18,075,"Indiana","Jay County",1,34,205,95,110
050,18,075,"Indiana","Jay County",1,35,195,94,101
050,18,075,"Indiana","Jay County",1,36,191,94,97
050,18,075,"Indiana","Jay County",1,37,236,118,118
050,18,075,"Indiana","Jay County",1,38,251,129,122
050,18,075,"Indiana","Jay County",1,39,245,127,118
050,18,075,"Indiana","Jay County",1,40,219,114,105
050,18,075,"Indiana","Jay County",1,41,234,124,110
050,18,075,"Indiana","Jay County",1,42,235,140,95
050,18,075,"Indiana","Jay County",1,43,209,114,95
050,18,075,"Indiana","Jay County",1,44,200,102,98
050,18,075,"Indiana","Jay County",1,45,228,105,123
050,18,075,"Indiana","Jay County",1,46,233,115,118
050,18,075,"Indiana","Jay County",1,47,244,113,131
050,18,075,"Indiana","Jay County",1,48,280,127,153
050,18,075,"Indiana","Jay County",1,49,273,134,139
050,18,075,"Indiana","Jay County",1,50,265,142,123
050,18,075,"Indiana","Jay County",1,51,264,136,128
050,18,075,"Indiana","Jay County",1,52,258,127,131
050,18,075,"Indiana","Jay County",1,53,266,144,122
050,18,075,"Indiana","Jay County",1,54,275,147,128
050,18,075,"Indiana","Jay County",1,55,284,143,141
050,18,075,"Indiana","Jay County",1,56,283,132,151
050,18,075,"Indiana","Jay County",1,57,288,151,137
050,18,075,"Indiana","Jay County",1,58,280,137,143
050,18,075,"Indiana","Jay County",1,59,292,128,164
050,18,075,"Indiana","Jay County",1,60,262,132,130
050,18,075,"Indiana","Jay County",1,61,256,139,117
050,18,075,"Indiana","Jay County",1,62,283,156,127
050,18,075,"Indiana","Jay County",1,63,262,128,134
050,18,075,"Indiana","Jay County",1,64,269,132,137
050,18,075,"Indiana","Jay County",1,65,263,144,119
050,18,075,"Indiana","Jay County",1,66,257,131,126
050,18,075,"Indiana","Jay County",1,67,244,118,126
050,18,075,"Indiana","Jay County",1,68,218,106,112
050,18,075,"Indiana","Jay County",1,69,223,116,107
050,18,075,"Indiana","Jay County",1,70,210,105,105
050,18,075,"Indiana","Jay County",1,71,191,87,104
050,18,075,"Indiana","Jay County",1,72,206,90,116
050,18,075,"Indiana","Jay County",1,73,225,103,122
050,18,075,"Indiana","Jay County",1,74,155,69,86
050,18,075,"Indiana","Jay County",1,75,147,71,76
050,18,075,"Indiana","Jay County",1,76,135,66,69
050,18,075,"Indiana","Jay County",1,77,130,60,70
050,18,075,"Indiana","Jay County",1,78,103,44,59
050,18,075,"Indiana","Jay County",1,79,106,45,61
050,18,075,"Indiana","Jay County",1,80,99,43,56
050,18,075,"Indiana","Jay County",1,81,102,44,58
050,18,075,"Indiana","Jay County",1,82,99,44,55
050,18,075,"Indiana","Jay County",1,83,83,33,50
050,18,075,"Indiana","Jay County",1,84,62,29,33
050,18,075,"Indiana","Jay County",1,85,404,131,273
050,18,075,"Indiana","Jay County",2,0,287,144,143
050,18,075,"Indiana","Jay County",2,1,290,152,138
050,18,075,"Indiana","Jay County",2,2,286,137,149
050,18,075,"Indiana","Jay County",2,3,284,138,146
050,18,075,"Indiana","Jay County",2,4,307,157,150
050,18,075,"Indiana","Jay County",2,5,312,155,157
050,18,075,"Indiana","Jay County",2,6,295,153,142
050,18,075,"Indiana","Jay County",2,7,276,149,127
050,18,075,"Indiana","Jay County",2,8,279,148,131
050,18,075,"Indiana","Jay County",2,9,299,155,144
050,18,075,"Indiana","Jay County",2,10,289,152,137
050,18,075,"Indiana","Jay County",2,11,299,162,137
050,18,075,"Indiana","Jay County",2,12,300,156,144
050,18,075,"Indiana","Jay County",2,13,293,145,148
050,18,075,"Indiana","Jay County",2,14,289,146,143
050,18,075,"Indiana","Jay County",2,15,297,161,136
050,18,075,"Indiana","Jay County",2,16,306,173,133
050,18,075,"Indiana","Jay County",2,17,307,165,142
050,18,075,"Indiana","Jay County",2,18,264,137,127
050,18,075,"Indiana","Jay County",2,19,207,111,96
050,18,075,"Indiana","Jay County",2,20,229,118,111
050,18,075,"Indiana","Jay County",2,21,239,115,124
050,18,075,"Indiana","Jay County",2,22,238,119,119
050,18,075,"Indiana","Jay County",2,23,223,113,110
050,18,075,"Indiana","Jay County",2,24,209,109,100
050,18,075,"Indiana","Jay County",2,25,239,129,110
050,18,075,"Indiana","Jay County",2,26,237,129,108
050,18,075,"Indiana","Jay County",2,27,240,127,113
050,18,075,"Indiana","Jay County",2,28,260,135,125
050,18,075,"Indiana","Jay County",2,29,265,132,133
050,18,075,"Indiana","Jay County",2,30,258,130,128
050,18,075,"Indiana","Jay County",2,31,236,128,108
050,18,075,"Indiana","Jay County",2,32,209,117,92
050,18,075,"Indiana","Jay County",2,33,213,116,97
050,18,075,"Indiana","Jay County",2,34,207,100,107
050,18,075,"Indiana","Jay County",2,35,198,93,105
050,18,075,"Indiana","Jay County",2,36,191,93,98
050,18,075,"Indiana","Jay County",2,37,228,114,114
050,18,075,"Indiana","Jay County",2,38,248,127,121
050,18,075,"Indiana","Jay County",2,39,242,125,117
050,18,075,"Indiana","Jay County",2,40,227,118,109
050,18,075,"Indiana","Jay County",2,41,231,122,109
050,18,075,"Indiana","Jay County",2,42,235,136,99
050,18,075,"Indiana","Jay County",2,43,218,121,97
050,18,075,"Indiana","Jay County",2,44,201,104,97
050,18,075,"Indiana","Jay County",2,45,225,107,118
050,18,075,"Indiana","Jay County",2,46,230,112,118
050,18,075,"Indiana","Jay County",2,47,241,112,129
050,18,075,"Indiana","Jay County",2,48,272,124,148
050,18,075,"Indiana","Jay County",2,49,276,134,142
050,18,075,"Indiana","Jay County",2,50,267,140,127
050,18,075,"Indiana","Jay County",2,51,263,137,126
050,18,075,"Indiana","Jay County",2,52,256,127,129
050,18,075,"Indiana","Jay County",2,53,264,141,123
050,18,075,"Indiana","Jay County",2,54,270,145,125
050,18,075,"Indiana","Jay County",2,55,282,144,138
050,18,075,"Indiana","Jay County",2,56,285,136,149
050,18,075,"Indiana","Jay County",2,57,284,145,139
050,18,075,"Indiana","Jay County",2,58,281,140,141
050,18,075,"Indiana","Jay County",2,59,291,131,160
050,18,075,"Indiana","Jay County",2,60,267,129,138
050,18,075,"Indiana","Jay County",2,61,255,137,118
050,18,075,"Indiana","Jay County",2,62,272,150,122
050,18,075,"Indiana","Jay County",2,63,268,135,133
050,18,075,"Indiana","Jay County",2,64,265,130,135
050,18,075,"Indiana","Jay County",2,65,263,140,123
050,18,075,"Indiana","Jay County",2,66,258,133,125
050,18,075,"Indiana","Jay County",2,67,247,121,126
050,18,075,"Indiana","Jay County",2,68,223,109,114
050,18,075,"Indiana","Jay County",2,69,222,113,109
050,18,075,"Indiana","Jay County",2,70,213,107,106
050,18,075,"Indiana","Jay County",2,71,193,90,103
050,18,075,"Indiana","Jay County",2,72,195,86,109
050,18,075,"Indiana","Jay County",2,73,233,106,127
050,18,075,"Indiana","Jay County",2,74,157,70,87
050,18,075,"Indiana","Jay County",2,75,151,71,80
050,18,075,"Indiana","Jay County",2,76,136,66,70
050,18,075,"Indiana","Jay County",2,77,131,60,71
050,18,075,"Indiana","Jay County",2,78,106,47,59
050,18,075,"Indiana","Jay County",2,79,106,45,61
050,18,075,"Indiana","Jay County",2,80,98,42,56
050,18,075,"Indiana","Jay County",2,81,102,44,58
050,18,075,"Indiana","Jay County",2,82,93,41,52
050,18,075,"Indiana","Jay County",2,83,80,34,46
050,18,075,"Indiana","Jay County",2,84,66,30,36
050,18,075,"Indiana","Jay County",2,85,400,131,269
050,18,075,"Indiana","Jay County",3,0,292,150,142
050,18,075,"Indiana","Jay County",3,1,305,153,152
050,18,075,"Indiana","Jay County",3,2,284,156,128
050,18,075,"Indiana","Jay County",3,3,280,131,149
050,18,075,"Indiana","Jay County",3,4,277,141,136
050,18,075,"Indiana","Jay County",3,5,304,159,145
050,18,075,"Indiana","Jay County",3,6,306,157,149
050,18,075,"Indiana","Jay County",3,7,282,143,139
050,18,075,"Indiana","Jay County",3,8,276,144,132
050,18,075,"Indiana","Jay County",3,9,272,148,124
050,18,075,"Indiana","Jay County",3,10,296,149,147
050,18,075,"Indiana","Jay County",3,11,277,149,128
050,18,075,"Indiana","Jay County",3,12,286,159,127
050,18,075,"Indiana","Jay County",3,13,292,157,135
050,18,075,"Indiana","Jay County",3,14,284,144,140
050,18,075,"Indiana","Jay County",3,15,289,147,142
050,18,075,"Indiana","Jay County",3,16,294,161,133
050,18,075,"Indiana","Jay County",3,17,305,175,130
050,18,075,"Indiana","Jay County",3,18,257,142,115
050,18,075,"Indiana","Jay County",3,19,205,105,100
050,18,075,"Indiana","Jay County",3,20,204,111,93
050,18,075,"Indiana","Jay County",3,21,238,118,120
050,18,075,"Indiana","Jay County",3,22,250,123,127
050,18,075,"Indiana","Jay County",3,23,231,120,111
050,18,075,"Indiana","Jay County",3,24,215,114,101
050,18,075,"Indiana","Jay County",3,25,207,111,96
050,18,075,"Indiana","Jay County",3,26,239,131,108
050,18,075,"Indiana","Jay County",3,27,241,125,116
050,18,075,"Indiana","Jay County",3,28,252,138,114
050,18,075,"Indiana","Jay County",3,29,256,128,128
050,18,075,"Indiana","Jay County",3,30,262,130,132
050,18,075,"Indiana","Jay County",3,31,264,132,132
050,18,075,"Indiana","Jay County",3,32,223,118,105
050,18,075,"Indiana","Jay County",3,33,213,123,90
050,18,075,"Indiana","Jay County",3,34,206,111,95
050,18,075,"Indiana","Jay County",3,35,202,101,101
050,18,075,"Indiana","Jay County",3,36,202,95,107
050,18,075,"Indiana","Jay County",3,37,197,101,96
050,18,075,"Indiana","Jay County",3,38,224,113,111
050,18,075,"Indiana","Jay County",3,39,244,121,123
050,18,075,"Indiana","Jay County",3,40,238,125,113
050,18,075,"Indiana","Jay County",3,41,227,122,105
050,18,075,"Indiana","Jay County",3,42,229,125,104
050,18,075,"Indiana","Jay County",3,43,230,127,103
050,18,075,"Indiana","Jay County",3,44,210,119,91
050,18,075,"Indiana","Jay County",3,45,191,101,90
050,18,075,"Indiana","Jay County",3,46,226,106,120
050,18,075,"Indiana","Jay County",3,47,223,104,119
050,18,075,"Indiana","Jay County",3,48,252,118,134
050,18,075,"Indiana","Jay County",3,49,280,132,148
050,18,075,"Indiana","Jay County",3,50,279,130,149
050,18,075,"Indiana","Jay County",3,51,258,137,121
050,18,075,"Indiana","Jay County",3,52,262,137,125
050,18,075,"Indiana","Jay County",3,53,257,128,129
050,18,075,"Indiana","Jay County",3,54,257,139,118
050,18,075,"Indiana","Jay County",3,55,259,140,119
050,18,075,"Indiana","Jay County",3,56,280,139,141
050,18,075,"Indiana","Jay County",3,57,277,134,143
050,18,075,"Indiana","Jay County",3,58,279,141,138
050,18,075,"Indiana","Jay County",3,59,278,139,139
050,18,075,"Indiana","Jay County",3,60,288,128,160
050,18,075,"Indiana","Jay County",3,61,258,125,133
050,18,075,"Indiana","Jay County",3,62,252,134,118
050,18,075,"Indiana","Jay County",3,63,266,150,116
050,18,075,"Indiana","Jay County",3,64,263,135,128
050,18,075,"Indiana","Jay County",3,65,258,124,134
050,18,075,"Indiana","Jay County",3,66,260,135,125
050,18,075,"Indiana","Jay County",3,67,253,130,123
050,18,075,"Indiana","Jay County",3,68,247,120,127
050,18,075,"Indiana","Jay County",3,69,220,105,115
050,18,075,"Indiana","Jay County",3,70,214,109,105
050,18,075,"Indiana","Jay County",3,71,206,102,104
050,18,075,"Indiana","Jay County",3,72,187,87,100
050,18,075,"Indiana","Jay County",3,73,195,88,107
050,18,075,"Indiana","Jay County",3,74,216,97,119
050,18,075,"Indiana","Jay County",3,75,148,62,86
050,18,075,"Indiana","Jay County",3,76,138,65,73
050,18,075,"Indiana","Jay County",3,77,129,62,67
050,18,075,"Indiana","Jay County",3,78,114,51,63
050,18,075,"Indiana","Jay County",3,79,110,48,62
050,18,075,"Indiana","Jay County",3,80,94,42,52
050,18,075,"Indiana","Jay County",3,81,100,44,56
050,18,075,"Indiana","Jay County",3,82,89,40,49
050,18,075,"Indiana","Jay County",3,83,83,35,48
050,18,075,"Indiana","Jay County",3,84,71,30,41
050,18,075,"Indiana","Jay County",3,85,398,135,263
050,18,075,"Indiana","Jay County",4,0,288,153,135
050,18,075,"Indiana","Jay County",4,1,281,140,141
050,18,075,"Indiana","Jay County",4,2,302,146,156
050,18,075,"Indiana","Jay County",4,3,289,158,131
050,18,075,"Indiana","Jay County",4,4,286,132,154
050,18,075,"Indiana","Jay County",4,5,267,132,135
050,18,075,"Indiana","Jay County",4,6,300,161,139
050,18,075,"Indiana","Jay County",4,7,299,156,143
050,18,075,"Indiana","Jay County",4,8,281,142,139
050,18,075,"Indiana","Jay County",4,9,281,143,138
050,18,075,"Indiana","Jay County",4,10,259,138,121
050,18,075,"Indiana","Jay County",4,11,297,147,150
050,18,075,"Indiana","Jay County",4,12,284,155,129
050,18,075,"Indiana","Jay County",4,13,292,156,136
050,18,075,"Indiana","Jay County",4,14,288,157,131
050,18,075,"Indiana","Jay County",4,15,286,143,143
050,18,075,"Indiana","Jay County",4,16,295,151,144
050,18,075,"Indiana","Jay County",4,17,289,153,136
050,18,075,"Indiana","Jay County",4,18,248,145,103
050,18,075,"Indiana","Jay County",4,19,202,111,91
050,18,075,"Indiana","Jay County",4,20,213,107,106
050,18,075,"Indiana","Jay County",4,21,211,110,101
050,18,075,"Indiana","Jay County",4,22,234,120,114
050,18,075,"Indiana","Jay County",4,23,236,116,120
050,18,075,"Indiana","Jay County",4,24,227,116,111
050,18,075,"Indiana","Jay County",4,25,215,109,106
050,18,075,"Indiana","Jay County",4,26,208,113,95
050,18,075,"Indiana","Jay County",4,27,231,129,102
050,18,075,"Indiana","Jay County",4,28,239,120,119
050,18,075,"Indiana","Jay County",4,29,237,132,105
050,18,075,"Indiana","Jay County",4,30,249,127,122
050,18,075,"Indiana","Jay County",4,31,268,132,136
050,18,075,"Indiana","Jay County",4,32,255,125,130
050,18,075,"Indiana","Jay County",4,33,225,123,102
050,18,075,"Indiana","Jay County",4,34,217,127,90
050,18,075,"Indiana","Jay County",4,35,206,110,96
050,18,075,"Indiana","Jay County",4,36,198,96,102
050,18,075,"Indiana","Jay County",4,37,208,102,106
050,18,075,"Indiana","Jay County",4,38,188,97,91
050,18,075,"Indiana","Jay County",4,39,213,106,107
050,18,075,"Indiana","Jay County",4,40,254,124,130
050,18,075,"Indiana","Jay County",4,41,245,128,117
050,18,075,"Indiana","Jay County",4,42,229,123,106
050,18,075,"Indiana","Jay County",4,43,233,127,106
050,18,075,"Indiana","Jay County",4,44,233,129,104
050,18,075,"Indiana","Jay County",4,45,212,122,90
050,18,075,"Indiana","Jay County",4,46,194,102,92
050,18,075,"Indiana","Jay County",4,47,219,102,117
050,18,075,"Indiana","Jay County",4,48,227,106,121
050,18,075,"Indiana","Jay County",4,49,249,116,133
050,18,075,"Indiana","Jay County",4,50,279,129,150
050,18,075,"Indiana","Jay County",4,51,272,129,143
050,18,075,"Indiana","Jay County",4,52,260,133,127
050,18,075,"Indiana","Jay County",4,53,256,133,123
050,18,075,"Indiana","Jay County",4,54,253,129,124
050,18,075,"Indiana","Jay County",4,55,255,137,118
050,18,075,"Indiana","Jay County",4,56,258,135,123
050,18,075,"Indiana","Jay County",4,57,271,136,135
050,18,075,"Indiana","Jay County",4,58,275,130,145
050,18,075,"Indiana","Jay County",4,59,271,140,131
050,18,075,"Indiana","Jay County",4,60,280,137,143
050,18,075,"Indiana","Jay County",4,61,281,123,158
050,18,075,"Indiana","Jay County",4,62,263,127,136
050,18,075,"Indiana","Jay County",4,63,247,132,115
050,18,075,"Indiana","Jay County",4,64,261,148,113
050,18,075,"Indiana","Jay County",4,65,258,132,126
050,18,075,"Indiana","Jay County",4,66,250,119,131
050,18,075,"Indiana","Jay County",4,67,251,133,118
050,18,075,"Indiana","Jay County",4,68,246,126,120
050,18,075,"Indiana","Jay County",4,69,250,123,127
050,18,075,"Indiana","Jay County",4,70,205,96,109
050,18,075,"Indiana","Jay County",4,71,202,101,101
050,18,075,"Indiana","Jay County",4,72,197,98,99
050,18,075,"Indiana","Jay County",4,73,182,85,97
050,18,075,"Indiana","Jay County",4,74,181,79,102
050,18,075,"Indiana","Jay County",4,75,201,90,111
050,18,075,"Indiana","Jay County",4,76,135,53,82
050,18,075,"Indiana","Jay County",4,77,126,60,66
050,18,075,"Indiana","Jay County",4,78,111,55,56
050,18,075,"Indiana","Jay County",4,79,111,50,61
050,18,075,"Indiana","Jay County",4,80,100,46,54
050,18,075,"Indiana","Jay County",4,81,92,42,50
050,18,075,"Indiana","Jay County",4,82,83,38,45
050,18,075,"Indiana","Jay County",4,83,81,34,47
050,18,075,"Indiana","Jay County",4,84,66,25,41
050,18,075,"Indiana","Jay County",4,85,421,146,275
050,18,075,"Indiana","Jay County",5,0,277,146,131
050,18,075,"Indiana","Jay County",5,1,301,158,143
050,18,075,"Indiana","Jay County",5,2,281,144,137
050,18,075,"Indiana","Jay County",5,3,310,162,148
050,18,075,"Indiana","Jay County",5,4,276,153,123
050,18,075,"Indiana","Jay County",5,5,289,136,153
050,18,075,"Indiana","Jay County",5,6,266,134,132
050,18,075,"Indiana","Jay County",5,7,305,167,138
050,18,075,"Indiana","Jay County",5,8,292,153,139
050,18,075,"Indiana","Jay County",5,9,292,144,148
050,18,075,"Indiana","Jay County",5,10,264,137,127
050,18,075,"Indiana","Jay County",5,11,255,141,114
050,18,075,"Indiana","Jay County",5,12,302,154,148
050,18,075,"Indiana","Jay County",5,13,286,153,133
050,18,075,"Indiana","Jay County",5,14,277,159,118
050,18,075,"Indiana","Jay County",5,15,301,163,138
050,18,075,"Indiana","Jay County",5,16,283,138,145
050,18,075,"Indiana","Jay County",5,17,289,149,140
050,18,075,"Indiana","Jay County",5,18,253,138,115
050,18,075,"Indiana","Jay County",5,19,187,106,81
050,18,075,"Indiana","Jay County",5,20,217,122,95
050,18,075,"Indiana","Jay County",5,21,229,114,115
050,18,075,"Indiana","Jay County",5,22,225,123,102
050,18,075,"Indiana","Jay County",5,23,231,119,112
050,18,075,"Indiana","Jay County",5,24,240,116,124
050,18,075,"Indiana","Jay County",5,25,234,117,117
050,18,075,"Indiana","Jay County",5,26,214,112,102
050,18,075,"Indiana","Jay County",5,27,214,113,101
050,18,075,"Indiana","Jay County",5,28,233,132,101
050,18,075,"Indiana","Jay County",5,29,224,107,117
050,18,075,"Indiana","Jay County",5,30,229,123,106
050,18,075,"Indiana","Jay County",5,31,243,126,117
050,18,075,"Indiana","Jay County",5,32,253,125,128
050,18,075,"Indiana","Jay County",5,33,253,125,128
050,18,075,"Indiana","Jay County",5,34,230,127,103
050,18,075,"Indiana","Jay County",5,35,217,131,86
050,18,075,"Indiana","Jay County",5,36,204,108,96
050,18,075,"Indiana","Jay County",5,37,204,102,102
050,18,075,"Indiana","Jay County",5,38,212,103,109
050,18,075,"Indiana","Jay County",5,39,182,95,87
050,18,075,"Indiana","Jay County",5,40,224,113,111
050,18,075,"Indiana","Jay County",5,41,247,122,125
050,18,075,"Indiana","Jay County",5,42,248,127,121
050,18,075,"Indiana","Jay County",5,43,238,127,111
050,18,075,"Indiana","Jay County",5,44,230,125,105
050,18,075,"Indiana","Jay County",5,45,225,126,99
050,18,075,"Indiana","Jay County",5,46,206,118,88
050,18,075,"Indiana","Jay County",5,47,198,104,94
050,18,075,"Indiana","Jay County",5,48,222,99,123
050,18,075,"Indiana","Jay County",5,49,230,110,120
050,18,075,"Indiana","Jay County",5,50,242,113,129
050,18,075,"Indiana","Jay County",5,51,274,126,148
050,18,075,"Indiana","Jay County",5,52,269,126,143
050,18,075,"Indiana","Jay County",5,53,247,125,122
050,18,075,"Indiana","Jay County",5,54,250,128,122
050,18,075,"Indiana","Jay County",5,55,251,126,125
050,18,075,"Indiana","Jay County",5,56,243,125,118
050,18,075,"Indiana","Jay County",5,57,252,133,119
050,18,075,"Indiana","Jay County",5,58,268,132,136
050,18,075,"Indiana","Jay County",5,59,278,134,144
050,18,075,"Indiana","Jay County",5,60,272,138,134
050,18,075,"Indiana","Jay County",5,61,277,135,142
050,18,075,"Indiana","Jay County",5,62,279,121,158
050,18,075,"Indiana","Jay County",5,63,254,123,131
050,18,075,"Indiana","Jay County",5,64,245,132,113
050,18,075,"Indiana","Jay County",5,65,255,144,111
050,18,075,"Indiana","Jay County",5,66,249,125,124
050,18,075,"Indiana","Jay County",5,67,244,116,128
050,18,075,"Indiana","Jay County",5,68,241,129,112
050,18,075,"Indiana","Jay County",5,69,246,125,121
050,18,075,"Indiana","Jay County",5,70,239,118,121
050,18,075,"Indiana","Jay County",5,71,198,90,108
050,18,075,"Indiana","Jay County",5,72,199,100,99
050,18,075,"Indiana","Jay County",5,73,194,96,98
050,18,075,"Indiana","Jay County",5,74,171,77,94
050,18,075,"Indiana","Jay County",5,75,169,71,98
050,18,075,"Indiana","Jay County",5,76,184,81,103
050,18,075,"Indiana","Jay County",5,77,124,49,75
050,18,075,"Indiana","Jay County",5,78,111,55,56
050,18,075,"Indiana","Jay County",5,79,111,55,56
050,18,075,"Indiana","Jay County",5,80,101,49,52
050,18,075,"Indiana","Jay County",5,81,100,47,53
050,18,075,"Indiana","Jay County",5,82,81,39,42
050,18,075,"Indiana","Jay County",5,83,74,32,42
050,18,075,"Indiana","Jay County",5,84,71,30,41
050,18,075,"Indiana","Jay County",5,85,427,149,278
050,18,077,"Indiana","Jefferson County",1,0,360,182,178
050,18,077,"Indiana","Jefferson County",1,1,358,175,183
050,18,077,"Indiana","Jefferson County",1,2,381,191,190
050,18,077,"Indiana","Jefferson County",1,3,393,197,196
050,18,077,"Indiana","Jefferson County",1,4,381,205,176
050,18,077,"Indiana","Jefferson County",1,5,367,200,167
050,18,077,"Indiana","Jefferson County",1,6,332,170,162
050,18,077,"Indiana","Jefferson County",1,7,336,172,164
050,18,077,"Indiana","Jefferson County",1,8,356,175,181
050,18,077,"Indiana","Jefferson County",1,9,367,173,194
050,18,077,"Indiana","Jefferson County",1,10,374,195,179
050,18,077,"Indiana","Jefferson County",1,11,363,187,176
050,18,077,"Indiana","Jefferson County",1,12,407,206,201
050,18,077,"Indiana","Jefferson County",1,13,381,191,190
050,18,077,"Indiana","Jefferson County",1,14,375,205,170
050,18,077,"Indiana","Jefferson County",1,15,406,191,215
050,18,077,"Indiana","Jefferson County",1,16,418,193,225
050,18,077,"Indiana","Jefferson County",1,17,415,195,220
050,18,077,"Indiana","Jefferson County",1,18,398,201,197
050,18,077,"Indiana","Jefferson County",1,19,581,277,304
050,18,077,"Indiana","Jefferson County",1,20,580,273,307
050,18,077,"Indiana","Jefferson County",1,21,521,249,272
050,18,077,"Indiana","Jefferson County",1,22,475,245,230
050,18,077,"Indiana","Jefferson County",1,23,414,200,214
050,18,077,"Indiana","Jefferson County",1,24,389,180,209
050,18,077,"Indiana","Jefferson County",1,25,410,184,226
050,18,077,"Indiana","Jefferson County",1,26,382,179,203
050,18,077,"Indiana","Jefferson County",1,27,406,185,221
050,18,077,"Indiana","Jefferson County",1,28,408,181,227
050,18,077,"Indiana","Jefferson County",1,29,428,193,235
050,18,077,"Indiana","Jefferson County",1,30,409,182,227
050,18,077,"Indiana","Jefferson County",1,31,395,193,202
050,18,077,"Indiana","Jefferson County",1,32,367,183,184
050,18,077,"Indiana","Jefferson County",1,33,358,182,176
050,18,077,"Indiana","Jefferson County",1,34,373,184,189
050,18,077,"Indiana","Jefferson County",1,35,370,169,201
050,18,077,"Indiana","Jefferson County",1,36,398,180,218
050,18,077,"Indiana","Jefferson County",1,37,412,187,225
050,18,077,"Indiana","Jefferson County",1,38,402,192,210
050,18,077,"Indiana","Jefferson County",1,39,397,188,209
050,18,077,"Indiana","Jefferson County",1,40,410,192,218
050,18,077,"Indiana","Jefferson County",1,41,402,197,205
050,18,077,"Indiana","Jefferson County",1,42,401,189,212
050,18,077,"Indiana","Jefferson County",1,43,394,187,207
050,18,077,"Indiana","Jefferson County",1,44,390,186,204
050,18,077,"Indiana","Jefferson County",1,45,413,195,218
050,18,077,"Indiana","Jefferson County",1,46,383,183,200
050,18,077,"Indiana","Jefferson County",1,47,402,203,199
050,18,077,"Indiana","Jefferson County",1,48,432,218,214
050,18,077,"Indiana","Jefferson County",1,49,444,215,229
050,18,077,"Indiana","Jefferson County",1,50,437,217,220
050,18,077,"Indiana","Jefferson County",1,51,424,221,203
050,18,077,"Indiana","Jefferson County",1,52,417,201,216
050,18,077,"Indiana","Jefferson County",1,53,450,218,232
050,18,077,"Indiana","Jefferson County",1,54,425,206,219
050,18,077,"Indiana","Jefferson County",1,55,458,224,234
050,18,077,"Indiana","Jefferson County",1,56,498,248,250
050,18,077,"Indiana","Jefferson County",1,57,498,250,248
050,18,077,"Indiana","Jefferson County",1,58,500,264,236
050,18,077,"Indiana","Jefferson County",1,59,494,250,244
050,18,077,"Indiana","Jefferson County",1,60,492,240,252
050,18,077,"Indiana","Jefferson County",1,61,502,255,247
050,18,077,"Indiana","Jefferson County",1,62,497,235,262
050,18,077,"Indiana","Jefferson County",1,63,487,227,260
050,18,077,"Indiana","Jefferson County",1,64,446,233,213
050,18,077,"Indiana","Jefferson County",1,65,422,220,202
050,18,077,"Indiana","Jefferson County",1,66,408,206,202
050,18,077,"Indiana","Jefferson County",1,67,395,190,205
050,18,077,"Indiana","Jefferson County",1,68,415,214,201
050,18,077,"Indiana","Jefferson County",1,69,367,187,180
050,18,077,"Indiana","Jefferson County",1,70,365,192,173
050,18,077,"Indiana","Jefferson County",1,71,349,173,176
050,18,077,"Indiana","Jefferson County",1,72,339,155,184
050,18,077,"Indiana","Jefferson County",1,73,349,158,191
050,18,077,"Indiana","Jefferson County",1,74,250,120,130
050,18,077,"Indiana","Jefferson County",1,75,242,115,127
050,18,077,"Indiana","Jefferson County",1,76,244,100,144
050,18,077,"Indiana","Jefferson County",1,77,239,102,137
050,18,077,"Indiana","Jefferson County",1,78,209,96,113
050,18,077,"Indiana","Jefferson County",1,79,187,86,101
050,18,077,"Indiana","Jefferson County",1,80,175,77,98
050,18,077,"Indiana","Jefferson County",1,81,137,65,72
050,18,077,"Indiana","Jefferson County",1,82,120,48,72
050,18,077,"Indiana","Jefferson County",1,83,109,35,74
050,18,077,"Indiana","Jefferson County",1,84,107,45,62
050,18,077,"Indiana","Jefferson County",1,85,576,185,391
050,18,077,"Indiana","Jefferson County",2,0,352,186,166
050,18,077,"Indiana","Jefferson County",2,1,356,174,182
050,18,077,"Indiana","Jefferson County",2,2,375,188,187
050,18,077,"Indiana","Jefferson County",2,3,386,191,195
050,18,077,"Indiana","Jefferson County",2,4,385,204,181
050,18,077,"Indiana","Jefferson County",2,5,369,201,168
050,18,077,"Indiana","Jefferson County",2,6,339,177,162
050,18,077,"Indiana","Jefferson County",2,7,331,170,161
050,18,077,"Indiana","Jefferson County",2,8,349,174,175
050,18,077,"Indiana","Jefferson County",2,9,362,173,189
050,18,077,"Indiana","Jefferson County",2,10,371,189,182
050,18,077,"Indiana","Jefferson County",2,11,365,189,176
050,18,077,"Indiana","Jefferson County",2,12,393,199,194
050,18,077,"Indiana","Jefferson County",2,13,386,196,190
050,18,077,"Indiana","Jefferson County",2,14,374,201,173
050,18,077,"Indiana","Jefferson County",2,15,404,192,212
050,18,077,"Indiana","Jefferson County",2,16,415,194,221
050,18,077,"Indiana","Jefferson County",2,17,417,195,222
050,18,077,"Indiana","Jefferson County",2,18,393,200,193
050,18,077,"Indiana","Jefferson County",2,19,576,277,299
050,18,077,"Indiana","Jefferson County",2,20,586,274,312
050,18,077,"Indiana","Jefferson County",2,21,520,249,271
050,18,077,"Indiana","Jefferson County",2,22,473,243,230
050,18,077,"Indiana","Jefferson County",2,23,409,199,210
050,18,077,"Indiana","Jefferson County",2,24,392,183,209
050,18,077,"Indiana","Jefferson County",2,25,406,183,223
050,18,077,"Indiana","Jefferson County",2,26,385,178,207
050,18,077,"Indiana","Jefferson County",2,27,400,181,219
050,18,077,"Indiana","Jefferson County",2,28,407,183,224
050,18,077,"Indiana","Jefferson County",2,29,425,191,234
050,18,077,"Indiana","Jefferson County",2,30,414,186,228
050,18,077,"Indiana","Jefferson County",2,31,391,187,204
050,18,077,"Indiana","Jefferson County",2,32,368,184,184
050,18,077,"Indiana","Jefferson County",2,33,355,179,176
050,18,077,"Indiana","Jefferson County",2,34,368,183,185
050,18,077,"Indiana","Jefferson County",2,35,373,174,199
050,18,077,"Indiana","Jefferson County",2,36,390,176,214
050,18,077,"Indiana","Jefferson County",2,37,408,186,222
050,18,077,"Indiana","Jefferson County",2,38,401,191,210
050,18,077,"Indiana","Jefferson County",2,39,398,189,209
050,18,077,"Indiana","Jefferson County",2,40,409,192,217
050,18,077,"Indiana","Jefferson County",2,41,407,197,210
050,18,077,"Indiana","Jefferson County",2,42,402,193,209
050,18,077,"Indiana","Jefferson County",2,43,397,189,208
050,18,077,"Indiana","Jefferson County",2,44,389,184,205
050,18,077,"Indiana","Jefferson County",2,45,407,192,215
050,18,077,"Indiana","Jefferson County",2,46,389,185,204
050,18,077,"Indiana","Jefferson County",2,47,396,199,197
050,18,077,"Indiana","Jefferson County",2,48,422,214,208
050,18,077,"Indiana","Jefferson County",2,49,442,218,224
050,18,077,"Indiana","Jefferson County",2,50,442,219,223
050,18,077,"Indiana","Jefferson County",2,51,417,216,201
050,18,077,"Indiana","Jefferson County",2,52,420,205,215
050,18,077,"Indiana","Jefferson County",2,53,441,213,228
050,18,077,"Indiana","Jefferson County",2,54,430,209,221
050,18,077,"Indiana","Jefferson County",2,55,450,219,231
050,18,077,"Indiana","Jefferson County",2,56,492,244,248
050,18,077,"Indiana","Jefferson County",2,57,501,251,250
050,18,077,"Indiana","Jefferson County",2,58,499,260,239
050,18,077,"Indiana","Jefferson County",2,59,499,255,244
050,18,077,"Indiana","Jefferson County",2,60,490,240,250
050,18,077,"Indiana","Jefferson County",2,61,500,251,249
050,18,077,"Indiana","Jefferson County",2,62,499,242,257
050,18,077,"Indiana","Jefferson County",2,63,496,234,262
050,18,077,"Indiana","Jefferson County",2,64,451,228,223
050,18,077,"Indiana","Jefferson County",2,65,427,224,203
050,18,077,"Indiana","Jefferson County",2,66,411,208,203
050,18,077,"Indiana","Jefferson County",2,67,394,192,202
050,18,077,"Indiana","Jefferson County",2,68,404,206,198
050,18,077,"Indiana","Jefferson County",2,69,382,195,187
050,18,077,"Indiana","Jefferson County",2,70,365,191,174
050,18,077,"Indiana","Jefferson County",2,71,351,176,175
050,18,077,"Indiana","Jefferson County",2,72,335,156,179
050,18,077,"Indiana","Jefferson County",2,73,362,165,197
050,18,077,"Indiana","Jefferson County",2,74,253,122,131
050,18,077,"Indiana","Jefferson County",2,75,243,116,127
050,18,077,"Indiana","Jefferson County",2,76,240,101,139
050,18,077,"Indiana","Jefferson County",2,77,243,101,142
050,18,077,"Indiana","Jefferson County",2,78,210,95,115
050,18,077,"Indiana","Jefferson County",2,79,191,88,103
050,18,077,"Indiana","Jefferson County",2,80,177,78,99
050,18,077,"Indiana","Jefferson County",2,81,139,63,76
050,18,077,"Indiana","Jefferson County",2,82,127,52,75
050,18,077,"Indiana","Jefferson County",2,83,106,38,68
050,18,077,"Indiana","Jefferson County",2,84,105,42,63
050,18,077,"Indiana","Jefferson County",2,85,581,186,395
050,18,077,"Indiana","Jefferson County",3,0,346,177,169
050,18,077,"Indiana","Jefferson County",3,1,365,192,173
050,18,077,"Indiana","Jefferson County",3,2,345,160,185
050,18,077,"Indiana","Jefferson County",3,3,366,188,178
050,18,077,"Indiana","Jefferson County",3,4,383,190,193
050,18,077,"Indiana","Jefferson County",3,5,394,205,189
050,18,077,"Indiana","Jefferson County",3,6,358,196,162
050,18,077,"Indiana","Jefferson County",3,7,342,186,156
050,18,077,"Indiana","Jefferson County",3,8,335,169,166
050,18,077,"Indiana","Jefferson County",3,9,361,179,182
050,18,077,"Indiana","Jefferson County",3,10,357,170,187
050,18,077,"Indiana","Jefferson County",3,11,368,180,188
050,18,077,"Indiana","Jefferson County",3,12,354,184,170
050,18,077,"Indiana","Jefferson County",3,13,380,194,186
050,18,077,"Indiana","Jefferson County",3,14,387,198,189
050,18,077,"Indiana","Jefferson County",3,15,401,193,208
050,18,077,"Indiana","Jefferson County",3,16,408,191,217
050,18,077,"Indiana","Jefferson County",3,17,430,202,228
050,18,077,"Indiana","Jefferson County",3,18,381,193,188
050,18,077,"Indiana","Jefferson County",3,19,555,276,279
050,18,077,"Indiana","Jefferson County",3,20,559,271,288
050,18,077,"Indiana","Jefferson County",3,21,525,248,277
050,18,077,"Indiana","Jefferson County",3,22,465,235,230
050,18,077,"Indiana","Jefferson County",3,23,385,188,197
050,18,077,"Indiana","Jefferson County",3,24,389,187,202
050,18,077,"Indiana","Jefferson County",3,25,406,187,219
050,18,077,"Indiana","Jefferson County",3,26,413,193,220
050,18,077,"Indiana","Jefferson County",3,27,423,189,234
050,18,077,"Indiana","Jefferson County",3,28,393,176,217
050,18,077,"Indiana","Jefferson County",3,29,425,185,240
050,18,077,"Indiana","Jefferson County",3,30,421,190,231
050,18,077,"Indiana","Jefferson County",3,31,426,189,237
050,18,077,"Indiana","Jefferson County",3,32,390,192,198
050,18,077,"Indiana","Jefferson County",3,33,352,173,179
050,18,077,"Indiana","Jefferson County",3,34,350,172,178
050,18,077,"Indiana","Jefferson County",3,35,375,181,194
050,18,077,"Indiana","Jefferson County",3,36,376,174,202
050,18,077,"Indiana","Jefferson County",3,37,392,176,216
050,18,077,"Indiana","Jefferson County",3,38,415,200,215
050,18,077,"Indiana","Jefferson County",3,39,412,191,221
050,18,077,"Indiana","Jefferson County",3,40,412,196,216
050,18,077,"Indiana","Jefferson County",3,41,408,189,219
050,18,077,"Indiana","Jefferson County",3,42,408,206,202
050,18,077,"Indiana","Jefferson County",3,43,396,194,202
050,18,077,"Indiana","Jefferson County",3,44,408,194,214
050,18,077,"Indiana","Jefferson County",3,45,380,180,200
050,18,077,"Indiana","Jefferson County",3,46,409,191,218
050,18,077,"Indiana","Jefferson County",3,47,387,191,196
050,18,077,"Indiana","Jefferson County",3,48,384,188,196
050,18,077,"Indiana","Jefferson County",3,49,432,220,212
050,18,077,"Indiana","Jefferson County",3,50,439,214,225
050,18,077,"Indiana","Jefferson County",3,51,435,221,214
050,18,077,"Indiana","Jefferson County",3,52,418,207,211
050,18,077,"Indiana","Jefferson County",3,53,415,206,209
050,18,077,"Indiana","Jefferson County",3,54,449,221,228
050,18,077,"Indiana","Jefferson County",3,55,420,208,212
050,18,077,"Indiana","Jefferson County",3,56,454,219,235
050,18,077,"Indiana","Jefferson County",3,57,494,242,252
050,18,077,"Indiana","Jefferson County",3,58,493,252,241
050,18,077,"Indiana","Jefferson County",3,59,504,259,245
050,18,077,"Indiana","Jefferson County",3,60,492,249,243
050,18,077,"Indiana","Jefferson County",3,61,498,243,255
050,18,077,"Indiana","Jefferson County",3,62,498,249,249
050,18,077,"Indiana","Jefferson County",3,63,504,248,256
050,18,077,"Indiana","Jefferson County",3,64,489,227,262
050,18,077,"Indiana","Jefferson County",3,65,450,232,218
050,18,077,"Indiana","Jefferson County",3,66,423,224,199
050,18,077,"Indiana","Jefferson County",3,67,402,202,200
050,18,077,"Indiana","Jefferson County",3,68,381,185,196
050,18,077,"Indiana","Jefferson County",3,69,403,208,195
050,18,077,"Indiana","Jefferson County",3,70,379,192,187
050,18,077,"Indiana","Jefferson County",3,71,353,180,173
050,18,077,"Indiana","Jefferson County",3,72,344,169,175
050,18,077,"Indiana","Jefferson County",3,73,323,152,171
050,18,077,"Indiana","Jefferson County",3,74,358,163,195
050,18,077,"Indiana","Jefferson County",3,75,241,113,128
050,18,077,"Indiana","Jefferson County",3,76,233,108,125
050,18,077,"Indiana","Jefferson County",3,77,228,87,141
050,18,077,"Indiana","Jefferson County",3,78,230,97,133
050,18,077,"Indiana","Jefferson County",3,79,197,82,115
050,18,077,"Indiana","Jefferson County",3,80,182,87,95
050,18,077,"Indiana","Jefferson County",3,81,162,70,92
050,18,077,"Indiana","Jefferson County",3,82,131,53,78
050,18,077,"Indiana","Jefferson County",3,83,112,50,62
050,18,077,"Indiana","Jefferson County",3,84,84,31,53
050,18,077,"Indiana","Jefferson County",3,85,567,182,385
050,18,077,"Indiana","Jefferson County",4,0,342,161,181
050,18,077,"Indiana","Jefferson County",4,1,332,172,160
050,18,077,"Indiana","Jefferson County",4,2,358,191,167
050,18,077,"Indiana","Jefferson County",4,3,342,161,181
050,18,077,"Indiana","Jefferson County",4,4,370,189,181
050,18,077,"Indiana","Jefferson County",4,5,376,189,187
050,18,077,"Indiana","Jefferson County",4,6,388,199,189
050,18,077,"Indiana","Jefferson County",4,7,362,200,162
050,18,077,"Indiana","Jefferson County",4,8,338,179,159
050,18,077,"Indiana","Jefferson County",4,9,334,167,167
050,18,077,"Indiana","Jefferson County",4,10,348,174,174
050,18,077,"Indiana","Jefferson County",4,11,353,170,183
050,18,077,"Indiana","Jefferson County",4,12,356,171,185
050,18,077,"Indiana","Jefferson County",4,13,360,188,172
050,18,077,"Indiana","Jefferson County",4,14,377,190,187
050,18,077,"Indiana","Jefferson County",4,15,425,197,228
050,18,077,"Indiana","Jefferson County",4,16,416,198,218
050,18,077,"Indiana","Jefferson County",4,17,410,189,221
050,18,077,"Indiana","Jefferson County",4,18,403,204,199
050,18,077,"Indiana","Jefferson County",4,19,526,253,273
050,18,077,"Indiana","Jefferson County",4,20,538,260,278
050,18,077,"Indiana","Jefferson County",4,21,499,251,248
050,18,077,"Indiana","Jefferson County",4,22,470,235,235
050,18,077,"Indiana","Jefferson County",4,23,368,179,189
050,18,077,"Indiana","Jefferson County",4,24,358,176,182
050,18,077,"Indiana","Jefferson County",4,25,394,186,208
050,18,077,"Indiana","Jefferson County",4,26,409,195,214
050,18,077,"Indiana","Jefferson County",4,27,422,181,241
050,18,077,"Indiana","Jefferson County",4,28,411,175,236
050,18,077,"Indiana","Jefferson County",4,29,393,175,218
050,18,077,"Indiana","Jefferson County",4,30,430,198,232
050,18,077,"Indiana","Jefferson County",4,31,416,188,228
050,18,077,"Indiana","Jefferson County",4,32,423,193,230
050,18,077,"Indiana","Jefferson County",4,33,400,202,198
050,18,077,"Indiana","Jefferson County",4,34,349,178,171
050,18,077,"Indiana","Jefferson County",4,35,352,168,184
050,18,077,"Indiana","Jefferson County",4,36,371,178,193
050,18,077,"Indiana","Jefferson County",4,37,365,179,186
050,18,077,"Indiana","Jefferson County",4,38,374,184,190
050,18,077,"Indiana","Jefferson County",4,39,413,199,214
050,18,077,"Indiana","Jefferson County",4,40,408,191,217
050,18,077,"Indiana","Jefferson County",4,41,401,192,209
050,18,077,"Indiana","Jefferson County",4,42,402,198,204
050,18,077,"Indiana","Jefferson County",4,43,401,203,198
050,18,077,"Indiana","Jefferson County",4,44,383,182,201
050,18,077,"Indiana","Jefferson County",4,45,404,197,207
050,18,077,"Indiana","Jefferson County",4,46,389,184,205
050,18,077,"Indiana","Jefferson County",4,47,413,200,213
050,18,077,"Indiana","Jefferson County",4,48,377,189,188
050,18,077,"Indiana","Jefferson County",4,49,396,196,200
050,18,077,"Indiana","Jefferson County",4,50,428,214,214
050,18,077,"Indiana","Jefferson County",4,51,421,215,206
050,18,077,"Indiana","Jefferson County",4,52,437,211,226
050,18,077,"Indiana","Jefferson County",4,53,411,209,202
050,18,077,"Indiana","Jefferson County",4,54,430,216,214
050,18,077,"Indiana","Jefferson County",4,55,442,218,224
050,18,077,"Indiana","Jefferson County",4,56,417,206,211
050,18,077,"Indiana","Jefferson County",4,57,455,218,237
050,18,077,"Indiana","Jefferson County",4,58,494,246,248
050,18,077,"Indiana","Jefferson County",4,59,490,248,242
050,18,077,"Indiana","Jefferson County",4,60,504,261,243
050,18,077,"Indiana","Jefferson County",4,61,499,249,250
050,18,077,"Indiana","Jefferson County",4,62,498,242,256
050,18,077,"Indiana","Jefferson County",4,63,491,246,245
050,18,077,"Indiana","Jefferson County",4,64,495,245,250
050,18,077,"Indiana","Jefferson County",4,65,490,224,266
050,18,077,"Indiana","Jefferson County",4,66,442,225,217
050,18,077,"Indiana","Jefferson County",4,67,433,227,206
050,18,077,"Indiana","Jefferson County",4,68,385,189,196
050,18,077,"Indiana","Jefferson County",4,69,384,185,199
050,18,077,"Indiana","Jefferson County",4,70,397,206,191
050,18,077,"Indiana","Jefferson County",4,71,358,176,182
050,18,077,"Indiana","Jefferson County",4,72,343,173,170
050,18,077,"Indiana","Jefferson County",4,73,328,162,166
050,18,077,"Indiana","Jefferson County",4,74,317,149,168
050,18,077,"Indiana","Jefferson County",4,75,352,159,193
050,18,077,"Indiana","Jefferson County",4,76,230,103,127
050,18,077,"Indiana","Jefferson County",4,77,222,98,124
050,18,077,"Indiana","Jefferson County",4,78,211,80,131
050,18,077,"Indiana","Jefferson County",4,79,227,91,136
050,18,077,"Indiana","Jefferson County",4,80,195,85,110
050,18,077,"Indiana","Jefferson County",4,81,165,76,89
050,18,077,"Indiana","Jefferson County",4,82,158,64,94
050,18,077,"Indiana","Jefferson County",4,83,112,48,64
050,18,077,"Indiana","Jefferson County",4,84,90,40,50
050,18,077,"Indiana","Jefferson County",4,85,540,163,377
050,18,077,"Indiana","Jefferson County",5,0,342,161,181
050,18,077,"Indiana","Jefferson County",5,1,319,147,172
050,18,077,"Indiana","Jefferson County",5,2,340,170,170
050,18,077,"Indiana","Jefferson County",5,3,376,203,173
050,18,077,"Indiana","Jefferson County",5,4,357,166,191
050,18,077,"Indiana","Jefferson County",5,5,371,190,181
050,18,077,"Indiana","Jefferson County",5,6,394,203,191
050,18,077,"Indiana","Jefferson County",5,7,378,197,181
050,18,077,"Indiana","Jefferson County",5,8,364,196,168
050,18,077,"Indiana","Jefferson County",5,9,335,172,163
050,18,077,"Indiana","Jefferson County",5,10,332,168,164
050,18,077,"Indiana","Jefferson County",5,11,362,178,184
050,18,077,"Indiana","Jefferson County",5,12,331,162,169
050,18,077,"Indiana","Jefferson County",5,13,360,169,191
050,18,077,"Indiana","Jefferson County",5,14,361,188,173
050,18,077,"Indiana","Jefferson County",5,15,413,194,219
050,18,077,"Indiana","Jefferson County",5,16,418,196,222
050,18,077,"Indiana","Jefferson County",5,17,422,198,224
050,18,077,"Indiana","Jefferson County",5,18,386,196,190
050,18,077,"Indiana","Jefferson County",5,19,545,263,282
050,18,077,"Indiana","Jefferson County",5,20,520,250,270
050,18,077,"Indiana","Jefferson County",5,21,483,238,245
050,18,077,"Indiana","Jefferson County",5,22,440,231,209
050,18,077,"Indiana","Jefferson County",5,23,400,197,203
050,18,077,"Indiana","Jefferson County",5,24,378,180,198
050,18,077,"Indiana","Jefferson County",5,25,382,186,196
050,18,077,"Indiana","Jefferson County",5,26,404,197,207
050,18,077,"Indiana","Jefferson County",5,27,416,190,226
050,18,077,"Indiana","Jefferson County",5,28,416,178,238
050,18,077,"Indiana","Jefferson County",5,29,418,172,246
050,18,077,"Indiana","Jefferson County",5,30,404,181,223
050,18,077,"Indiana","Jefferson County",5,31,445,213,232
050,18,077,"Indiana","Jefferson County",5,32,424,206,218
050,18,077,"Indiana","Jefferson County",5,33,433,202,231
050,18,077,"Indiana","Jefferson County",5,34,394,196,198
050,18,077,"Indiana","Jefferson County",5,35,360,178,182
050,18,077,"Indiana","Jefferson County",5,36,356,172,184
050,18,077,"Indiana","Jefferson County",5,37,377,189,188
050,18,077,"Indiana","Jefferson County",5,38,355,175,180
050,18,077,"Indiana","Jefferson County",5,39,375,181,194
050,18,077,"Indiana","Jefferson County",5,40,410,195,215
050,18,077,"Indiana","Jefferson County",5,41,410,189,221
050,18,077,"Indiana","Jefferson County",5,42,406,201,205
050,18,077,"Indiana","Jefferson County",5,43,390,194,196
050,18,077,"Indiana","Jefferson County",5,44,400,199,201
050,18,077,"Indiana","Jefferson County",5,45,384,183,201
050,18,077,"Indiana","Jefferson County",5,46,413,188,225
050,18,077,"Indiana","Jefferson County",5,47,381,189,192
050,18,077,"Indiana","Jefferson County",5,48,415,204,211
050,18,077,"Indiana","Jefferson County",5,49,374,190,184
050,18,077,"Indiana","Jefferson County",5,50,404,203,201
050,18,077,"Indiana","Jefferson County",5,51,416,219,197
050,18,077,"Indiana","Jefferson County",5,52,431,215,216
050,18,077,"Indiana","Jefferson County",5,53,436,209,227
050,18,077,"Indiana","Jefferson County",5,54,422,218,204
050,18,077,"Indiana","Jefferson County",5,55,429,218,211
050,18,077,"Indiana","Jefferson County",5,56,432,217,215
050,18,077,"Indiana","Jefferson County",5,57,427,210,217
050,18,077,"Indiana","Jefferson County",5,58,442,215,227
050,18,077,"Indiana","Jefferson County",5,59,494,247,247
050,18,077,"Indiana","Jefferson County",5,60,487,246,241
050,18,077,"Indiana","Jefferson County",5,61,524,264,260
050,18,077,"Indiana","Jefferson County",5,62,498,254,244
050,18,077,"Indiana","Jefferson County",5,63,488,241,247
050,18,077,"Indiana","Jefferson County",5,64,479,239,240
050,18,077,"Indiana","Jefferson County",5,65,485,237,248
050,18,077,"Indiana","Jefferson County",5,66,488,221,267
050,18,077,"Indiana","Jefferson County",5,67,437,221,216
050,18,077,"Indiana","Jefferson County",5,68,413,220,193
050,18,077,"Indiana","Jefferson County",5,69,378,188,190
050,18,077,"Indiana","Jefferson County",5,70,372,184,188
050,18,077,"Indiana","Jefferson County",5,71,387,200,187
050,18,077,"Indiana","Jefferson County",5,72,352,172,180
050,18,077,"Indiana","Jefferson County",5,73,326,169,157
050,18,077,"Indiana","Jefferson County",5,74,329,162,167
050,18,077,"Indiana","Jefferson County",5,75,306,145,161
050,18,077,"Indiana","Jefferson County",5,76,336,147,189
050,18,077,"Indiana","Jefferson County",5,77,224,92,132
050,18,077,"Indiana","Jefferson County",5,78,211,94,117
050,18,077,"Indiana","Jefferson County",5,79,201,74,127
050,18,077,"Indiana","Jefferson County",5,80,219,88,131
050,18,077,"Indiana","Jefferson County",5,81,175,72,103
050,18,077,"Indiana","Jefferson County",5,82,160,69,91
050,18,077,"Indiana","Jefferson County",5,83,141,60,81
050,18,077,"Indiana","Jefferson County",5,84,94,40,54
050,18,077,"Indiana","Jefferson County",5,85,544,169,375
050,18,079,"Indiana","Jennings County",1,0,307,158,149
050,18,079,"Indiana","Jennings County",1,1,330,161,169
050,18,079,"Indiana","Jennings County",1,2,344,176,168
050,18,079,"Indiana","Jennings County",1,3,318,164,154
050,18,079,"Indiana","Jennings County",1,4,330,171,159
050,18,079,"Indiana","Jennings County",1,5,357,184,173
050,18,079,"Indiana","Jennings County",1,6,356,191,165
050,18,079,"Indiana","Jennings County",1,7,371,178,193
050,18,079,"Indiana","Jennings County",1,8,342,167,175
050,18,079,"Indiana","Jennings County",1,9,369,198,171
050,18,079,"Indiana","Jennings County",1,10,373,182,191
050,18,079,"Indiana","Jennings County",1,11,378,187,191
050,18,079,"Indiana","Jennings County",1,12,398,211,187
050,18,079,"Indiana","Jennings County",1,13,378,190,188
050,18,079,"Indiana","Jennings County",1,14,367,189,178
050,18,079,"Indiana","Jennings County",1,15,388,192,196
050,18,079,"Indiana","Jennings County",1,16,378,192,186
050,18,079,"Indiana","Jennings County",1,17,365,177,188
050,18,079,"Indiana","Jennings County",1,18,331,183,148
050,18,079,"Indiana","Jennings County",1,19,254,138,116
050,18,079,"Indiana","Jennings County",1,20,288,145,143
050,18,079,"Indiana","Jennings County",1,21,300,156,144
050,18,079,"Indiana","Jennings County",1,22,329,171,158
050,18,079,"Indiana","Jennings County",1,23,356,193,163
050,18,079,"Indiana","Jennings County",1,24,358,193,165
050,18,079,"Indiana","Jennings County",1,25,359,184,175
050,18,079,"Indiana","Jennings County",1,26,358,180,178
050,18,079,"Indiana","Jennings County",1,27,393,190,203
050,18,079,"Indiana","Jennings County",1,28,409,199,210
050,18,079,"Indiana","Jennings County",1,29,384,187,197
050,18,079,"Indiana","Jennings County",1,30,352,173,179
050,18,079,"Indiana","Jennings County",1,31,300,150,150
050,18,079,"Indiana","Jennings County",1,32,313,170,143
050,18,079,"Indiana","Jennings County",1,33,312,173,139
050,18,079,"Indiana","Jennings County",1,34,299,158,141
050,18,079,"Indiana","Jennings County",1,35,273,137,136
050,18,079,"Indiana","Jennings County",1,36,287,148,139
050,18,079,"Indiana","Jennings County",1,37,313,160,153
050,18,079,"Indiana","Jennings County",1,38,306,159,147
050,18,079,"Indiana","Jennings County",1,39,292,140,152
050,18,079,"Indiana","Jennings County",1,40,314,163,151
050,18,079,"Indiana","Jennings County",1,41,306,157,149
050,18,079,"Indiana","Jennings County",1,42,317,167,150
050,18,079,"Indiana","Jennings County",1,43,312,163,149
050,18,079,"Indiana","Jennings County",1,44,327,166,161
050,18,079,"Indiana","Jennings County",1,45,353,167,186
050,18,079,"Indiana","Jennings County",1,46,370,194,176
050,18,079,"Indiana","Jennings County",1,47,371,202,169
050,18,079,"Indiana","Jennings County",1,48,396,209,187
050,18,079,"Indiana","Jennings County",1,49,431,233,198
050,18,079,"Indiana","Jennings County",1,50,407,196,211
050,18,079,"Indiana","Jennings County",1,51,412,208,204
050,18,079,"Indiana","Jennings County",1,52,409,220,189
050,18,079,"Indiana","Jennings County",1,53,403,224,179
050,18,079,"Indiana","Jennings County",1,54,405,207,198
050,18,079,"Indiana","Jennings County",1,55,391,188,203
050,18,079,"Indiana","Jennings County",1,56,402,200,202
050,18,079,"Indiana","Jennings County",1,57,417,217,200
050,18,079,"Indiana","Jennings County",1,58,412,200,212
050,18,079,"Indiana","Jennings County",1,59,403,202,201
050,18,079,"Indiana","Jennings County",1,60,416,230,186
050,18,079,"Indiana","Jennings County",1,61,404,221,183
050,18,079,"Indiana","Jennings County",1,62,368,197,171
050,18,079,"Indiana","Jennings County",1,63,336,168,168
050,18,079,"Indiana","Jennings County",1,64,355,186,169
050,18,079,"Indiana","Jennings County",1,65,329,169,160
050,18,079,"Indiana","Jennings County",1,66,317,157,160
050,18,079,"Indiana","Jennings County",1,67,307,148,159
050,18,079,"Indiana","Jennings County",1,68,294,135,159
050,18,079,"Indiana","Jennings County",1,69,239,111,128
050,18,079,"Indiana","Jennings County",1,70,267,127,140
050,18,079,"Indiana","Jennings County",1,71,266,109,157
050,18,079,"Indiana","Jennings County",1,72,281,132,149
050,18,079,"Indiana","Jennings County",1,73,292,143,149
050,18,079,"Indiana","Jennings County",1,74,195,93,102
050,18,079,"Indiana","Jennings County",1,75,189,92,97
050,18,079,"Indiana","Jennings County",1,76,200,92,108
050,18,079,"Indiana","Jennings County",1,77,195,100,95
050,18,079,"Indiana","Jennings County",1,78,157,72,85
050,18,079,"Indiana","Jennings County",1,79,146,67,79
050,18,079,"Indiana","Jennings County",1,80,125,46,79
050,18,079,"Indiana","Jennings County",1,81,119,52,67
050,18,079,"Indiana","Jennings County",1,82,98,45,53
050,18,079,"Indiana","Jennings County",1,83,91,37,54
050,18,079,"Indiana","Jennings County",1,84,83,38,45
050,18,079,"Indiana","Jennings County",1,85,369,142,227
050,18,079,"Indiana","Jennings County",2,0,321,164,157
050,18,079,"Indiana","Jennings County",2,1,326,161,165
050,18,079,"Indiana","Jennings County",2,2,339,170,169
050,18,079,"Indiana","Jennings County",2,3,321,164,157
050,18,079,"Indiana","Jennings County",2,4,327,169,158
050,18,079,"Indiana","Jennings County",2,5,349,181,168
050,18,079,"Indiana","Jennings County",2,6,357,188,169
050,18,079,"Indiana","Jennings County",2,7,369,182,187
050,18,079,"Indiana","Jennings County",2,8,350,172,178
050,18,079,"Indiana","Jennings County",2,9,359,189,170
050,18,079,"Indiana","Jennings County",2,10,372,186,186
050,18,079,"Indiana","Jennings County",2,11,375,184,191
050,18,079,"Indiana","Jennings County",2,12,394,204,190
050,18,079,"Indiana","Jennings County",2,13,380,194,186
050,18,079,"Indiana","Jennings County",2,14,369,189,180
050,18,079,"Indiana","Jennings County",2,15,383,192,191
050,18,079,"Indiana","Jennings County",2,16,380,191,189
050,18,079,"Indiana","Jennings County",2,17,367,182,185
050,18,079,"Indiana","Jennings County",2,18,324,177,147
050,18,079,"Indiana","Jennings County",2,19,261,142,119
050,18,079,"Indiana","Jennings County",2,20,286,147,139
050,18,079,"Indiana","Jennings County",2,21,301,156,145
050,18,079,"Indiana","Jennings County",2,22,329,171,158
050,18,079,"Indiana","Jennings County",2,23,357,193,164
050,18,079,"Indiana","Jennings County",2,24,363,195,168
050,18,079,"Indiana","Jennings County",2,25,358,184,174
050,18,079,"Indiana","Jennings County",2,26,359,181,178
050,18,079,"Indiana","Jennings County",2,27,383,186,197
050,18,079,"Indiana","Jennings County",2,28,403,197,206
050,18,079,"Indiana","Jennings County",2,29,389,191,198
050,18,079,"Indiana","Jennings County",2,30,358,175,183
050,18,079,"Indiana","Jennings County",2,31,306,152,154
050,18,079,"Indiana","Jennings County",2,32,306,164,142
050,18,079,"Indiana","Jennings County",2,33,311,170,141
050,18,079,"Indiana","Jennings County",2,34,301,162,139
050,18,079,"Indiana","Jennings County",2,35,285,146,139
050,18,079,"Indiana","Jennings County",2,36,281,144,137
050,18,079,"Indiana","Jennings County",2,37,307,158,149
050,18,079,"Indiana","Jennings County",2,38,308,160,148
050,18,079,"Indiana","Jennings County",2,39,298,145,153
050,18,079,"Indiana","Jennings County",2,40,313,162,151
050,18,079,"Indiana","Jennings County",2,41,304,157,147
050,18,079,"Indiana","Jennings County",2,42,309,161,148
050,18,079,"Indiana","Jennings County",2,43,316,165,151
050,18,079,"Indiana","Jennings County",2,44,318,163,155
050,18,079,"Indiana","Jennings County",2,45,350,169,181
050,18,079,"Indiana","Jennings County",2,46,364,188,176
050,18,079,"Indiana","Jennings County",2,47,371,200,171
050,18,079,"Indiana","Jennings County",2,48,388,205,183
050,18,079,"Indiana","Jennings County",2,49,423,228,195
050,18,079,"Indiana","Jennings County",2,50,413,205,208
050,18,079,"Indiana","Jennings County",2,51,408,204,204
050,18,079,"Indiana","Jennings County",2,52,407,216,191
050,18,079,"Indiana","Jennings County",2,53,401,221,180
050,18,079,"Indiana","Jennings County",2,54,404,212,192
050,18,079,"Indiana","Jennings County",2,55,394,193,201
050,18,079,"Indiana","Jennings County",2,56,399,198,201
050,18,079,"Indiana","Jennings County",2,57,412,212,200
050,18,079,"Indiana","Jennings County",2,58,412,203,209
050,18,079,"Indiana","Jennings County",2,59,408,202,206
050,18,079,"Indiana","Jennings County",2,60,410,223,187
050,18,079,"Indiana","Jennings County",2,61,403,220,183
050,18,079,"Indiana","Jennings County",2,62,376,202,174
050,18,079,"Indiana","Jennings County",2,63,346,177,169
050,18,079,"Indiana","Jennings County",2,64,346,179,167
050,18,079,"Indiana","Jennings County",2,65,328,169,159
050,18,079,"Indiana","Jennings County",2,66,320,160,160
050,18,079,"Indiana","Jennings County",2,67,309,151,158
050,18,079,"Indiana","Jennings County",2,68,293,135,158
050,18,079,"Indiana","Jennings County",2,69,251,116,135
050,18,079,"Indiana","Jennings County",2,70,260,124,136
050,18,079,"Indiana","Jennings County",2,71,264,113,151
050,18,079,"Indiana","Jennings County",2,72,269,122,147
050,18,079,"Indiana","Jennings County",2,73,303,146,157
050,18,079,"Indiana","Jennings County",2,74,203,98,105
050,18,079,"Indiana","Jennings County",2,75,188,90,98
050,18,079,"Indiana","Jennings County",2,76,189,89,100
050,18,079,"Indiana","Jennings County",2,77,202,101,101
050,18,079,"Indiana","Jennings County",2,78,161,76,85
050,18,079,"Indiana","Jennings County",2,79,148,67,81
050,18,079,"Indiana","Jennings County",2,80,126,49,77
050,18,079,"Indiana","Jennings County",2,81,120,50,70
050,18,079,"Indiana","Jennings County",2,82,97,46,51
050,18,079,"Indiana","Jennings County",2,83,90,40,50
050,18,079,"Indiana","Jennings County",2,84,81,36,45
050,18,079,"Indiana","Jennings County",2,85,371,146,225
050,18,079,"Indiana","Jennings County",3,0,329,178,151
050,18,079,"Indiana","Jennings County",3,1,310,163,147
050,18,079,"Indiana","Jennings County",3,2,322,160,162
050,18,079,"Indiana","Jennings County",3,3,339,171,168
050,18,079,"Indiana","Jennings County",3,4,319,166,153
050,18,079,"Indiana","Jennings County",3,5,334,169,165
050,18,079,"Indiana","Jennings County",3,6,356,189,167
050,18,079,"Indiana","Jennings County",3,7,363,195,168
050,18,079,"Indiana","Jennings County",3,8,366,185,181
050,18,079,"Indiana","Jennings County",3,9,347,171,176
050,18,079,"Indiana","Jennings County",3,10,367,198,169
050,18,079,"Indiana","Jennings County",3,11,386,192,194
050,18,079,"Indiana","Jennings County",3,12,365,184,181
050,18,079,"Indiana","Jennings County",3,13,394,200,194
050,18,079,"Indiana","Jennings County",3,14,375,190,185
050,18,079,"Indiana","Jennings County",3,15,356,183,173
050,18,079,"Indiana","Jennings County",3,16,381,190,191
050,18,079,"Indiana","Jennings County",3,17,375,189,186
050,18,079,"Indiana","Jennings County",3,18,315,159,156
050,18,079,"Indiana","Jennings County",3,19,256,141,115
050,18,079,"Indiana","Jennings County",3,20,279,149,130
050,18,079,"Indiana","Jennings County",3,21,293,151,142
050,18,079,"Indiana","Jennings County",3,22,309,155,154
050,18,079,"Indiana","Jennings County",3,23,354,184,170
050,18,079,"Indiana","Jennings County",3,24,374,205,169
050,18,079,"Indiana","Jennings County",3,25,346,182,164
050,18,079,"Indiana","Jennings County",3,26,360,189,171
050,18,079,"Indiana","Jennings County",3,27,362,179,183
050,18,079,"Indiana","Jennings County",3,28,379,185,194
050,18,079,"Indiana","Jennings County",3,29,392,193,199
050,18,079,"Indiana","Jennings County",3,30,385,186,199
050,18,079,"Indiana","Jennings County",3,31,350,178,172
050,18,079,"Indiana","Jennings County",3,32,303,149,154
050,18,079,"Indiana","Jennings County",3,33,309,163,146
050,18,079,"Indiana","Jennings County",3,34,324,177,147
050,18,079,"Indiana","Jennings County",3,35,301,164,137
050,18,079,"Indiana","Jennings County",3,36,281,142,139
050,18,079,"Indiana","Jennings County",3,37,288,147,141
050,18,079,"Indiana","Jennings County",3,38,322,168,154
050,18,079,"Indiana","Jennings County",3,39,317,161,156
050,18,079,"Indiana","Jennings County",3,40,296,146,150
050,18,079,"Indiana","Jennings County",3,41,319,166,153
050,18,079,"Indiana","Jennings County",3,42,319,160,159
050,18,079,"Indiana","Jennings County",3,43,314,170,144
050,18,079,"Indiana","Jennings County",3,44,315,164,151
050,18,079,"Indiana","Jennings County",3,45,325,162,163
050,18,079,"Indiana","Jennings County",3,46,351,171,180
050,18,079,"Indiana","Jennings County",3,47,363,180,183
050,18,079,"Indiana","Jennings County",3,48,366,190,176
050,18,079,"Indiana","Jennings County",3,49,376,202,174
050,18,079,"Indiana","Jennings County",3,50,419,225,194
050,18,079,"Indiana","Jennings County",3,51,408,203,205
050,18,079,"Indiana","Jennings County",3,52,417,206,211
050,18,079,"Indiana","Jennings County",3,53,399,208,191
050,18,079,"Indiana","Jennings County",3,54,392,220,172
050,18,079,"Indiana","Jennings County",3,55,396,208,188
050,18,079,"Indiana","Jennings County",3,56,389,190,199
050,18,079,"Indiana","Jennings County",3,57,415,212,203
050,18,079,"Indiana","Jennings County",3,58,403,207,196
050,18,079,"Indiana","Jennings County",3,59,410,200,210
050,18,079,"Indiana","Jennings County",3,60,393,191,202
050,18,079,"Indiana","Jennings County",3,61,395,212,183
050,18,079,"Indiana","Jennings County",3,62,401,216,185
050,18,079,"Indiana","Jennings County",3,63,374,202,172
050,18,079,"Indiana","Jennings County",3,64,339,172,167
050,18,079,"Indiana","Jennings County",3,65,339,178,161
050,18,079,"Indiana","Jennings County",3,66,315,158,157
050,18,079,"Indiana","Jennings County",3,67,306,153,153
050,18,079,"Indiana","Jennings County",3,68,299,141,158
050,18,079,"Indiana","Jennings County",3,69,281,130,151
050,18,079,"Indiana","Jennings County",3,70,236,105,131
050,18,079,"Indiana","Jennings County",3,71,249,121,128
050,18,079,"Indiana","Jennings County",3,72,253,107,146
050,18,079,"Indiana","Jennings County",3,73,259,114,145
050,18,079,"Indiana","Jennings County",3,74,296,143,153
050,18,079,"Indiana","Jennings County",3,75,203,97,106
050,18,079,"Indiana","Jennings County",3,76,177,85,92
050,18,079,"Indiana","Jennings County",3,77,175,83,92
050,18,079,"Indiana","Jennings County",3,78,192,94,98
050,18,079,"Indiana","Jennings County",3,79,157,72,85
050,18,079,"Indiana","Jennings County",3,80,136,63,73
050,18,079,"Indiana","Jennings County",3,81,120,48,72
050,18,079,"Indiana","Jennings County",3,82,101,42,59
050,18,079,"Indiana","Jennings County",3,83,93,43,50
050,18,079,"Indiana","Jennings County",3,84,84,35,49
050,18,079,"Indiana","Jennings County",3,85,365,152,213
050,18,079,"Indiana","Jennings County",4,0,293,152,141
050,18,079,"Indiana","Jennings County",4,1,328,183,145
050,18,079,"Indiana","Jennings County",4,2,316,161,155
050,18,079,"Indiana","Jennings County",4,3,329,167,162
050,18,079,"Indiana","Jennings County",4,4,346,175,171
050,18,079,"Indiana","Jennings County",4,5,325,167,158
050,18,079,"Indiana","Jennings County",4,6,341,173,168
050,18,079,"Indiana","Jennings County",4,7,364,198,166
050,18,079,"Indiana","Jennings County",4,8,368,190,178
050,18,079,"Indiana","Jennings County",4,9,376,189,187
050,18,079,"Indiana","Jennings County",4,10,359,176,183
050,18,079,"Indiana","Jennings County",4,11,352,191,161
050,18,079,"Indiana","Jennings County",4,12,388,191,197
050,18,079,"Indiana","Jennings County",4,13,354,178,176
050,18,079,"Indiana","Jennings County",4,14,406,207,199
050,18,079,"Indiana","Jennings County",4,15,383,195,188
050,18,079,"Indiana","Jennings County",4,16,356,180,176
050,18,079,"Indiana","Jennings County",4,17,370,185,185
050,18,079,"Indiana","Jennings County",4,18,312,170,142
050,18,079,"Indiana","Jennings County",4,19,247,123,124
050,18,079,"Indiana","Jennings County",4,20,272,148,124
050,18,079,"Indiana","Jennings County",4,21,290,150,140
050,18,079,"Indiana","Jennings County",4,22,288,153,135
050,18,079,"Indiana","Jennings County",4,23,327,168,159
050,18,079,"Indiana","Jennings County",4,24,366,190,176
050,18,079,"Indiana","Jennings County",4,25,352,188,164
050,18,079,"Indiana","Jennings County",4,26,354,189,165
050,18,079,"Indiana","Jennings County",4,27,349,190,159
050,18,079,"Indiana","Jennings County",4,28,369,186,183
050,18,079,"Indiana","Jennings County",4,29,382,188,194
050,18,079,"Indiana","Jennings County",4,30,402,202,200
050,18,079,"Indiana","Jennings County",4,31,374,173,201
050,18,079,"Indiana","Jennings County",4,32,347,174,173
050,18,079,"Indiana","Jennings County",4,33,304,148,156
050,18,079,"Indiana","Jennings County",4,34,316,169,147
050,18,079,"Indiana","Jennings County",4,35,327,185,142
050,18,079,"Indiana","Jennings County",4,36,295,161,134
050,18,079,"Indiana","Jennings County",4,37,286,145,141
050,18,079,"Indiana","Jennings County",4,38,286,148,138
050,18,079,"Indiana","Jennings County",4,39,332,167,165
050,18,079,"Indiana","Jennings County",4,40,318,164,154
050,18,079,"Indiana","Jennings County",4,41,302,148,154
050,18,079,"Indiana","Jennings County",4,42,329,167,162
050,18,079,"Indiana","Jennings County",4,43,314,163,151
050,18,079,"Indiana","Jennings County",4,44,324,179,145
050,18,079,"Indiana","Jennings County",4,45,308,156,152
050,18,079,"Indiana","Jennings County",4,46,342,169,173
050,18,079,"Indiana","Jennings County",4,47,345,170,175
050,18,079,"Indiana","Jennings County",4,48,370,183,187
050,18,079,"Indiana","Jennings County",4,49,367,195,172
050,18,079,"Indiana","Jennings County",4,50,376,206,170
050,18,079,"Indiana","Jennings County",4,51,414,225,189
050,18,079,"Indiana","Jennings County",4,52,411,210,201
050,18,079,"Indiana","Jennings County",4,53,407,201,206
050,18,079,"Indiana","Jennings County",4,54,393,204,189
050,18,079,"Indiana","Jennings County",4,55,390,214,176
050,18,079,"Indiana","Jennings County",4,56,383,203,180
050,18,079,"Indiana","Jennings County",4,57,392,190,202
050,18,079,"Indiana","Jennings County",4,58,409,208,201
050,18,079,"Indiana","Jennings County",4,59,403,207,196
050,18,079,"Indiana","Jennings County",4,60,395,187,208
050,18,079,"Indiana","Jennings County",4,61,394,190,204
050,18,079,"Indiana","Jennings County",4,62,392,206,186
050,18,079,"Indiana","Jennings County",4,63,399,219,180
050,18,079,"Indiana","Jennings County",4,64,369,204,165
050,18,079,"Indiana","Jennings County",4,65,337,171,166
050,18,079,"Indiana","Jennings County",4,66,321,169,152
050,18,079,"Indiana","Jennings County",4,67,291,147,144
050,18,079,"Indiana","Jennings County",4,68,296,148,148
050,18,079,"Indiana","Jennings County",4,69,288,138,150
050,18,079,"Indiana","Jennings County",4,70,268,123,145
050,18,079,"Indiana","Jennings County",4,71,228,102,126
050,18,079,"Indiana","Jennings County",4,72,243,118,125
050,18,079,"Indiana","Jennings County",4,73,239,96,143
050,18,079,"Indiana","Jennings County",4,74,249,109,140
050,18,079,"Indiana","Jennings County",4,75,286,143,143
050,18,079,"Indiana","Jennings County",4,76,187,90,97
050,18,079,"Indiana","Jennings County",4,77,168,82,86
050,18,079,"Indiana","Jennings County",4,78,171,81,90
050,18,079,"Indiana","Jennings County",4,79,187,89,98
050,18,079,"Indiana","Jennings County",4,80,145,66,79
050,18,079,"Indiana","Jennings County",4,81,127,61,66
050,18,079,"Indiana","Jennings County",4,82,108,41,67
050,18,079,"Indiana","Jennings County",4,83,99,42,57
050,18,079,"Indiana","Jennings County",4,84,86,41,45
050,18,079,"Indiana","Jennings County",4,85,383,166,217
050,18,079,"Indiana","Jennings County",5,0,285,147,138
050,18,079,"Indiana","Jennings County",5,1,308,162,146
050,18,079,"Indiana","Jennings County",5,2,330,186,144
050,18,079,"Indiana","Jennings County",5,3,321,161,160
050,18,079,"Indiana","Jennings County",5,4,330,169,161
050,18,079,"Indiana","Jennings County",5,5,352,187,165
050,18,079,"Indiana","Jennings County",5,6,329,167,162
050,18,079,"Indiana","Jennings County",5,7,336,167,169
050,18,079,"Indiana","Jennings County",5,8,361,195,166
050,18,079,"Indiana","Jennings County",5,9,382,196,186
050,18,079,"Indiana","Jennings County",5,10,374,195,179
050,18,079,"Indiana","Jennings County",5,11,360,177,183
050,18,079,"Indiana","Jennings County",5,12,363,201,162
050,18,079,"Indiana","Jennings County",5,13,401,198,203
050,18,079,"Indiana","Jennings County",5,14,372,187,185
050,18,079,"Indiana","Jennings County",5,15,402,211,191
050,18,079,"Indiana","Jennings County",5,16,391,191,200
050,18,079,"Indiana","Jennings County",5,17,359,183,176
050,18,079,"Indiana","Jennings County",5,18,319,162,157
050,18,079,"Indiana","Jennings County",5,19,239,138,101
050,18,079,"Indiana","Jennings County",5,20,264,135,129
050,18,079,"Indiana","Jennings County",5,21,284,151,133
050,18,079,"Indiana","Jennings County",5,22,313,152,161
050,18,079,"Indiana","Jennings County",5,23,332,172,160
050,18,079,"Indiana","Jennings County",5,24,335,172,163
050,18,079,"Indiana","Jennings County",5,25,357,185,172
050,18,079,"Indiana","Jennings County",5,26,355,186,169
050,18,079,"Indiana","Jennings County",5,27,366,191,175
050,18,079,"Indiana","Jennings County",5,28,342,193,149
050,18,079,"Indiana","Jennings County",5,29,377,194,183
050,18,079,"Indiana","Jennings County",5,30,380,180,200
050,18,079,"Indiana","Jennings County",5,31,398,198,200
050,18,079,"Indiana","Jennings County",5,32,370,178,192
050,18,079,"Indiana","Jennings County",5,33,348,169,179
050,18,079,"Indiana","Jennings County",5,34,316,154,162
050,18,079,"Indiana","Jennings County",5,35,313,164,149
050,18,079,"Indiana","Jennings County",5,36,326,178,148
050,18,079,"Indiana","Jennings County",5,37,302,165,137
050,18,079,"Indiana","Jennings County",5,38,303,148,155
050,18,079,"Indiana","Jennings County",5,39,286,146,140
050,18,079,"Indiana","Jennings County",5,40,341,171,170
050,18,079,"Indiana","Jennings County",5,41,326,168,158
050,18,079,"Indiana","Jennings County",5,42,313,150,163
050,18,079,"Indiana","Jennings County",5,43,326,164,162
050,18,079,"Indiana","Jennings County",5,44,314,165,149
050,18,079,"Indiana","Jennings County",5,45,326,174,152
050,18,079,"Indiana","Jennings County",5,46,319,163,156
050,18,079,"Indiana","Jennings County",5,47,336,164,172
050,18,079,"Indiana","Jennings County",5,48,337,163,174
050,18,079,"Indiana","Jennings County",5,49,368,187,181
050,18,079,"Indiana","Jennings County",5,50,360,197,163
050,18,079,"Indiana","Jennings County",5,51,392,217,175
050,18,079,"Indiana","Jennings County",5,52,413,213,200
050,18,079,"Indiana","Jennings County",5,53,401,206,195
050,18,079,"Indiana","Jennings County",5,54,399,201,198
050,18,079,"Indiana","Jennings County",5,55,401,204,197
050,18,079,"Indiana","Jennings County",5,56,394,212,182
050,18,079,"Indiana","Jennings County",5,57,377,202,175
050,18,079,"Indiana","Jennings County",5,58,390,188,202
050,18,079,"Indiana","Jennings County",5,59,417,211,206
050,18,079,"Indiana","Jennings County",5,60,397,207,190
050,18,079,"Indiana","Jennings County",5,61,390,181,209
050,18,079,"Indiana","Jennings County",5,62,394,186,208
050,18,079,"Indiana","Jennings County",5,63,378,201,177
050,18,079,"Indiana","Jennings County",5,64,396,219,177
050,18,079,"Indiana","Jennings County",5,65,370,204,166
050,18,079,"Indiana","Jennings County",5,66,327,169,158
050,18,079,"Indiana","Jennings County",5,67,307,163,144
050,18,079,"Indiana","Jennings County",5,68,282,139,143
050,18,079,"Indiana","Jennings County",5,69,288,145,143
050,18,079,"Indiana","Jennings County",5,70,277,135,142
050,18,079,"Indiana","Jennings County",5,71,272,124,148
050,18,079,"Indiana","Jennings County",5,72,218,95,123
050,18,079,"Indiana","Jennings County",5,73,233,112,121
050,18,079,"Indiana","Jennings County",5,74,230,91,139
050,18,079,"Indiana","Jennings County",5,75,243,107,136
050,18,079,"Indiana","Jennings County",5,76,271,137,134
050,18,079,"Indiana","Jennings County",5,77,177,86,91
050,18,079,"Indiana","Jennings County",5,78,160,78,82
050,18,079,"Indiana","Jennings County",5,79,158,73,85
050,18,079,"Indiana","Jennings County",5,80,177,85,92
050,18,079,"Indiana","Jennings County",5,81,138,64,74
050,18,079,"Indiana","Jennings County",5,82,115,56,59
050,18,079,"Indiana","Jennings County",5,83,106,39,67
050,18,079,"Indiana","Jennings County",5,84,87,38,49
050,18,079,"Indiana","Jennings County",5,85,400,184,216
050,18,081,"Indiana","Johnson County",1,0,1833,946,887
050,18,081,"Indiana","Johnson County",1,1,1880,954,926
050,18,081,"Indiana","Johnson County",1,2,1970,1018,952
050,18,081,"Indiana","Johnson County",1,3,2068,1060,1008
050,18,081,"Indiana","Johnson County",1,4,2172,1180,992
050,18,081,"Indiana","Johnson County",1,5,2231,1175,1056
050,18,081,"Indiana","Johnson County",1,6,2228,1142,1086
050,18,081,"Indiana","Johnson County",1,7,2196,1092,1104
050,18,081,"Indiana","Johnson County",1,8,2223,1122,1101
050,18,081,"Indiana","Johnson County",1,9,2221,1132,1089
050,18,081,"Indiana","Johnson County",1,10,2323,1204,1119
050,18,081,"Indiana","Johnson County",1,11,2382,1230,1152
050,18,081,"Indiana","Johnson County",1,12,2444,1229,1215
050,18,081,"Indiana","Johnson County",1,13,2377,1201,1176
050,18,081,"Indiana","Johnson County",1,14,2330,1187,1143
050,18,081,"Indiana","Johnson County",1,15,2350,1238,1112
050,18,081,"Indiana","Johnson County",1,16,2372,1252,1120
050,18,081,"Indiana","Johnson County",1,17,2270,1187,1083
050,18,081,"Indiana","Johnson County",1,18,1959,1024,935
050,18,081,"Indiana","Johnson County",1,19,1722,923,799
050,18,081,"Indiana","Johnson County",1,20,1811,955,856
050,18,081,"Indiana","Johnson County",1,21,1892,988,904
050,18,081,"Indiana","Johnson County",1,22,1871,972,899
050,18,081,"Indiana","Johnson County",1,23,2003,1028,975
050,18,081,"Indiana","Johnson County",1,24,2044,1009,1035
050,18,081,"Indiana","Johnson County",1,25,2003,968,1035
050,18,081,"Indiana","Johnson County",1,26,2083,1028,1055
050,18,081,"Indiana","Johnson County",1,27,2144,1075,1069
050,18,081,"Indiana","Johnson County",1,28,2230,1145,1085
050,18,081,"Indiana","Johnson County",1,29,2220,1117,1103
050,18,081,"Indiana","Johnson County",1,30,2180,1108,1072
050,18,081,"Indiana","Johnson County",1,31,2134,1081,1053
050,18,081,"Indiana","Johnson County",1,32,2166,1052,1114
050,18,081,"Indiana","Johnson County",1,33,2143,1050,1093
050,18,081,"Indiana","Johnson County",1,34,2233,1089,1144
050,18,081,"Indiana","Johnson County",1,35,2182,1077,1105
050,18,081,"Indiana","Johnson County",1,36,2230,1084,1146
050,18,081,"Indiana","Johnson County",1,37,2242,1107,1135
050,18,081,"Indiana","Johnson County",1,38,2322,1167,1155
050,18,081,"Indiana","Johnson County",1,39,2348,1192,1156
050,18,081,"Indiana","Johnson County",1,40,2323,1166,1157
050,18,081,"Indiana","Johnson County",1,41,2225,1122,1103
050,18,081,"Indiana","Johnson County",1,42,2187,1107,1080
050,18,081,"Indiana","Johnson County",1,43,2062,1056,1006
050,18,081,"Indiana","Johnson County",1,44,2021,996,1025
050,18,081,"Indiana","Johnson County",1,45,2055,1034,1021
050,18,081,"Indiana","Johnson County",1,46,1992,1006,986
050,18,081,"Indiana","Johnson County",1,47,2018,1013,1005
050,18,081,"Indiana","Johnson County",1,48,2162,1119,1043
050,18,081,"Indiana","Johnson County",1,49,2259,1153,1106
050,18,081,"Indiana","Johnson County",1,50,2105,1080,1025
050,18,081,"Indiana","Johnson County",1,51,1975,1012,963
050,18,081,"Indiana","Johnson County",1,52,1943,983,960
050,18,081,"Indiana","Johnson County",1,53,2028,1023,1005
050,18,081,"Indiana","Johnson County",1,54,2015,994,1021
050,18,081,"Indiana","Johnson County",1,55,2064,1007,1057
050,18,081,"Indiana","Johnson County",1,56,2103,1047,1056
050,18,081,"Indiana","Johnson County",1,57,2055,1032,1023
050,18,081,"Indiana","Johnson County",1,58,2082,1036,1046
050,18,081,"Indiana","Johnson County",1,59,2089,1038,1051
050,18,081,"Indiana","Johnson County",1,60,2005,977,1028
050,18,081,"Indiana","Johnson County",1,61,1992,975,1017
050,18,081,"Indiana","Johnson County",1,62,1930,952,978
050,18,081,"Indiana","Johnson County",1,63,1847,916,931
050,18,081,"Indiana","Johnson County",1,64,1791,835,956
050,18,081,"Indiana","Johnson County",1,65,1709,819,890
050,18,081,"Indiana","Johnson County",1,66,1640,789,851
050,18,081,"Indiana","Johnson County",1,67,1580,729,851
050,18,081,"Indiana","Johnson County",1,68,1543,728,815
050,18,081,"Indiana","Johnson County",1,69,1436,678,758
050,18,081,"Indiana","Johnson County",1,70,1397,637,760
050,18,081,"Indiana","Johnson County",1,71,1439,648,791
050,18,081,"Indiana","Johnson County",1,72,1347,632,715
050,18,081,"Indiana","Johnson County",1,73,1333,634,699
050,18,081,"Indiana","Johnson County",1,74,925,449,476
050,18,081,"Indiana","Johnson County",1,75,914,424,490
050,18,081,"Indiana","Johnson County",1,76,962,418,544
050,18,081,"Indiana","Johnson County",1,77,979,436,543
050,18,081,"Indiana","Johnson County",1,78,836,361,475
050,18,081,"Indiana","Johnson County",1,79,764,336,428
050,18,081,"Indiana","Johnson County",1,80,679,292,387
050,18,081,"Indiana","Johnson County",1,81,644,254,390
050,18,081,"Indiana","Johnson County",1,82,574,229,345
050,18,081,"Indiana","Johnson County",1,83,541,223,318
050,18,081,"Indiana","Johnson County",1,84,473,198,275
050,18,081,"Indiana","Johnson County",1,85,2688,879,1809
050,18,081,"Indiana","Johnson County",2,0,1824,926,898
050,18,081,"Indiana","Johnson County",2,1,1883,959,924
050,18,081,"Indiana","Johnson County",2,2,1973,1010,963
050,18,081,"Indiana","Johnson County",2,3,2054,1056,998
050,18,081,"Indiana","Johnson County",2,4,2169,1166,1003
050,18,081,"Indiana","Johnson County",2,5,2221,1178,1043
050,18,081,"Indiana","Johnson County",2,6,2237,1150,1087
050,18,081,"Indiana","Johnson County",2,7,2208,1105,1103
050,18,081,"Indiana","Johnson County",2,8,2214,1118,1096
050,18,081,"Indiana","Johnson County",2,9,2229,1138,1091
050,18,081,"Indiana","Johnson County",2,10,2315,1194,1121
050,18,081,"Indiana","Johnson County",2,11,2365,1222,1143
050,18,081,"Indiana","Johnson County",2,12,2448,1242,1206
050,18,081,"Indiana","Johnson County",2,13,2405,1216,1189
050,18,081,"Indiana","Johnson County",2,14,2349,1198,1151
050,18,081,"Indiana","Johnson County",2,15,2352,1226,1126
050,18,081,"Indiana","Johnson County",2,16,2375,1252,1123
050,18,081,"Indiana","Johnson County",2,17,2293,1205,1088
050,18,081,"Indiana","Johnson County",2,18,1953,1031,922
050,18,081,"Indiana","Johnson County",2,19,1732,921,811
050,18,081,"Indiana","Johnson County",2,20,1849,979,870
050,18,081,"Indiana","Johnson County",2,21,1890,982,908
050,18,081,"Indiana","Johnson County",2,22,1898,987,911
050,18,081,"Indiana","Johnson County",2,23,1984,1016,968
050,18,081,"Indiana","Johnson County",2,24,2025,1007,1018
050,18,081,"Indiana","Johnson County",2,25,2021,980,1041
050,18,081,"Indiana","Johnson County",2,26,2079,1020,1059
050,18,081,"Indiana","Johnson County",2,27,2134,1068,1066
050,18,081,"Indiana","Johnson County",2,28,2227,1137,1090
050,18,081,"Indiana","Johnson County",2,29,2248,1139,1109
050,18,081,"Indiana","Johnson County",2,30,2224,1130,1094
050,18,081,"Indiana","Johnson County",2,31,2162,1098,1064
050,18,081,"Indiana","Johnson County",2,32,2177,1067,1110
050,18,081,"Indiana","Johnson County",2,33,2160,1057,1103
050,18,081,"Indiana","Johnson County",2,34,2219,1084,1135
050,18,081,"Indiana","Johnson County",2,35,2220,1095,1125
050,18,081,"Indiana","Johnson County",2,36,2218,1085,1133
050,18,081,"Indiana","Johnson County",2,37,2255,1114,1141
050,18,081,"Indiana","Johnson County",2,38,2314,1158,1156
050,18,081,"Indiana","Johnson County",2,39,2342,1188,1154
050,18,081,"Indiana","Johnson County",2,40,2337,1173,1164
050,18,081,"Indiana","Johnson County",2,41,2257,1136,1121
050,18,081,"Indiana","Johnson County",2,42,2189,1108,1081
050,18,081,"Indiana","Johnson County",2,43,2114,1079,1035
050,18,081,"Indiana","Johnson County",2,44,2017,1004,1013
050,18,081,"Indiana","Johnson County",2,45,2052,1028,1024
050,18,081,"Indiana","Johnson County",2,46,1996,1000,996
050,18,081,"Indiana","Johnson County",2,47,2002,1008,994
050,18,081,"Indiana","Johnson County",2,48,2114,1085,1029
050,18,081,"Indiana","Johnson County",2,49,2245,1151,1094
050,18,081,"Indiana","Johnson County",2,50,2147,1099,1048
050,18,081,"Indiana","Johnson County",2,51,2001,1026,975
050,18,081,"Indiana","Johnson County",2,52,1947,992,955
050,18,081,"Indiana","Johnson County",2,53,2019,1016,1003
050,18,081,"Indiana","Johnson County",2,54,2009,996,1013
050,18,081,"Indiana","Johnson County",2,55,2046,1000,1046
050,18,081,"Indiana","Johnson County",2,56,2096,1040,1056
050,18,081,"Indiana","Johnson County",2,57,2076,1040,1036
050,18,081,"Indiana","Johnson County",2,58,2073,1028,1045
050,18,081,"Indiana","Johnson County",2,59,2085,1034,1051
050,18,081,"Indiana","Johnson County",2,60,2021,990,1031
050,18,081,"Indiana","Johnson County",2,61,1980,966,1014
050,18,081,"Indiana","Johnson County",2,62,1938,954,984
050,18,081,"Indiana","Johnson County",2,63,1877,929,948
050,18,081,"Indiana","Johnson County",2,64,1797,853,944
050,18,081,"Indiana","Johnson County",2,65,1723,821,902
050,18,081,"Indiana","Johnson County",2,66,1657,796,861
050,18,081,"Indiana","Johnson County",2,67,1587,740,847
050,18,081,"Indiana","Johnson County",2,68,1532,718,814
050,18,081,"Indiana","Johnson County",2,69,1465,687,778
050,18,081,"Indiana","Johnson County",2,70,1403,640,763
050,18,081,"Indiana","Johnson County",2,71,1423,641,782
050,18,081,"Indiana","Johnson County",2,72,1338,625,713
050,18,081,"Indiana","Johnson County",2,73,1400,665,735
050,18,081,"Indiana","Johnson County",2,74,958,463,495
050,18,081,"Indiana","Johnson County",2,75,913,423,490
050,18,081,"Indiana","Johnson County",2,76,937,408,529
050,18,081,"Indiana","Johnson County",2,77,984,434,550
050,18,081,"Indiana","Johnson County",2,78,845,362,483
050,18,081,"Indiana","Johnson County",2,79,777,343,434
050,18,081,"Indiana","Johnson County",2,80,684,294,390
050,18,081,"Indiana","Johnson County",2,81,636,256,380
050,18,081,"Indiana","Johnson County",2,82,580,229,351
050,18,081,"Indiana","Johnson County",2,83,545,224,321
050,18,081,"Indiana","Johnson County",2,84,478,200,278
050,18,081,"Indiana","Johnson County",2,85,2692,885,1807
050,18,081,"Indiana","Johnson County",3,0,1805,966,839
050,18,081,"Indiana","Johnson County",3,1,1943,978,965
050,18,081,"Indiana","Johnson County",3,2,1982,1008,974
050,18,081,"Indiana","Johnson County",3,3,1995,988,1007
050,18,081,"Indiana","Johnson County",3,4,2137,1128,1009
050,18,081,"Indiana","Johnson County",3,5,2184,1167,1017
050,18,081,"Indiana","Johnson County",3,6,2253,1199,1054
050,18,081,"Indiana","Johnson County",3,7,2285,1150,1135
050,18,081,"Indiana","Johnson County",3,8,2248,1113,1135
050,18,081,"Indiana","Johnson County",3,9,2234,1129,1105
050,18,081,"Indiana","Johnson County",3,10,2271,1144,1127
050,18,081,"Indiana","Johnson County",3,11,2360,1208,1152
050,18,081,"Indiana","Johnson County",3,12,2376,1235,1141
050,18,081,"Indiana","Johnson County",3,13,2472,1263,1209
050,18,081,"Indiana","Johnson County",3,14,2419,1218,1201
050,18,081,"Indiana","Johnson County",3,15,2354,1178,1176
050,18,081,"Indiana","Johnson County",3,16,2339,1214,1125
050,18,081,"Indiana","Johnson County",3,17,2370,1263,1107
050,18,081,"Indiana","Johnson County",3,18,1984,1061,923
050,18,081,"Indiana","Johnson County",3,19,1743,908,835
050,18,081,"Indiana","Johnson County",3,20,1847,970,877
050,18,081,"Indiana","Johnson County",3,21,1960,1008,952
050,18,081,"Indiana","Johnson County",3,22,2014,1053,961
050,18,081,"Indiana","Johnson County",3,23,1952,1048,904
050,18,081,"Indiana","Johnson County",3,24,2039,1036,1003
050,18,081,"Indiana","Johnson County",3,25,2064,1065,999
050,18,081,"Indiana","Johnson County",3,26,2170,1074,1096
050,18,081,"Indiana","Johnson County",3,27,2148,1067,1081
050,18,081,"Indiana","Johnson County",3,28,2188,1087,1101
050,18,081,"Indiana","Johnson County",3,29,2299,1174,1125
050,18,081,"Indiana","Johnson County",3,30,2300,1176,1124
050,18,081,"Indiana","Johnson County",3,31,2302,1164,1138
050,18,081,"Indiana","Johnson County",3,32,2187,1099,1088
050,18,081,"Indiana","Johnson County",3,33,2268,1129,1139
050,18,081,"Indiana","Johnson County",3,34,2231,1108,1123
050,18,081,"Indiana","Johnson County",3,35,2284,1124,1160
050,18,081,"Indiana","Johnson County",3,36,2247,1113,1134
050,18,081,"Indiana","Johnson County",3,37,2265,1110,1155
050,18,081,"Indiana","Johnson County",3,38,2263,1121,1142
050,18,081,"Indiana","Johnson County",3,39,2326,1174,1152
050,18,081,"Indiana","Johnson County",3,40,2352,1194,1158
050,18,081,"Indiana","Johnson County",3,41,2365,1181,1184
050,18,081,"Indiana","Johnson County",3,42,2297,1160,1137
050,18,081,"Indiana","Johnson County",3,43,2197,1118,1079
050,18,081,"Indiana","Johnson County",3,44,2081,1064,1017
050,18,081,"Indiana","Johnson County",3,45,2026,1008,1018
050,18,081,"Indiana","Johnson County",3,46,2097,1034,1063
050,18,081,"Indiana","Johnson County",3,47,2016,1025,991
050,18,081,"Indiana","Johnson County",3,48,2014,1008,1006
050,18,081,"Indiana","Johnson County",3,49,2130,1105,1025
050,18,081,"Indiana","Johnson County",3,50,2233,1132,1101
050,18,081,"Indiana","Johnson County",3,51,2159,1115,1044
050,18,081,"Indiana","Johnson County",3,52,2012,1038,974
050,18,081,"Indiana","Johnson County",3,53,1951,989,962
050,18,081,"Indiana","Johnson County",3,54,2018,1031,987
050,18,081,"Indiana","Johnson County",3,55,2007,980,1027
050,18,081,"Indiana","Johnson County",3,56,2038,1009,1029
050,18,081,"Indiana","Johnson County",3,57,2107,1050,1057
050,18,081,"Indiana","Johnson County",3,58,2088,1030,1058
050,18,081,"Indiana","Johnson County",3,59,2055,1025,1030
050,18,081,"Indiana","Johnson County",3,60,2077,1024,1053
050,18,081,"Indiana","Johnson County",3,61,2013,978,1035
050,18,081,"Indiana","Johnson County",3,62,1938,943,995
050,18,081,"Indiana","Johnson County",3,63,1930,940,990
050,18,081,"Indiana","Johnson County",3,64,1878,926,952
050,18,081,"Indiana","Johnson County",3,65,1767,837,930
050,18,081,"Indiana","Johnson County",3,66,1712,813,899
050,18,081,"Indiana","Johnson County",3,67,1637,781,856
050,18,081,"Indiana","Johnson County",3,68,1559,729,830
050,18,081,"Indiana","Johnson County",3,69,1509,704,805
050,18,081,"Indiana","Johnson County",3,70,1431,649,782
050,18,081,"Indiana","Johnson County",3,71,1377,621,756
050,18,081,"Indiana","Johnson County",3,72,1365,621,744
050,18,081,"Indiana","Johnson County",3,73,1298,595,703
050,18,081,"Indiana","Johnson County",3,74,1392,656,736
050,18,081,"Indiana","Johnson County",3,75,932,432,500
050,18,081,"Indiana","Johnson County",3,76,896,404,492
050,18,081,"Indiana","Johnson County",3,77,903,401,502
050,18,081,"Indiana","Johnson County",3,78,942,394,548
050,18,081,"Indiana","Johnson County",3,79,834,363,471
050,18,081,"Indiana","Johnson County",3,80,716,313,403
050,18,081,"Indiana","Johnson County",3,81,635,256,379
050,18,081,"Indiana","Johnson County",3,82,578,230,348
050,18,081,"Indiana","Johnson County",3,83,554,219,335
050,18,081,"Indiana","Johnson County",3,84,473,194,279
050,18,081,"Indiana","Johnson County",3,85,2697,885,1812
050,18,081,"Indiana","Johnson County",4,0,1858,986,872
050,18,081,"Indiana","Johnson County",4,1,1917,1021,896
050,18,081,"Indiana","Johnson County",4,2,1988,1007,981
050,18,081,"Indiana","Johnson County",4,3,2017,1026,991
050,18,081,"Indiana","Johnson County",4,4,2084,1058,1026
050,18,081,"Indiana","Johnson County",4,5,2186,1139,1047
050,18,081,"Indiana","Johnson County",4,6,2237,1182,1055
050,18,081,"Indiana","Johnson County",4,7,2308,1232,1076
050,18,081,"Indiana","Johnson County",4,8,2326,1183,1143
050,18,081,"Indiana","Johnson County",4,9,2315,1161,1154
050,18,081,"Indiana","Johnson County",4,10,2258,1135,1123
050,18,081,"Indiana","Johnson County",4,11,2310,1174,1136
050,18,081,"Indiana","Johnson County",4,12,2390,1213,1177
050,18,081,"Indiana","Johnson County",4,13,2415,1260,1155
050,18,081,"Indiana","Johnson County",4,14,2478,1272,1206
050,18,081,"Indiana","Johnson County",4,15,2458,1246,1212
050,18,081,"Indiana","Johnson County",4,16,2361,1200,1161
050,18,081,"Indiana","Johnson County",4,17,2372,1248,1124
050,18,081,"Indiana","Johnson County",4,18,2017,1095,922
050,18,081,"Indiana","Johnson County",4,19,1680,878,802
050,18,081,"Indiana","Johnson County",4,20,1832,952,880
050,18,081,"Indiana","Johnson County",4,21,1908,967,941
050,18,081,"Indiana","Johnson County",4,22,2050,1053,997
050,18,081,"Indiana","Johnson County",4,23,1999,1062,937
050,18,081,"Indiana","Johnson County",4,24,1944,1025,919
050,18,081,"Indiana","Johnson County",4,25,2089,1065,1024
050,18,081,"Indiana","Johnson County",4,26,2162,1112,1050
050,18,081,"Indiana","Johnson County",4,27,2153,1061,1092
050,18,081,"Indiana","Johnson County",4,28,2174,1087,1087
050,18,081,"Indiana","Johnson County",4,29,2202,1094,1108
050,18,081,"Indiana","Johnson County",4,30,2288,1177,1111
050,18,081,"Indiana","Johnson County",4,31,2313,1203,1110
050,18,081,"Indiana","Johnson County",4,32,2321,1167,1154
050,18,081,"Indiana","Johnson County",4,33,2216,1099,1117
050,18,081,"Indiana","Johnson County",4,34,2331,1144,1187
050,18,081,"Indiana","Johnson County",4,35,2332,1159,1173
050,18,081,"Indiana","Johnson County",4,36,2338,1172,1166
050,18,081,"Indiana","Johnson County",4,37,2270,1124,1146
050,18,081,"Indiana","Johnson County",4,38,2286,1116,1170
050,18,081,"Indiana","Johnson County",4,39,2330,1178,1152
050,18,081,"Indiana","Johnson County",4,40,2372,1192,1180
050,18,081,"Indiana","Johnson County",4,41,2403,1232,1171
050,18,081,"Indiana","Johnson County",4,42,2324,1155,1169
050,18,081,"Indiana","Johnson County",4,43,2295,1155,1140
050,18,081,"Indiana","Johnson County",4,44,2191,1126,1065
050,18,081,"Indiana","Johnson County",4,45,2085,1077,1008
050,18,081,"Indiana","Johnson County",4,46,2000,1000,1000
050,18,081,"Indiana","Johnson County",4,47,2117,1060,1057
050,18,081,"Indiana","Johnson County",4,48,1995,1004,991
050,18,081,"Indiana","Johnson County",4,49,1986,996,990
050,18,081,"Indiana","Johnson County",4,50,2125,1090,1035
050,18,081,"Indiana","Johnson County",4,51,2203,1112,1091
050,18,081,"Indiana","Johnson County",4,52,2151,1108,1043
050,18,081,"Indiana","Johnson County",4,53,2005,1042,963
050,18,081,"Indiana","Johnson County",4,54,1914,976,938
050,18,081,"Indiana","Johnson County",4,55,1988,1002,986
050,18,081,"Indiana","Johnson County",4,56,1992,951,1041
050,18,081,"Indiana","Johnson County",4,57,2031,1002,1029
050,18,081,"Indiana","Johnson County",4,58,2085,1030,1055
050,18,081,"Indiana","Johnson County",4,59,2058,1010,1048
050,18,081,"Indiana","Johnson County",4,60,2038,1016,1022
050,18,081,"Indiana","Johnson County",4,61,2054,1003,1051
050,18,081,"Indiana","Johnson County",4,62,1986,977,1009
050,18,081,"Indiana","Johnson County",4,63,1924,930,994
050,18,081,"Indiana","Johnson County",4,64,1932,932,1000
050,18,081,"Indiana","Johnson County",4,65,1826,912,914
050,18,081,"Indiana","Johnson County",4,66,1769,838,931
050,18,081,"Indiana","Johnson County",4,67,1672,789,883
050,18,081,"Indiana","Johnson County",4,68,1589,748,841
050,18,081,"Indiana","Johnson County",4,69,1518,707,811
050,18,081,"Indiana","Johnson County",4,70,1482,677,805
050,18,081,"Indiana","Johnson County",4,71,1397,626,771
050,18,081,"Indiana","Johnson County",4,72,1358,620,738
050,18,081,"Indiana","Johnson County",4,73,1331,590,741
050,18,081,"Indiana","Johnson County",4,74,1270,588,682
050,18,081,"Indiana","Johnson County",4,75,1340,616,724
050,18,081,"Indiana","Johnson County",4,76,900,413,487
050,18,081,"Indiana","Johnson County",4,77,870,400,470
050,18,081,"Indiana","Johnson County",4,78,880,369,511
050,18,081,"Indiana","Johnson County",4,79,918,387,531
050,18,081,"Indiana","Johnson County",4,80,792,352,440
050,18,081,"Indiana","Johnson County",4,81,664,282,382
050,18,081,"Indiana","Johnson County",4,82,580,222,358
050,18,081,"Indiana","Johnson County",4,83,553,223,330
050,18,081,"Indiana","Johnson County",4,84,495,195,300
050,18,081,"Indiana","Johnson County",4,85,2715,893,1822
050,18,081,"Indiana","Johnson County",5,0,1856,989,867
050,18,081,"Indiana","Johnson County",5,1,1869,980,889
050,18,081,"Indiana","Johnson County",5,2,1970,1027,943
050,18,081,"Indiana","Johnson County",5,3,1990,1028,962
050,18,081,"Indiana","Johnson County",5,4,2045,1034,1011
050,18,081,"Indiana","Johnson County",5,5,2141,1110,1031
050,18,081,"Indiana","Johnson County",5,6,2266,1175,1091
050,18,081,"Indiana","Johnson County",5,7,2282,1183,1099
050,18,081,"Indiana","Johnson County",5,8,2333,1233,1100
050,18,081,"Indiana","Johnson County",5,9,2370,1206,1164
050,18,081,"Indiana","Johnson County",5,10,2346,1178,1168
050,18,081,"Indiana","Johnson County",5,11,2310,1173,1137
050,18,081,"Indiana","Johnson County",5,12,2362,1190,1172
050,18,081,"Indiana","Johnson County",5,13,2444,1227,1217
050,18,081,"Indiana","Johnson County",5,14,2460,1293,1167
050,18,081,"Indiana","Johnson County",5,15,2523,1289,1234
050,18,081,"Indiana","Johnson County",5,16,2477,1251,1226
050,18,081,"Indiana","Johnson County",5,17,2388,1228,1160
050,18,081,"Indiana","Johnson County",5,18,1989,1059,930
050,18,081,"Indiana","Johnson County",5,19,1739,947,792
050,18,081,"Indiana","Johnson County",5,20,1833,957,876
050,18,081,"Indiana","Johnson County",5,21,1948,969,979
050,18,081,"Indiana","Johnson County",5,22,2006,1013,993
050,18,081,"Indiana","Johnson County",5,23,2089,1070,1019
050,18,081,"Indiana","Johnson County",5,24,2120,1111,1009
050,18,081,"Indiana","Johnson County",5,25,2057,1118,939
050,18,081,"Indiana","Johnson County",5,26,2159,1113,1046
050,18,081,"Indiana","Johnson County",5,27,2223,1150,1073
050,18,081,"Indiana","Johnson County",5,28,2210,1102,1108
050,18,081,"Indiana","Johnson County",5,29,2212,1118,1094
050,18,081,"Indiana","Johnson County",5,30,2264,1135,1129
050,18,081,"Indiana","Johnson County",5,31,2382,1235,1147
050,18,081,"Indiana","Johnson County",5,32,2404,1230,1174
050,18,081,"Indiana","Johnson County",5,33,2357,1185,1172
050,18,081,"Indiana","Johnson County",5,34,2265,1128,1137
050,18,081,"Indiana","Johnson County",5,35,2356,1153,1203
050,18,081,"Indiana","Johnson County",5,36,2342,1157,1185
050,18,081,"Indiana","Johnson County",5,37,2335,1154,1181
050,18,081,"Indiana","Johnson County",5,38,2314,1167,1147
050,18,081,"Indiana","Johnson County",5,39,2336,1151,1185
050,18,081,"Indiana","Johnson County",5,40,2349,1162,1187
050,18,081,"Indiana","Johnson County",5,41,2383,1206,1177
050,18,081,"Indiana","Johnson County",5,42,2409,1245,1164
050,18,081,"Indiana","Johnson County",5,43,2336,1176,1160
050,18,081,"Indiana","Johnson County",5,44,2358,1188,1170
050,18,081,"Indiana","Johnson County",5,45,2206,1139,1067
050,18,081,"Indiana","Johnson County",5,46,2071,1056,1015
050,18,081,"Indiana","Johnson County",5,47,2015,1018,997
050,18,081,"Indiana","Johnson County",5,48,2097,1053,1044
050,18,081,"Indiana","Johnson County",5,49,1997,1003,994
050,18,081,"Indiana","Johnson County",5,50,1983,994,989
050,18,081,"Indiana","Johnson County",5,51,2115,1080,1035
050,18,081,"Indiana","Johnson County",5,52,2225,1123,1102
050,18,081,"Indiana","Johnson County",5,53,2182,1126,1056
050,18,081,"Indiana","Johnson County",5,54,2016,1050,966
050,18,081,"Indiana","Johnson County",5,55,1878,954,924
050,18,081,"Indiana","Johnson County",5,56,1945,974,971
050,18,081,"Indiana","Johnson County",5,57,1978,953,1025
050,18,081,"Indiana","Johnson County",5,58,2003,976,1027
050,18,081,"Indiana","Johnson County",5,59,2045,1003,1042
050,18,081,"Indiana","Johnson County",5,60,2067,1014,1053
050,18,081,"Indiana","Johnson County",5,61,2024,1004,1020
050,18,081,"Indiana","Johnson County",5,62,2028,994,1034
050,18,081,"Indiana","Johnson County",5,63,1981,979,1002
050,18,081,"Indiana","Johnson County",5,64,1938,923,1015
050,18,081,"Indiana","Johnson County",5,65,1907,922,985
050,18,081,"Indiana","Johnson County",5,66,1810,917,893
050,18,081,"Indiana","Johnson County",5,67,1748,821,927
050,18,081,"Indiana","Johnson County",5,68,1635,780,855
050,18,081,"Indiana","Johnson County",5,69,1563,724,839
050,18,081,"Indiana","Johnson County",5,70,1493,681,812
050,18,081,"Indiana","Johnson County",5,71,1443,651,792
050,18,081,"Indiana","Johnson County",5,72,1358,615,743
050,18,081,"Indiana","Johnson County",5,73,1338,606,732
050,18,081,"Indiana","Johnson County",5,74,1329,589,740
050,18,081,"Indiana","Johnson County",5,75,1216,545,671
050,18,081,"Indiana","Johnson County",5,76,1296,591,705
050,18,081,"Indiana","Johnson County",5,77,887,412,475
050,18,081,"Indiana","Johnson County",5,78,831,366,465
050,18,081,"Indiana","Johnson County",5,79,857,359,498
050,18,081,"Indiana","Johnson County",5,80,852,359,493
050,18,081,"Indiana","Johnson County",5,81,750,323,427
050,18,081,"Indiana","Johnson County",5,82,625,261,364
050,18,081,"Indiana","Johnson County",5,83,568,217,351
050,18,081,"Indiana","Johnson County",5,84,491,201,290
050,18,081,"Indiana","Johnson County",5,85,2821,942,1879
050,18,083,"Indiana","Knox County",1,0,392,198,194
050,18,083,"Indiana","Knox County",1,1,399,209,190
050,18,083,"Indiana","Knox County",1,2,421,215,206
050,18,083,"Indiana","Knox County",1,3,421,224,197
050,18,083,"Indiana","Knox County",1,4,437,233,204
050,18,083,"Indiana","Knox County",1,5,428,219,209
050,18,083,"Indiana","Knox County",1,6,463,240,223
050,18,083,"Indiana","Knox County",1,7,467,241,226
050,18,083,"Indiana","Knox County",1,8,437,215,222
050,18,083,"Indiana","Knox County",1,9,449,253,196
050,18,083,"Indiana","Knox County",1,10,422,210,212
050,18,083,"Indiana","Knox County",1,11,425,204,221
050,18,083,"Indiana","Knox County",1,12,451,227,224
050,18,083,"Indiana","Knox County",1,13,478,261,217
050,18,083,"Indiana","Knox County",1,14,446,229,217
050,18,083,"Indiana","Knox County",1,15,434,224,210
050,18,083,"Indiana","Knox County",1,16,438,223,215
050,18,083,"Indiana","Knox County",1,17,433,215,218
050,18,083,"Indiana","Knox County",1,18,487,248,239
050,18,083,"Indiana","Knox County",1,19,928,585,343
050,18,083,"Indiana","Knox County",1,20,913,525,388
050,18,083,"Indiana","Knox County",1,21,580,321,259
050,18,083,"Indiana","Knox County",1,22,512,277,235
050,18,083,"Indiana","Knox County",1,23,458,245,213
050,18,083,"Indiana","Knox County",1,24,434,219,215
050,18,083,"Indiana","Knox County",1,25,428,235,193
050,18,083,"Indiana","Knox County",1,26,409,202,207
050,18,083,"Indiana","Knox County",1,27,417,227,190
050,18,083,"Indiana","Knox County",1,28,397,214,183
050,18,083,"Indiana","Knox County",1,29,457,251,206
050,18,083,"Indiana","Knox County",1,30,402,218,184
050,18,083,"Indiana","Knox County",1,31,416,232,184
050,18,083,"Indiana","Knox County",1,32,418,217,201
050,18,083,"Indiana","Knox County",1,33,422,234,188
050,18,083,"Indiana","Knox County",1,34,443,245,198
050,18,083,"Indiana","Knox County",1,35,460,248,212
050,18,083,"Indiana","Knox County",1,36,460,252,208
050,18,083,"Indiana","Knox County",1,37,452,239,213
050,18,083,"Indiana","Knox County",1,38,444,222,222
050,18,083,"Indiana","Knox County",1,39,425,218,207
050,18,083,"Indiana","Knox County",1,40,444,229,215
050,18,083,"Indiana","Knox County",1,41,448,215,233
050,18,083,"Indiana","Knox County",1,42,396,200,196
050,18,083,"Indiana","Knox County",1,43,375,190,185
050,18,083,"Indiana","Knox County",1,44,352,185,167
050,18,083,"Indiana","Knox County",1,45,347,184,163
050,18,083,"Indiana","Knox County",1,46,367,187,180
050,18,083,"Indiana","Knox County",1,47,372,178,194
050,18,083,"Indiana","Knox County",1,48,411,194,217
050,18,083,"Indiana","Knox County",1,49,438,215,223
050,18,083,"Indiana","Knox County",1,50,429,221,208
050,18,083,"Indiana","Knox County",1,51,417,235,182
050,18,083,"Indiana","Knox County",1,52,383,200,183
050,18,083,"Indiana","Knox County",1,53,419,211,208
050,18,083,"Indiana","Knox County",1,54,427,223,204
050,18,083,"Indiana","Knox County",1,55,473,236,237
050,18,083,"Indiana","Knox County",1,56,520,272,248
050,18,083,"Indiana","Knox County",1,57,503,252,251
050,18,083,"Indiana","Knox County",1,58,527,271,256
050,18,083,"Indiana","Knox County",1,59,536,271,265
050,18,083,"Indiana","Knox County",1,60,531,276,255
050,18,083,"Indiana","Knox County",1,61,504,261,243
050,18,083,"Indiana","Knox County",1,62,525,250,275
050,18,083,"Indiana","Knox County",1,63,485,241,244
050,18,083,"Indiana","Knox County",1,64,464,228,236
050,18,083,"Indiana","Knox County",1,65,470,239,231
050,18,083,"Indiana","Knox County",1,66,460,220,240
050,18,083,"Indiana","Knox County",1,67,427,197,230
050,18,083,"Indiana","Knox County",1,68,403,192,211
050,18,083,"Indiana","Knox County",1,69,374,187,187
050,18,083,"Indiana","Knox County",1,70,368,176,192
050,18,083,"Indiana","Knox County",1,71,369,176,193
050,18,083,"Indiana","Knox County",1,72,352,166,186
050,18,083,"Indiana","Knox County",1,73,348,157,191
050,18,083,"Indiana","Knox County",1,74,251,118,133
050,18,083,"Indiana","Knox County",1,75,251,119,132
050,18,083,"Indiana","Knox County",1,76,254,112,142
050,18,083,"Indiana","Knox County",1,77,251,105,146
050,18,083,"Indiana","Knox County",1,78,224,93,131
050,18,083,"Indiana","Knox County",1,79,194,78,116
050,18,083,"Indiana","Knox County",1,80,185,73,112
050,18,083,"Indiana","Knox County",1,81,196,81,115
050,18,083,"Indiana","Knox County",1,82,175,65,110
050,18,083,"Indiana","Knox County",1,83,145,63,82
050,18,083,"Indiana","Knox County",1,84,136,49,87
050,18,083,"Indiana","Knox County",1,85,760,235,525
050,18,083,"Indiana","Knox County",2,0,389,203,186
050,18,083,"Indiana","Knox County",2,1,397,208,189
050,18,083,"Indiana","Knox County",2,2,417,214,203
050,18,083,"Indiana","Knox County",2,3,418,220,198
050,18,083,"Indiana","Knox County",2,4,435,232,203
050,18,083,"Indiana","Knox County",2,5,428,221,207
050,18,083,"Indiana","Knox County",2,6,456,237,219
050,18,083,"Indiana","Knox County",2,7,466,242,224
050,18,083,"Indiana","Knox County",2,8,444,221,223
050,18,083,"Indiana","Knox County",2,9,448,245,203
050,18,083,"Indiana","Knox County",2,10,428,220,208
050,18,083,"Indiana","Knox County",2,11,421,204,217
050,18,083,"Indiana","Knox County",2,12,448,224,224
050,18,083,"Indiana","Knox County",2,13,471,253,218
050,18,083,"Indiana","Knox County",2,14,454,237,217
050,18,083,"Indiana","Knox County",2,15,437,224,213
050,18,083,"Indiana","Knox County",2,16,438,222,216
050,18,083,"Indiana","Knox County",2,17,437,218,219
050,18,083,"Indiana","Knox County",2,18,484,245,239
050,18,083,"Indiana","Knox County",2,19,926,580,346
050,18,083,"Indiana","Knox County",2,20,910,524,386
050,18,083,"Indiana","Knox County",2,21,580,323,257
050,18,083,"Indiana","Knox County",2,22,516,278,238
050,18,083,"Indiana","Knox County",2,23,452,240,212
050,18,083,"Indiana","Knox County",2,24,436,218,218
050,18,083,"Indiana","Knox County",2,25,424,227,197
050,18,083,"Indiana","Knox County",2,26,411,210,201
050,18,083,"Indiana","Knox County",2,27,410,218,192
050,18,083,"Indiana","Knox County",2,28,407,221,186
050,18,083,"Indiana","Knox County",2,29,447,244,203
050,18,083,"Indiana","Knox County",2,30,417,225,192
050,18,083,"Indiana","Knox County",2,31,411,228,183
050,18,083,"Indiana","Knox County",2,32,418,222,196
050,18,083,"Indiana","Knox County",2,33,415,227,188
050,18,083,"Indiana","Knox County",2,34,439,244,195
050,18,083,"Indiana","Knox County",2,35,459,247,212
050,18,083,"Indiana","Knox County",2,36,457,249,208
050,18,083,"Indiana","Knox County",2,37,456,243,213
050,18,083,"Indiana","Knox County",2,38,446,225,221
050,18,083,"Indiana","Knox County",2,39,428,218,210
050,18,083,"Indiana","Knox County",2,40,443,228,215
050,18,083,"Indiana","Knox County",2,41,448,219,229
050,18,083,"Indiana","Knox County",2,42,405,202,203
050,18,083,"Indiana","Knox County",2,43,383,194,189
050,18,083,"Indiana","Knox County",2,44,354,184,170
050,18,083,"Indiana","Knox County",2,45,349,184,165
050,18,083,"Indiana","Knox County",2,46,357,183,174
050,18,083,"Indiana","Knox County",2,47,369,179,190
050,18,083,"Indiana","Knox County",2,48,401,190,211
050,18,083,"Indiana","Knox County",2,49,433,210,223
050,18,083,"Indiana","Knox County",2,50,433,220,213
050,18,083,"Indiana","Knox County",2,51,419,232,187
050,18,083,"Indiana","Knox County",2,52,390,208,182
050,18,083,"Indiana","Knox County",2,53,409,208,201
050,18,083,"Indiana","Knox County",2,54,421,220,201
050,18,083,"Indiana","Knox County",2,55,462,232,230
050,18,083,"Indiana","Knox County",2,56,511,265,246
050,18,083,"Indiana","Knox County",2,57,507,258,249
050,18,083,"Indiana","Knox County",2,58,517,265,252
050,18,083,"Indiana","Knox County",2,59,534,272,262
050,18,083,"Indiana","Knox County",2,60,528,273,255
050,18,083,"Indiana","Knox County",2,61,508,263,245
050,18,083,"Indiana","Knox County",2,62,514,250,264
050,18,083,"Indiana","Knox County",2,63,497,244,253
050,18,083,"Indiana","Knox County",2,64,463,229,234
050,18,083,"Indiana","Knox County",2,65,463,234,229
050,18,083,"Indiana","Knox County",2,66,461,222,239
050,18,083,"Indiana","Knox County",2,67,433,202,231
050,18,083,"Indiana","Knox County",2,68,405,191,214
050,18,083,"Indiana","Knox County",2,69,380,188,192
050,18,083,"Indiana","Knox County",2,70,368,178,190
050,18,083,"Indiana","Knox County",2,71,369,177,192
050,18,083,"Indiana","Knox County",2,72,348,164,184
050,18,083,"Indiana","Knox County",2,73,369,169,200
050,18,083,"Indiana","Knox County",2,74,254,118,136
050,18,083,"Indiana","Knox County",2,75,249,118,131
050,18,083,"Indiana","Knox County",2,76,251,113,138
050,18,083,"Indiana","Knox County",2,77,255,108,147
050,18,083,"Indiana","Knox County",2,78,222,92,130
050,18,083,"Indiana","Knox County",2,79,200,80,120
050,18,083,"Indiana","Knox County",2,80,181,73,108
050,18,083,"Indiana","Knox County",2,81,189,78,111
050,18,083,"Indiana","Knox County",2,82,179,66,113
050,18,083,"Indiana","Knox County",2,83,148,63,85
050,18,083,"Indiana","Knox County",2,84,135,50,85
050,18,083,"Indiana","Knox County",2,85,761,238,523
050,18,083,"Indiana","Knox County",3,0,410,196,214
050,18,083,"Indiana","Knox County",3,1,393,213,180
050,18,083,"Indiana","Knox County",3,2,387,204,183
050,18,083,"Indiana","Knox County",3,3,408,210,198
050,18,083,"Indiana","Knox County",3,4,415,215,200
050,18,083,"Indiana","Knox County",3,5,433,233,200
050,18,083,"Indiana","Knox County",3,6,418,218,200
050,18,083,"Indiana","Knox County",3,7,453,237,216
050,18,083,"Indiana","Knox County",3,8,454,236,218
050,18,083,"Indiana","Knox County",3,9,442,223,219
050,18,083,"Indiana","Knox County",3,10,448,245,203
050,18,083,"Indiana","Knox County",3,11,424,216,208
050,18,083,"Indiana","Knox County",3,12,427,212,215
050,18,083,"Indiana","Knox County",3,13,455,223,232
050,18,083,"Indiana","Knox County",3,14,469,249,220
050,18,083,"Indiana","Knox County",3,15,463,244,219
050,18,083,"Indiana","Knox County",3,16,434,218,216
050,18,083,"Indiana","Knox County",3,17,438,231,207
050,18,083,"Indiana","Knox County",3,18,479,239,240
050,18,083,"Indiana","Knox County",3,19,915,566,349
050,18,083,"Indiana","Knox County",3,20,869,511,358
050,18,083,"Indiana","Knox County",3,21,591,336,255
050,18,083,"Indiana","Knox County",3,22,533,287,246
050,18,083,"Indiana","Knox County",3,23,440,237,203
050,18,083,"Indiana","Knox County",3,24,448,224,224
050,18,083,"Indiana","Knox County",3,25,420,224,196
050,18,083,"Indiana","Knox County",3,26,408,221,187
050,18,083,"Indiana","Knox County",3,27,403,210,193
050,18,083,"Indiana","Knox County",3,28,402,213,189
050,18,083,"Indiana","Knox County",3,29,400,215,185
050,18,083,"Indiana","Knox County",3,30,440,241,199
050,18,083,"Indiana","Knox County",3,31,430,240,190
050,18,083,"Indiana","Knox County",3,32,411,228,183
050,18,083,"Indiana","Knox County",3,33,395,205,190
050,18,083,"Indiana","Knox County",3,34,412,223,189
050,18,083,"Indiana","Knox County",3,35,433,244,189
050,18,083,"Indiana","Knox County",3,36,454,248,206
050,18,083,"Indiana","Knox County",3,37,450,238,212
050,18,083,"Indiana","Knox County",3,38,454,246,208
050,18,083,"Indiana","Knox County",3,39,450,222,228
050,18,083,"Indiana","Knox County",3,40,414,212,202
050,18,083,"Indiana","Knox County",3,41,437,225,212
050,18,083,"Indiana","Knox County",3,42,436,212,224
050,18,083,"Indiana","Knox County",3,43,413,204,209
050,18,083,"Indiana","Knox County",3,44,392,195,197
050,18,083,"Indiana","Knox County",3,45,351,181,170
050,18,083,"Indiana","Knox County",3,46,350,189,161
050,18,083,"Indiana","Knox County",3,47,356,187,169
050,18,083,"Indiana","Knox County",3,48,382,190,192
050,18,083,"Indiana","Knox County",3,49,393,187,206
050,18,083,"Indiana","Knox County",3,50,427,207,220
050,18,083,"Indiana","Knox County",3,51,430,218,212
050,18,083,"Indiana","Knox County",3,52,408,222,186
050,18,083,"Indiana","Knox County",3,53,388,206,182
050,18,083,"Indiana","Knox County",3,54,395,204,191
050,18,083,"Indiana","Knox County",3,55,421,219,202
050,18,083,"Indiana","Knox County",3,56,458,228,230
050,18,083,"Indiana","Knox County",3,57,518,269,249
050,18,083,"Indiana","Knox County",3,58,501,255,246
050,18,083,"Indiana","Knox County",3,59,510,257,253
050,18,083,"Indiana","Knox County",3,60,525,267,258
050,18,083,"Indiana","Knox County",3,61,527,273,254
050,18,083,"Indiana","Knox County",3,62,497,256,241
050,18,083,"Indiana","Knox County",3,63,508,248,260
050,18,083,"Indiana","Knox County",3,64,480,230,250
050,18,083,"Indiana","Knox County",3,65,459,223,236
050,18,083,"Indiana","Knox County",3,66,455,225,230
050,18,083,"Indiana","Knox County",3,67,452,217,235
050,18,083,"Indiana","Knox County",3,68,415,190,225
050,18,083,"Indiana","Knox County",3,69,385,181,204
050,18,083,"Indiana","Knox County",3,70,370,179,191
050,18,083,"Indiana","Knox County",3,71,354,169,185
050,18,083,"Indiana","Knox County",3,72,359,176,183
050,18,083,"Indiana","Knox County",3,73,333,151,182
050,18,083,"Indiana","Knox County",3,74,357,165,192
050,18,083,"Indiana","Knox County",3,75,236,105,131
050,18,083,"Indiana","Knox County",3,76,236,112,124
050,18,083,"Indiana","Knox County",3,77,224,94,130
050,18,083,"Indiana","Knox County",3,78,231,97,134
050,18,083,"Indiana","Knox County",3,79,214,86,128
050,18,083,"Indiana","Knox County",3,80,190,77,113
050,18,083,"Indiana","Knox County",3,81,169,69,100
050,18,083,"Indiana","Knox County",3,82,182,71,111
050,18,083,"Indiana","Knox County",3,83,150,54,96
050,18,083,"Indiana","Knox County",3,84,130,52,78
050,18,083,"Indiana","Knox County",3,85,750,239,511
050,18,083,"Indiana","Knox County",4,0,398,189,209
050,18,083,"Indiana","Knox County",4,1,414,189,225
050,18,083,"Indiana","Knox County",4,2,386,216,170
050,18,083,"Indiana","Knox County",4,3,386,202,184
050,18,083,"Indiana","Knox County",4,4,413,218,195
050,18,083,"Indiana","Knox County",4,5,397,204,193
050,18,083,"Indiana","Knox County",4,6,425,226,199
050,18,083,"Indiana","Knox County",4,7,417,220,197
050,18,083,"Indiana","Knox County",4,8,460,243,217
050,18,083,"Indiana","Knox County",4,9,454,233,221
050,18,083,"Indiana","Knox County",4,10,434,221,213
050,18,083,"Indiana","Knox County",4,11,446,243,203
050,18,083,"Indiana","Knox County",4,12,418,211,207
050,18,083,"Indiana","Knox County",4,13,435,213,222
050,18,083,"Indiana","Knox County",4,14,439,222,217
050,18,083,"Indiana","Knox County",4,15,478,259,219
050,18,083,"Indiana","Knox County",4,16,457,235,222
050,18,083,"Indiana","Knox County",4,17,432,221,211
050,18,083,"Indiana","Knox County",4,18,473,245,228
050,18,083,"Indiana","Knox County",4,19,912,564,348
050,18,083,"Indiana","Knox County",4,20,874,503,371
050,18,083,"Indiana","Knox County",4,21,573,335,238
050,18,083,"Indiana","Knox County",4,22,538,295,243
050,18,083,"Indiana","Knox County",4,23,489,249,240
050,18,083,"Indiana","Knox County",4,24,434,209,225
050,18,083,"Indiana","Knox County",4,25,458,230,228
050,18,083,"Indiana","Knox County",4,26,427,219,208
050,18,083,"Indiana","Knox County",4,27,415,225,190
050,18,083,"Indiana","Knox County",4,28,406,212,194
050,18,083,"Indiana","Knox County",4,29,412,222,190
050,18,083,"Indiana","Knox County",4,30,406,219,187
050,18,083,"Indiana","Knox County",4,31,447,250,197
050,18,083,"Indiana","Knox County",4,32,438,245,193
050,18,083,"Indiana","Knox County",4,33,397,215,182
050,18,083,"Indiana","Knox County",4,34,390,204,186
050,18,083,"Indiana","Knox County",4,35,406,224,182
050,18,083,"Indiana","Knox County",4,36,439,251,188
050,18,083,"Indiana","Knox County",4,37,445,247,198
050,18,083,"Indiana","Knox County",4,38,442,237,205
050,18,083,"Indiana","Knox County",4,39,450,244,206
050,18,083,"Indiana","Knox County",4,40,451,231,220
050,18,083,"Indiana","Knox County",4,41,413,211,202
050,18,083,"Indiana","Knox County",4,42,436,222,214
050,18,083,"Indiana","Knox County",4,43,440,217,223
050,18,083,"Indiana","Knox County",4,44,417,206,211
050,18,083,"Indiana","Knox County",4,45,394,199,195
050,18,083,"Indiana","Knox County",4,46,352,182,170
050,18,083,"Indiana","Knox County",4,47,348,195,153
050,18,083,"Indiana","Knox County",4,48,348,181,167
050,18,083,"Indiana","Knox County",4,49,386,190,196
050,18,083,"Indiana","Knox County",4,50,381,181,200
050,18,083,"Indiana","Knox County",4,51,425,208,217
050,18,083,"Indiana","Knox County",4,52,424,212,212
050,18,083,"Indiana","Knox County",4,53,405,220,185
050,18,083,"Indiana","Knox County",4,54,388,203,185
050,18,083,"Indiana","Knox County",4,55,395,199,196
050,18,083,"Indiana","Knox County",4,56,421,217,204
050,18,083,"Indiana","Knox County",4,57,449,224,225
050,18,083,"Indiana","Knox County",4,58,505,259,246
050,18,083,"Indiana","Knox County",4,59,485,249,236
050,18,083,"Indiana","Knox County",4,60,499,251,248
050,18,083,"Indiana","Knox County",4,61,510,263,247
050,18,083,"Indiana","Knox County",4,62,518,268,250
050,18,083,"Indiana","Knox County",4,63,490,248,242
050,18,083,"Indiana","Knox County",4,64,486,234,252
050,18,083,"Indiana","Knox County",4,65,464,224,240
050,18,083,"Indiana","Knox County",4,66,457,217,240
050,18,083,"Indiana","Knox County",4,67,442,220,222
050,18,083,"Indiana","Knox County",4,68,442,214,228
050,18,083,"Indiana","Knox County",4,69,410,190,220
050,18,083,"Indiana","Knox County",4,70,377,176,201
050,18,083,"Indiana","Knox County",4,71,361,175,186
050,18,083,"Indiana","Knox County",4,72,333,165,168
050,18,083,"Indiana","Knox County",4,73,350,168,182
050,18,083,"Indiana","Knox County",4,74,323,149,174
050,18,083,"Indiana","Knox County",4,75,338,152,186
050,18,083,"Indiana","Knox County",4,76,225,99,126
050,18,083,"Indiana","Knox County",4,77,222,103,119
050,18,083,"Indiana","Knox County",4,78,205,87,118
050,18,083,"Indiana","Knox County",4,79,223,92,131
050,18,083,"Indiana","Knox County",4,80,202,81,121
050,18,083,"Indiana","Knox County",4,81,176,72,104
050,18,083,"Indiana","Knox County",4,82,159,58,101
050,18,083,"Indiana","Knox County",4,83,166,68,98
050,18,083,"Indiana","Knox County",4,84,129,43,86
050,18,083,"Indiana","Knox County",4,85,746,245,501
050,18,083,"Indiana","Knox County",5,0,405,191,214
050,18,083,"Indiana","Knox County",5,1,406,204,202
050,18,083,"Indiana","Knox County",5,2,400,187,213
050,18,083,"Indiana","Knox County",5,3,408,227,181
050,18,083,"Indiana","Knox County",5,4,392,210,182
050,18,083,"Indiana","Knox County",5,5,424,225,199
050,18,083,"Indiana","Knox County",5,6,396,209,187
050,18,083,"Indiana","Knox County",5,7,433,238,195
050,18,083,"Indiana","Knox County",5,8,438,234,204
050,18,083,"Indiana","Knox County",5,9,465,247,218
050,18,083,"Indiana","Knox County",5,10,450,229,221
050,18,083,"Indiana","Knox County",5,11,431,219,212
050,18,083,"Indiana","Knox County",5,12,450,243,207
050,18,083,"Indiana","Knox County",5,13,441,224,217
050,18,083,"Indiana","Knox County",5,14,444,221,223
050,18,083,"Indiana","Knox County",5,15,457,231,226
050,18,083,"Indiana","Knox County",5,16,474,252,222
050,18,083,"Indiana","Knox County",5,17,474,249,225
050,18,083,"Indiana","Knox County",5,18,478,248,230
050,18,083,"Indiana","Knox County",5,19,908,573,335
050,18,083,"Indiana","Knox County",5,20,857,489,368
050,18,083,"Indiana","Knox County",5,21,567,331,236
050,18,083,"Indiana","Knox County",5,22,503,275,228
050,18,083,"Indiana","Knox County",5,23,470,256,214
050,18,083,"Indiana","Knox County",5,24,458,218,240
050,18,083,"Indiana","Knox County",5,25,427,208,219
050,18,083,"Indiana","Knox County",5,26,450,220,230
050,18,083,"Indiana","Knox County",5,27,407,204,203
050,18,083,"Indiana","Knox County",5,28,401,217,184
050,18,083,"Indiana","Knox County",5,29,424,227,197
050,18,083,"Indiana","Knox County",5,30,419,224,195
050,18,083,"Indiana","Knox County",5,31,410,217,193
050,18,083,"Indiana","Knox County",5,32,445,241,204
050,18,083,"Indiana","Knox County",5,33,430,234,196
050,18,083,"Indiana","Knox County",5,34,423,236,187
050,18,083,"Indiana","Knox County",5,35,390,204,186
050,18,083,"Indiana","Knox County",5,36,426,233,193
050,18,083,"Indiana","Knox County",5,37,431,243,188
050,18,083,"Indiana","Knox County",5,38,439,246,193
050,18,083,"Indiana","Knox County",5,39,449,239,210
050,18,083,"Indiana","Knox County",5,40,436,232,204
050,18,083,"Indiana","Knox County",5,41,452,232,220
050,18,083,"Indiana","Knox County",5,42,415,215,200
050,18,083,"Indiana","Knox County",5,43,435,223,212
050,18,083,"Indiana","Knox County",5,44,451,226,225
050,18,083,"Indiana","Knox County",5,45,432,220,212
050,18,083,"Indiana","Knox County",5,46,401,209,192
050,18,083,"Indiana","Knox County",5,47,355,182,173
050,18,083,"Indiana","Knox County",5,48,360,202,158
050,18,083,"Indiana","Knox County",5,49,353,185,168
050,18,083,"Indiana","Knox County",5,50,377,186,191
050,18,083,"Indiana","Knox County",5,51,386,185,201
050,18,083,"Indiana","Knox County",5,52,413,199,214
050,18,083,"Indiana","Knox County",5,53,420,210,210
050,18,083,"Indiana","Knox County",5,54,417,217,200
050,18,083,"Indiana","Knox County",5,55,389,198,191
050,18,083,"Indiana","Knox County",5,56,398,203,195
050,18,083,"Indiana","Knox County",5,57,423,220,203
050,18,083,"Indiana","Knox County",5,58,448,220,228
050,18,083,"Indiana","Knox County",5,59,499,258,241
050,18,083,"Indiana","Knox County",5,60,483,244,239
050,18,083,"Indiana","Knox County",5,61,497,252,245
050,18,083,"Indiana","Knox County",5,62,504,257,247
050,18,083,"Indiana","Knox County",5,63,525,263,262
050,18,083,"Indiana","Knox County",5,64,481,236,245
050,18,083,"Indiana","Knox County",5,65,484,233,251
050,18,083,"Indiana","Knox County",5,66,454,216,238
050,18,083,"Indiana","Knox County",5,67,447,213,234
050,18,083,"Indiana","Knox County",5,68,434,219,215
050,18,083,"Indiana","Knox County",5,69,435,211,224
050,18,083,"Indiana","Knox County",5,70,411,187,224
050,18,083,"Indiana","Knox County",5,71,366,171,195
050,18,083,"Indiana","Knox County",5,72,348,170,178
050,18,083,"Indiana","Knox County",5,73,331,158,173
050,18,083,"Indiana","Knox County",5,74,337,163,174
050,18,083,"Indiana","Knox County",5,75,305,139,166
050,18,083,"Indiana","Knox County",5,76,324,145,179
050,18,083,"Indiana","Knox County",5,77,218,90,128
050,18,083,"Indiana","Knox County",5,78,210,101,109
050,18,083,"Indiana","Knox County",5,79,196,78,118
050,18,083,"Indiana","Knox County",5,80,214,88,126
050,18,083,"Indiana","Knox County",5,81,188,73,115
050,18,083,"Indiana","Knox County",5,82,166,62,104
050,18,083,"Indiana","Knox County",5,83,142,53,89
050,18,083,"Indiana","Knox County",5,84,144,56,88
050,18,083,"Indiana","Knox County",5,85,766,254,512
050,18,085,"Indiana","Kosciusko County",1,0,993,506,487
050,18,085,"Indiana","Kosciusko County",1,1,994,497,497
050,18,085,"Indiana","Kosciusko County",1,2,1049,519,530
050,18,085,"Indiana","Kosciusko County",1,3,1038,521,517
050,18,085,"Indiana","Kosciusko County",1,4,1027,527,500
050,18,085,"Indiana","Kosciusko County",1,5,1090,548,542
050,18,085,"Indiana","Kosciusko County",1,6,1065,551,514
050,18,085,"Indiana","Kosciusko County",1,7,1018,506,512
050,18,085,"Indiana","Kosciusko County",1,8,1046,549,497
050,18,085,"Indiana","Kosciusko County",1,9,1040,541,499
050,18,085,"Indiana","Kosciusko County",1,10,1054,534,520
050,18,085,"Indiana","Kosciusko County",1,11,1074,537,537
050,18,085,"Indiana","Kosciusko County",1,12,1120,543,577
050,18,085,"Indiana","Kosciusko County",1,13,1152,591,561
050,18,085,"Indiana","Kosciusko County",1,14,1159,621,538
050,18,085,"Indiana","Kosciusko County",1,15,1116,575,541
050,18,085,"Indiana","Kosciusko County",1,16,1122,576,546
050,18,085,"Indiana","Kosciusko County",1,17,1087,546,541
050,18,085,"Indiana","Kosciusko County",1,18,1024,531,493
050,18,085,"Indiana","Kosciusko County",1,19,1047,506,541
050,18,085,"Indiana","Kosciusko County",1,20,1084,544,540
050,18,085,"Indiana","Kosciusko County",1,21,1068,507,561
050,18,085,"Indiana","Kosciusko County",1,22,1061,533,528
050,18,085,"Indiana","Kosciusko County",1,23,985,528,457
050,18,085,"Indiana","Kosciusko County",1,24,985,519,466
050,18,085,"Indiana","Kosciusko County",1,25,1031,520,511
050,18,085,"Indiana","Kosciusko County",1,26,1053,560,493
050,18,085,"Indiana","Kosciusko County",1,27,1065,555,510
050,18,085,"Indiana","Kosciusko County",1,28,1032,516,516
050,18,085,"Indiana","Kosciusko County",1,29,1026,517,509
050,18,085,"Indiana","Kosciusko County",1,30,1001,500,501
050,18,085,"Indiana","Kosciusko County",1,31,984,503,481
050,18,085,"Indiana","Kosciusko County",1,32,995,521,474
050,18,085,"Indiana","Kosciusko County",1,33,996,503,493
050,18,085,"Indiana","Kosciusko County",1,34,1020,525,495
050,18,085,"Indiana","Kosciusko County",1,35,1010,498,512
050,18,085,"Indiana","Kosciusko County",1,36,954,500,454
050,18,085,"Indiana","Kosciusko County",1,37,1005,517,488
050,18,085,"Indiana","Kosciusko County",1,38,992,531,461
050,18,085,"Indiana","Kosciusko County",1,39,964,502,462
050,18,085,"Indiana","Kosciusko County",1,40,923,485,438
050,18,085,"Indiana","Kosciusko County",1,41,918,483,435
050,18,085,"Indiana","Kosciusko County",1,42,910,462,448
050,18,085,"Indiana","Kosciusko County",1,43,871,466,405
050,18,085,"Indiana","Kosciusko County",1,44,875,452,423
050,18,085,"Indiana","Kosciusko County",1,45,853,438,415
050,18,085,"Indiana","Kosciusko County",1,46,838,425,413
050,18,085,"Indiana","Kosciusko County",1,47,889,449,440
050,18,085,"Indiana","Kosciusko County",1,48,948,475,473
050,18,085,"Indiana","Kosciusko County",1,49,1047,526,521
050,18,085,"Indiana","Kosciusko County",1,50,950,484,466
050,18,085,"Indiana","Kosciusko County",1,51,935,498,437
050,18,085,"Indiana","Kosciusko County",1,52,944,485,459
050,18,085,"Indiana","Kosciusko County",1,53,999,493,506
050,18,085,"Indiana","Kosciusko County",1,54,969,480,489
050,18,085,"Indiana","Kosciusko County",1,55,1051,530,521
050,18,085,"Indiana","Kosciusko County",1,56,1072,541,531
050,18,085,"Indiana","Kosciusko County",1,57,1107,537,570
050,18,085,"Indiana","Kosciusko County",1,58,1122,549,573
050,18,085,"Indiana","Kosciusko County",1,59,1135,567,568
050,18,085,"Indiana","Kosciusko County",1,60,1123,575,548
050,18,085,"Indiana","Kosciusko County",1,61,1132,572,560
050,18,085,"Indiana","Kosciusko County",1,62,1110,553,557
050,18,085,"Indiana","Kosciusko County",1,63,1081,547,534
050,18,085,"Indiana","Kosciusko County",1,64,1067,551,516
050,18,085,"Indiana","Kosciusko County",1,65,1022,504,518
050,18,085,"Indiana","Kosciusko County",1,66,985,502,483
050,18,085,"Indiana","Kosciusko County",1,67,943,472,471
050,18,085,"Indiana","Kosciusko County",1,68,882,439,443
050,18,085,"Indiana","Kosciusko County",1,69,781,377,404
050,18,085,"Indiana","Kosciusko County",1,70,794,390,404
050,18,085,"Indiana","Kosciusko County",1,71,786,387,399
050,18,085,"Indiana","Kosciusko County",1,72,768,385,383
050,18,085,"Indiana","Kosciusko County",1,73,778,372,406
050,18,085,"Indiana","Kosciusko County",1,74,530,254,276
050,18,085,"Indiana","Kosciusko County",1,75,535,259,276
050,18,085,"Indiana","Kosciusko County",1,76,542,253,289
050,18,085,"Indiana","Kosciusko County",1,77,505,242,263
050,18,085,"Indiana","Kosciusko County",1,78,472,210,262
050,18,085,"Indiana","Kosciusko County",1,79,396,173,223
050,18,085,"Indiana","Kosciusko County",1,80,373,165,208
050,18,085,"Indiana","Kosciusko County",1,81,360,169,191
050,18,085,"Indiana","Kosciusko County",1,82,322,136,186
050,18,085,"Indiana","Kosciusko County",1,83,274,115,159
050,18,085,"Indiana","Kosciusko County",1,84,242,98,144
050,18,085,"Indiana","Kosciusko County",1,85,1448,498,950
050,18,085,"Indiana","Kosciusko County",2,0,984,495,489
050,18,085,"Indiana","Kosciusko County",2,1,989,498,491
050,18,085,"Indiana","Kosciusko County",2,2,1030,509,521
050,18,085,"Indiana","Kosciusko County",2,3,1035,518,517
050,18,085,"Indiana","Kosciusko County",2,4,1030,525,505
050,18,085,"Indiana","Kosciusko County",2,5,1071,539,532
050,18,085,"Indiana","Kosciusko County",2,6,1073,551,522
050,18,085,"Indiana","Kosciusko County",2,7,1025,513,512
050,18,085,"Indiana","Kosciusko County",2,8,1031,531,500
050,18,085,"Indiana","Kosciusko County",2,9,1037,540,497
050,18,085,"Indiana","Kosciusko County",2,10,1046,534,512
050,18,085,"Indiana","Kosciusko County",2,11,1063,532,531
050,18,085,"Indiana","Kosciusko County",2,12,1110,542,568
050,18,085,"Indiana","Kosciusko County",2,13,1147,578,569
050,18,085,"Indiana","Kosciusko County",2,14,1158,613,545
050,18,085,"Indiana","Kosciusko County",2,15,1129,589,540
050,18,085,"Indiana","Kosciusko County",2,16,1117,576,541
050,18,085,"Indiana","Kosciusko County",2,17,1094,554,540
050,18,085,"Indiana","Kosciusko County",2,18,1011,520,491
050,18,085,"Indiana","Kosciusko County",2,19,1040,502,538
050,18,085,"Indiana","Kosciusko County",2,20,1098,548,550
050,18,085,"Indiana","Kosciusko County",2,21,1063,511,552
050,18,085,"Indiana","Kosciusko County",2,22,1050,525,525
050,18,085,"Indiana","Kosciusko County",2,23,987,521,466
050,18,085,"Indiana","Kosciusko County",2,24,983,518,465
050,18,085,"Indiana","Kosciusko County",2,25,1013,517,496
050,18,085,"Indiana","Kosciusko County",2,26,1040,548,492
050,18,085,"Indiana","Kosciusko County",2,27,1049,548,501
050,18,085,"Indiana","Kosciusko County",2,28,1034,521,513
050,18,085,"Indiana","Kosciusko County",2,29,1029,517,512
050,18,085,"Indiana","Kosciusko County",2,30,1012,507,505
050,18,085,"Indiana","Kosciusko County",2,31,982,503,479
050,18,085,"Indiana","Kosciusko County",2,32,987,514,473
050,18,085,"Indiana","Kosciusko County",2,33,992,504,488
050,18,085,"Indiana","Kosciusko County",2,34,1015,520,495
050,18,085,"Indiana","Kosciusko County",2,35,1015,506,509
050,18,085,"Indiana","Kosciusko County",2,36,955,491,464
050,18,085,"Indiana","Kosciusko County",2,37,992,514,478
050,18,085,"Indiana","Kosciusko County",2,38,994,526,468
050,18,085,"Indiana","Kosciusko County",2,39,968,510,458
050,18,085,"Indiana","Kosciusko County",2,40,938,494,444
050,18,085,"Indiana","Kosciusko County",2,41,918,484,434
050,18,085,"Indiana","Kosciusko County",2,42,907,467,440
050,18,085,"Indiana","Kosciusko County",2,43,888,469,419
050,18,085,"Indiana","Kosciusko County",2,44,862,448,414
050,18,085,"Indiana","Kosciusko County",2,45,857,440,417
050,18,085,"Indiana","Kosciusko County",2,46,838,427,411
050,18,085,"Indiana","Kosciusko County",2,47,872,443,429
050,18,085,"Indiana","Kosciusko County",2,48,930,468,462
050,18,085,"Indiana","Kosciusko County",2,49,1024,514,510
050,18,085,"Indiana","Kosciusko County",2,50,973,493,480
050,18,085,"Indiana","Kosciusko County",2,51,938,494,444
050,18,085,"Indiana","Kosciusko County",2,52,942,489,453
050,18,085,"Indiana","Kosciusko County",2,53,982,487,495
050,18,085,"Indiana","Kosciusko County",2,54,972,481,491
050,18,085,"Indiana","Kosciusko County",2,55,1028,515,513
050,18,085,"Indiana","Kosciusko County",2,56,1065,534,531
050,18,085,"Indiana","Kosciusko County",2,57,1093,535,558
050,18,085,"Indiana","Kosciusko County",2,58,1115,544,571
050,18,085,"Indiana","Kosciusko County",2,59,1142,567,575
050,18,085,"Indiana","Kosciusko County",2,60,1128,575,553
050,18,085,"Indiana","Kosciusko County",2,61,1125,567,558
050,18,085,"Indiana","Kosciusko County",2,62,1113,557,556
050,18,085,"Indiana","Kosciusko County",2,63,1098,554,544
050,18,085,"Indiana","Kosciusko County",2,64,1060,542,518
050,18,085,"Indiana","Kosciusko County",2,65,1031,515,516
050,18,085,"Indiana","Kosciusko County",2,66,991,501,490
050,18,085,"Indiana","Kosciusko County",2,67,949,477,472
050,18,085,"Indiana","Kosciusko County",2,68,887,443,444
050,18,085,"Indiana","Kosciusko County",2,69,804,392,412
050,18,085,"Indiana","Kosciusko County",2,70,786,384,402
050,18,085,"Indiana","Kosciusko County",2,71,786,386,400
050,18,085,"Indiana","Kosciusko County",2,72,753,376,377
050,18,085,"Indiana","Kosciusko County",2,73,808,390,418
050,18,085,"Indiana","Kosciusko County",2,74,546,263,283
050,18,085,"Indiana","Kosciusko County",2,75,536,260,276
050,18,085,"Indiana","Kosciusko County",2,76,530,247,283
050,18,085,"Indiana","Kosciusko County",2,77,520,246,274
050,18,085,"Indiana","Kosciusko County",2,78,469,212,257
050,18,085,"Indiana","Kosciusko County",2,79,410,181,229
050,18,085,"Indiana","Kosciusko County",2,80,376,166,210
050,18,085,"Indiana","Kosciusko County",2,81,354,167,187
050,18,085,"Indiana","Kosciusko County",2,82,328,141,187
050,18,085,"Indiana","Kosciusko County",2,83,278,116,162
050,18,085,"Indiana","Kosciusko County",2,84,248,102,146
050,18,085,"Indiana","Kosciusko County",2,85,1465,507,958
050,18,085,"Indiana","Kosciusko County",3,0,883,470,413
050,18,085,"Indiana","Kosciusko County",3,1,949,466,483
050,18,085,"Indiana","Kosciusko County",3,2,987,505,482
050,18,085,"Indiana","Kosciusko County",3,3,1047,527,520
050,18,085,"Indiana","Kosciusko County",3,4,1055,531,524
050,18,085,"Indiana","Kosciusko County",3,5,1019,524,495
050,18,085,"Indiana","Kosciusko County",3,6,1085,540,545
050,18,085,"Indiana","Kosciusko County",3,7,1065,558,507
050,18,085,"Indiana","Kosciusko County",3,8,1030,506,524
050,18,085,"Indiana","Kosciusko County",3,9,1026,528,498
050,18,085,"Indiana","Kosciusko County",3,10,1062,550,512
050,18,085,"Indiana","Kosciusko County",3,11,1084,560,524
050,18,085,"Indiana","Kosciusko County",3,12,1082,544,538
050,18,085,"Indiana","Kosciusko County",3,13,1130,559,571
050,18,085,"Indiana","Kosciusko County",3,14,1137,586,551
050,18,085,"Indiana","Kosciusko County",3,15,1168,622,546
050,18,085,"Indiana","Kosciusko County",3,16,1117,577,540
050,18,085,"Indiana","Kosciusko County",3,17,1126,574,552
050,18,085,"Indiana","Kosciusko County",3,18,1013,505,508
050,18,085,"Indiana","Kosciusko County",3,19,1025,500,525
050,18,085,"Indiana","Kosciusko County",3,20,1103,548,555
050,18,085,"Indiana","Kosciusko County",3,21,1091,544,547
050,18,085,"Indiana","Kosciusko County",3,22,1045,522,523
050,18,085,"Indiana","Kosciusko County",3,23,970,488,482
050,18,085,"Indiana","Kosciusko County",3,24,987,515,472
050,18,085,"Indiana","Kosciusko County",3,25,977,511,466
050,18,085,"Indiana","Kosciusko County",3,26,998,506,492
050,18,085,"Indiana","Kosciusko County",3,27,985,525,460
050,18,085,"Indiana","Kosciusko County",3,28,1032,541,491
050,18,085,"Indiana","Kosciusko County",3,29,1035,523,512
050,18,085,"Indiana","Kosciusko County",3,30,1022,514,508
050,18,085,"Indiana","Kosciusko County",3,31,1020,504,516
050,18,085,"Indiana","Kosciusko County",3,32,1006,515,491
050,18,085,"Indiana","Kosciusko County",3,33,1000,519,481
050,18,085,"Indiana","Kosciusko County",3,34,998,515,483
050,18,085,"Indiana","Kosciusko County",3,35,1013,519,494
050,18,085,"Indiana","Kosciusko County",3,36,992,496,496
050,18,085,"Indiana","Kosciusko County",3,37,944,483,461
050,18,085,"Indiana","Kosciusko County",3,38,988,508,480
050,18,085,"Indiana","Kosciusko County",3,39,998,536,462
050,18,085,"Indiana","Kosciusko County",3,40,958,506,452
050,18,085,"Indiana","Kosciusko County",3,41,937,484,453
050,18,085,"Indiana","Kosciusko County",3,42,918,487,431
050,18,085,"Indiana","Kosciusko County",3,43,909,467,442
050,18,085,"Indiana","Kosciusko County",3,44,893,464,429
050,18,085,"Indiana","Kosciusko County",3,45,836,427,409
050,18,085,"Indiana","Kosciusko County",3,46,875,447,428
050,18,085,"Indiana","Kosciusko County",3,47,833,430,403
050,18,085,"Indiana","Kosciusko County",3,48,875,442,433
050,18,085,"Indiana","Kosciusko County",3,49,926,468,458
050,18,085,"Indiana","Kosciusko County",3,50,1017,521,496
050,18,085,"Indiana","Kosciusko County",3,51,987,503,484
050,18,085,"Indiana","Kosciusko County",3,52,935,501,434
050,18,085,"Indiana","Kosciusko County",3,53,939,484,455
050,18,085,"Indiana","Kosciusko County",3,54,987,481,506
050,18,085,"Indiana","Kosciusko County",3,55,988,479,509
050,18,085,"Indiana","Kosciusko County",3,56,1035,519,516
050,18,085,"Indiana","Kosciusko County",3,57,1060,521,539
050,18,085,"Indiana","Kosciusko County",3,58,1097,537,560
050,18,085,"Indiana","Kosciusko County",3,59,1129,552,577
050,18,085,"Indiana","Kosciusko County",3,60,1136,571,565
050,18,085,"Indiana","Kosciusko County",3,61,1123,568,555
050,18,085,"Indiana","Kosciusko County",3,62,1113,555,558
050,18,085,"Indiana","Kosciusko County",3,63,1100,547,553
050,18,085,"Indiana","Kosciusko County",3,64,1089,544,545
050,18,085,"Indiana","Kosciusko County",3,65,1037,530,507
050,18,085,"Indiana","Kosciusko County",3,66,1007,513,494
050,18,085,"Indiana","Kosciusko County",3,67,994,504,490
050,18,085,"Indiana","Kosciusko County",3,68,926,469,457
050,18,085,"Indiana","Kosciusko County",3,69,864,433,431
050,18,085,"Indiana","Kosciusko County",3,70,794,382,412
050,18,085,"Indiana","Kosciusko County",3,71,770,377,393
050,18,085,"Indiana","Kosciusko County",3,72,759,370,389
050,18,085,"Indiana","Kosciusko County",3,73,727,355,372
050,18,085,"Indiana","Kosciusko County",3,74,765,369,396
050,18,085,"Indiana","Kosciusko County",3,75,522,246,276
050,18,085,"Indiana","Kosciusko County",3,76,519,248,271
050,18,085,"Indiana","Kosciusko County",3,77,506,238,268
050,18,085,"Indiana","Kosciusko County",3,78,500,224,276
050,18,085,"Indiana","Kosciusko County",3,79,452,205,247
050,18,085,"Indiana","Kosciusko County",3,80,385,166,219
050,18,085,"Indiana","Kosciusko County",3,81,350,156,194
050,18,085,"Indiana","Kosciusko County",3,82,339,151,188
050,18,085,"Indiana","Kosciusko County",3,83,296,121,175
050,18,085,"Indiana","Kosciusko County",3,84,259,108,151
050,18,085,"Indiana","Kosciusko County",3,85,1477,518,959
050,18,085,"Indiana","Kosciusko County",4,0,917,458,459
050,18,085,"Indiana","Kosciusko County",4,1,896,484,412
050,18,085,"Indiana","Kosciusko County",4,2,940,464,476
050,18,085,"Indiana","Kosciusko County",4,3,998,517,481
050,18,085,"Indiana","Kosciusko County",4,4,1048,520,528
050,18,085,"Indiana","Kosciusko County",4,5,1069,532,537
050,18,085,"Indiana","Kosciusko County",4,6,1014,525,489
050,18,085,"Indiana","Kosciusko County",4,7,1095,556,539
050,18,085,"Indiana","Kosciusko County",4,8,1084,562,522
050,18,085,"Indiana","Kosciusko County",4,9,1038,507,531
050,18,085,"Indiana","Kosciusko County",4,10,1018,517,501
050,18,085,"Indiana","Kosciusko County",4,11,1082,574,508
050,18,085,"Indiana","Kosciusko County",4,12,1098,579,519
050,18,085,"Indiana","Kosciusko County",4,13,1095,549,546
050,18,085,"Indiana","Kosciusko County",4,14,1145,568,577
050,18,085,"Indiana","Kosciusko County",4,15,1147,580,567
050,18,085,"Indiana","Kosciusko County",4,16,1187,635,552
050,18,085,"Indiana","Kosciusko County",4,17,1128,592,536
050,18,085,"Indiana","Kosciusko County",4,18,1043,533,510
050,18,085,"Indiana","Kosciusko County",4,19,1010,481,529
050,18,085,"Indiana","Kosciusko County",4,20,1055,523,532
050,18,085,"Indiana","Kosciusko County",4,21,1082,535,547
050,18,085,"Indiana","Kosciusko County",4,22,1083,549,534
050,18,085,"Indiana","Kosciusko County",4,23,973,507,466
050,18,085,"Indiana","Kosciusko County",4,24,1023,529,494
050,18,085,"Indiana","Kosciusko County",4,25,977,513,464
050,18,085,"Indiana","Kosciusko County",4,26,1007,535,472
050,18,085,"Indiana","Kosciusko County",4,27,980,489,491
050,18,085,"Indiana","Kosciusko County",4,28,993,536,457
050,18,085,"Indiana","Kosciusko County",4,29,1033,540,493
050,18,085,"Indiana","Kosciusko County",4,30,1044,530,514
050,18,085,"Indiana","Kosciusko County",4,31,1041,516,525
050,18,085,"Indiana","Kosciusko County",4,32,1018,510,508
050,18,085,"Indiana","Kosciusko County",4,33,1013,506,507
050,18,085,"Indiana","Kosciusko County",4,34,1004,516,488
050,18,085,"Indiana","Kosciusko County",4,35,997,507,490
050,18,085,"Indiana","Kosciusko County",4,36,1009,512,497
050,18,085,"Indiana","Kosciusko County",4,37,1001,500,501
050,18,085,"Indiana","Kosciusko County",4,38,953,481,472
050,18,085,"Indiana","Kosciusko County",4,39,1003,503,500
050,18,085,"Indiana","Kosciusko County",4,40,978,516,462
050,18,085,"Indiana","Kosciusko County",4,41,946,492,454
050,18,085,"Indiana","Kosciusko County",4,42,951,494,457
050,18,085,"Indiana","Kosciusko County",4,43,930,490,440
050,18,085,"Indiana","Kosciusko County",4,44,898,459,439
050,18,085,"Indiana","Kosciusko County",4,45,882,460,422
050,18,085,"Indiana","Kosciusko County",4,46,839,426,413
050,18,085,"Indiana","Kosciusko County",4,47,871,446,425
050,18,085,"Indiana","Kosciusko County",4,48,813,419,394
050,18,085,"Indiana","Kosciusko County",4,49,870,448,422
050,18,085,"Indiana","Kosciusko County",4,50,940,473,467
050,18,085,"Indiana","Kosciusko County",4,51,1033,526,507
050,18,085,"Indiana","Kosciusko County",4,52,1000,507,493
050,18,085,"Indiana","Kosciusko County",4,53,929,494,435
050,18,085,"Indiana","Kosciusko County",4,54,953,498,455
050,18,085,"Indiana","Kosciusko County",4,55,979,475,504
050,18,085,"Indiana","Kosciusko County",4,56,980,476,504
050,18,085,"Indiana","Kosciusko County",4,57,1029,517,512
050,18,085,"Indiana","Kosciusko County",4,58,1065,522,543
050,18,085,"Indiana","Kosciusko County",4,59,1092,540,552
050,18,085,"Indiana","Kosciusko County",4,60,1122,546,576
050,18,085,"Indiana","Kosciusko County",4,61,1132,571,561
050,18,085,"Indiana","Kosciusko County",4,62,1118,566,552
050,18,085,"Indiana","Kosciusko County",4,63,1123,563,560
050,18,085,"Indiana","Kosciusko County",4,64,1098,545,553
050,18,085,"Indiana","Kosciusko County",4,65,1083,538,545
050,18,085,"Indiana","Kosciusko County",4,66,1024,526,498
050,18,085,"Indiana","Kosciusko County",4,67,1009,514,495
050,18,085,"Indiana","Kosciusko County",4,68,975,498,477
050,18,085,"Indiana","Kosciusko County",4,69,895,451,444
050,18,085,"Indiana","Kosciusko County",4,70,851,424,427
050,18,085,"Indiana","Kosciusko County",4,71,775,374,401
050,18,085,"Indiana","Kosciusko County",4,72,748,369,379
050,18,085,"Indiana","Kosciusko County",4,73,728,350,378
050,18,085,"Indiana","Kosciusko County",4,74,682,330,352
050,18,085,"Indiana","Kosciusko County",4,75,747,354,393
050,18,085,"Indiana","Kosciusko County",4,76,496,229,267
050,18,085,"Indiana","Kosciusko County",4,77,491,238,253
050,18,085,"Indiana","Kosciusko County",4,78,497,224,273
050,18,085,"Indiana","Kosciusko County",4,79,464,212,252
050,18,085,"Indiana","Kosciusko County",4,80,431,192,239
050,18,085,"Indiana","Kosciusko County",4,81,356,153,203
050,18,085,"Indiana","Kosciusko County",4,82,332,141,191
050,18,085,"Indiana","Kosciusko County",4,83,304,129,175
050,18,085,"Indiana","Kosciusko County",4,84,267,100,167
050,18,085,"Indiana","Kosciusko County",4,85,1497,540,957
050,18,085,"Indiana","Kosciusko County",5,0,892,447,445
050,18,085,"Indiana","Kosciusko County",5,1,930,455,475
050,18,085,"Indiana","Kosciusko County",5,2,902,477,425
050,18,085,"Indiana","Kosciusko County",5,3,961,474,487
050,18,085,"Indiana","Kosciusko County",5,4,1008,512,496
050,18,085,"Indiana","Kosciusko County",5,5,1052,518,534
050,18,085,"Indiana","Kosciusko County",5,6,1054,542,512
050,18,085,"Indiana","Kosciusko County",5,7,1002,515,487
050,18,085,"Indiana","Kosciusko County",5,8,1096,560,536
050,18,085,"Indiana","Kosciusko County",5,9,1103,572,531
050,18,085,"Indiana","Kosciusko County",5,10,1036,505,531
050,18,085,"Indiana","Kosciusko County",5,11,1040,532,508
050,18,085,"Indiana","Kosciusko County",5,12,1074,561,513
050,18,085,"Indiana","Kosciusko County",5,13,1074,555,519
050,18,085,"Indiana","Kosciusko County",5,14,1076,540,536
050,18,085,"Indiana","Kosciusko County",5,15,1141,564,577
050,18,085,"Indiana","Kosciusko County",5,16,1121,570,551
050,18,085,"Indiana","Kosciusko County",5,17,1174,623,551
050,18,085,"Indiana","Kosciusko County",5,18,1020,544,476
050,18,085,"Indiana","Kosciusko County",5,19,1032,500,532
050,18,085,"Indiana","Kosciusko County",5,20,1067,519,548
050,18,085,"Indiana","Kosciusko County",5,21,1057,523,534
050,18,085,"Indiana","Kosciusko County",5,22,1059,535,524
050,18,085,"Indiana","Kosciusko County",5,23,1012,519,493
050,18,085,"Indiana","Kosciusko County",5,24,998,532,466
050,18,085,"Indiana","Kosciusko County",5,25,983,504,479
050,18,085,"Indiana","Kosciusko County",5,26,985,511,474
050,18,085,"Indiana","Kosciusko County",5,27,996,521,475
050,18,085,"Indiana","Kosciusko County",5,28,962,485,477
050,18,085,"Indiana","Kosciusko County",5,29,973,523,450
050,18,085,"Indiana","Kosciusko County",5,30,1008,526,482
050,18,085,"Indiana","Kosciusko County",5,31,1032,518,514
050,18,085,"Indiana","Kosciusko County",5,32,1029,506,523
050,18,085,"Indiana","Kosciusko County",5,33,1006,505,501
050,18,085,"Indiana","Kosciusko County",5,34,1012,520,492
050,18,085,"Indiana","Kosciusko County",5,35,991,509,482
050,18,085,"Indiana","Kosciusko County",5,36,976,495,481
050,18,085,"Indiana","Kosciusko County",5,37,994,501,493
050,18,085,"Indiana","Kosciusko County",5,38,1018,516,502
050,18,085,"Indiana","Kosciusko County",5,39,929,472,457
050,18,085,"Indiana","Kosciusko County",5,40,990,502,488
050,18,085,"Indiana","Kosciusko County",5,41,975,512,463
050,18,085,"Indiana","Kosciusko County",5,42,931,476,455
050,18,085,"Indiana","Kosciusko County",5,43,959,497,462
050,18,085,"Indiana","Kosciusko County",5,44,921,483,438
050,18,085,"Indiana","Kosciusko County",5,45,884,457,427
050,18,085,"Indiana","Kosciusko County",5,46,890,456,434
050,18,085,"Indiana","Kosciusko County",5,47,834,420,414
050,18,085,"Indiana","Kosciusko County",5,48,868,443,425
050,18,085,"Indiana","Kosciusko County",5,49,799,410,389
050,18,085,"Indiana","Kosciusko County",5,50,870,449,421
050,18,085,"Indiana","Kosciusko County",5,51,922,462,460
050,18,085,"Indiana","Kosciusko County",5,52,1020,519,501
050,18,085,"Indiana","Kosciusko County",5,53,1019,519,500
050,18,085,"Indiana","Kosciusko County",5,54,927,494,433
050,18,085,"Indiana","Kosciusko County",5,55,953,502,451
050,18,085,"Indiana","Kosciusko County",5,56,965,473,492
050,18,085,"Indiana","Kosciusko County",5,57,985,476,509
050,18,085,"Indiana","Kosciusko County",5,58,1040,529,511
050,18,085,"Indiana","Kosciusko County",5,59,1054,510,544
050,18,085,"Indiana","Kosciusko County",5,60,1097,546,551
050,18,085,"Indiana","Kosciusko County",5,61,1118,539,579
050,18,085,"Indiana","Kosciusko County",5,62,1139,574,565
050,18,085,"Indiana","Kosciusko County",5,63,1110,560,550
050,18,085,"Indiana","Kosciusko County",5,64,1129,558,571
050,18,085,"Indiana","Kosciusko County",5,65,1078,540,538
050,18,085,"Indiana","Kosciusko County",5,66,1056,537,519
050,18,085,"Indiana","Kosciusko County",5,67,1001,510,491
050,18,085,"Indiana","Kosciusko County",5,68,986,504,482
050,18,085,"Indiana","Kosciusko County",5,69,954,492,462
050,18,085,"Indiana","Kosciusko County",5,70,885,442,443
050,18,085,"Indiana","Kosciusko County",5,71,826,411,415
050,18,085,"Indiana","Kosciusko County",5,72,748,360,388
050,18,085,"Indiana","Kosciusko County",5,73,726,353,373
050,18,085,"Indiana","Kosciusko County",5,74,704,333,371
050,18,085,"Indiana","Kosciusko County",5,75,654,318,336
050,18,085,"Indiana","Kosciusko County",5,76,713,331,382
050,18,085,"Indiana","Kosciusko County",5,77,481,226,255
050,18,085,"Indiana","Kosciusko County",5,78,484,226,258
050,18,085,"Indiana","Kosciusko County",5,79,477,216,261
050,18,085,"Indiana","Kosciusko County",5,80,440,198,242
050,18,085,"Indiana","Kosciusko County",5,81,398,177,221
050,18,085,"Indiana","Kosciusko County",5,82,343,141,202
050,18,085,"Indiana","Kosciusko County",5,83,301,122,179
050,18,085,"Indiana","Kosciusko County",5,84,274,109,165
050,18,085,"Indiana","Kosciusko County",5,85,1561,571,990
050,18,087,"Indiana","LaGrange County",1,0,781,402,379
050,18,087,"Indiana","LaGrange County",1,1,762,401,361
050,18,087,"Indiana","LaGrange County",1,2,709,374,335
050,18,087,"Indiana","LaGrange County",1,3,694,363,331
050,18,087,"Indiana","LaGrange County",1,4,708,386,322
050,18,087,"Indiana","LaGrange County",1,5,703,367,336
050,18,087,"Indiana","LaGrange County",1,6,683,351,332
050,18,087,"Indiana","LaGrange County",1,7,729,360,369
050,18,087,"Indiana","LaGrange County",1,8,679,341,338
050,18,087,"Indiana","LaGrange County",1,9,684,356,328
050,18,087,"Indiana","LaGrange County",1,10,733,396,337
050,18,087,"Indiana","LaGrange County",1,11,734,376,358
050,18,087,"Indiana","LaGrange County",1,12,785,401,384
050,18,087,"Indiana","LaGrange County",1,13,772,400,372
050,18,087,"Indiana","LaGrange County",1,14,753,396,357
050,18,087,"Indiana","LaGrange County",1,15,751,398,353
050,18,087,"Indiana","LaGrange County",1,16,731,384,347
050,18,087,"Indiana","LaGrange County",1,17,716,364,352
050,18,087,"Indiana","LaGrange County",1,18,616,330,286
050,18,087,"Indiana","LaGrange County",1,19,482,265,217
050,18,087,"Indiana","LaGrange County",1,20,511,264,247
050,18,087,"Indiana","LaGrange County",1,21,534,272,262
050,18,087,"Indiana","LaGrange County",1,22,533,279,254
050,18,087,"Indiana","LaGrange County",1,23,538,285,253
050,18,087,"Indiana","LaGrange County",1,24,513,273,240
050,18,087,"Indiana","LaGrange County",1,25,522,276,246
050,18,087,"Indiana","LaGrange County",1,26,498,286,212
050,18,087,"Indiana","LaGrange County",1,27,467,250,217
050,18,087,"Indiana","LaGrange County",1,28,467,234,233
050,18,087,"Indiana","LaGrange County",1,29,480,242,238
050,18,087,"Indiana","LaGrange County",1,30,472,235,237
050,18,087,"Indiana","LaGrange County",1,31,488,247,241
050,18,087,"Indiana","LaGrange County",1,32,426,207,219
050,18,087,"Indiana","LaGrange County",1,33,451,214,237
050,18,087,"Indiana","LaGrange County",1,34,437,227,210
050,18,087,"Indiana","LaGrange County",1,35,448,241,207
050,18,087,"Indiana","LaGrange County",1,36,469,246,223
050,18,087,"Indiana","LaGrange County",1,37,461,240,221
050,18,087,"Indiana","LaGrange County",1,38,465,234,231
050,18,087,"Indiana","LaGrange County",1,39,464,238,226
050,18,087,"Indiana","LaGrange County",1,40,409,215,194
050,18,087,"Indiana","LaGrange County",1,41,416,211,205
050,18,087,"Indiana","LaGrange County",1,42,442,218,224
050,18,087,"Indiana","LaGrange County",1,43,451,212,239
050,18,087,"Indiana","LaGrange County",1,44,446,222,224
050,18,087,"Indiana","LaGrange County",1,45,427,210,217
050,18,087,"Indiana","LaGrange County",1,46,420,203,217
050,18,087,"Indiana","LaGrange County",1,47,474,251,223
050,18,087,"Indiana","LaGrange County",1,48,471,250,221
050,18,087,"Indiana","LaGrange County",1,49,446,245,201
050,18,087,"Indiana","LaGrange County",1,50,428,229,199
050,18,087,"Indiana","LaGrange County",1,51,428,216,212
050,18,087,"Indiana","LaGrange County",1,52,417,203,214
050,18,087,"Indiana","LaGrange County",1,53,419,214,205
050,18,087,"Indiana","LaGrange County",1,54,422,212,210
050,18,087,"Indiana","LaGrange County",1,55,447,238,209
050,18,087,"Indiana","LaGrange County",1,56,456,224,232
050,18,087,"Indiana","LaGrange County",1,57,450,218,232
050,18,087,"Indiana","LaGrange County",1,58,431,213,218
050,18,087,"Indiana","LaGrange County",1,59,461,218,243
050,18,087,"Indiana","LaGrange County",1,60,464,239,225
050,18,087,"Indiana","LaGrange County",1,61,454,233,221
050,18,087,"Indiana","LaGrange County",1,62,444,232,212
050,18,087,"Indiana","LaGrange County",1,63,423,214,209
050,18,087,"Indiana","LaGrange County",1,64,412,202,210
050,18,087,"Indiana","LaGrange County",1,65,425,213,212
050,18,087,"Indiana","LaGrange County",1,66,416,207,209
050,18,087,"Indiana","LaGrange County",1,67,386,199,187
050,18,087,"Indiana","LaGrange County",1,68,385,203,182
050,18,087,"Indiana","LaGrange County",1,69,344,171,173
050,18,087,"Indiana","LaGrange County",1,70,337,159,178
050,18,087,"Indiana","LaGrange County",1,71,317,158,159
050,18,087,"Indiana","LaGrange County",1,72,301,158,143
050,18,087,"Indiana","LaGrange County",1,73,305,153,152
050,18,087,"Indiana","LaGrange County",1,74,242,118,124
050,18,087,"Indiana","LaGrange County",1,75,237,114,123
050,18,087,"Indiana","LaGrange County",1,76,220,102,118
050,18,087,"Indiana","LaGrange County",1,77,225,104,121
050,18,087,"Indiana","LaGrange County",1,78,185,88,97
050,18,087,"Indiana","LaGrange County",1,79,171,87,84
050,18,087,"Indiana","LaGrange County",1,80,178,93,85
050,18,087,"Indiana","LaGrange County",1,81,144,68,76
050,18,087,"Indiana","LaGrange County",1,82,121,48,73
050,18,087,"Indiana","LaGrange County",1,83,101,38,63
050,18,087,"Indiana","LaGrange County",1,84,93,37,56
050,18,087,"Indiana","LaGrange County",1,85,513,192,321
050,18,087,"Indiana","LaGrange County",2,0,776,408,368
050,18,087,"Indiana","LaGrange County",2,1,760,398,362
050,18,087,"Indiana","LaGrange County",2,2,721,379,342
050,18,087,"Indiana","LaGrange County",2,3,694,366,328
050,18,087,"Indiana","LaGrange County",2,4,706,382,324
050,18,087,"Indiana","LaGrange County",2,5,705,372,333
050,18,087,"Indiana","LaGrange County",2,6,691,357,334
050,18,087,"Indiana","LaGrange County",2,7,717,357,360
050,18,087,"Indiana","LaGrange County",2,8,690,344,346
050,18,087,"Indiana","LaGrange County",2,9,682,352,330
050,18,087,"Indiana","LaGrange County",2,10,718,383,335
050,18,087,"Indiana","LaGrange County",2,11,734,379,355
050,18,087,"Indiana","LaGrange County",2,12,777,397,380
050,18,087,"Indiana","LaGrange County",2,13,776,401,375
050,18,087,"Indiana","LaGrange County",2,14,757,395,362
050,18,087,"Indiana","LaGrange County",2,15,753,399,354
050,18,087,"Indiana","LaGrange County",2,16,741,392,349
050,18,087,"Indiana","LaGrange County",2,17,720,369,351
050,18,087,"Indiana","LaGrange County",2,18,609,325,284
050,18,087,"Indiana","LaGrange County",2,19,485,264,221
050,18,087,"Indiana","LaGrange County",2,20,521,272,249
050,18,087,"Indiana","LaGrange County",2,21,534,272,262
050,18,087,"Indiana","LaGrange County",2,22,538,279,259
050,18,087,"Indiana","LaGrange County",2,23,543,286,257
050,18,087,"Indiana","LaGrange County",2,24,522,279,243
050,18,087,"Indiana","LaGrange County",2,25,520,279,241
050,18,087,"Indiana","LaGrange County",2,26,504,286,218
050,18,087,"Indiana","LaGrange County",2,27,471,256,215
050,18,087,"Indiana","LaGrange County",2,28,465,236,229
050,18,087,"Indiana","LaGrange County",2,29,472,237,235
050,18,087,"Indiana","LaGrange County",2,30,475,237,238
050,18,087,"Indiana","LaGrange County",2,31,478,242,236
050,18,087,"Indiana","LaGrange County",2,32,441,217,224
050,18,087,"Indiana","LaGrange County",2,33,446,214,232
050,18,087,"Indiana","LaGrange County",2,34,441,224,217
050,18,087,"Indiana","LaGrange County",2,35,448,238,210
050,18,087,"Indiana","LaGrange County",2,36,459,243,216
050,18,087,"Indiana","LaGrange County",2,37,460,240,220
050,18,087,"Indiana","LaGrange County",2,38,462,234,228
050,18,087,"Indiana","LaGrange County",2,39,459,236,223
050,18,087,"Indiana","LaGrange County",2,40,424,221,203
050,18,087,"Indiana","LaGrange County",2,41,415,213,202
050,18,087,"Indiana","LaGrange County",2,42,435,216,219
050,18,087,"Indiana","LaGrange County",2,43,453,215,238
050,18,087,"Indiana","LaGrange County",2,44,442,218,224
050,18,087,"Indiana","LaGrange County",2,45,439,216,223
050,18,087,"Indiana","LaGrange County",2,46,418,203,215
050,18,087,"Indiana","LaGrange County",2,47,459,238,221
050,18,087,"Indiana","LaGrange County",2,48,471,249,222
050,18,087,"Indiana","LaGrange County",2,49,457,249,208
050,18,087,"Indiana","LaGrange County",2,50,436,235,201
050,18,087,"Indiana","LaGrange County",2,51,429,220,209
050,18,087,"Indiana","LaGrange County",2,52,418,206,212
050,18,087,"Indiana","LaGrange County",2,53,419,210,209
050,18,087,"Indiana","LaGrange County",2,54,420,214,206
050,18,087,"Indiana","LaGrange County",2,55,441,231,210
050,18,087,"Indiana","LaGrange County",2,56,456,229,227
050,18,087,"Indiana","LaGrange County",2,57,449,218,231
050,18,087,"Indiana","LaGrange County",2,58,438,215,223
050,18,087,"Indiana","LaGrange County",2,59,456,217,239
050,18,087,"Indiana","LaGrange County",2,60,464,234,230
050,18,087,"Indiana","LaGrange County",2,61,458,234,224
050,18,087,"Indiana","LaGrange County",2,62,449,233,216
050,18,087,"Indiana","LaGrange County",2,63,434,222,212
050,18,087,"Indiana","LaGrange County",2,64,412,204,208
050,18,087,"Indiana","LaGrange County",2,65,425,212,213
050,18,087,"Indiana","LaGrange County",2,66,414,207,207
050,18,087,"Indiana","LaGrange County",2,67,392,200,192
050,18,087,"Indiana","LaGrange County",2,68,383,201,182
050,18,087,"Indiana","LaGrange County",2,69,355,178,177
050,18,087,"Indiana","LaGrange County",2,70,337,162,175
050,18,087,"Indiana","LaGrange County",2,71,320,157,163
050,18,087,"Indiana","LaGrange County",2,72,299,154,145
050,18,087,"Indiana","LaGrange County",2,73,316,161,155
050,18,087,"Indiana","LaGrange County",2,74,238,115,123
050,18,087,"Indiana","LaGrange County",2,75,238,116,122
050,18,087,"Indiana","LaGrange County",2,76,222,103,119
050,18,087,"Indiana","LaGrange County",2,77,227,104,123
050,18,087,"Indiana","LaGrange County",2,78,187,88,99
050,18,087,"Indiana","LaGrange County",2,79,171,87,84
050,18,087,"Indiana","LaGrange County",2,80,175,90,85
050,18,087,"Indiana","LaGrange County",2,81,147,71,76
050,18,087,"Indiana","LaGrange County",2,82,127,53,74
050,18,087,"Indiana","LaGrange County",2,83,101,40,61
050,18,087,"Indiana","LaGrange County",2,84,89,33,56
050,18,087,"Indiana","LaGrange County",2,85,516,192,324
050,18,087,"Indiana","LaGrange County",3,0,686,370,316
050,18,087,"Indiana","LaGrange County",3,1,746,380,366
050,18,087,"Indiana","LaGrange County",3,2,729,376,353
050,18,087,"Indiana","LaGrange County",3,3,710,369,341
050,18,087,"Indiana","LaGrange County",3,4,679,362,317
050,18,087,"Indiana","LaGrange County",3,5,691,379,312
050,18,087,"Indiana","LaGrange County",3,6,688,370,318
050,18,087,"Indiana","LaGrange County",3,7,704,359,345
050,18,087,"Indiana","LaGrange County",3,8,700,344,356
050,18,087,"Indiana","LaGrange County",3,9,699,344,355
050,18,087,"Indiana","LaGrange County",3,10,674,345,329
050,18,087,"Indiana","LaGrange County",3,11,729,392,337
050,18,087,"Indiana","LaGrange County",3,12,722,377,345
050,18,087,"Indiana","LaGrange County",3,13,790,401,389
050,18,087,"Indiana","LaGrange County",3,14,765,394,371
050,18,087,"Indiana","LaGrange County",3,15,766,393,373
050,18,087,"Indiana","LaGrange County",3,16,765,406,359
050,18,087,"Indiana","LaGrange County",3,17,747,393,354
050,18,087,"Indiana","LaGrange County",3,18,595,322,273
050,18,087,"Indiana","LaGrange County",3,19,476,254,222
050,18,087,"Indiana","LaGrange County",3,20,528,295,233
050,18,087,"Indiana","LaGrange County",3,21,554,289,265
050,18,087,"Indiana","LaGrange County",3,22,527,262,265
050,18,087,"Indiana","LaGrange County",3,23,539,293,246
050,18,087,"Indiana","LaGrange County",3,24,541,295,246
050,18,087,"Indiana","LaGrange County",3,25,505,277,228
050,18,087,"Indiana","LaGrange County",3,26,508,275,233
050,18,087,"Indiana","LaGrange County",3,27,499,284,215
050,18,087,"Indiana","LaGrange County",3,28,457,248,209
050,18,087,"Indiana","LaGrange County",3,29,437,218,219
050,18,087,"Indiana","LaGrange County",3,30,476,238,238
050,18,087,"Indiana","LaGrange County",3,31,479,238,241
050,18,087,"Indiana","LaGrange County",3,32,471,237,234
050,18,087,"Indiana","LaGrange County",3,33,436,215,221
050,18,087,"Indiana","LaGrange County",3,34,439,210,229
050,18,087,"Indiana","LaGrange County",3,35,450,229,221
050,18,087,"Indiana","LaGrange County",3,36,445,239,206
050,18,087,"Indiana","LaGrange County",3,37,446,234,212
050,18,087,"Indiana","LaGrange County",3,38,449,233,216
050,18,087,"Indiana","LaGrange County",3,39,464,230,234
050,18,087,"Indiana","LaGrange County",3,40,465,236,229
050,18,087,"Indiana","LaGrange County",3,41,425,224,201
050,18,087,"Indiana","LaGrange County",3,42,408,218,190
050,18,087,"Indiana","LaGrange County",3,43,436,212,224
050,18,087,"Indiana","LaGrange County",3,44,443,217,226
050,18,087,"Indiana","LaGrange County",3,45,444,216,228
050,18,087,"Indiana","LaGrange County",3,46,436,217,219
050,18,087,"Indiana","LaGrange County",3,47,419,205,214
050,18,087,"Indiana","LaGrange County",3,48,473,240,233
050,18,087,"Indiana","LaGrange County",3,49,467,248,219
050,18,087,"Indiana","LaGrange County",3,50,467,259,208
050,18,087,"Indiana","LaGrange County",3,51,439,237,202
050,18,087,"Indiana","LaGrange County",3,52,435,224,211
050,18,087,"Indiana","LaGrange County",3,53,414,205,209
050,18,087,"Indiana","LaGrange County",3,54,406,205,201
050,18,087,"Indiana","LaGrange County",3,55,410,208,202
050,18,087,"Indiana","LaGrange County",3,56,434,226,208
050,18,087,"Indiana","LaGrange County",3,57,456,231,225
050,18,087,"Indiana","LaGrange County",3,58,452,218,234
050,18,087,"Indiana","LaGrange County",3,59,460,219,241
050,18,087,"Indiana","LaGrange County",3,60,453,217,236
050,18,087,"Indiana","LaGrange County",3,61,462,235,227
050,18,087,"Indiana","LaGrange County",3,62,460,233,227
050,18,087,"Indiana","LaGrange County",3,63,441,230,211
050,18,087,"Indiana","LaGrange County",3,64,435,224,211
050,18,087,"Indiana","LaGrange County",3,65,409,203,206
050,18,087,"Indiana","LaGrange County",3,66,417,208,209
050,18,087,"Indiana","LaGrange County",3,67,401,201,200
050,18,087,"Indiana","LaGrange County",3,68,375,192,183
050,18,087,"Indiana","LaGrange County",3,69,374,194,180
050,18,087,"Indiana","LaGrange County",3,70,340,171,169
050,18,087,"Indiana","LaGrange County",3,71,325,154,171
050,18,087,"Indiana","LaGrange County",3,72,315,153,162
050,18,087,"Indiana","LaGrange County",3,73,292,150,142
050,18,087,"Indiana","LaGrange County",3,74,309,158,151
050,18,087,"Indiana","LaGrange County",3,75,226,109,117
050,18,087,"Indiana","LaGrange County",3,76,226,110,116
050,18,087,"Indiana","LaGrange County",3,77,209,94,115
050,18,087,"Indiana","LaGrange County",3,78,217,101,116
050,18,087,"Indiana","LaGrange County",3,79,175,82,93
050,18,087,"Indiana","LaGrange County",3,80,163,79,84
050,18,087,"Indiana","LaGrange County",3,81,163,80,83
050,18,087,"Indiana","LaGrange County",3,82,125,60,65
050,18,087,"Indiana","LaGrange County",3,83,111,49,62
050,18,087,"Indiana","LaGrange County",3,84,89,32,57
050,18,087,"Indiana","LaGrange County",3,85,515,194,321
050,18,087,"Indiana","LaGrange County",4,0,703,367,336
050,18,087,"Indiana","LaGrange County",4,1,688,358,330
050,18,087,"Indiana","LaGrange County",4,2,753,380,373
050,18,087,"Indiana","LaGrange County",4,3,723,375,348
050,18,087,"Indiana","LaGrange County",4,4,703,368,335
050,18,087,"Indiana","LaGrange County",4,5,680,371,309
050,18,087,"Indiana","LaGrange County",4,6,704,388,316
050,18,087,"Indiana","LaGrange County",4,7,686,377,309
050,18,087,"Indiana","LaGrange County",4,8,686,345,341
050,18,087,"Indiana","LaGrange County",4,9,709,338,371
050,18,087,"Indiana","LaGrange County",4,10,695,349,346
050,18,087,"Indiana","LaGrange County",4,11,706,349,357
050,18,087,"Indiana","LaGrange County",4,12,717,385,332
050,18,087,"Indiana","LaGrange County",4,13,745,397,348
050,18,087,"Indiana","LaGrange County",4,14,773,388,385
050,18,087,"Indiana","LaGrange County",4,15,764,397,367
050,18,087,"Indiana","LaGrange County",4,16,774,399,375
050,18,087,"Indiana","LaGrange County",4,17,761,404,357
050,18,087,"Indiana","LaGrange County",4,18,625,340,285
050,18,087,"Indiana","LaGrange County",4,19,453,243,210
050,18,087,"Indiana","LaGrange County",4,20,504,267,237
050,18,087,"Indiana","LaGrange County",4,21,553,300,253
050,18,087,"Indiana","LaGrange County",4,22,590,295,295
050,18,087,"Indiana","LaGrange County",4,23,560,278,282
050,18,087,"Indiana","LaGrange County",4,24,529,288,241
050,18,087,"Indiana","LaGrange County",4,25,516,280,236
050,18,087,"Indiana","LaGrange County",4,26,516,276,240
050,18,087,"Indiana","LaGrange County",4,27,511,279,232
050,18,087,"Indiana","LaGrange County",4,28,515,294,221
050,18,087,"Indiana","LaGrange County",4,29,445,242,203
050,18,087,"Indiana","LaGrange County",4,30,447,231,216
050,18,087,"Indiana","LaGrange County",4,31,485,243,242
050,18,087,"Indiana","LaGrange County",4,32,496,241,255
050,18,087,"Indiana","LaGrange County",4,33,463,228,235
050,18,087,"Indiana","LaGrange County",4,34,430,208,222
050,18,087,"Indiana","LaGrange County",4,35,434,207,227
050,18,087,"Indiana","LaGrange County",4,36,450,234,216
050,18,087,"Indiana","LaGrange County",4,37,437,233,204
050,18,087,"Indiana","LaGrange County",4,38,454,241,213
050,18,087,"Indiana","LaGrange County",4,39,443,234,209
050,18,087,"Indiana","LaGrange County",4,40,471,235,236
050,18,087,"Indiana","LaGrange County",4,41,455,232,223
050,18,087,"Indiana","LaGrange County",4,42,428,224,204
050,18,087,"Indiana","LaGrange County",4,43,411,218,193
050,18,087,"Indiana","LaGrange County",4,44,434,218,216
050,18,087,"Indiana","LaGrange County",4,45,440,214,226
050,18,087,"Indiana","LaGrange County",4,46,433,206,227
050,18,087,"Indiana","LaGrange County",4,47,438,213,225
050,18,087,"Indiana","LaGrange County",4,48,420,203,217
050,18,087,"Indiana","LaGrange County",4,49,466,240,226
050,18,087,"Indiana","LaGrange County",4,50,475,249,226
050,18,087,"Indiana","LaGrange County",4,51,474,268,206
050,18,087,"Indiana","LaGrange County",4,52,442,242,200
050,18,087,"Indiana","LaGrange County",4,53,441,227,214
050,18,087,"Indiana","LaGrange County",4,54,425,210,215
050,18,087,"Indiana","LaGrange County",4,55,410,205,205
050,18,087,"Indiana","LaGrange County",4,56,414,209,205
050,18,087,"Indiana","LaGrange County",4,57,436,229,207
050,18,087,"Indiana","LaGrange County",4,58,459,239,220
050,18,087,"Indiana","LaGrange County",4,59,454,216,238
050,18,087,"Indiana","LaGrange County",4,60,447,209,238
050,18,087,"Indiana","LaGrange County",4,61,459,218,241
050,18,087,"Indiana","LaGrange County",4,62,481,246,235
050,18,087,"Indiana","LaGrange County",4,63,448,225,223
050,18,087,"Indiana","LaGrange County",4,64,440,227,213
050,18,087,"Indiana","LaGrange County",4,65,430,223,207
050,18,087,"Indiana","LaGrange County",4,66,406,201,205
050,18,087,"Indiana","LaGrange County",4,67,413,206,207
050,18,087,"Indiana","LaGrange County",4,68,390,197,193
050,18,087,"Indiana","LaGrange County",4,69,380,188,192
050,18,087,"Indiana","LaGrange County",4,70,361,193,168
050,18,087,"Indiana","LaGrange County",4,71,326,166,160
050,18,087,"Indiana","LaGrange County",4,72,319,148,171
050,18,087,"Indiana","LaGrange County",4,73,311,153,158
050,18,087,"Indiana","LaGrange County",4,74,280,141,139
050,18,087,"Indiana","LaGrange County",4,75,292,148,144
050,18,087,"Indiana","LaGrange County",4,76,206,100,106
050,18,087,"Indiana","LaGrange County",4,77,221,109,112
050,18,087,"Indiana","LaGrange County",4,78,198,88,110
050,18,087,"Indiana","LaGrange County",4,79,208,95,113
050,18,087,"Indiana","LaGrange County",4,80,165,72,93
050,18,087,"Indiana","LaGrange County",4,81,151,71,80
050,18,087,"Indiana","LaGrange County",4,82,140,68,72
050,18,087,"Indiana","LaGrange County",4,83,111,56,55
050,18,087,"Indiana","LaGrange County",4,84,97,42,55
050,18,087,"Indiana","LaGrange County",4,85,522,194,328
050,18,087,"Indiana","LaGrange County",5,0,666,347,319
050,18,087,"Indiana","LaGrange County",5,1,711,359,352
050,18,087,"Indiana","LaGrange County",5,2,697,361,336
050,18,087,"Indiana","LaGrange County",5,3,752,384,368
050,18,087,"Indiana","LaGrange County",5,4,712,371,341
050,18,087,"Indiana","LaGrange County",5,5,706,358,348
050,18,087,"Indiana","LaGrange County",5,6,666,353,313
050,18,087,"Indiana","LaGrange County",5,7,700,383,317
050,18,087,"Indiana","LaGrange County",5,8,678,359,319
050,18,087,"Indiana","LaGrange County",5,9,691,345,346
050,18,087,"Indiana","LaGrange County",5,10,685,335,350
050,18,087,"Indiana","LaGrange County",5,11,689,345,344
050,18,087,"Indiana","LaGrange County",5,12,701,349,352
050,18,087,"Indiana","LaGrange County",5,13,720,389,331
050,18,087,"Indiana","LaGrange County",5,14,736,391,345
050,18,087,"Indiana","LaGrange County",5,15,779,387,392
050,18,087,"Indiana","LaGrange County",5,16,774,405,369
050,18,087,"Indiana","LaGrange County",5,17,776,399,377
050,18,087,"Indiana","LaGrange County",5,18,636,340,296
050,18,087,"Indiana","LaGrange County",5,19,473,256,217
050,18,087,"Indiana","LaGrange County",5,20,495,258,237
050,18,087,"Indiana","LaGrange County",5,21,526,278,248
050,18,087,"Indiana","LaGrange County",5,22,585,311,274
050,18,087,"Indiana","LaGrange County",5,23,587,304,283
050,18,087,"Indiana","LaGrange County",5,24,559,277,282
050,18,087,"Indiana","LaGrange County",5,25,526,278,248
050,18,087,"Indiana","LaGrange County",5,26,517,286,231
050,18,087,"Indiana","LaGrange County",5,27,499,271,228
050,18,087,"Indiana","LaGrange County",5,28,491,265,226
050,18,087,"Indiana","LaGrange County",5,29,496,277,219
050,18,087,"Indiana","LaGrange County",5,30,454,247,207
050,18,087,"Indiana","LaGrange County",5,31,462,239,223
050,18,087,"Indiana","LaGrange County",5,32,469,242,227
050,18,087,"Indiana","LaGrange County",5,33,494,242,252
050,18,087,"Indiana","LaGrange County",5,34,460,228,232
050,18,087,"Indiana","LaGrange County",5,35,425,204,221
050,18,087,"Indiana","LaGrange County",5,36,428,214,214
050,18,087,"Indiana","LaGrange County",5,37,450,238,212
050,18,087,"Indiana","LaGrange County",5,38,434,227,207
050,18,087,"Indiana","LaGrange County",5,39,447,234,213
050,18,087,"Indiana","LaGrange County",5,40,440,229,211
050,18,087,"Indiana","LaGrange County",5,41,469,237,232
050,18,087,"Indiana","LaGrange County",5,42,455,235,220
050,18,087,"Indiana","LaGrange County",5,43,427,222,205
050,18,087,"Indiana","LaGrange County",5,44,408,218,190
050,18,087,"Indiana","LaGrange County",5,45,444,217,227
050,18,087,"Indiana","LaGrange County",5,46,433,212,221
050,18,087,"Indiana","LaGrange County",5,47,427,205,222
050,18,087,"Indiana","LaGrange County",5,48,437,215,222
050,18,087,"Indiana","LaGrange County",5,49,421,209,212
050,18,087,"Indiana","LaGrange County",5,50,460,236,224
050,18,087,"Indiana","LaGrange County",5,51,476,249,227
050,18,087,"Indiana","LaGrange County",5,52,459,263,196
050,18,087,"Indiana","LaGrange County",5,53,451,245,206
050,18,087,"Indiana","LaGrange County",5,54,435,229,206
050,18,087,"Indiana","LaGrange County",5,55,419,212,207
050,18,087,"Indiana","LaGrange County",5,56,418,211,207
050,18,087,"Indiana","LaGrange County",5,57,414,210,204
050,18,087,"Indiana","LaGrange County",5,58,429,223,206
050,18,087,"Indiana","LaGrange County",5,59,458,233,225
050,18,087,"Indiana","LaGrange County",5,60,440,213,227
050,18,087,"Indiana","LaGrange County",5,61,448,207,241
050,18,087,"Indiana","LaGrange County",5,62,458,215,243
050,18,087,"Indiana","LaGrange County",5,63,473,242,231
050,18,087,"Indiana","LaGrange County",5,64,448,222,226
050,18,087,"Indiana","LaGrange County",5,65,441,227,214
050,18,087,"Indiana","LaGrange County",5,66,423,222,201
050,18,087,"Indiana","LaGrange County",5,67,402,199,203
050,18,087,"Indiana","LaGrange County",5,68,408,204,204
050,18,087,"Indiana","LaGrange County",5,69,382,190,192
050,18,087,"Indiana","LaGrange County",5,70,372,184,188
050,18,087,"Indiana","LaGrange County",5,71,357,192,165
050,18,087,"Indiana","LaGrange County",5,72,320,162,158
050,18,087,"Indiana","LaGrange County",5,73,310,144,166
050,18,087,"Indiana","LaGrange County",5,74,301,148,153
050,18,087,"Indiana","LaGrange County",5,75,268,135,133
050,18,087,"Indiana","LaGrange County",5,76,277,143,134
050,18,087,"Indiana","LaGrange County",5,77,198,95,103
050,18,087,"Indiana","LaGrange County",5,78,210,105,105
050,18,087,"Indiana","LaGrange County",5,79,190,81,109
050,18,087,"Indiana","LaGrange County",5,80,196,83,113
050,18,087,"Indiana","LaGrange County",5,81,150,62,88
050,18,087,"Indiana","LaGrange County",5,82,135,63,72
050,18,087,"Indiana","LaGrange County",5,83,126,62,64
050,18,087,"Indiana","LaGrange County",5,84,98,46,52
050,18,087,"Indiana","LaGrange County",5,85,544,212,332
050,18,089,"Indiana","Lake County",1,0,5757,2934,2823
050,18,089,"Indiana","Lake County",1,1,5837,2972,2865
050,18,089,"Indiana","Lake County",1,2,5876,2990,2886
050,18,089,"Indiana","Lake County",1,3,5805,2976,2829
050,18,089,"Indiana","Lake County",1,4,6156,3156,3000
050,18,089,"Indiana","Lake County",1,5,6300,3256,3044
050,18,089,"Indiana","Lake County",1,6,6359,3287,3072
050,18,089,"Indiana","Lake County",1,7,6345,3261,3084
050,18,089,"Indiana","Lake County",1,8,6328,3217,3111
050,18,089,"Indiana","Lake County",1,9,6435,3219,3216
050,18,089,"Indiana","Lake County",1,10,6774,3421,3353
050,18,089,"Indiana","Lake County",1,11,6831,3521,3310
050,18,089,"Indiana","Lake County",1,12,7175,3671,3504
050,18,089,"Indiana","Lake County",1,13,7168,3659,3509
050,18,089,"Indiana","Lake County",1,14,7097,3643,3454
050,18,089,"Indiana","Lake County",1,15,7061,3649,3412
050,18,089,"Indiana","Lake County",1,16,7337,3747,3590
050,18,089,"Indiana","Lake County",1,17,7147,3676,3471
050,18,089,"Indiana","Lake County",1,18,6259,3255,3004
050,18,089,"Indiana","Lake County",1,19,5599,2870,2729
050,18,089,"Indiana","Lake County",1,20,5769,2934,2835
050,18,089,"Indiana","Lake County",1,21,5849,2928,2921
050,18,089,"Indiana","Lake County",1,22,5864,2952,2912
050,18,089,"Indiana","Lake County",1,23,5914,2934,2980
050,18,089,"Indiana","Lake County",1,24,5924,3046,2878
050,18,089,"Indiana","Lake County",1,25,6019,3051,2968
050,18,089,"Indiana","Lake County",1,26,6075,2986,3089
050,18,089,"Indiana","Lake County",1,27,6211,3088,3123
050,18,089,"Indiana","Lake County",1,28,6312,3080,3232
050,18,089,"Indiana","Lake County",1,29,6329,3058,3271
050,18,089,"Indiana","Lake County",1,30,6128,3008,3120
050,18,089,"Indiana","Lake County",1,31,5863,2874,2989
050,18,089,"Indiana","Lake County",1,32,5742,2804,2938
050,18,089,"Indiana","Lake County",1,33,5886,2832,3054
050,18,089,"Indiana","Lake County",1,34,6208,3026,3182
050,18,089,"Indiana","Lake County",1,35,6208,3060,3148
050,18,089,"Indiana","Lake County",1,36,6296,3075,3221
050,18,089,"Indiana","Lake County",1,37,6539,3183,3356
050,18,089,"Indiana","Lake County",1,38,6687,3245,3442
050,18,089,"Indiana","Lake County",1,39,6797,3263,3534
050,18,089,"Indiana","Lake County",1,40,6729,3261,3468
050,18,089,"Indiana","Lake County",1,41,6346,3056,3290
050,18,089,"Indiana","Lake County",1,42,6330,3105,3225
050,18,089,"Indiana","Lake County",1,43,6205,3074,3131
050,18,089,"Indiana","Lake County",1,44,6122,2984,3138
050,18,089,"Indiana","Lake County",1,45,6159,2974,3185
050,18,089,"Indiana","Lake County",1,46,5900,2867,3033
050,18,089,"Indiana","Lake County",1,47,5929,2877,3052
050,18,089,"Indiana","Lake County",1,48,6224,3043,3181
050,18,089,"Indiana","Lake County",1,49,6665,3247,3418
050,18,089,"Indiana","Lake County",1,50,6407,3121,3286
050,18,089,"Indiana","Lake County",1,51,6010,2993,3017
050,18,089,"Indiana","Lake County",1,52,6046,2934,3112
050,18,089,"Indiana","Lake County",1,53,6161,2969,3192
050,18,089,"Indiana","Lake County",1,54,6339,3092,3247
050,18,089,"Indiana","Lake County",1,55,6664,3305,3359
050,18,089,"Indiana","Lake County",1,56,6825,3372,3453
050,18,089,"Indiana","Lake County",1,57,6700,3202,3498
050,18,089,"Indiana","Lake County",1,58,6942,3328,3614
050,18,089,"Indiana","Lake County",1,59,7014,3390,3624
050,18,089,"Indiana","Lake County",1,60,6976,3410,3566
050,18,089,"Indiana","Lake County",1,61,7008,3340,3668
050,18,089,"Indiana","Lake County",1,62,7080,3402,3678
050,18,089,"Indiana","Lake County",1,63,6712,3251,3461
050,18,089,"Indiana","Lake County",1,64,6568,3147,3421
050,18,089,"Indiana","Lake County",1,65,6447,3102,3345
050,18,089,"Indiana","Lake County",1,66,5934,2812,3122
050,18,089,"Indiana","Lake County",1,67,5601,2604,2997
050,18,089,"Indiana","Lake County",1,68,5415,2604,2811
050,18,089,"Indiana","Lake County",1,69,5135,2422,2713
050,18,089,"Indiana","Lake County",1,70,5008,2352,2656
050,18,089,"Indiana","Lake County",1,71,4816,2261,2555
050,18,089,"Indiana","Lake County",1,72,4635,2134,2501
050,18,089,"Indiana","Lake County",1,73,4503,2070,2433
050,18,089,"Indiana","Lake County",1,74,3169,1410,1759
050,18,089,"Indiana","Lake County",1,75,3129,1394,1735
050,18,089,"Indiana","Lake County",1,76,3004,1288,1716
050,18,089,"Indiana","Lake County",1,77,3050,1311,1739
050,18,089,"Indiana","Lake County",1,78,2735,1163,1572
050,18,089,"Indiana","Lake County",1,79,2494,1046,1448
050,18,089,"Indiana","Lake County",1,80,2205,891,1314
050,18,089,"Indiana","Lake County",1,81,2036,810,1226
050,18,089,"Indiana","Lake County",1,82,1973,794,1179
050,18,089,"Indiana","Lake County",1,83,1759,701,1058
050,18,089,"Indiana","Lake County",1,84,1543,596,947
050,18,089,"Indiana","Lake County",1,85,9787,3411,6376
050,18,089,"Indiana","Lake County",2,0,5707,2925,2782
050,18,089,"Indiana","Lake County",2,1,5857,2981,2876
050,18,089,"Indiana","Lake County",2,2,5899,3000,2899
050,18,089,"Indiana","Lake County",2,3,5847,3002,2845
050,18,089,"Indiana","Lake County",2,4,6107,3134,2973
050,18,089,"Indiana","Lake County",2,5,6294,3247,3047
050,18,089,"Indiana","Lake County",2,6,6372,3301,3071
050,18,089,"Indiana","Lake County",2,7,6356,3273,3083
050,18,089,"Indiana","Lake County",2,8,6338,3233,3105
050,18,089,"Indiana","Lake County",2,9,6427,3228,3199
050,18,089,"Indiana","Lake County",2,10,6691,3371,3320
050,18,089,"Indiana","Lake County",2,11,6797,3484,3313
050,18,089,"Indiana","Lake County",2,12,7117,3650,3467
050,18,089,"Indiana","Lake County",2,13,7171,3665,3506
050,18,089,"Indiana","Lake County",2,14,7112,3652,3460
050,18,089,"Indiana","Lake County",2,15,7075,3654,3421
050,18,089,"Indiana","Lake County",2,16,7277,3734,3543
050,18,089,"Indiana","Lake County",2,17,7188,3689,3499
050,18,089,"Indiana","Lake County",2,18,6248,3255,2993
050,18,089,"Indiana","Lake County",2,19,5586,2871,2715
050,18,089,"Indiana","Lake County",2,20,5854,2972,2882
050,18,089,"Indiana","Lake County",2,21,5863,2939,2924
050,18,089,"Indiana","Lake County",2,22,5899,2953,2946
050,18,089,"Indiana","Lake County",2,23,5909,2941,2968
050,18,089,"Indiana","Lake County",2,24,5894,3005,2889
050,18,089,"Indiana","Lake County",2,25,5988,3039,2949
050,18,089,"Indiana","Lake County",2,26,6083,3007,3076
050,18,089,"Indiana","Lake County",2,27,6168,3052,3116
050,18,089,"Indiana","Lake County",2,28,6308,3094,3214
050,18,089,"Indiana","Lake County",2,29,6334,3064,3270
050,18,089,"Indiana","Lake County",2,30,6224,3042,3182
050,18,089,"Indiana","Lake County",2,31,5927,2907,3020
050,18,089,"Indiana","Lake County",2,32,5791,2830,2961
050,18,089,"Indiana","Lake County",2,33,5878,2838,3040
050,18,089,"Indiana","Lake County",2,34,6134,2976,3158
050,18,089,"Indiana","Lake County",2,35,6265,3080,3185
050,18,089,"Indiana","Lake County",2,36,6252,3061,3191
050,18,089,"Indiana","Lake County",2,37,6496,3161,3335
050,18,089,"Indiana","Lake County",2,38,6682,3247,3435
050,18,089,"Indiana","Lake County",2,39,6756,3256,3500
050,18,089,"Indiana","Lake County",2,40,6792,3289,3503
050,18,089,"Indiana","Lake County",2,41,6450,3110,3340
050,18,089,"Indiana","Lake County",2,42,6316,3094,3222
050,18,089,"Indiana","Lake County",2,43,6280,3101,3179
050,18,089,"Indiana","Lake County",2,44,6103,2986,3117
050,18,089,"Indiana","Lake County",2,45,6184,2986,3198
050,18,089,"Indiana","Lake County",2,46,5948,2887,3061
050,18,089,"Indiana","Lake County",2,47,5914,2869,3045
050,18,089,"Indiana","Lake County",2,48,6153,3002,3151
050,18,089,"Indiana","Lake County",2,49,6575,3203,3372
050,18,089,"Indiana","Lake County",2,50,6465,3149,3316
050,18,089,"Indiana","Lake County",2,51,6070,3007,3063
050,18,089,"Indiana","Lake County",2,52,6021,2938,3083
050,18,089,"Indiana","Lake County",2,53,6107,2950,3157
050,18,089,"Indiana","Lake County",2,54,6285,3055,3230
050,18,089,"Indiana","Lake County",2,55,6589,3254,3335
050,18,089,"Indiana","Lake County",2,56,6803,3364,3439
050,18,089,"Indiana","Lake County",2,57,6722,3239,3483
050,18,089,"Indiana","Lake County",2,58,6856,3277,3579
050,18,089,"Indiana","Lake County",2,59,6986,3369,3617
050,18,089,"Indiana","Lake County",2,60,6971,3401,3570
050,18,089,"Indiana","Lake County",2,61,6968,3337,3631
050,18,089,"Indiana","Lake County",2,62,7011,3358,3653
050,18,089,"Indiana","Lake County",2,63,6812,3283,3529
050,18,089,"Indiana","Lake County",2,64,6552,3146,3406
050,18,089,"Indiana","Lake County",2,65,6445,3088,3357
050,18,089,"Indiana","Lake County",2,66,6038,2870,3168
050,18,089,"Indiana","Lake County",2,67,5640,2633,3007
050,18,089,"Indiana","Lake County",2,68,5395,2570,2825
050,18,089,"Indiana","Lake County",2,69,5217,2471,2746
050,18,089,"Indiana","Lake County",2,70,5000,2345,2655
050,18,089,"Indiana","Lake County",2,71,4834,2271,2563
050,18,089,"Indiana","Lake County",2,72,4582,2119,2463
050,18,089,"Indiana","Lake County",2,73,4690,2152,2538
050,18,089,"Indiana","Lake County",2,74,3279,1470,1809
050,18,089,"Indiana","Lake County",2,75,3128,1384,1744
050,18,089,"Indiana","Lake County",2,76,2990,1295,1695
050,18,089,"Indiana","Lake County",2,77,3069,1315,1754
050,18,089,"Indiana","Lake County",2,78,2738,1172,1566
050,18,089,"Indiana","Lake County",2,79,2499,1047,1452
050,18,089,"Indiana","Lake County",2,80,2244,913,1331
050,18,089,"Indiana","Lake County",2,81,2041,814,1227
050,18,089,"Indiana","Lake County",2,82,1964,781,1183
050,18,089,"Indiana","Lake County",2,83,1786,708,1078
050,18,089,"Indiana","Lake County",2,84,1553,600,953
050,18,089,"Indiana","Lake County",2,85,9721,3385,6336
050,18,089,"Indiana","Lake County",3,0,5265,2664,2601
050,18,089,"Indiana","Lake County",3,1,5744,2912,2832
050,18,089,"Indiana","Lake County",3,2,5934,3025,2909
050,18,089,"Indiana","Lake County",3,3,5945,3011,2934
050,18,089,"Indiana","Lake County",3,4,5949,3054,2895
050,18,089,"Indiana","Lake County",3,5,6174,3173,3001
050,18,089,"Indiana","Lake County",3,6,6367,3276,3091
050,18,089,"Indiana","Lake County",3,7,6418,3327,3091
050,18,089,"Indiana","Lake County",3,8,6381,3277,3104
050,18,089,"Indiana","Lake County",3,9,6313,3209,3104
050,18,089,"Indiana","Lake County",3,10,6452,3272,3180
050,18,089,"Indiana","Lake County",3,11,6712,3389,3323
050,18,089,"Indiana","Lake County",3,12,6892,3543,3349
050,18,089,"Indiana","Lake County",3,13,7154,3678,3476
050,18,089,"Indiana","Lake County",3,14,7225,3702,3523
050,18,089,"Indiana","Lake County",3,15,7155,3661,3494
050,18,089,"Indiana","Lake County",3,16,7109,3649,3460
050,18,089,"Indiana","Lake County",3,17,7271,3726,3545
050,18,089,"Indiana","Lake County",3,18,6378,3326,3052
050,18,089,"Indiana","Lake County",3,19,5513,2861,2652
050,18,089,"Indiana","Lake County",3,20,5867,2985,2882
050,18,089,"Indiana","Lake County",3,21,5981,3011,2970
050,18,089,"Indiana","Lake County",3,22,6032,3031,3001
050,18,089,"Indiana","Lake County",3,23,5995,3007,2988
050,18,089,"Indiana","Lake County",3,24,5864,2970,2894
050,18,089,"Indiana","Lake County",3,25,5870,2976,2894
050,18,089,"Indiana","Lake County",3,26,5969,3049,2920
050,18,089,"Indiana","Lake County",3,27,6062,2965,3097
050,18,089,"Indiana","Lake County",3,28,6239,3055,3184
050,18,089,"Indiana","Lake County",3,29,6349,3099,3250
050,18,089,"Indiana","Lake County",3,30,6378,3096,3282
050,18,089,"Indiana","Lake County",3,31,6352,3082,3270
050,18,089,"Indiana","Lake County",3,32,5988,2930,3058
050,18,089,"Indiana","Lake County",3,33,5859,2873,2986
050,18,089,"Indiana","Lake County",3,34,5899,2817,3082
050,18,089,"Indiana","Lake County",3,35,6174,2992,3182
050,18,089,"Indiana","Lake County",3,36,6366,3115,3251
050,18,089,"Indiana","Lake County",3,37,6315,3090,3225
050,18,089,"Indiana","Lake County",3,38,6552,3196,3356
050,18,089,"Indiana","Lake County",3,39,6674,3250,3424
050,18,089,"Indiana","Lake County",3,40,6802,3304,3498
050,18,089,"Indiana","Lake County",3,41,6838,3318,3520
050,18,089,"Indiana","Lake County",3,42,6437,3107,3330
050,18,089,"Indiana","Lake County",3,43,6377,3123,3254
050,18,089,"Indiana","Lake County",3,44,6327,3126,3201
050,18,089,"Indiana","Lake County",3,45,6107,3023,3084
050,18,089,"Indiana","Lake County",3,46,6140,2950,3190
050,18,089,"Indiana","Lake County",3,47,5973,2897,3076
050,18,089,"Indiana","Lake County",3,48,5889,2847,3042
050,18,089,"Indiana","Lake County",3,49,6165,2999,3166
050,18,089,"Indiana","Lake County",3,50,6569,3189,3380
050,18,089,"Indiana","Lake County",3,51,6465,3142,3323
050,18,089,"Indiana","Lake County",3,52,6052,2973,3079
050,18,089,"Indiana","Lake County",3,53,5952,2899,3053
050,18,089,"Indiana","Lake County",3,54,6032,2898,3134
050,18,089,"Indiana","Lake County",3,55,6224,3024,3200
050,18,089,"Indiana","Lake County",3,56,6517,3228,3289
050,18,089,"Indiana","Lake County",3,57,6752,3322,3430
050,18,089,"Indiana","Lake County",3,58,6644,3168,3476
050,18,089,"Indiana","Lake County",3,59,6776,3227,3549
050,18,089,"Indiana","Lake County",3,60,6859,3299,3560
050,18,089,"Indiana","Lake County",3,61,6884,3353,3531
050,18,089,"Indiana","Lake County",3,62,6841,3265,3576
050,18,089,"Indiana","Lake County",3,63,6898,3287,3611
050,18,089,"Indiana","Lake County",3,64,6700,3225,3475
050,18,089,"Indiana","Lake County",3,65,6410,3066,3344
050,18,089,"Indiana","Lake County",3,66,6294,2994,3300
050,18,089,"Indiana","Lake County",3,67,5909,2799,3110
050,18,089,"Indiana","Lake County",3,68,5492,2550,2942
050,18,089,"Indiana","Lake County",3,69,5296,2507,2789
050,18,089,"Indiana","Lake County",3,70,5097,2393,2704
050,18,089,"Indiana","Lake County",3,71,4909,2303,2606
050,18,089,"Indiana","Lake County",3,72,4672,2169,2503
050,18,089,"Indiana","Lake County",3,73,4435,2044,2391
050,18,089,"Indiana","Lake County",3,74,4552,2070,2482
050,18,089,"Indiana","Lake County",3,75,3136,1387,1749
050,18,089,"Indiana","Lake County",3,76,3002,1332,1670
050,18,089,"Indiana","Lake County",3,77,2837,1213,1624
050,18,089,"Indiana","Lake County",3,78,2931,1251,1680
050,18,089,"Indiana","Lake County",3,79,2594,1089,1505
050,18,089,"Indiana","Lake County",3,80,2340,971,1369
050,18,089,"Indiana","Lake County",3,81,2108,841,1267
050,18,089,"Indiana","Lake County",3,82,1888,753,1135
050,18,089,"Indiana","Lake County",3,83,1852,707,1145
050,18,089,"Indiana","Lake County",3,84,1601,640,961
050,18,089,"Indiana","Lake County",3,85,9546,3295,6251
050,18,089,"Indiana","Lake County",4,0,5514,2797,2717
050,18,089,"Indiana","Lake County",4,1,5381,2687,2694
050,18,089,"Indiana","Lake County",4,2,5891,2968,2923
050,18,089,"Indiana","Lake County",4,3,6040,3066,2974
050,18,089,"Indiana","Lake County",4,4,6012,3035,2977
050,18,089,"Indiana","Lake County",4,5,6045,3090,2955
050,18,089,"Indiana","Lake County",4,6,6319,3242,3077
050,18,089,"Indiana","Lake County",4,7,6447,3269,3178
050,18,089,"Indiana","Lake County",4,8,6463,3341,3122
050,18,089,"Indiana","Lake County",4,9,6444,3325,3119
050,18,089,"Indiana","Lake County",4,10,6439,3301,3138
050,18,089,"Indiana","Lake County",4,11,6516,3325,3191
050,18,089,"Indiana","Lake County",4,12,6799,3405,3394
050,18,089,"Indiana","Lake County",4,13,6969,3586,3383
050,18,089,"Indiana","Lake County",4,14,7173,3698,3475
050,18,089,"Indiana","Lake County",4,15,7280,3734,3546
050,18,089,"Indiana","Lake County",4,16,7217,3706,3511
050,18,089,"Indiana","Lake County",4,17,7067,3647,3420
050,18,089,"Indiana","Lake County",4,18,6417,3372,3045
050,18,089,"Indiana","Lake County",4,19,5493,2866,2627
050,18,089,"Indiana","Lake County",4,20,5638,2900,2738
050,18,089,"Indiana","Lake County",4,21,5974,3010,2964
050,18,089,"Indiana","Lake County",4,22,6131,3036,3095
050,18,089,"Indiana","Lake County",4,23,6047,3037,3010
050,18,089,"Indiana","Lake County",4,24,5850,2992,2858
050,18,089,"Indiana","Lake County",4,25,5783,2930,2853
050,18,089,"Indiana","Lake County",4,26,5831,2921,2910
050,18,089,"Indiana","Lake County",4,27,5890,3008,2882
050,18,089,"Indiana","Lake County",4,28,6063,2976,3087
050,18,089,"Indiana","Lake County",4,29,6336,3080,3256
050,18,089,"Indiana","Lake County",4,30,6378,3092,3286
050,18,089,"Indiana","Lake County",4,31,6440,3105,3335
050,18,089,"Indiana","Lake County",4,32,6485,3176,3309
050,18,089,"Indiana","Lake County",4,33,6031,2944,3087
050,18,089,"Indiana","Lake County",4,34,5925,2907,3018
050,18,089,"Indiana","Lake County",4,35,6010,2868,3142
050,18,089,"Indiana","Lake County",4,36,6282,3029,3253
050,18,089,"Indiana","Lake County",4,37,6423,3131,3292
050,18,089,"Indiana","Lake County",4,38,6364,3121,3243
050,18,089,"Indiana","Lake County",4,39,6558,3218,3340
050,18,089,"Indiana","Lake County",4,40,6720,3279,3441
050,18,089,"Indiana","Lake County",4,41,6816,3347,3469
050,18,089,"Indiana","Lake County",4,42,6869,3348,3521
050,18,089,"Indiana","Lake County",4,43,6450,3113,3337
050,18,089,"Indiana","Lake County",4,44,6398,3135,3263
050,18,089,"Indiana","Lake County",4,45,6323,3120,3203
050,18,089,"Indiana","Lake County",4,46,6141,3035,3106
050,18,089,"Indiana","Lake County",4,47,6154,2954,3200
050,18,089,"Indiana","Lake County",4,48,5946,2869,3077
050,18,089,"Indiana","Lake County",4,49,5868,2857,3011
050,18,089,"Indiana","Lake County",4,50,6181,2998,3183
050,18,089,"Indiana","Lake County",4,51,6573,3199,3374
050,18,089,"Indiana","Lake County",4,52,6456,3146,3310
050,18,089,"Indiana","Lake County",4,53,6028,2934,3094
050,18,089,"Indiana","Lake County",4,54,5848,2843,3005
050,18,089,"Indiana","Lake County",4,55,6038,2918,3120
050,18,089,"Indiana","Lake County",4,56,6197,3013,3184
050,18,089,"Indiana","Lake County",4,57,6386,3153,3233
050,18,089,"Indiana","Lake County",4,58,6684,3278,3406
050,18,089,"Indiana","Lake County",4,59,6539,3119,3420
050,18,089,"Indiana","Lake County",4,60,6677,3152,3525
050,18,089,"Indiana","Lake County",4,61,6776,3248,3528
050,18,089,"Indiana","Lake County",4,62,6761,3282,3479
050,18,089,"Indiana","Lake County",4,63,6685,3170,3515
050,18,089,"Indiana","Lake County",4,64,6746,3187,3559
050,18,089,"Indiana","Lake County",4,65,6585,3146,3439
050,18,089,"Indiana","Lake County",4,66,6270,3006,3264
050,18,089,"Indiana","Lake County",4,67,6178,2922,3256
050,18,089,"Indiana","Lake County",4,68,5743,2701,3042
050,18,089,"Indiana","Lake County",4,69,5372,2462,2910
050,18,089,"Indiana","Lake County",4,70,5179,2437,2742
050,18,089,"Indiana","Lake County",4,71,5004,2341,2663
050,18,089,"Indiana","Lake County",4,72,4754,2215,2539
050,18,089,"Indiana","Lake County",4,73,4541,2116,2425
050,18,089,"Indiana","Lake County",4,74,4311,1992,2319
050,18,089,"Indiana","Lake County",4,75,4379,1960,2419
050,18,089,"Indiana","Lake County",4,76,3011,1330,1681
050,18,089,"Indiana","Lake County",4,77,2836,1242,1594
050,18,089,"Indiana","Lake County",4,78,2707,1161,1546
050,18,089,"Indiana","Lake County",4,79,2783,1154,1629
050,18,089,"Indiana","Lake County",4,80,2416,1009,1407
050,18,089,"Indiana","Lake County",4,81,2210,902,1308
050,18,089,"Indiana","Lake County",4,82,1961,775,1186
050,18,089,"Indiana","Lake County",4,83,1762,684,1078
050,18,089,"Indiana","Lake County",4,84,1666,625,1041
050,18,089,"Indiana","Lake County",4,85,9364,3269,6095
050,18,089,"Indiana","Lake County",5,0,5599,2848,2751
050,18,089,"Indiana","Lake County",5,1,5575,2820,2755
050,18,089,"Indiana","Lake County",5,2,5379,2732,2647
050,18,089,"Indiana","Lake County",5,3,5943,3019,2924
050,18,089,"Indiana","Lake County",5,4,6122,3107,3015
050,18,089,"Indiana","Lake County",5,5,6115,3087,3028
050,18,089,"Indiana","Lake County",5,6,6110,3135,2975
050,18,089,"Indiana","Lake County",5,7,6338,3268,3070
050,18,089,"Indiana","Lake County",5,8,6484,3294,3190
050,18,089,"Indiana","Lake County",5,9,6507,3358,3149
050,18,089,"Indiana","Lake County",5,10,6473,3354,3119
050,18,089,"Indiana","Lake County",5,11,6537,3355,3182
050,18,089,"Indiana","Lake County",5,12,6567,3325,3242
050,18,089,"Indiana","Lake County",5,13,6822,3445,3377
050,18,089,"Indiana","Lake County",5,14,6972,3564,3408
050,18,089,"Indiana","Lake County",5,15,7219,3701,3518
050,18,089,"Indiana","Lake County",5,16,7312,3740,3572
050,18,089,"Indiana","Lake County",5,17,7154,3682,3472
050,18,089,"Indiana","Lake County",5,18,6221,3289,2932
050,18,089,"Indiana","Lake County",5,19,5628,2967,2661
050,18,089,"Indiana","Lake County",5,20,5771,2990,2781
050,18,089,"Indiana","Lake County",5,21,5796,2920,2876
050,18,089,"Indiana","Lake County",5,22,6192,3088,3104
050,18,089,"Indiana","Lake County",5,23,6182,3075,3107
050,18,089,"Indiana","Lake County",5,24,6027,3077,2950
050,18,089,"Indiana","Lake County",5,25,5763,2933,2830
050,18,089,"Indiana","Lake County",5,26,5784,2927,2857
050,18,089,"Indiana","Lake County",5,27,5816,2921,2895
050,18,089,"Indiana","Lake County",5,28,5891,2975,2916
050,18,089,"Indiana","Lake County",5,29,6108,2986,3122
050,18,089,"Indiana","Lake County",5,30,6347,3068,3279
050,18,089,"Indiana","Lake County",5,31,6461,3091,3370
050,18,089,"Indiana","Lake County",5,32,6548,3144,3404
050,18,089,"Indiana","Lake County",5,33,6600,3237,3363
050,18,089,"Indiana","Lake County",5,34,6066,2960,3106
050,18,089,"Indiana","Lake County",5,35,5991,2924,3067
050,18,089,"Indiana","Lake County",5,36,5989,2848,3141
050,18,089,"Indiana","Lake County",5,37,6360,3080,3280
050,18,089,"Indiana","Lake County",5,38,6493,3208,3285
050,18,089,"Indiana","Lake County",5,39,6423,3120,3303
050,18,089,"Indiana","Lake County",5,40,6554,3212,3342
050,18,089,"Indiana","Lake County",5,41,6795,3308,3487
050,18,089,"Indiana","Lake County",5,42,6860,3367,3493
050,18,089,"Indiana","Lake County",5,43,6844,3302,3542
050,18,089,"Indiana","Lake County",5,44,6449,3107,3342
050,18,089,"Indiana","Lake County",5,45,6391,3126,3265
050,18,089,"Indiana","Lake County",5,46,6327,3118,3209
050,18,089,"Indiana","Lake County",5,47,6156,3049,3107
050,18,089,"Indiana","Lake County",5,48,6130,2910,3220
050,18,089,"Indiana","Lake County",5,49,5907,2850,3057
050,18,089,"Indiana","Lake County",5,50,5925,2885,3040
050,18,089,"Indiana","Lake County",5,51,6127,2956,3171
050,18,089,"Indiana","Lake County",5,52,6532,3180,3352
050,18,089,"Indiana","Lake County",5,53,6394,3114,3280
050,18,089,"Indiana","Lake County",5,54,5977,2892,3085
050,18,089,"Indiana","Lake County",5,55,5862,2860,3002
050,18,089,"Indiana","Lake County",5,56,6005,2915,3090
050,18,089,"Indiana","Lake County",5,57,6160,2981,3179
050,18,089,"Indiana","Lake County",5,58,6281,3101,3180
050,18,089,"Indiana","Lake County",5,59,6599,3231,3368
050,18,089,"Indiana","Lake County",5,60,6441,3051,3390
050,18,089,"Indiana","Lake County",5,61,6598,3101,3497
050,18,089,"Indiana","Lake County",5,62,6687,3178,3509
050,18,089,"Indiana","Lake County",5,63,6660,3203,3457
050,18,089,"Indiana","Lake County",5,64,6596,3115,3481
050,18,089,"Indiana","Lake County",5,65,6656,3125,3531
050,18,089,"Indiana","Lake County",5,66,6442,3081,3361
050,18,089,"Indiana","Lake County",5,67,6173,2951,3222
050,18,089,"Indiana","Lake County",5,68,6026,2844,3182
050,18,089,"Indiana","Lake County",5,69,5638,2634,3004
050,18,089,"Indiana","Lake County",5,70,5255,2381,2874
050,18,089,"Indiana","Lake County",5,71,5105,2402,2703
050,18,089,"Indiana","Lake County",5,72,4856,2252,2604
050,18,089,"Indiana","Lake County",5,73,4657,2174,2483
050,18,089,"Indiana","Lake County",5,74,4400,2045,2355
050,18,089,"Indiana","Lake County",5,75,4193,1918,2275
050,18,089,"Indiana","Lake County",5,76,4233,1905,2328
050,18,089,"Indiana","Lake County",5,77,2881,1249,1632
050,18,089,"Indiana","Lake County",5,78,2710,1192,1518
050,18,089,"Indiana","Lake County",5,79,2576,1084,1492
050,18,089,"Indiana","Lake County",5,80,2598,1069,1529
050,18,089,"Indiana","Lake County",5,81,2287,945,1342
050,18,089,"Indiana","Lake County",5,82,2068,842,1226
050,18,089,"Indiana","Lake County",5,83,1887,734,1153
050,18,089,"Indiana","Lake County",5,84,1610,616,994
050,18,089,"Indiana","Lake County",5,85,9405,3287,6118
050,18,091,"Indiana","LaPorte County",1,0,1252,641,611
050,18,091,"Indiana","LaPorte County",1,1,1267,664,603
050,18,091,"Indiana","LaPorte County",1,2,1321,706,615
050,18,091,"Indiana","LaPorte County",1,3,1355,680,675
050,18,091,"Indiana","LaPorte County",1,4,1354,688,666
050,18,091,"Indiana","LaPorte County",1,5,1353,692,661
050,18,091,"Indiana","LaPorte County",1,6,1354,660,694
050,18,091,"Indiana","LaPorte County",1,7,1331,661,670
050,18,091,"Indiana","LaPorte County",1,8,1306,658,648
050,18,091,"Indiana","LaPorte County",1,9,1347,683,664
050,18,091,"Indiana","LaPorte County",1,10,1401,697,704
050,18,091,"Indiana","LaPorte County",1,11,1393,693,700
050,18,091,"Indiana","LaPorte County",1,12,1456,761,695
050,18,091,"Indiana","LaPorte County",1,13,1421,740,681
050,18,091,"Indiana","LaPorte County",1,14,1342,706,636
050,18,091,"Indiana","LaPorte County",1,15,1332,686,646
050,18,091,"Indiana","LaPorte County",1,16,1373,688,685
050,18,091,"Indiana","LaPorte County",1,17,1348,664,684
050,18,091,"Indiana","LaPorte County",1,18,1202,653,549
050,18,091,"Indiana","LaPorte County",1,19,1098,610,488
050,18,091,"Indiana","LaPorte County",1,20,1227,681,546
050,18,091,"Indiana","LaPorte County",1,21,1295,713,582
050,18,091,"Indiana","LaPorte County",1,22,1386,781,605
050,18,091,"Indiana","LaPorte County",1,23,1456,806,650
050,18,091,"Indiana","LaPorte County",1,24,1373,765,608
050,18,091,"Indiana","LaPorte County",1,25,1389,799,590
050,18,091,"Indiana","LaPorte County",1,26,1456,845,611
050,18,091,"Indiana","LaPorte County",1,27,1553,893,660
050,18,091,"Indiana","LaPorte County",1,28,1564,871,693
050,18,091,"Indiana","LaPorte County",1,29,1572,882,690
050,18,091,"Indiana","LaPorte County",1,30,1566,909,657
050,18,091,"Indiana","LaPorte County",1,31,1496,821,675
050,18,091,"Indiana","LaPorte County",1,32,1390,757,633
050,18,091,"Indiana","LaPorte County",1,33,1358,785,573
050,18,091,"Indiana","LaPorte County",1,34,1374,780,594
050,18,091,"Indiana","LaPorte County",1,35,1404,789,615
050,18,091,"Indiana","LaPorte County",1,36,1377,762,615
050,18,091,"Indiana","LaPorte County",1,37,1431,811,620
050,18,091,"Indiana","LaPorte County",1,38,1430,824,606
050,18,091,"Indiana","LaPorte County",1,39,1395,756,639
050,18,091,"Indiana","LaPorte County",1,40,1431,788,643
050,18,091,"Indiana","LaPorte County",1,41,1384,761,623
050,18,091,"Indiana","LaPorte County",1,42,1362,750,612
050,18,091,"Indiana","LaPorte County",1,43,1276,676,600
050,18,091,"Indiana","LaPorte County",1,44,1239,660,579
050,18,091,"Indiana","LaPorte County",1,45,1291,729,562
050,18,091,"Indiana","LaPorte County",1,46,1242,691,551
050,18,091,"Indiana","LaPorte County",1,47,1359,734,625
050,18,091,"Indiana","LaPorte County",1,48,1484,795,689
050,18,091,"Indiana","LaPorte County",1,49,1563,831,732
050,18,091,"Indiana","LaPorte County",1,50,1430,732,698
050,18,091,"Indiana","LaPorte County",1,51,1386,724,662
050,18,091,"Indiana","LaPorte County",1,52,1407,737,670
050,18,091,"Indiana","LaPorte County",1,53,1449,758,691
050,18,091,"Indiana","LaPorte County",1,54,1532,791,741
050,18,091,"Indiana","LaPorte County",1,55,1576,792,784
050,18,091,"Indiana","LaPorte County",1,56,1550,791,759
050,18,091,"Indiana","LaPorte County",1,57,1560,789,771
050,18,091,"Indiana","LaPorte County",1,58,1600,810,790
050,18,091,"Indiana","LaPorte County",1,59,1643,824,819
050,18,091,"Indiana","LaPorte County",1,60,1616,827,789
050,18,091,"Indiana","LaPorte County",1,61,1586,818,768
050,18,091,"Indiana","LaPorte County",1,62,1586,788,798
050,18,091,"Indiana","LaPorte County",1,63,1550,772,778
050,18,091,"Indiana","LaPorte County",1,64,1515,737,778
050,18,091,"Indiana","LaPorte County",1,65,1456,727,729
050,18,091,"Indiana","LaPorte County",1,66,1476,727,749
050,18,091,"Indiana","LaPorte County",1,67,1431,718,713
050,18,091,"Indiana","LaPorte County",1,68,1433,698,735
050,18,091,"Indiana","LaPorte County",1,69,1258,589,669
050,18,091,"Indiana","LaPorte County",1,70,1192,549,643
050,18,091,"Indiana","LaPorte County",1,71,1179,574,605
050,18,091,"Indiana","LaPorte County",1,72,1188,542,646
050,18,091,"Indiana","LaPorte County",1,73,1190,548,642
050,18,091,"Indiana","LaPorte County",1,74,824,403,421
050,18,091,"Indiana","LaPorte County",1,75,831,387,444
050,18,091,"Indiana","LaPorte County",1,76,815,376,439
050,18,091,"Indiana","LaPorte County",1,77,783,364,419
050,18,091,"Indiana","LaPorte County",1,78,656,297,359
050,18,091,"Indiana","LaPorte County",1,79,612,263,349
050,18,091,"Indiana","LaPorte County",1,80,534,222,312
050,18,091,"Indiana","LaPorte County",1,81,516,203,313
050,18,091,"Indiana","LaPorte County",1,82,445,199,246
050,18,091,"Indiana","LaPorte County",1,83,370,155,215
050,18,091,"Indiana","LaPorte County",1,84,357,138,219
050,18,091,"Indiana","LaPorte County",1,85,2143,676,1467
050,18,091,"Indiana","LaPorte County",2,0,1228,640,588
050,18,091,"Indiana","LaPorte County",2,1,1256,655,601
050,18,091,"Indiana","LaPorte County",2,2,1311,696,615
050,18,091,"Indiana","LaPorte County",2,3,1340,682,658
050,18,091,"Indiana","LaPorte County",2,4,1354,686,668
050,18,091,"Indiana","LaPorte County",2,5,1350,690,660
050,18,091,"Indiana","LaPorte County",2,6,1355,672,683
050,18,091,"Indiana","LaPorte County",2,7,1334,659,675
050,18,091,"Indiana","LaPorte County",2,8,1314,663,651
050,18,091,"Indiana","LaPorte County",2,9,1335,676,659
050,18,091,"Indiana","LaPorte County",2,10,1388,692,696
050,18,091,"Indiana","LaPorte County",2,11,1394,692,702
050,18,091,"Indiana","LaPorte County",2,12,1447,748,699
050,18,091,"Indiana","LaPorte County",2,13,1425,744,681
050,18,091,"Indiana","LaPorte County",2,14,1360,712,648
050,18,091,"Indiana","LaPorte County",2,15,1338,694,644
050,18,091,"Indiana","LaPorte County",2,16,1367,688,679
050,18,091,"Indiana","LaPorte County",2,17,1362,675,687
050,18,091,"Indiana","LaPorte County",2,18,1191,636,555
050,18,091,"Indiana","LaPorte County",2,19,1093,610,483
050,18,091,"Indiana","LaPorte County",2,20,1242,696,546
050,18,091,"Indiana","LaPorte County",2,21,1289,710,579
050,18,091,"Indiana","LaPorte County",2,22,1372,768,604
050,18,091,"Indiana","LaPorte County",2,23,1451,809,642
050,18,091,"Indiana","LaPorte County",2,24,1384,770,614
050,18,091,"Indiana","LaPorte County",2,25,1392,799,593
050,18,091,"Indiana","LaPorte County",2,26,1438,832,606
050,18,091,"Indiana","LaPorte County",2,27,1529,885,644
050,18,091,"Indiana","LaPorte County",2,28,1559,875,684
050,18,091,"Indiana","LaPorte County",2,29,1565,876,689
050,18,091,"Indiana","LaPorte County",2,30,1585,912,673
050,18,091,"Indiana","LaPorte County",2,31,1501,828,673
050,18,091,"Indiana","LaPorte County",2,32,1410,769,641
050,18,091,"Indiana","LaPorte County",2,33,1354,771,583
050,18,091,"Indiana","LaPorte County",2,34,1369,786,583
050,18,091,"Indiana","LaPorte County",2,35,1394,781,613
050,18,091,"Indiana","LaPorte County",2,36,1373,762,611
050,18,091,"Indiana","LaPorte County",2,37,1414,798,616
050,18,091,"Indiana","LaPorte County",2,38,1427,817,610
050,18,091,"Indiana","LaPorte County",2,39,1401,773,628
050,18,091,"Indiana","LaPorte County",2,40,1428,781,647
050,18,091,"Indiana","LaPorte County",2,41,1390,766,624
050,18,091,"Indiana","LaPorte County",2,42,1360,750,610
050,18,091,"Indiana","LaPorte County",2,43,1299,693,606
050,18,091,"Indiana","LaPorte County",2,44,1236,657,579
050,18,091,"Indiana","LaPorte County",2,45,1285,718,567
050,18,091,"Indiana","LaPorte County",2,46,1249,699,550
050,18,091,"Indiana","LaPorte County",2,47,1321,718,603
050,18,091,"Indiana","LaPorte County",2,48,1448,776,672
050,18,091,"Indiana","LaPorte County",2,49,1552,829,723
050,18,091,"Indiana","LaPorte County",2,50,1455,745,710
050,18,091,"Indiana","LaPorte County",2,51,1387,721,666
050,18,091,"Indiana","LaPorte County",2,52,1399,733,666
050,18,091,"Indiana","LaPorte County",2,53,1436,752,684
050,18,091,"Indiana","LaPorte County",2,54,1507,781,726
050,18,091,"Indiana","LaPorte County",2,55,1567,793,774
050,18,091,"Indiana","LaPorte County",2,56,1557,788,769
050,18,091,"Indiana","LaPorte County",2,57,1560,789,771
050,18,091,"Indiana","LaPorte County",2,58,1590,803,787
050,18,091,"Indiana","LaPorte County",2,59,1636,824,812
050,18,091,"Indiana","LaPorte County",2,60,1612,821,791
050,18,091,"Indiana","LaPorte County",2,61,1580,808,772
050,18,091,"Indiana","LaPorte County",2,62,1575,791,784
050,18,091,"Indiana","LaPorte County",2,63,1557,771,786
050,18,091,"Indiana","LaPorte County",2,64,1511,740,771
050,18,091,"Indiana","LaPorte County",2,65,1466,725,741
050,18,091,"Indiana","LaPorte County",2,66,1467,722,745
050,18,091,"Indiana","LaPorte County",2,67,1425,706,719
050,18,091,"Indiana","LaPorte County",2,68,1422,700,722
050,18,091,"Indiana","LaPorte County",2,69,1306,620,686
050,18,091,"Indiana","LaPorte County",2,70,1190,549,641
050,18,091,"Indiana","LaPorte County",2,71,1177,564,613
050,18,091,"Indiana","LaPorte County",2,72,1156,534,622
050,18,091,"Indiana","LaPorte County",2,73,1235,565,670
050,18,091,"Indiana","LaPorte County",2,74,851,405,446
050,18,091,"Indiana","LaPorte County",2,75,827,392,435
050,18,091,"Indiana","LaPorte County",2,76,802,370,432
050,18,091,"Indiana","LaPorte County",2,77,802,374,428
050,18,091,"Indiana","LaPorte County",2,78,666,303,363
050,18,091,"Indiana","LaPorte County",2,79,612,267,345
050,18,091,"Indiana","LaPorte County",2,80,545,226,319
050,18,091,"Indiana","LaPorte County",2,81,511,202,309
050,18,091,"Indiana","LaPorte County",2,82,451,196,255
050,18,091,"Indiana","LaPorte County",2,83,376,161,215
050,18,091,"Indiana","LaPorte County",2,84,358,140,218
050,18,091,"Indiana","LaPorte County",2,85,2137,678,1459
050,18,091,"Indiana","LaPorte County",3,0,1105,602,503
050,18,091,"Indiana","LaPorte County",3,1,1210,632,578
050,18,091,"Indiana","LaPorte County",3,2,1272,670,602
050,18,091,"Indiana","LaPorte County",3,3,1321,692,629
050,18,091,"Indiana","LaPorte County",3,4,1336,690,646
050,18,091,"Indiana","LaPorte County",3,5,1362,692,670
050,18,091,"Indiana","LaPorte County",3,6,1339,689,650
050,18,091,"Indiana","LaPorte County",3,7,1375,674,701
050,18,091,"Indiana","LaPorte County",3,8,1347,654,693
050,18,091,"Indiana","LaPorte County",3,9,1319,656,663
050,18,091,"Indiana","LaPorte County",3,10,1323,667,656
050,18,091,"Indiana","LaPorte County",3,11,1377,696,681
050,18,091,"Indiana","LaPorte County",3,12,1379,694,685
050,18,091,"Indiana","LaPorte County",3,13,1459,754,705
050,18,091,"Indiana","LaPorte County",3,14,1434,743,691
050,18,091,"Indiana","LaPorte County",3,15,1356,696,660
050,18,091,"Indiana","LaPorte County",3,16,1337,697,640
050,18,091,"Indiana","LaPorte County",3,17,1358,689,669
050,18,091,"Indiana","LaPorte County",3,18,1188,613,575
050,18,091,"Indiana","LaPorte County",3,19,1045,596,449
050,18,091,"Indiana","LaPorte County",3,20,1256,722,534
050,18,091,"Indiana","LaPorte County",3,21,1313,727,586
050,18,091,"Indiana","LaPorte County",3,22,1386,760,626
050,18,091,"Indiana","LaPorte County",3,23,1416,813,603
050,18,091,"Indiana","LaPorte County",3,24,1458,819,639
050,18,091,"Indiana","LaPorte County",3,25,1455,826,629
050,18,091,"Indiana","LaPorte County",3,26,1408,800,608
050,18,091,"Indiana","LaPorte County",3,27,1474,861,613
050,18,091,"Indiana","LaPorte County",3,28,1524,875,649
050,18,091,"Indiana","LaPorte County",3,29,1600,900,700
050,18,091,"Indiana","LaPorte County",3,30,1600,905,695
050,18,091,"Indiana","LaPorte County",3,31,1565,902,663
050,18,091,"Indiana","LaPorte County",3,32,1484,808,676
050,18,091,"Indiana","LaPorte County",3,33,1419,781,638
050,18,091,"Indiana","LaPorte County",3,34,1390,793,597
050,18,091,"Indiana","LaPorte County",3,35,1363,778,585
050,18,091,"Indiana","LaPorte County",3,36,1397,799,598
050,18,091,"Indiana","LaPorte County",3,37,1386,769,617
050,18,091,"Indiana","LaPorte County",3,38,1414,805,609
050,18,091,"Indiana","LaPorte County",3,39,1431,827,604
050,18,091,"Indiana","LaPorte County",3,40,1405,753,652
050,18,091,"Indiana","LaPorte County",3,41,1421,783,638
050,18,091,"Indiana","LaPorte County",3,42,1442,805,637
050,18,091,"Indiana","LaPorte County",3,43,1351,740,611
050,18,091,"Indiana","LaPorte County",3,44,1286,683,603
050,18,091,"Indiana","LaPorte County",3,45,1248,667,581
050,18,091,"Indiana","LaPorte County",3,46,1299,734,565
050,18,091,"Indiana","LaPorte County",3,47,1229,680,549
050,18,091,"Indiana","LaPorte County",3,48,1303,693,610
050,18,091,"Indiana","LaPorte County",3,49,1473,814,659
050,18,091,"Indiana","LaPorte County",3,50,1518,788,730
050,18,091,"Indiana","LaPorte County",3,51,1457,745,712
050,18,091,"Indiana","LaPorte County",3,52,1383,723,660
050,18,091,"Indiana","LaPorte County",3,53,1381,728,653
050,18,091,"Indiana","LaPorte County",3,54,1437,758,679
050,18,091,"Indiana","LaPorte County",3,55,1513,778,735
050,18,091,"Indiana","LaPorte County",3,56,1552,769,783
050,18,091,"Indiana","LaPorte County",3,57,1569,801,768
050,18,091,"Indiana","LaPorte County",3,58,1574,793,781
050,18,091,"Indiana","LaPorte County",3,59,1567,786,781
050,18,091,"Indiana","LaPorte County",3,60,1627,822,805
050,18,091,"Indiana","LaPorte County",3,61,1585,796,789
050,18,091,"Indiana","LaPorte County",3,62,1595,825,770
050,18,091,"Indiana","LaPorte County",3,63,1543,774,769
050,18,091,"Indiana","LaPorte County",3,64,1512,754,758
050,18,091,"Indiana","LaPorte County",3,65,1517,752,765
050,18,091,"Indiana","LaPorte County",3,66,1450,712,738
050,18,091,"Indiana","LaPorte County",3,67,1419,679,740
050,18,091,"Indiana","LaPorte County",3,68,1405,698,707
050,18,091,"Indiana","LaPorte County",3,69,1372,671,701
050,18,091,"Indiana","LaPorte County",3,70,1284,604,680
050,18,091,"Indiana","LaPorte County",3,71,1178,552,626
050,18,091,"Indiana","LaPorte County",3,72,1147,540,607
050,18,091,"Indiana","LaPorte County",3,73,1119,515,604
050,18,091,"Indiana","LaPorte County",3,74,1199,540,659
050,18,091,"Indiana","LaPorte County",3,75,820,390,430
050,18,091,"Indiana","LaPorte County",3,76,789,370,419
050,18,091,"Indiana","LaPorte County",3,77,774,359,415
050,18,091,"Indiana","LaPorte County",3,78,741,343,398
050,18,091,"Indiana","LaPorte County",3,79,632,284,348
050,18,091,"Indiana","LaPorte County",3,80,571,248,323
050,18,091,"Indiana","LaPorte County",3,81,529,211,318
050,18,091,"Indiana","LaPorte County",3,82,461,180,281
050,18,091,"Indiana","LaPorte County",3,83,405,172,233
050,18,091,"Indiana","LaPorte County",3,84,356,147,209
050,18,091,"Indiana","LaPorte County",3,85,2094,682,1412
050,18,091,"Indiana","LaPorte County",4,0,1176,615,561
050,18,091,"Indiana","LaPorte County",4,1,1088,592,496
050,18,091,"Indiana","LaPorte County",4,2,1178,610,568
050,18,091,"Indiana","LaPorte County",4,3,1266,664,602
050,18,091,"Indiana","LaPorte County",4,4,1300,687,613
050,18,091,"Indiana","LaPorte County",4,5,1317,682,635
050,18,091,"Indiana","LaPorte County",4,6,1357,684,673
050,18,091,"Indiana","LaPorte County",4,7,1332,693,639
050,18,091,"Indiana","LaPorte County",4,8,1377,682,695
050,18,091,"Indiana","LaPorte County",4,9,1314,646,668
050,18,091,"Indiana","LaPorte County",4,10,1319,661,658
050,18,091,"Indiana","LaPorte County",4,11,1328,660,668
050,18,091,"Indiana","LaPorte County",4,12,1391,708,683
050,18,091,"Indiana","LaPorte County",4,13,1399,703,696
050,18,091,"Indiana","LaPorte County",4,14,1456,757,699
050,18,091,"Indiana","LaPorte County",4,15,1427,739,688
050,18,091,"Indiana","LaPorte County",4,16,1337,693,644
050,18,091,"Indiana","LaPorte County",4,17,1333,705,628
050,18,091,"Indiana","LaPorte County",4,18,1169,623,546
050,18,091,"Indiana","LaPorte County",4,19,1017,557,460
050,18,091,"Indiana","LaPorte County",4,20,1167,674,493
050,18,091,"Indiana","LaPorte County",4,21,1293,727,566
050,18,091,"Indiana","LaPorte County",4,22,1360,747,613
050,18,091,"Indiana","LaPorte County",4,23,1420,783,637
050,18,091,"Indiana","LaPorte County",4,24,1412,805,607
050,18,091,"Indiana","LaPorte County",4,25,1433,826,607
050,18,091,"Indiana","LaPorte County",4,26,1428,799,629
050,18,091,"Indiana","LaPorte County",4,27,1403,810,593
050,18,091,"Indiana","LaPorte County",4,28,1460,860,600
050,18,091,"Indiana","LaPorte County",4,29,1499,865,634
050,18,091,"Indiana","LaPorte County",4,30,1601,930,671
050,18,091,"Indiana","LaPorte County",4,31,1567,859,708
050,18,091,"Indiana","LaPorte County",4,32,1542,877,665
050,18,091,"Indiana","LaPorte County",4,33,1455,803,652
050,18,091,"Indiana","LaPorte County",4,34,1406,768,638
050,18,091,"Indiana","LaPorte County",4,35,1350,752,598
050,18,091,"Indiana","LaPorte County",4,36,1380,789,591
050,18,091,"Indiana","LaPorte County",4,37,1388,784,604
050,18,091,"Indiana","LaPorte County",4,38,1377,746,631
050,18,091,"Indiana","LaPorte County",4,39,1431,824,607
050,18,091,"Indiana","LaPorte County",4,40,1400,808,592
050,18,091,"Indiana","LaPorte County",4,41,1425,767,658
050,18,091,"Indiana","LaPorte County",4,42,1426,788,638
050,18,091,"Indiana","LaPorte County",4,43,1408,771,637
050,18,091,"Indiana","LaPorte County",4,44,1355,728,627
050,18,091,"Indiana","LaPorte County",4,45,1263,660,603
050,18,091,"Indiana","LaPorte County",4,46,1232,663,569
050,18,091,"Indiana","LaPorte County",4,47,1302,727,575
050,18,091,"Indiana","LaPorte County",4,48,1223,672,551
050,18,091,"Indiana","LaPorte County",4,49,1302,706,596
050,18,091,"Indiana","LaPorte County",4,50,1427,756,671
050,18,091,"Indiana","LaPorte County",4,51,1505,781,724
050,18,091,"Indiana","LaPorte County",4,52,1432,731,701
050,18,091,"Indiana","LaPorte County",4,53,1369,719,650
050,18,091,"Indiana","LaPorte County",4,54,1381,724,657
050,18,091,"Indiana","LaPorte County",4,55,1451,761,690
050,18,091,"Indiana","LaPorte County",4,56,1468,740,728
050,18,091,"Indiana","LaPorte County",4,57,1527,747,780
050,18,091,"Indiana","LaPorte County",4,58,1579,798,781
050,18,091,"Indiana","LaPorte County",4,59,1552,778,774
050,18,091,"Indiana","LaPorte County",4,60,1544,767,777
050,18,091,"Indiana","LaPorte County",4,61,1607,809,798
050,18,091,"Indiana","LaPorte County",4,62,1564,787,777
050,18,091,"Indiana","LaPorte County",4,63,1563,802,761
050,18,091,"Indiana","LaPorte County",4,64,1509,751,758
050,18,091,"Indiana","LaPorte County",4,65,1498,755,743
050,18,091,"Indiana","LaPorte County",4,66,1506,741,765
050,18,091,"Indiana","LaPorte County",4,67,1403,685,718
050,18,091,"Indiana","LaPorte County",4,68,1384,667,717
050,18,091,"Indiana","LaPorte County",4,69,1357,671,686
050,18,091,"Indiana","LaPorte County",4,70,1352,651,701
050,18,091,"Indiana","LaPorte County",4,71,1266,604,662
050,18,091,"Indiana","LaPorte County",4,72,1159,537,622
050,18,091,"Indiana","LaPorte County",4,73,1109,519,590
050,18,091,"Indiana","LaPorte County",4,74,1093,496,597
050,18,091,"Indiana","LaPorte County",4,75,1164,521,643
050,18,091,"Indiana","LaPorte County",4,76,786,375,411
050,18,091,"Indiana","LaPorte County",4,77,751,357,394
050,18,091,"Indiana","LaPorte County",4,78,727,324,403
050,18,091,"Indiana","LaPorte County",4,79,693,324,369
050,18,091,"Indiana","LaPorte County",4,80,611,275,336
050,18,091,"Indiana","LaPorte County",4,81,530,223,307
050,18,091,"Indiana","LaPorte County",4,82,491,197,294
050,18,091,"Indiana","LaPorte County",4,83,431,165,266
050,18,091,"Indiana","LaPorte County",4,84,376,158,218
050,18,091,"Indiana","LaPorte County",4,85,2068,689,1379
050,18,091,"Indiana","LaPorte County",5,0,1171,616,555
050,18,091,"Indiana","LaPorte County",5,1,1188,609,579
050,18,091,"Indiana","LaPorte County",5,2,1100,596,504
050,18,091,"Indiana","LaPorte County",5,3,1178,619,559
050,18,091,"Indiana","LaPorte County",5,4,1263,658,605
050,18,091,"Indiana","LaPorte County",5,5,1287,689,598
050,18,091,"Indiana","LaPorte County",5,6,1295,677,618
050,18,091,"Indiana","LaPorte County",5,7,1365,681,684
050,18,091,"Indiana","LaPorte County",5,8,1353,697,656
050,18,091,"Indiana","LaPorte County",5,9,1354,670,684
050,18,091,"Indiana","LaPorte County",5,10,1327,649,678
050,18,091,"Indiana","LaPorte County",5,11,1344,678,666
050,18,091,"Indiana","LaPorte County",5,12,1329,656,673
050,18,091,"Indiana","LaPorte County",5,13,1396,705,691
050,18,091,"Indiana","LaPorte County",5,14,1375,697,678
050,18,091,"Indiana","LaPorte County",5,15,1449,757,692
050,18,091,"Indiana","LaPorte County",5,16,1417,739,678
050,18,091,"Indiana","LaPorte County",5,17,1349,685,664
050,18,091,"Indiana","LaPorte County",5,18,1146,627,519
050,18,091,"Indiana","LaPorte County",5,19,1011,561,450
050,18,091,"Indiana","LaPorte County",5,20,1147,651,496
050,18,091,"Indiana","LaPorte County",5,21,1205,679,526
050,18,091,"Indiana","LaPorte County",5,22,1352,768,584
050,18,091,"Indiana","LaPorte County",5,23,1432,785,647
050,18,091,"Indiana","LaPorte County",5,24,1431,792,639
050,18,091,"Indiana","LaPorte County",5,25,1431,815,616
050,18,091,"Indiana","LaPorte County",5,26,1423,812,611
050,18,091,"Indiana","LaPorte County",5,27,1449,811,638
050,18,091,"Indiana","LaPorte County",5,28,1370,785,585
050,18,091,"Indiana","LaPorte County",5,29,1474,869,605
050,18,091,"Indiana","LaPorte County",5,30,1549,911,638
050,18,091,"Indiana","LaPorte County",5,31,1577,904,673
050,18,091,"Indiana","LaPorte County",5,32,1544,853,691
050,18,091,"Indiana","LaPorte County",5,33,1524,851,673
050,18,091,"Indiana","LaPorte County",5,34,1494,832,662
050,18,091,"Indiana","LaPorte County",5,35,1371,731,640
050,18,091,"Indiana","LaPorte County",5,36,1369,764,605
050,18,091,"Indiana","LaPorte County",5,37,1375,778,597
050,18,091,"Indiana","LaPorte County",5,38,1350,743,607
050,18,091,"Indiana","LaPorte County",5,39,1386,760,626
050,18,091,"Indiana","LaPorte County",5,40,1398,799,599
050,18,091,"Indiana","LaPorte County",5,41,1392,811,581
050,18,091,"Indiana","LaPorte County",5,42,1414,778,636
050,18,091,"Indiana","LaPorte County",5,43,1404,766,638
050,18,091,"Indiana","LaPorte County",5,44,1391,752,639
050,18,091,"Indiana","LaPorte County",5,45,1340,716,624
050,18,091,"Indiana","LaPorte County",5,46,1263,660,603
050,18,091,"Indiana","LaPorte County",5,47,1242,652,590
050,18,091,"Indiana","LaPorte County",5,48,1294,719,575
050,18,091,"Indiana","LaPorte County",5,49,1239,689,550
050,18,091,"Indiana","LaPorte County",5,50,1286,686,600
050,18,091,"Indiana","LaPorte County",5,51,1412,762,650
050,18,091,"Indiana","LaPorte County",5,52,1488,766,722
050,18,091,"Indiana","LaPorte County",5,53,1418,732,686
050,18,091,"Indiana","LaPorte County",5,54,1353,702,651
050,18,091,"Indiana","LaPorte County",5,55,1408,739,669
050,18,091,"Indiana","LaPorte County",5,56,1411,727,684
050,18,091,"Indiana","LaPorte County",5,57,1438,718,720
050,18,091,"Indiana","LaPorte County",5,58,1531,739,792
050,18,091,"Indiana","LaPorte County",5,59,1563,782,781
050,18,091,"Indiana","LaPorte County",5,60,1537,768,769
050,18,091,"Indiana","LaPorte County",5,61,1522,757,765
050,18,091,"Indiana","LaPorte County",5,62,1599,803,796
050,18,091,"Indiana","LaPorte County",5,63,1538,772,766
050,18,091,"Indiana","LaPorte County",5,64,1532,775,757
050,18,091,"Indiana","LaPorte County",5,65,1505,756,749
050,18,091,"Indiana","LaPorte County",5,66,1489,747,742
050,18,091,"Indiana","LaPorte County",5,67,1464,710,754
050,18,091,"Indiana","LaPorte County",5,68,1380,673,707
050,18,091,"Indiana","LaPorte County",5,69,1358,648,710
050,18,091,"Indiana","LaPorte County",5,70,1334,651,683
050,18,091,"Indiana","LaPorte County",5,71,1329,649,680
050,18,091,"Indiana","LaPorte County",5,72,1227,577,650
050,18,091,"Indiana","LaPorte County",5,73,1126,518,608
050,18,091,"Indiana","LaPorte County",5,74,1090,501,589
050,18,091,"Indiana","LaPorte County",5,75,1056,479,577
050,18,091,"Indiana","LaPorte County",5,76,1134,496,638
050,18,091,"Indiana","LaPorte County",5,77,762,366,396
050,18,091,"Indiana","LaPorte County",5,78,712,335,377
050,18,091,"Indiana","LaPorte County",5,79,696,310,386
050,18,091,"Indiana","LaPorte County",5,80,660,312,348
050,18,091,"Indiana","LaPorte County",5,81,575,251,324
050,18,091,"Indiana","LaPorte County",5,82,487,204,283
050,18,091,"Indiana","LaPorte County",5,83,442,176,266
050,18,091,"Indiana","LaPorte County",5,84,405,151,254
050,18,091,"Indiana","LaPorte County",5,85,2112,720,1392
050,18,093,"Indiana","Lawrence County",1,0,503,258,245
050,18,093,"Indiana","Lawrence County",1,1,519,257,262
050,18,093,"Indiana","Lawrence County",1,2,499,248,251
050,18,093,"Indiana","Lawrence County",1,3,513,274,239
050,18,093,"Indiana","Lawrence County",1,4,489,254,235
050,18,093,"Indiana","Lawrence County",1,5,511,253,258
050,18,093,"Indiana","Lawrence County",1,6,499,255,244
050,18,093,"Indiana","Lawrence County",1,7,506,261,245
050,18,093,"Indiana","Lawrence County",1,8,495,271,224
050,18,093,"Indiana","Lawrence County",1,9,490,256,234
050,18,093,"Indiana","Lawrence County",1,10,543,273,270
050,18,093,"Indiana","Lawrence County",1,11,542,278,264
050,18,093,"Indiana","Lawrence County",1,12,569,307,262
050,18,093,"Indiana","Lawrence County",1,13,630,347,283
050,18,093,"Indiana","Lawrence County",1,14,634,333,301
050,18,093,"Indiana","Lawrence County",1,15,625,337,288
050,18,093,"Indiana","Lawrence County",1,16,600,300,300
050,18,093,"Indiana","Lawrence County",1,17,625,297,328
050,18,093,"Indiana","Lawrence County",1,18,508,257,251
050,18,093,"Indiana","Lawrence County",1,19,409,215,194
050,18,093,"Indiana","Lawrence County",1,20,440,233,207
050,18,093,"Indiana","Lawrence County",1,21,464,252,212
050,18,093,"Indiana","Lawrence County",1,22,513,279,234
050,18,093,"Indiana","Lawrence County",1,23,521,278,243
050,18,093,"Indiana","Lawrence County",1,24,486,260,226
050,18,093,"Indiana","Lawrence County",1,25,511,267,244
050,18,093,"Indiana","Lawrence County",1,26,500,253,247
050,18,093,"Indiana","Lawrence County",1,27,524,273,251
050,18,093,"Indiana","Lawrence County",1,28,501,261,240
050,18,093,"Indiana","Lawrence County",1,29,506,254,252
050,18,093,"Indiana","Lawrence County",1,30,522,272,250
050,18,093,"Indiana","Lawrence County",1,31,488,264,224
050,18,093,"Indiana","Lawrence County",1,32,489,246,243
050,18,093,"Indiana","Lawrence County",1,33,475,245,230
050,18,093,"Indiana","Lawrence County",1,34,491,245,246
050,18,093,"Indiana","Lawrence County",1,35,511,245,266
050,18,093,"Indiana","Lawrence County",1,36,533,268,265
050,18,093,"Indiana","Lawrence County",1,37,541,268,273
050,18,093,"Indiana","Lawrence County",1,38,534,258,276
050,18,093,"Indiana","Lawrence County",1,39,515,243,272
050,18,093,"Indiana","Lawrence County",1,40,551,257,294
050,18,093,"Indiana","Lawrence County",1,41,533,258,275
050,18,093,"Indiana","Lawrence County",1,42,555,287,268
050,18,093,"Indiana","Lawrence County",1,43,543,281,262
050,18,093,"Indiana","Lawrence County",1,44,527,271,256
050,18,093,"Indiana","Lawrence County",1,45,519,266,253
050,18,093,"Indiana","Lawrence County",1,46,560,283,277
050,18,093,"Indiana","Lawrence County",1,47,561,292,269
050,18,093,"Indiana","Lawrence County",1,48,615,335,280
050,18,093,"Indiana","Lawrence County",1,49,631,345,286
050,18,093,"Indiana","Lawrence County",1,50,610,320,290
050,18,093,"Indiana","Lawrence County",1,51,597,317,280
050,18,093,"Indiana","Lawrence County",1,52,584,307,277
050,18,093,"Indiana","Lawrence County",1,53,605,297,308
050,18,093,"Indiana","Lawrence County",1,54,634,315,319
050,18,093,"Indiana","Lawrence County",1,55,676,312,364
050,18,093,"Indiana","Lawrence County",1,56,681,336,345
050,18,093,"Indiana","Lawrence County",1,57,669,319,350
050,18,093,"Indiana","Lawrence County",1,58,671,322,349
050,18,093,"Indiana","Lawrence County",1,59,662,338,324
050,18,093,"Indiana","Lawrence County",1,60,660,333,327
050,18,093,"Indiana","Lawrence County",1,61,647,324,323
050,18,093,"Indiana","Lawrence County",1,62,659,337,322
050,18,093,"Indiana","Lawrence County",1,63,640,318,322
050,18,093,"Indiana","Lawrence County",1,64,607,299,308
050,18,093,"Indiana","Lawrence County",1,65,602,283,319
050,18,093,"Indiana","Lawrence County",1,66,592,293,299
050,18,093,"Indiana","Lawrence County",1,67,576,284,292
050,18,093,"Indiana","Lawrence County",1,68,592,293,299
050,18,093,"Indiana","Lawrence County",1,69,534,267,267
050,18,093,"Indiana","Lawrence County",1,70,537,265,272
050,18,093,"Indiana","Lawrence County",1,71,501,238,263
050,18,093,"Indiana","Lawrence County",1,72,535,264,271
050,18,093,"Indiana","Lawrence County",1,73,525,251,274
050,18,093,"Indiana","Lawrence County",1,74,374,171,203
050,18,093,"Indiana","Lawrence County",1,75,356,164,192
050,18,093,"Indiana","Lawrence County",1,76,357,151,206
050,18,093,"Indiana","Lawrence County",1,77,384,171,213
050,18,093,"Indiana","Lawrence County",1,78,303,128,175
050,18,093,"Indiana","Lawrence County",1,79,267,108,159
050,18,093,"Indiana","Lawrence County",1,80,252,119,133
050,18,093,"Indiana","Lawrence County",1,81,236,112,124
050,18,093,"Indiana","Lawrence County",1,82,213,86,127
050,18,093,"Indiana","Lawrence County",1,83,185,84,101
050,18,093,"Indiana","Lawrence County",1,84,177,76,101
050,18,093,"Indiana","Lawrence County",1,85,946,320,626
050,18,093,"Indiana","Lawrence County",2,0,484,249,235
050,18,093,"Indiana","Lawrence County",2,1,514,255,259
050,18,093,"Indiana","Lawrence County",2,2,503,251,252
050,18,093,"Indiana","Lawrence County",2,3,508,268,240
050,18,093,"Indiana","Lawrence County",2,4,498,262,236
050,18,093,"Indiana","Lawrence County",2,5,506,252,254
050,18,093,"Indiana","Lawrence County",2,6,505,257,248
050,18,093,"Indiana","Lawrence County",2,7,503,258,245
050,18,093,"Indiana","Lawrence County",2,8,495,265,230
050,18,093,"Indiana","Lawrence County",2,9,491,259,232
050,18,093,"Indiana","Lawrence County",2,10,534,270,264
050,18,093,"Indiana","Lawrence County",2,11,541,276,265
050,18,093,"Indiana","Lawrence County",2,12,566,301,265
050,18,093,"Indiana","Lawrence County",2,13,613,336,277
050,18,093,"Indiana","Lawrence County",2,14,636,338,298
050,18,093,"Indiana","Lawrence County",2,15,628,336,292
050,18,093,"Indiana","Lawrence County",2,16,608,308,300
050,18,093,"Indiana","Lawrence County",2,17,621,297,324
050,18,093,"Indiana","Lawrence County",2,18,513,258,255
050,18,093,"Indiana","Lawrence County",2,19,407,211,196
050,18,093,"Indiana","Lawrence County",2,20,449,238,211
050,18,093,"Indiana","Lawrence County",2,21,466,251,215
050,18,093,"Indiana","Lawrence County",2,22,511,278,233
050,18,093,"Indiana","Lawrence County",2,23,524,280,244
050,18,093,"Indiana","Lawrence County",2,24,499,266,233
050,18,093,"Indiana","Lawrence County",2,25,508,265,243
050,18,093,"Indiana","Lawrence County",2,26,507,259,248
050,18,093,"Indiana","Lawrence County",2,27,519,269,250
050,18,093,"Indiana","Lawrence County",2,28,508,265,243
050,18,093,"Indiana","Lawrence County",2,29,504,256,248
050,18,093,"Indiana","Lawrence County",2,30,521,270,251
050,18,093,"Indiana","Lawrence County",2,31,496,266,230
050,18,093,"Indiana","Lawrence County",2,32,487,249,238
050,18,093,"Indiana","Lawrence County",2,33,481,247,234
050,18,093,"Indiana","Lawrence County",2,34,486,243,243
050,18,093,"Indiana","Lawrence County",2,35,509,246,263
050,18,093,"Indiana","Lawrence County",2,36,524,259,265
050,18,093,"Indiana","Lawrence County",2,37,542,269,273
050,18,093,"Indiana","Lawrence County",2,38,541,263,278
050,18,093,"Indiana","Lawrence County",2,39,518,245,273
050,18,093,"Indiana","Lawrence County",2,40,546,255,291
050,18,093,"Indiana","Lawrence County",2,41,536,257,279
050,18,093,"Indiana","Lawrence County",2,42,548,279,269
050,18,093,"Indiana","Lawrence County",2,43,553,285,268
050,18,093,"Indiana","Lawrence County",2,44,527,272,255
050,18,093,"Indiana","Lawrence County",2,45,527,270,257
050,18,093,"Indiana","Lawrence County",2,46,549,278,271
050,18,093,"Indiana","Lawrence County",2,47,557,287,270
050,18,093,"Indiana","Lawrence County",2,48,606,330,276
050,18,093,"Indiana","Lawrence County",2,49,633,346,287
050,18,093,"Indiana","Lawrence County",2,50,619,330,289
050,18,093,"Indiana","Lawrence County",2,51,599,316,283
050,18,093,"Indiana","Lawrence County",2,52,582,307,275
050,18,093,"Indiana","Lawrence County",2,53,600,300,300
050,18,093,"Indiana","Lawrence County",2,54,623,309,314
050,18,093,"Indiana","Lawrence County",2,55,666,313,353
050,18,093,"Indiana","Lawrence County",2,56,680,331,349
050,18,093,"Indiana","Lawrence County",2,57,673,324,349
050,18,093,"Indiana","Lawrence County",2,58,666,321,345
050,18,093,"Indiana","Lawrence County",2,59,665,335,330
050,18,093,"Indiana","Lawrence County",2,60,661,334,327
050,18,093,"Indiana","Lawrence County",2,61,645,324,321
050,18,093,"Indiana","Lawrence County",2,62,653,334,319
050,18,093,"Indiana","Lawrence County",2,63,647,323,324
050,18,093,"Indiana","Lawrence County",2,64,613,301,312
050,18,093,"Indiana","Lawrence County",2,65,603,287,316
050,18,093,"Indiana","Lawrence County",2,66,594,291,303
050,18,093,"Indiana","Lawrence County",2,67,576,285,291
050,18,093,"Indiana","Lawrence County",2,68,578,285,293
050,18,093,"Indiana","Lawrence County",2,69,552,274,278
050,18,093,"Indiana","Lawrence County",2,70,533,264,269
050,18,093,"Indiana","Lawrence County",2,71,507,245,262
050,18,093,"Indiana","Lawrence County",2,72,514,252,262
050,18,093,"Indiana","Lawrence County",2,73,552,265,287
050,18,093,"Indiana","Lawrence County",2,74,381,177,204
050,18,093,"Indiana","Lawrence County",2,75,353,162,191
050,18,093,"Indiana","Lawrence County",2,76,353,153,200
050,18,093,"Indiana","Lawrence County",2,77,388,170,218
050,18,093,"Indiana","Lawrence County",2,78,312,135,177
050,18,093,"Indiana","Lawrence County",2,79,273,111,162
050,18,093,"Indiana","Lawrence County",2,80,251,114,137
050,18,093,"Indiana","Lawrence County",2,81,234,110,124
050,18,093,"Indiana","Lawrence County",2,82,215,89,126
050,18,093,"Indiana","Lawrence County",2,83,184,82,102
050,18,093,"Indiana","Lawrence County",2,84,175,78,97
050,18,093,"Indiana","Lawrence County",2,85,940,315,625
050,18,093,"Indiana","Lawrence County",3,0,445,216,229
050,18,093,"Indiana","Lawrence County",3,1,528,268,260
050,18,093,"Indiana","Lawrence County",3,2,510,255,255
050,18,093,"Indiana","Lawrence County",3,3,526,265,261
050,18,093,"Indiana","Lawrence County",3,4,509,261,248
050,18,093,"Indiana","Lawrence County",3,5,500,262,238
050,18,093,"Indiana","Lawrence County",3,6,498,248,250
050,18,093,"Indiana","Lawrence County",3,7,499,255,244
050,18,093,"Indiana","Lawrence County",3,8,495,257,238
050,18,093,"Indiana","Lawrence County",3,9,519,282,237
050,18,093,"Indiana","Lawrence County",3,10,500,269,231
050,18,093,"Indiana","Lawrence County",3,11,516,258,258
050,18,093,"Indiana","Lawrence County",3,12,541,276,265
050,18,093,"Indiana","Lawrence County",3,13,558,297,261
050,18,093,"Indiana","Lawrence County",3,14,620,340,280
050,18,093,"Indiana","Lawrence County",3,15,630,331,299
050,18,093,"Indiana","Lawrence County",3,16,624,331,293
050,18,093,"Indiana","Lawrence County",3,17,615,313,302
050,18,093,"Indiana","Lawrence County",3,18,514,261,253
050,18,093,"Indiana","Lawrence County",3,19,416,210,206
050,18,093,"Indiana","Lawrence County",3,20,452,237,215
050,18,093,"Indiana","Lawrence County",3,21,472,253,219
050,18,093,"Indiana","Lawrence County",3,22,498,267,231
050,18,093,"Indiana","Lawrence County",3,23,531,290,241
050,18,093,"Indiana","Lawrence County",3,24,536,288,248
050,18,093,"Indiana","Lawrence County",3,25,528,275,253
050,18,093,"Indiana","Lawrence County",3,26,518,272,246
050,18,093,"Indiana","Lawrence County",3,27,524,267,257
050,18,093,"Indiana","Lawrence County",3,28,540,286,254
050,18,093,"Indiana","Lawrence County",3,29,518,267,251
050,18,093,"Indiana","Lawrence County",3,30,517,262,255
050,18,093,"Indiana","Lawrence County",3,31,524,276,248
050,18,093,"Indiana","Lawrence County",3,32,493,266,227
050,18,093,"Indiana","Lawrence County",3,33,512,257,255
050,18,093,"Indiana","Lawrence County",3,34,482,244,238
050,18,093,"Indiana","Lawrence County",3,35,486,247,239
050,18,093,"Indiana","Lawrence County",3,36,523,256,267
050,18,093,"Indiana","Lawrence County",3,37,531,263,268
050,18,093,"Indiana","Lawrence County",3,38,544,273,271
050,18,093,"Indiana","Lawrence County",3,39,541,262,279
050,18,093,"Indiana","Lawrence County",3,40,524,257,267
050,18,093,"Indiana","Lawrence County",3,41,534,245,289
050,18,093,"Indiana","Lawrence County",3,42,547,269,278
050,18,093,"Indiana","Lawrence County",3,43,541,272,269
050,18,093,"Indiana","Lawrence County",3,44,566,292,274
050,18,093,"Indiana","Lawrence County",3,45,527,269,258
050,18,093,"Indiana","Lawrence County",3,46,524,268,256
050,18,093,"Indiana","Lawrence County",3,47,560,281,279
050,18,093,"Indiana","Lawrence County",3,48,568,302,266
050,18,093,"Indiana","Lawrence County",3,49,608,332,276
050,18,093,"Indiana","Lawrence County",3,50,639,351,288
050,18,093,"Indiana","Lawrence County",3,51,607,318,289
050,18,093,"Indiana","Lawrence County",3,52,602,323,279
050,18,093,"Indiana","Lawrence County",3,53,608,322,286
050,18,093,"Indiana","Lawrence County",3,54,601,302,299
050,18,093,"Indiana","Lawrence County",3,55,628,308,320
050,18,093,"Indiana","Lawrence County",3,56,647,306,341
050,18,093,"Indiana","Lawrence County",3,57,675,323,352
050,18,093,"Indiana","Lawrence County",3,58,670,326,344
050,18,093,"Indiana","Lawrence County",3,59,650,311,339
050,18,093,"Indiana","Lawrence County",3,60,664,333,331
050,18,093,"Indiana","Lawrence County",3,61,654,329,325
050,18,093,"Indiana","Lawrence County",3,62,633,316,317
050,18,093,"Indiana","Lawrence County",3,63,638,328,310
050,18,093,"Indiana","Lawrence County",3,64,644,321,323
050,18,093,"Indiana","Lawrence County",3,65,593,289,304
050,18,093,"Indiana","Lawrence County",3,66,593,282,311
050,18,093,"Indiana","Lawrence County",3,67,588,292,296
050,18,093,"Indiana","Lawrence County",3,68,560,277,283
050,18,093,"Indiana","Lawrence County",3,69,566,280,286
050,18,093,"Indiana","Lawrence County",3,70,533,258,275
050,18,093,"Indiana","Lawrence County",3,71,529,264,265
050,18,093,"Indiana","Lawrence County",3,72,485,232,253
050,18,093,"Indiana","Lawrence County",3,73,499,241,258
050,18,093,"Indiana","Lawrence County",3,74,526,252,274
050,18,093,"Indiana","Lawrence County",3,75,355,158,197
050,18,093,"Indiana","Lawrence County",3,76,333,153,180
050,18,093,"Indiana","Lawrence County",3,77,345,150,195
050,18,093,"Indiana","Lawrence County",3,78,364,161,203
050,18,093,"Indiana","Lawrence County",3,79,295,125,170
050,18,093,"Indiana","Lawrence County",3,80,248,97,151
050,18,093,"Indiana","Lawrence County",3,81,245,116,129
050,18,093,"Indiana","Lawrence County",3,82,219,98,121
050,18,093,"Indiana","Lawrence County",3,83,180,81,99
050,18,093,"Indiana","Lawrence County",3,84,170,76,94
050,18,093,"Indiana","Lawrence County",3,85,948,311,637
050,18,093,"Indiana","Lawrence County",4,0,494,233,261
050,18,093,"Indiana","Lawrence County",4,1,450,219,231
050,18,093,"Indiana","Lawrence County",4,2,526,271,255
050,18,093,"Indiana","Lawrence County",4,3,529,267,262
050,18,093,"Indiana","Lawrence County",4,4,516,268,248
050,18,093,"Indiana","Lawrence County",4,5,531,272,259
050,18,093,"Indiana","Lawrence County",4,6,507,262,245
050,18,093,"Indiana","Lawrence County",4,7,526,263,263
050,18,093,"Indiana","Lawrence County",4,8,526,277,249
050,18,093,"Indiana","Lawrence County",4,9,521,264,257
050,18,093,"Indiana","Lawrence County",4,10,527,284,243
050,18,093,"Indiana","Lawrence County",4,11,517,277,240
050,18,093,"Indiana","Lawrence County",4,12,530,272,258
050,18,093,"Indiana","Lawrence County",4,13,561,291,270
050,18,093,"Indiana","Lawrence County",4,14,580,301,279
050,18,093,"Indiana","Lawrence County",4,15,619,343,276
050,18,093,"Indiana","Lawrence County",4,16,633,345,288
050,18,093,"Indiana","Lawrence County",4,17,619,325,294
050,18,093,"Indiana","Lawrence County",4,18,511,276,235
050,18,093,"Indiana","Lawrence County",4,19,399,205,194
050,18,093,"Indiana","Lawrence County",4,20,436,225,211
050,18,093,"Indiana","Lawrence County",4,21,459,241,218
050,18,093,"Indiana","Lawrence County",4,22,490,261,229
050,18,093,"Indiana","Lawrence County",4,23,511,264,247
050,18,093,"Indiana","Lawrence County",4,24,544,293,251
050,18,093,"Indiana","Lawrence County",4,25,552,294,258
050,18,093,"Indiana","Lawrence County",4,26,552,281,271
050,18,093,"Indiana","Lawrence County",4,27,531,275,256
050,18,093,"Indiana","Lawrence County",4,28,534,269,265
050,18,093,"Indiana","Lawrence County",4,29,563,293,270
050,18,093,"Indiana","Lawrence County",4,30,540,288,252
050,18,093,"Indiana","Lawrence County",4,31,542,262,280
050,18,093,"Indiana","Lawrence County",4,32,537,284,253
050,18,093,"Indiana","Lawrence County",4,33,517,273,244
050,18,093,"Indiana","Lawrence County",4,34,518,260,258
050,18,093,"Indiana","Lawrence County",4,35,489,248,241
050,18,093,"Indiana","Lawrence County",4,36,507,254,253
050,18,093,"Indiana","Lawrence County",4,37,535,259,276
050,18,093,"Indiana","Lawrence County",4,38,531,263,268
050,18,093,"Indiana","Lawrence County",4,39,563,285,278
050,18,093,"Indiana","Lawrence County",4,40,546,262,284
050,18,093,"Indiana","Lawrence County",4,41,519,253,266
050,18,093,"Indiana","Lawrence County",4,42,545,261,284
050,18,093,"Indiana","Lawrence County",4,43,546,263,283
050,18,093,"Indiana","Lawrence County",4,44,549,279,270
050,18,093,"Indiana","Lawrence County",4,45,575,300,275
050,18,093,"Indiana","Lawrence County",4,46,533,279,254
050,18,093,"Indiana","Lawrence County",4,47,519,257,262
050,18,093,"Indiana","Lawrence County",4,48,574,294,280
050,18,093,"Indiana","Lawrence County",4,49,565,297,268
050,18,093,"Indiana","Lawrence County",4,50,618,329,289
050,18,093,"Indiana","Lawrence County",4,51,638,345,293
050,18,093,"Indiana","Lawrence County",4,52,602,319,283
050,18,093,"Indiana","Lawrence County",4,53,603,324,279
050,18,093,"Indiana","Lawrence County",4,54,595,312,283
050,18,093,"Indiana","Lawrence County",4,55,604,298,306
050,18,093,"Indiana","Lawrence County",4,56,634,314,320
050,18,093,"Indiana","Lawrence County",4,57,640,308,332
050,18,093,"Indiana","Lawrence County",4,58,669,321,348
050,18,093,"Indiana","Lawrence County",4,59,655,314,341
050,18,093,"Indiana","Lawrence County",4,60,650,308,342
050,18,093,"Indiana","Lawrence County",4,61,646,323,323
050,18,093,"Indiana","Lawrence County",4,62,641,323,318
050,18,093,"Indiana","Lawrence County",4,63,630,309,321
050,18,093,"Indiana","Lawrence County",4,64,636,324,312
050,18,093,"Indiana","Lawrence County",4,65,630,308,322
050,18,093,"Indiana","Lawrence County",4,66,582,284,298
050,18,093,"Indiana","Lawrence County",4,67,576,272,304
050,18,093,"Indiana","Lawrence County",4,68,576,283,293
050,18,093,"Indiana","Lawrence County",4,69,554,273,281
050,18,093,"Indiana","Lawrence County",4,70,544,267,277
050,18,093,"Indiana","Lawrence County",4,71,518,247,271
050,18,093,"Indiana","Lawrence County",4,72,511,250,261
050,18,093,"Indiana","Lawrence County",4,73,466,224,242
050,18,093,"Indiana","Lawrence County",4,74,476,232,244
050,18,093,"Indiana","Lawrence County",4,75,491,231,260
050,18,093,"Indiana","Lawrence County",4,76,338,154,184
050,18,093,"Indiana","Lawrence County",4,77,322,146,176
050,18,093,"Indiana","Lawrence County",4,78,316,137,179
050,18,093,"Indiana","Lawrence County",4,79,339,149,190
050,18,093,"Indiana","Lawrence County",4,80,261,109,152
050,18,093,"Indiana","Lawrence County",4,81,227,95,132
050,18,093,"Indiana","Lawrence County",4,82,225,103,122
050,18,093,"Indiana","Lawrence County",4,83,195,93,102
050,18,093,"Indiana","Lawrence County",4,84,166,74,92
050,18,093,"Indiana","Lawrence County",4,85,913,295,618
050,18,093,"Indiana","Lawrence County",5,0,496,233,263
050,18,093,"Indiana","Lawrence County",5,1,497,229,268
050,18,093,"Indiana","Lawrence County",5,2,459,223,236
050,18,093,"Indiana","Lawrence County",5,3,525,266,259
050,18,093,"Indiana","Lawrence County",5,4,522,268,254
050,18,093,"Indiana","Lawrence County",5,5,516,263,253
050,18,093,"Indiana","Lawrence County",5,6,521,274,247
050,18,093,"Indiana","Lawrence County",5,7,500,253,247
050,18,093,"Indiana","Lawrence County",5,8,512,255,257
050,18,093,"Indiana","Lawrence County",5,9,517,268,249
050,18,093,"Indiana","Lawrence County",5,10,514,272,242
050,18,093,"Indiana","Lawrence County",5,11,532,282,250
050,18,093,"Indiana","Lawrence County",5,12,522,278,244
050,18,093,"Indiana","Lawrence County",5,13,521,268,253
050,18,093,"Indiana","Lawrence County",5,14,550,278,272
050,18,093,"Indiana","Lawrence County",5,15,575,306,269
050,18,093,"Indiana","Lawrence County",5,16,612,324,288
050,18,093,"Indiana","Lawrence County",5,17,639,341,298
050,18,093,"Indiana","Lawrence County",5,18,509,281,228
050,18,093,"Indiana","Lawrence County",5,19,390,209,181
050,18,093,"Indiana","Lawrence County",5,20,447,232,215
050,18,093,"Indiana","Lawrence County",5,21,425,217,208
050,18,093,"Indiana","Lawrence County",5,22,504,253,251
050,18,093,"Indiana","Lawrence County",5,23,524,271,253
050,18,093,"Indiana","Lawrence County",5,24,526,274,252
050,18,093,"Indiana","Lawrence County",5,25,553,294,259
050,18,093,"Indiana","Lawrence County",5,26,562,303,259
050,18,093,"Indiana","Lawrence County",5,27,579,299,280
050,18,093,"Indiana","Lawrence County",5,28,550,288,262
050,18,093,"Indiana","Lawrence County",5,29,519,264,255
050,18,093,"Indiana","Lawrence County",5,30,578,299,279
050,18,093,"Indiana","Lawrence County",5,31,533,282,251
050,18,093,"Indiana","Lawrence County",5,32,526,254,272
050,18,093,"Indiana","Lawrence County",5,33,552,285,267
050,18,093,"Indiana","Lawrence County",5,34,516,279,237
050,18,093,"Indiana","Lawrence County",5,35,521,267,254
050,18,093,"Indiana","Lawrence County",5,36,496,249,247
050,18,093,"Indiana","Lawrence County",5,37,499,253,246
050,18,093,"Indiana","Lawrence County",5,38,534,257,277
050,18,093,"Indiana","Lawrence County",5,39,522,254,268
050,18,093,"Indiana","Lawrence County",5,40,571,292,279
050,18,093,"Indiana","Lawrence County",5,41,551,270,281
050,18,093,"Indiana","Lawrence County",5,42,511,253,258
050,18,093,"Indiana","Lawrence County",5,43,543,255,288
050,18,093,"Indiana","Lawrence County",5,44,559,275,284
050,18,093,"Indiana","Lawrence County",5,45,547,278,269
050,18,093,"Indiana","Lawrence County",5,46,576,305,271
050,18,093,"Indiana","Lawrence County",5,47,518,268,250
050,18,093,"Indiana","Lawrence County",5,48,520,260,260
050,18,093,"Indiana","Lawrence County",5,49,568,290,278
050,18,093,"Indiana","Lawrence County",5,50,567,301,266
050,18,093,"Indiana","Lawrence County",5,51,612,323,289
050,18,093,"Indiana","Lawrence County",5,52,639,343,296
050,18,093,"Indiana","Lawrence County",5,53,610,326,284
050,18,093,"Indiana","Lawrence County",5,54,601,328,273
050,18,093,"Indiana","Lawrence County",5,55,608,307,301
050,18,093,"Indiana","Lawrence County",5,56,596,296,300
050,18,093,"Indiana","Lawrence County",5,57,638,312,326
050,18,093,"Indiana","Lawrence County",5,58,626,302,324
050,18,093,"Indiana","Lawrence County",5,59,655,311,344
050,18,093,"Indiana","Lawrence County",5,60,651,312,339
050,18,093,"Indiana","Lawrence County",5,61,659,311,348
050,18,093,"Indiana","Lawrence County",5,62,646,326,320
050,18,093,"Indiana","Lawrence County",5,63,629,314,315
050,18,093,"Indiana","Lawrence County",5,64,628,308,320
050,18,093,"Indiana","Lawrence County",5,65,623,315,308
050,18,093,"Indiana","Lawrence County",5,66,619,301,318
050,18,093,"Indiana","Lawrence County",5,67,577,283,294
050,18,093,"Indiana","Lawrence County",5,68,564,263,301
050,18,093,"Indiana","Lawrence County",5,69,566,277,289
050,18,093,"Indiana","Lawrence County",5,70,525,262,263
050,18,093,"Indiana","Lawrence County",5,71,543,265,278
050,18,093,"Indiana","Lawrence County",5,72,495,231,264
050,18,093,"Indiana","Lawrence County",5,73,490,244,246
050,18,093,"Indiana","Lawrence County",5,74,446,213,233
050,18,093,"Indiana","Lawrence County",5,75,446,212,234
050,18,093,"Indiana","Lawrence County",5,76,476,222,254
050,18,093,"Indiana","Lawrence County",5,77,331,149,182
050,18,093,"Indiana","Lawrence County",5,78,298,134,164
050,18,093,"Indiana","Lawrence County",5,79,294,122,172
050,18,093,"Indiana","Lawrence County",5,80,315,136,179
050,18,093,"Indiana","Lawrence County",5,81,245,109,136
050,18,093,"Indiana","Lawrence County",5,82,212,84,128
050,18,093,"Indiana","Lawrence County",5,83,199,96,103
050,18,093,"Indiana","Lawrence County",5,84,184,90,94
050,18,093,"Indiana","Lawrence County",5,85,912,300,612
050,18,095,"Indiana","Madison County",1,0,1360,692,668
050,18,095,"Indiana","Madison County",1,1,1373,690,683
050,18,095,"Indiana","Madison County",1,2,1442,752,690
050,18,095,"Indiana","Madison County",1,3,1445,779,666
050,18,095,"Indiana","Madison County",1,4,1478,795,683
050,18,095,"Indiana","Madison County",1,5,1500,772,728
050,18,095,"Indiana","Madison County",1,6,1510,794,716
050,18,095,"Indiana","Madison County",1,7,1564,802,762
050,18,095,"Indiana","Madison County",1,8,1559,810,749
050,18,095,"Indiana","Madison County",1,9,1594,802,792
050,18,095,"Indiana","Madison County",1,10,1616,815,801
050,18,095,"Indiana","Madison County",1,11,1653,851,802
050,18,095,"Indiana","Madison County",1,12,1664,859,805
050,18,095,"Indiana","Madison County",1,13,1711,904,807
050,18,095,"Indiana","Madison County",1,14,1696,885,811
050,18,095,"Indiana","Madison County",1,15,1689,867,822
050,18,095,"Indiana","Madison County",1,16,1711,894,817
050,18,095,"Indiana","Madison County",1,17,1734,936,798
050,18,095,"Indiana","Madison County",1,18,1492,798,694
050,18,095,"Indiana","Madison County",1,19,1412,740,672
050,18,095,"Indiana","Madison County",1,20,1511,792,719
050,18,095,"Indiana","Madison County",1,21,1478,773,705
050,18,095,"Indiana","Madison County",1,22,1471,749,722
050,18,095,"Indiana","Madison County",1,23,1510,786,724
050,18,095,"Indiana","Madison County",1,24,1584,870,714
050,18,095,"Indiana","Madison County",1,25,1533,823,710
050,18,095,"Indiana","Madison County",1,26,1590,856,734
050,18,095,"Indiana","Madison County",1,27,1647,855,792
050,18,095,"Indiana","Madison County",1,28,1770,875,895
050,18,095,"Indiana","Madison County",1,29,1778,934,844
050,18,095,"Indiana","Madison County",1,30,1673,890,783
050,18,095,"Indiana","Madison County",1,31,1641,847,794
050,18,095,"Indiana","Madison County",1,32,1687,897,790
050,18,095,"Indiana","Madison County",1,33,1621,834,787
050,18,095,"Indiana","Madison County",1,34,1613,849,764
050,18,095,"Indiana","Madison County",1,35,1554,809,745
050,18,095,"Indiana","Madison County",1,36,1555,825,730
050,18,095,"Indiana","Madison County",1,37,1612,854,758
050,18,095,"Indiana","Madison County",1,38,1671,900,771
050,18,095,"Indiana","Madison County",1,39,1636,868,768
050,18,095,"Indiana","Madison County",1,40,1665,855,810
050,18,095,"Indiana","Madison County",1,41,1679,880,799
050,18,095,"Indiana","Madison County",1,42,1617,833,784
050,18,095,"Indiana","Madison County",1,43,1622,859,763
050,18,095,"Indiana","Madison County",1,44,1547,804,743
050,18,095,"Indiana","Madison County",1,45,1548,782,766
050,18,095,"Indiana","Madison County",1,46,1523,791,732
050,18,095,"Indiana","Madison County",1,47,1662,863,799
050,18,095,"Indiana","Madison County",1,48,1777,921,856
050,18,095,"Indiana","Madison County",1,49,1853,967,886
050,18,095,"Indiana","Madison County",1,50,1782,937,845
050,18,095,"Indiana","Madison County",1,51,1704,891,813
050,18,095,"Indiana","Madison County",1,52,1658,831,827
050,18,095,"Indiana","Madison County",1,53,1718,869,849
050,18,095,"Indiana","Madison County",1,54,1726,891,835
050,18,095,"Indiana","Madison County",1,55,1829,943,886
050,18,095,"Indiana","Madison County",1,56,1840,916,924
050,18,095,"Indiana","Madison County",1,57,1814,906,908
050,18,095,"Indiana","Madison County",1,58,1772,899,873
050,18,095,"Indiana","Madison County",1,59,1801,889,912
050,18,095,"Indiana","Madison County",1,60,1743,860,883
050,18,095,"Indiana","Madison County",1,61,1731,840,891
050,18,095,"Indiana","Madison County",1,62,1772,894,878
050,18,095,"Indiana","Madison County",1,63,1786,883,903
050,18,095,"Indiana","Madison County",1,64,1659,792,867
050,18,095,"Indiana","Madison County",1,65,1596,786,810
050,18,095,"Indiana","Madison County",1,66,1587,751,836
050,18,095,"Indiana","Madison County",1,67,1565,775,790
050,18,095,"Indiana","Madison County",1,68,1515,692,823
050,18,095,"Indiana","Madison County",1,69,1393,628,765
050,18,095,"Indiana","Madison County",1,70,1364,618,746
050,18,095,"Indiana","Madison County",1,71,1372,623,749
050,18,095,"Indiana","Madison County",1,72,1427,653,774
050,18,095,"Indiana","Madison County",1,73,1422,659,763
050,18,095,"Indiana","Madison County",1,74,966,440,526
050,18,095,"Indiana","Madison County",1,75,1031,491,540
050,18,095,"Indiana","Madison County",1,76,976,465,511
050,18,095,"Indiana","Madison County",1,77,947,440,507
050,18,095,"Indiana","Madison County",1,78,782,360,422
050,18,095,"Indiana","Madison County",1,79,707,324,383
050,18,095,"Indiana","Madison County",1,80,635,275,360
050,18,095,"Indiana","Madison County",1,81,596,242,354
050,18,095,"Indiana","Madison County",1,82,545,225,320
050,18,095,"Indiana","Madison County",1,83,493,197,296
050,18,095,"Indiana","Madison County",1,84,468,183,285
050,18,095,"Indiana","Madison County",1,85,2568,906,1662
050,18,095,"Indiana","Madison County",2,0,1374,697,677
050,18,095,"Indiana","Madison County",2,1,1374,693,681
050,18,095,"Indiana","Madison County",2,2,1433,740,693
050,18,095,"Indiana","Madison County",2,3,1436,769,667
050,18,095,"Indiana","Madison County",2,4,1470,791,679
050,18,095,"Indiana","Madison County",2,5,1493,776,717
050,18,095,"Indiana","Madison County",2,6,1514,793,721
050,18,095,"Indiana","Madison County",2,7,1550,802,748
050,18,095,"Indiana","Madison County",2,8,1561,810,751
050,18,095,"Indiana","Madison County",2,9,1589,805,784
050,18,095,"Indiana","Madison County",2,10,1614,814,800
050,18,095,"Indiana","Madison County",2,11,1638,838,800
050,18,095,"Indiana","Madison County",2,12,1673,865,808
050,18,095,"Indiana","Madison County",2,13,1698,892,806
050,18,095,"Indiana","Madison County",2,14,1702,892,810
050,18,095,"Indiana","Madison County",2,15,1696,872,824
050,18,095,"Indiana","Madison County",2,16,1713,893,820
050,18,095,"Indiana","Madison County",2,17,1734,934,800
050,18,095,"Indiana","Madison County",2,18,1493,800,693
050,18,095,"Indiana","Madison County",2,19,1410,736,674
050,18,095,"Indiana","Madison County",2,20,1517,794,723
050,18,095,"Indiana","Madison County",2,21,1486,782,704
050,18,095,"Indiana","Madison County",2,22,1477,756,721
050,18,095,"Indiana","Madison County",2,23,1516,787,729
050,18,095,"Indiana","Madison County",2,24,1580,863,717
050,18,095,"Indiana","Madison County",2,25,1543,831,712
050,18,095,"Indiana","Madison County",2,26,1596,859,737
050,18,095,"Indiana","Madison County",2,27,1631,849,782
050,18,095,"Indiana","Madison County",2,28,1754,883,871
050,18,095,"Indiana","Madison County",2,29,1771,919,852
050,18,095,"Indiana","Madison County",2,30,1710,907,803
050,18,095,"Indiana","Madison County",2,31,1640,852,788
050,18,095,"Indiana","Madison County",2,32,1681,894,787
050,18,095,"Indiana","Madison County",2,33,1620,837,783
050,18,095,"Indiana","Madison County",2,34,1620,848,772
050,18,095,"Indiana","Madison County",2,35,1573,824,749
050,18,095,"Indiana","Madison County",2,36,1551,818,733
050,18,095,"Indiana","Madison County",2,37,1599,845,754
050,18,095,"Indiana","Madison County",2,38,1657,890,767
050,18,095,"Indiana","Madison County",2,39,1646,877,769
050,18,095,"Indiana","Madison County",2,40,1667,860,807
050,18,095,"Indiana","Madison County",2,41,1681,879,802
050,18,095,"Indiana","Madison County",2,42,1619,839,780
050,18,095,"Indiana","Madison County",2,43,1633,863,770
050,18,095,"Indiana","Madison County",2,44,1556,813,743
050,18,095,"Indiana","Madison County",2,45,1550,788,762
050,18,095,"Indiana","Madison County",2,46,1523,786,737
050,18,095,"Indiana","Madison County",2,47,1630,850,780
050,18,095,"Indiana","Madison County",2,48,1745,907,838
050,18,095,"Indiana","Madison County",2,49,1843,961,882
050,18,095,"Indiana","Madison County",2,50,1805,948,857
050,18,095,"Indiana","Madison County",2,51,1717,894,823
050,18,095,"Indiana","Madison County",2,52,1660,841,819
050,18,095,"Indiana","Madison County",2,53,1706,858,848
050,18,095,"Indiana","Madison County",2,54,1719,882,837
050,18,095,"Indiana","Madison County",2,55,1802,926,876
050,18,095,"Indiana","Madison County",2,56,1840,926,914
050,18,095,"Indiana","Madison County",2,57,1821,909,912
050,18,095,"Indiana","Madison County",2,58,1775,896,879
050,18,095,"Indiana","Madison County",2,59,1807,898,909
050,18,095,"Indiana","Madison County",2,60,1750,859,891
050,18,095,"Indiana","Madison County",2,61,1732,845,887
050,18,095,"Indiana","Madison County",2,62,1761,879,882
050,18,095,"Indiana","Madison County",2,63,1791,885,906
050,18,095,"Indiana","Madison County",2,64,1665,802,863
050,18,095,"Indiana","Madison County",2,65,1601,783,818
050,18,095,"Indiana","Madison County",2,66,1588,759,829
050,18,095,"Indiana","Madison County",2,67,1561,764,797
050,18,095,"Indiana","Madison County",2,68,1515,707,808
050,18,095,"Indiana","Madison County",2,69,1429,644,785
050,18,095,"Indiana","Madison County",2,70,1353,609,744
050,18,095,"Indiana","Madison County",2,71,1364,621,743
050,18,095,"Indiana","Madison County",2,72,1376,626,750
050,18,095,"Indiana","Madison County",2,73,1483,685,798
050,18,095,"Indiana","Madison County",2,74,1006,458,548
050,18,095,"Indiana","Madison County",2,75,1005,468,537
050,18,095,"Indiana","Madison County",2,76,974,464,510
050,18,095,"Indiana","Madison County",2,77,975,457,518
050,18,095,"Indiana","Madison County",2,78,803,375,428
050,18,095,"Indiana","Madison County",2,79,720,331,389
050,18,095,"Indiana","Madison County",2,80,641,281,360
050,18,095,"Indiana","Madison County",2,81,589,243,346
050,18,095,"Indiana","Madison County",2,82,552,225,327
050,18,095,"Indiana","Madison County",2,83,496,200,296
050,18,095,"Indiana","Madison County",2,84,462,181,281
050,18,095,"Indiana","Madison County",2,85,2543,897,1646
050,18,095,"Indiana","Madison County",3,0,1366,724,642
050,18,095,"Indiana","Madison County",3,1,1424,730,694
050,18,095,"Indiana","Madison County",3,2,1436,726,710
050,18,095,"Indiana","Madison County",3,3,1422,736,686
050,18,095,"Indiana","Madison County",3,4,1468,791,677
050,18,095,"Indiana","Madison County",3,5,1452,781,671
050,18,095,"Indiana","Madison County",3,6,1495,777,718
050,18,095,"Indiana","Madison County",3,7,1507,798,709
050,18,095,"Indiana","Madison County",3,8,1545,796,749
050,18,095,"Indiana","Madison County",3,9,1572,820,752
050,18,095,"Indiana","Madison County",3,10,1554,791,763
050,18,095,"Indiana","Madison County",3,11,1631,820,811
050,18,095,"Indiana","Madison County",3,12,1615,825,790
050,18,095,"Indiana","Madison County",3,13,1702,885,817
050,18,095,"Indiana","Madison County",3,14,1701,901,800
050,18,095,"Indiana","Madison County",3,15,1747,915,832
050,18,095,"Indiana","Madison County",3,16,1721,910,811
050,18,095,"Indiana","Madison County",3,17,1768,943,825
050,18,095,"Indiana","Madison County",3,18,1539,828,711
050,18,095,"Indiana","Madison County",3,19,1414,722,692
050,18,095,"Indiana","Madison County",3,20,1491,785,706
050,18,095,"Indiana","Madison County",3,21,1549,827,722
050,18,095,"Indiana","Madison County",3,22,1550,791,759
050,18,095,"Indiana","Madison County",3,23,1530,775,755
050,18,095,"Indiana","Madison County",3,24,1638,876,762
050,18,095,"Indiana","Madison County",3,25,1584,851,733
050,18,095,"Indiana","Madison County",3,26,1629,860,769
050,18,095,"Indiana","Madison County",3,27,1625,862,763
050,18,095,"Indiana","Madison County",3,28,1701,900,801
050,18,095,"Indiana","Madison County",3,29,1779,899,880
050,18,095,"Indiana","Madison County",3,30,1833,965,868
050,18,095,"Indiana","Madison County",3,31,1728,914,814
050,18,095,"Indiana","Madison County",3,32,1741,925,816
050,18,095,"Indiana","Madison County",3,33,1654,874,780
050,18,095,"Indiana","Madison County",3,34,1663,865,798
050,18,095,"Indiana","Madison County",3,35,1625,840,785
050,18,095,"Indiana","Madison County",3,36,1595,834,761
050,18,095,"Indiana","Madison County",3,37,1552,804,748
050,18,095,"Indiana","Madison County",3,38,1617,854,763
050,18,095,"Indiana","Madison County",3,39,1661,897,764
050,18,095,"Indiana","Madison County",3,40,1633,872,761
050,18,095,"Indiana","Madison County",3,41,1702,888,814
050,18,095,"Indiana","Madison County",3,42,1667,864,803
050,18,095,"Indiana","Madison County",3,43,1631,844,787
050,18,095,"Indiana","Madison County",3,44,1674,873,801
050,18,095,"Indiana","Madison County",3,45,1551,807,744
050,18,095,"Indiana","Madison County",3,46,1554,795,759
050,18,095,"Indiana","Madison County",3,47,1532,798,734
050,18,095,"Indiana","Madison County",3,48,1635,873,762
050,18,095,"Indiana","Madison County",3,49,1718,888,830
050,18,095,"Indiana","Madison County",3,50,1857,975,882
050,18,095,"Indiana","Madison County",3,51,1811,943,868
050,18,095,"Indiana","Madison County",3,52,1694,876,818
050,18,095,"Indiana","Madison County",3,53,1678,845,833
050,18,095,"Indiana","Madison County",3,54,1698,850,848
050,18,095,"Indiana","Madison County",3,55,1714,875,839
050,18,095,"Indiana","Madison County",3,56,1784,913,871
050,18,095,"Indiana","Madison County",3,57,1838,915,923
050,18,095,"Indiana","Madison County",3,58,1800,904,896
050,18,095,"Indiana","Madison County",3,59,1792,892,900
050,18,095,"Indiana","Madison County",3,60,1793,886,907
050,18,095,"Indiana","Madison County",3,61,1744,861,883
050,18,095,"Indiana","Madison County",3,62,1723,837,886
050,18,095,"Indiana","Madison County",3,63,1723,846,877
050,18,095,"Indiana","Madison County",3,64,1766,870,896
050,18,095,"Indiana","Madison County",3,65,1660,800,860
050,18,095,"Indiana","Madison County",3,66,1546,737,809
050,18,095,"Indiana","Madison County",3,67,1562,740,822
050,18,095,"Indiana","Madison County",3,68,1515,732,783
050,18,095,"Indiana","Madison County",3,69,1488,689,799
050,18,095,"Indiana","Madison County",3,70,1381,618,763
050,18,095,"Indiana","Madison County",3,71,1317,595,722
050,18,095,"Indiana","Madison County",3,72,1309,586,723
050,18,095,"Indiana","Madison County",3,73,1333,609,724
050,18,095,"Indiana","Madison County",3,74,1443,654,789
050,18,095,"Indiana","Madison County",3,75,976,428,548
050,18,095,"Indiana","Madison County",3,76,958,440,518
050,18,095,"Indiana","Madison County",3,77,925,433,492
050,18,095,"Indiana","Madison County",3,78,918,423,495
050,18,095,"Indiana","Madison County",3,79,750,347,403
050,18,095,"Indiana","Madison County",3,80,673,306,367
050,18,095,"Indiana","Madison County",3,81,598,255,343
050,18,095,"Indiana","Madison County",3,82,535,220,315
050,18,095,"Indiana","Madison County",3,83,494,209,285
050,18,095,"Indiana","Madison County",3,84,456,178,278
050,18,095,"Indiana","Madison County",3,85,2468,878,1590
050,18,095,"Indiana","Madison County",4,0,1388,737,651
050,18,095,"Indiana","Madison County",4,1,1381,713,668
050,18,095,"Indiana","Madison County",4,2,1458,751,707
050,18,095,"Indiana","Madison County",4,3,1445,724,721
050,18,095,"Indiana","Madison County",4,4,1441,760,681
050,18,095,"Indiana","Madison County",4,5,1499,795,704
050,18,095,"Indiana","Madison County",4,6,1464,767,697
050,18,095,"Indiana","Madison County",4,7,1523,788,735
050,18,095,"Indiana","Madison County",4,8,1533,814,719
050,18,095,"Indiana","Madison County",4,9,1592,817,775
050,18,095,"Indiana","Madison County",4,10,1583,833,750
050,18,095,"Indiana","Madison County",4,11,1581,797,784
050,18,095,"Indiana","Madison County",4,12,1657,844,813
050,18,095,"Indiana","Madison County",4,13,1669,851,818
050,18,095,"Indiana","Madison County",4,14,1730,906,824
050,18,095,"Indiana","Madison County",4,15,1747,927,820
050,18,095,"Indiana","Madison County",4,16,1788,942,846
050,18,095,"Indiana","Madison County",4,17,1746,934,812
050,18,095,"Indiana","Madison County",4,18,1549,825,724
050,18,095,"Indiana","Madison County",4,19,1383,711,672
050,18,095,"Indiana","Madison County",4,20,1488,780,708
050,18,095,"Indiana","Madison County",4,21,1481,799,682
050,18,095,"Indiana","Madison County",4,22,1568,827,741
050,18,095,"Indiana","Madison County",4,23,1562,799,763
050,18,095,"Indiana","Madison County",4,24,1618,855,763
050,18,095,"Indiana","Madison County",4,25,1662,878,784
050,18,095,"Indiana","Madison County",4,26,1652,878,774
050,18,095,"Indiana","Madison County",4,27,1634,873,761
050,18,095,"Indiana","Madison County",4,28,1682,882,800
050,18,095,"Indiana","Madison County",4,29,1748,924,824
050,18,095,"Indiana","Madison County",4,30,1899,974,925
050,18,095,"Indiana","Madison County",4,31,1868,963,905
050,18,095,"Indiana","Madison County",4,32,1801,964,837
050,18,095,"Indiana","Madison County",4,33,1707,904,803
050,18,095,"Indiana","Madison County",4,34,1708,888,820
050,18,095,"Indiana","Madison County",4,35,1647,847,800
050,18,095,"Indiana","Madison County",4,36,1644,861,783
050,18,095,"Indiana","Madison County",4,37,1610,812,798
050,18,095,"Indiana","Madison County",4,38,1612,837,775
050,18,095,"Indiana","Madison County",4,39,1653,892,761
050,18,095,"Indiana","Madison County",4,40,1695,895,800
050,18,095,"Indiana","Madison County",4,41,1656,893,763
050,18,095,"Indiana","Madison County",4,42,1685,870,815
050,18,095,"Indiana","Madison County",4,43,1686,882,804
050,18,095,"Indiana","Madison County",4,44,1634,843,791
050,18,095,"Indiana","Madison County",4,45,1655,847,808
050,18,095,"Indiana","Madison County",4,46,1539,793,746
050,18,095,"Indiana","Madison County",4,47,1573,813,760
050,18,095,"Indiana","Madison County",4,48,1506,780,726
050,18,095,"Indiana","Madison County",4,49,1666,876,790
050,18,095,"Indiana","Madison County",4,50,1698,878,820
050,18,095,"Indiana","Madison County",4,51,1836,952,884
050,18,095,"Indiana","Madison County",4,52,1793,936,857
050,18,095,"Indiana","Madison County",4,53,1701,890,811
050,18,095,"Indiana","Madison County",4,54,1647,824,823
050,18,095,"Indiana","Madison County",4,55,1697,839,858
050,18,095,"Indiana","Madison County",4,56,1687,867,820
050,18,095,"Indiana","Madison County",4,57,1793,913,880
050,18,095,"Indiana","Madison County",4,58,1811,889,922
050,18,095,"Indiana","Madison County",4,59,1797,897,900
050,18,095,"Indiana","Madison County",4,60,1749,861,888
050,18,095,"Indiana","Madison County",4,61,1794,894,900
050,18,095,"Indiana","Madison County",4,62,1689,829,860
050,18,095,"Indiana","Madison County",4,63,1675,787,888
050,18,095,"Indiana","Madison County",4,64,1694,823,871
050,18,095,"Indiana","Madison County",4,65,1747,859,888
050,18,095,"Indiana","Madison County",4,66,1605,754,851
050,18,095,"Indiana","Madison County",4,67,1529,734,795
050,18,095,"Indiana","Madison County",4,68,1519,707,812
050,18,095,"Indiana","Madison County",4,69,1483,714,769
050,18,095,"Indiana","Madison County",4,70,1456,678,778
050,18,095,"Indiana","Madison County",4,71,1334,598,736
050,18,095,"Indiana","Madison County",4,72,1263,562,701
050,18,095,"Indiana","Madison County",4,73,1253,570,683
050,18,095,"Indiana","Madison County",4,74,1278,582,696
050,18,095,"Indiana","Madison County",4,75,1403,628,775
050,18,095,"Indiana","Madison County",4,76,921,400,521
050,18,095,"Indiana","Madison County",4,77,901,400,501
050,18,095,"Indiana","Madison County",4,78,884,416,468
050,18,095,"Indiana","Madison County",4,79,858,398,460
050,18,095,"Indiana","Madison County",4,80,694,317,377
050,18,095,"Indiana","Madison County",4,81,625,270,355
050,18,095,"Indiana","Madison County",4,82,552,226,326
050,18,095,"Indiana","Madison County",4,83,489,204,285
050,18,095,"Indiana","Madison County",4,84,437,176,261
050,18,095,"Indiana","Madison County",4,85,2395,855,1540
050,18,095,"Indiana","Madison County",5,0,1375,728,647
050,18,095,"Indiana","Madison County",5,1,1409,744,665
050,18,095,"Indiana","Madison County",5,2,1442,763,679
050,18,095,"Indiana","Madison County",5,3,1512,779,733
050,18,095,"Indiana","Madison County",5,4,1495,735,760
050,18,095,"Indiana","Madison County",5,5,1475,759,716
050,18,095,"Indiana","Madison County",5,6,1524,812,712
050,18,095,"Indiana","Madison County",5,7,1505,794,711
050,18,095,"Indiana","Madison County",5,8,1514,782,732
050,18,095,"Indiana","Madison County",5,9,1537,815,722
050,18,095,"Indiana","Madison County",5,10,1560,808,752
050,18,095,"Indiana","Madison County",5,11,1607,831,776
050,18,095,"Indiana","Madison County",5,12,1604,817,787
050,18,095,"Indiana","Madison County",5,13,1653,845,808
050,18,095,"Indiana","Madison County",5,14,1684,860,824
050,18,095,"Indiana","Madison County",5,15,1760,933,827
050,18,095,"Indiana","Madison County",5,16,1766,942,824
050,18,095,"Indiana","Madison County",5,17,1794,961,833
050,18,095,"Indiana","Madison County",5,18,1515,804,711
050,18,095,"Indiana","Madison County",5,19,1436,734,702
050,18,095,"Indiana","Madison County",5,20,1494,783,711
050,18,095,"Indiana","Madison County",5,21,1511,794,717
050,18,095,"Indiana","Madison County",5,22,1526,815,711
050,18,095,"Indiana","Madison County",5,23,1609,840,769
050,18,095,"Indiana","Madison County",5,24,1686,882,804
050,18,095,"Indiana","Madison County",5,25,1601,841,760
050,18,095,"Indiana","Madison County",5,26,1726,908,818
050,18,095,"Indiana","Madison County",5,27,1701,891,810
050,18,095,"Indiana","Madison County",5,28,1744,937,807
050,18,095,"Indiana","Madison County",5,29,1699,893,806
050,18,095,"Indiana","Madison County",5,30,1835,966,869
050,18,095,"Indiana","Madison County",5,31,1896,955,941
050,18,095,"Indiana","Madison County",5,32,1935,1026,909
050,18,095,"Indiana","Madison County",5,33,1790,944,846
050,18,095,"Indiana","Madison County",5,34,1769,949,820
050,18,095,"Indiana","Madison County",5,35,1745,890,855
050,18,095,"Indiana","Madison County",5,36,1693,858,835
050,18,095,"Indiana","Madison County",5,37,1665,877,788
050,18,095,"Indiana","Madison County",5,38,1621,825,796
050,18,095,"Indiana","Madison County",5,39,1643,852,791
050,18,095,"Indiana","Madison County",5,40,1658,886,772
050,18,095,"Indiana","Madison County",5,41,1764,936,828
050,18,095,"Indiana","Madison County",5,42,1633,864,769
050,18,095,"Indiana","Madison County",5,43,1733,893,840
050,18,095,"Indiana","Madison County",5,44,1686,886,800
050,18,095,"Indiana","Madison County",5,45,1657,842,815
050,18,095,"Indiana","Madison County",5,46,1656,839,817
050,18,095,"Indiana","Madison County",5,47,1572,811,761
050,18,095,"Indiana","Madison County",5,48,1592,836,756
050,18,095,"Indiana","Madison County",5,49,1501,775,726
050,18,095,"Indiana","Madison County",5,50,1656,873,783
050,18,095,"Indiana","Madison County",5,51,1695,867,828
050,18,095,"Indiana","Madison County",5,52,1825,946,879
050,18,095,"Indiana","Madison County",5,53,1793,931,862
050,18,095,"Indiana","Madison County",5,54,1685,874,811
050,18,095,"Indiana","Madison County",5,55,1658,826,832
050,18,095,"Indiana","Madison County",5,56,1695,834,861
050,18,095,"Indiana","Madison County",5,57,1693,869,824
050,18,095,"Indiana","Madison County",5,58,1761,893,868
050,18,095,"Indiana","Madison County",5,59,1813,885,928
050,18,095,"Indiana","Madison County",5,60,1801,895,906
050,18,095,"Indiana","Madison County",5,61,1736,854,882
050,18,095,"Indiana","Madison County",5,62,1773,879,894
050,18,095,"Indiana","Madison County",5,63,1664,807,857
050,18,095,"Indiana","Madison County",5,64,1657,775,882
050,18,095,"Indiana","Madison County",5,65,1684,817,867
050,18,095,"Indiana","Madison County",5,66,1718,843,875
050,18,095,"Indiana","Madison County",5,67,1583,742,841
050,18,095,"Indiana","Madison County",5,68,1503,716,787
050,18,095,"Indiana","Madison County",5,69,1489,687,802
050,18,095,"Indiana","Madison County",5,70,1459,692,767
050,18,095,"Indiana","Madison County",5,71,1420,660,760
050,18,095,"Indiana","Madison County",5,72,1283,565,718
050,18,095,"Indiana","Madison County",5,73,1227,549,678
050,18,095,"Indiana","Madison County",5,74,1213,548,665
050,18,095,"Indiana","Madison County",5,75,1251,557,694
050,18,095,"Indiana","Madison County",5,76,1335,600,735
050,18,095,"Indiana","Madison County",5,77,870,364,506
050,18,095,"Indiana","Madison County",5,78,868,386,482
050,18,095,"Indiana","Madison County",5,79,829,390,439
050,18,095,"Indiana","Madison County",5,80,807,376,431
050,18,095,"Indiana","Madison County",5,81,655,289,366
050,18,095,"Indiana","Madison County",5,82,590,251,339
050,18,095,"Indiana","Madison County",5,83,508,215,293
050,18,095,"Indiana","Madison County",5,84,448,174,274
050,18,095,"Indiana","Madison County",5,85,2351,846,1505
050,18,097,"Indiana","Marion County",1,0,14095,7186,6909
050,18,097,"Indiana","Marion County",1,1,13887,7075,6812
050,18,097,"Indiana","Marion County",1,2,14184,7318,6866
050,18,097,"Indiana","Marion County",1,3,13965,7175,6790
050,18,097,"Indiana","Marion County",1,4,14052,7317,6735
050,18,097,"Indiana","Marion County",1,5,14178,7252,6926
050,18,097,"Indiana","Marion County",1,6,13725,6998,6727
050,18,097,"Indiana","Marion County",1,7,13724,6982,6742
050,18,097,"Indiana","Marion County",1,8,13569,6886,6683
050,18,097,"Indiana","Marion County",1,9,13552,6897,6655
050,18,097,"Indiana","Marion County",1,10,13770,7058,6712
050,18,097,"Indiana","Marion County",1,11,14014,7098,6916
050,18,097,"Indiana","Marion County",1,12,14300,7297,7003
050,18,097,"Indiana","Marion County",1,13,13997,7229,6768
050,18,097,"Indiana","Marion County",1,14,13370,6912,6458
050,18,097,"Indiana","Marion County",1,15,12915,6655,6260
050,18,097,"Indiana","Marion County",1,16,12916,6667,6249
050,18,097,"Indiana","Marion County",1,17,12601,6431,6170
050,18,097,"Indiana","Marion County",1,18,11723,5927,5796
050,18,097,"Indiana","Marion County",1,19,12632,6019,6613
050,18,097,"Indiana","Marion County",1,20,12500,6091,6409
050,18,097,"Indiana","Marion County",1,21,12364,5958,6406
050,18,097,"Indiana","Marion County",1,22,12616,6053,6563
050,18,097,"Indiana","Marion County",1,23,14113,6723,7390
050,18,097,"Indiana","Marion County",1,24,15359,7389,7970
050,18,097,"Indiana","Marion County",1,25,16133,7784,8349
050,18,097,"Indiana","Marion County",1,26,16588,8067,8521
050,18,097,"Indiana","Marion County",1,27,17084,8249,8835
050,18,097,"Indiana","Marion County",1,28,17625,8601,9024
050,18,097,"Indiana","Marion County",1,29,17579,8396,9183
050,18,097,"Indiana","Marion County",1,30,16932,8219,8713
050,18,097,"Indiana","Marion County",1,31,16180,7876,8304
050,18,097,"Indiana","Marion County",1,32,15501,7544,7957
050,18,097,"Indiana","Marion County",1,33,15021,7313,7708
050,18,097,"Indiana","Marion County",1,34,14797,7157,7640
050,18,097,"Indiana","Marion County",1,35,14344,6995,7349
050,18,097,"Indiana","Marion County",1,36,13890,6815,7075
050,18,097,"Indiana","Marion County",1,37,13793,6753,7040
050,18,097,"Indiana","Marion County",1,38,13280,6481,6799
050,18,097,"Indiana","Marion County",1,39,13417,6598,6819
050,18,097,"Indiana","Marion County",1,40,13151,6485,6666
050,18,097,"Indiana","Marion County",1,41,12400,6111,6289
050,18,097,"Indiana","Marion County",1,42,12010,5930,6080
050,18,097,"Indiana","Marion County",1,43,11457,5621,5836
050,18,097,"Indiana","Marion County",1,44,11163,5438,5725
050,18,097,"Indiana","Marion County",1,45,11092,5435,5657
050,18,097,"Indiana","Marion County",1,46,10640,5138,5502
050,18,097,"Indiana","Marion County",1,47,10861,5276,5585
050,18,097,"Indiana","Marion County",1,48,11393,5653,5740
050,18,097,"Indiana","Marion County",1,49,12024,5917,6107
050,18,097,"Indiana","Marion County",1,50,11276,5468,5808
050,18,097,"Indiana","Marion County",1,51,10847,5254,5593
050,18,097,"Indiana","Marion County",1,52,10643,5164,5479
050,18,097,"Indiana","Marion County",1,53,10676,5177,5499
050,18,097,"Indiana","Marion County",1,54,11041,5367,5674
050,18,097,"Indiana","Marion County",1,55,11706,5664,6042
050,18,097,"Indiana","Marion County",1,56,11836,5754,6082
050,18,097,"Indiana","Marion County",1,57,11693,5648,6045
050,18,097,"Indiana","Marion County",1,58,11974,5763,6211
050,18,097,"Indiana","Marion County",1,59,11950,5691,6259
050,18,097,"Indiana","Marion County",1,60,11688,5542,6146
050,18,097,"Indiana","Marion County",1,61,11576,5496,6080
050,18,097,"Indiana","Marion County",1,62,11369,5386,5983
050,18,097,"Indiana","Marion County",1,63,10786,5140,5646
050,18,097,"Indiana","Marion County",1,64,10351,4880,5471
050,18,097,"Indiana","Marion County",1,65,9767,4549,5218
050,18,097,"Indiana","Marion County",1,66,9234,4244,4990
050,18,097,"Indiana","Marion County",1,67,8928,4080,4848
050,18,097,"Indiana","Marion County",1,68,8433,3845,4588
050,18,097,"Indiana","Marion County",1,69,7617,3490,4127
050,18,097,"Indiana","Marion County",1,70,7198,3279,3919
050,18,097,"Indiana","Marion County",1,71,6877,3111,3766
050,18,097,"Indiana","Marion County",1,72,6692,3023,3669
050,18,097,"Indiana","Marion County",1,73,6381,2842,3539
050,18,097,"Indiana","Marion County",1,74,4395,1914,2481
050,18,097,"Indiana","Marion County",1,75,4307,1862,2445
050,18,097,"Indiana","Marion County",1,76,4241,1821,2420
050,18,097,"Indiana","Marion County",1,77,4288,1799,2489
050,18,097,"Indiana","Marion County",1,78,3693,1518,2175
050,18,097,"Indiana","Marion County",1,79,3225,1323,1902
050,18,097,"Indiana","Marion County",1,80,2932,1196,1736
050,18,097,"Indiana","Marion County",1,81,2815,1151,1664
050,18,097,"Indiana","Marion County",1,82,2595,1000,1595
050,18,097,"Indiana","Marion County",1,83,2251,855,1396
050,18,097,"Indiana","Marion County",1,84,2131,821,1310
050,18,097,"Indiana","Marion County",1,85,13314,4250,9064
050,18,097,"Indiana","Marion County",2,0,13842,7038,6804
050,18,097,"Indiana","Marion County",2,1,13907,7082,6825
050,18,097,"Indiana","Marion County",2,2,14094,7243,6851
050,18,097,"Indiana","Marion County",2,3,13939,7174,6765
050,18,097,"Indiana","Marion County",2,4,14013,7259,6754
050,18,097,"Indiana","Marion County",2,5,14123,7254,6869
050,18,097,"Indiana","Marion County",2,6,13811,7051,6760
050,18,097,"Indiana","Marion County",2,7,13697,6967,6730
050,18,097,"Indiana","Marion County",2,8,13543,6876,6667
050,18,097,"Indiana","Marion County",2,9,13505,6871,6634
050,18,097,"Indiana","Marion County",2,10,13673,7000,6673
050,18,097,"Indiana","Marion County",2,11,13877,7056,6821
050,18,097,"Indiana","Marion County",2,12,14258,7261,6997
050,18,097,"Indiana","Marion County",2,13,14035,7233,6802
050,18,097,"Indiana","Marion County",2,14,13482,6964,6518
050,18,097,"Indiana","Marion County",2,15,13010,6703,6307
050,18,097,"Indiana","Marion County",2,16,12917,6669,6248
050,18,097,"Indiana","Marion County",2,17,12658,6471,6187
050,18,097,"Indiana","Marion County",2,18,11736,5936,5800
050,18,097,"Indiana","Marion County",2,19,12652,6039,6613
050,18,097,"Indiana","Marion County",2,20,12630,6142,6488
050,18,097,"Indiana","Marion County",2,21,12422,5985,6437
050,18,097,"Indiana","Marion County",2,22,12764,6123,6641
050,18,097,"Indiana","Marion County",2,23,14070,6706,7364
050,18,097,"Indiana","Marion County",2,24,15217,7317,7900
050,18,097,"Indiana","Marion County",2,25,16051,7744,8307
050,18,097,"Indiana","Marion County",2,26,16552,8046,8506
050,18,097,"Indiana","Marion County",2,27,16943,8221,8722
050,18,097,"Indiana","Marion County",2,28,17479,8518,8961
050,18,097,"Indiana","Marion County",2,29,17524,8409,9115
050,18,097,"Indiana","Marion County",2,30,17098,8272,8826
050,18,097,"Indiana","Marion County",2,31,16261,7919,8342
050,18,097,"Indiana","Marion County",2,32,15552,7568,7984
050,18,097,"Indiana","Marion County",2,33,15038,7319,7719
050,18,097,"Indiana","Marion County",2,34,14776,7149,7627
050,18,097,"Indiana","Marion County",2,35,14474,7052,7422
050,18,097,"Indiana","Marion County",2,36,13869,6800,7069
050,18,097,"Indiana","Marion County",2,37,13772,6744,7028
050,18,097,"Indiana","Marion County",2,38,13407,6548,6859
050,18,097,"Indiana","Marion County",2,39,13276,6512,6764
050,18,097,"Indiana","Marion County",2,40,13251,6530,6721
050,18,097,"Indiana","Marion County",2,41,12514,6149,6365
050,18,097,"Indiana","Marion County",2,42,11997,5917,6080
050,18,097,"Indiana","Marion County",2,43,11624,5704,5920
050,18,097,"Indiana","Marion County",2,44,11099,5421,5678
050,18,097,"Indiana","Marion County",2,45,11110,5445,5665
050,18,097,"Indiana","Marion County",2,46,10685,5184,5501
050,18,097,"Indiana","Marion County",2,47,10752,5210,5542
050,18,097,"Indiana","Marion County",2,48,11263,5561,5702
050,18,097,"Indiana","Marion County",2,49,11890,5848,6042
050,18,097,"Indiana","Marion County",2,50,11443,5570,5873
050,18,097,"Indiana","Marion County",2,51,10874,5264,5610
050,18,097,"Indiana","Marion County",2,52,10658,5170,5488
050,18,097,"Indiana","Marion County",2,53,10626,5139,5487
050,18,097,"Indiana","Marion County",2,54,10891,5295,5596
050,18,097,"Indiana","Marion County",2,55,11494,5572,5922
050,18,097,"Indiana","Marion County",2,56,11780,5720,6060
050,18,097,"Indiana","Marion County",2,57,11684,5647,6037
050,18,097,"Indiana","Marion County",2,58,11837,5699,6138
050,18,097,"Indiana","Marion County",2,59,11942,5701,6241
050,18,097,"Indiana","Marion County",2,60,11657,5532,6125
050,18,097,"Indiana","Marion County",2,61,11520,5461,6059
050,18,097,"Indiana","Marion County",2,62,11316,5349,5967
050,18,097,"Indiana","Marion County",2,63,10946,5193,5753
050,18,097,"Indiana","Marion County",2,64,10318,4873,5445
050,18,097,"Indiana","Marion County",2,65,9810,4581,5229
050,18,097,"Indiana","Marion County",2,66,9300,4289,5011
050,18,097,"Indiana","Marion County",2,67,8892,4061,4831
050,18,097,"Indiana","Marion County",2,68,8413,3834,4579
050,18,097,"Indiana","Marion County",2,69,7790,3553,4237
050,18,097,"Indiana","Marion County",2,70,7203,3281,3922
050,18,097,"Indiana","Marion County",2,71,6883,3106,3777
050,18,097,"Indiana","Marion County",2,72,6559,2957,3602
050,18,097,"Indiana","Marion County",2,73,6667,2975,3692
050,18,097,"Indiana","Marion County",2,74,4545,1979,2566
050,18,097,"Indiana","Marion County",2,75,4291,1844,2447
050,18,097,"Indiana","Marion County",2,76,4168,1798,2370
050,18,097,"Indiana","Marion County",2,77,4315,1824,2491
050,18,097,"Indiana","Marion County",2,78,3715,1526,2189
050,18,097,"Indiana","Marion County",2,79,3263,1338,1925
050,18,097,"Indiana","Marion County",2,80,2967,1204,1763
050,18,097,"Indiana","Marion County",2,81,2764,1128,1636
050,18,097,"Indiana","Marion County",2,82,2583,1001,1582
050,18,097,"Indiana","Marion County",2,83,2271,867,1404
050,18,097,"Indiana","Marion County",2,84,2085,796,1289
050,18,097,"Indiana","Marion County",2,85,13057,4161,8896
050,18,097,"Indiana","Marion County",3,0,13140,6665,6475
050,18,097,"Indiana","Marion County",3,1,13566,6890,6676
050,18,097,"Indiana","Marion County",3,2,13568,6849,6719
050,18,097,"Indiana","Marion County",3,3,13865,7137,6728
050,18,097,"Indiana","Marion County",3,4,13689,7012,6677
050,18,097,"Indiana","Marion County",3,5,13707,7101,6606
050,18,097,"Indiana","Marion County",3,6,13882,7120,6762
050,18,097,"Indiana","Marion County",3,7,13663,7014,6649
050,18,097,"Indiana","Marion County",3,8,13550,6841,6709
050,18,097,"Indiana","Marion County",3,9,13433,6781,6652
050,18,097,"Indiana","Marion County",3,10,13347,6786,6561
050,18,097,"Indiana","Marion County",3,11,13497,6887,6610
050,18,097,"Indiana","Marion County",3,12,13777,6999,6778
050,18,097,"Indiana","Marion County",3,13,14065,7190,6875
050,18,097,"Indiana","Marion County",3,14,13982,7205,6777
050,18,097,"Indiana","Marion County",3,15,13333,6875,6458
050,18,097,"Indiana","Marion County",3,16,12975,6682,6293
050,18,097,"Indiana","Marion County",3,17,12773,6593,6180
050,18,097,"Indiana","Marion County",3,18,11860,6048,5812
050,18,097,"Indiana","Marion County",3,19,12593,6036,6557
050,18,097,"Indiana","Marion County",3,20,12600,6114,6486
050,18,097,"Indiana","Marion County",3,21,12640,6089,6551
050,18,097,"Indiana","Marion County",3,22,12599,6084,6515
050,18,097,"Indiana","Marion County",3,23,14057,6697,7360
050,18,097,"Indiana","Marion County",3,24,15012,7166,7846
050,18,097,"Indiana","Marion County",3,25,15551,7476,8075
050,18,097,"Indiana","Marion County",3,26,16092,7864,8228
050,18,097,"Indiana","Marion County",3,27,16361,8022,8339
050,18,097,"Indiana","Marion County",3,28,16638,8005,8633
050,18,097,"Indiana","Marion County",3,29,17049,8365,8684
050,18,097,"Indiana","Marion County",3,30,17031,8174,8857
050,18,097,"Indiana","Marion County",3,31,16689,8081,8608
050,18,097,"Indiana","Marion County",3,32,15878,7726,8152
050,18,097,"Indiana","Marion County",3,33,15106,7345,7761
050,18,097,"Indiana","Marion County",3,34,14613,7108,7505
050,18,097,"Indiana","Marion County",3,35,14451,6997,7454
050,18,097,"Indiana","Marion County",3,36,14075,6820,7255
050,18,097,"Indiana","Marion County",3,37,13482,6613,6869
050,18,097,"Indiana","Marion County",3,38,13484,6636,6848
050,18,097,"Indiana","Marion County",3,39,13095,6420,6675
050,18,097,"Indiana","Marion County",3,40,13022,6369,6653
050,18,097,"Indiana","Marion County",3,41,12978,6332,6646
050,18,097,"Indiana","Marion County",3,42,12239,5993,6246
050,18,097,"Indiana","Marion County",3,43,11753,5778,5975
050,18,097,"Indiana","Marion County",3,44,11411,5576,5835
050,18,097,"Indiana","Marion County",3,45,10908,5264,5644
050,18,097,"Indiana","Marion County",3,46,10845,5307,5538
050,18,097,"Indiana","Marion County",3,47,10518,5061,5457
050,18,097,"Indiana","Marion County",3,48,10543,5123,5420
050,18,097,"Indiana","Marion County",3,49,11001,5372,5629
050,18,097,"Indiana","Marion County",3,50,11708,5741,5967
050,18,097,"Indiana","Marion County",3,51,11245,5467,5778
050,18,097,"Indiana","Marion County",3,52,10705,5199,5506
050,18,097,"Indiana","Marion County",3,53,10465,5029,5436
050,18,097,"Indiana","Marion County",3,54,10441,5031,5410
050,18,097,"Indiana","Marion County",3,55,10626,5177,5449
050,18,097,"Indiana","Marion County",3,56,11317,5462,5855
050,18,097,"Indiana","Marion County",3,57,11528,5590,5938
050,18,097,"Indiana","Marion County",3,58,11410,5509,5901
050,18,097,"Indiana","Marion County",3,59,11533,5535,5998
050,18,097,"Indiana","Marion County",3,60,11602,5521,6081
050,18,097,"Indiana","Marion County",3,61,11345,5415,5930
050,18,097,"Indiana","Marion County",3,62,11164,5274,5890
050,18,097,"Indiana","Marion County",3,63,10965,5140,5825
050,18,097,"Indiana","Marion County",3,64,10624,5021,5603
050,18,097,"Indiana","Marion County",3,65,9967,4648,5319
050,18,097,"Indiana","Marion County",3,66,9571,4472,5099
050,18,097,"Indiana","Marion County",3,67,9082,4157,4925
050,18,097,"Indiana","Marion County",3,68,8621,3930,4691
050,18,097,"Indiana","Marion County",3,69,8113,3674,4439
050,18,097,"Indiana","Marion County",3,70,7507,3389,4118
050,18,097,"Indiana","Marion County",3,71,6939,3146,3793
050,18,097,"Indiana","Marion County",3,72,6600,2971,3629
050,18,097,"Indiana","Marion County",3,73,6325,2816,3509
050,18,097,"Indiana","Marion County",3,74,6422,2843,3579
050,18,097,"Indiana","Marion County",3,75,4345,1881,2464
050,18,097,"Indiana","Marion County",3,76,4062,1742,2320
050,18,097,"Indiana","Marion County",3,77,3981,1706,2275
050,18,097,"Indiana","Marion County",3,78,4036,1693,2343
050,18,097,"Indiana","Marion County",3,79,3526,1422,2104
050,18,097,"Indiana","Marion County",3,80,3098,1249,1849
050,18,097,"Indiana","Marion County",3,81,2734,1105,1629
050,18,097,"Indiana","Marion County",3,82,2544,1015,1529
050,18,097,"Indiana","Marion County",3,83,2405,910,1495
050,18,097,"Indiana","Marion County",3,84,2084,793,1291
050,18,097,"Indiana","Marion County",3,85,12917,4111,8806
050,18,097,"Indiana","Marion County",4,0,13749,7000,6749
050,18,097,"Indiana","Marion County",4,1,12759,6452,6307
050,18,097,"Indiana","Marion County",4,2,13352,6812,6540
050,18,097,"Indiana","Marion County",4,3,13365,6835,6530
050,18,097,"Indiana","Marion County",4,4,13680,7029,6651
050,18,097,"Indiana","Marion County",4,5,13501,6903,6598
050,18,097,"Indiana","Marion County",4,6,13497,6990,6507
050,18,097,"Indiana","Marion County",4,7,13757,7026,6731
050,18,097,"Indiana","Marion County",4,8,13485,6919,6566
050,18,097,"Indiana","Marion County",4,9,13430,6781,6649
050,18,097,"Indiana","Marion County",4,10,13286,6717,6569
050,18,097,"Indiana","Marion County",4,11,13153,6698,6455
050,18,097,"Indiana","Marion County",4,12,13296,6790,6506
050,18,097,"Indiana","Marion County",4,13,13661,6943,6718
050,18,097,"Indiana","Marion County",4,14,13946,7087,6859
050,18,097,"Indiana","Marion County",4,15,13857,7102,6755
050,18,097,"Indiana","Marion County",4,16,13316,6855,6461
050,18,097,"Indiana","Marion County",4,17,12889,6668,6221
050,18,097,"Indiana","Marion County",4,18,11868,6131,5737
050,18,097,"Indiana","Marion County",4,19,12511,6053,6458
050,18,097,"Indiana","Marion County",4,20,12387,6040,6347
050,18,097,"Indiana","Marion County",4,21,12582,6046,6536
050,18,097,"Indiana","Marion County",4,22,12801,6214,6587
050,18,097,"Indiana","Marion County",4,23,13972,6595,7377
050,18,097,"Indiana","Marion County",4,24,15235,7355,7880
050,18,097,"Indiana","Marion County",4,25,15471,7434,8037
050,18,097,"Indiana","Marion County",4,26,15771,7656,8115
050,18,097,"Indiana","Marion County",4,27,16202,7898,8304
050,18,097,"Indiana","Marion County",4,28,16238,7911,8327
050,18,097,"Indiana","Marion County",4,29,16527,7993,8534
050,18,097,"Indiana","Marion County",4,30,16913,8318,8595
050,18,097,"Indiana","Marion County",4,31,16776,8089,8687
050,18,097,"Indiana","Marion County",4,32,16342,8000,8342
050,18,097,"Indiana","Marion County",4,33,15564,7660,7904
050,18,097,"Indiana","Marion County",4,34,14796,7168,7628
050,18,097,"Indiana","Marion County",4,35,14297,6988,7309
050,18,097,"Indiana","Marion County",4,36,14171,6809,7362
050,18,097,"Indiana","Marion County",4,37,13892,6708,7184
050,18,097,"Indiana","Marion County",4,38,13214,6497,6717
050,18,097,"Indiana","Marion County",4,39,13310,6491,6819
050,18,097,"Indiana","Marion County",4,40,12841,6330,6511
050,18,097,"Indiana","Marion County",4,41,12664,6223,6441
050,18,097,"Indiana","Marion County",4,42,12709,6214,6495
050,18,097,"Indiana","Marion County",4,43,12040,5908,6132
050,18,097,"Indiana","Marion County",4,44,11495,5656,5839
050,18,097,"Indiana","Marion County",4,45,11208,5452,5756
050,18,097,"Indiana","Marion County",4,46,10699,5151,5548
050,18,097,"Indiana","Marion County",4,47,10689,5192,5497
050,18,097,"Indiana","Marion County",4,48,10374,5022,5352
050,18,097,"Indiana","Marion County",4,49,10374,4985,5389
050,18,097,"Indiana","Marion County",4,50,10794,5252,5542
050,18,097,"Indiana","Marion County",4,51,11543,5648,5895
050,18,097,"Indiana","Marion County",4,52,11085,5373,5712
050,18,097,"Indiana","Marion County",4,53,10552,5074,5478
050,18,097,"Indiana","Marion County",4,54,10281,4942,5339
050,18,097,"Indiana","Marion County",4,55,10227,4900,5327
050,18,097,"Indiana","Marion County",4,56,10398,5057,5341
050,18,097,"Indiana","Marion County",4,57,11066,5332,5734
050,18,097,"Indiana","Marion County",4,58,11282,5439,5843
050,18,097,"Indiana","Marion County",4,59,11170,5367,5803
050,18,097,"Indiana","Marion County",4,60,11262,5352,5910
050,18,097,"Indiana","Marion County",4,61,11275,5345,5930
050,18,097,"Indiana","Marion County",4,62,11042,5247,5795
050,18,097,"Indiana","Marion County",4,63,10827,5116,5711
050,18,097,"Indiana","Marion County",4,64,10593,4956,5637
050,18,097,"Indiana","Marion County",4,65,10293,4857,5436
050,18,097,"Indiana","Marion County",4,66,9629,4467,5162
050,18,097,"Indiana","Marion County",4,67,9320,4334,4986
050,18,097,"Indiana","Marion County",4,68,8769,4023,4746
050,18,097,"Indiana","Marion County",4,69,8319,3771,4548
050,18,097,"Indiana","Marion County",4,70,7841,3507,4334
050,18,097,"Indiana","Marion County",4,71,7271,3265,4006
050,18,097,"Indiana","Marion County",4,72,6637,2987,3650
050,18,097,"Indiana","Marion County",4,73,6324,2827,3497
050,18,097,"Indiana","Marion County",4,74,6060,2669,3391
050,18,097,"Indiana","Marion County",4,75,6147,2707,3440
050,18,097,"Indiana","Marion County",4,76,4105,1744,2361
050,18,097,"Indiana","Marion County",4,77,3851,1627,2224
050,18,097,"Indiana","Marion County",4,78,3727,1574,2153
050,18,097,"Indiana","Marion County",4,79,3831,1579,2252
050,18,097,"Indiana","Marion County",4,80,3368,1327,2041
050,18,097,"Indiana","Marion County",4,81,2848,1146,1702
050,18,097,"Indiana","Marion County",4,82,2493,990,1503
050,18,097,"Indiana","Marion County",4,83,2337,914,1423
050,18,097,"Indiana","Marion County",4,84,2169,808,1361
050,18,097,"Indiana","Marion County",4,85,12575,4009,8566
050,18,097,"Indiana","Marion County",5,0,13748,7001,6747
050,18,097,"Indiana","Marion County",5,1,13614,6968,6646
050,18,097,"Indiana","Marion County",5,2,12705,6450,6255
050,18,097,"Indiana","Marion County",5,3,13200,6751,6449
050,18,097,"Indiana","Marion County",5,4,13222,6789,6433
050,18,097,"Indiana","Marion County",5,5,13462,6878,6584
050,18,097,"Indiana","Marion County",5,6,13366,6846,6520
050,18,097,"Indiana","Marion County",5,7,13424,6954,6470
050,18,097,"Indiana","Marion County",5,8,13625,6955,6670
050,18,097,"Indiana","Marion County",5,9,13359,6867,6492
050,18,097,"Indiana","Marion County",5,10,13276,6722,6554
050,18,097,"Indiana","Marion County",5,11,13148,6640,6508
050,18,097,"Indiana","Marion County",5,12,12970,6591,6379
050,18,097,"Indiana","Marion County",5,13,13253,6750,6503
050,18,097,"Indiana","Marion County",5,14,13477,6858,6619
050,18,097,"Indiana","Marion County",5,15,13815,7013,6802
050,18,097,"Indiana","Marion County",5,16,13768,7058,6710
050,18,097,"Indiana","Marion County",5,17,13194,6803,6391
050,18,097,"Indiana","Marion County",5,18,11946,6197,5749
050,18,097,"Indiana","Marion County",5,19,12584,6184,6400
050,18,097,"Indiana","Marion County",5,20,12529,6143,6386
050,18,097,"Indiana","Marion County",5,21,12431,5981,6450
050,18,097,"Indiana","Marion County",5,22,12691,6104,6587
050,18,097,"Indiana","Marion County",5,23,14327,6879,7448
050,18,097,"Indiana","Marion County",5,24,14900,7054,7846
050,18,097,"Indiana","Marion County",5,25,15631,7580,8051
050,18,097,"Indiana","Marion County",5,26,15775,7648,8127
050,18,097,"Indiana","Marion County",5,27,15666,7651,8015
050,18,097,"Indiana","Marion County",5,28,16045,7834,8211
050,18,097,"Indiana","Marion County",5,29,15992,7764,8228
050,18,097,"Indiana","Marion County",5,30,16200,7858,8342
050,18,097,"Indiana","Marion County",5,31,16642,8222,8420
050,18,097,"Indiana","Marion County",5,32,16391,7974,8417
050,18,097,"Indiana","Marion County",5,33,16106,7924,8182
050,18,097,"Indiana","Marion County",5,34,15173,7393,7780
050,18,097,"Indiana","Marion County",5,35,14380,6969,7411
050,18,097,"Indiana","Marion County",5,36,14091,6864,7227
050,18,097,"Indiana","Marion County",5,37,13925,6718,7207
050,18,097,"Indiana","Marion County",5,38,13656,6606,7050
050,18,097,"Indiana","Marion County",5,39,12908,6306,6602
050,18,097,"Indiana","Marion County",5,40,13036,6372,6664
050,18,097,"Indiana","Marion County",5,41,12637,6233,6404
050,18,097,"Indiana","Marion County",5,42,12426,6117,6309
050,18,097,"Indiana","Marion County",5,43,12506,6135,6371
050,18,097,"Indiana","Marion County",5,44,11803,5809,5994
050,18,097,"Indiana","Marion County",5,45,11370,5565,5805
050,18,097,"Indiana","Marion County",5,46,11055,5365,5690
050,18,097,"Indiana","Marion County",5,47,10564,5090,5474
050,18,097,"Indiana","Marion County",5,48,10625,5182,5443
050,18,097,"Indiana","Marion County",5,49,10284,4932,5352
050,18,097,"Indiana","Marion County",5,50,10268,4934,5334
050,18,097,"Indiana","Marion County",5,51,10688,5208,5480
050,18,097,"Indiana","Marion County",5,52,11346,5571,5775
050,18,097,"Indiana","Marion County",5,53,10919,5265,5654
050,18,097,"Indiana","Marion County",5,54,10413,4971,5442
050,18,097,"Indiana","Marion County",5,55,10075,4815,5260
050,18,097,"Indiana","Marion County",5,56,10084,4831,5253
050,18,097,"Indiana","Marion County",5,57,10188,4944,5244
050,18,097,"Indiana","Marion County",5,58,10892,5233,5659
050,18,097,"Indiana","Marion County",5,59,11037,5307,5730
050,18,097,"Indiana","Marion County",5,60,10867,5195,5672
050,18,097,"Indiana","Marion County",5,61,11036,5234,5802
050,18,097,"Indiana","Marion County",5,62,10947,5144,5803
050,18,097,"Indiana","Marion County",5,63,10685,5037,5648
050,18,097,"Indiana","Marion County",5,64,10518,4962,5556
050,18,097,"Indiana","Marion County",5,65,10301,4783,5518
050,18,097,"Indiana","Marion County",5,66,9997,4700,5297
050,18,097,"Indiana","Marion County",5,67,9392,4353,5039
050,18,097,"Indiana","Marion County",5,68,9009,4180,4829
050,18,097,"Indiana","Marion County",5,69,8503,3878,4625
050,18,097,"Indiana","Marion County",5,70,8067,3599,4468
050,18,097,"Indiana","Marion County",5,71,7621,3413,4208
050,18,097,"Indiana","Marion County",5,72,7034,3157,3877
050,18,097,"Indiana","Marion County",5,73,6410,2875,3535
050,18,097,"Indiana","Marion County",5,74,6107,2715,3392
050,18,097,"Indiana","Marion County",5,75,5842,2567,3275
050,18,097,"Indiana","Marion County",5,76,5838,2554,3284
050,18,097,"Indiana","Marion County",5,77,3924,1670,2254
050,18,097,"Indiana","Marion County",5,78,3651,1532,2119
050,18,097,"Indiana","Marion County",5,79,3549,1496,2053
050,18,097,"Indiana","Marion County",5,80,3670,1481,2189
050,18,097,"Indiana","Marion County",5,81,3104,1216,1888
050,18,097,"Indiana","Marion County",5,82,2641,1030,1611
050,18,097,"Indiana","Marion County",5,83,2304,883,1421
050,18,097,"Indiana","Marion County",5,84,2129,821,1308
050,18,097,"Indiana","Marion County",5,85,12483,3964,8519
050,18,099,"Indiana","Marshall County",1,0,519,268,251
050,18,099,"Indiana","Marshall County",1,1,533,277,256
050,18,099,"Indiana","Marshall County",1,2,583,294,289
050,18,099,"Indiana","Marshall County",1,3,614,314,300
050,18,099,"Indiana","Marshall County",1,4,636,316,320
050,18,099,"Indiana","Marshall County",1,5,583,294,289
050,18,099,"Indiana","Marshall County",1,6,555,295,260
050,18,099,"Indiana","Marshall County",1,7,604,323,281
050,18,099,"Indiana","Marshall County",1,8,605,301,304
050,18,099,"Indiana","Marshall County",1,9,588,308,280
050,18,099,"Indiana","Marshall County",1,10,651,363,288
050,18,099,"Indiana","Marshall County",1,11,692,366,326
050,18,099,"Indiana","Marshall County",1,12,760,386,374
050,18,099,"Indiana","Marshall County",1,13,723,366,357
050,18,099,"Indiana","Marshall County",1,14,720,367,353
050,18,099,"Indiana","Marshall County",1,15,724,370,354
050,18,099,"Indiana","Marshall County",1,16,756,381,375
050,18,099,"Indiana","Marshall County",1,17,714,359,355
050,18,099,"Indiana","Marshall County",1,18,614,327,287
050,18,099,"Indiana","Marshall County",1,19,547,295,252
050,18,099,"Indiana","Marshall County",1,20,513,271,242
050,18,099,"Indiana","Marshall County",1,21,553,294,259
050,18,099,"Indiana","Marshall County",1,22,558,310,248
050,18,099,"Indiana","Marshall County",1,23,530,274,256
050,18,099,"Indiana","Marshall County",1,24,534,270,264
050,18,099,"Indiana","Marshall County",1,25,536,269,267
050,18,099,"Indiana","Marshall County",1,26,522,283,239
050,18,099,"Indiana","Marshall County",1,27,515,290,225
050,18,099,"Indiana","Marshall County",1,28,540,287,253
050,18,099,"Indiana","Marshall County",1,29,467,246,221
050,18,099,"Indiana","Marshall County",1,30,523,257,266
050,18,099,"Indiana","Marshall County",1,31,499,251,248
050,18,099,"Indiana","Marshall County",1,32,456,236,220
050,18,099,"Indiana","Marshall County",1,33,489,247,242
050,18,099,"Indiana","Marshall County",1,34,489,231,258
050,18,099,"Indiana","Marshall County",1,35,483,233,250
050,18,099,"Indiana","Marshall County",1,36,518,279,239
050,18,099,"Indiana","Marshall County",1,37,538,282,256
050,18,099,"Indiana","Marshall County",1,38,541,278,263
050,18,099,"Indiana","Marshall County",1,39,582,308,274
050,18,099,"Indiana","Marshall County",1,40,552,282,270
050,18,099,"Indiana","Marshall County",1,41,530,268,262
050,18,099,"Indiana","Marshall County",1,42,521,259,262
050,18,099,"Indiana","Marshall County",1,43,548,281,267
050,18,099,"Indiana","Marshall County",1,44,531,267,264
050,18,099,"Indiana","Marshall County",1,45,571,284,287
050,18,099,"Indiana","Marshall County",1,46,536,272,264
050,18,099,"Indiana","Marshall County",1,47,538,284,254
050,18,099,"Indiana","Marshall County",1,48,557,281,276
050,18,099,"Indiana","Marshall County",1,49,617,316,301
050,18,099,"Indiana","Marshall County",1,50,586,292,294
050,18,099,"Indiana","Marshall County",1,51,534,270,264
050,18,099,"Indiana","Marshall County",1,52,577,291,286
050,18,099,"Indiana","Marshall County",1,53,580,285,295
050,18,099,"Indiana","Marshall County",1,54,584,302,282
050,18,099,"Indiana","Marshall County",1,55,631,340,291
050,18,099,"Indiana","Marshall County",1,56,659,349,310
050,18,099,"Indiana","Marshall County",1,57,624,307,317
050,18,099,"Indiana","Marshall County",1,58,645,317,328
050,18,099,"Indiana","Marshall County",1,59,642,321,321
050,18,099,"Indiana","Marshall County",1,60,614,330,284
050,18,099,"Indiana","Marshall County",1,61,604,316,288
050,18,099,"Indiana","Marshall County",1,62,618,316,302
050,18,099,"Indiana","Marshall County",1,63,625,310,315
050,18,099,"Indiana","Marshall County",1,64,598,297,301
050,18,099,"Indiana","Marshall County",1,65,607,302,305
050,18,099,"Indiana","Marshall County",1,66,572,277,295
050,18,099,"Indiana","Marshall County",1,67,603,286,317
050,18,099,"Indiana","Marshall County",1,68,543,262,281
050,18,099,"Indiana","Marshall County",1,69,473,244,229
050,18,099,"Indiana","Marshall County",1,70,451,218,233
050,18,099,"Indiana","Marshall County",1,71,454,214,240
050,18,099,"Indiana","Marshall County",1,72,431,218,213
050,18,099,"Indiana","Marshall County",1,73,438,223,215
050,18,099,"Indiana","Marshall County",1,74,290,139,151
050,18,099,"Indiana","Marshall County",1,75,287,135,152
050,18,099,"Indiana","Marshall County",1,76,323,144,179
050,18,099,"Indiana","Marshall County",1,77,331,148,183
050,18,099,"Indiana","Marshall County",1,78,276,130,146
050,18,099,"Indiana","Marshall County",1,79,251,112,139
050,18,099,"Indiana","Marshall County",1,80,220,101,119
050,18,099,"Indiana","Marshall County",1,81,229,106,123
050,18,099,"Indiana","Marshall County",1,82,191,85,106
050,18,099,"Indiana","Marshall County",1,83,182,75,107
050,18,099,"Indiana","Marshall County",1,84,172,63,109
050,18,099,"Indiana","Marshall County",1,85,1032,335,697
050,18,099,"Indiana","Marshall County",2,0,519,254,265
050,18,099,"Indiana","Marshall County",2,1,528,272,256
050,18,099,"Indiana","Marshall County",2,2,572,289,283
050,18,099,"Indiana","Marshall County",2,3,604,306,298
050,18,099,"Indiana","Marshall County",2,4,633,316,317
050,18,099,"Indiana","Marshall County",2,5,594,300,294
050,18,099,"Indiana","Marshall County",2,6,564,296,268
050,18,099,"Indiana","Marshall County",2,7,591,315,276
050,18,099,"Indiana","Marshall County",2,8,603,306,297
050,18,099,"Indiana","Marshall County",2,9,588,307,281
050,18,099,"Indiana","Marshall County",2,10,637,350,287
050,18,099,"Indiana","Marshall County",2,11,684,366,318
050,18,099,"Indiana","Marshall County",2,12,749,384,365
050,18,099,"Indiana","Marshall County",2,13,729,371,358
050,18,099,"Indiana","Marshall County",2,14,724,370,354
050,18,099,"Indiana","Marshall County",2,15,725,370,355
050,18,099,"Indiana","Marshall County",2,16,751,380,371
050,18,099,"Indiana","Marshall County",2,17,723,364,359
050,18,099,"Indiana","Marshall County",2,18,610,324,286
050,18,099,"Indiana","Marshall County",2,19,538,288,250
050,18,099,"Indiana","Marshall County",2,20,531,282,249
050,18,099,"Indiana","Marshall County",2,21,548,290,258
050,18,099,"Indiana","Marshall County",2,22,559,306,253
050,18,099,"Indiana","Marshall County",2,23,539,283,256
050,18,099,"Indiana","Marshall County",2,24,533,269,264
050,18,099,"Indiana","Marshall County",2,25,531,269,262
050,18,099,"Indiana","Marshall County",2,26,523,279,244
050,18,099,"Indiana","Marshall County",2,27,516,289,227
050,18,099,"Indiana","Marshall County",2,28,531,287,244
050,18,099,"Indiana","Marshall County",2,29,487,255,232
050,18,099,"Indiana","Marshall County",2,30,515,258,257
050,18,099,"Indiana","Marshall County",2,31,506,256,250
050,18,099,"Indiana","Marshall County",2,32,466,239,227
050,18,099,"Indiana","Marshall County",2,33,481,246,235
050,18,099,"Indiana","Marshall County",2,34,492,236,256
050,18,099,"Indiana","Marshall County",2,35,486,233,253
050,18,099,"Indiana","Marshall County",2,36,509,268,241
050,18,099,"Indiana","Marshall County",2,37,534,280,254
050,18,099,"Indiana","Marshall County",2,38,541,279,262
050,18,099,"Indiana","Marshall County",2,39,571,302,269
050,18,099,"Indiana","Marshall County",2,40,564,291,273
050,18,099,"Indiana","Marshall County",2,41,534,272,262
050,18,099,"Indiana","Marshall County",2,42,517,257,260
050,18,099,"Indiana","Marshall County",2,43,543,275,268
050,18,099,"Indiana","Marshall County",2,44,531,268,263
050,18,099,"Indiana","Marshall County",2,45,561,281,280
050,18,099,"Indiana","Marshall County",2,46,543,275,268
050,18,099,"Indiana","Marshall County",2,47,539,282,257
050,18,099,"Indiana","Marshall County",2,48,550,281,269
050,18,099,"Indiana","Marshall County",2,49,607,311,296
050,18,099,"Indiana","Marshall County",2,50,595,298,297
050,18,099,"Indiana","Marshall County",2,51,542,271,271
050,18,099,"Indiana","Marshall County",2,52,567,287,280
050,18,099,"Indiana","Marshall County",2,53,579,287,292
050,18,099,"Indiana","Marshall County",2,54,579,294,285
050,18,099,"Indiana","Marshall County",2,55,625,333,292
050,18,099,"Indiana","Marshall County",2,56,650,347,303
050,18,099,"Indiana","Marshall County",2,57,632,316,316
050,18,099,"Indiana","Marshall County",2,58,640,315,325
050,18,099,"Indiana","Marshall County",2,59,644,321,323
050,18,099,"Indiana","Marshall County",2,60,614,325,289
050,18,099,"Indiana","Marshall County",2,61,606,319,287
050,18,099,"Indiana","Marshall County",2,62,614,317,297
050,18,099,"Indiana","Marshall County",2,63,630,313,317
050,18,099,"Indiana","Marshall County",2,64,597,298,299
050,18,099,"Indiana","Marshall County",2,65,605,301,304
050,18,099,"Indiana","Marshall County",2,66,579,281,298
050,18,099,"Indiana","Marshall County",2,67,595,283,312
050,18,099,"Indiana","Marshall County",2,68,554,266,288
050,18,099,"Indiana","Marshall County",2,69,493,251,242
050,18,099,"Indiana","Marshall County",2,70,452,222,230
050,18,099,"Indiana","Marshall County",2,71,448,213,235
050,18,099,"Indiana","Marshall County",2,72,423,211,212
050,18,099,"Indiana","Marshall County",2,73,457,232,225
050,18,099,"Indiana","Marshall County",2,74,302,147,155
050,18,099,"Indiana","Marshall County",2,75,283,132,151
050,18,099,"Indiana","Marshall County",2,76,309,140,169
050,18,099,"Indiana","Marshall County",2,77,335,150,185
050,18,099,"Indiana","Marshall County",2,78,276,127,149
050,18,099,"Indiana","Marshall County",2,79,255,113,142
050,18,099,"Indiana","Marshall County",2,80,224,103,121
050,18,099,"Indiana","Marshall County",2,81,229,105,124
050,18,099,"Indiana","Marshall County",2,82,200,90,110
050,18,099,"Indiana","Marshall County",2,83,184,75,109
050,18,099,"Indiana","Marshall County",2,84,170,64,106
050,18,099,"Indiana","Marshall County",2,85,1030,331,699
050,18,099,"Indiana","Marshall County",3,0,522,276,246
050,18,099,"Indiana","Marshall County",3,1,567,270,297
050,18,099,"Indiana","Marshall County",3,2,538,279,259
050,18,099,"Indiana","Marshall County",3,3,567,283,284
050,18,099,"Indiana","Marshall County",3,4,613,318,295
050,18,099,"Indiana","Marshall County",3,5,641,316,325
050,18,099,"Indiana","Marshall County",3,6,599,298,301
050,18,099,"Indiana","Marshall County",3,7,578,306,272
050,18,099,"Indiana","Marshall County",3,8,596,312,284
050,18,099,"Indiana","Marshall County",3,9,621,315,306
050,18,099,"Indiana","Marshall County",3,10,605,313,292
050,18,099,"Indiana","Marshall County",3,11,651,358,293
050,18,099,"Indiana","Marshall County",3,12,675,365,310
050,18,099,"Indiana","Marshall County",3,13,770,395,375
050,18,099,"Indiana","Marshall County",3,14,739,384,355
050,18,099,"Indiana","Marshall County",3,15,728,370,358
050,18,099,"Indiana","Marshall County",3,16,731,375,356
050,18,099,"Indiana","Marshall County",3,17,758,374,384
050,18,099,"Indiana","Marshall County",3,18,630,319,311
050,18,099,"Indiana","Marshall County",3,19,510,278,232
050,18,099,"Indiana","Marshall County",3,20,564,307,257
050,18,099,"Indiana","Marshall County",3,21,540,277,263
050,18,099,"Indiana","Marshall County",3,22,558,285,273
050,18,099,"Indiana","Marshall County",3,23,566,300,266
050,18,099,"Indiana","Marshall County",3,24,495,268,227
050,18,099,"Indiana","Marshall County",3,25,522,270,252
050,18,099,"Indiana","Marshall County",3,26,529,272,257
050,18,099,"Indiana","Marshall County",3,27,531,284,247
050,18,099,"Indiana","Marshall County",3,28,516,285,231
050,18,099,"Indiana","Marshall County",3,29,539,300,239
050,18,099,"Indiana","Marshall County",3,30,502,261,241
050,18,099,"Indiana","Marshall County",3,31,544,275,269
050,18,099,"Indiana","Marshall County",3,32,508,251,257
050,18,099,"Indiana","Marshall County",3,33,481,251,230
050,18,099,"Indiana","Marshall County",3,34,480,241,239
050,18,099,"Indiana","Marshall County",3,35,498,237,261
050,18,099,"Indiana","Marshall County",3,36,505,245,260
050,18,099,"Indiana","Marshall County",3,37,517,272,245
050,18,099,"Indiana","Marshall County",3,38,539,279,260
050,18,099,"Indiana","Marshall County",3,39,556,288,268
050,18,099,"Indiana","Marshall County",3,40,563,301,262
050,18,099,"Indiana","Marshall County",3,41,568,286,282
050,18,099,"Indiana","Marshall County",3,42,530,261,269
050,18,099,"Indiana","Marshall County",3,43,521,255,266
050,18,099,"Indiana","Marshall County",3,44,538,275,263
050,18,099,"Indiana","Marshall County",3,45,535,267,268
050,18,099,"Indiana","Marshall County",3,46,554,275,279
050,18,099,"Indiana","Marshall County",3,47,540,275,265
050,18,099,"Indiana","Marshall County",3,48,528,281,247
050,18,099,"Indiana","Marshall County",3,49,554,291,263
050,18,099,"Indiana","Marshall County",3,50,622,318,304
050,18,099,"Indiana","Marshall County",3,51,580,294,286
050,18,099,"Indiana","Marshall County",3,52,549,265,284
050,18,099,"Indiana","Marshall County",3,53,570,288,282
050,18,099,"Indiana","Marshall County",3,54,584,282,302
050,18,099,"Indiana","Marshall County",3,55,588,296,292
050,18,099,"Indiana","Marshall County",3,56,604,326,278
050,18,099,"Indiana","Marshall County",3,57,645,343,302
050,18,099,"Indiana","Marshall County",3,58,637,313,324
050,18,099,"Indiana","Marshall County",3,59,639,315,324
050,18,099,"Indiana","Marshall County",3,60,637,321,316
050,18,099,"Indiana","Marshall County",3,61,616,323,293
050,18,099,"Indiana","Marshall County",3,62,602,321,281
050,18,099,"Indiana","Marshall County",3,63,616,316,300
050,18,099,"Indiana","Marshall County",3,64,607,297,310
050,18,099,"Indiana","Marshall County",3,65,584,288,296
050,18,099,"Indiana","Marshall County",3,66,589,291,298
050,18,099,"Indiana","Marshall County",3,67,570,278,292
050,18,099,"Indiana","Marshall County",3,68,577,274,303
050,18,099,"Indiana","Marshall County",3,69,543,263,280
050,18,099,"Indiana","Marshall County",3,70,479,243,236
050,18,099,"Indiana","Marshall County",3,71,434,212,222
050,18,099,"Indiana","Marshall County",3,72,431,208,223
050,18,099,"Indiana","Marshall County",3,73,421,203,218
050,18,099,"Indiana","Marshall County",3,74,433,217,216
050,18,099,"Indiana","Marshall County",3,75,289,138,151
050,18,099,"Indiana","Marshall County",3,76,271,131,140
050,18,099,"Indiana","Marshall County",3,77,295,127,168
050,18,099,"Indiana","Marshall County",3,78,308,140,168
050,18,099,"Indiana","Marshall County",3,79,263,118,145
050,18,099,"Indiana","Marshall County",3,80,235,102,133
050,18,099,"Indiana","Marshall County",3,81,212,91,121
050,18,099,"Indiana","Marshall County",3,82,210,99,111
050,18,099,"Indiana","Marshall County",3,83,191,78,113
050,18,099,"Indiana","Marshall County",3,84,161,68,93
050,18,099,"Indiana","Marshall County",3,85,1008,336,672
050,18,099,"Indiana","Marshall County",4,0,552,284,268
050,18,099,"Indiana","Marshall County",4,1,531,283,248
050,18,099,"Indiana","Marshall County",4,2,566,270,296
050,18,099,"Indiana","Marshall County",4,3,552,277,275
050,18,099,"Indiana","Marshall County",4,4,567,297,270
050,18,099,"Indiana","Marshall County",4,5,608,314,294
050,18,099,"Indiana","Marshall County",4,6,668,330,338
050,18,099,"Indiana","Marshall County",4,7,605,293,312
050,18,099,"Indiana","Marshall County",4,8,592,302,290
050,18,099,"Indiana","Marshall County",4,9,606,313,293
050,18,099,"Indiana","Marshall County",4,10,631,323,308
050,18,099,"Indiana","Marshall County",4,11,598,307,291
050,18,099,"Indiana","Marshall County",4,12,654,361,293
050,18,099,"Indiana","Marshall County",4,13,670,363,307
050,18,099,"Indiana","Marshall County",4,14,758,393,365
050,18,099,"Indiana","Marshall County",4,15,756,403,353
050,18,099,"Indiana","Marshall County",4,16,720,369,351
050,18,099,"Indiana","Marshall County",4,17,732,374,358
050,18,099,"Indiana","Marshall County",4,18,644,328,316
050,18,099,"Indiana","Marshall County",4,19,518,263,255
050,18,099,"Indiana","Marshall County",4,20,537,292,245
050,18,099,"Indiana","Marshall County",4,21,578,314,264
050,18,099,"Indiana","Marshall County",4,22,566,273,293
050,18,099,"Indiana","Marshall County",4,23,561,305,256
050,18,099,"Indiana","Marshall County",4,24,554,301,253
050,18,099,"Indiana","Marshall County",4,25,508,272,236
050,18,099,"Indiana","Marshall County",4,26,535,282,253
050,18,099,"Indiana","Marshall County",4,27,537,283,254
050,18,099,"Indiana","Marshall County",4,28,524,275,249
050,18,099,"Indiana","Marshall County",4,29,526,277,249
050,18,099,"Indiana","Marshall County",4,30,550,305,245
050,18,099,"Indiana","Marshall County",4,31,526,273,253
050,18,099,"Indiana","Marshall County",4,32,537,271,266
050,18,099,"Indiana","Marshall County",4,33,514,253,261
050,18,099,"Indiana","Marshall County",4,34,472,243,229
050,18,099,"Indiana","Marshall County",4,35,491,245,246
050,18,099,"Indiana","Marshall County",4,36,504,244,260
050,18,099,"Indiana","Marshall County",4,37,520,248,272
050,18,099,"Indiana","Marshall County",4,38,510,266,244
050,18,099,"Indiana","Marshall County",4,39,549,293,256
050,18,099,"Indiana","Marshall County",4,40,556,281,275
050,18,099,"Indiana","Marshall County",4,41,568,299,269
050,18,099,"Indiana","Marshall County",4,42,564,286,278
050,18,099,"Indiana","Marshall County",4,43,527,260,267
050,18,099,"Indiana","Marshall County",4,44,528,275,253
050,18,099,"Indiana","Marshall County",4,45,539,274,265
050,18,099,"Indiana","Marshall County",4,46,542,266,276
050,18,099,"Indiana","Marshall County",4,47,576,299,277
050,18,099,"Indiana","Marshall County",4,48,543,274,269
050,18,099,"Indiana","Marshall County",4,49,523,280,243
050,18,099,"Indiana","Marshall County",4,50,558,290,268
050,18,099,"Indiana","Marshall County",4,51,631,326,305
050,18,099,"Indiana","Marshall County",4,52,579,295,284
050,18,099,"Indiana","Marshall County",4,53,544,272,272
050,18,099,"Indiana","Marshall County",4,54,566,273,293
050,18,099,"Indiana","Marshall County",4,55,584,283,301
050,18,099,"Indiana","Marshall County",4,56,585,299,286
050,18,099,"Indiana","Marshall County",4,57,597,321,276
050,18,099,"Indiana","Marshall County",4,58,640,342,298
050,18,099,"Indiana","Marshall County",4,59,635,309,326
050,18,099,"Indiana","Marshall County",4,60,626,309,317
050,18,099,"Indiana","Marshall County",4,61,644,324,320
050,18,099,"Indiana","Marshall County",4,62,615,319,296
050,18,099,"Indiana","Marshall County",4,63,604,319,285
050,18,099,"Indiana","Marshall County",4,64,607,312,295
050,18,099,"Indiana","Marshall County",4,65,601,295,306
050,18,099,"Indiana","Marshall County",4,66,576,282,294
050,18,099,"Indiana","Marshall County",4,67,594,298,296
050,18,099,"Indiana","Marshall County",4,68,561,268,293
050,18,099,"Indiana","Marshall County",4,69,569,270,299
050,18,099,"Indiana","Marshall County",4,70,535,252,283
050,18,099,"Indiana","Marshall County",4,71,469,237,232
050,18,099,"Indiana","Marshall County",4,72,425,206,219
050,18,099,"Indiana","Marshall County",4,73,432,204,228
050,18,099,"Indiana","Marshall County",4,74,412,197,215
050,18,099,"Indiana","Marshall County",4,75,424,211,213
050,18,099,"Indiana","Marshall County",4,76,274,132,142
050,18,099,"Indiana","Marshall County",4,77,270,130,140
050,18,099,"Indiana","Marshall County",4,78,275,119,156
050,18,099,"Indiana","Marshall County",4,79,295,130,165
050,18,099,"Indiana","Marshall County",4,80,240,108,132
050,18,099,"Indiana","Marshall County",4,81,228,94,134
050,18,099,"Indiana","Marshall County",4,82,205,89,116
050,18,099,"Indiana","Marshall County",4,83,201,79,122
050,18,099,"Indiana","Marshall County",4,84,177,69,108
050,18,099,"Indiana","Marshall County",4,85,1007,352,655
050,18,099,"Indiana","Marshall County",5,0,558,287,271
050,18,099,"Indiana","Marshall County",5,1,550,274,276
050,18,099,"Indiana","Marshall County",5,2,535,284,251
050,18,099,"Indiana","Marshall County",5,3,565,273,292
050,18,099,"Indiana","Marshall County",5,4,548,280,268
050,18,099,"Indiana","Marshall County",5,5,578,299,279
050,18,099,"Indiana","Marshall County",5,6,611,309,302
050,18,099,"Indiana","Marshall County",5,7,667,326,341
050,18,099,"Indiana","Marshall County",5,8,603,293,310
050,18,099,"Indiana","Marshall County",5,9,573,292,281
050,18,099,"Indiana","Marshall County",5,10,603,309,294
050,18,099,"Indiana","Marshall County",5,11,628,322,306
050,18,099,"Indiana","Marshall County",5,12,595,309,286
050,18,099,"Indiana","Marshall County",5,13,657,359,298
050,18,099,"Indiana","Marshall County",5,14,670,365,305
050,18,099,"Indiana","Marshall County",5,15,758,393,365
050,18,099,"Indiana","Marshall County",5,16,741,401,340
050,18,099,"Indiana","Marshall County",5,17,737,382,355
050,18,099,"Indiana","Marshall County",5,18,620,325,295
050,18,099,"Indiana","Marshall County",5,19,513,262,251
050,18,099,"Indiana","Marshall County",5,20,560,283,277
050,18,099,"Indiana","Marshall County",5,21,559,294,265
050,18,099,"Indiana","Marshall County",5,22,596,312,284
050,18,099,"Indiana","Marshall County",5,23,626,315,311
050,18,099,"Indiana","Marshall County",5,24,546,302,244
050,18,099,"Indiana","Marshall County",5,25,563,308,255
050,18,099,"Indiana","Marshall County",5,26,505,271,234
050,18,099,"Indiana","Marshall County",5,27,509,271,238
050,18,099,"Indiana","Marshall County",5,28,532,271,261
050,18,099,"Indiana","Marshall County",5,29,503,261,242
050,18,099,"Indiana","Marshall County",5,30,531,280,251
050,18,099,"Indiana","Marshall County",5,31,553,312,241
050,18,099,"Indiana","Marshall County",5,32,519,260,259
050,18,099,"Indiana","Marshall County",5,33,533,278,255
050,18,099,"Indiana","Marshall County",5,34,524,255,269
050,18,099,"Indiana","Marshall County",5,35,495,261,234
050,18,099,"Indiana","Marshall County",5,36,494,249,245
050,18,099,"Indiana","Marshall County",5,37,510,244,266
050,18,099,"Indiana","Marshall County",5,38,508,246,262
050,18,099,"Indiana","Marshall County",5,39,523,276,247
050,18,099,"Indiana","Marshall County",5,40,542,286,256
050,18,099,"Indiana","Marshall County",5,41,566,292,274
050,18,099,"Indiana","Marshall County",5,42,561,300,261
050,18,099,"Indiana","Marshall County",5,43,552,282,270
050,18,099,"Indiana","Marshall County",5,44,520,252,268
050,18,099,"Indiana","Marshall County",5,45,529,271,258
050,18,099,"Indiana","Marshall County",5,46,531,274,257
050,18,099,"Indiana","Marshall County",5,47,553,278,275
050,18,099,"Indiana","Marshall County",5,48,573,299,274
050,18,099,"Indiana","Marshall County",5,49,544,278,266
050,18,099,"Indiana","Marshall County",5,50,509,269,240
050,18,099,"Indiana","Marshall County",5,51,540,277,263
050,18,099,"Indiana","Marshall County",5,52,634,322,312
050,18,099,"Indiana","Marshall County",5,53,579,288,291
050,18,099,"Indiana","Marshall County",5,54,537,267,270
050,18,099,"Indiana","Marshall County",5,55,559,271,288
050,18,099,"Indiana","Marshall County",5,56,581,282,299
050,18,099,"Indiana","Marshall County",5,57,585,300,285
050,18,099,"Indiana","Marshall County",5,58,607,325,282
050,18,099,"Indiana","Marshall County",5,59,638,344,294
050,18,099,"Indiana","Marshall County",5,60,628,308,320
050,18,099,"Indiana","Marshall County",5,61,627,311,316
050,18,099,"Indiana","Marshall County",5,62,636,325,311
050,18,099,"Indiana","Marshall County",5,63,625,317,308
050,18,099,"Indiana","Marshall County",5,64,589,311,278
050,18,099,"Indiana","Marshall County",5,65,606,311,295
050,18,099,"Indiana","Marshall County",5,66,594,290,304
050,18,099,"Indiana","Marshall County",5,67,581,287,294
050,18,099,"Indiana","Marshall County",5,68,581,284,297
050,18,099,"Indiana","Marshall County",5,69,548,266,282
050,18,099,"Indiana","Marshall County",5,70,559,260,299
050,18,099,"Indiana","Marshall County",5,71,527,246,281
050,18,099,"Indiana","Marshall County",5,72,458,233,225
050,18,099,"Indiana","Marshall County",5,73,409,192,217
050,18,099,"Indiana","Marshall County",5,74,418,196,222
050,18,099,"Indiana","Marshall County",5,75,401,191,210
050,18,099,"Indiana","Marshall County",5,76,406,201,205
050,18,099,"Indiana","Marshall County",5,77,272,129,143
050,18,099,"Indiana","Marshall County",5,78,252,123,129
050,18,099,"Indiana","Marshall County",5,79,261,112,149
050,18,099,"Indiana","Marshall County",5,80,268,118,150
050,18,099,"Indiana","Marshall County",5,81,233,102,131
050,18,099,"Indiana","Marshall County",5,82,210,86,124
050,18,099,"Indiana","Marshall County",5,83,198,73,125
050,18,099,"Indiana","Marshall County",5,84,186,73,113
050,18,099,"Indiana","Marshall County",5,85,1040,372,668
050,18,101,"Indiana","Martin County",1,0,98,51,47
050,18,101,"Indiana","Martin County",1,1,110,58,52
050,18,101,"Indiana","Martin County",1,2,117,56,61
050,18,101,"Indiana","Martin County",1,3,116,70,46
050,18,101,"Indiana","Martin County",1,4,120,50,70
050,18,101,"Indiana","Martin County",1,5,116,58,58
050,18,101,"Indiana","Martin County",1,6,136,68,68
050,18,101,"Indiana","Martin County",1,7,132,69,63
050,18,101,"Indiana","Martin County",1,8,119,63,56
050,18,101,"Indiana","Martin County",1,9,97,50,47
050,18,101,"Indiana","Martin County",1,10,111,58,53
050,18,101,"Indiana","Martin County",1,11,125,63,62
050,18,101,"Indiana","Martin County",1,12,126,63,63
050,18,101,"Indiana","Martin County",1,13,128,71,57
050,18,101,"Indiana","Martin County",1,14,139,79,60
050,18,101,"Indiana","Martin County",1,15,137,70,67
050,18,101,"Indiana","Martin County",1,16,121,69,52
050,18,101,"Indiana","Martin County",1,17,123,70,53
050,18,101,"Indiana","Martin County",1,18,111,55,56
050,18,101,"Indiana","Martin County",1,19,84,51,33
050,18,101,"Indiana","Martin County",1,20,92,54,38
050,18,101,"Indiana","Martin County",1,21,115,59,56
050,18,101,"Indiana","Martin County",1,22,117,56,61
050,18,101,"Indiana","Martin County",1,23,119,66,53
050,18,101,"Indiana","Martin County",1,24,115,57,58
050,18,101,"Indiana","Martin County",1,25,101,56,45
050,18,101,"Indiana","Martin County",1,26,115,57,58
050,18,101,"Indiana","Martin County",1,27,116,55,61
050,18,101,"Indiana","Martin County",1,28,117,62,55
050,18,101,"Indiana","Martin County",1,29,106,47,59
050,18,101,"Indiana","Martin County",1,30,92,48,44
050,18,101,"Indiana","Martin County",1,31,100,48,52
050,18,101,"Indiana","Martin County",1,32,103,52,51
050,18,101,"Indiana","Martin County",1,33,97,42,55
050,18,101,"Indiana","Martin County",1,34,112,58,54
050,18,101,"Indiana","Martin County",1,35,120,67,53
050,18,101,"Indiana","Martin County",1,36,121,68,53
050,18,101,"Indiana","Martin County",1,37,109,60,49
050,18,101,"Indiana","Martin County",1,38,117,72,45
050,18,101,"Indiana","Martin County",1,39,124,66,58
050,18,101,"Indiana","Martin County",1,40,108,58,50
050,18,101,"Indiana","Martin County",1,41,107,59,48
050,18,101,"Indiana","Martin County",1,42,112,57,55
050,18,101,"Indiana","Martin County",1,43,119,64,55
050,18,101,"Indiana","Martin County",1,44,121,66,55
050,18,101,"Indiana","Martin County",1,45,121,64,57
050,18,101,"Indiana","Martin County",1,46,121,71,50
050,18,101,"Indiana","Martin County",1,47,126,65,61
050,18,101,"Indiana","Martin County",1,48,131,59,72
050,18,101,"Indiana","Martin County",1,49,122,60,62
050,18,101,"Indiana","Martin County",1,50,96,52,44
050,18,101,"Indiana","Martin County",1,51,126,71,55
050,18,101,"Indiana","Martin County",1,52,134,69,65
050,18,101,"Indiana","Martin County",1,53,144,76,68
050,18,101,"Indiana","Martin County",1,54,134,67,67
050,18,101,"Indiana","Martin County",1,55,135,66,69
050,18,101,"Indiana","Martin County",1,56,148,73,75
050,18,101,"Indiana","Martin County",1,57,133,73,60
050,18,101,"Indiana","Martin County",1,58,153,78,75
050,18,101,"Indiana","Martin County",1,59,154,86,68
050,18,101,"Indiana","Martin County",1,60,143,73,70
050,18,101,"Indiana","Martin County",1,61,151,80,71
050,18,101,"Indiana","Martin County",1,62,158,79,79
050,18,101,"Indiana","Martin County",1,63,146,75,71
050,18,101,"Indiana","Martin County",1,64,139,69,70
050,18,101,"Indiana","Martin County",1,65,145,74,71
050,18,101,"Indiana","Martin County",1,66,144,68,76
050,18,101,"Indiana","Martin County",1,67,135,64,71
050,18,101,"Indiana","Martin County",1,68,132,61,71
050,18,101,"Indiana","Martin County",1,69,123,59,64
050,18,101,"Indiana","Martin County",1,70,120,60,60
050,18,101,"Indiana","Martin County",1,71,111,59,52
050,18,101,"Indiana","Martin County",1,72,105,51,54
050,18,101,"Indiana","Martin County",1,73,104,48,56
050,18,101,"Indiana","Martin County",1,74,74,36,38
050,18,101,"Indiana","Martin County",1,75,69,32,37
050,18,101,"Indiana","Martin County",1,76,78,31,47
050,18,101,"Indiana","Martin County",1,77,75,38,37
050,18,101,"Indiana","Martin County",1,78,63,28,35
050,18,101,"Indiana","Martin County",1,79,64,28,36
050,18,101,"Indiana","Martin County",1,80,59,25,34
050,18,101,"Indiana","Martin County",1,81,46,17,29
050,18,101,"Indiana","Martin County",1,82,40,19,21
050,18,101,"Indiana","Martin County",1,83,54,25,29
050,18,101,"Indiana","Martin County",1,84,40,12,28
050,18,101,"Indiana","Martin County",1,85,174,73,101
050,18,101,"Indiana","Martin County",2,0,111,58,53
050,18,101,"Indiana","Martin County",2,1,107,55,52
050,18,101,"Indiana","Martin County",2,2,116,57,59
050,18,101,"Indiana","Martin County",2,3,116,65,51
050,18,101,"Indiana","Martin County",2,4,118,54,64
050,18,101,"Indiana","Martin County",2,5,117,57,60
050,18,101,"Indiana","Martin County",2,6,130,64,66
050,18,101,"Indiana","Martin County",2,7,130,68,62
050,18,101,"Indiana","Martin County",2,8,120,63,57
050,18,101,"Indiana","Martin County",2,9,101,53,48
050,18,101,"Indiana","Martin County",2,10,107,56,51
050,18,101,"Indiana","Martin County",2,11,122,61,61
050,18,101,"Indiana","Martin County",2,12,126,63,63
050,18,101,"Indiana","Martin County",2,13,128,70,58
050,18,101,"Indiana","Martin County",2,14,136,77,59
050,18,101,"Indiana","Martin County",2,15,137,72,65
050,18,101,"Indiana","Martin County",2,16,124,69,55
050,18,101,"Indiana","Martin County",2,17,121,69,52
050,18,101,"Indiana","Martin County",2,18,108,55,53
050,18,101,"Indiana","Martin County",2,19,86,51,35
050,18,101,"Indiana","Martin County",2,20,92,54,38
050,18,101,"Indiana","Martin County",2,21,112,58,54
050,18,101,"Indiana","Martin County",2,22,118,58,60
050,18,101,"Indiana","Martin County",2,23,122,66,56
050,18,101,"Indiana","Martin County",2,24,116,59,57
050,18,101,"Indiana","Martin County",2,25,103,55,48
050,18,101,"Indiana","Martin County",2,26,115,59,56
050,18,101,"Indiana","Martin County",2,27,116,54,62
050,18,101,"Indiana","Martin County",2,28,116,60,56
050,18,101,"Indiana","Martin County",2,29,110,52,58
050,18,101,"Indiana","Martin County",2,30,96,48,48
050,18,101,"Indiana","Martin County",2,31,98,48,50
050,18,101,"Indiana","Martin County",2,32,102,52,50
050,18,101,"Indiana","Martin County",2,33,98,44,54
050,18,101,"Indiana","Martin County",2,34,110,55,55
050,18,101,"Indiana","Martin County",2,35,121,67,54
050,18,101,"Indiana","Martin County",2,36,120,67,53
050,18,101,"Indiana","Martin County",2,37,110,61,49
050,18,101,"Indiana","Martin County",2,38,116,70,46
050,18,101,"Indiana","Martin County",2,39,123,68,55
050,18,101,"Indiana","Martin County",2,40,110,59,51
050,18,101,"Indiana","Martin County",2,41,108,59,49
050,18,101,"Indiana","Martin County",2,42,109,56,53
050,18,101,"Indiana","Martin County",2,43,117,63,54
050,18,101,"Indiana","Martin County",2,44,120,65,55
050,18,101,"Indiana","Martin County",2,45,121,65,56
050,18,101,"Indiana","Martin County",2,46,121,70,51
050,18,101,"Indiana","Martin County",2,47,123,65,58
050,18,101,"Indiana","Martin County",2,48,130,60,70
050,18,101,"Indiana","Martin County",2,49,124,60,64
050,18,101,"Indiana","Martin County",2,50,102,54,48
050,18,101,"Indiana","Martin County",2,51,118,66,52
050,18,101,"Indiana","Martin County",2,52,130,68,62
050,18,101,"Indiana","Martin County",2,53,141,75,66
050,18,101,"Indiana","Martin County",2,54,137,70,67
050,18,101,"Indiana","Martin County",2,55,134,66,68
050,18,101,"Indiana","Martin County",2,56,146,72,74
050,18,101,"Indiana","Martin County",2,57,136,73,63
050,18,101,"Indiana","Martin County",2,58,148,77,71
050,18,101,"Indiana","Martin County",2,59,154,83,71
050,18,101,"Indiana","Martin County",2,60,146,76,70
050,18,101,"Indiana","Martin County",2,61,147,77,70
050,18,101,"Indiana","Martin County",2,62,155,79,76
050,18,101,"Indiana","Martin County",2,63,148,76,72
050,18,101,"Indiana","Martin County",2,64,139,69,70
050,18,101,"Indiana","Martin County",2,65,145,73,72
050,18,101,"Indiana","Martin County",2,66,146,71,75
050,18,101,"Indiana","Martin County",2,67,137,65,72
050,18,101,"Indiana","Martin County",2,68,132,61,71
050,18,101,"Indiana","Martin County",2,69,125,60,65
050,18,101,"Indiana","Martin County",2,70,119,59,60
050,18,101,"Indiana","Martin County",2,71,113,59,54
050,18,101,"Indiana","Martin County",2,72,104,52,52
050,18,101,"Indiana","Martin County",2,73,109,52,57
050,18,101,"Indiana","Martin County",2,74,76,36,40
050,18,101,"Indiana","Martin County",2,75,70,33,37
050,18,101,"Indiana","Martin County",2,76,75,31,44
050,18,101,"Indiana","Martin County",2,77,76,36,40
050,18,101,"Indiana","Martin County",2,78,65,30,35
050,18,101,"Indiana","Martin County",2,79,63,28,35
050,18,101,"Indiana","Martin County",2,80,60,26,34
050,18,101,"Indiana","Martin County",2,81,48,19,29
050,18,101,"Indiana","Martin County",2,82,41,18,23
050,18,101,"Indiana","Martin County",2,83,50,23,27
050,18,101,"Indiana","Martin County",2,84,41,13,28
050,18,101,"Indiana","Martin County",2,85,175,73,102
050,18,101,"Indiana","Martin County",3,0,105,49,56
050,18,101,"Indiana","Martin County",3,1,104,53,51
050,18,101,"Indiana","Martin County",3,2,115,61,54
050,18,101,"Indiana","Martin County",3,3,116,60,56
050,18,101,"Indiana","Martin County",3,4,121,62,59
050,18,101,"Indiana","Martin County",3,5,123,56,67
050,18,101,"Indiana","Martin County",3,6,120,56,64
050,18,101,"Indiana","Martin County",3,7,130,63,67
050,18,101,"Indiana","Martin County",3,8,131,66,65
050,18,101,"Indiana","Martin County",3,9,117,61,56
050,18,101,"Indiana","Martin County",3,10,92,51,41
050,18,101,"Indiana","Martin County",3,11,110,55,55
050,18,101,"Indiana","Martin County",3,12,120,56,64
050,18,101,"Indiana","Martin County",3,13,128,63,65
050,18,101,"Indiana","Martin County",3,14,128,71,57
050,18,101,"Indiana","Martin County",3,15,134,73,61
050,18,101,"Indiana","Martin County",3,16,132,72,60
050,18,101,"Indiana","Martin County",3,17,125,70,55
050,18,101,"Indiana","Martin County",3,18,114,61,53
050,18,101,"Indiana","Martin County",3,19,90,54,36
050,18,101,"Indiana","Martin County",3,20,90,51,39
050,18,101,"Indiana","Martin County",3,21,101,56,45
050,18,101,"Indiana","Martin County",3,22,114,56,58
050,18,101,"Indiana","Martin County",3,23,125,65,60
050,18,101,"Indiana","Martin County",3,24,132,71,61
050,18,101,"Indiana","Martin County",3,25,109,49,60
050,18,101,"Indiana","Martin County",3,26,116,61,55
050,18,101,"Indiana","Martin County",3,27,114,58,56
050,18,101,"Indiana","Martin County",3,28,112,56,56
050,18,101,"Indiana","Martin County",3,29,122,67,55
050,18,101,"Indiana","Martin County",3,30,108,50,58
050,18,101,"Indiana","Martin County",3,31,104,47,57
050,18,101,"Indiana","Martin County",3,32,100,51,49
050,18,101,"Indiana","Martin County",3,33,97,49,48
050,18,101,"Indiana","Martin County",3,34,95,41,54
050,18,101,"Indiana","Martin County",3,35,108,57,51
050,18,101,"Indiana","Martin County",3,36,118,64,54
050,18,101,"Indiana","Martin County",3,37,121,69,52
050,18,101,"Indiana","Martin County",3,38,115,65,50
050,18,101,"Indiana","Martin County",3,39,130,80,50
050,18,101,"Indiana","Martin County",3,40,117,64,53
050,18,101,"Indiana","Martin County",3,41,112,60,52
050,18,101,"Indiana","Martin County",3,42,106,54,52
050,18,101,"Indiana","Martin County",3,43,105,54,51
050,18,101,"Indiana","Martin County",3,44,114,60,54
050,18,101,"Indiana","Martin County",3,45,116,64,52
050,18,101,"Indiana","Martin County",3,46,121,66,55
050,18,101,"Indiana","Martin County",3,47,109,60,49
050,18,101,"Indiana","Martin County",3,48,125,67,58
050,18,101,"Indiana","Martin County",3,49,126,57,69
050,18,101,"Indiana","Martin County",3,50,122,58,64
050,18,101,"Indiana","Martin County",3,51,114,62,52
050,18,101,"Indiana","Martin County",3,52,112,59,53
050,18,101,"Indiana","Martin County",3,53,122,64,58
050,18,101,"Indiana","Martin County",3,54,139,76,63
050,18,101,"Indiana","Martin County",3,55,130,65,65
050,18,101,"Indiana","Martin County",3,56,136,67,69
050,18,101,"Indiana","Martin County",3,57,143,70,73
050,18,101,"Indiana","Martin County",3,58,135,70,65
050,18,101,"Indiana","Martin County",3,59,145,77,68
050,18,101,"Indiana","Martin County",3,60,155,79,76
050,18,101,"Indiana","Martin County",3,61,146,78,68
050,18,101,"Indiana","Martin County",3,62,141,75,66
050,18,101,"Indiana","Martin County",3,63,153,78,75
050,18,101,"Indiana","Martin County",3,64,145,74,71
050,18,101,"Indiana","Martin County",3,65,139,70,69
050,18,101,"Indiana","Martin County",3,66,145,70,75
050,18,101,"Indiana","Martin County",3,67,142,68,74
050,18,101,"Indiana","Martin County",3,68,137,64,73
050,18,101,"Indiana","Martin County",3,69,131,60,71
050,18,101,"Indiana","Martin County",3,70,119,59,60
050,18,101,"Indiana","Martin County",3,71,116,55,61
050,18,101,"Indiana","Martin County",3,72,110,59,51
050,18,101,"Indiana","Martin County",3,73,98,50,48
050,18,101,"Indiana","Martin County",3,74,106,50,56
050,18,101,"Indiana","Martin County",3,75,74,34,40
050,18,101,"Indiana","Martin County",3,76,72,35,37
050,18,101,"Indiana","Martin County",3,77,71,29,42
050,18,101,"Indiana","Martin County",3,78,72,35,37
050,18,101,"Indiana","Martin County",3,79,66,30,36
050,18,101,"Indiana","Martin County",3,80,58,26,32
050,18,101,"Indiana","Martin County",3,81,59,26,33
050,18,101,"Indiana","Martin County",3,82,41,17,24
050,18,101,"Indiana","Martin County",3,83,39,16,23
050,18,101,"Indiana","Martin County",3,84,47,22,25
050,18,101,"Indiana","Martin County",3,85,187,74,113
050,18,101,"Indiana","Martin County",4,0,133,64,69
050,18,101,"Indiana","Martin County",4,1,103,55,48
050,18,101,"Indiana","Martin County",4,2,118,56,62
050,18,101,"Indiana","Martin County",4,3,110,61,49
050,18,101,"Indiana","Martin County",4,4,117,62,55
050,18,101,"Indiana","Martin County",4,5,115,60,55
050,18,101,"Indiana","Martin County",4,6,123,59,64
050,18,101,"Indiana","Martin County",4,7,118,57,61
050,18,101,"Indiana","Martin County",4,8,131,60,71
050,18,101,"Indiana","Martin County",4,9,132,68,64
050,18,101,"Indiana","Martin County",4,10,119,66,53
050,18,101,"Indiana","Martin County",4,11,91,49,42
050,18,101,"Indiana","Martin County",4,12,117,61,56
050,18,101,"Indiana","Martin County",4,13,126,62,64
050,18,101,"Indiana","Martin County",4,14,125,63,62
050,18,101,"Indiana","Martin County",4,15,130,70,60
050,18,101,"Indiana","Martin County",4,16,131,74,57
050,18,101,"Indiana","Martin County",4,17,135,75,60
050,18,101,"Indiana","Martin County",4,18,111,60,51
050,18,101,"Indiana","Martin County",4,19,89,52,37
050,18,101,"Indiana","Martin County",4,20,93,54,39
050,18,101,"Indiana","Martin County",4,21,102,52,50
050,18,101,"Indiana","Martin County",4,22,96,49,47
050,18,101,"Indiana","Martin County",4,23,115,63,52
050,18,101,"Indiana","Martin County",4,24,130,68,62
050,18,101,"Indiana","Martin County",4,25,117,64,53
050,18,101,"Indiana","Martin County",4,26,117,57,60
050,18,101,"Indiana","Martin County",4,27,113,56,57
050,18,101,"Indiana","Martin County",4,28,108,60,48
050,18,101,"Indiana","Martin County",4,29,121,61,60
050,18,101,"Indiana","Martin County",4,30,124,63,61
050,18,101,"Indiana","Martin County",4,31,109,51,58
050,18,101,"Indiana","Martin County",4,32,102,47,55
050,18,101,"Indiana","Martin County",4,33,88,44,44
050,18,101,"Indiana","Martin County",4,34,107,58,49
050,18,101,"Indiana","Martin County",4,35,98,43,55
050,18,101,"Indiana","Martin County",4,36,112,58,54
050,18,101,"Indiana","Martin County",4,37,115,64,51
050,18,101,"Indiana","Martin County",4,38,120,67,53
050,18,101,"Indiana","Martin County",4,39,121,66,55
050,18,101,"Indiana","Martin County",4,40,124,72,52
050,18,101,"Indiana","Martin County",4,41,116,60,56
050,18,101,"Indiana","Martin County",4,42,110,60,50
050,18,101,"Indiana","Martin County",4,43,104,55,49
050,18,101,"Indiana","Martin County",4,44,102,55,47
050,18,101,"Indiana","Martin County",4,45,121,66,55
050,18,101,"Indiana","Martin County",4,46,115,67,48
050,18,101,"Indiana","Martin County",4,47,118,60,58
050,18,101,"Indiana","Martin County",4,48,120,67,53
050,18,101,"Indiana","Martin County",4,49,120,63,57
050,18,101,"Indiana","Martin County",4,50,118,55,63
050,18,101,"Indiana","Martin County",4,51,129,65,64
050,18,101,"Indiana","Martin County",4,52,112,58,54
050,18,101,"Indiana","Martin County",4,53,108,58,50
050,18,101,"Indiana","Martin County",4,54,126,67,59
050,18,101,"Indiana","Martin County",4,55,138,71,67
050,18,101,"Indiana","Martin County",4,56,130,64,66
050,18,101,"Indiana","Martin County",4,57,135,65,70
050,18,101,"Indiana","Martin County",4,58,137,65,72
050,18,101,"Indiana","Martin County",4,59,140,74,66
050,18,101,"Indiana","Martin County",4,60,143,79,64
050,18,101,"Indiana","Martin County",4,61,145,74,71
050,18,101,"Indiana","Martin County",4,62,147,81,66
050,18,101,"Indiana","Martin County",4,63,142,78,64
050,18,101,"Indiana","Martin County",4,64,152,79,73
050,18,101,"Indiana","Martin County",4,65,143,72,71
050,18,101,"Indiana","Martin County",4,66,139,72,67
050,18,101,"Indiana","Martin County",4,67,148,71,77
050,18,101,"Indiana","Martin County",4,68,145,69,76
050,18,101,"Indiana","Martin County",4,69,136,61,75
050,18,101,"Indiana","Martin County",4,70,123,56,67
050,18,101,"Indiana","Martin County",4,71,116,56,60
050,18,101,"Indiana","Martin County",4,72,115,54,61
050,18,101,"Indiana","Martin County",4,73,106,56,50
050,18,101,"Indiana","Martin County",4,74,100,53,47
050,18,101,"Indiana","Martin County",4,75,102,48,54
050,18,101,"Indiana","Martin County",4,76,72,34,38
050,18,101,"Indiana","Martin County",4,77,66,30,36
050,18,101,"Indiana","Martin County",4,78,61,24,37
050,18,101,"Indiana","Martin County",4,79,71,36,35
050,18,101,"Indiana","Martin County",4,80,63,28,35
050,18,101,"Indiana","Martin County",4,81,54,25,29
050,18,101,"Indiana","Martin County",4,82,55,24,31
050,18,101,"Indiana","Martin County",4,83,37,15,22
050,18,101,"Indiana","Martin County",4,84,36,15,21
050,18,101,"Indiana","Martin County",4,85,205,87,118
050,18,101,"Indiana","Martin County",5,0,142,69,73
050,18,101,"Indiana","Martin County",5,1,125,56,69
050,18,101,"Indiana","Martin County",5,2,103,53,50
050,18,101,"Indiana","Martin County",5,3,112,56,56
050,18,101,"Indiana","Martin County",5,4,111,61,50
050,18,101,"Indiana","Martin County",5,5,115,62,53
050,18,101,"Indiana","Martin County",5,6,113,62,51
050,18,101,"Indiana","Martin County",5,7,121,55,66
050,18,101,"Indiana","Martin County",5,8,123,60,63
050,18,101,"Indiana","Martin County",5,9,126,62,64
050,18,101,"Indiana","Martin County",5,10,129,67,62
050,18,101,"Indiana","Martin County",5,11,122,66,56
050,18,101,"Indiana","Martin County",5,12,94,52,42
050,18,101,"Indiana","Martin County",5,13,122,67,55
050,18,101,"Indiana","Martin County",5,14,125,62,63
050,18,101,"Indiana","Martin County",5,15,123,61,62
050,18,101,"Indiana","Martin County",5,16,132,72,60
050,18,101,"Indiana","Martin County",5,17,136,73,63
050,18,101,"Indiana","Martin County",5,18,113,65,48
050,18,101,"Indiana","Martin County",5,19,88,51,37
050,18,101,"Indiana","Martin County",5,20,97,56,41
050,18,101,"Indiana","Martin County",5,21,110,58,52
050,18,101,"Indiana","Martin County",5,22,98,50,48
050,18,101,"Indiana","Martin County",5,23,110,62,48
050,18,101,"Indiana","Martin County",5,24,124,65,59
050,18,101,"Indiana","Martin County",5,25,123,68,55
050,18,101,"Indiana","Martin County",5,26,131,68,63
050,18,101,"Indiana","Martin County",5,27,121,65,56
050,18,101,"Indiana","Martin County",5,28,120,66,54
050,18,101,"Indiana","Martin County",5,29,110,61,49
050,18,101,"Indiana","Martin County",5,30,110,53,57
050,18,101,"Indiana","Martin County",5,31,130,66,64
050,18,101,"Indiana","Martin County",5,32,112,52,60
050,18,101,"Indiana","Martin County",5,33,101,47,54
050,18,101,"Indiana","Martin County",5,34,86,42,44
050,18,101,"Indiana","Martin County",5,35,109,60,49
050,18,101,"Indiana","Martin County",5,36,108,46,62
050,18,101,"Indiana","Martin County",5,37,107,57,50
050,18,101,"Indiana","Martin County",5,38,124,71,53
050,18,101,"Indiana","Martin County",5,39,123,71,52
050,18,101,"Indiana","Martin County",5,40,116,61,55
050,18,101,"Indiana","Martin County",5,41,119,66,53
050,18,101,"Indiana","Martin County",5,42,113,56,57
050,18,101,"Indiana","Martin County",5,43,120,67,53
050,18,101,"Indiana","Martin County",5,44,102,53,49
050,18,101,"Indiana","Martin County",5,45,108,60,48
050,18,101,"Indiana","Martin County",5,46,125,68,57
050,18,101,"Indiana","Martin County",5,47,105,61,44
050,18,101,"Indiana","Martin County",5,48,123,62,61
050,18,101,"Indiana","Martin County",5,49,114,66,48
050,18,101,"Indiana","Martin County",5,50,123,62,61
050,18,101,"Indiana","Martin County",5,51,123,59,64
050,18,101,"Indiana","Martin County",5,52,129,64,65
050,18,101,"Indiana","Martin County",5,53,109,58,51
050,18,101,"Indiana","Martin County",5,54,111,61,50
050,18,101,"Indiana","Martin County",5,55,123,62,61
050,18,101,"Indiana","Martin County",5,56,149,72,77
050,18,101,"Indiana","Martin County",5,57,120,56,64
050,18,101,"Indiana","Martin County",5,58,133,66,67
050,18,101,"Indiana","Martin County",5,59,137,67,70
050,18,101,"Indiana","Martin County",5,60,133,70,63
050,18,101,"Indiana","Martin County",5,61,134,72,62
050,18,101,"Indiana","Martin County",5,62,138,71,67
050,18,101,"Indiana","Martin County",5,63,145,84,61
050,18,101,"Indiana","Martin County",5,64,140,78,62
050,18,101,"Indiana","Martin County",5,65,158,81,77
050,18,101,"Indiana","Martin County",5,66,141,73,68
050,18,101,"Indiana","Martin County",5,67,138,70,68
050,18,101,"Indiana","Martin County",5,68,145,69,76
050,18,101,"Indiana","Martin County",5,69,146,69,77
050,18,101,"Indiana","Martin County",5,70,131,58,73
050,18,101,"Indiana","Martin County",5,71,119,53,66
050,18,101,"Indiana","Martin County",5,72,114,55,59
050,18,101,"Indiana","Martin County",5,73,113,53,60
050,18,101,"Indiana","Martin County",5,74,108,58,50
050,18,101,"Indiana","Martin County",5,75,100,53,47
050,18,101,"Indiana","Martin County",5,76,102,48,54
050,18,101,"Indiana","Martin County",5,77,66,29,37
050,18,101,"Indiana","Martin County",5,78,58,26,32
050,18,101,"Indiana","Martin County",5,79,64,23,41
050,18,101,"Indiana","Martin County",5,80,65,32,33
050,18,101,"Indiana","Martin County",5,81,56,28,28
050,18,101,"Indiana","Martin County",5,82,49,24,25
050,18,101,"Indiana","Martin County",5,83,52,23,29
050,18,101,"Indiana","Martin County",5,84,36,14,22
050,18,101,"Indiana","Martin County",5,85,215,94,121
050,18,103,"Indiana","Miami County",1,0,353,183,170
050,18,103,"Indiana","Miami County",1,1,362,180,182
050,18,103,"Indiana","Miami County",1,2,377,200,177
050,18,103,"Indiana","Miami County",1,3,407,200,207
050,18,103,"Indiana","Miami County",1,4,357,187,170
050,18,103,"Indiana","Miami County",1,5,421,230,191
050,18,103,"Indiana","Miami County",1,6,425,230,195
050,18,103,"Indiana","Miami County",1,7,382,202,180
050,18,103,"Indiana","Miami County",1,8,413,191,222
050,18,103,"Indiana","Miami County",1,9,397,203,194
050,18,103,"Indiana","Miami County",1,10,396,196,200
050,18,103,"Indiana","Miami County",1,11,464,241,223
050,18,103,"Indiana","Miami County",1,12,481,246,235
050,18,103,"Indiana","Miami County",1,13,499,261,238
050,18,103,"Indiana","Miami County",1,14,471,248,223
050,18,103,"Indiana","Miami County",1,15,491,256,235
050,18,103,"Indiana","Miami County",1,16,486,257,229
050,18,103,"Indiana","Miami County",1,17,469,236,233
050,18,103,"Indiana","Miami County",1,18,407,225,182
050,18,103,"Indiana","Miami County",1,19,368,225,143
050,18,103,"Indiana","Miami County",1,20,406,243,163
050,18,103,"Indiana","Miami County",1,21,440,275,165
050,18,103,"Indiana","Miami County",1,22,426,251,175
050,18,103,"Indiana","Miami County",1,23,452,269,183
050,18,103,"Indiana","Miami County",1,24,429,259,170
050,18,103,"Indiana","Miami County",1,25,441,280,161
050,18,103,"Indiana","Miami County",1,26,467,293,174
050,18,103,"Indiana","Miami County",1,27,492,287,205
050,18,103,"Indiana","Miami County",1,28,490,301,189
050,18,103,"Indiana","Miami County",1,29,504,293,211
050,18,103,"Indiana","Miami County",1,30,492,296,196
050,18,103,"Indiana","Miami County",1,31,471,283,188
050,18,103,"Indiana","Miami County",1,32,477,288,189
050,18,103,"Indiana","Miami County",1,33,470,284,186
050,18,103,"Indiana","Miami County",1,34,450,265,185
050,18,103,"Indiana","Miami County",1,35,443,277,166
050,18,103,"Indiana","Miami County",1,36,441,271,170
050,18,103,"Indiana","Miami County",1,37,431,259,172
050,18,103,"Indiana","Miami County",1,38,449,281,168
050,18,103,"Indiana","Miami County",1,39,479,290,189
050,18,103,"Indiana","Miami County",1,40,491,279,212
050,18,103,"Indiana","Miami County",1,41,488,276,212
050,18,103,"Indiana","Miami County",1,42,472,282,190
050,18,103,"Indiana","Miami County",1,43,451,270,181
050,18,103,"Indiana","Miami County",1,44,494,281,213
050,18,103,"Indiana","Miami County",1,45,491,286,205
050,18,103,"Indiana","Miami County",1,46,465,253,212
050,18,103,"Indiana","Miami County",1,47,434,237,197
050,18,103,"Indiana","Miami County",1,48,485,260,225
050,18,103,"Indiana","Miami County",1,49,510,290,220
050,18,103,"Indiana","Miami County",1,50,508,296,212
050,18,103,"Indiana","Miami County",1,51,471,265,206
050,18,103,"Indiana","Miami County",1,52,470,265,205
050,18,103,"Indiana","Miami County",1,53,469,248,221
050,18,103,"Indiana","Miami County",1,54,478,264,214
050,18,103,"Indiana","Miami County",1,55,477,255,222
050,18,103,"Indiana","Miami County",1,56,504,267,237
050,18,103,"Indiana","Miami County",1,57,519,279,240
050,18,103,"Indiana","Miami County",1,58,510,266,244
050,18,103,"Indiana","Miami County",1,59,499,250,249
050,18,103,"Indiana","Miami County",1,60,485,254,231
050,18,103,"Indiana","Miami County",1,61,486,255,231
050,18,103,"Indiana","Miami County",1,62,461,235,226
050,18,103,"Indiana","Miami County",1,63,438,223,215
050,18,103,"Indiana","Miami County",1,64,430,201,229
050,18,103,"Indiana","Miami County",1,65,435,211,224
050,18,103,"Indiana","Miami County",1,66,433,203,230
050,18,103,"Indiana","Miami County",1,67,412,208,204
050,18,103,"Indiana","Miami County",1,68,410,214,196
050,18,103,"Indiana","Miami County",1,69,390,203,187
050,18,103,"Indiana","Miami County",1,70,385,198,187
050,18,103,"Indiana","Miami County",1,71,368,185,183
050,18,103,"Indiana","Miami County",1,72,358,174,184
050,18,103,"Indiana","Miami County",1,73,364,173,191
050,18,103,"Indiana","Miami County",1,74,281,140,141
050,18,103,"Indiana","Miami County",1,75,257,130,127
050,18,103,"Indiana","Miami County",1,76,242,101,141
050,18,103,"Indiana","Miami County",1,77,254,105,149
050,18,103,"Indiana","Miami County",1,78,205,89,116
050,18,103,"Indiana","Miami County",1,79,201,102,99
050,18,103,"Indiana","Miami County",1,80,183,87,96
050,18,103,"Indiana","Miami County",1,81,171,72,99
050,18,103,"Indiana","Miami County",1,82,140,58,82
050,18,103,"Indiana","Miami County",1,83,124,55,69
050,18,103,"Indiana","Miami County",1,84,119,48,71
050,18,103,"Indiana","Miami County",1,85,669,242,427
050,18,103,"Indiana","Miami County",2,0,340,174,166
050,18,103,"Indiana","Miami County",2,1,357,178,179
050,18,103,"Indiana","Miami County",2,2,370,191,179
050,18,103,"Indiana","Miami County",2,3,397,199,198
050,18,103,"Indiana","Miami County",2,4,374,195,179
050,18,103,"Indiana","Miami County",2,5,407,222,185
050,18,103,"Indiana","Miami County",2,6,425,233,192
050,18,103,"Indiana","Miami County",2,7,393,209,184
050,18,103,"Indiana","Miami County",2,8,404,195,209
050,18,103,"Indiana","Miami County",2,9,402,202,200
050,18,103,"Indiana","Miami County",2,10,398,200,198
050,18,103,"Indiana","Miami County",2,11,449,232,217
050,18,103,"Indiana","Miami County",2,12,481,246,235
050,18,103,"Indiana","Miami County",2,13,495,256,239
050,18,103,"Indiana","Miami County",2,14,478,251,227
050,18,103,"Indiana","Miami County",2,15,484,252,232
050,18,103,"Indiana","Miami County",2,16,487,255,232
050,18,103,"Indiana","Miami County",2,17,474,242,232
050,18,103,"Indiana","Miami County",2,18,402,219,183
050,18,103,"Indiana","Miami County",2,19,366,222,144
050,18,103,"Indiana","Miami County",2,20,412,248,164
050,18,103,"Indiana","Miami County",2,21,439,275,164
050,18,103,"Indiana","Miami County",2,22,431,256,175
050,18,103,"Indiana","Miami County",2,23,447,268,179
050,18,103,"Indiana","Miami County",2,24,434,261,173
050,18,103,"Indiana","Miami County",2,25,442,276,166
050,18,103,"Indiana","Miami County",2,26,467,294,173
050,18,103,"Indiana","Miami County",2,27,482,287,195
050,18,103,"Indiana","Miami County",2,28,491,298,193
050,18,103,"Indiana","Miami County",2,29,500,295,205
050,18,103,"Indiana","Miami County",2,30,495,295,200
050,18,103,"Indiana","Miami County",2,31,477,285,192
050,18,103,"Indiana","Miami County",2,32,475,285,190
050,18,103,"Indiana","Miami County",2,33,468,280,188
050,18,103,"Indiana","Miami County",2,34,455,270,185
050,18,103,"Indiana","Miami County",2,35,448,278,170
050,18,103,"Indiana","Miami County",2,36,437,269,168
050,18,103,"Indiana","Miami County",2,37,428,259,169
050,18,103,"Indiana","Miami County",2,38,450,280,170
050,18,103,"Indiana","Miami County",2,39,469,287,182
050,18,103,"Indiana","Miami County",2,40,488,279,209
050,18,103,"Indiana","Miami County",2,41,488,276,212
050,18,103,"Indiana","Miami County",2,42,471,279,192
050,18,103,"Indiana","Miami County",2,43,459,274,185
050,18,103,"Indiana","Miami County",2,44,483,279,204
050,18,103,"Indiana","Miami County",2,45,498,289,209
050,18,103,"Indiana","Miami County",2,46,463,253,210
050,18,103,"Indiana","Miami County",2,47,439,240,199
050,18,103,"Indiana","Miami County",2,48,474,257,217
050,18,103,"Indiana","Miami County",2,49,506,284,222
050,18,103,"Indiana","Miami County",2,50,508,295,213
050,18,103,"Indiana","Miami County",2,51,475,267,208
050,18,103,"Indiana","Miami County",2,52,469,264,205
050,18,103,"Indiana","Miami County",2,53,466,249,217
050,18,103,"Indiana","Miami County",2,54,476,260,216
050,18,103,"Indiana","Miami County",2,55,477,255,222
050,18,103,"Indiana","Miami County",2,56,495,265,230
050,18,103,"Indiana","Miami County",2,57,508,270,238
050,18,103,"Indiana","Miami County",2,58,510,267,243
050,18,103,"Indiana","Miami County",2,59,501,253,248
050,18,103,"Indiana","Miami County",2,60,483,249,234
050,18,103,"Indiana","Miami County",2,61,482,252,230
050,18,103,"Indiana","Miami County",2,62,463,237,226
050,18,103,"Indiana","Miami County",2,63,446,227,219
050,18,103,"Indiana","Miami County",2,64,424,202,222
050,18,103,"Indiana","Miami County",2,65,430,206,224
050,18,103,"Indiana","Miami County",2,66,432,204,228
050,18,103,"Indiana","Miami County",2,67,413,204,209
050,18,103,"Indiana","Miami County",2,68,406,210,196
050,18,103,"Indiana","Miami County",2,69,397,207,190
050,18,103,"Indiana","Miami County",2,70,385,198,187
050,18,103,"Indiana","Miami County",2,71,370,185,185
050,18,103,"Indiana","Miami County",2,72,353,172,181
050,18,103,"Indiana","Miami County",2,73,381,183,198
050,18,103,"Indiana","Miami County",2,74,280,139,141
050,18,103,"Indiana","Miami County",2,75,261,132,129
050,18,103,"Indiana","Miami County",2,76,239,106,133
050,18,103,"Indiana","Miami County",2,77,260,108,152
050,18,103,"Indiana","Miami County",2,78,209,89,120
050,18,103,"Indiana","Miami County",2,79,197,94,103
050,18,103,"Indiana","Miami County",2,80,180,86,94
050,18,103,"Indiana","Miami County",2,81,169,75,94
050,18,103,"Indiana","Miami County",2,82,146,60,86
050,18,103,"Indiana","Miami County",2,83,127,56,71
050,18,103,"Indiana","Miami County",2,84,120,50,70
050,18,103,"Indiana","Miami County",2,85,669,244,425
050,18,103,"Indiana","Miami County",3,0,345,176,169
050,18,103,"Indiana","Miami County",3,1,359,176,183
050,18,103,"Indiana","Miami County",3,2,378,188,190
050,18,103,"Indiana","Miami County",3,3,379,199,180
050,18,103,"Indiana","Miami County",3,4,408,215,193
050,18,103,"Indiana","Miami County",3,5,377,194,183
050,18,103,"Indiana","Miami County",3,6,410,231,179
050,18,103,"Indiana","Miami County",3,7,428,233,195
050,18,103,"Indiana","Miami County",3,8,405,211,194
050,18,103,"Indiana","Miami County",3,9,388,199,189
050,18,103,"Indiana","Miami County",3,10,416,206,210
050,18,103,"Indiana","Miami County",3,11,402,206,196
050,18,103,"Indiana","Miami County",3,12,449,231,218
050,18,103,"Indiana","Miami County",3,13,490,246,244
050,18,103,"Indiana","Miami County",3,14,488,248,240
050,18,103,"Indiana","Miami County",3,15,481,250,231
050,18,103,"Indiana","Miami County",3,16,469,239,230
050,18,103,"Indiana","Miami County",3,17,486,255,231
050,18,103,"Indiana","Miami County",3,18,411,222,189
050,18,103,"Indiana","Miami County",3,19,355,211,144
050,18,103,"Indiana","Miami County",3,20,415,254,161
050,18,103,"Indiana","Miami County",3,21,457,288,169
050,18,103,"Indiana","Miami County",3,22,466,280,186
050,18,103,"Indiana","Miami County",3,23,453,276,177
050,18,103,"Indiana","Miami County",3,24,437,267,170
050,18,103,"Indiana","Miami County",3,25,437,259,178
050,18,103,"Indiana","Miami County",3,26,466,300,166
050,18,103,"Indiana","Miami County",3,27,473,293,180
050,18,103,"Indiana","Miami County",3,28,498,303,195
050,18,103,"Indiana","Miami County",3,29,496,294,202
050,18,103,"Indiana","Miami County",3,30,521,314,207
050,18,103,"Indiana","Miami County",3,31,512,301,211
050,18,103,"Indiana","Miami County",3,32,482,296,186
050,18,103,"Indiana","Miami County",3,33,465,269,196
050,18,103,"Indiana","Miami County",3,34,466,285,181
050,18,103,"Indiana","Miami County",3,35,479,295,184
050,18,103,"Indiana","Miami County",3,36,458,277,181
050,18,103,"Indiana","Miami County",3,37,457,281,176
050,18,103,"Indiana","Miami County",3,38,460,280,180
050,18,103,"Indiana","Miami County",3,39,465,291,174
050,18,103,"Indiana","Miami County",3,40,463,281,182
050,18,103,"Indiana","Miami County",3,41,483,274,209
050,18,103,"Indiana","Miami County",3,42,475,275,200
050,18,103,"Indiana","Miami County",3,43,462,274,188
050,18,103,"Indiana","Miami County",3,44,475,283,192
050,18,103,"Indiana","Miami County",3,45,494,287,207
050,18,103,"Indiana","Miami County",3,46,466,257,209
050,18,103,"Indiana","Miami County",3,47,447,244,203
050,18,103,"Indiana","Miami County",3,48,460,255,205
050,18,103,"Indiana","Miami County",3,49,467,260,207
050,18,103,"Indiana","Miami County",3,50,507,283,224
050,18,103,"Indiana","Miami County",3,51,488,277,211
050,18,103,"Indiana","Miami County",3,52,469,263,206
050,18,103,"Indiana","Miami County",3,53,463,256,207
050,18,103,"Indiana","Miami County",3,54,457,249,208
050,18,103,"Indiana","Miami County",3,55,466,248,218
050,18,103,"Indiana","Miami County",3,56,493,267,226
050,18,103,"Indiana","Miami County",3,57,474,248,226
050,18,103,"Indiana","Miami County",3,58,502,264,238
050,18,103,"Indiana","Miami County",3,59,501,260,241
050,18,103,"Indiana","Miami County",3,60,485,243,242
050,18,103,"Indiana","Miami County",3,61,473,242,231
050,18,103,"Indiana","Miami County",3,62,476,245,231
050,18,103,"Indiana","Miami County",3,63,452,232,220
050,18,103,"Indiana","Miami County",3,64,425,210,215
050,18,103,"Indiana","Miami County",3,65,420,198,222
050,18,103,"Indiana","Miami County",3,66,424,203,221
050,18,103,"Indiana","Miami County",3,67,424,202,222
050,18,103,"Indiana","Miami County",3,68,405,195,210
050,18,103,"Indiana","Miami County",3,69,401,210,191
050,18,103,"Indiana","Miami County",3,70,384,199,185
050,18,103,"Indiana","Miami County",3,71,369,189,180
050,18,103,"Indiana","Miami County",3,72,361,178,183
050,18,103,"Indiana","Miami County",3,73,332,158,174
050,18,103,"Indiana","Miami County",3,74,372,178,194
050,18,103,"Indiana","Miami County",3,75,273,135,138
050,18,103,"Indiana","Miami County",3,76,246,121,125
050,18,103,"Indiana","Miami County",3,77,232,103,129
050,18,103,"Indiana","Miami County",3,78,236,98,138
050,18,103,"Indiana","Miami County",3,79,200,81,119
050,18,103,"Indiana","Miami County",3,80,174,82,92
050,18,103,"Indiana","Miami County",3,81,174,87,87
050,18,103,"Indiana","Miami County",3,82,154,64,90
050,18,103,"Indiana","Miami County",3,83,137,57,80
050,18,103,"Indiana","Miami County",3,84,127,56,71
050,18,103,"Indiana","Miami County",3,85,644,241,403
050,18,103,"Indiana","Miami County",4,0,345,173,172
050,18,103,"Indiana","Miami County",4,1,361,191,170
050,18,103,"Indiana","Miami County",4,2,355,182,173
050,18,103,"Indiana","Miami County",4,3,384,193,191
050,18,103,"Indiana","Miami County",4,4,381,208,173
050,18,103,"Indiana","Miami County",4,5,411,210,201
050,18,103,"Indiana","Miami County",4,6,383,190,193
050,18,103,"Indiana","Miami County",4,7,405,219,186
050,18,103,"Indiana","Miami County",4,8,432,230,202
050,18,103,"Indiana","Miami County",4,9,409,221,188
050,18,103,"Indiana","Miami County",4,10,385,194,191
050,18,103,"Indiana","Miami County",4,11,411,205,206
050,18,103,"Indiana","Miami County",4,12,408,199,209
050,18,103,"Indiana","Miami County",4,13,447,228,219
050,18,103,"Indiana","Miami County",4,14,485,251,234
050,18,103,"Indiana","Miami County",4,15,494,242,252
050,18,103,"Indiana","Miami County",4,16,453,236,217
050,18,103,"Indiana","Miami County",4,17,476,242,234
050,18,103,"Indiana","Miami County",4,18,400,220,180
050,18,103,"Indiana","Miami County",4,19,343,199,144
050,18,103,"Indiana","Miami County",4,20,376,226,150
050,18,103,"Indiana","Miami County",4,21,428,280,148
050,18,103,"Indiana","Miami County",4,22,457,275,182
050,18,103,"Indiana","Miami County",4,23,488,304,184
050,18,103,"Indiana","Miami County",4,24,455,269,186
050,18,103,"Indiana","Miami County",4,25,426,251,175
050,18,103,"Indiana","Miami County",4,26,449,275,174
050,18,103,"Indiana","Miami County",4,27,470,305,165
050,18,103,"Indiana","Miami County",4,28,477,302,175
050,18,103,"Indiana","Miami County",4,29,500,293,207
050,18,103,"Indiana","Miami County",4,30,475,286,189
050,18,103,"Indiana","Miami County",4,31,519,311,208
050,18,103,"Indiana","Miami County",4,32,511,299,212
050,18,103,"Indiana","Miami County",4,33,467,281,186
050,18,103,"Indiana","Miami County",4,34,459,258,201
050,18,103,"Indiana","Miami County",4,35,478,297,181
050,18,103,"Indiana","Miami County",4,36,462,283,179
050,18,103,"Indiana","Miami County",4,37,450,268,182
050,18,103,"Indiana","Miami County",4,38,460,283,177
050,18,103,"Indiana","Miami County",4,39,454,280,174
050,18,103,"Indiana","Miami County",4,40,454,281,173
050,18,103,"Indiana","Miami County",4,41,450,272,178
050,18,103,"Indiana","Miami County",4,42,482,273,209
050,18,103,"Indiana","Miami County",4,43,471,269,202
050,18,103,"Indiana","Miami County",4,44,458,270,188
050,18,103,"Indiana","Miami County",4,45,476,290,186
050,18,103,"Indiana","Miami County",4,46,465,254,211
050,18,103,"Indiana","Miami County",4,47,446,238,208
050,18,103,"Indiana","Miami County",4,48,457,254,203
050,18,103,"Indiana","Miami County",4,49,445,251,194
050,18,103,"Indiana","Miami County",4,50,482,268,214
050,18,103,"Indiana","Miami County",4,51,481,256,225
050,18,103,"Indiana","Miami County",4,52,485,276,209
050,18,103,"Indiana","Miami County",4,53,443,248,195
050,18,103,"Indiana","Miami County",4,54,460,259,201
050,18,103,"Indiana","Miami County",4,55,444,236,208
050,18,103,"Indiana","Miami County",4,56,457,244,213
050,18,103,"Indiana","Miami County",4,57,468,247,221
050,18,103,"Indiana","Miami County",4,58,455,240,215
050,18,103,"Indiana","Miami County",4,59,497,258,239
050,18,103,"Indiana","Miami County",4,60,494,257,237
050,18,103,"Indiana","Miami County",4,61,478,242,236
050,18,103,"Indiana","Miami County",4,62,457,235,222
050,18,103,"Indiana","Miami County",4,63,464,240,224
050,18,103,"Indiana","Miami County",4,64,436,216,220
050,18,103,"Indiana","Miami County",4,65,427,208,219
050,18,103,"Indiana","Miami County",4,66,406,190,216
050,18,103,"Indiana","Miami County",4,67,420,198,222
050,18,103,"Indiana","Miami County",4,68,399,184,215
050,18,103,"Indiana","Miami County",4,69,396,191,205
050,18,103,"Indiana","Miami County",4,70,381,200,181
050,18,103,"Indiana","Miami County",4,71,381,201,180
050,18,103,"Indiana","Miami County",4,72,347,177,170
050,18,103,"Indiana","Miami County",4,73,350,170,180
050,18,103,"Indiana","Miami County",4,74,325,154,171
050,18,103,"Indiana","Miami County",4,75,350,166,184
050,18,103,"Indiana","Miami County",4,76,260,123,137
050,18,103,"Indiana","Miami County",4,77,238,118,120
050,18,103,"Indiana","Miami County",4,78,208,93,115
050,18,103,"Indiana","Miami County",4,79,226,89,137
050,18,103,"Indiana","Miami County",4,80,193,76,117
050,18,103,"Indiana","Miami County",4,81,164,80,84
050,18,103,"Indiana","Miami County",4,82,154,72,82
050,18,103,"Indiana","Miami County",4,83,141,56,85
050,18,103,"Indiana","Miami County",4,84,134,56,78
050,18,103,"Indiana","Miami County",4,85,612,239,373
050,18,103,"Indiana","Miami County",5,0,334,168,166
050,18,103,"Indiana","Miami County",5,1,367,207,160
050,18,103,"Indiana","Miami County",5,2,351,194,157
050,18,103,"Indiana","Miami County",5,3,357,183,174
050,18,103,"Indiana","Miami County",5,4,390,198,192
050,18,103,"Indiana","Miami County",5,5,377,202,175
050,18,103,"Indiana","Miami County",5,6,404,206,198
050,18,103,"Indiana","Miami County",5,7,408,206,202
050,18,103,"Indiana","Miami County",5,8,399,216,183
050,18,103,"Indiana","Miami County",5,9,424,226,198
050,18,103,"Indiana","Miami County",5,10,421,227,194
050,18,103,"Indiana","Miami County",5,11,379,194,185
050,18,103,"Indiana","Miami County",5,12,415,208,207
050,18,103,"Indiana","Miami County",5,13,405,202,203
050,18,103,"Indiana","Miami County",5,14,442,229,213
050,18,103,"Indiana","Miami County",5,15,489,251,238
050,18,103,"Indiana","Miami County",5,16,496,247,249
050,18,103,"Indiana","Miami County",5,17,452,237,215
050,18,103,"Indiana","Miami County",5,18,409,217,192
050,18,103,"Indiana","Miami County",5,19,349,205,144
050,18,103,"Indiana","Miami County",5,20,396,235,161
050,18,103,"Indiana","Miami County",5,21,409,253,156
050,18,103,"Indiana","Miami County",5,22,434,272,162
050,18,103,"Indiana","Miami County",5,23,478,296,182
050,18,103,"Indiana","Miami County",5,24,482,303,179
050,18,103,"Indiana","Miami County",5,25,437,252,185
050,18,103,"Indiana","Miami County",5,26,444,270,174
050,18,103,"Indiana","Miami County",5,27,476,292,184
050,18,103,"Indiana","Miami County",5,28,475,308,167
050,18,103,"Indiana","Miami County",5,29,452,286,166
050,18,103,"Indiana","Miami County",5,30,482,285,197
050,18,103,"Indiana","Miami County",5,31,466,287,179
050,18,103,"Indiana","Miami County",5,32,522,310,212
050,18,103,"Indiana","Miami County",5,33,499,278,221
050,18,103,"Indiana","Miami County",5,34,465,278,187
050,18,103,"Indiana","Miami County",5,35,456,261,195
050,18,103,"Indiana","Miami County",5,36,460,285,175
050,18,103,"Indiana","Miami County",5,37,467,289,178
050,18,103,"Indiana","Miami County",5,38,459,275,184
050,18,103,"Indiana","Miami County",5,39,458,283,175
050,18,103,"Indiana","Miami County",5,40,453,271,182
050,18,103,"Indiana","Miami County",5,41,450,276,174
050,18,103,"Indiana","Miami County",5,42,456,270,186
050,18,103,"Indiana","Miami County",5,43,476,268,208
050,18,103,"Indiana","Miami County",5,44,491,285,206
050,18,103,"Indiana","Miami County",5,45,472,278,194
050,18,103,"Indiana","Miami County",5,46,450,267,183
050,18,103,"Indiana","Miami County",5,47,455,245,210
050,18,103,"Indiana","Miami County",5,48,469,258,211
050,18,103,"Indiana","Miami County",5,49,462,257,205
050,18,103,"Indiana","Miami County",5,50,454,265,189
050,18,103,"Indiana","Miami County",5,51,457,244,213
050,18,103,"Indiana","Miami County",5,52,504,268,236
050,18,103,"Indiana","Miami County",5,53,471,266,205
050,18,103,"Indiana","Miami County",5,54,444,250,194
050,18,103,"Indiana","Miami County",5,55,447,248,199
050,18,103,"Indiana","Miami County",5,56,446,236,210
050,18,103,"Indiana","Miami County",5,57,444,232,212
050,18,103,"Indiana","Miami County",5,58,450,237,213
050,18,103,"Indiana","Miami County",5,59,462,243,219
050,18,103,"Indiana","Miami County",5,60,483,253,230
050,18,103,"Indiana","Miami County",5,61,489,263,226
050,18,103,"Indiana","Miami County",5,62,474,233,241
050,18,103,"Indiana","Miami County",5,63,454,235,219
050,18,103,"Indiana","Miami County",5,64,449,227,222
050,18,103,"Indiana","Miami County",5,65,424,211,213
050,18,103,"Indiana","Miami County",5,66,422,202,220
050,18,103,"Indiana","Miami County",5,67,405,190,215
050,18,103,"Indiana","Miami County",5,68,400,187,213
050,18,103,"Indiana","Miami County",5,69,383,178,205
050,18,103,"Indiana","Miami County",5,70,384,188,196
050,18,103,"Indiana","Miami County",5,71,375,200,175
050,18,103,"Indiana","Miami County",5,72,362,191,171
050,18,103,"Indiana","Miami County",5,73,341,173,168
050,18,103,"Indiana","Miami County",5,74,345,171,174
050,18,103,"Indiana","Miami County",5,75,301,143,158
050,18,103,"Indiana","Miami County",5,76,329,150,179
050,18,103,"Indiana","Miami County",5,77,249,119,130
050,18,103,"Indiana","Miami County",5,78,219,107,112
050,18,103,"Indiana","Miami County",5,79,197,84,113
050,18,103,"Indiana","Miami County",5,80,208,81,127
050,18,103,"Indiana","Miami County",5,81,180,71,109
050,18,103,"Indiana","Miami County",5,82,143,67,76
050,18,103,"Indiana","Miami County",5,83,143,66,77
050,18,103,"Indiana","Miami County",5,84,144,57,87
050,18,103,"Indiana","Miami County",5,85,601,245,356
050,18,105,"Indiana","Monroe County",1,0,1194,613,581
050,18,105,"Indiana","Monroe County",1,1,1185,603,582
050,18,105,"Indiana","Monroe County",1,2,1249,635,614
050,18,105,"Indiana","Monroe County",1,3,1225,667,558
050,18,105,"Indiana","Monroe County",1,4,1268,670,598
050,18,105,"Indiana","Monroe County",1,5,1264,661,603
050,18,105,"Indiana","Monroe County",1,6,1244,631,613
050,18,105,"Indiana","Monroe County",1,7,1221,638,583
050,18,105,"Indiana","Monroe County",1,8,1236,672,564
050,18,105,"Indiana","Monroe County",1,9,1209,633,576
050,18,105,"Indiana","Monroe County",1,10,1276,677,599
050,18,105,"Indiana","Monroe County",1,11,1279,683,596
050,18,105,"Indiana","Monroe County",1,12,1299,718,581
050,18,105,"Indiana","Monroe County",1,13,1291,682,609
050,18,105,"Indiana","Monroe County",1,14,1252,645,607
050,18,105,"Indiana","Monroe County",1,15,1256,639,617
050,18,105,"Indiana","Monroe County",1,16,1304,657,647
050,18,105,"Indiana","Monroe County",1,17,1343,648,695
050,18,105,"Indiana","Monroe County",1,18,2865,1362,1503
050,18,105,"Indiana","Monroe County",1,19,6473,3222,3251
050,18,105,"Indiana","Monroe County",1,20,6349,3087,3262
050,18,105,"Indiana","Monroe County",1,21,6155,2941,3214
050,18,105,"Indiana","Monroe County",1,22,5331,2800,2531
050,18,105,"Indiana","Monroe County",1,23,3889,2076,1813
050,18,105,"Indiana","Monroe County",1,24,3037,1544,1493
050,18,105,"Indiana","Monroe County",1,25,2616,1381,1235
050,18,105,"Indiana","Monroe County",1,26,2410,1315,1095
050,18,105,"Indiana","Monroe County",1,27,2038,1092,946
050,18,105,"Indiana","Monroe County",1,28,2020,1027,993
050,18,105,"Indiana","Monroe County",1,29,2007,1043,964
050,18,105,"Indiana","Monroe County",1,30,1995,1072,923
050,18,105,"Indiana","Monroe County",1,31,1846,996,850
050,18,105,"Indiana","Monroe County",1,32,1806,961,845
050,18,105,"Indiana","Monroe County",1,33,1720,906,814
050,18,105,"Indiana","Monroe County",1,34,1631,847,784
050,18,105,"Indiana","Monroe County",1,35,1546,796,750
050,18,105,"Indiana","Monroe County",1,36,1541,816,725
050,18,105,"Indiana","Monroe County",1,37,1670,864,806
050,18,105,"Indiana","Monroe County",1,38,1663,840,823
050,18,105,"Indiana","Monroe County",1,39,1696,859,837
050,18,105,"Indiana","Monroe County",1,40,1610,825,785
050,18,105,"Indiana","Monroe County",1,41,1536,773,763
050,18,105,"Indiana","Monroe County",1,42,1492,757,735
050,18,105,"Indiana","Monroe County",1,43,1475,722,753
050,18,105,"Indiana","Monroe County",1,44,1410,709,701
050,18,105,"Indiana","Monroe County",1,45,1340,678,662
050,18,105,"Indiana","Monroe County",1,46,1274,636,638
050,18,105,"Indiana","Monroe County",1,47,1305,646,659
050,18,105,"Indiana","Monroe County",1,48,1297,639,658
050,18,105,"Indiana","Monroe County",1,49,1462,751,711
050,18,105,"Indiana","Monroe County",1,50,1394,712,682
050,18,105,"Indiana","Monroe County",1,51,1390,694,696
050,18,105,"Indiana","Monroe County",1,52,1327,663,664
050,18,105,"Indiana","Monroe County",1,53,1317,636,681
050,18,105,"Indiana","Monroe County",1,54,1360,664,696
050,18,105,"Indiana","Monroe County",1,55,1408,734,674
050,18,105,"Indiana","Monroe County",1,56,1396,712,684
050,18,105,"Indiana","Monroe County",1,57,1400,681,719
050,18,105,"Indiana","Monroe County",1,58,1450,718,732
050,18,105,"Indiana","Monroe County",1,59,1474,711,763
050,18,105,"Indiana","Monroe County",1,60,1446,703,743
050,18,105,"Indiana","Monroe County",1,61,1466,692,774
050,18,105,"Indiana","Monroe County",1,62,1513,735,778
050,18,105,"Indiana","Monroe County",1,63,1477,697,780
050,18,105,"Indiana","Monroe County",1,64,1451,674,777
050,18,105,"Indiana","Monroe County",1,65,1443,664,779
050,18,105,"Indiana","Monroe County",1,66,1417,692,725
050,18,105,"Indiana","Monroe County",1,67,1333,639,694
050,18,105,"Indiana","Monroe County",1,68,1249,575,674
050,18,105,"Indiana","Monroe County",1,69,1124,518,606
050,18,105,"Indiana","Monroe County",1,70,1092,532,560
050,18,105,"Indiana","Monroe County",1,71,1086,533,553
050,18,105,"Indiana","Monroe County",1,72,1076,505,571
050,18,105,"Indiana","Monroe County",1,73,1085,484,601
050,18,105,"Indiana","Monroe County",1,74,731,316,415
050,18,105,"Indiana","Monroe County",1,75,711,327,384
050,18,105,"Indiana","Monroe County",1,76,693,313,380
050,18,105,"Indiana","Monroe County",1,77,700,300,400
050,18,105,"Indiana","Monroe County",1,78,595,269,326
050,18,105,"Indiana","Monroe County",1,79,585,269,316
050,18,105,"Indiana","Monroe County",1,80,509,228,281
050,18,105,"Indiana","Monroe County",1,81,468,191,277
050,18,105,"Indiana","Monroe County",1,82,416,172,244
050,18,105,"Indiana","Monroe County",1,83,363,140,223
050,18,105,"Indiana","Monroe County",1,84,357,137,220
050,18,105,"Indiana","Monroe County",1,85,2309,808,1501
050,18,105,"Indiana","Monroe County",2,0,1173,599,574
050,18,105,"Indiana","Monroe County",2,1,1188,606,582
050,18,105,"Indiana","Monroe County",2,2,1232,628,604
050,18,105,"Indiana","Monroe County",2,3,1228,658,570
050,18,105,"Indiana","Monroe County",2,4,1257,667,590
050,18,105,"Indiana","Monroe County",2,5,1263,660,603
050,18,105,"Indiana","Monroe County",2,6,1254,642,612
050,18,105,"Indiana","Monroe County",2,7,1228,638,590
050,18,105,"Indiana","Monroe County",2,8,1228,661,567
050,18,105,"Indiana","Monroe County",2,9,1213,643,570
050,18,105,"Indiana","Monroe County",2,10,1259,669,590
050,18,105,"Indiana","Monroe County",2,11,1270,679,591
050,18,105,"Indiana","Monroe County",2,12,1298,711,587
050,18,105,"Indiana","Monroe County",2,13,1297,694,603
050,18,105,"Indiana","Monroe County",2,14,1259,652,607
050,18,105,"Indiana","Monroe County",2,15,1257,641,616
050,18,105,"Indiana","Monroe County",2,16,1294,654,640
050,18,105,"Indiana","Monroe County",2,17,1343,655,688
050,18,105,"Indiana","Monroe County",2,18,2835,1340,1495
050,18,105,"Indiana","Monroe County",2,19,6466,3210,3256
050,18,105,"Indiana","Monroe County",2,20,6396,3114,3282
050,18,105,"Indiana","Monroe County",2,21,6165,2938,3227
050,18,105,"Indiana","Monroe County",2,22,5287,2787,2500
050,18,105,"Indiana","Monroe County",2,23,3886,2083,1803
050,18,105,"Indiana","Monroe County",2,24,3012,1520,1492
050,18,105,"Indiana","Monroe County",2,25,2601,1377,1224
050,18,105,"Indiana","Monroe County",2,26,2373,1287,1086
050,18,105,"Indiana","Monroe County",2,27,2037,1094,943
050,18,105,"Indiana","Monroe County",2,28,1997,1027,970
050,18,105,"Indiana","Monroe County",2,29,1985,1026,959
050,18,105,"Indiana","Monroe County",2,30,1988,1056,932
050,18,105,"Indiana","Monroe County",2,31,1852,1000,852
050,18,105,"Indiana","Monroe County",2,32,1794,957,837
050,18,105,"Indiana","Monroe County",2,33,1726,912,814
050,18,105,"Indiana","Monroe County",2,34,1642,855,787
050,18,105,"Indiana","Monroe County",2,35,1567,810,757
050,18,105,"Indiana","Monroe County",2,36,1529,802,727
050,18,105,"Indiana","Monroe County",2,37,1637,848,789
050,18,105,"Indiana","Monroe County",2,38,1672,847,825
050,18,105,"Indiana","Monroe County",2,39,1682,851,831
050,18,105,"Indiana","Monroe County",2,40,1638,835,803
050,18,105,"Indiana","Monroe County",2,41,1550,784,766
050,18,105,"Indiana","Monroe County",2,42,1490,754,736
050,18,105,"Indiana","Monroe County",2,43,1484,733,751
050,18,105,"Indiana","Monroe County",2,44,1410,705,705
050,18,105,"Indiana","Monroe County",2,45,1362,689,673
050,18,105,"Indiana","Monroe County",2,46,1289,647,642
050,18,105,"Indiana","Monroe County",2,47,1294,642,652
050,18,105,"Indiana","Monroe County",2,48,1295,638,657
050,18,105,"Indiana","Monroe County",2,49,1420,724,696
050,18,105,"Indiana","Monroe County",2,50,1409,720,689
050,18,105,"Indiana","Monroe County",2,51,1382,694,688
050,18,105,"Indiana","Monroe County",2,52,1334,667,667
050,18,105,"Indiana","Monroe County",2,53,1316,640,676
050,18,105,"Indiana","Monroe County",2,54,1342,654,688
050,18,105,"Indiana","Monroe County",2,55,1397,720,677
050,18,105,"Indiana","Monroe County",2,56,1395,715,680
050,18,105,"Indiana","Monroe County",2,57,1402,690,712
050,18,105,"Indiana","Monroe County",2,58,1434,705,729
050,18,105,"Indiana","Monroe County",2,59,1465,709,756
050,18,105,"Indiana","Monroe County",2,60,1448,701,747
050,18,105,"Indiana","Monroe County",2,61,1454,690,764
050,18,105,"Indiana","Monroe County",2,62,1502,726,776
050,18,105,"Indiana","Monroe County",2,63,1499,713,786
050,18,105,"Indiana","Monroe County",2,64,1446,674,772
050,18,105,"Indiana","Monroe County",2,65,1435,659,776
050,18,105,"Indiana","Monroe County",2,66,1418,682,736
050,18,105,"Indiana","Monroe County",2,67,1341,643,698
050,18,105,"Indiana","Monroe County",2,68,1254,582,672
050,18,105,"Indiana","Monroe County",2,69,1161,532,629
050,18,105,"Indiana","Monroe County",2,70,1090,521,569
050,18,105,"Indiana","Monroe County",2,71,1090,533,557
050,18,105,"Indiana","Monroe County",2,72,1058,501,557
050,18,105,"Indiana","Monroe County",2,73,1132,510,622
050,18,105,"Indiana","Monroe County",2,74,763,332,431
050,18,105,"Indiana","Monroe County",2,75,715,326,389
050,18,105,"Indiana","Monroe County",2,76,681,305,376
050,18,105,"Indiana","Monroe County",2,77,712,310,402
050,18,105,"Indiana","Monroe County",2,78,605,271,334
050,18,105,"Indiana","Monroe County",2,79,578,264,314
050,18,105,"Indiana","Monroe County",2,80,523,237,286
050,18,105,"Indiana","Monroe County",2,81,472,196,276
050,18,105,"Indiana","Monroe County",2,82,417,166,251
050,18,105,"Indiana","Monroe County",2,83,368,146,222
050,18,105,"Indiana","Monroe County",2,84,351,136,215
050,18,105,"Indiana","Monroe County",2,85,2294,799,1495
050,18,105,"Indiana","Monroe County",3,0,1100,599,501
050,18,105,"Indiana","Monroe County",3,1,1143,574,569
050,18,105,"Indiana","Monroe County",3,2,1193,606,587
050,18,105,"Indiana","Monroe County",3,3,1230,643,587
050,18,105,"Indiana","Monroe County",3,4,1242,654,588
050,18,105,"Indiana","Monroe County",3,5,1252,663,589
050,18,105,"Indiana","Monroe County",3,6,1278,668,610
050,18,105,"Indiana","Monroe County",3,7,1247,643,604
050,18,105,"Indiana","Monroe County",3,8,1202,628,574
050,18,105,"Indiana","Monroe County",3,9,1222,642,580
050,18,105,"Indiana","Monroe County",3,10,1220,641,579
050,18,105,"Indiana","Monroe County",3,11,1272,669,603
050,18,105,"Indiana","Monroe County",3,12,1274,672,602
050,18,105,"Indiana","Monroe County",3,13,1314,724,590
050,18,105,"Indiana","Monroe County",3,14,1292,685,607
050,18,105,"Indiana","Monroe County",3,15,1253,652,601
050,18,105,"Indiana","Monroe County",3,16,1297,664,633
050,18,105,"Indiana","Monroe County",3,17,1348,671,677
050,18,105,"Indiana","Monroe County",3,18,2823,1314,1509
050,18,105,"Indiana","Monroe County",3,19,6463,3193,3270
050,18,105,"Indiana","Monroe County",3,20,6516,3156,3360
050,18,105,"Indiana","Monroe County",3,21,6328,2999,3329
050,18,105,"Indiana","Monroe County",3,22,5378,2837,2541
050,18,105,"Indiana","Monroe County",3,23,3903,2088,1815
050,18,105,"Indiana","Monroe County",3,24,3024,1515,1509
050,18,105,"Indiana","Monroe County",3,25,2592,1363,1229
050,18,105,"Indiana","Monroe County",3,26,2306,1230,1076
050,18,105,"Indiana","Monroe County",3,27,1969,1067,902
050,18,105,"Indiana","Monroe County",3,28,1970,1057,913
050,18,105,"Indiana","Monroe County",3,29,1920,1011,909
050,18,105,"Indiana","Monroe County",3,30,1911,996,915
050,18,105,"Indiana","Monroe County",3,31,1845,964,881
050,18,105,"Indiana","Monroe County",3,32,1774,952,822
050,18,105,"Indiana","Monroe County",3,33,1746,918,828
050,18,105,"Indiana","Monroe County",3,34,1681,904,777
050,18,105,"Indiana","Monroe County",3,35,1613,842,771
050,18,105,"Indiana","Monroe County",3,36,1551,800,751
050,18,105,"Indiana","Monroe County",3,37,1537,800,737
050,18,105,"Indiana","Monroe County",3,38,1642,839,803
050,18,105,"Indiana","Monroe County",3,39,1661,834,827
050,18,105,"Indiana","Monroe County",3,40,1662,855,807
050,18,105,"Indiana","Monroe County",3,41,1637,835,802
050,18,105,"Indiana","Monroe County",3,42,1525,770,755
050,18,105,"Indiana","Monroe County",3,43,1482,757,725
050,18,105,"Indiana","Monroe County",3,44,1466,718,748
050,18,105,"Indiana","Monroe County",3,45,1413,711,702
050,18,105,"Indiana","Monroe County",3,46,1348,669,679
050,18,105,"Indiana","Monroe County",3,47,1302,652,650
050,18,105,"Indiana","Monroe County",3,48,1281,628,653
050,18,105,"Indiana","Monroe County",3,49,1301,651,650
050,18,105,"Indiana","Monroe County",3,50,1423,726,697
050,18,105,"Indiana","Monroe County",3,51,1422,729,693
050,18,105,"Indiana","Monroe County",3,52,1386,690,696
050,18,105,"Indiana","Monroe County",3,53,1325,664,661
050,18,105,"Indiana","Monroe County",3,54,1324,637,687
050,18,105,"Indiana","Monroe County",3,55,1346,656,690
050,18,105,"Indiana","Monroe County",3,56,1384,703,681
050,18,105,"Indiana","Monroe County",3,57,1399,709,690
050,18,105,"Indiana","Monroe County",3,58,1406,688,718
050,18,105,"Indiana","Monroe County",3,59,1436,708,728
050,18,105,"Indiana","Monroe County",3,60,1474,717,757
050,18,105,"Indiana","Monroe County",3,61,1420,681,739
050,18,105,"Indiana","Monroe County",3,62,1437,683,754
050,18,105,"Indiana","Monroe County",3,63,1506,725,781
050,18,105,"Indiana","Monroe County",3,64,1490,715,775
050,18,105,"Indiana","Monroe County",3,65,1433,653,780
050,18,105,"Indiana","Monroe County",3,66,1414,653,761
050,18,105,"Indiana","Monroe County",3,67,1391,665,726
050,18,105,"Indiana","Monroe County",3,68,1321,633,688
050,18,105,"Indiana","Monroe County",3,69,1216,557,659
050,18,105,"Indiana","Monroe County",3,70,1123,515,608
050,18,105,"Indiana","Monroe County",3,71,1063,497,566
050,18,105,"Indiana","Monroe County",3,72,1060,517,543
050,18,105,"Indiana","Monroe County",3,73,1034,492,542
050,18,105,"Indiana","Monroe County",3,74,1085,486,599
050,18,105,"Indiana","Monroe County",3,75,745,321,424
050,18,105,"Indiana","Monroe County",3,76,706,313,393
050,18,105,"Indiana","Monroe County",3,77,677,295,382
050,18,105,"Indiana","Monroe County",3,78,682,305,377
050,18,105,"Indiana","Monroe County",3,79,588,254,334
050,18,105,"Indiana","Monroe County",3,80,547,255,292
050,18,105,"Indiana","Monroe County",3,81,510,214,296
050,18,105,"Indiana","Monroe County",3,82,446,180,266
050,18,105,"Indiana","Monroe County",3,83,388,150,238
050,18,105,"Indiana","Monroe County",3,84,353,138,215
050,18,105,"Indiana","Monroe County",3,85,2267,788,1479
050,18,105,"Indiana","Monroe County",4,0,1133,565,568
050,18,105,"Indiana","Monroe County",4,1,1031,569,462
050,18,105,"Indiana","Monroe County",4,2,1113,564,549
050,18,105,"Indiana","Monroe County",4,3,1197,616,581
050,18,105,"Indiana","Monroe County",4,4,1220,634,586
050,18,105,"Indiana","Monroe County",4,5,1217,653,564
050,18,105,"Indiana","Monroe County",4,6,1248,666,582
050,18,105,"Indiana","Monroe County",4,7,1258,654,604
050,18,105,"Indiana","Monroe County",4,8,1211,617,594
050,18,105,"Indiana","Monroe County",4,9,1214,619,595
050,18,105,"Indiana","Monroe County",4,10,1267,663,604
050,18,105,"Indiana","Monroe County",4,11,1192,626,566
050,18,105,"Indiana","Monroe County",4,12,1252,653,599
050,18,105,"Indiana","Monroe County",4,13,1273,684,589
050,18,105,"Indiana","Monroe County",4,14,1303,706,597
050,18,105,"Indiana","Monroe County",4,15,1301,694,607
050,18,105,"Indiana","Monroe County",4,16,1285,667,618
050,18,105,"Indiana","Monroe County",4,17,1382,700,682
050,18,105,"Indiana","Monroe County",4,18,2812,1336,1476
050,18,105,"Indiana","Monroe County",4,19,6376,3137,3239
050,18,105,"Indiana","Monroe County",4,20,6396,3093,3303
050,18,105,"Indiana","Monroe County",4,21,6386,2985,3401
050,18,105,"Indiana","Monroe County",4,22,5595,2900,2695
050,18,105,"Indiana","Monroe County",4,23,3862,2091,1771
050,18,105,"Indiana","Monroe County",4,24,2961,1473,1488
050,18,105,"Indiana","Monroe County",4,25,2547,1342,1205
050,18,105,"Indiana","Monroe County",4,26,2338,1224,1114
050,18,105,"Indiana","Monroe County",4,27,1913,1003,910
050,18,105,"Indiana","Monroe County",4,28,1862,1006,856
050,18,105,"Indiana","Monroe County",4,29,1920,1025,895
050,18,105,"Indiana","Monroe County",4,30,1848,969,879
050,18,105,"Indiana","Monroe County",4,31,1814,946,868
050,18,105,"Indiana","Monroe County",4,32,1790,931,859
050,18,105,"Indiana","Monroe County",4,33,1694,900,794
050,18,105,"Indiana","Monroe County",4,34,1679,870,809
050,18,105,"Indiana","Monroe County",4,35,1633,872,761
050,18,105,"Indiana","Monroe County",4,36,1554,794,760
050,18,105,"Indiana","Monroe County",4,37,1515,777,738
050,18,105,"Indiana","Monroe County",4,38,1488,764,724
050,18,105,"Indiana","Monroe County",4,39,1611,830,781
050,18,105,"Indiana","Monroe County",4,40,1629,817,812
050,18,105,"Indiana","Monroe County",4,41,1618,824,794
050,18,105,"Indiana","Monroe County",4,42,1601,812,789
050,18,105,"Indiana","Monroe County",4,43,1505,758,747
050,18,105,"Indiana","Monroe County",4,44,1479,743,736
050,18,105,"Indiana","Monroe County",4,45,1471,717,754
050,18,105,"Indiana","Monroe County",4,46,1413,706,707
050,18,105,"Indiana","Monroe County",4,47,1347,670,677
050,18,105,"Indiana","Monroe County",4,48,1285,635,650
050,18,105,"Indiana","Monroe County",4,49,1255,615,640
050,18,105,"Indiana","Monroe County",4,50,1274,639,635
050,18,105,"Indiana","Monroe County",4,51,1409,729,680
050,18,105,"Indiana","Monroe County",4,52,1387,714,673
050,18,105,"Indiana","Monroe County",4,53,1370,686,684
050,18,105,"Indiana","Monroe County",4,54,1310,653,657
050,18,105,"Indiana","Monroe County",4,55,1311,638,673
050,18,105,"Indiana","Monroe County",4,56,1319,636,683
050,18,105,"Indiana","Monroe County",4,57,1383,703,680
050,18,105,"Indiana","Monroe County",4,58,1408,711,697
050,18,105,"Indiana","Monroe County",4,59,1388,671,717
050,18,105,"Indiana","Monroe County",4,60,1418,700,718
050,18,105,"Indiana","Monroe County",4,61,1453,706,747
050,18,105,"Indiana","Monroe County",4,62,1382,660,722
050,18,105,"Indiana","Monroe County",4,63,1432,680,752
050,18,105,"Indiana","Monroe County",4,64,1477,709,768
050,18,105,"Indiana","Monroe County",4,65,1465,690,775
050,18,105,"Indiana","Monroe County",4,66,1391,642,749
050,18,105,"Indiana","Monroe County",4,67,1364,635,729
050,18,105,"Indiana","Monroe County",4,68,1368,650,718
050,18,105,"Indiana","Monroe County",4,69,1288,609,679
050,18,105,"Indiana","Monroe County",4,70,1195,551,644
050,18,105,"Indiana","Monroe County",4,71,1105,499,606
050,18,105,"Indiana","Monroe County",4,72,1043,487,556
050,18,105,"Indiana","Monroe County",4,73,1034,510,524
050,18,105,"Indiana","Monroe County",4,74,998,469,529
050,18,105,"Indiana","Monroe County",4,75,1055,471,584
050,18,105,"Indiana","Monroe County",4,76,722,313,409
050,18,105,"Indiana","Monroe County",4,77,694,301,393
050,18,105,"Indiana","Monroe County",4,78,643,285,358
050,18,105,"Indiana","Monroe County",4,79,656,285,371
050,18,105,"Indiana","Monroe County",4,80,552,247,305
050,18,105,"Indiana","Monroe County",4,81,517,230,287
050,18,105,"Indiana","Monroe County",4,82,476,192,284
050,18,105,"Indiana","Monroe County",4,83,404,158,246
050,18,105,"Indiana","Monroe County",4,84,361,142,219
050,18,105,"Indiana","Monroe County",4,85,2275,795,1480
050,18,105,"Indiana","Monroe County",5,0,1144,575,569
050,18,105,"Indiana","Monroe County",5,1,1137,569,568
050,18,105,"Indiana","Monroe County",5,2,1008,552,456
050,18,105,"Indiana","Monroe County",5,3,1147,575,572
050,18,105,"Indiana","Monroe County",5,4,1167,591,576
050,18,105,"Indiana","Monroe County",5,5,1209,619,590
050,18,105,"Indiana","Monroe County",5,6,1208,634,574
050,18,105,"Indiana","Monroe County",5,7,1234,662,572
050,18,105,"Indiana","Monroe County",5,8,1218,631,587
050,18,105,"Indiana","Monroe County",5,9,1240,624,616
050,18,105,"Indiana","Monroe County",5,10,1243,634,609
050,18,105,"Indiana","Monroe County",5,11,1250,655,595
050,18,105,"Indiana","Monroe County",5,12,1174,618,556
050,18,105,"Indiana","Monroe County",5,13,1262,663,599
050,18,105,"Indiana","Monroe County",5,14,1296,689,607
050,18,105,"Indiana","Monroe County",5,15,1301,701,600
050,18,105,"Indiana","Monroe County",5,16,1343,733,610
050,18,105,"Indiana","Monroe County",5,17,1379,702,677
050,18,105,"Indiana","Monroe County",5,18,2823,1345,1478
050,18,105,"Indiana","Monroe County",5,19,6408,3170,3238
050,18,105,"Indiana","Monroe County",5,20,6304,3037,3267
050,18,105,"Indiana","Monroe County",5,21,6254,2940,3314
050,18,105,"Indiana","Monroe County",5,22,5572,2880,2692
050,18,105,"Indiana","Monroe County",5,23,4022,2119,1903
050,18,105,"Indiana","Monroe County",5,24,3005,1536,1469
050,18,105,"Indiana","Monroe County",5,25,2505,1321,1184
050,18,105,"Indiana","Monroe County",5,26,2282,1181,1101
050,18,105,"Indiana","Monroe County",5,27,1889,979,910
050,18,105,"Indiana","Monroe County",5,28,1768,925,843
050,18,105,"Indiana","Monroe County",5,29,1809,960,849
050,18,105,"Indiana","Monroe County",5,30,1835,983,852
050,18,105,"Indiana","Monroe County",5,31,1779,941,838
050,18,105,"Indiana","Monroe County",5,32,1755,909,846
050,18,105,"Indiana","Monroe County",5,33,1780,914,866
050,18,105,"Indiana","Monroe County",5,34,1611,847,764
050,18,105,"Indiana","Monroe County",5,35,1649,858,791
050,18,105,"Indiana","Monroe County",5,36,1570,840,730
050,18,105,"Indiana","Monroe County",5,37,1536,781,755
050,18,105,"Indiana","Monroe County",5,38,1497,765,732
050,18,105,"Indiana","Monroe County",5,39,1459,740,719
050,18,105,"Indiana","Monroe County",5,40,1546,800,746
050,18,105,"Indiana","Monroe County",5,41,1609,808,801
050,18,105,"Indiana","Monroe County",5,42,1579,801,778
050,18,105,"Indiana","Monroe County",5,43,1597,816,781
050,18,105,"Indiana","Monroe County",5,44,1489,760,729
050,18,105,"Indiana","Monroe County",5,45,1451,722,729
050,18,105,"Indiana","Monroe County",5,46,1451,705,746
050,18,105,"Indiana","Monroe County",5,47,1403,710,693
050,18,105,"Indiana","Monroe County",5,48,1327,659,668
050,18,105,"Indiana","Monroe County",5,49,1277,637,640
050,18,105,"Indiana","Monroe County",5,50,1259,603,656
050,18,105,"Indiana","Monroe County",5,51,1242,628,614
050,18,105,"Indiana","Monroe County",5,52,1375,705,670
050,18,105,"Indiana","Monroe County",5,53,1370,717,653
050,18,105,"Indiana","Monroe County",5,54,1369,690,679
050,18,105,"Indiana","Monroe County",5,55,1291,645,646
050,18,105,"Indiana","Monroe County",5,56,1312,638,674
050,18,105,"Indiana","Monroe County",5,57,1309,622,687
050,18,105,"Indiana","Monroe County",5,58,1377,702,675
050,18,105,"Indiana","Monroe County",5,59,1379,690,689
050,18,105,"Indiana","Monroe County",5,60,1382,660,722
050,18,105,"Indiana","Monroe County",5,61,1385,686,699
050,18,105,"Indiana","Monroe County",5,62,1427,695,732
050,18,105,"Indiana","Monroe County",5,63,1375,656,719
050,18,105,"Indiana","Monroe County",5,64,1394,662,732
050,18,105,"Indiana","Monroe County",5,65,1448,690,758
050,18,105,"Indiana","Monroe County",5,66,1458,686,772
050,18,105,"Indiana","Monroe County",5,67,1354,627,727
050,18,105,"Indiana","Monroe County",5,68,1349,622,727
050,18,105,"Indiana","Monroe County",5,69,1327,625,702
050,18,105,"Indiana","Monroe County",5,70,1271,592,679
050,18,105,"Indiana","Monroe County",5,71,1191,539,652
050,18,105,"Indiana","Monroe County",5,72,1094,500,594
050,18,105,"Indiana","Monroe County",5,73,1026,480,546
050,18,105,"Indiana","Monroe County",5,74,999,492,507
050,18,105,"Indiana","Monroe County",5,75,967,452,515
050,18,105,"Indiana","Monroe County",5,76,1026,452,574
050,18,105,"Indiana","Monroe County",5,77,707,303,404
050,18,105,"Indiana","Monroe County",5,78,671,293,378
050,18,105,"Indiana","Monroe County",5,79,623,271,352
050,18,105,"Indiana","Monroe County",5,80,623,277,346
050,18,105,"Indiana","Monroe County",5,81,534,225,309
050,18,105,"Indiana","Monroe County",5,82,481,213,268
050,18,105,"Indiana","Monroe County",5,83,445,174,271
050,18,105,"Indiana","Monroe County",5,84,383,152,231
050,18,105,"Indiana","Monroe County",5,85,2318,817,1501
050,18,107,"Indiana","Montgomery County",1,0,426,219,207
050,18,107,"Indiana","Montgomery County",1,1,428,235,193
050,18,107,"Indiana","Montgomery County",1,2,438,242,196
050,18,107,"Indiana","Montgomery County",1,3,456,241,215
050,18,107,"Indiana","Montgomery County",1,4,466,246,220
050,18,107,"Indiana","Montgomery County",1,5,453,230,223
050,18,107,"Indiana","Montgomery County",1,6,454,233,221
050,18,107,"Indiana","Montgomery County",1,7,503,259,244
050,18,107,"Indiana","Montgomery County",1,8,495,265,230
050,18,107,"Indiana","Montgomery County",1,9,511,266,245
050,18,107,"Indiana","Montgomery County",1,10,543,264,279
050,18,107,"Indiana","Montgomery County",1,11,502,249,253
050,18,107,"Indiana","Montgomery County",1,12,539,266,273
050,18,107,"Indiana","Montgomery County",1,13,549,262,287
050,18,107,"Indiana","Montgomery County",1,14,510,249,261
050,18,107,"Indiana","Montgomery County",1,15,507,259,248
050,18,107,"Indiana","Montgomery County",1,16,525,276,249
050,18,107,"Indiana","Montgomery County",1,17,497,262,235
050,18,107,"Indiana","Montgomery County",1,18,497,296,201
050,18,107,"Indiana","Montgomery County",1,19,571,402,169
050,18,107,"Indiana","Montgomery County",1,20,578,396,182
050,18,107,"Indiana","Montgomery County",1,21,522,334,188
050,18,107,"Indiana","Montgomery County",1,22,478,278,200
050,18,107,"Indiana","Montgomery County",1,23,398,192,206
050,18,107,"Indiana","Montgomery County",1,24,383,189,194
050,18,107,"Indiana","Montgomery County",1,25,431,212,219
050,18,107,"Indiana","Montgomery County",1,26,452,224,228
050,18,107,"Indiana","Montgomery County",1,27,449,227,222
050,18,107,"Indiana","Montgomery County",1,28,455,228,227
050,18,107,"Indiana","Montgomery County",1,29,473,238,235
050,18,107,"Indiana","Montgomery County",1,30,437,222,215
050,18,107,"Indiana","Montgomery County",1,31,452,231,221
050,18,107,"Indiana","Montgomery County",1,32,459,238,221
050,18,107,"Indiana","Montgomery County",1,33,438,229,209
050,18,107,"Indiana","Montgomery County",1,34,410,216,194
050,18,107,"Indiana","Montgomery County",1,35,468,247,221
050,18,107,"Indiana","Montgomery County",1,36,428,219,209
050,18,107,"Indiana","Montgomery County",1,37,458,240,218
050,18,107,"Indiana","Montgomery County",1,38,438,228,210
050,18,107,"Indiana","Montgomery County",1,39,423,220,203
050,18,107,"Indiana","Montgomery County",1,40,408,207,201
050,18,107,"Indiana","Montgomery County",1,41,415,220,195
050,18,107,"Indiana","Montgomery County",1,42,392,209,183
050,18,107,"Indiana","Montgomery County",1,43,415,203,212
050,18,107,"Indiana","Montgomery County",1,44,430,205,225
050,18,107,"Indiana","Montgomery County",1,45,436,220,216
050,18,107,"Indiana","Montgomery County",1,46,427,200,227
050,18,107,"Indiana","Montgomery County",1,47,438,208,230
050,18,107,"Indiana","Montgomery County",1,48,462,246,216
050,18,107,"Indiana","Montgomery County",1,49,500,258,242
050,18,107,"Indiana","Montgomery County",1,50,462,240,222
050,18,107,"Indiana","Montgomery County",1,51,450,239,211
050,18,107,"Indiana","Montgomery County",1,52,465,242,223
050,18,107,"Indiana","Montgomery County",1,53,497,258,239
050,18,107,"Indiana","Montgomery County",1,54,460,226,234
050,18,107,"Indiana","Montgomery County",1,55,542,258,284
050,18,107,"Indiana","Montgomery County",1,56,587,291,296
050,18,107,"Indiana","Montgomery County",1,57,576,289,287
050,18,107,"Indiana","Montgomery County",1,58,576,283,293
050,18,107,"Indiana","Montgomery County",1,59,568,288,280
050,18,107,"Indiana","Montgomery County",1,60,540,275,265
050,18,107,"Indiana","Montgomery County",1,61,530,275,255
050,18,107,"Indiana","Montgomery County",1,62,547,279,268
050,18,107,"Indiana","Montgomery County",1,63,519,271,248
050,18,107,"Indiana","Montgomery County",1,64,481,247,234
050,18,107,"Indiana","Montgomery County",1,65,468,234,234
050,18,107,"Indiana","Montgomery County",1,66,464,234,230
050,18,107,"Indiana","Montgomery County",1,67,418,207,211
050,18,107,"Indiana","Montgomery County",1,68,423,213,210
050,18,107,"Indiana","Montgomery County",1,69,381,190,191
050,18,107,"Indiana","Montgomery County",1,70,368,168,200
050,18,107,"Indiana","Montgomery County",1,71,375,173,202
050,18,107,"Indiana","Montgomery County",1,72,347,161,186
050,18,107,"Indiana","Montgomery County",1,73,360,167,193
050,18,107,"Indiana","Montgomery County",1,74,267,116,151
050,18,107,"Indiana","Montgomery County",1,75,257,104,153
050,18,107,"Indiana","Montgomery County",1,76,280,120,160
050,18,107,"Indiana","Montgomery County",1,77,293,130,163
050,18,107,"Indiana","Montgomery County",1,78,251,107,144
050,18,107,"Indiana","Montgomery County",1,79,235,112,123
050,18,107,"Indiana","Montgomery County",1,80,209,98,111
050,18,107,"Indiana","Montgomery County",1,81,202,81,121
050,18,107,"Indiana","Montgomery County",1,82,188,90,98
050,18,107,"Indiana","Montgomery County",1,83,168,81,87
050,18,107,"Indiana","Montgomery County",1,84,130,62,68
050,18,107,"Indiana","Montgomery County",1,85,823,283,540
050,18,107,"Indiana","Montgomery County",2,0,421,214,207
050,18,107,"Indiana","Montgomery County",2,1,424,230,194
050,18,107,"Indiana","Montgomery County",2,2,436,240,196
050,18,107,"Indiana","Montgomery County",2,3,451,242,209
050,18,107,"Indiana","Montgomery County",2,4,466,246,220
050,18,107,"Indiana","Montgomery County",2,5,459,235,224
050,18,107,"Indiana","Montgomery County",2,6,460,235,225
050,18,107,"Indiana","Montgomery County",2,7,494,256,238
050,18,107,"Indiana","Montgomery County",2,8,496,264,232
050,18,107,"Indiana","Montgomery County",2,9,508,266,242
050,18,107,"Indiana","Montgomery County",2,10,537,265,272
050,18,107,"Indiana","Montgomery County",2,11,512,252,260
050,18,107,"Indiana","Montgomery County",2,12,537,266,271
050,18,107,"Indiana","Montgomery County",2,13,546,263,283
050,18,107,"Indiana","Montgomery County",2,14,517,252,265
050,18,107,"Indiana","Montgomery County",2,15,507,257,250
050,18,107,"Indiana","Montgomery County",2,16,520,271,249
050,18,107,"Indiana","Montgomery County",2,17,505,265,240
050,18,107,"Indiana","Montgomery County",2,18,492,292,200
050,18,107,"Indiana","Montgomery County",2,19,573,404,169
050,18,107,"Indiana","Montgomery County",2,20,582,397,185
050,18,107,"Indiana","Montgomery County",2,21,521,331,190
050,18,107,"Indiana","Montgomery County",2,22,484,282,202
050,18,107,"Indiana","Montgomery County",2,23,402,193,209
050,18,107,"Indiana","Montgomery County",2,24,384,187,197
050,18,107,"Indiana","Montgomery County",2,25,421,206,215
050,18,107,"Indiana","Montgomery County",2,26,449,222,227
050,18,107,"Indiana","Montgomery County",2,27,453,228,225
050,18,107,"Indiana","Montgomery County",2,28,455,228,227
050,18,107,"Indiana","Montgomery County",2,29,467,233,234
050,18,107,"Indiana","Montgomery County",2,30,448,224,224
050,18,107,"Indiana","Montgomery County",2,31,450,230,220
050,18,107,"Indiana","Montgomery County",2,32,459,236,223
050,18,107,"Indiana","Montgomery County",2,33,445,233,212
050,18,107,"Indiana","Montgomery County",2,34,421,224,197
050,18,107,"Indiana","Montgomery County",2,35,456,242,214
050,18,107,"Indiana","Montgomery County",2,36,434,223,211
050,18,107,"Indiana","Montgomery County",2,37,451,236,215
050,18,107,"Indiana","Montgomery County",2,38,445,230,215
050,18,107,"Indiana","Montgomery County",2,39,423,222,201
050,18,107,"Indiana","Montgomery County",2,40,413,211,202
050,18,107,"Indiana","Montgomery County",2,41,412,216,196
050,18,107,"Indiana","Montgomery County",2,42,396,211,185
050,18,107,"Indiana","Montgomery County",2,43,413,206,207
050,18,107,"Indiana","Montgomery County",2,44,423,205,218
050,18,107,"Indiana","Montgomery County",2,45,439,218,221
050,18,107,"Indiana","Montgomery County",2,46,427,203,224
050,18,107,"Indiana","Montgomery County",2,47,432,205,227
050,18,107,"Indiana","Montgomery County",2,48,458,239,219
050,18,107,"Indiana","Montgomery County",2,49,493,256,237
050,18,107,"Indiana","Montgomery County",2,50,472,245,227
050,18,107,"Indiana","Montgomery County",2,51,450,236,214
050,18,107,"Indiana","Montgomery County",2,52,457,238,219
050,18,107,"Indiana","Montgomery County",2,53,487,254,233
050,18,107,"Indiana","Montgomery County",2,54,468,234,234
050,18,107,"Indiana","Montgomery County",2,55,523,249,274
050,18,107,"Indiana","Montgomery County",2,56,574,282,292
050,18,107,"Indiana","Montgomery County",2,57,579,289,290
050,18,107,"Indiana","Montgomery County",2,58,574,282,292
050,18,107,"Indiana","Montgomery County",2,59,574,289,285
050,18,107,"Indiana","Montgomery County",2,60,543,276,267
050,18,107,"Indiana","Montgomery County",2,61,529,275,254
050,18,107,"Indiana","Montgomery County",2,62,541,276,265
050,18,107,"Indiana","Montgomery County",2,63,531,276,255
050,18,107,"Indiana","Montgomery County",2,64,484,250,234
050,18,107,"Indiana","Montgomery County",2,65,472,237,235
050,18,107,"Indiana","Montgomery County",2,66,464,233,231
050,18,107,"Indiana","Montgomery County",2,67,430,214,216
050,18,107,"Indiana","Montgomery County",2,68,418,211,207
050,18,107,"Indiana","Montgomery County",2,69,396,197,199
050,18,107,"Indiana","Montgomery County",2,70,366,170,196
050,18,107,"Indiana","Montgomery County",2,71,372,172,200
050,18,107,"Indiana","Montgomery County",2,72,347,161,186
050,18,107,"Indiana","Montgomery County",2,73,368,167,201
050,18,107,"Indiana","Montgomery County",2,74,269,119,150
050,18,107,"Indiana","Montgomery County",2,75,258,106,152
050,18,107,"Indiana","Montgomery County",2,76,268,113,155
050,18,107,"Indiana","Montgomery County",2,77,294,129,165
050,18,107,"Indiana","Montgomery County",2,78,255,110,145
050,18,107,"Indiana","Montgomery County",2,79,231,106,125
050,18,107,"Indiana","Montgomery County",2,80,213,102,111
050,18,107,"Indiana","Montgomery County",2,81,198,83,115
050,18,107,"Indiana","Montgomery County",2,82,189,89,100
050,18,107,"Indiana","Montgomery County",2,83,168,81,87
050,18,107,"Indiana","Montgomery County",2,84,137,66,71
050,18,107,"Indiana","Montgomery County",2,85,819,279,540
050,18,107,"Indiana","Montgomery County",3,0,393,202,191
050,18,107,"Indiana","Montgomery County",3,1,431,218,213
050,18,107,"Indiana","Montgomery County",3,2,434,232,202
050,18,107,"Indiana","Montgomery County",3,3,445,248,197
050,18,107,"Indiana","Montgomery County",3,4,468,252,216
050,18,107,"Indiana","Montgomery County",3,5,464,251,213
050,18,107,"Indiana","Montgomery County",3,6,467,243,224
050,18,107,"Indiana","Montgomery County",3,7,484,249,235
050,18,107,"Indiana","Montgomery County",3,8,485,246,239
050,18,107,"Indiana","Montgomery County",3,9,492,264,228
050,18,107,"Indiana","Montgomery County",3,10,520,275,245
050,18,107,"Indiana","Montgomery County",3,11,520,259,261
050,18,107,"Indiana","Montgomery County",3,12,508,246,262
050,18,107,"Indiana","Montgomery County",3,13,544,260,284
050,18,107,"Indiana","Montgomery County",3,14,543,254,289
050,18,107,"Indiana","Montgomery County",3,15,518,252,266
050,18,107,"Indiana","Montgomery County",3,16,501,257,244
050,18,107,"Indiana","Montgomery County",3,17,530,281,249
050,18,107,"Indiana","Montgomery County",3,18,496,294,202
050,18,107,"Indiana","Montgomery County",3,19,571,405,166
050,18,107,"Indiana","Montgomery County",3,20,577,392,185
050,18,107,"Indiana","Montgomery County",3,21,542,342,200
050,18,107,"Indiana","Montgomery County",3,22,508,295,213
050,18,107,"Indiana","Montgomery County",3,23,441,225,216
050,18,107,"Indiana","Montgomery County",3,24,396,181,215
050,18,107,"Indiana","Montgomery County",3,25,404,202,202
050,18,107,"Indiana","Montgomery County",3,26,445,218,227
050,18,107,"Indiana","Montgomery County",3,27,460,230,230
050,18,107,"Indiana","Montgomery County",3,28,457,234,223
050,18,107,"Indiana","Montgomery County",3,29,467,230,237
050,18,107,"Indiana","Montgomery County",3,30,456,224,232
050,18,107,"Indiana","Montgomery County",3,31,451,234,217
050,18,107,"Indiana","Montgomery County",3,32,448,234,214
050,18,107,"Indiana","Montgomery County",3,33,464,237,227
050,18,107,"Indiana","Montgomery County",3,34,443,238,205
050,18,107,"Indiana","Montgomery County",3,35,418,219,199
050,18,107,"Indiana","Montgomery County",3,36,467,249,218
050,18,107,"Indiana","Montgomery County",3,37,449,234,215
050,18,107,"Indiana","Montgomery County",3,38,444,225,219
050,18,107,"Indiana","Montgomery County",3,39,451,231,220
050,18,107,"Indiana","Montgomery County",3,40,418,221,197
050,18,107,"Indiana","Montgomery County",3,41,417,213,204
050,18,107,"Indiana","Montgomery County",3,42,414,225,189
050,18,107,"Indiana","Montgomery County",3,43,402,212,190
050,18,107,"Indiana","Montgomery County",3,44,412,205,207
050,18,107,"Indiana","Montgomery County",3,45,420,203,217
050,18,107,"Indiana","Montgomery County",3,46,435,214,221
050,18,107,"Indiana","Montgomery County",3,47,428,205,223
050,18,107,"Indiana","Montgomery County",3,48,437,207,230
050,18,107,"Indiana","Montgomery County",3,49,461,243,218
050,18,107,"Indiana","Montgomery County",3,50,501,263,238
050,18,107,"Indiana","Montgomery County",3,51,474,241,233
050,18,107,"Indiana","Montgomery County",3,52,456,238,218
050,18,107,"Indiana","Montgomery County",3,53,463,243,220
050,18,107,"Indiana","Montgomery County",3,54,487,256,231
050,18,107,"Indiana","Montgomery County",3,55,473,234,239
050,18,107,"Indiana","Montgomery County",3,56,513,249,264
050,18,107,"Indiana","Montgomery County",3,57,565,278,287
050,18,107,"Indiana","Montgomery County",3,58,575,292,283
050,18,107,"Indiana","Montgomery County",3,59,584,285,299
050,18,107,"Indiana","Montgomery County",3,60,564,293,271
050,18,107,"Indiana","Montgomery County",3,61,542,275,267
050,18,107,"Indiana","Montgomery County",3,62,524,271,253
050,18,107,"Indiana","Montgomery County",3,63,529,268,261
050,18,107,"Indiana","Montgomery County",3,64,531,275,256
050,18,107,"Indiana","Montgomery County",3,65,476,242,234
050,18,107,"Indiana","Montgomery County",3,66,467,232,235
050,18,107,"Indiana","Montgomery County",3,67,447,217,230
050,18,107,"Indiana","Montgomery County",3,68,424,208,216
050,18,107,"Indiana","Montgomery County",3,69,411,206,205
050,18,107,"Indiana","Montgomery County",3,70,379,188,191
050,18,107,"Indiana","Montgomery County",3,71,358,165,193
050,18,107,"Indiana","Montgomery County",3,72,358,166,192
050,18,107,"Indiana","Montgomery County",3,73,332,153,179
050,18,107,"Indiana","Montgomery County",3,74,353,155,198
050,18,107,"Indiana","Montgomery County",3,75,262,116,146
050,18,107,"Indiana","Montgomery County",3,76,260,109,151
050,18,107,"Indiana","Montgomery County",3,77,243,102,141
050,18,107,"Indiana","Montgomery County",3,78,291,129,162
050,18,107,"Indiana","Montgomery County",3,79,234,98,136
050,18,107,"Indiana","Montgomery County",3,80,215,101,114
050,18,107,"Indiana","Montgomery County",3,81,200,94,106
050,18,107,"Indiana","Montgomery County",3,82,189,78,111
050,18,107,"Indiana","Montgomery County",3,83,168,77,91
050,18,107,"Indiana","Montgomery County",3,84,151,70,81
050,18,107,"Indiana","Montgomery County",3,85,812,285,527
050,18,107,"Indiana","Montgomery County",4,0,441,233,208
050,18,107,"Indiana","Montgomery County",4,1,433,220,213
050,18,107,"Indiana","Montgomery County",4,2,439,227,212
050,18,107,"Indiana","Montgomery County",4,3,449,238,211
050,18,107,"Indiana","Montgomery County",4,4,454,248,206
050,18,107,"Indiana","Montgomery County",4,5,455,248,207
050,18,107,"Indiana","Montgomery County",4,6,481,263,218
050,18,107,"Indiana","Montgomery County",4,7,487,248,239
050,18,107,"Indiana","Montgomery County",4,8,466,237,229
050,18,107,"Indiana","Montgomery County",4,9,522,272,250
050,18,107,"Indiana","Montgomery County",4,10,493,258,235
050,18,107,"Indiana","Montgomery County",4,11,523,279,244
050,18,107,"Indiana","Montgomery County",4,12,543,274,269
050,18,107,"Indiana","Montgomery County",4,13,517,248,269
050,18,107,"Indiana","Montgomery County",4,14,549,262,287
050,18,107,"Indiana","Montgomery County",4,15,552,257,295
050,18,107,"Indiana","Montgomery County",4,16,523,258,265
050,18,107,"Indiana","Montgomery County",4,17,499,255,244
050,18,107,"Indiana","Montgomery County",4,18,522,307,215
050,18,107,"Indiana","Montgomery County",4,19,549,394,155
050,18,107,"Indiana","Montgomery County",4,20,594,410,184
050,18,107,"Indiana","Montgomery County",4,21,513,319,194
050,18,107,"Indiana","Montgomery County",4,22,527,310,217
050,18,107,"Indiana","Montgomery County",4,23,439,226,213
050,18,107,"Indiana","Montgomery County",4,24,408,208,200
050,18,107,"Indiana","Montgomery County",4,25,394,174,220
050,18,107,"Indiana","Montgomery County",4,26,410,207,203
050,18,107,"Indiana","Montgomery County",4,27,452,215,237
050,18,107,"Indiana","Montgomery County",4,28,478,250,228
050,18,107,"Indiana","Montgomery County",4,29,480,251,229
050,18,107,"Indiana","Montgomery County",4,30,491,238,253
050,18,107,"Indiana","Montgomery County",4,31,444,221,223
050,18,107,"Indiana","Montgomery County",4,32,453,237,216
050,18,107,"Indiana","Montgomery County",4,33,462,230,232
050,18,107,"Indiana","Montgomery County",4,34,480,250,230
050,18,107,"Indiana","Montgomery County",4,35,452,237,215
050,18,107,"Indiana","Montgomery County",4,36,419,216,203
050,18,107,"Indiana","Montgomery County",4,37,456,245,211
050,18,107,"Indiana","Montgomery County",4,38,455,237,218
050,18,107,"Indiana","Montgomery County",4,39,449,227,222
050,18,107,"Indiana","Montgomery County",4,40,465,237,228
050,18,107,"Indiana","Montgomery County",4,41,425,227,198
050,18,107,"Indiana","Montgomery County",4,42,403,205,198
050,18,107,"Indiana","Montgomery County",4,43,423,224,199
050,18,107,"Indiana","Montgomery County",4,44,409,218,191
050,18,107,"Indiana","Montgomery County",4,45,413,210,203
050,18,107,"Indiana","Montgomery County",4,46,428,210,218
050,18,107,"Indiana","Montgomery County",4,47,445,210,235
050,18,107,"Indiana","Montgomery County",4,48,425,211,214
050,18,107,"Indiana","Montgomery County",4,49,432,207,225
050,18,107,"Indiana","Montgomery County",4,50,462,245,217
050,18,107,"Indiana","Montgomery County",4,51,502,263,239
050,18,107,"Indiana","Montgomery County",4,52,464,232,232
050,18,107,"Indiana","Montgomery County",4,53,461,239,222
050,18,107,"Indiana","Montgomery County",4,54,460,246,214
050,18,107,"Indiana","Montgomery County",4,55,500,257,243
050,18,107,"Indiana","Montgomery County",4,56,467,235,232
050,18,107,"Indiana","Montgomery County",4,57,521,253,268
050,18,107,"Indiana","Montgomery County",4,58,568,278,290
050,18,107,"Indiana","Montgomery County",4,59,579,293,286
050,18,107,"Indiana","Montgomery County",4,60,563,280,283
050,18,107,"Indiana","Montgomery County",4,61,567,289,278
050,18,107,"Indiana","Montgomery County",4,62,546,282,264
050,18,107,"Indiana","Montgomery County",4,63,519,271,248
050,18,107,"Indiana","Montgomery County",4,64,504,255,249
050,18,107,"Indiana","Montgomery County",4,65,524,267,257
050,18,107,"Indiana","Montgomery County",4,66,471,237,234
050,18,107,"Indiana","Montgomery County",4,67,461,232,229
050,18,107,"Indiana","Montgomery County",4,68,446,213,233
050,18,107,"Indiana","Montgomery County",4,69,426,213,213
050,18,107,"Indiana","Montgomery County",4,70,388,194,194
050,18,107,"Indiana","Montgomery County",4,71,370,185,185
050,18,107,"Indiana","Montgomery County",4,72,345,157,188
050,18,107,"Indiana","Montgomery County",4,73,352,162,190
050,18,107,"Indiana","Montgomery County",4,74,322,148,174
050,18,107,"Indiana","Montgomery County",4,75,347,152,195
050,18,107,"Indiana","Montgomery County",4,76,258,115,143
050,18,107,"Indiana","Montgomery County",4,77,239,101,138
050,18,107,"Indiana","Montgomery County",4,78,234,99,135
050,18,107,"Indiana","Montgomery County",4,79,272,118,154
050,18,107,"Indiana","Montgomery County",4,80,222,94,128
050,18,107,"Indiana","Montgomery County",4,81,201,96,105
050,18,107,"Indiana","Montgomery County",4,82,192,92,100
050,18,107,"Indiana","Montgomery County",4,83,171,69,102
050,18,107,"Indiana","Montgomery County",4,84,154,72,82
050,18,107,"Indiana","Montgomery County",4,85,820,294,526
050,18,107,"Indiana","Montgomery County",5,0,442,234,208
050,18,107,"Indiana","Montgomery County",5,1,443,236,207
050,18,107,"Indiana","Montgomery County",5,2,434,225,209
050,18,107,"Indiana","Montgomery County",5,3,444,231,213
050,18,107,"Indiana","Montgomery County",5,4,466,255,211
050,18,107,"Indiana","Montgomery County",5,5,454,240,214
050,18,107,"Indiana","Montgomery County",5,6,456,256,200
050,18,107,"Indiana","Montgomery County",5,7,483,264,219
050,18,107,"Indiana","Montgomery County",5,8,486,248,238
050,18,107,"Indiana","Montgomery County",5,9,492,260,232
050,18,107,"Indiana","Montgomery County",5,10,507,272,235
050,18,107,"Indiana","Montgomery County",5,11,497,268,229
050,18,107,"Indiana","Montgomery County",5,12,532,270,262
050,18,107,"Indiana","Montgomery County",5,13,549,282,267
050,18,107,"Indiana","Montgomery County",5,14,510,248,262
050,18,107,"Indiana","Montgomery County",5,15,538,258,280
050,18,107,"Indiana","Montgomery County",5,16,554,259,295
050,18,107,"Indiana","Montgomery County",5,17,529,265,264
050,18,107,"Indiana","Montgomery County",5,18,481,290,191
050,18,107,"Indiana","Montgomery County",5,19,578,410,168
050,18,107,"Indiana","Montgomery County",5,20,570,395,175
050,18,107,"Indiana","Montgomery County",5,21,537,347,190
050,18,107,"Indiana","Montgomery County",5,22,514,297,217
050,18,107,"Indiana","Montgomery County",5,23,470,240,230
050,18,107,"Indiana","Montgomery County",5,24,431,212,219
050,18,107,"Indiana","Montgomery County",5,25,410,210,200
050,18,107,"Indiana","Montgomery County",5,26,413,180,233
050,18,107,"Indiana","Montgomery County",5,27,422,210,212
050,18,107,"Indiana","Montgomery County",5,28,451,220,231
050,18,107,"Indiana","Montgomery County",5,29,480,242,238
050,18,107,"Indiana","Montgomery County",5,30,471,239,232
050,18,107,"Indiana","Montgomery County",5,31,508,252,256
050,18,107,"Indiana","Montgomery County",5,32,468,236,232
050,18,107,"Indiana","Montgomery County",5,33,469,245,224
050,18,107,"Indiana","Montgomery County",5,34,462,231,231
050,18,107,"Indiana","Montgomery County",5,35,502,256,246
050,18,107,"Indiana","Montgomery County",5,36,452,230,222
050,18,107,"Indiana","Montgomery County",5,37,425,225,200
050,18,107,"Indiana","Montgomery County",5,38,457,247,210
050,18,107,"Indiana","Montgomery County",5,39,453,238,215
050,18,107,"Indiana","Montgomery County",5,40,458,235,223
050,18,107,"Indiana","Montgomery County",5,41,472,238,234
050,18,107,"Indiana","Montgomery County",5,42,431,230,201
050,18,107,"Indiana","Montgomery County",5,43,399,201,198
050,18,107,"Indiana","Montgomery County",5,44,404,212,192
050,18,107,"Indiana","Montgomery County",5,45,406,219,187
050,18,107,"Indiana","Montgomery County",5,46,414,209,205
050,18,107,"Indiana","Montgomery County",5,47,426,205,221
050,18,107,"Indiana","Montgomery County",5,48,457,214,243
050,18,107,"Indiana","Montgomery County",5,49,424,207,217
050,18,107,"Indiana","Montgomery County",5,50,437,212,225
050,18,107,"Indiana","Montgomery County",5,51,462,241,221
050,18,107,"Indiana","Montgomery County",5,52,504,263,241
050,18,107,"Indiana","Montgomery County",5,53,462,235,227
050,18,107,"Indiana","Montgomery County",5,54,466,239,227
050,18,107,"Indiana","Montgomery County",5,55,470,249,221
050,18,107,"Indiana","Montgomery County",5,56,498,261,237
050,18,107,"Indiana","Montgomery County",5,57,460,232,228
050,18,107,"Indiana","Montgomery County",5,58,526,257,269
050,18,107,"Indiana","Montgomery County",5,59,567,278,289
050,18,107,"Indiana","Montgomery County",5,60,574,289,285
050,18,107,"Indiana","Montgomery County",5,61,564,280,284
050,18,107,"Indiana","Montgomery County",5,62,570,287,283
050,18,107,"Indiana","Montgomery County",5,63,551,287,264
050,18,107,"Indiana","Montgomery County",5,64,493,258,235
050,18,107,"Indiana","Montgomery County",5,65,506,256,250
050,18,107,"Indiana","Montgomery County",5,66,520,260,260
050,18,107,"Indiana","Montgomery County",5,67,464,231,233
050,18,107,"Indiana","Montgomery County",5,68,458,229,229
050,18,107,"Indiana","Montgomery County",5,69,453,214,239
050,18,107,"Indiana","Montgomery County",5,70,414,204,210
050,18,107,"Indiana","Montgomery County",5,71,382,190,192
050,18,107,"Indiana","Montgomery County",5,72,360,178,182
050,18,107,"Indiana","Montgomery County",5,73,335,151,184
050,18,107,"Indiana","Montgomery County",5,74,342,156,186
050,18,107,"Indiana","Montgomery County",5,75,316,148,168
050,18,107,"Indiana","Montgomery County",5,76,349,155,194
050,18,107,"Indiana","Montgomery County",5,77,247,104,143
050,18,107,"Indiana","Montgomery County",5,78,234,101,133
050,18,107,"Indiana","Montgomery County",5,79,212,89,123
050,18,107,"Indiana","Montgomery County",5,80,259,113,146
050,18,107,"Indiana","Montgomery County",5,81,208,87,121
050,18,107,"Indiana","Montgomery County",5,82,194,93,101
050,18,107,"Indiana","Montgomery County",5,83,174,81,93
050,18,107,"Indiana","Montgomery County",5,84,164,66,98
050,18,107,"Indiana","Montgomery County",5,85,847,304,543
050,18,109,"Indiana","Morgan County",1,0,750,384,366
050,18,109,"Indiana","Morgan County",1,1,759,387,372
050,18,109,"Indiana","Morgan County",1,2,779,381,398
050,18,109,"Indiana","Morgan County",1,3,827,433,394
050,18,109,"Indiana","Morgan County",1,4,872,430,442
050,18,109,"Indiana","Morgan County",1,5,835,419,416
050,18,109,"Indiana","Morgan County",1,6,804,434,370
050,18,109,"Indiana","Morgan County",1,7,828,447,381
050,18,109,"Indiana","Morgan County",1,8,815,439,376
050,18,109,"Indiana","Morgan County",1,9,853,434,419
050,18,109,"Indiana","Morgan County",1,10,920,469,451
050,18,109,"Indiana","Morgan County",1,11,984,516,468
050,18,109,"Indiana","Morgan County",1,12,1023,549,474
050,18,109,"Indiana","Morgan County",1,13,1036,524,512
050,18,109,"Indiana","Morgan County",1,14,988,490,498
050,18,109,"Indiana","Morgan County",1,15,1032,531,501
050,18,109,"Indiana","Morgan County",1,16,1053,547,506
050,18,109,"Indiana","Morgan County",1,17,1008,520,488
050,18,109,"Indiana","Morgan County",1,18,889,462,427
050,18,109,"Indiana","Morgan County",1,19,708,378,330
050,18,109,"Indiana","Morgan County",1,20,768,425,343
050,18,109,"Indiana","Morgan County",1,21,776,418,358
050,18,109,"Indiana","Morgan County",1,22,779,405,374
050,18,109,"Indiana","Morgan County",1,23,770,389,381
050,18,109,"Indiana","Morgan County",1,24,813,406,407
050,18,109,"Indiana","Morgan County",1,25,820,418,402
050,18,109,"Indiana","Morgan County",1,26,822,423,399
050,18,109,"Indiana","Morgan County",1,27,800,408,392
050,18,109,"Indiana","Morgan County",1,28,847,435,412
050,18,109,"Indiana","Morgan County",1,29,879,417,462
050,18,109,"Indiana","Morgan County",1,30,860,417,443
050,18,109,"Indiana","Morgan County",1,31,817,408,409
050,18,109,"Indiana","Morgan County",1,32,783,409,374
050,18,109,"Indiana","Morgan County",1,33,808,410,398
050,18,109,"Indiana","Morgan County",1,34,814,421,393
050,18,109,"Indiana","Morgan County",1,35,809,392,417
050,18,109,"Indiana","Morgan County",1,36,839,395,444
050,18,109,"Indiana","Morgan County",1,37,864,420,444
050,18,109,"Indiana","Morgan County",1,38,861,428,433
050,18,109,"Indiana","Morgan County",1,39,873,434,439
050,18,109,"Indiana","Morgan County",1,40,866,422,444
050,18,109,"Indiana","Morgan County",1,41,886,435,451
050,18,109,"Indiana","Morgan County",1,42,901,455,446
050,18,109,"Indiana","Morgan County",1,43,855,443,412
050,18,109,"Indiana","Morgan County",1,44,819,426,393
050,18,109,"Indiana","Morgan County",1,45,864,448,416
050,18,109,"Indiana","Morgan County",1,46,861,420,441
050,18,109,"Indiana","Morgan County",1,47,935,447,488
050,18,109,"Indiana","Morgan County",1,48,983,482,501
050,18,109,"Indiana","Morgan County",1,49,1082,563,519
050,18,109,"Indiana","Morgan County",1,50,1067,556,511
050,18,109,"Indiana","Morgan County",1,51,1039,518,521
050,18,109,"Indiana","Morgan County",1,52,1008,486,522
050,18,109,"Indiana","Morgan County",1,53,1058,532,526
050,18,109,"Indiana","Morgan County",1,54,1064,532,532
050,18,109,"Indiana","Morgan County",1,55,1086,547,539
050,18,109,"Indiana","Morgan County",1,56,1161,580,581
050,18,109,"Indiana","Morgan County",1,57,1094,555,539
050,18,109,"Indiana","Morgan County",1,58,1161,598,563
050,18,109,"Indiana","Morgan County",1,59,1180,604,576
050,18,109,"Indiana","Morgan County",1,60,1119,591,528
050,18,109,"Indiana","Morgan County",1,61,1069,548,521
050,18,109,"Indiana","Morgan County",1,62,1052,530,522
050,18,109,"Indiana","Morgan County",1,63,1001,503,498
050,18,109,"Indiana","Morgan County",1,64,1002,491,511
050,18,109,"Indiana","Morgan County",1,65,972,499,473
050,18,109,"Indiana","Morgan County",1,66,899,450,449
050,18,109,"Indiana","Morgan County",1,67,872,398,474
050,18,109,"Indiana","Morgan County",1,68,771,329,442
050,18,109,"Indiana","Morgan County",1,69,765,350,415
050,18,109,"Indiana","Morgan County",1,70,755,358,397
050,18,109,"Indiana","Morgan County",1,71,730,364,366
050,18,109,"Indiana","Morgan County",1,72,736,383,353
050,18,109,"Indiana","Morgan County",1,73,715,347,368
050,18,109,"Indiana","Morgan County",1,74,494,230,264
050,18,109,"Indiana","Morgan County",1,75,510,247,263
050,18,109,"Indiana","Morgan County",1,76,475,212,263
050,18,109,"Indiana","Morgan County",1,77,471,211,260
050,18,109,"Indiana","Morgan County",1,78,433,197,236
050,18,109,"Indiana","Morgan County",1,79,360,177,183
050,18,109,"Indiana","Morgan County",1,80,318,140,178
050,18,109,"Indiana","Morgan County",1,81,312,132,180
050,18,109,"Indiana","Morgan County",1,82,283,117,166
050,18,109,"Indiana","Morgan County",1,83,245,101,144
050,18,109,"Indiana","Morgan County",1,84,201,82,119
050,18,109,"Indiana","Morgan County",1,85,1081,392,689
050,18,109,"Indiana","Morgan County",2,0,744,381,363
050,18,109,"Indiana","Morgan County",2,1,753,383,370
050,18,109,"Indiana","Morgan County",2,2,776,386,390
050,18,109,"Indiana","Morgan County",2,3,817,420,397
050,18,109,"Indiana","Morgan County",2,4,866,431,435
050,18,109,"Indiana","Morgan County",2,5,843,422,421
050,18,109,"Indiana","Morgan County",2,6,824,438,386
050,18,109,"Indiana","Morgan County",2,7,825,445,380
050,18,109,"Indiana","Morgan County",2,8,818,440,378
050,18,109,"Indiana","Morgan County",2,9,847,435,412
050,18,109,"Indiana","Morgan County",2,10,907,460,447
050,18,109,"Indiana","Morgan County",2,11,967,505,462
050,18,109,"Indiana","Morgan County",2,12,1021,541,480
050,18,109,"Indiana","Morgan County",2,13,1031,526,505
050,18,109,"Indiana","Morgan County",2,14,1003,500,503
050,18,109,"Indiana","Morgan County",2,15,1027,523,504
050,18,109,"Indiana","Morgan County",2,16,1051,546,505
050,18,109,"Indiana","Morgan County",2,17,1023,528,495
050,18,109,"Indiana","Morgan County",2,18,876,460,416
050,18,109,"Indiana","Morgan County",2,19,711,378,333
050,18,109,"Indiana","Morgan County",2,20,777,424,353
050,18,109,"Indiana","Morgan County",2,21,777,418,359
050,18,109,"Indiana","Morgan County",2,22,784,410,374
050,18,109,"Indiana","Morgan County",2,23,783,397,386
050,18,109,"Indiana","Morgan County",2,24,805,403,402
050,18,109,"Indiana","Morgan County",2,25,826,421,405
050,18,109,"Indiana","Morgan County",2,26,827,422,405
050,18,109,"Indiana","Morgan County",2,27,810,413,397
050,18,109,"Indiana","Morgan County",2,28,841,430,411
050,18,109,"Indiana","Morgan County",2,29,878,426,452
050,18,109,"Indiana","Morgan County",2,30,876,421,455
050,18,109,"Indiana","Morgan County",2,31,833,415,418
050,18,109,"Indiana","Morgan County",2,32,789,407,382
050,18,109,"Indiana","Morgan County",2,33,804,410,394
050,18,109,"Indiana","Morgan County",2,34,815,418,397
050,18,109,"Indiana","Morgan County",2,35,821,403,418
050,18,109,"Indiana","Morgan County",2,36,826,394,432
050,18,109,"Indiana","Morgan County",2,37,858,414,444
050,18,109,"Indiana","Morgan County",2,38,861,424,437
050,18,109,"Indiana","Morgan County",2,39,867,431,436
050,18,109,"Indiana","Morgan County",2,40,877,432,445
050,18,109,"Indiana","Morgan County",2,41,880,432,448
050,18,109,"Indiana","Morgan County",2,42,896,450,446
050,18,109,"Indiana","Morgan County",2,43,879,450,429
050,18,109,"Indiana","Morgan County",2,44,821,426,395
050,18,109,"Indiana","Morgan County",2,45,859,447,412
050,18,109,"Indiana","Morgan County",2,46,859,426,433
050,18,109,"Indiana","Morgan County",2,47,913,442,471
050,18,109,"Indiana","Morgan County",2,48,970,473,497
050,18,109,"Indiana","Morgan County",2,49,1067,550,517
050,18,109,"Indiana","Morgan County",2,50,1070,556,514
050,18,109,"Indiana","Morgan County",2,51,1039,522,517
050,18,109,"Indiana","Morgan County",2,52,1018,496,522
050,18,109,"Indiana","Morgan County",2,53,1049,522,527
050,18,109,"Indiana","Morgan County",2,54,1060,528,532
050,18,109,"Indiana","Morgan County",2,55,1086,546,540
050,18,109,"Indiana","Morgan County",2,56,1148,575,573
050,18,109,"Indiana","Morgan County",2,57,1110,561,549
050,18,109,"Indiana","Morgan County",2,58,1143,587,556
050,18,109,"Indiana","Morgan County",2,59,1178,604,574
050,18,109,"Indiana","Morgan County",2,60,1125,588,537
050,18,109,"Indiana","Morgan County",2,61,1073,553,520
050,18,109,"Indiana","Morgan County",2,62,1052,532,520
050,18,109,"Indiana","Morgan County",2,63,1017,510,507
050,18,109,"Indiana","Morgan County",2,64,989,487,502
050,18,109,"Indiana","Morgan County",2,65,980,497,483
050,18,109,"Indiana","Morgan County",2,66,917,461,456
050,18,109,"Indiana","Morgan County",2,67,872,407,465
050,18,109,"Indiana","Morgan County",2,68,790,343,447
050,18,109,"Indiana","Morgan County",2,69,765,341,424
050,18,109,"Indiana","Morgan County",2,70,749,354,395
050,18,109,"Indiana","Morgan County",2,71,731,356,375
050,18,109,"Indiana","Morgan County",2,72,709,367,342
050,18,109,"Indiana","Morgan County",2,73,751,372,379
050,18,109,"Indiana","Morgan County",2,74,513,242,271
050,18,109,"Indiana","Morgan County",2,75,503,241,262
050,18,109,"Indiana","Morgan County",2,76,474,217,257
050,18,109,"Indiana","Morgan County",2,77,474,214,260
050,18,109,"Indiana","Morgan County",2,78,429,194,235
050,18,109,"Indiana","Morgan County",2,79,364,178,186
050,18,109,"Indiana","Morgan County",2,80,325,148,177
050,18,109,"Indiana","Morgan County",2,81,311,133,178
050,18,109,"Indiana","Morgan County",2,82,287,118,169
050,18,109,"Indiana","Morgan County",2,83,248,100,148
050,18,109,"Indiana","Morgan County",2,84,205,84,121
050,18,109,"Indiana","Morgan County",2,85,1073,394,679
050,18,109,"Indiana","Morgan County",3,0,692,356,336
050,18,109,"Indiana","Morgan County",3,1,745,373,372
050,18,109,"Indiana","Morgan County",3,2,807,415,392
050,18,109,"Indiana","Morgan County",3,3,780,394,386
050,18,109,"Indiana","Morgan County",3,4,834,417,417
050,18,109,"Indiana","Morgan County",3,5,908,453,455
050,18,109,"Indiana","Morgan County",3,6,844,430,414
050,18,109,"Indiana","Morgan County",3,7,811,414,397
050,18,109,"Indiana","Morgan County",3,8,829,460,369
050,18,109,"Indiana","Morgan County",3,9,839,448,391
050,18,109,"Indiana","Morgan County",3,10,872,450,422
050,18,109,"Indiana","Morgan County",3,11,925,484,441
050,18,109,"Indiana","Morgan County",3,12,990,514,476
050,18,109,"Indiana","Morgan County",3,13,1024,537,487
050,18,109,"Indiana","Morgan County",3,14,1045,545,500
050,18,109,"Indiana","Morgan County",3,15,1030,523,507
050,18,109,"Indiana","Morgan County",3,16,1045,515,530
050,18,109,"Indiana","Morgan County",3,17,1081,559,522
050,18,109,"Indiana","Morgan County",3,18,874,468,406
050,18,109,"Indiana","Morgan County",3,19,679,361,318
050,18,109,"Indiana","Morgan County",3,20,788,419,369
050,18,109,"Indiana","Morgan County",3,21,797,423,374
050,18,109,"Indiana","Morgan County",3,22,782,413,369
050,18,109,"Indiana","Morgan County",3,23,821,439,382
050,18,109,"Indiana","Morgan County",3,24,757,392,365
050,18,109,"Indiana","Morgan County",3,25,794,404,390
050,18,109,"Indiana","Morgan County",3,26,811,413,398
050,18,109,"Indiana","Morgan County",3,27,837,418,419
050,18,109,"Indiana","Morgan County",3,28,813,411,402
050,18,109,"Indiana","Morgan County",3,29,870,451,419
050,18,109,"Indiana","Morgan County",3,30,913,439,474
050,18,109,"Indiana","Morgan County",3,31,885,433,452
050,18,109,"Indiana","Morgan County",3,32,845,434,411
050,18,109,"Indiana","Morgan County",3,33,803,414,389
050,18,109,"Indiana","Morgan County",3,34,816,411,405
050,18,109,"Indiana","Morgan County",3,35,839,421,418
050,18,109,"Indiana","Morgan County",3,36,820,396,424
050,18,109,"Indiana","Morgan County",3,37,840,400,440
050,18,109,"Indiana","Morgan County",3,38,875,418,457
050,18,109,"Indiana","Morgan County",3,39,880,426,454
050,18,109,"Indiana","Morgan County",3,40,883,449,434
050,18,109,"Indiana","Morgan County",3,41,888,437,451
050,18,109,"Indiana","Morgan County",3,42,891,434,457
050,18,109,"Indiana","Morgan County",3,43,916,456,460
050,18,109,"Indiana","Morgan County",3,44,886,448,438
050,18,109,"Indiana","Morgan County",3,45,826,434,392
050,18,109,"Indiana","Morgan County",3,46,857,435,422
050,18,109,"Indiana","Morgan County",3,47,873,446,427
050,18,109,"Indiana","Morgan County",3,48,922,444,478
050,18,109,"Indiana","Morgan County",3,49,995,480,515
050,18,109,"Indiana","Morgan County",3,50,1064,550,514
050,18,109,"Indiana","Morgan County",3,51,1058,544,514
050,18,109,"Indiana","Morgan County",3,52,1052,534,518
050,18,109,"Indiana","Morgan County",3,53,1020,498,522
050,18,109,"Indiana","Morgan County",3,54,1040,515,525
050,18,109,"Indiana","Morgan County",3,55,1070,537,533
050,18,109,"Indiana","Morgan County",3,56,1068,532,536
050,18,109,"Indiana","Morgan County",3,57,1146,572,574
050,18,109,"Indiana","Morgan County",3,58,1125,576,549
050,18,109,"Indiana","Morgan County",3,59,1148,592,556
050,18,109,"Indiana","Morgan County",3,60,1181,607,574
050,18,109,"Indiana","Morgan County",3,61,1119,590,529
050,18,109,"Indiana","Morgan County",3,62,1092,561,531
050,18,109,"Indiana","Morgan County",3,63,1035,518,517
050,18,109,"Indiana","Morgan County",3,64,1006,494,512
050,18,109,"Indiana","Morgan County",3,65,988,480,508
050,18,109,"Indiana","Morgan County",3,66,953,481,472
050,18,109,"Indiana","Morgan County",3,67,909,453,456
050,18,109,"Indiana","Morgan County",3,68,851,397,454
050,18,109,"Indiana","Morgan County",3,69,773,335,438
050,18,109,"Indiana","Morgan County",3,70,746,336,410
050,18,109,"Indiana","Morgan County",3,71,731,335,396
050,18,109,"Indiana","Morgan County",3,72,704,342,362
050,18,109,"Indiana","Morgan County",3,73,692,360,332
050,18,109,"Indiana","Morgan County",3,74,728,359,369
050,18,109,"Indiana","Morgan County",3,75,509,234,275
050,18,109,"Indiana","Morgan County",3,76,483,225,258
050,18,109,"Indiana","Morgan County",3,77,449,212,237
050,18,109,"Indiana","Morgan County",3,78,456,196,260
050,18,109,"Indiana","Morgan County",3,79,385,179,206
050,18,109,"Indiana","Morgan County",3,80,347,165,182
050,18,109,"Indiana","Morgan County",3,81,314,144,170
050,18,109,"Indiana","Morgan County",3,82,283,110,173
050,18,109,"Indiana","Morgan County",3,83,266,103,163
050,18,109,"Indiana","Morgan County",3,84,226,92,134
050,18,109,"Indiana","Morgan County",3,85,1081,400,681
050,18,109,"Indiana","Morgan County",4,0,774,407,367
050,18,109,"Indiana","Morgan County",4,1,698,370,328
050,18,109,"Indiana","Morgan County",4,2,752,381,371
050,18,109,"Indiana","Morgan County",4,3,822,422,400
050,18,109,"Indiana","Morgan County",4,4,778,394,384
050,18,109,"Indiana","Morgan County",4,5,801,401,400
050,18,109,"Indiana","Morgan County",4,6,912,458,454
050,18,109,"Indiana","Morgan County",4,7,839,423,416
050,18,109,"Indiana","Morgan County",4,8,834,425,409
050,18,109,"Indiana","Morgan County",4,9,824,446,378
050,18,109,"Indiana","Morgan County",4,10,846,453,393
050,18,109,"Indiana","Morgan County",4,11,891,464,427
050,18,109,"Indiana","Morgan County",4,12,969,501,468
050,18,109,"Indiana","Morgan County",4,13,1020,517,503
050,18,109,"Indiana","Morgan County",4,14,1035,542,493
050,18,109,"Indiana","Morgan County",4,15,1053,544,509
050,18,109,"Indiana","Morgan County",4,16,1012,506,506
050,18,109,"Indiana","Morgan County",4,17,1060,523,537
050,18,109,"Indiana","Morgan County",4,18,903,490,413
050,18,109,"Indiana","Morgan County",4,19,658,354,304
050,18,109,"Indiana","Morgan County",4,20,708,370,338
050,18,109,"Indiana","Morgan County",4,21,776,405,371
050,18,109,"Indiana","Morgan County",4,22,791,412,379
050,18,109,"Indiana","Morgan County",4,23,818,440,378
050,18,109,"Indiana","Morgan County",4,24,822,429,393
050,18,109,"Indiana","Morgan County",4,25,762,406,356
050,18,109,"Indiana","Morgan County",4,26,791,407,384
050,18,109,"Indiana","Morgan County",4,27,804,417,387
050,18,109,"Indiana","Morgan County",4,28,829,397,432
050,18,109,"Indiana","Morgan County",4,29,836,430,406
050,18,109,"Indiana","Morgan County",4,30,882,445,437
050,18,109,"Indiana","Morgan County",4,31,920,436,484
050,18,109,"Indiana","Morgan County",4,32,901,432,469
050,18,109,"Indiana","Morgan County",4,33,852,435,417
050,18,109,"Indiana","Morgan County",4,34,801,415,386
050,18,109,"Indiana","Morgan County",4,35,836,421,415
050,18,109,"Indiana","Morgan County",4,36,876,435,441
050,18,109,"Indiana","Morgan County",4,37,807,391,416
050,18,109,"Indiana","Morgan County",4,38,849,408,441
050,18,109,"Indiana","Morgan County",4,39,893,427,466
050,18,109,"Indiana","Morgan County",4,40,889,434,455
050,18,109,"Indiana","Morgan County",4,41,906,461,445
050,18,109,"Indiana","Morgan County",4,42,899,451,448
050,18,109,"Indiana","Morgan County",4,43,895,447,448
050,18,109,"Indiana","Morgan County",4,44,915,458,457
050,18,109,"Indiana","Morgan County",4,45,897,441,456
050,18,109,"Indiana","Morgan County",4,46,833,443,390
050,18,109,"Indiana","Morgan County",4,47,872,440,432
050,18,109,"Indiana","Morgan County",4,48,873,449,424
050,18,109,"Indiana","Morgan County",4,49,945,468,477
050,18,109,"Indiana","Morgan County",4,50,991,484,507
050,18,109,"Indiana","Morgan County",4,51,1080,558,522
050,18,109,"Indiana","Morgan County",4,52,1082,561,521
050,18,109,"Indiana","Morgan County",4,53,1056,540,516
050,18,109,"Indiana","Morgan County",4,54,1006,484,522
050,18,109,"Indiana","Morgan County",4,55,1038,517,521
050,18,109,"Indiana","Morgan County",4,56,1062,534,528
050,18,109,"Indiana","Morgan County",4,57,1053,515,538
050,18,109,"Indiana","Morgan County",4,58,1130,557,573
050,18,109,"Indiana","Morgan County",4,59,1121,583,538
050,18,109,"Indiana","Morgan County",4,60,1121,575,546
050,18,109,"Indiana","Morgan County",4,61,1155,599,556
050,18,109,"Indiana","Morgan County",4,62,1106,573,533
050,18,109,"Indiana","Morgan County",4,63,1067,548,519
050,18,109,"Indiana","Morgan County",4,64,1019,519,500
050,18,109,"Indiana","Morgan County",4,65,996,478,518
050,18,109,"Indiana","Morgan County",4,66,965,466,499
050,18,109,"Indiana","Morgan County",4,67,922,455,467
050,18,109,"Indiana","Morgan County",4,68,902,452,450
050,18,109,"Indiana","Morgan County",4,69,833,391,442
050,18,109,"Indiana","Morgan County",4,70,751,334,417
050,18,109,"Indiana","Morgan County",4,71,726,322,404
050,18,109,"Indiana","Morgan County",4,72,708,323,385
050,18,109,"Indiana","Morgan County",4,73,687,335,352
050,18,109,"Indiana","Morgan County",4,74,669,349,320
050,18,109,"Indiana","Morgan County",4,75,701,333,368
050,18,109,"Indiana","Morgan County",4,76,491,219,272
050,18,109,"Indiana","Morgan County",4,77,454,217,237
050,18,109,"Indiana","Morgan County",4,78,426,190,236
050,18,109,"Indiana","Morgan County",4,79,416,182,234
050,18,109,"Indiana","Morgan County",4,80,358,163,195
050,18,109,"Indiana","Morgan County",4,81,317,148,169
050,18,109,"Indiana","Morgan County",4,82,287,126,161
050,18,109,"Indiana","Morgan County",4,83,256,94,162
050,18,109,"Indiana","Morgan County",4,84,249,99,150
050,18,109,"Indiana","Morgan County",4,85,1100,412,688
050,18,109,"Indiana","Morgan County",5,0,793,414,379
050,18,109,"Indiana","Morgan County",5,1,803,408,395
050,18,109,"Indiana","Morgan County",5,2,744,400,344
050,18,109,"Indiana","Morgan County",5,3,801,399,402
050,18,109,"Indiana","Morgan County",5,4,810,425,385
050,18,109,"Indiana","Morgan County",5,5,810,418,392
050,18,109,"Indiana","Morgan County",5,6,851,430,421
050,18,109,"Indiana","Morgan County",5,7,914,463,451
050,18,109,"Indiana","Morgan County",5,8,873,438,435
050,18,109,"Indiana","Morgan County",5,9,848,430,418
050,18,109,"Indiana","Morgan County",5,10,827,451,376
050,18,109,"Indiana","Morgan County",5,11,872,474,398
050,18,109,"Indiana","Morgan County",5,12,925,477,448
050,18,109,"Indiana","Morgan County",5,13,965,487,478
050,18,109,"Indiana","Morgan County",5,14,1029,524,505
050,18,109,"Indiana","Morgan County",5,15,1052,555,497
050,18,109,"Indiana","Morgan County",5,16,1053,544,509
050,18,109,"Indiana","Morgan County",5,17,1039,541,498
050,18,109,"Indiana","Morgan County",5,18,897,467,430
050,18,109,"Indiana","Morgan County",5,19,688,376,312
050,18,109,"Indiana","Morgan County",5,20,719,393,326
050,18,109,"Indiana","Morgan County",5,21,751,378,373
050,18,109,"Indiana","Morgan County",5,22,838,434,404
050,18,109,"Indiana","Morgan County",5,23,862,470,392
050,18,109,"Indiana","Morgan County",5,24,844,460,384
050,18,109,"Indiana","Morgan County",5,25,837,439,398
050,18,109,"Indiana","Morgan County",5,26,767,407,360
050,18,109,"Indiana","Morgan County",5,27,825,435,390
050,18,109,"Indiana","Morgan County",5,28,836,417,419
050,18,109,"Indiana","Morgan County",5,29,858,418,440
050,18,109,"Indiana","Morgan County",5,30,884,450,434
050,18,109,"Indiana","Morgan County",5,31,908,452,456
050,18,109,"Indiana","Morgan County",5,32,955,458,497
050,18,109,"Indiana","Morgan County",5,33,940,452,488
050,18,109,"Indiana","Morgan County",5,34,871,453,418
050,18,109,"Indiana","Morgan County",5,35,839,429,410
050,18,109,"Indiana","Morgan County",5,36,843,431,412
050,18,109,"Indiana","Morgan County",5,37,891,438,453
050,18,109,"Indiana","Morgan County",5,38,847,422,425
050,18,109,"Indiana","Morgan County",5,39,872,407,465
050,18,109,"Indiana","Morgan County",5,40,926,449,477
050,18,109,"Indiana","Morgan County",5,41,908,446,462
050,18,109,"Indiana","Morgan County",5,42,915,466,449
050,18,109,"Indiana","Morgan County",5,43,911,459,452
050,18,109,"Indiana","Morgan County",5,44,897,453,444
050,18,109,"Indiana","Morgan County",5,45,926,464,462
050,18,109,"Indiana","Morgan County",5,46,909,438,471
050,18,109,"Indiana","Morgan County",5,47,832,448,384
050,18,109,"Indiana","Morgan County",5,48,883,442,441
050,18,109,"Indiana","Morgan County",5,49,871,459,412
050,18,109,"Indiana","Morgan County",5,50,939,464,475
050,18,109,"Indiana","Morgan County",5,51,985,480,505
050,18,109,"Indiana","Morgan County",5,52,1100,577,523
050,18,109,"Indiana","Morgan County",5,53,1096,573,523
050,18,109,"Indiana","Morgan County",5,54,1048,535,513
050,18,109,"Indiana","Morgan County",5,55,1014,489,525
050,18,109,"Indiana","Morgan County",5,56,1034,517,517
050,18,109,"Indiana","Morgan County",5,57,1052,520,532
050,18,109,"Indiana","Morgan County",5,58,1040,505,535
050,18,109,"Indiana","Morgan County",5,59,1147,564,583
050,18,109,"Indiana","Morgan County",5,60,1127,590,537
050,18,109,"Indiana","Morgan County",5,61,1122,568,554
050,18,109,"Indiana","Morgan County",5,62,1149,591,558
050,18,109,"Indiana","Morgan County",5,63,1098,563,535
050,18,109,"Indiana","Morgan County",5,64,1088,563,525
050,18,109,"Indiana","Morgan County",5,65,1023,509,514
050,18,109,"Indiana","Morgan County",5,66,981,470,511
050,18,109,"Indiana","Morgan County",5,67,944,445,499
050,18,109,"Indiana","Morgan County",5,68,895,437,458
050,18,109,"Indiana","Morgan County",5,69,899,455,444
050,18,109,"Indiana","Morgan County",5,70,817,387,430
050,18,109,"Indiana","Morgan County",5,71,729,326,403
050,18,109,"Indiana","Morgan County",5,72,706,312,394
050,18,109,"Indiana","Morgan County",5,73,707,322,385
050,18,109,"Indiana","Morgan County",5,74,661,320,341
050,18,109,"Indiana","Morgan County",5,75,636,328,308
050,18,109,"Indiana","Morgan County",5,76,669,308,361
050,18,109,"Indiana","Morgan County",5,77,471,214,257
050,18,109,"Indiana","Morgan County",5,78,433,199,234
050,18,109,"Indiana","Morgan County",5,79,384,175,209
050,18,109,"Indiana","Morgan County",5,80,395,169,226
050,18,109,"Indiana","Morgan County",5,81,334,147,187
050,18,109,"Indiana","Morgan County",5,82,292,125,167
050,18,109,"Indiana","Morgan County",5,83,270,112,158
050,18,109,"Indiana","Morgan County",5,84,243,91,152
050,18,109,"Indiana","Morgan County",5,85,1140,449,691
050,18,111,"Indiana","Newton County",1,0,150,78,72
050,18,111,"Indiana","Newton County",1,1,153,80,73
050,18,111,"Indiana","Newton County",1,2,148,82,66
050,18,111,"Indiana","Newton County",1,3,140,64,76
050,18,111,"Indiana","Newton County",1,4,171,76,95
050,18,111,"Indiana","Newton County",1,5,156,68,88
050,18,111,"Indiana","Newton County",1,6,140,75,65
050,18,111,"Indiana","Newton County",1,7,161,92,69
050,18,111,"Indiana","Newton County",1,8,141,78,63
050,18,111,"Indiana","Newton County",1,9,161,82,79
050,18,111,"Indiana","Newton County",1,10,177,85,92
050,18,111,"Indiana","Newton County",1,11,162,82,80
050,18,111,"Indiana","Newton County",1,12,187,87,100
050,18,111,"Indiana","Newton County",1,13,190,85,105
050,18,111,"Indiana","Newton County",1,14,169,83,86
050,18,111,"Indiana","Newton County",1,15,177,92,85
050,18,111,"Indiana","Newton County",1,16,186,98,88
050,18,111,"Indiana","Newton County",1,17,180,100,80
050,18,111,"Indiana","Newton County",1,18,153,82,71
050,18,111,"Indiana","Newton County",1,19,111,55,56
050,18,111,"Indiana","Newton County",1,20,139,77,62
050,18,111,"Indiana","Newton County",1,21,155,90,65
050,18,111,"Indiana","Newton County",1,22,142,75,67
050,18,111,"Indiana","Newton County",1,23,151,83,68
050,18,111,"Indiana","Newton County",1,24,141,77,64
050,18,111,"Indiana","Newton County",1,25,146,71,75
050,18,111,"Indiana","Newton County",1,26,152,82,70
050,18,111,"Indiana","Newton County",1,27,176,94,82
050,18,111,"Indiana","Newton County",1,28,182,104,78
050,18,111,"Indiana","Newton County",1,29,176,93,83
050,18,111,"Indiana","Newton County",1,30,155,83,72
050,18,111,"Indiana","Newton County",1,31,153,85,68
050,18,111,"Indiana","Newton County",1,32,144,72,72
050,18,111,"Indiana","Newton County",1,33,165,79,86
050,18,111,"Indiana","Newton County",1,34,171,82,89
050,18,111,"Indiana","Newton County",1,35,177,95,82
050,18,111,"Indiana","Newton County",1,36,150,79,71
050,18,111,"Indiana","Newton County",1,37,156,74,82
050,18,111,"Indiana","Newton County",1,38,154,82,72
050,18,111,"Indiana","Newton County",1,39,167,91,76
050,18,111,"Indiana","Newton County",1,40,182,101,81
050,18,111,"Indiana","Newton County",1,41,172,92,80
050,18,111,"Indiana","Newton County",1,42,159,85,74
050,18,111,"Indiana","Newton County",1,43,172,91,81
050,18,111,"Indiana","Newton County",1,44,153,75,78
050,18,111,"Indiana","Newton County",1,45,162,87,75
050,18,111,"Indiana","Newton County",1,46,160,86,74
050,18,111,"Indiana","Newton County",1,47,151,78,73
050,18,111,"Indiana","Newton County",1,48,167,88,79
050,18,111,"Indiana","Newton County",1,49,198,110,88
050,18,111,"Indiana","Newton County",1,50,182,97,85
050,18,111,"Indiana","Newton County",1,51,183,98,85
050,18,111,"Indiana","Newton County",1,52,177,98,79
050,18,111,"Indiana","Newton County",1,53,184,98,86
050,18,111,"Indiana","Newton County",1,54,190,106,84
050,18,111,"Indiana","Newton County",1,55,195,102,93
050,18,111,"Indiana","Newton County",1,56,220,108,112
050,18,111,"Indiana","Newton County",1,57,229,111,118
050,18,111,"Indiana","Newton County",1,58,229,117,112
050,18,111,"Indiana","Newton County",1,59,239,121,118
050,18,111,"Indiana","Newton County",1,60,215,109,106
050,18,111,"Indiana","Newton County",1,61,209,101,108
050,18,111,"Indiana","Newton County",1,62,209,118,91
050,18,111,"Indiana","Newton County",1,63,215,126,89
050,18,111,"Indiana","Newton County",1,64,203,103,100
050,18,111,"Indiana","Newton County",1,65,204,110,94
050,18,111,"Indiana","Newton County",1,66,197,103,94
050,18,111,"Indiana","Newton County",1,67,182,94,88
050,18,111,"Indiana","Newton County",1,68,169,77,92
050,18,111,"Indiana","Newton County",1,69,164,74,90
050,18,111,"Indiana","Newton County",1,70,167,81,86
050,18,111,"Indiana","Newton County",1,71,138,71,67
050,18,111,"Indiana","Newton County",1,72,121,56,65
050,18,111,"Indiana","Newton County",1,73,140,64,76
050,18,111,"Indiana","Newton County",1,74,87,36,51
050,18,111,"Indiana","Newton County",1,75,98,51,47
050,18,111,"Indiana","Newton County",1,76,120,57,63
050,18,111,"Indiana","Newton County",1,77,120,52,68
050,18,111,"Indiana","Newton County",1,78,97,43,54
050,18,111,"Indiana","Newton County",1,79,79,31,48
050,18,111,"Indiana","Newton County",1,80,80,39,41
050,18,111,"Indiana","Newton County",1,81,86,42,44
050,18,111,"Indiana","Newton County",1,82,69,29,40
050,18,111,"Indiana","Newton County",1,83,60,27,33
050,18,111,"Indiana","Newton County",1,84,53,18,35
050,18,111,"Indiana","Newton County",1,85,284,105,179
050,18,111,"Indiana","Newton County",2,0,151,82,69
050,18,111,"Indiana","Newton County",2,1,149,78,71
050,18,111,"Indiana","Newton County",2,2,143,79,64
050,18,111,"Indiana","Newton County",2,3,142,68,74
050,18,111,"Indiana","Newton County",2,4,164,74,90
050,18,111,"Indiana","Newton County",2,5,159,70,89
050,18,111,"Indiana","Newton County",2,6,146,74,72
050,18,111,"Indiana","Newton County",2,7,154,87,67
050,18,111,"Indiana","Newton County",2,8,147,82,65
050,18,111,"Indiana","Newton County",2,9,156,80,76
050,18,111,"Indiana","Newton County",2,10,173,85,88
050,18,111,"Indiana","Newton County",2,11,166,83,83
050,18,111,"Indiana","Newton County",2,12,184,87,97
050,18,111,"Indiana","Newton County",2,13,189,85,104
050,18,111,"Indiana","Newton County",2,14,174,84,90
050,18,111,"Indiana","Newton County",2,15,172,88,84
050,18,111,"Indiana","Newton County",2,16,182,95,87
050,18,111,"Indiana","Newton County",2,17,184,101,83
050,18,111,"Indiana","Newton County",2,18,148,79,69
050,18,111,"Indiana","Newton County",2,19,113,58,55
050,18,111,"Indiana","Newton County",2,20,139,76,63
050,18,111,"Indiana","Newton County",2,21,149,85,64
050,18,111,"Indiana","Newton County",2,22,148,81,67
050,18,111,"Indiana","Newton County",2,23,146,80,66
050,18,111,"Indiana","Newton County",2,24,142,78,64
050,18,111,"Indiana","Newton County",2,25,142,72,70
050,18,111,"Indiana","Newton County",2,26,153,80,73
050,18,111,"Indiana","Newton County",2,27,170,91,79
050,18,111,"Indiana","Newton County",2,28,184,104,80
050,18,111,"Indiana","Newton County",2,29,177,96,81
050,18,111,"Indiana","Newton County",2,30,163,86,77
050,18,111,"Indiana","Newton County",2,31,153,83,70
050,18,111,"Indiana","Newton County",2,32,145,74,71
050,18,111,"Indiana","Newton County",2,33,159,76,83
050,18,111,"Indiana","Newton County",2,34,169,81,88
050,18,111,"Indiana","Newton County",2,35,178,94,84
050,18,111,"Indiana","Newton County",2,36,156,82,74
050,18,111,"Indiana","Newton County",2,37,154,76,78
050,18,111,"Indiana","Newton County",2,38,156,80,76
050,18,111,"Indiana","Newton County",2,39,164,90,74
050,18,111,"Indiana","Newton County",2,40,179,100,79
050,18,111,"Indiana","Newton County",2,41,173,94,79
050,18,111,"Indiana","Newton County",2,42,161,87,74
050,18,111,"Indiana","Newton County",2,43,171,91,80
050,18,111,"Indiana","Newton County",2,44,157,79,78
050,18,111,"Indiana","Newton County",2,45,161,85,76
050,18,111,"Indiana","Newton County",2,46,157,85,72
050,18,111,"Indiana","Newton County",2,47,153,81,72
050,18,111,"Indiana","Newton County",2,48,162,84,78
050,18,111,"Indiana","Newton County",2,49,191,106,85
050,18,111,"Indiana","Newton County",2,50,189,102,87
050,18,111,"Indiana","Newton County",2,51,184,98,86
050,18,111,"Indiana","Newton County",2,52,180,98,82
050,18,111,"Indiana","Newton County",2,53,183,98,85
050,18,111,"Indiana","Newton County",2,54,187,103,84
050,18,111,"Indiana","Newton County",2,55,195,103,92
050,18,111,"Indiana","Newton County",2,56,213,106,107
050,18,111,"Indiana","Newton County",2,57,224,107,117
050,18,111,"Indiana","Newton County",2,58,231,118,113
050,18,111,"Indiana","Newton County",2,59,237,120,117
050,18,111,"Indiana","Newton County",2,60,220,111,109
050,18,111,"Indiana","Newton County",2,61,208,101,107
050,18,111,"Indiana","Newton County",2,62,205,112,93
050,18,111,"Indiana","Newton County",2,63,217,126,91
050,18,111,"Indiana","Newton County",2,64,203,106,97
050,18,111,"Indiana","Newton County",2,65,203,109,94
050,18,111,"Indiana","Newton County",2,66,200,106,94
050,18,111,"Indiana","Newton County",2,67,183,94,89
050,18,111,"Indiana","Newton County",2,68,169,80,89
050,18,111,"Indiana","Newton County",2,69,164,73,91
050,18,111,"Indiana","Newton County",2,70,164,78,86
050,18,111,"Indiana","Newton County",2,71,141,72,69
050,18,111,"Indiana","Newton County",2,72,122,58,64
050,18,111,"Indiana","Newton County",2,73,143,67,76
050,18,111,"Indiana","Newton County",2,74,92,39,53
050,18,111,"Indiana","Newton County",2,75,93,44,49
050,18,111,"Indiana","Newton County",2,76,113,54,59
050,18,111,"Indiana","Newton County",2,77,121,55,66
050,18,111,"Indiana","Newton County",2,78,100,44,56
050,18,111,"Indiana","Newton County",2,79,80,31,49
050,18,111,"Indiana","Newton County",2,80,76,35,41
050,18,111,"Indiana","Newton County",2,81,81,39,42
050,18,111,"Indiana","Newton County",2,82,72,32,40
050,18,111,"Indiana","Newton County",2,83,62,28,34
050,18,111,"Indiana","Newton County",2,84,53,19,34
050,18,111,"Indiana","Newton County",2,85,283,103,180
050,18,111,"Indiana","Newton County",3,0,143,84,59
050,18,111,"Indiana","Newton County",3,1,152,77,75
050,18,111,"Indiana","Newton County",3,2,145,77,68
050,18,111,"Indiana","Newton County",3,3,153,88,65
050,18,111,"Indiana","Newton County",3,4,145,74,71
050,18,111,"Indiana","Newton County",3,5,167,75,92
050,18,111,"Indiana","Newton County",3,6,162,72,90
050,18,111,"Indiana","Newton County",3,7,156,84,72
050,18,111,"Indiana","Newton County",3,8,159,86,73
050,18,111,"Indiana","Newton County",3,9,141,77,64
050,18,111,"Indiana","Newton County",3,10,162,82,80
050,18,111,"Indiana","Newton County",3,11,180,85,95
050,18,111,"Indiana","Newton County",3,12,178,86,92
050,18,111,"Indiana","Newton County",3,13,169,85,84
050,18,111,"Indiana","Newton County",3,14,178,75,103
050,18,111,"Indiana","Newton County",3,15,168,78,90
050,18,111,"Indiana","Newton County",3,16,171,88,83
050,18,111,"Indiana","Newton County",3,17,182,96,86
050,18,111,"Indiana","Newton County",3,18,155,86,69
050,18,111,"Indiana","Newton County",3,19,110,54,56
050,18,111,"Indiana","Newton County",3,20,126,60,66
050,18,111,"Indiana","Newton County",3,21,145,82,63
050,18,111,"Indiana","Newton County",3,22,154,89,65
050,18,111,"Indiana","Newton County",3,23,145,73,72
050,18,111,"Indiana","Newton County",3,24,150,89,61
050,18,111,"Indiana","Newton County",3,25,158,87,71
050,18,111,"Indiana","Newton County",3,26,152,77,75
050,18,111,"Indiana","Newton County",3,27,157,80,77
050,18,111,"Indiana","Newton County",3,28,169,94,75
050,18,111,"Indiana","Newton County",3,29,191,108,83
050,18,111,"Indiana","Newton County",3,30,172,94,78
050,18,111,"Indiana","Newton County",3,31,160,84,76
050,18,111,"Indiana","Newton County",3,32,148,83,65
050,18,111,"Indiana","Newton County",3,33,163,80,83
050,18,111,"Indiana","Newton County",3,34,150,69,81
050,18,111,"Indiana","Newton County",3,35,168,80,88
050,18,111,"Indiana","Newton County",3,36,189,105,84
050,18,111,"Indiana","Newton County",3,37,154,81,73
050,18,111,"Indiana","Newton County",3,38,168,77,91
050,18,111,"Indiana","Newton County",3,39,157,83,74
050,18,111,"Indiana","Newton County",3,40,166,92,74
050,18,111,"Indiana","Newton County",3,41,179,101,78
050,18,111,"Indiana","Newton County",3,42,168,90,78
050,18,111,"Indiana","Newton County",3,43,152,84,68
050,18,111,"Indiana","Newton County",3,44,181,98,83
050,18,111,"Indiana","Newton County",3,45,143,72,71
050,18,111,"Indiana","Newton County",3,46,156,82,74
050,18,111,"Indiana","Newton County",3,47,150,82,68
050,18,111,"Indiana","Newton County",3,48,146,78,68
050,18,111,"Indiana","Newton County",3,49,167,91,76
050,18,111,"Indiana","Newton County",3,50,192,106,86
050,18,111,"Indiana","Newton County",3,51,190,102,88
050,18,111,"Indiana","Newton County",3,52,186,99,87
050,18,111,"Indiana","Newton County",3,53,179,95,84
050,18,111,"Indiana","Newton County",3,54,186,101,85
050,18,111,"Indiana","Newton County",3,55,192,105,87
050,18,111,"Indiana","Newton County",3,56,195,103,92
050,18,111,"Indiana","Newton County",3,57,206,101,105
050,18,111,"Indiana","Newton County",3,58,218,105,113
050,18,111,"Indiana","Newton County",3,59,227,114,113
050,18,111,"Indiana","Newton County",3,60,237,120,117
050,18,111,"Indiana","Newton County",3,61,220,108,112
050,18,111,"Indiana","Newton County",3,62,208,99,109
050,18,111,"Indiana","Newton County",3,63,207,110,97
050,18,111,"Indiana","Newton County",3,64,215,120,95
050,18,111,"Indiana","Newton County",3,65,198,105,93
050,18,111,"Indiana","Newton County",3,66,203,110,93
050,18,111,"Indiana","Newton County",3,67,207,110,97
050,18,111,"Indiana","Newton County",3,68,186,97,89
050,18,111,"Indiana","Newton County",3,69,161,77,84
050,18,111,"Indiana","Newton County",3,70,155,71,84
050,18,111,"Indiana","Newton County",3,71,163,76,87
050,18,111,"Indiana","Newton County",3,72,137,67,70
050,18,111,"Indiana","Newton County",3,73,120,58,62
050,18,111,"Indiana","Newton County",3,74,134,65,69
050,18,111,"Indiana","Newton County",3,75,92,38,54
050,18,111,"Indiana","Newton County",3,76,90,41,49
050,18,111,"Indiana","Newton County",3,77,102,51,51
050,18,111,"Indiana","Newton County",3,78,114,50,64
050,18,111,"Indiana","Newton County",3,79,94,41,53
050,18,111,"Indiana","Newton County",3,80,71,29,42
050,18,111,"Indiana","Newton County",3,81,76,35,41
050,18,111,"Indiana","Newton County",3,82,76,34,42
050,18,111,"Indiana","Newton County",3,83,71,32,39
050,18,111,"Indiana","Newton County",3,84,54,24,30
050,18,111,"Indiana","Newton County",3,85,298,105,193
050,18,111,"Indiana","Newton County",4,0,156,77,79
050,18,111,"Indiana","Newton County",4,1,144,83,61
050,18,111,"Indiana","Newton County",4,2,159,80,79
050,18,111,"Indiana","Newton County",4,3,158,80,78
050,18,111,"Indiana","Newton County",4,4,150,83,67
050,18,111,"Indiana","Newton County",4,5,134,65,69
050,18,111,"Indiana","Newton County",4,6,170,77,93
050,18,111,"Indiana","Newton County",4,7,159,76,83
050,18,111,"Indiana","Newton County",4,8,141,77,64
050,18,111,"Indiana","Newton County",4,9,169,92,77
050,18,111,"Indiana","Newton County",4,10,138,78,60
050,18,111,"Indiana","Newton County",4,11,169,87,82
050,18,111,"Indiana","Newton County",4,12,168,78,90
050,18,111,"Indiana","Newton County",4,13,173,88,85
050,18,111,"Indiana","Newton County",4,14,173,85,88
050,18,111,"Indiana","Newton County",4,15,179,79,100
050,18,111,"Indiana","Newton County",4,16,178,85,93
050,18,111,"Indiana","Newton County",4,17,178,93,85
050,18,111,"Indiana","Newton County",4,18,154,85,69
050,18,111,"Indiana","Newton County",4,19,118,67,51
050,18,111,"Indiana","Newton County",4,20,118,61,57
050,18,111,"Indiana","Newton County",4,21,134,65,69
050,18,111,"Indiana","Newton County",4,22,148,87,61
050,18,111,"Indiana","Newton County",4,23,167,94,73
050,18,111,"Indiana","Newton County",4,24,140,67,73
050,18,111,"Indiana","Newton County",4,25,162,91,71
050,18,111,"Indiana","Newton County",4,26,159,87,72
050,18,111,"Indiana","Newton County",4,27,144,61,83
050,18,111,"Indiana","Newton County",4,28,148,83,65
050,18,111,"Indiana","Newton County",4,29,170,95,75
050,18,111,"Indiana","Newton County",4,30,192,109,83
050,18,111,"Indiana","Newton County",4,31,172,95,77
050,18,111,"Indiana","Newton County",4,32,177,91,86
050,18,111,"Indiana","Newton County",4,33,150,80,70
050,18,111,"Indiana","Newton County",4,34,165,81,84
050,18,111,"Indiana","Newton County",4,35,157,73,84
050,18,111,"Indiana","Newton County",4,36,169,84,85
050,18,111,"Indiana","Newton County",4,37,184,100,84
050,18,111,"Indiana","Newton County",4,38,157,85,72
050,18,111,"Indiana","Newton County",4,39,176,77,99
050,18,111,"Indiana","Newton County",4,40,150,76,74
050,18,111,"Indiana","Newton County",4,41,151,85,66
050,18,111,"Indiana","Newton County",4,42,186,108,78
050,18,111,"Indiana","Newton County",4,43,169,87,82
050,18,111,"Indiana","Newton County",4,44,151,83,68
050,18,111,"Indiana","Newton County",4,45,185,98,87
050,18,111,"Indiana","Newton County",4,46,146,71,75
050,18,111,"Indiana","Newton County",4,47,157,83,74
050,18,111,"Indiana","Newton County",4,48,153,83,70
050,18,111,"Indiana","Newton County",4,49,153,80,73
050,18,111,"Indiana","Newton County",4,50,169,91,78
050,18,111,"Indiana","Newton County",4,51,191,108,83
050,18,111,"Indiana","Newton County",4,52,203,106,97
050,18,111,"Indiana","Newton County",4,53,186,100,86
050,18,111,"Indiana","Newton County",4,54,174,95,79
050,18,111,"Indiana","Newton County",4,55,187,101,86
050,18,111,"Indiana","Newton County",4,56,189,102,87
050,18,111,"Indiana","Newton County",4,57,197,102,95
050,18,111,"Indiana","Newton County",4,58,201,97,104
050,18,111,"Indiana","Newton County",4,59,224,109,115
050,18,111,"Indiana","Newton County",4,60,224,117,107
050,18,111,"Indiana","Newton County",4,61,233,118,115
050,18,111,"Indiana","Newton County",4,62,218,107,111
050,18,111,"Indiana","Newton County",4,63,213,98,115
050,18,111,"Indiana","Newton County",4,64,209,108,101
050,18,111,"Indiana","Newton County",4,65,213,120,93
050,18,111,"Indiana","Newton County",4,66,195,100,95
050,18,111,"Indiana","Newton County",4,67,204,111,93
050,18,111,"Indiana","Newton County",4,68,209,109,100
050,18,111,"Indiana","Newton County",4,69,177,91,86
050,18,111,"Indiana","Newton County",4,70,152,76,76
050,18,111,"Indiana","Newton County",4,71,152,69,83
050,18,111,"Indiana","Newton County",4,72,159,72,87
050,18,111,"Indiana","Newton County",4,73,126,63,63
050,18,111,"Indiana","Newton County",4,74,114,55,59
050,18,111,"Indiana","Newton County",4,75,133,65,68
050,18,111,"Indiana","Newton County",4,76,92,36,56
050,18,111,"Indiana","Newton County",4,77,79,36,43
050,18,111,"Indiana","Newton County",4,78,92,49,43
050,18,111,"Indiana","Newton County",4,79,109,47,62
050,18,111,"Indiana","Newton County",4,80,85,40,45
050,18,111,"Indiana","Newton County",4,81,62,24,38
050,18,111,"Indiana","Newton County",4,82,70,29,41
050,18,111,"Indiana","Newton County",4,83,75,33,42
050,18,111,"Indiana","Newton County",4,84,57,22,35
050,18,111,"Indiana","Newton County",4,85,308,111,197
050,18,111,"Indiana","Newton County",5,0,155,75,80
050,18,111,"Indiana","Newton County",5,1,163,81,82
050,18,111,"Indiana","Newton County",5,2,150,84,66
050,18,111,"Indiana","Newton County",5,3,173,93,80
050,18,111,"Indiana","Newton County",5,4,155,74,81
050,18,111,"Indiana","Newton County",5,5,154,88,66
050,18,111,"Indiana","Newton County",5,6,154,74,80
050,18,111,"Indiana","Newton County",5,7,167,74,93
050,18,111,"Indiana","Newton County",5,8,155,73,82
050,18,111,"Indiana","Newton County",5,9,148,82,66
050,18,111,"Indiana","Newton County",5,10,182,99,83
050,18,111,"Indiana","Newton County",5,11,140,86,54
050,18,111,"Indiana","Newton County",5,12,177,83,94
050,18,111,"Indiana","Newton County",5,13,171,79,92
050,18,111,"Indiana","Newton County",5,14,174,92,82
050,18,111,"Indiana","Newton County",5,15,181,91,90
050,18,111,"Indiana","Newton County",5,16,172,73,99
050,18,111,"Indiana","Newton County",5,17,177,86,91
050,18,111,"Indiana","Newton County",5,18,153,83,70
050,18,111,"Indiana","Newton County",5,19,117,65,52
050,18,111,"Indiana","Newton County",5,20,136,77,59
050,18,111,"Indiana","Newton County",5,21,124,62,62
050,18,111,"Indiana","Newton County",5,22,144,70,74
050,18,111,"Indiana","Newton County",5,23,149,79,70
050,18,111,"Indiana","Newton County",5,24,171,99,72
050,18,111,"Indiana","Newton County",5,25,152,76,76
050,18,111,"Indiana","Newton County",5,26,166,90,76
050,18,111,"Indiana","Newton County",5,27,172,93,79
050,18,111,"Indiana","Newton County",5,28,147,57,90
050,18,111,"Indiana","Newton County",5,29,143,86,57
050,18,111,"Indiana","Newton County",5,30,168,95,73
050,18,111,"Indiana","Newton County",5,31,192,111,81
050,18,111,"Indiana","Newton County",5,32,183,94,89
050,18,111,"Indiana","Newton County",5,33,174,88,86
050,18,111,"Indiana","Newton County",5,34,162,87,75
050,18,111,"Indiana","Newton County",5,35,172,86,86
050,18,111,"Indiana","Newton County",5,36,155,74,81
050,18,111,"Indiana","Newton County",5,37,172,88,84
050,18,111,"Indiana","Newton County",5,38,186,101,85
050,18,111,"Indiana","Newton County",5,39,168,89,79
050,18,111,"Indiana","Newton County",5,40,177,72,105
050,18,111,"Indiana","Newton County",5,41,155,81,74
050,18,111,"Indiana","Newton County",5,42,159,93,66
050,18,111,"Indiana","Newton County",5,43,177,101,76
050,18,111,"Indiana","Newton County",5,44,172,91,81
050,18,111,"Indiana","Newton County",5,45,153,85,68
050,18,111,"Indiana","Newton County",5,46,184,98,86
050,18,111,"Indiana","Newton County",5,47,140,72,68
050,18,111,"Indiana","Newton County",5,48,154,81,73
050,18,111,"Indiana","Newton County",5,49,149,79,70
050,18,111,"Indiana","Newton County",5,50,152,83,69
050,18,111,"Indiana","Newton County",5,51,183,96,87
050,18,111,"Indiana","Newton County",5,52,195,111,84
050,18,111,"Indiana","Newton County",5,53,198,104,94
050,18,111,"Indiana","Newton County",5,54,185,99,86
050,18,111,"Indiana","Newton County",5,55,174,91,83
050,18,111,"Indiana","Newton County",5,56,184,102,82
050,18,111,"Indiana","Newton County",5,57,183,96,87
050,18,111,"Indiana","Newton County",5,58,201,105,96
050,18,111,"Indiana","Newton County",5,59,199,96,103
050,18,111,"Indiana","Newton County",5,60,225,112,113
050,18,111,"Indiana","Newton County",5,61,227,118,109
050,18,111,"Indiana","Newton County",5,62,231,116,115
050,18,111,"Indiana","Newton County",5,63,216,110,106
050,18,111,"Indiana","Newton County",5,64,215,103,112
050,18,111,"Indiana","Newton County",5,65,203,104,99
050,18,111,"Indiana","Newton County",5,66,216,115,101
050,18,111,"Indiana","Newton County",5,67,192,94,98
050,18,111,"Indiana","Newton County",5,68,200,110,90
050,18,111,"Indiana","Newton County",5,69,198,104,94
050,18,111,"Indiana","Newton County",5,70,175,94,81
050,18,111,"Indiana","Newton County",5,71,154,75,79
050,18,111,"Indiana","Newton County",5,72,148,64,84
050,18,111,"Indiana","Newton County",5,73,149,71,78
050,18,111,"Indiana","Newton County",5,74,116,60,56
050,18,111,"Indiana","Newton County",5,75,112,56,56
050,18,111,"Indiana","Newton County",5,76,127,63,64
050,18,111,"Indiana","Newton County",5,77,80,29,51
050,18,111,"Indiana","Newton County",5,78,73,33,40
050,18,111,"Indiana","Newton County",5,79,88,47,41
050,18,111,"Indiana","Newton County",5,80,95,46,49
050,18,111,"Indiana","Newton County",5,81,79,35,44
050,18,111,"Indiana","Newton County",5,82,56,19,37
050,18,111,"Indiana","Newton County",5,83,66,28,38
050,18,111,"Indiana","Newton County",5,84,63,26,37
050,18,111,"Indiana","Newton County",5,85,328,117,211
050,18,113,"Indiana","Noble County",1,0,611,312,299
050,18,113,"Indiana","Noble County",1,1,620,322,298
050,18,113,"Indiana","Noble County",1,2,623,312,311
050,18,113,"Indiana","Noble County",1,3,599,295,304
050,18,113,"Indiana","Noble County",1,4,631,312,319
050,18,113,"Indiana","Noble County",1,5,660,349,311
050,18,113,"Indiana","Noble County",1,6,628,326,302
050,18,113,"Indiana","Noble County",1,7,597,298,299
050,18,113,"Indiana","Noble County",1,8,609,311,298
050,18,113,"Indiana","Noble County",1,9,639,337,302
050,18,113,"Indiana","Noble County",1,10,653,340,313
050,18,113,"Indiana","Noble County",1,11,688,357,331
050,18,113,"Indiana","Noble County",1,12,716,368,348
050,18,113,"Indiana","Noble County",1,13,697,381,316
050,18,113,"Indiana","Noble County",1,14,675,326,349
050,18,113,"Indiana","Noble County",1,15,681,352,329
050,18,113,"Indiana","Noble County",1,16,688,348,340
050,18,113,"Indiana","Noble County",1,17,674,332,342
050,18,113,"Indiana","Noble County",1,18,577,320,257
050,18,113,"Indiana","Noble County",1,19,487,265,222
050,18,113,"Indiana","Noble County",1,20,539,281,258
050,18,113,"Indiana","Noble County",1,21,567,292,275
050,18,113,"Indiana","Noble County",1,22,586,314,272
050,18,113,"Indiana","Noble County",1,23,561,288,273
050,18,113,"Indiana","Noble County",1,24,565,280,285
050,18,113,"Indiana","Noble County",1,25,609,307,302
050,18,113,"Indiana","Noble County",1,26,623,306,317
050,18,113,"Indiana","Noble County",1,27,590,296,294
050,18,113,"Indiana","Noble County",1,28,599,308,291
050,18,113,"Indiana","Noble County",1,29,570,286,284
050,18,113,"Indiana","Noble County",1,30,570,287,283
050,18,113,"Indiana","Noble County",1,31,543,266,277
050,18,113,"Indiana","Noble County",1,32,556,289,267
050,18,113,"Indiana","Noble County",1,33,548,281,267
050,18,113,"Indiana","Noble County",1,34,548,281,267
050,18,113,"Indiana","Noble County",1,35,549,290,259
050,18,113,"Indiana","Noble County",1,36,564,297,267
050,18,113,"Indiana","Noble County",1,37,557,278,279
050,18,113,"Indiana","Noble County",1,38,578,294,284
050,18,113,"Indiana","Noble County",1,39,574,282,292
050,18,113,"Indiana","Noble County",1,40,591,309,282
050,18,113,"Indiana","Noble County",1,41,570,290,280
050,18,113,"Indiana","Noble County",1,42,602,311,291
050,18,113,"Indiana","Noble County",1,43,583,307,276
050,18,113,"Indiana","Noble County",1,44,580,296,284
050,18,113,"Indiana","Noble County",1,45,578,294,284
050,18,113,"Indiana","Noble County",1,46,561,291,270
050,18,113,"Indiana","Noble County",1,47,548,273,275
050,18,113,"Indiana","Noble County",1,48,580,288,292
050,18,113,"Indiana","Noble County",1,49,642,320,322
050,18,113,"Indiana","Noble County",1,50,627,323,304
050,18,113,"Indiana","Noble County",1,51,573,297,276
050,18,113,"Indiana","Noble County",1,52,604,323,281
050,18,113,"Indiana","Noble County",1,53,606,316,290
050,18,113,"Indiana","Noble County",1,54,605,312,293
050,18,113,"Indiana","Noble County",1,55,660,344,316
050,18,113,"Indiana","Noble County",1,56,684,364,320
050,18,113,"Indiana","Noble County",1,57,661,340,321
050,18,113,"Indiana","Noble County",1,58,688,351,337
050,18,113,"Indiana","Noble County",1,59,676,358,318
050,18,113,"Indiana","Noble County",1,60,668,327,341
050,18,113,"Indiana","Noble County",1,61,658,345,313
050,18,113,"Indiana","Noble County",1,62,676,357,319
050,18,113,"Indiana","Noble County",1,63,646,348,298
050,18,113,"Indiana","Noble County",1,64,608,311,297
050,18,113,"Indiana","Noble County",1,65,604,295,309
050,18,113,"Indiana","Noble County",1,66,603,304,299
050,18,113,"Indiana","Noble County",1,67,584,312,272
050,18,113,"Indiana","Noble County",1,68,532,291,241
050,18,113,"Indiana","Noble County",1,69,467,227,240
050,18,113,"Indiana","Noble County",1,70,489,231,258
050,18,113,"Indiana","Noble County",1,71,472,217,255
050,18,113,"Indiana","Noble County",1,72,457,212,245
050,18,113,"Indiana","Noble County",1,73,448,221,227
050,18,113,"Indiana","Noble County",1,74,313,161,152
050,18,113,"Indiana","Noble County",1,75,290,138,152
050,18,113,"Indiana","Noble County",1,76,281,127,154
050,18,113,"Indiana","Noble County",1,77,276,119,157
050,18,113,"Indiana","Noble County",1,78,242,109,133
050,18,113,"Indiana","Noble County",1,79,220,94,126
050,18,113,"Indiana","Noble County",1,80,167,67,100
050,18,113,"Indiana","Noble County",1,81,149,63,86
050,18,113,"Indiana","Noble County",1,82,162,76,86
050,18,113,"Indiana","Noble County",1,83,131,60,71
050,18,113,"Indiana","Noble County",1,84,114,43,71
050,18,113,"Indiana","Noble County",1,85,837,264,573
050,18,113,"Indiana","Noble County",2,0,643,331,312
050,18,113,"Indiana","Noble County",2,1,616,321,295
050,18,113,"Indiana","Noble County",2,2,620,314,306
050,18,113,"Indiana","Noble County",2,3,602,298,304
050,18,113,"Indiana","Noble County",2,4,623,310,313
050,18,113,"Indiana","Noble County",2,5,650,337,313
050,18,113,"Indiana","Noble County",2,6,635,329,306
050,18,113,"Indiana","Noble County",2,7,605,305,300
050,18,113,"Indiana","Noble County",2,8,607,310,297
050,18,113,"Indiana","Noble County",2,9,627,328,299
050,18,113,"Indiana","Noble County",2,10,649,338,311
050,18,113,"Indiana","Noble County",2,11,677,350,327
050,18,113,"Indiana","Noble County",2,12,711,368,343
050,18,113,"Indiana","Noble County",2,13,700,379,321
050,18,113,"Indiana","Noble County",2,14,680,339,341
050,18,113,"Indiana","Noble County",2,15,682,347,335
050,18,113,"Indiana","Noble County",2,16,685,349,336
050,18,113,"Indiana","Noble County",2,17,672,334,338
050,18,113,"Indiana","Noble County",2,18,567,308,259
050,18,113,"Indiana","Noble County",2,19,483,264,219
050,18,113,"Indiana","Noble County",2,20,541,283,258
050,18,113,"Indiana","Noble County",2,21,564,291,273
050,18,113,"Indiana","Noble County",2,22,582,310,272
050,18,113,"Indiana","Noble County",2,23,570,296,274
050,18,113,"Indiana","Noble County",2,24,567,282,285
050,18,113,"Indiana","Noble County",2,25,599,300,299
050,18,113,"Indiana","Noble County",2,26,613,301,312
050,18,113,"Indiana","Noble County",2,27,596,299,297
050,18,113,"Indiana","Noble County",2,28,597,305,292
050,18,113,"Indiana","Noble County",2,29,579,293,286
050,18,113,"Indiana","Noble County",2,30,572,284,288
050,18,113,"Indiana","Noble County",2,31,550,275,275
050,18,113,"Indiana","Noble County",2,32,554,282,272
050,18,113,"Indiana","Noble County",2,33,549,283,266
050,18,113,"Indiana","Noble County",2,34,547,281,266
050,18,113,"Indiana","Noble County",2,35,553,294,259
050,18,113,"Indiana","Noble County",2,36,557,294,263
050,18,113,"Indiana","Noble County",2,37,562,285,277
050,18,113,"Indiana","Noble County",2,38,572,290,282
050,18,113,"Indiana","Noble County",2,39,573,286,287
050,18,113,"Indiana","Noble County",2,40,588,299,289
050,18,113,"Indiana","Noble County",2,41,577,296,281
050,18,113,"Indiana","Noble County",2,42,592,307,285
050,18,113,"Indiana","Noble County",2,43,591,310,281
050,18,113,"Indiana","Noble County",2,44,576,297,279
050,18,113,"Indiana","Noble County",2,45,578,293,285
050,18,113,"Indiana","Noble County",2,46,563,290,273
050,18,113,"Indiana","Noble County",2,47,549,276,273
050,18,113,"Indiana","Noble County",2,48,572,286,286
050,18,113,"Indiana","Noble County",2,49,631,315,316
050,18,113,"Indiana","Noble County",2,50,631,322,309
050,18,113,"Indiana","Noble County",2,51,589,307,282
050,18,113,"Indiana","Noble County",2,52,598,319,279
050,18,113,"Indiana","Noble County",2,53,605,318,287
050,18,113,"Indiana","Noble County",2,54,602,312,290
050,18,113,"Indiana","Noble County",2,55,649,338,311
050,18,113,"Indiana","Noble County",2,56,677,356,321
050,18,113,"Indiana","Noble County",2,57,667,346,321
050,18,113,"Indiana","Noble County",2,58,683,350,333
050,18,113,"Indiana","Noble County",2,59,684,361,323
050,18,113,"Indiana","Noble County",2,60,665,331,334
050,18,113,"Indiana","Noble County",2,61,657,340,317
050,18,113,"Indiana","Noble County",2,62,665,350,315
050,18,113,"Indiana","Noble County",2,63,656,350,306
050,18,113,"Indiana","Noble County",2,64,608,314,294
050,18,113,"Indiana","Noble County",2,65,604,298,306
050,18,113,"Indiana","Noble County",2,66,598,300,298
050,18,113,"Indiana","Noble County",2,67,583,307,276
050,18,113,"Indiana","Noble County",2,68,540,293,247
050,18,113,"Indiana","Noble County",2,69,487,244,243
050,18,113,"Indiana","Noble County",2,70,484,229,255
050,18,113,"Indiana","Noble County",2,71,471,220,251
050,18,113,"Indiana","Noble County",2,72,448,206,242
050,18,113,"Indiana","Noble County",2,73,465,227,238
050,18,113,"Indiana","Noble County",2,74,321,163,158
050,18,113,"Indiana","Noble County",2,75,293,143,150
050,18,113,"Indiana","Noble County",2,76,276,126,150
050,18,113,"Indiana","Noble County",2,77,287,124,163
050,18,113,"Indiana","Noble County",2,78,242,107,135
050,18,113,"Indiana","Noble County",2,79,219,94,125
050,18,113,"Indiana","Noble County",2,80,171,71,100
050,18,113,"Indiana","Noble County",2,81,148,63,85
050,18,113,"Indiana","Noble County",2,82,158,71,87
050,18,113,"Indiana","Noble County",2,83,136,62,74
050,18,113,"Indiana","Noble County",2,84,116,46,70
050,18,113,"Indiana","Noble County",2,85,829,263,566
050,18,113,"Indiana","Noble County",3,0,593,327,266
050,18,113,"Indiana","Noble County",3,1,661,340,321
050,18,113,"Indiana","Noble County",3,2,612,308,304
050,18,113,"Indiana","Noble County",3,3,605,309,296
050,18,113,"Indiana","Noble County",3,4,594,298,296
050,18,113,"Indiana","Noble County",3,5,615,312,303
050,18,113,"Indiana","Noble County",3,6,647,335,312
050,18,113,"Indiana","Noble County",3,7,625,325,300
050,18,113,"Indiana","Noble County",3,8,605,306,299
050,18,113,"Indiana","Noble County",3,9,594,298,296
050,18,113,"Indiana","Noble County",3,10,622,317,305
050,18,113,"Indiana","Noble County",3,11,660,339,321
050,18,113,"Indiana","Noble County",3,12,672,350,322
050,18,113,"Indiana","Noble County",3,13,728,375,353
050,18,113,"Indiana","Noble County",3,14,696,375,321
050,18,113,"Indiana","Noble County",3,15,690,349,341
050,18,113,"Indiana","Noble County",3,16,674,347,327
050,18,113,"Indiana","Noble County",3,17,682,343,339
050,18,113,"Indiana","Noble County",3,18,591,305,286
050,18,113,"Indiana","Noble County",3,19,474,256,218
050,18,113,"Indiana","Noble County",3,20,542,292,250
050,18,113,"Indiana","Noble County",3,21,549,285,264
050,18,113,"Indiana","Noble County",3,22,593,306,287
050,18,113,"Indiana","Noble County",3,23,567,284,283
050,18,113,"Indiana","Noble County",3,24,568,285,283
050,18,113,"Indiana","Noble County",3,25,566,293,273
050,18,113,"Indiana","Noble County",3,26,620,305,315
050,18,113,"Indiana","Noble County",3,27,610,303,307
050,18,113,"Indiana","Noble County",3,28,602,304,298
050,18,113,"Indiana","Noble County",3,29,574,297,277
050,18,113,"Indiana","Noble County",3,30,572,291,281
050,18,113,"Indiana","Noble County",3,31,579,291,288
050,18,113,"Indiana","Noble County",3,32,544,274,270
050,18,113,"Indiana","Noble County",3,33,555,278,277
050,18,113,"Indiana","Noble County",3,34,561,287,274
050,18,113,"Indiana","Noble County",3,35,539,273,266
050,18,113,"Indiana","Noble County",3,36,551,285,266
050,18,113,"Indiana","Noble County",3,37,580,304,276
050,18,113,"Indiana","Noble County",3,38,581,301,280
050,18,113,"Indiana","Noble County",3,39,583,294,289
050,18,113,"Indiana","Noble County",3,40,579,278,301
050,18,113,"Indiana","Noble County",3,41,581,296,285
050,18,113,"Indiana","Noble County",3,42,576,295,281
050,18,113,"Indiana","Noble County",3,43,587,301,286
050,18,113,"Indiana","Noble County",3,44,596,310,286
050,18,113,"Indiana","Noble County",3,45,573,298,275
050,18,113,"Indiana","Noble County",3,46,567,292,275
050,18,113,"Indiana","Noble County",3,47,563,294,269
050,18,113,"Indiana","Noble County",3,48,550,281,269
050,18,113,"Indiana","Noble County",3,49,566,279,287
050,18,113,"Indiana","Noble County",3,50,623,315,308
050,18,113,"Indiana","Noble County",3,51,613,314,299
050,18,113,"Indiana","Noble County",3,52,593,307,286
050,18,113,"Indiana","Noble County",3,53,583,314,269
050,18,113,"Indiana","Noble County",3,54,581,298,283
050,18,113,"Indiana","Noble County",3,55,594,307,287
050,18,113,"Indiana","Noble County",3,56,646,345,301
050,18,113,"Indiana","Noble County",3,57,663,344,319
050,18,113,"Indiana","Noble County",3,58,657,338,319
050,18,113,"Indiana","Noble County",3,59,672,349,323
050,18,113,"Indiana","Noble County",3,60,680,350,330
050,18,113,"Indiana","Noble County",3,61,656,325,331
050,18,113,"Indiana","Noble County",3,62,656,343,313
050,18,113,"Indiana","Noble County",3,63,661,351,310
050,18,113,"Indiana","Noble County",3,64,641,347,294
050,18,113,"Indiana","Noble County",3,65,599,304,295
050,18,113,"Indiana","Noble County",3,66,589,290,299
050,18,113,"Indiana","Noble County",3,67,570,285,285
050,18,113,"Indiana","Noble County",3,68,576,305,271
050,18,113,"Indiana","Noble County",3,69,517,277,240
050,18,113,"Indiana","Noble County",3,70,487,238,249
050,18,113,"Indiana","Noble County",3,71,462,224,238
050,18,113,"Indiana","Noble County",3,72,457,213,244
050,18,113,"Indiana","Noble County",3,73,439,204,235
050,18,113,"Indiana","Noble County",3,74,449,217,232
050,18,113,"Indiana","Noble County",3,75,302,149,153
050,18,113,"Indiana","Noble County",3,76,274,134,140
050,18,113,"Indiana","Noble County",3,77,260,119,141
050,18,113,"Indiana","Noble County",3,78,279,124,155
050,18,113,"Indiana","Noble County",3,79,230,98,132
050,18,113,"Indiana","Noble County",3,80,192,82,110
050,18,113,"Indiana","Noble County",3,81,154,67,87
050,18,113,"Indiana","Noble County",3,82,144,55,89
050,18,113,"Indiana","Noble County",3,83,149,65,84
050,18,113,"Indiana","Noble County",3,84,130,59,71
050,18,113,"Indiana","Noble County",3,85,800,253,547
050,18,113,"Indiana","Noble County",4,0,591,305,286
050,18,113,"Indiana","Noble County",4,1,611,346,265
050,18,113,"Indiana","Noble County",4,2,647,333,314
050,18,113,"Indiana","Noble County",4,3,610,323,287
050,18,113,"Indiana","Noble County",4,4,613,310,303
050,18,113,"Indiana","Noble County",4,5,585,293,292
050,18,113,"Indiana","Noble County",4,6,628,333,295
050,18,113,"Indiana","Noble County",4,7,651,332,319
050,18,113,"Indiana","Noble County",4,8,615,329,286
050,18,113,"Indiana","Noble County",4,9,573,283,290
050,18,113,"Indiana","Noble County",4,10,597,302,295
050,18,113,"Indiana","Noble County",4,11,624,320,304
050,18,113,"Indiana","Noble County",4,12,680,339,341
050,18,113,"Indiana","Noble County",4,13,656,347,309
050,18,113,"Indiana","Noble County",4,14,737,378,359
050,18,113,"Indiana","Noble County",4,15,691,375,316
050,18,113,"Indiana","Noble County",4,16,680,344,336
050,18,113,"Indiana","Noble County",4,17,666,344,322
050,18,113,"Indiana","Noble County",4,18,585,308,277
050,18,113,"Indiana","Noble County",4,19,464,239,225
050,18,113,"Indiana","Noble County",4,20,504,265,239
050,18,113,"Indiana","Noble County",4,21,562,299,263
050,18,113,"Indiana","Noble County",4,22,584,302,282
050,18,113,"Indiana","Noble County",4,23,617,322,295
050,18,113,"Indiana","Noble County",4,24,564,297,267
050,18,113,"Indiana","Noble County",4,25,562,271,291
050,18,113,"Indiana","Noble County",4,26,560,285,275
050,18,113,"Indiana","Noble County",4,27,626,312,314
050,18,113,"Indiana","Noble County",4,28,594,290,304
050,18,113,"Indiana","Noble County",4,29,600,299,301
050,18,113,"Indiana","Noble County",4,30,569,294,275
050,18,113,"Indiana","Noble County",4,31,568,296,272
050,18,113,"Indiana","Noble County",4,32,570,284,286
050,18,113,"Indiana","Noble County",4,33,549,276,273
050,18,113,"Indiana","Noble County",4,34,535,260,275
050,18,113,"Indiana","Noble County",4,35,564,293,271
050,18,113,"Indiana","Noble County",4,36,546,272,274
050,18,113,"Indiana","Noble County",4,37,559,283,276
050,18,113,"Indiana","Noble County",4,38,578,299,279
050,18,113,"Indiana","Noble County",4,39,587,310,277
050,18,113,"Indiana","Noble County",4,40,565,277,288
050,18,113,"Indiana","Noble County",4,41,576,287,289
050,18,113,"Indiana","Noble County",4,42,565,280,285
050,18,113,"Indiana","Noble County",4,43,575,300,275
050,18,113,"Indiana","Noble County",4,44,584,299,285
050,18,113,"Indiana","Noble County",4,45,586,293,293
050,18,113,"Indiana","Noble County",4,46,568,293,275
050,18,113,"Indiana","Noble County",4,47,556,285,271
050,18,113,"Indiana","Noble County",4,48,560,296,264
050,18,113,"Indiana","Noble County",4,49,537,268,269
050,18,113,"Indiana","Noble County",4,50,577,281,296
050,18,113,"Indiana","Noble County",4,51,634,316,318
050,18,113,"Indiana","Noble County",4,52,612,315,297
050,18,113,"Indiana","Noble County",4,53,586,308,278
050,18,113,"Indiana","Noble County",4,54,578,315,263
050,18,113,"Indiana","Noble County",4,55,582,295,287
050,18,113,"Indiana","Noble County",4,56,579,295,284
050,18,113,"Indiana","Noble County",4,57,627,332,295
050,18,113,"Indiana","Noble County",4,58,645,330,315
050,18,113,"Indiana","Noble County",4,59,660,343,317
050,18,113,"Indiana","Noble County",4,60,650,335,315
050,18,113,"Indiana","Noble County",4,61,679,348,331
050,18,113,"Indiana","Noble County",4,62,652,316,336
050,18,113,"Indiana","Noble County",4,63,652,333,319
050,18,113,"Indiana","Noble County",4,64,640,340,300
050,18,113,"Indiana","Noble County",4,65,632,343,289
050,18,113,"Indiana","Noble County",4,66,575,293,282
050,18,113,"Indiana","Noble County",4,67,580,284,296
050,18,113,"Indiana","Noble County",4,68,571,286,285
050,18,113,"Indiana","Noble County",4,69,556,290,266
050,18,113,"Indiana","Noble County",4,70,520,271,249
050,18,113,"Indiana","Noble County",4,71,467,235,232
050,18,113,"Indiana","Noble County",4,72,461,220,241
050,18,113,"Indiana","Noble County",4,73,443,203,240
050,18,113,"Indiana","Noble County",4,74,425,200,225
050,18,113,"Indiana","Noble County",4,75,429,200,229
050,18,113,"Indiana","Noble County",4,76,279,141,138
050,18,113,"Indiana","Noble County",4,77,253,120,133
050,18,113,"Indiana","Noble County",4,78,252,121,131
050,18,113,"Indiana","Noble County",4,79,261,110,151
050,18,113,"Indiana","Noble County",4,80,210,92,118
050,18,113,"Indiana","Noble County",4,81,172,74,98
050,18,113,"Indiana","Noble County",4,82,153,60,93
050,18,113,"Indiana","Noble County",4,83,135,51,84
050,18,113,"Indiana","Noble County",4,84,139,61,78
050,18,113,"Indiana","Noble County",4,85,794,265,529
050,18,113,"Indiana","Noble County",5,0,588,305,283
050,18,113,"Indiana","Noble County",5,1,601,316,285
050,18,113,"Indiana","Noble County",5,2,605,336,269
050,18,113,"Indiana","Noble County",5,3,656,325,331
050,18,113,"Indiana","Noble County",5,4,609,320,289
050,18,113,"Indiana","Noble County",5,5,597,310,287
050,18,113,"Indiana","Noble County",5,6,600,303,297
050,18,113,"Indiana","Noble County",5,7,645,339,306
050,18,113,"Indiana","Noble County",5,8,641,333,308
050,18,113,"Indiana","Noble County",5,9,636,336,300
050,18,113,"Indiana","Noble County",5,10,578,291,287
050,18,113,"Indiana","Noble County",5,11,603,303,300
050,18,113,"Indiana","Noble County",5,12,621,314,307
050,18,113,"Indiana","Noble County",5,13,671,334,337
050,18,113,"Indiana","Noble County",5,14,676,354,322
050,18,113,"Indiana","Noble County",5,15,744,383,361
050,18,113,"Indiana","Noble County",5,16,686,367,319
050,18,113,"Indiana","Noble County",5,17,672,337,335
050,18,113,"Indiana","Noble County",5,18,562,302,260
050,18,113,"Indiana","Noble County",5,19,468,240,228
050,18,113,"Indiana","Noble County",5,20,517,265,252
050,18,113,"Indiana","Noble County",5,21,536,278,258
050,18,113,"Indiana","Noble County",5,22,612,320,292
050,18,113,"Indiana","Noble County",5,23,624,324,300
050,18,113,"Indiana","Noble County",5,24,600,317,283
050,18,113,"Indiana","Noble County",5,25,611,330,281
050,18,113,"Indiana","Noble County",5,26,602,287,315
050,18,113,"Indiana","Noble County",5,27,558,290,268
050,18,113,"Indiana","Noble County",5,28,617,305,312
050,18,113,"Indiana","Noble County",5,29,611,301,310
050,18,113,"Indiana","Noble County",5,30,597,293,304
050,18,113,"Indiana","Noble County",5,31,575,298,277
050,18,113,"Indiana","Noble County",5,32,574,295,279
050,18,113,"Indiana","Noble County",5,33,579,280,299
050,18,113,"Indiana","Noble County",5,34,556,280,276
050,18,113,"Indiana","Noble County",5,35,534,264,270
050,18,113,"Indiana","Noble County",5,36,567,290,277
050,18,113,"Indiana","Noble County",5,37,548,274,274
050,18,113,"Indiana","Noble County",5,38,564,285,279
050,18,113,"Indiana","Noble County",5,39,600,317,283
050,18,113,"Indiana","Noble County",5,40,583,295,288
050,18,113,"Indiana","Noble County",5,41,561,282,279
050,18,113,"Indiana","Noble County",5,42,570,277,293
050,18,113,"Indiana","Noble County",5,43,566,279,287
050,18,113,"Indiana","Noble County",5,44,576,304,272
050,18,113,"Indiana","Noble County",5,45,561,283,278
050,18,113,"Indiana","Noble County",5,46,564,288,276
050,18,113,"Indiana","Noble County",5,47,569,293,276
050,18,113,"Indiana","Noble County",5,48,553,291,262
050,18,113,"Indiana","Noble County",5,49,557,285,272
050,18,113,"Indiana","Noble County",5,50,545,273,272
050,18,113,"Indiana","Noble County",5,51,569,272,297
050,18,113,"Indiana","Noble County",5,52,652,320,332
050,18,113,"Indiana","Noble County",5,53,614,316,298
050,18,113,"Indiana","Noble County",5,54,577,301,276
050,18,113,"Indiana","Noble County",5,55,579,315,264
050,18,113,"Indiana","Noble County",5,56,583,287,296
050,18,113,"Indiana","Noble County",5,57,569,293,276
050,18,113,"Indiana","Noble County",5,58,616,321,295
050,18,113,"Indiana","Noble County",5,59,633,328,305
050,18,113,"Indiana","Noble County",5,60,648,335,313
050,18,113,"Indiana","Noble County",5,61,651,332,319
050,18,113,"Indiana","Noble County",5,62,682,350,332
050,18,113,"Indiana","Noble County",5,63,650,320,330
050,18,113,"Indiana","Noble County",5,64,631,321,310
050,18,113,"Indiana","Noble County",5,65,633,335,298
050,18,113,"Indiana","Noble County",5,66,602,325,277
050,18,113,"Indiana","Noble County",5,67,554,280,274
050,18,113,"Indiana","Noble County",5,68,584,287,297
050,18,113,"Indiana","Noble County",5,69,553,270,283
050,18,113,"Indiana","Noble County",5,70,551,278,273
050,18,113,"Indiana","Noble County",5,71,496,264,232
050,18,113,"Indiana","Noble County",5,72,455,229,226
050,18,113,"Indiana","Noble County",5,73,446,210,236
050,18,113,"Indiana","Noble County",5,74,427,196,231
050,18,113,"Indiana","Noble County",5,75,416,195,221
050,18,113,"Indiana","Noble County",5,76,409,193,216
050,18,113,"Indiana","Noble County",5,77,262,131,131
050,18,113,"Indiana","Noble County",5,78,243,122,121
050,18,113,"Indiana","Noble County",5,79,240,108,132
050,18,113,"Indiana","Noble County",5,80,242,103,139
050,18,113,"Indiana","Noble County",5,81,188,84,104
050,18,113,"Indiana","Noble County",5,82,172,68,104
050,18,113,"Indiana","Noble County",5,83,143,56,87
050,18,113,"Indiana","Noble County",5,84,122,47,75
050,18,113,"Indiana","Noble County",5,85,792,271,521
050,18,115,"Indiana","Ohio County",1,0,58,30,28
050,18,115,"Indiana","Ohio County",1,1,59,24,35
050,18,115,"Indiana","Ohio County",1,2,64,28,36
050,18,115,"Indiana","Ohio County",1,3,57,33,24
050,18,115,"Indiana","Ohio County",1,4,58,30,28
050,18,115,"Indiana","Ohio County",1,5,61,30,31
050,18,115,"Indiana","Ohio County",1,6,65,32,33
050,18,115,"Indiana","Ohio County",1,7,63,35,28
050,18,115,"Indiana","Ohio County",1,8,77,44,33
050,18,115,"Indiana","Ohio County",1,9,75,38,37
050,18,115,"Indiana","Ohio County",1,10,59,30,29
050,18,115,"Indiana","Ohio County",1,11,63,33,30
050,18,115,"Indiana","Ohio County",1,12,74,28,46
050,18,115,"Indiana","Ohio County",1,13,67,32,35
050,18,115,"Indiana","Ohio County",1,14,64,32,32
050,18,115,"Indiana","Ohio County",1,15,61,31,30
050,18,115,"Indiana","Ohio County",1,16,73,38,35
050,18,115,"Indiana","Ohio County",1,17,68,36,32
050,18,115,"Indiana","Ohio County",1,18,63,36,27
050,18,115,"Indiana","Ohio County",1,19,43,23,20
050,18,115,"Indiana","Ohio County",1,20,51,28,23
050,18,115,"Indiana","Ohio County",1,21,51,28,23
050,18,115,"Indiana","Ohio County",1,22,55,25,30
050,18,115,"Indiana","Ohio County",1,23,62,24,38
050,18,115,"Indiana","Ohio County",1,24,52,18,34
050,18,115,"Indiana","Ohio County",1,25,45,23,22
050,18,115,"Indiana","Ohio County",1,26,44,20,24
050,18,115,"Indiana","Ohio County",1,27,49,25,24
050,18,115,"Indiana","Ohio County",1,28,59,30,29
050,18,115,"Indiana","Ohio County",1,29,64,37,27
050,18,115,"Indiana","Ohio County",1,30,76,36,40
050,18,115,"Indiana","Ohio County",1,31,67,32,35
050,18,115,"Indiana","Ohio County",1,32,72,34,38
050,18,115,"Indiana","Ohio County",1,33,71,29,42
050,18,115,"Indiana","Ohio County",1,34,66,36,30
050,18,115,"Indiana","Ohio County",1,35,58,36,22
050,18,115,"Indiana","Ohio County",1,36,58,31,27
050,18,115,"Indiana","Ohio County",1,37,62,31,31
050,18,115,"Indiana","Ohio County",1,38,63,35,28
050,18,115,"Indiana","Ohio County",1,39,64,34,30
050,18,115,"Indiana","Ohio County",1,40,72,34,38
050,18,115,"Indiana","Ohio County",1,41,65,35,30
050,18,115,"Indiana","Ohio County",1,42,68,34,34
050,18,115,"Indiana","Ohio County",1,43,60,32,28
050,18,115,"Indiana","Ohio County",1,44,61,28,33
050,18,115,"Indiana","Ohio County",1,45,71,33,38
050,18,115,"Indiana","Ohio County",1,46,69,40,29
050,18,115,"Indiana","Ohio County",1,47,78,41,37
050,18,115,"Indiana","Ohio County",1,48,84,38,46
050,18,115,"Indiana","Ohio County",1,49,71,37,34
050,18,115,"Indiana","Ohio County",1,50,76,33,43
050,18,115,"Indiana","Ohio County",1,51,77,37,40
050,18,115,"Indiana","Ohio County",1,52,75,44,31
050,18,115,"Indiana","Ohio County",1,53,81,46,35
050,18,115,"Indiana","Ohio County",1,54,78,40,38
050,18,115,"Indiana","Ohio County",1,55,97,56,41
050,18,115,"Indiana","Ohio County",1,56,104,56,48
050,18,115,"Indiana","Ohio County",1,57,111,57,54
050,18,115,"Indiana","Ohio County",1,58,115,51,64
050,18,115,"Indiana","Ohio County",1,59,113,50,63
050,18,115,"Indiana","Ohio County",1,60,114,57,57
050,18,115,"Indiana","Ohio County",1,61,106,55,51
050,18,115,"Indiana","Ohio County",1,62,93,44,49
050,18,115,"Indiana","Ohio County",1,63,89,41,48
050,18,115,"Indiana","Ohio County",1,64,95,43,52
050,18,115,"Indiana","Ohio County",1,65,97,54,43
050,18,115,"Indiana","Ohio County",1,66,98,58,40
050,18,115,"Indiana","Ohio County",1,67,94,56,38
050,18,115,"Indiana","Ohio County",1,68,89,41,48
050,18,115,"Indiana","Ohio County",1,69,82,37,45
050,18,115,"Indiana","Ohio County",1,70,68,35,33
050,18,115,"Indiana","Ohio County",1,71,63,30,33
050,18,115,"Indiana","Ohio County",1,72,80,37,43
050,18,115,"Indiana","Ohio County",1,73,72,40,32
050,18,115,"Indiana","Ohio County",1,74,55,23,32
050,18,115,"Indiana","Ohio County",1,75,54,23,31
050,18,115,"Indiana","Ohio County",1,76,62,28,34
050,18,115,"Indiana","Ohio County",1,77,68,37,31
050,18,115,"Indiana","Ohio County",1,78,46,19,27
050,18,115,"Indiana","Ohio County",1,79,39,16,23
050,18,115,"Indiana","Ohio County",1,80,40,19,21
050,18,115,"Indiana","Ohio County",1,81,42,23,19
050,18,115,"Indiana","Ohio County",1,82,36,21,15
050,18,115,"Indiana","Ohio County",1,83,25,14,11
050,18,115,"Indiana","Ohio County",1,84,17,4,13
050,18,115,"Indiana","Ohio County",1,85,124,40,84
050,18,115,"Indiana","Ohio County",2,0,48,24,24
050,18,115,"Indiana","Ohio County",2,1,59,25,34
050,18,115,"Indiana","Ohio County",2,2,62,27,35
050,18,115,"Indiana","Ohio County",2,3,59,32,27
050,18,115,"Indiana","Ohio County",2,4,58,31,27
050,18,115,"Indiana","Ohio County",2,5,63,32,31
050,18,115,"Indiana","Ohio County",2,6,65,32,33
050,18,115,"Indiana","Ohio County",2,7,64,34,30
050,18,115,"Indiana","Ohio County",2,8,75,42,33
050,18,115,"Indiana","Ohio County",2,9,76,40,36
050,18,115,"Indiana","Ohio County",2,10,64,33,31
050,18,115,"Indiana","Ohio County",2,11,62,32,30
050,18,115,"Indiana","Ohio County",2,12,72,29,43
050,18,115,"Indiana","Ohio County",2,13,66,29,37
050,18,115,"Indiana","Ohio County",2,14,64,31,33
050,18,115,"Indiana","Ohio County",2,15,62,31,31
050,18,115,"Indiana","Ohio County",2,16,70,36,34
050,18,115,"Indiana","Ohio County",2,17,69,36,33
050,18,115,"Indiana","Ohio County",2,18,61,34,27
050,18,115,"Indiana","Ohio County",2,19,45,24,21
050,18,115,"Indiana","Ohio County",2,20,51,28,23
050,18,115,"Indiana","Ohio County",2,21,53,29,24
050,18,115,"Indiana","Ohio County",2,22,56,26,30
050,18,115,"Indiana","Ohio County",2,23,59,23,36
050,18,115,"Indiana","Ohio County",2,24,54,20,34
050,18,115,"Indiana","Ohio County",2,25,46,21,25
050,18,115,"Indiana","Ohio County",2,26,44,21,23
050,18,115,"Indiana","Ohio County",2,27,47,23,24
050,18,115,"Indiana","Ohio County",2,28,55,28,27
050,18,115,"Indiana","Ohio County",2,29,64,35,29
050,18,115,"Indiana","Ohio County",2,30,75,37,38
050,18,115,"Indiana","Ohio County",2,31,68,32,36
050,18,115,"Indiana","Ohio County",2,32,71,34,37
050,18,115,"Indiana","Ohio County",2,33,70,30,40
050,18,115,"Indiana","Ohio County",2,34,66,34,32
050,18,115,"Indiana","Ohio County",2,35,61,37,24
050,18,115,"Indiana","Ohio County",2,36,57,32,25
050,18,115,"Indiana","Ohio County",2,37,62,32,30
050,18,115,"Indiana","Ohio County",2,38,63,35,28
050,18,115,"Indiana","Ohio County",2,39,63,34,29
050,18,115,"Indiana","Ohio County",2,40,70,34,36
050,18,115,"Indiana","Ohio County",2,41,67,35,32
050,18,115,"Indiana","Ohio County",2,42,66,33,33
050,18,115,"Indiana","Ohio County",2,43,63,33,30
050,18,115,"Indiana","Ohio County",2,44,61,29,32
050,18,115,"Indiana","Ohio County",2,45,70,33,37
050,18,115,"Indiana","Ohio County",2,46,70,38,32
050,18,115,"Indiana","Ohio County",2,47,76,40,36
050,18,115,"Indiana","Ohio County",2,48,82,38,44
050,18,115,"Indiana","Ohio County",2,49,75,38,37
050,18,115,"Indiana","Ohio County",2,50,75,34,41
050,18,115,"Indiana","Ohio County",2,51,76,36,40
050,18,115,"Indiana","Ohio County",2,52,75,42,33
050,18,115,"Indiana","Ohio County",2,53,79,46,33
050,18,115,"Indiana","Ohio County",2,54,76,40,36
050,18,115,"Indiana","Ohio County",2,55,93,52,41
050,18,115,"Indiana","Ohio County",2,56,101,55,46
050,18,115,"Indiana","Ohio County",2,57,109,57,52
050,18,115,"Indiana","Ohio County",2,58,115,53,62
050,18,115,"Indiana","Ohio County",2,59,113,51,62
050,18,115,"Indiana","Ohio County",2,60,114,55,59
050,18,115,"Indiana","Ohio County",2,61,108,55,53
050,18,115,"Indiana","Ohio County",2,62,96,47,49
050,18,115,"Indiana","Ohio County",2,63,92,43,49
050,18,115,"Indiana","Ohio County",2,64,93,42,51
050,18,115,"Indiana","Ohio County",2,65,98,52,46
050,18,115,"Indiana","Ohio County",2,66,99,57,42
050,18,115,"Indiana","Ohio County",2,67,95,56,39
050,18,115,"Indiana","Ohio County",2,68,90,44,46
050,18,115,"Indiana","Ohio County",2,69,83,38,45
050,18,115,"Indiana","Ohio County",2,70,70,35,35
050,18,115,"Indiana","Ohio County",2,71,65,32,33
050,18,115,"Indiana","Ohio County",2,72,75,36,39
050,18,115,"Indiana","Ohio County",2,73,75,39,36
050,18,115,"Indiana","Ohio County",2,74,55,26,29
050,18,115,"Indiana","Ohio County",2,75,54,23,31
050,18,115,"Indiana","Ohio County",2,76,60,27,33
050,18,115,"Indiana","Ohio County",2,77,67,34,33
050,18,115,"Indiana","Ohio County",2,78,50,22,28
050,18,115,"Indiana","Ohio County",2,79,40,16,24
050,18,115,"Indiana","Ohio County",2,80,40,19,21
050,18,115,"Indiana","Ohio County",2,81,40,22,18
050,18,115,"Indiana","Ohio County",2,82,37,21,16
050,18,115,"Indiana","Ohio County",2,83,28,16,12
050,18,115,"Indiana","Ohio County",2,84,18,6,12
050,18,115,"Indiana","Ohio County",2,85,125,40,85
050,18,115,"Indiana","Ohio County",3,0,59,27,32
050,18,115,"Indiana","Ohio County",3,1,55,30,25
050,18,115,"Indiana","Ohio County",3,2,63,27,36
050,18,115,"Indiana","Ohio County",3,3,69,35,34
050,18,115,"Indiana","Ohio County",3,4,56,29,27
050,18,115,"Indiana","Ohio County",3,5,64,33,31
050,18,115,"Indiana","Ohio County",3,6,64,36,28
050,18,115,"Indiana","Ohio County",3,7,60,31,29
050,18,115,"Indiana","Ohio County",3,8,76,40,36
050,18,115,"Indiana","Ohio County",3,9,74,45,29
050,18,115,"Indiana","Ohio County",3,10,76,40,36
050,18,115,"Indiana","Ohio County",3,11,66,35,31
050,18,115,"Indiana","Ohio County",3,12,69,40,29
050,18,115,"Indiana","Ohio County",3,13,79,31,48
050,18,115,"Indiana","Ohio County",3,14,69,30,39
050,18,115,"Indiana","Ohio County",3,15,63,32,31
050,18,115,"Indiana","Ohio County",3,16,66,32,34
050,18,115,"Indiana","Ohio County",3,17,71,37,34
050,18,115,"Indiana","Ohio County",3,18,60,34,26
050,18,115,"Indiana","Ohio County",3,19,51,27,24
050,18,115,"Indiana","Ohio County",3,20,48,26,22
050,18,115,"Indiana","Ohio County",3,21,56,31,25
050,18,115,"Indiana","Ohio County",3,22,49,30,19
050,18,115,"Indiana","Ohio County",3,23,49,26,23
050,18,115,"Indiana","Ohio County",3,24,54,24,30
050,18,115,"Indiana","Ohio County",3,25,56,27,29
050,18,115,"Indiana","Ohio County",3,26,46,21,25
050,18,115,"Indiana","Ohio County",3,27,49,19,30
050,18,115,"Indiana","Ohio County",3,28,52,25,27
050,18,115,"Indiana","Ohio County",3,29,65,28,37
050,18,115,"Indiana","Ohio County",3,30,64,32,32
050,18,115,"Indiana","Ohio County",3,31,82,42,40
050,18,115,"Indiana","Ohio County",3,32,72,30,42
050,18,115,"Indiana","Ohio County",3,33,82,42,40
050,18,115,"Indiana","Ohio County",3,34,73,33,40
050,18,115,"Indiana","Ohio County",3,35,67,34,33
050,18,115,"Indiana","Ohio County",3,36,64,39,25
050,18,115,"Indiana","Ohio County",3,37,59,32,27
050,18,115,"Indiana","Ohio County",3,38,65,32,33
050,18,115,"Indiana","Ohio County",3,39,62,33,29
050,18,115,"Indiana","Ohio County",3,40,63,33,30
050,18,115,"Indiana","Ohio County",3,41,71,36,35
050,18,115,"Indiana","Ohio County",3,42,68,34,34
050,18,115,"Indiana","Ohio County",3,43,74,36,38
050,18,115,"Indiana","Ohio County",3,44,69,35,34
050,18,115,"Indiana","Ohio County",3,45,61,29,32
050,18,115,"Indiana","Ohio County",3,46,68,33,35
050,18,115,"Indiana","Ohio County",3,47,73,40,33
050,18,115,"Indiana","Ohio County",3,48,74,41,33
050,18,115,"Indiana","Ohio County",3,49,83,41,42
050,18,115,"Indiana","Ohio County",3,50,79,44,35
050,18,115,"Indiana","Ohio County",3,51,73,30,43
050,18,115,"Indiana","Ohio County",3,52,75,35,40
050,18,115,"Indiana","Ohio County",3,53,77,41,36
050,18,115,"Indiana","Ohio County",3,54,76,43,33
050,18,115,"Indiana","Ohio County",3,55,75,40,35
050,18,115,"Indiana","Ohio County",3,56,93,53,40
050,18,115,"Indiana","Ohio County",3,57,103,55,48
050,18,115,"Indiana","Ohio County",3,58,113,57,56
050,18,115,"Indiana","Ohio County",3,59,113,52,61
050,18,115,"Indiana","Ohio County",3,60,111,49,62
050,18,115,"Indiana","Ohio County",3,61,114,51,63
050,18,115,"Indiana","Ohio County",3,62,103,55,48
050,18,115,"Indiana","Ohio County",3,63,95,44,51
050,18,115,"Indiana","Ohio County",3,64,98,44,54
050,18,115,"Indiana","Ohio County",3,65,96,40,56
050,18,115,"Indiana","Ohio County",3,66,97,52,45
050,18,115,"Indiana","Ohio County",3,67,100,58,42
050,18,115,"Indiana","Ohio County",3,68,90,51,39
050,18,115,"Indiana","Ohio County",3,69,81,41,40
050,18,115,"Indiana","Ohio County",3,70,79,35,44
050,18,115,"Indiana","Ohio County",3,71,61,30,31
050,18,115,"Indiana","Ohio County",3,72,64,31,33
050,18,115,"Indiana","Ohio County",3,73,71,34,37
050,18,115,"Indiana","Ohio County",3,74,73,38,35
050,18,115,"Indiana","Ohio County",3,75,49,24,25
050,18,115,"Indiana","Ohio County",3,76,47,18,29
050,18,115,"Indiana","Ohio County",3,77,56,27,29
050,18,115,"Indiana","Ohio County",3,78,62,31,31
050,18,115,"Indiana","Ohio County",3,79,48,21,27
050,18,115,"Indiana","Ohio County",3,80,40,17,23
050,18,115,"Indiana","Ohio County",3,81,37,16,21
050,18,115,"Indiana","Ohio County",3,82,37,22,15
050,18,115,"Indiana","Ohio County",3,83,33,21,12
050,18,115,"Indiana","Ohio County",3,84,27,14,13
050,18,115,"Indiana","Ohio County",3,85,120,39,81
050,18,115,"Indiana","Ohio County",4,0,47,21,26
050,18,115,"Indiana","Ohio County",4,1,55,29,26
050,18,115,"Indiana","Ohio County",4,2,67,34,33
050,18,115,"Indiana","Ohio County",4,3,63,28,35
050,18,115,"Indiana","Ohio County",4,4,62,30,32
050,18,115,"Indiana","Ohio County",4,5,66,39,27
050,18,115,"Indiana","Ohio County",4,6,69,37,32
050,18,115,"Indiana","Ohio County",4,7,76,44,32
050,18,115,"Indiana","Ohio County",4,8,69,34,35
050,18,115,"Indiana","Ohio County",4,9,76,39,37
050,18,115,"Indiana","Ohio County",4,10,69,45,24
050,18,115,"Indiana","Ohio County",4,11,84,46,38
050,18,115,"Indiana","Ohio County",4,12,76,34,42
050,18,115,"Indiana","Ohio County",4,13,73,45,28
050,18,115,"Indiana","Ohio County",4,14,83,34,49
050,18,115,"Indiana","Ohio County",4,15,75,33,42
050,18,115,"Indiana","Ohio County",4,16,66,32,34
050,18,115,"Indiana","Ohio County",4,17,61,29,32
050,18,115,"Indiana","Ohio County",4,18,71,36,35
050,18,115,"Indiana","Ohio County",4,19,49,29,20
050,18,115,"Indiana","Ohio County",4,20,52,27,25
050,18,115,"Indiana","Ohio County",4,21,48,26,22
050,18,115,"Indiana","Ohio County",4,22,59,29,30
050,18,115,"Indiana","Ohio County",4,23,55,32,23
050,18,115,"Indiana","Ohio County",4,24,54,24,30
050,18,115,"Indiana","Ohio County",4,25,54,25,29
050,18,115,"Indiana","Ohio County",4,26,58,28,30
050,18,115,"Indiana","Ohio County",4,27,47,22,25
050,18,115,"Indiana","Ohio County",4,28,52,23,29
050,18,115,"Indiana","Ohio County",4,29,58,31,27
050,18,115,"Indiana","Ohio County",4,30,67,31,36
050,18,115,"Indiana","Ohio County",4,31,66,34,32
050,18,115,"Indiana","Ohio County",4,32,79,39,40
050,18,115,"Indiana","Ohio County",4,33,73,35,38
050,18,115,"Indiana","Ohio County",4,34,81,42,39
050,18,115,"Indiana","Ohio County",4,35,71,32,39
050,18,115,"Indiana","Ohio County",4,36,75,39,36
050,18,115,"Indiana","Ohio County",4,37,66,41,25
050,18,115,"Indiana","Ohio County",4,38,66,36,30
050,18,115,"Indiana","Ohio County",4,39,69,35,34
050,18,115,"Indiana","Ohio County",4,40,67,38,29
050,18,115,"Indiana","Ohio County",4,41,69,38,31
050,18,115,"Indiana","Ohio County",4,42,72,35,37
050,18,115,"Indiana","Ohio County",4,43,67,34,33
050,18,115,"Indiana","Ohio County",4,44,77,37,40
050,18,115,"Indiana","Ohio County",4,45,67,36,31
050,18,115,"Indiana","Ohio County",4,46,61,30,31
050,18,115,"Indiana","Ohio County",4,47,64,32,32
050,18,115,"Indiana","Ohio County",4,48,81,43,38
050,18,115,"Indiana","Ohio County",4,49,78,43,35
050,18,115,"Indiana","Ohio County",4,50,84,41,43
050,18,115,"Indiana","Ohio County",4,51,89,45,44
050,18,115,"Indiana","Ohio County",4,52,77,33,44
050,18,115,"Indiana","Ohio County",4,53,80,39,41
050,18,115,"Indiana","Ohio County",4,54,69,37,32
050,18,115,"Indiana","Ohio County",4,55,77,43,34
050,18,115,"Indiana","Ohio County",4,56,78,40,38
050,18,115,"Indiana","Ohio County",4,57,94,53,41
050,18,115,"Indiana","Ohio County",4,58,98,50,48
050,18,115,"Indiana","Ohio County",4,59,109,56,53
050,18,115,"Indiana","Ohio County",4,60,114,53,61
050,18,115,"Indiana","Ohio County",4,61,111,50,61
050,18,115,"Indiana","Ohio County",4,62,110,51,59
050,18,115,"Indiana","Ohio County",4,63,102,52,50
050,18,115,"Indiana","Ohio County",4,64,85,40,45
050,18,115,"Indiana","Ohio County",4,65,86,38,48
050,18,115,"Indiana","Ohio County",4,66,100,43,57
050,18,115,"Indiana","Ohio County",4,67,95,52,43
050,18,115,"Indiana","Ohio County",4,68,101,57,44
050,18,115,"Indiana","Ohio County",4,69,93,53,40
050,18,115,"Indiana","Ohio County",4,70,78,38,40
050,18,115,"Indiana","Ohio County",4,71,76,33,43
050,18,115,"Indiana","Ohio County",4,72,58,28,30
050,18,115,"Indiana","Ohio County",4,73,65,33,32
050,18,115,"Indiana","Ohio County",4,74,77,38,39
050,18,115,"Indiana","Ohio County",4,75,68,36,32
050,18,115,"Indiana","Ohio County",4,76,45,21,24
050,18,115,"Indiana","Ohio County",4,77,44,17,27
050,18,115,"Indiana","Ohio County",4,78,51,22,29
050,18,115,"Indiana","Ohio County",4,79,66,33,33
050,18,115,"Indiana","Ohio County",4,80,46,22,24
050,18,115,"Indiana","Ohio County",4,81,36,16,20
050,18,115,"Indiana","Ohio County",4,82,34,16,18
050,18,115,"Indiana","Ohio County",4,83,29,20,9
050,18,115,"Indiana","Ohio County",4,84,30,18,12
050,18,115,"Indiana","Ohio County",4,85,132,50,82
050,18,115,"Indiana","Ohio County",5,0,47,21,26
050,18,115,"Indiana","Ohio County",5,1,43,23,20
050,18,115,"Indiana","Ohio County",5,2,58,34,24
050,18,115,"Indiana","Ohio County",5,3,68,40,28
050,18,115,"Indiana","Ohio County",5,4,62,27,35
050,18,115,"Indiana","Ohio County",5,5,58,27,31
050,18,115,"Indiana","Ohio County",5,6,63,37,26
050,18,115,"Indiana","Ohio County",5,7,69,40,29
050,18,115,"Indiana","Ohio County",5,8,70,39,31
050,18,115,"Indiana","Ohio County",5,9,64,28,36
050,18,115,"Indiana","Ohio County",5,10,74,39,35
050,18,115,"Indiana","Ohio County",5,11,67,44,23
050,18,115,"Indiana","Ohio County",5,12,86,49,37
050,18,115,"Indiana","Ohio County",5,13,76,32,44
050,18,115,"Indiana","Ohio County",5,14,72,43,29
050,18,115,"Indiana","Ohio County",5,15,82,34,48
050,18,115,"Indiana","Ohio County",5,16,72,30,42
050,18,115,"Indiana","Ohio County",5,17,64,34,30
050,18,115,"Indiana","Ohio County",5,18,53,30,23
050,18,115,"Indiana","Ohio County",5,19,54,31,23
050,18,115,"Indiana","Ohio County",5,20,46,25,21
050,18,115,"Indiana","Ohio County",5,21,55,27,28
050,18,115,"Indiana","Ohio County",5,22,51,25,26
050,18,115,"Indiana","Ohio County",5,23,59,28,31
050,18,115,"Indiana","Ohio County",5,24,58,32,26
050,18,115,"Indiana","Ohio County",5,25,46,21,25
050,18,115,"Indiana","Ohio County",5,26,48,28,20
050,18,115,"Indiana","Ohio County",5,27,56,25,31
050,18,115,"Indiana","Ohio County",5,28,49,21,28
050,18,115,"Indiana","Ohio County",5,29,53,28,25
050,18,115,"Indiana","Ohio County",5,30,49,25,24
050,18,115,"Indiana","Ohio County",5,31,59,29,30
050,18,115,"Indiana","Ohio County",5,32,58,32,26
050,18,115,"Indiana","Ohio County",5,33,77,37,40
050,18,115,"Indiana","Ohio County",5,34,77,38,39
050,18,115,"Indiana","Ohio County",5,35,72,39,33
050,18,115,"Indiana","Ohio County",5,36,72,31,41
050,18,115,"Indiana","Ohio County",5,37,81,39,42
050,18,115,"Indiana","Ohio County",5,38,66,42,24
050,18,115,"Indiana","Ohio County",5,39,69,37,32
050,18,115,"Indiana","Ohio County",5,40,67,34,33
050,18,115,"Indiana","Ohio County",5,41,68,38,30
050,18,115,"Indiana","Ohio County",5,42,69,38,31
050,18,115,"Indiana","Ohio County",5,43,70,36,34
050,18,115,"Indiana","Ohio County",5,44,66,34,32
050,18,115,"Indiana","Ohio County",5,45,82,38,44
050,18,115,"Indiana","Ohio County",5,46,66,36,30
050,18,115,"Indiana","Ohio County",5,47,57,28,29
050,18,115,"Indiana","Ohio County",5,48,66,32,34
050,18,115,"Indiana","Ohio County",5,49,83,43,40
050,18,115,"Indiana","Ohio County",5,50,80,43,37
050,18,115,"Indiana","Ohio County",5,51,86,41,45
050,18,115,"Indiana","Ohio County",5,52,88,43,45
050,18,115,"Indiana","Ohio County",5,53,78,36,42
050,18,115,"Indiana","Ohio County",5,54,81,39,42
050,18,115,"Indiana","Ohio County",5,55,72,37,35
050,18,115,"Indiana","Ohio County",5,56,73,40,33
050,18,115,"Indiana","Ohio County",5,57,80,43,37
050,18,115,"Indiana","Ohio County",5,58,95,53,42
050,18,115,"Indiana","Ohio County",5,59,95,48,47
050,18,115,"Indiana","Ohio County",5,60,106,57,49
050,18,115,"Indiana","Ohio County",5,61,115,52,63
050,18,115,"Indiana","Ohio County",5,62,115,54,61
050,18,115,"Indiana","Ohio County",5,63,112,53,59
050,18,115,"Indiana","Ohio County",5,64,104,53,51
050,18,115,"Indiana","Ohio County",5,65,84,36,48
050,18,115,"Indiana","Ohio County",5,66,84,37,47
050,18,115,"Indiana","Ohio County",5,67,101,43,58
050,18,115,"Indiana","Ohio County",5,68,95,51,44
050,18,115,"Indiana","Ohio County",5,69,100,57,43
050,18,115,"Indiana","Ohio County",5,70,86,50,36
050,18,115,"Indiana","Ohio County",5,71,75,38,37
050,18,115,"Indiana","Ohio County",5,72,69,30,39
050,18,115,"Indiana","Ohio County",5,73,55,27,28
050,18,115,"Indiana","Ohio County",5,74,69,35,34
050,18,115,"Indiana","Ohio County",5,75,71,34,37
050,18,115,"Indiana","Ohio County",5,76,63,33,30
050,18,115,"Indiana","Ohio County",5,77,42,22,20
050,18,115,"Indiana","Ohio County",5,78,39,13,26
050,18,115,"Indiana","Ohio County",5,79,52,23,29
050,18,115,"Indiana","Ohio County",5,80,66,34,32
050,18,115,"Indiana","Ohio County",5,81,42,17,25
050,18,115,"Indiana","Ohio County",5,82,34,17,17
050,18,115,"Indiana","Ohio County",5,83,28,14,14
050,18,115,"Indiana","Ohio County",5,84,31,17,14
050,18,115,"Indiana","Ohio County",5,85,141,60,81
050,18,117,"Indiana","Orange County",1,0,263,136,127
050,18,117,"Indiana","Orange County",1,1,251,132,119
050,18,117,"Indiana","Orange County",1,2,245,138,107
050,18,117,"Indiana","Orange County",1,3,264,152,112
050,18,117,"Indiana","Orange County",1,4,241,123,118
050,18,117,"Indiana","Orange County",1,5,235,129,106
050,18,117,"Indiana","Orange County",1,6,245,127,118
050,18,117,"Indiana","Orange County",1,7,239,127,112
050,18,117,"Indiana","Orange County",1,8,235,128,107
050,18,117,"Indiana","Orange County",1,9,247,123,124
050,18,117,"Indiana","Orange County",1,10,244,127,117
050,18,117,"Indiana","Orange County",1,11,262,145,117
050,18,117,"Indiana","Orange County",1,12,268,143,125
050,18,117,"Indiana","Orange County",1,13,281,144,137
050,18,117,"Indiana","Orange County",1,14,277,154,123
050,18,117,"Indiana","Orange County",1,15,258,135,123
050,18,117,"Indiana","Orange County",1,16,262,133,129
050,18,117,"Indiana","Orange County",1,17,260,132,128
050,18,117,"Indiana","Orange County",1,18,252,130,122
050,18,117,"Indiana","Orange County",1,19,203,112,91
050,18,117,"Indiana","Orange County",1,20,219,122,97
050,18,117,"Indiana","Orange County",1,21,201,97,104
050,18,117,"Indiana","Orange County",1,22,207,102,105
050,18,117,"Indiana","Orange County",1,23,230,118,112
050,18,117,"Indiana","Orange County",1,24,230,121,109
050,18,117,"Indiana","Orange County",1,25,229,119,110
050,18,117,"Indiana","Orange County",1,26,210,109,101
050,18,117,"Indiana","Orange County",1,27,209,111,98
050,18,117,"Indiana","Orange County",1,28,242,116,126
050,18,117,"Indiana","Orange County",1,29,232,112,120
050,18,117,"Indiana","Orange County",1,30,213,109,104
050,18,117,"Indiana","Orange County",1,31,203,103,100
050,18,117,"Indiana","Orange County",1,32,216,120,96
050,18,117,"Indiana","Orange County",1,33,209,105,104
050,18,117,"Indiana","Orange County",1,34,226,111,115
050,18,117,"Indiana","Orange County",1,35,222,105,117
050,18,117,"Indiana","Orange County",1,36,214,114,100
050,18,117,"Indiana","Orange County",1,37,221,112,109
050,18,117,"Indiana","Orange County",1,38,219,110,109
050,18,117,"Indiana","Orange County",1,39,227,119,108
050,18,117,"Indiana","Orange County",1,40,215,114,101
050,18,117,"Indiana","Orange County",1,41,227,111,116
050,18,117,"Indiana","Orange County",1,42,224,106,118
050,18,117,"Indiana","Orange County",1,43,246,116,130
050,18,117,"Indiana","Orange County",1,44,238,117,121
050,18,117,"Indiana","Orange County",1,45,215,121,94
050,18,117,"Indiana","Orange County",1,46,214,108,106
050,18,117,"Indiana","Orange County",1,47,232,120,112
050,18,117,"Indiana","Orange County",1,48,270,135,135
050,18,117,"Indiana","Orange County",1,49,253,128,125
050,18,117,"Indiana","Orange County",1,50,223,119,104
050,18,117,"Indiana","Orange County",1,51,206,109,97
050,18,117,"Indiana","Orange County",1,52,239,127,112
050,18,117,"Indiana","Orange County",1,53,262,134,128
050,18,117,"Indiana","Orange County",1,54,279,135,144
050,18,117,"Indiana","Orange County",1,55,271,139,132
050,18,117,"Indiana","Orange County",1,56,292,148,144
050,18,117,"Indiana","Orange County",1,57,298,155,143
050,18,117,"Indiana","Orange County",1,58,298,147,151
050,18,117,"Indiana","Orange County",1,59,290,139,151
050,18,117,"Indiana","Orange County",1,60,309,149,160
050,18,117,"Indiana","Orange County",1,61,324,165,159
050,18,117,"Indiana","Orange County",1,62,328,158,170
050,18,117,"Indiana","Orange County",1,63,297,146,151
050,18,117,"Indiana","Orange County",1,64,283,138,145
050,18,117,"Indiana","Orange County",1,65,276,143,133
050,18,117,"Indiana","Orange County",1,66,245,125,120
050,18,117,"Indiana","Orange County",1,67,237,119,118
050,18,117,"Indiana","Orange County",1,68,232,114,118
050,18,117,"Indiana","Orange County",1,69,232,105,127
050,18,117,"Indiana","Orange County",1,70,238,107,131
050,18,117,"Indiana","Orange County",1,71,238,116,122
050,18,117,"Indiana","Orange County",1,72,261,120,141
050,18,117,"Indiana","Orange County",1,73,245,112,133
050,18,117,"Indiana","Orange County",1,74,162,73,89
050,18,117,"Indiana","Orange County",1,75,162,73,89
050,18,117,"Indiana","Orange County",1,76,153,78,75
050,18,117,"Indiana","Orange County",1,77,142,70,72
050,18,117,"Indiana","Orange County",1,78,123,48,75
050,18,117,"Indiana","Orange County",1,79,127,51,76
050,18,117,"Indiana","Orange County",1,80,109,52,57
050,18,117,"Indiana","Orange County",1,81,110,47,63
050,18,117,"Indiana","Orange County",1,82,102,43,59
050,18,117,"Indiana","Orange County",1,83,76,37,39
050,18,117,"Indiana","Orange County",1,84,64,32,32
050,18,117,"Indiana","Orange County",1,85,392,147,245
050,18,117,"Indiana","Orange County",2,0,254,131,123
050,18,117,"Indiana","Orange County",2,1,251,131,120
050,18,117,"Indiana","Orange County",2,2,250,139,111
050,18,117,"Indiana","Orange County",2,3,259,148,111
050,18,117,"Indiana","Orange County",2,4,247,130,117
050,18,117,"Indiana","Orange County",2,5,235,126,109
050,18,117,"Indiana","Orange County",2,6,242,129,113
050,18,117,"Indiana","Orange County",2,7,241,128,113
050,18,117,"Indiana","Orange County",2,8,240,130,110
050,18,117,"Indiana","Orange County",2,9,245,125,120
050,18,117,"Indiana","Orange County",2,10,245,127,118
050,18,117,"Indiana","Orange County",2,11,260,141,119
050,18,117,"Indiana","Orange County",2,12,268,144,124
050,18,117,"Indiana","Orange County",2,13,279,146,133
050,18,117,"Indiana","Orange County",2,14,275,151,124
050,18,117,"Indiana","Orange County",2,15,261,140,121
050,18,117,"Indiana","Orange County",2,16,260,133,127
050,18,117,"Indiana","Orange County",2,17,262,133,129
050,18,117,"Indiana","Orange County",2,18,241,125,116
050,18,117,"Indiana","Orange County",2,19,202,109,93
050,18,117,"Indiana","Orange County",2,20,219,121,98
050,18,117,"Indiana","Orange County",2,21,208,105,103
050,18,117,"Indiana","Orange County",2,22,208,101,107
050,18,117,"Indiana","Orange County",2,23,224,114,110
050,18,117,"Indiana","Orange County",2,24,229,121,108
050,18,117,"Indiana","Orange County",2,25,231,120,111
050,18,117,"Indiana","Orange County",2,26,216,112,104
050,18,117,"Indiana","Orange County",2,27,210,110,100
050,18,117,"Indiana","Orange County",2,28,235,114,121
050,18,117,"Indiana","Orange County",2,29,236,115,121
050,18,117,"Indiana","Orange County",2,30,218,110,108
050,18,117,"Indiana","Orange County",2,31,204,103,101
050,18,117,"Indiana","Orange County",2,32,214,116,98
050,18,117,"Indiana","Orange County",2,33,212,111,101
050,18,117,"Indiana","Orange County",2,34,223,111,112
050,18,117,"Indiana","Orange County",2,35,224,108,116
050,18,117,"Indiana","Orange County",2,36,215,112,103
050,18,117,"Indiana","Orange County",2,37,217,111,106
050,18,117,"Indiana","Orange County",2,38,220,110,110
050,18,117,"Indiana","Orange County",2,39,225,117,108
050,18,117,"Indiana","Orange County",2,40,220,116,104
050,18,117,"Indiana","Orange County",2,41,225,112,113
050,18,117,"Indiana","Orange County",2,42,222,106,116
050,18,117,"Indiana","Orange County",2,43,245,116,129
050,18,117,"Indiana","Orange County",2,44,238,116,122
050,18,117,"Indiana","Orange County",2,45,221,120,101
050,18,117,"Indiana","Orange County",2,46,212,110,102
050,18,117,"Indiana","Orange County",2,47,228,117,111
050,18,117,"Indiana","Orange County",2,48,261,131,130
050,18,117,"Indiana","Orange County",2,49,255,129,126
050,18,117,"Indiana","Orange County",2,50,230,121,109
050,18,117,"Indiana","Orange County",2,51,210,111,99
050,18,117,"Indiana","Orange County",2,52,231,122,109
050,18,117,"Indiana","Orange County",2,53,254,131,123
050,18,117,"Indiana","Orange County",2,54,273,133,140
050,18,117,"Indiana","Orange County",2,55,273,139,134
050,18,117,"Indiana","Orange County",2,56,289,147,142
050,18,117,"Indiana","Orange County",2,57,296,153,143
050,18,117,"Indiana","Orange County",2,58,298,148,150
050,18,117,"Indiana","Orange County",2,59,292,141,151
050,18,117,"Indiana","Orange County",2,60,305,147,158
050,18,117,"Indiana","Orange County",2,61,321,162,159
050,18,117,"Indiana","Orange County",2,62,325,159,166
050,18,117,"Indiana","Orange County",2,63,306,151,155
050,18,117,"Indiana","Orange County",2,64,283,139,144
050,18,117,"Indiana","Orange County",2,65,279,142,137
050,18,117,"Indiana","Orange County",2,66,249,125,124
050,18,117,"Indiana","Orange County",2,67,237,119,118
050,18,117,"Indiana","Orange County",2,68,230,115,115
050,18,117,"Indiana","Orange County",2,69,233,107,126
050,18,117,"Indiana","Orange County",2,70,236,107,129
050,18,117,"Indiana","Orange County",2,71,236,113,123
050,18,117,"Indiana","Orange County",2,72,248,114,134
050,18,117,"Indiana","Orange County",2,73,261,121,140
050,18,117,"Indiana","Orange County",2,74,170,78,92
050,18,117,"Indiana","Orange County",2,75,159,73,86
050,18,117,"Indiana","Orange County",2,76,153,77,76
050,18,117,"Indiana","Orange County",2,77,143,69,74
050,18,117,"Indiana","Orange County",2,78,118,48,70
050,18,117,"Indiana","Orange County",2,79,127,50,77
050,18,117,"Indiana","Orange County",2,80,112,51,61
050,18,117,"Indiana","Orange County",2,81,105,47,58
050,18,117,"Indiana","Orange County",2,82,102,44,58
050,18,117,"Indiana","Orange County",2,83,79,38,41
050,18,117,"Indiana","Orange County",2,84,67,32,35
050,18,117,"Indiana","Orange County",2,85,388,147,241
050,18,117,"Indiana","Orange County",3,0,212,107,105
050,18,117,"Indiana","Orange County",3,1,254,133,121
050,18,117,"Indiana","Orange County",3,2,251,131,120
050,18,117,"Indiana","Orange County",3,3,246,138,108
050,18,117,"Indiana","Orange County",3,4,256,145,111
050,18,117,"Indiana","Orange County",3,5,245,128,117
050,18,117,"Indiana","Orange County",3,6,235,127,108
050,18,117,"Indiana","Orange County",3,7,240,130,110
050,18,117,"Indiana","Orange County",3,8,249,128,121
050,18,117,"Indiana","Orange County",3,9,232,128,104
050,18,117,"Indiana","Orange County",3,10,246,126,120
050,18,117,"Indiana","Orange County",3,11,252,130,122
050,18,117,"Indiana","Orange County",3,12,251,136,115
050,18,117,"Indiana","Orange County",3,13,275,154,121
050,18,117,"Indiana","Orange County",3,14,279,145,134
050,18,117,"Indiana","Orange County",3,15,274,152,122
050,18,117,"Indiana","Orange County",3,16,267,145,122
050,18,117,"Indiana","Orange County",3,17,256,129,127
050,18,117,"Indiana","Orange County",3,18,226,120,106
050,18,117,"Indiana","Orange County",3,19,180,92,88
050,18,117,"Indiana","Orange County",3,20,229,120,109
050,18,117,"Indiana","Orange County",3,21,221,125,96
050,18,117,"Indiana","Orange County",3,22,208,106,102
050,18,117,"Indiana","Orange County",3,23,210,100,110
050,18,117,"Indiana","Orange County",3,24,219,107,112
050,18,117,"Indiana","Orange County",3,25,237,117,120
050,18,117,"Indiana","Orange County",3,26,218,108,110
050,18,117,"Indiana","Orange County",3,27,229,122,107
050,18,117,"Indiana","Orange County",3,28,205,103,102
050,18,117,"Indiana","Orange County",3,29,236,117,119
050,18,117,"Indiana","Orange County",3,30,244,123,121
050,18,117,"Indiana","Orange County",3,31,217,106,111
050,18,117,"Indiana","Orange County",3,32,217,109,108
050,18,117,"Indiana","Orange County",3,33,220,118,102
050,18,117,"Indiana","Orange County",3,34,223,122,101
050,18,117,"Indiana","Orange County",3,35,215,103,112
050,18,117,"Indiana","Orange County",3,36,230,114,116
050,18,117,"Indiana","Orange County",3,37,213,110,103
050,18,117,"Indiana","Orange County",3,38,217,108,109
050,18,117,"Indiana","Orange County",3,39,216,111,105
050,18,117,"Indiana","Orange County",3,40,225,117,108
050,18,117,"Indiana","Orange County",3,41,229,125,104
050,18,117,"Indiana","Orange County",3,42,231,116,115
050,18,117,"Indiana","Orange County",3,43,225,110,115
050,18,117,"Indiana","Orange County",3,44,229,107,122
050,18,117,"Indiana","Orange County",3,45,242,120,122
050,18,117,"Indiana","Orange County",3,46,223,121,102
050,18,117,"Indiana","Orange County",3,47,220,114,106
050,18,117,"Indiana","Orange County",3,48,228,114,114
050,18,117,"Indiana","Orange County",3,49,263,136,127
050,18,117,"Indiana","Orange County",3,50,259,127,132
050,18,117,"Indiana","Orange County",3,51,233,118,115
050,18,117,"Indiana","Orange County",3,52,210,109,101
050,18,117,"Indiana","Orange County",3,53,234,127,107
050,18,117,"Indiana","Orange County",3,54,261,131,130
050,18,117,"Indiana","Orange County",3,55,270,134,136
050,18,117,"Indiana","Orange County",3,56,273,139,134
050,18,117,"Indiana","Orange County",3,57,278,148,130
050,18,117,"Indiana","Orange County",3,58,289,150,139
050,18,117,"Indiana","Orange County",3,59,298,146,152
050,18,117,"Indiana","Orange County",3,60,287,136,151
050,18,117,"Indiana","Orange County",3,61,295,142,153
050,18,117,"Indiana","Orange County",3,62,320,160,160
050,18,117,"Indiana","Orange County",3,63,321,152,169
050,18,117,"Indiana","Orange County",3,64,308,152,156
050,18,117,"Indiana","Orange County",3,65,276,136,140
050,18,117,"Indiana","Orange County",3,66,273,140,133
050,18,117,"Indiana","Orange County",3,67,249,125,124
050,18,117,"Indiana","Orange County",3,68,231,118,113
050,18,117,"Indiana","Orange County",3,69,221,109,112
050,18,117,"Indiana","Orange County",3,70,222,103,119
050,18,117,"Indiana","Orange County",3,71,237,107,130
050,18,117,"Indiana","Orange County",3,72,231,115,116
050,18,117,"Indiana","Orange County",3,73,239,111,128
050,18,117,"Indiana","Orange County",3,74,259,117,142
050,18,117,"Indiana","Orange County",3,75,165,77,88
050,18,117,"Indiana","Orange County",3,76,154,73,81
050,18,117,"Indiana","Orange County",3,77,134,64,70
050,18,117,"Indiana","Orange County",3,78,134,64,70
050,18,117,"Indiana","Orange County",3,79,115,45,70
050,18,117,"Indiana","Orange County",3,80,122,47,75
050,18,117,"Indiana","Orange County",3,81,101,48,53
050,18,117,"Indiana","Orange County",3,82,105,46,59
050,18,117,"Indiana","Orange County",3,83,93,42,51
050,18,117,"Indiana","Orange County",3,84,70,31,39
050,18,117,"Indiana","Orange County",3,85,374,141,233
050,18,117,"Indiana","Orange County",4,0,221,113,108
050,18,117,"Indiana","Orange County",4,1,213,116,97
050,18,117,"Indiana","Orange County",4,2,241,127,114
050,18,117,"Indiana","Orange County",4,3,242,124,118
050,18,117,"Indiana","Orange County",4,4,245,138,107
050,18,117,"Indiana","Orange County",4,5,241,139,102
050,18,117,"Indiana","Orange County",4,6,248,130,118
050,18,117,"Indiana","Orange County",4,7,231,124,107
050,18,117,"Indiana","Orange County",4,8,232,123,109
050,18,117,"Indiana","Orange County",4,9,256,139,117
050,18,117,"Indiana","Orange County",4,10,218,121,97
050,18,117,"Indiana","Orange County",4,11,242,123,119
050,18,117,"Indiana","Orange County",4,12,253,130,123
050,18,117,"Indiana","Orange County",4,13,249,132,117
050,18,117,"Indiana","Orange County",4,14,282,157,125
050,18,117,"Indiana","Orange County",4,15,294,151,143
050,18,117,"Indiana","Orange County",4,16,276,148,128
050,18,117,"Indiana","Orange County",4,17,266,147,119
050,18,117,"Indiana","Orange County",4,18,215,113,102
050,18,117,"Indiana","Orange County",4,19,171,90,81
050,18,117,"Indiana","Orange County",4,20,189,96,93
050,18,117,"Indiana","Orange County",4,21,234,126,108
050,18,117,"Indiana","Orange County",4,22,216,119,97
050,18,117,"Indiana","Orange County",4,23,218,108,110
050,18,117,"Indiana","Orange County",4,24,194,99,95
050,18,117,"Indiana","Orange County",4,25,223,115,108
050,18,117,"Indiana","Orange County",4,26,225,109,116
050,18,117,"Indiana","Orange County",4,27,227,115,112
050,18,117,"Indiana","Orange County",4,28,216,110,106
050,18,117,"Indiana","Orange County",4,29,208,110,98
050,18,117,"Indiana","Orange County",4,30,221,110,111
050,18,117,"Indiana","Orange County",4,31,242,122,120
050,18,117,"Indiana","Orange County",4,32,216,106,110
050,18,117,"Indiana","Orange County",4,33,211,96,115
050,18,117,"Indiana","Orange County",4,34,223,118,105
050,18,117,"Indiana","Orange County",4,35,206,115,91
050,18,117,"Indiana","Orange County",4,36,221,115,106
050,18,117,"Indiana","Orange County",4,37,232,115,117
050,18,117,"Indiana","Orange County",4,38,221,115,106
050,18,117,"Indiana","Orange County",4,39,206,106,100
050,18,117,"Indiana","Orange County",4,40,216,111,105
050,18,117,"Indiana","Orange County",4,41,225,116,109
050,18,117,"Indiana","Orange County",4,42,230,121,109
050,18,117,"Indiana","Orange County",4,43,233,117,116
050,18,117,"Indiana","Orange County",4,44,222,105,117
050,18,117,"Indiana","Orange County",4,45,229,106,123
050,18,117,"Indiana","Orange County",4,46,245,122,123
050,18,117,"Indiana","Orange County",4,47,224,123,101
050,18,117,"Indiana","Orange County",4,48,218,109,109
050,18,117,"Indiana","Orange County",4,49,223,112,111
050,18,117,"Indiana","Orange County",4,50,269,139,130
050,18,117,"Indiana","Orange County",4,51,254,126,128
050,18,117,"Indiana","Orange County",4,52,244,124,120
050,18,117,"Indiana","Orange County",4,53,216,110,106
050,18,117,"Indiana","Orange County",4,54,228,121,107
050,18,117,"Indiana","Orange County",4,55,270,137,133
050,18,117,"Indiana","Orange County",4,56,272,130,142
050,18,117,"Indiana","Orange County",4,57,271,140,131
050,18,117,"Indiana","Orange County",4,58,286,151,135
050,18,117,"Indiana","Orange County",4,59,282,145,137
050,18,117,"Indiana","Orange County",4,60,289,145,144
050,18,117,"Indiana","Orange County",4,61,272,132,140
050,18,117,"Indiana","Orange County",4,62,291,141,150
050,18,117,"Indiana","Orange County",4,63,323,161,162
050,18,117,"Indiana","Orange County",4,64,314,149,165
050,18,117,"Indiana","Orange County",4,65,303,150,153
050,18,117,"Indiana","Orange County",4,66,272,134,138
050,18,117,"Indiana","Orange County",4,67,275,137,138
050,18,117,"Indiana","Orange County",4,68,250,130,120
050,18,117,"Indiana","Orange County",4,69,224,118,106
050,18,117,"Indiana","Orange County",4,70,213,107,106
050,18,117,"Indiana","Orange County",4,71,215,98,117
050,18,117,"Indiana","Orange County",4,72,236,108,128
050,18,117,"Indiana","Orange County",4,73,223,110,113
050,18,117,"Indiana","Orange County",4,74,226,100,126
050,18,117,"Indiana","Orange County",4,75,253,111,142
050,18,117,"Indiana","Orange County",4,76,161,78,83
050,18,117,"Indiana","Orange County",4,77,133,56,77
050,18,117,"Indiana","Orange County",4,78,127,60,67
050,18,117,"Indiana","Orange County",4,79,129,59,70
050,18,117,"Indiana","Orange County",4,80,97,33,64
050,18,117,"Indiana","Orange County",4,81,108,40,68
050,18,117,"Indiana","Orange County",4,82,91,44,47
050,18,117,"Indiana","Orange County",4,83,93,42,51
050,18,117,"Indiana","Orange County",4,84,89,36,53
050,18,117,"Indiana","Orange County",4,85,352,129,223
050,18,117,"Indiana","Orange County",5,0,212,109,103
050,18,117,"Indiana","Orange County",5,1,227,111,116
050,18,117,"Indiana","Orange County",5,2,220,123,97
050,18,117,"Indiana","Orange County",5,3,247,125,122
050,18,117,"Indiana","Orange County",5,4,252,135,117
050,18,117,"Indiana","Orange County",5,5,252,138,114
050,18,117,"Indiana","Orange County",5,6,256,150,106
050,18,117,"Indiana","Orange County",5,7,249,135,114
050,18,117,"Indiana","Orange County",5,8,246,136,110
050,18,117,"Indiana","Orange County",5,9,244,137,107
050,18,117,"Indiana","Orange County",5,10,264,134,130
050,18,117,"Indiana","Orange County",5,11,227,120,107
050,18,117,"Indiana","Orange County",5,12,239,122,117
050,18,117,"Indiana","Orange County",5,13,254,131,123
050,18,117,"Indiana","Orange County",5,14,260,135,125
050,18,117,"Indiana","Orange County",5,15,284,160,124
050,18,117,"Indiana","Orange County",5,16,297,158,139
050,18,117,"Indiana","Orange County",5,17,280,150,130
050,18,117,"Indiana","Orange County",5,18,235,132,103
050,18,117,"Indiana","Orange County",5,19,166,89,77
050,18,117,"Indiana","Orange County",5,20,179,88,91
050,18,117,"Indiana","Orange County",5,21,205,109,96
050,18,117,"Indiana","Orange County",5,22,233,127,106
050,18,117,"Indiana","Orange County",5,23,228,121,107
050,18,117,"Indiana","Orange County",5,24,223,105,118
050,18,117,"Indiana","Orange County",5,25,202,104,98
050,18,117,"Indiana","Orange County",5,26,203,101,102
050,18,117,"Indiana","Orange County",5,27,219,102,117
050,18,117,"Indiana","Orange County",5,28,218,105,113
050,18,117,"Indiana","Orange County",5,29,211,113,98
050,18,117,"Indiana","Orange County",5,30,204,107,97
050,18,117,"Indiana","Orange County",5,31,226,113,113
050,18,117,"Indiana","Orange County",5,32,238,121,117
050,18,117,"Indiana","Orange County",5,33,215,103,112
050,18,117,"Indiana","Orange County",5,34,214,100,114
050,18,117,"Indiana","Orange County",5,35,228,120,108
050,18,117,"Indiana","Orange County",5,36,221,124,97
050,18,117,"Indiana","Orange County",5,37,219,109,110
050,18,117,"Indiana","Orange County",5,38,238,114,124
050,18,117,"Indiana","Orange County",5,39,219,116,103
050,18,117,"Indiana","Orange County",5,40,206,106,100
050,18,117,"Indiana","Orange County",5,41,219,114,105
050,18,117,"Indiana","Orange County",5,42,227,119,108
050,18,117,"Indiana","Orange County",5,43,233,123,110
050,18,117,"Indiana","Orange County",5,44,223,111,112
050,18,117,"Indiana","Orange County",5,45,228,110,118
050,18,117,"Indiana","Orange County",5,46,227,107,120
050,18,117,"Indiana","Orange County",5,47,247,122,125
050,18,117,"Indiana","Orange County",5,48,224,118,106
050,18,117,"Indiana","Orange County",5,49,214,104,110
050,18,117,"Indiana","Orange County",5,50,236,121,115
050,18,117,"Indiana","Orange County",5,51,265,138,127
050,18,117,"Indiana","Orange County",5,52,260,124,136
050,18,117,"Indiana","Orange County",5,53,235,118,117
050,18,117,"Indiana","Orange County",5,54,211,108,103
050,18,117,"Indiana","Orange County",5,55,225,123,102
050,18,117,"Indiana","Orange County",5,56,272,137,135
050,18,117,"Indiana","Orange County",5,57,275,132,143
050,18,117,"Indiana","Orange County",5,58,277,144,133
050,18,117,"Indiana","Orange County",5,59,279,148,131
050,18,117,"Indiana","Orange County",5,60,282,145,137
050,18,117,"Indiana","Orange County",5,61,277,140,137
050,18,117,"Indiana","Orange County",5,62,271,133,138
050,18,117,"Indiana","Orange County",5,63,285,139,146
050,18,117,"Indiana","Orange County",5,64,321,158,163
050,18,117,"Indiana","Orange County",5,65,305,144,161
050,18,117,"Indiana","Orange County",5,66,296,148,148
050,18,117,"Indiana","Orange County",5,67,272,132,140
050,18,117,"Indiana","Orange County",5,68,270,135,135
050,18,117,"Indiana","Orange County",5,69,237,124,113
050,18,117,"Indiana","Orange County",5,70,221,116,105
050,18,117,"Indiana","Orange County",5,71,207,100,107
050,18,117,"Indiana","Orange County",5,72,217,95,122
050,18,117,"Indiana","Orange County",5,73,231,106,125
050,18,117,"Indiana","Orange County",5,74,214,103,111
050,18,117,"Indiana","Orange County",5,75,222,97,125
050,18,117,"Indiana","Orange County",5,76,243,109,134
050,18,117,"Indiana","Orange County",5,77,140,63,77
050,18,117,"Indiana","Orange County",5,78,125,52,73
050,18,117,"Indiana","Orange County",5,79,125,56,69
050,18,117,"Indiana","Orange County",5,80,113,51,62
050,18,117,"Indiana","Orange County",5,81,87,29,58
050,18,117,"Indiana","Orange County",5,82,100,39,61
050,18,117,"Indiana","Orange County",5,83,78,40,38
050,18,117,"Indiana","Orange County",5,84,90,37,53
050,18,117,"Indiana","Orange County",5,85,372,136,236
050,18,119,"Indiana","Owen County",1,0,236,123,113
050,18,119,"Indiana","Owen County",1,1,231,120,111
050,18,119,"Indiana","Owen County",1,2,241,132,109
050,18,119,"Indiana","Owen County",1,3,208,108,100
050,18,119,"Indiana","Owen County",1,4,232,121,111
050,18,119,"Indiana","Owen County",1,5,223,108,115
050,18,119,"Indiana","Owen County",1,6,227,115,112
050,18,119,"Indiana","Owen County",1,7,238,119,119
050,18,119,"Indiana","Owen County",1,8,245,130,115
050,18,119,"Indiana","Owen County",1,9,240,127,113
050,18,119,"Indiana","Owen County",1,10,238,123,115
050,18,119,"Indiana","Owen County",1,11,247,125,122
050,18,119,"Indiana","Owen County",1,12,263,135,128
050,18,119,"Indiana","Owen County",1,13,264,136,128
050,18,119,"Indiana","Owen County",1,14,280,141,139
050,18,119,"Indiana","Owen County",1,15,283,145,138
050,18,119,"Indiana","Owen County",1,16,288,146,142
050,18,119,"Indiana","Owen County",1,17,278,133,145
050,18,119,"Indiana","Owen County",1,18,253,129,124
050,18,119,"Indiana","Owen County",1,19,199,103,96
050,18,119,"Indiana","Owen County",1,20,201,114,87
050,18,119,"Indiana","Owen County",1,21,218,125,93
050,18,119,"Indiana","Owen County",1,22,210,110,100
050,18,119,"Indiana","Owen County",1,23,224,112,112
050,18,119,"Indiana","Owen County",1,24,218,110,108
050,18,119,"Indiana","Owen County",1,25,239,130,109
050,18,119,"Indiana","Owen County",1,26,235,121,114
050,18,119,"Indiana","Owen County",1,27,212,115,97
050,18,119,"Indiana","Owen County",1,28,226,99,127
050,18,119,"Indiana","Owen County",1,29,240,113,127
050,18,119,"Indiana","Owen County",1,30,235,110,125
050,18,119,"Indiana","Owen County",1,31,222,117,105
050,18,119,"Indiana","Owen County",1,32,238,124,114
050,18,119,"Indiana","Owen County",1,33,254,134,120
050,18,119,"Indiana","Owen County",1,34,231,114,117
050,18,119,"Indiana","Owen County",1,35,247,117,130
050,18,119,"Indiana","Owen County",1,36,219,115,104
050,18,119,"Indiana","Owen County",1,37,243,134,109
050,18,119,"Indiana","Owen County",1,38,231,127,104
050,18,119,"Indiana","Owen County",1,39,232,122,110
050,18,119,"Indiana","Owen County",1,40,235,115,120
050,18,119,"Indiana","Owen County",1,41,241,124,117
050,18,119,"Indiana","Owen County",1,42,259,137,122
050,18,119,"Indiana","Owen County",1,43,248,124,124
050,18,119,"Indiana","Owen County",1,44,225,108,117
050,18,119,"Indiana","Owen County",1,45,248,118,130
050,18,119,"Indiana","Owen County",1,46,248,125,123
050,18,119,"Indiana","Owen County",1,47,261,135,126
050,18,119,"Indiana","Owen County",1,48,291,156,135
050,18,119,"Indiana","Owen County",1,49,274,142,132
050,18,119,"Indiana","Owen County",1,50,288,151,137
050,18,119,"Indiana","Owen County",1,51,300,144,156
050,18,119,"Indiana","Owen County",1,52,289,145,144
050,18,119,"Indiana","Owen County",1,53,306,161,145
050,18,119,"Indiana","Owen County",1,54,333,165,168
050,18,119,"Indiana","Owen County",1,55,359,175,184
050,18,119,"Indiana","Owen County",1,56,367,192,175
050,18,119,"Indiana","Owen County",1,57,364,192,172
050,18,119,"Indiana","Owen County",1,58,372,183,189
050,18,119,"Indiana","Owen County",1,59,363,188,175
050,18,119,"Indiana","Owen County",1,60,358,175,183
050,18,119,"Indiana","Owen County",1,61,379,190,189
050,18,119,"Indiana","Owen County",1,62,358,189,169
050,18,119,"Indiana","Owen County",1,63,315,161,154
050,18,119,"Indiana","Owen County",1,64,332,175,157
050,18,119,"Indiana","Owen County",1,65,319,157,162
050,18,119,"Indiana","Owen County",1,66,306,156,150
050,18,119,"Indiana","Owen County",1,67,298,149,149
050,18,119,"Indiana","Owen County",1,68,307,149,158
050,18,119,"Indiana","Owen County",1,69,283,126,157
050,18,119,"Indiana","Owen County",1,70,259,128,131
050,18,119,"Indiana","Owen County",1,71,247,132,115
050,18,119,"Indiana","Owen County",1,72,241,117,124
050,18,119,"Indiana","Owen County",1,73,246,128,118
050,18,119,"Indiana","Owen County",1,74,176,89,87
050,18,119,"Indiana","Owen County",1,75,159,82,77
050,18,119,"Indiana","Owen County",1,76,168,85,83
050,18,119,"Indiana","Owen County",1,77,157,77,80
050,18,119,"Indiana","Owen County",1,78,128,63,65
050,18,119,"Indiana","Owen County",1,79,115,59,56
050,18,119,"Indiana","Owen County",1,80,120,64,56
050,18,119,"Indiana","Owen County",1,81,112,56,56
050,18,119,"Indiana","Owen County",1,82,92,47,45
050,18,119,"Indiana","Owen County",1,83,67,28,39
050,18,119,"Indiana","Owen County",1,84,77,29,48
050,18,119,"Indiana","Owen County",1,85,348,129,219
050,18,119,"Indiana","Owen County",2,0,227,111,116
050,18,119,"Indiana","Owen County",2,1,232,120,112
050,18,119,"Indiana","Owen County",2,2,237,128,109
050,18,119,"Indiana","Owen County",2,3,214,114,100
050,18,119,"Indiana","Owen County",2,4,227,117,110
050,18,119,"Indiana","Owen County",2,5,222,108,114
050,18,119,"Indiana","Owen County",2,6,225,112,113
050,18,119,"Indiana","Owen County",2,7,235,119,116
050,18,119,"Indiana","Owen County",2,8,242,127,115
050,18,119,"Indiana","Owen County",2,9,240,126,114
050,18,119,"Indiana","Owen County",2,10,238,123,115
050,18,119,"Indiana","Owen County",2,11,243,122,121
050,18,119,"Indiana","Owen County",2,12,261,134,127
050,18,119,"Indiana","Owen County",2,13,265,136,129
050,18,119,"Indiana","Owen County",2,14,277,141,136
050,18,119,"Indiana","Owen County",2,15,282,144,138
050,18,119,"Indiana","Owen County",2,16,287,146,141
050,18,119,"Indiana","Owen County",2,17,280,137,143
050,18,119,"Indiana","Owen County",2,18,242,123,119
050,18,119,"Indiana","Owen County",2,19,202,105,97
050,18,119,"Indiana","Owen County",2,20,207,114,93
050,18,119,"Indiana","Owen County",2,21,216,125,91
050,18,119,"Indiana","Owen County",2,22,213,114,99
050,18,119,"Indiana","Owen County",2,23,220,113,107
050,18,119,"Indiana","Owen County",2,24,222,114,108
050,18,119,"Indiana","Owen County",2,25,233,125,108
050,18,119,"Indiana","Owen County",2,26,236,124,112
050,18,119,"Indiana","Owen County",2,27,218,115,103
050,18,119,"Indiana","Owen County",2,28,223,103,120
050,18,119,"Indiana","Owen County",2,29,238,110,128
050,18,119,"Indiana","Owen County",2,30,237,111,126
050,18,119,"Indiana","Owen County",2,31,225,117,108
050,18,119,"Indiana","Owen County",2,32,235,122,113
050,18,119,"Indiana","Owen County",2,33,248,130,118
050,18,119,"Indiana","Owen County",2,34,236,118,118
050,18,119,"Indiana","Owen County",2,35,244,116,128
050,18,119,"Indiana","Owen County",2,36,226,116,110
050,18,119,"Indiana","Owen County",2,37,236,129,107
050,18,119,"Indiana","Owen County",2,38,236,130,106
050,18,119,"Indiana","Owen County",2,39,231,122,109
050,18,119,"Indiana","Owen County",2,40,235,117,118
050,18,119,"Indiana","Owen County",2,41,240,123,117
050,18,119,"Indiana","Owen County",2,42,251,131,120
050,18,119,"Indiana","Owen County",2,43,253,128,125
050,18,119,"Indiana","Owen County",2,44,226,109,117
050,18,119,"Indiana","Owen County",2,45,245,117,128
050,18,119,"Indiana","Owen County",2,46,246,121,125
050,18,119,"Indiana","Owen County",2,47,260,133,127
050,18,119,"Indiana","Owen County",2,48,284,151,133
050,18,119,"Indiana","Owen County",2,49,280,146,134
050,18,119,"Indiana","Owen County",2,50,284,149,135
050,18,119,"Indiana","Owen County",2,51,296,145,151
050,18,119,"Indiana","Owen County",2,52,292,145,147
050,18,119,"Indiana","Owen County",2,53,303,159,144
050,18,119,"Indiana","Owen County",2,54,326,164,162
050,18,119,"Indiana","Owen County",2,55,356,174,182
050,18,119,"Indiana","Owen County",2,56,366,188,178
050,18,119,"Indiana","Owen County",2,57,365,190,175
050,18,119,"Indiana","Owen County",2,58,370,183,187
050,18,119,"Indiana","Owen County",2,59,367,188,179
050,18,119,"Indiana","Owen County",2,60,360,179,181
050,18,119,"Indiana","Owen County",2,61,376,188,188
050,18,119,"Indiana","Owen County",2,62,362,190,172
050,18,119,"Indiana","Owen County",2,63,327,169,158
050,18,119,"Indiana","Owen County",2,64,330,170,160
050,18,119,"Indiana","Owen County",2,65,319,160,159
050,18,119,"Indiana","Owen County",2,66,310,157,153
050,18,119,"Indiana","Owen County",2,67,301,151,150
050,18,119,"Indiana","Owen County",2,68,302,148,154
050,18,119,"Indiana","Owen County",2,69,291,132,159
050,18,119,"Indiana","Owen County",2,70,257,124,133
050,18,119,"Indiana","Owen County",2,71,248,130,118
050,18,119,"Indiana","Owen County",2,72,236,117,119
050,18,119,"Indiana","Owen County",2,73,255,130,125
050,18,119,"Indiana","Owen County",2,74,178,91,87
050,18,119,"Indiana","Owen County",2,75,161,83,78
050,18,119,"Indiana","Owen County",2,76,165,84,81
050,18,119,"Indiana","Owen County",2,77,161,78,83
050,18,119,"Indiana","Owen County",2,78,133,64,69
050,18,119,"Indiana","Owen County",2,79,115,59,56
050,18,119,"Indiana","Owen County",2,80,119,63,56
050,18,119,"Indiana","Owen County",2,81,111,55,56
050,18,119,"Indiana","Owen County",2,82,95,49,46
050,18,119,"Indiana","Owen County",2,83,72,32,40
050,18,119,"Indiana","Owen County",2,84,76,29,47
050,18,119,"Indiana","Owen County",2,85,355,130,225
050,18,119,"Indiana","Owen County",3,0,243,112,131
050,18,119,"Indiana","Owen County",3,1,225,115,110
050,18,119,"Indiana","Owen County",3,2,240,124,116
050,18,119,"Indiana","Owen County",3,3,240,121,119
050,18,119,"Indiana","Owen County",3,4,225,125,100
050,18,119,"Indiana","Owen County",3,5,238,129,109
050,18,119,"Indiana","Owen County",3,6,237,127,110
050,18,119,"Indiana","Owen County",3,7,222,114,108
050,18,119,"Indiana","Owen County",3,8,230,122,108
050,18,119,"Indiana","Owen County",3,9,257,132,125
050,18,119,"Indiana","Owen County",3,10,240,133,107
050,18,119,"Indiana","Owen County",3,11,243,127,116
050,18,119,"Indiana","Owen County",3,12,248,129,119
050,18,119,"Indiana","Owen County",3,13,277,135,142
050,18,119,"Indiana","Owen County",3,14,268,131,137
050,18,119,"Indiana","Owen County",3,15,284,149,135
050,18,119,"Indiana","Owen County",3,16,282,143,139
050,18,119,"Indiana","Owen County",3,17,279,142,137
050,18,119,"Indiana","Owen County",3,18,228,115,113
050,18,119,"Indiana","Owen County",3,19,186,95,91
050,18,119,"Indiana","Owen County",3,20,217,109,108
050,18,119,"Indiana","Owen County",3,21,198,107,91
050,18,119,"Indiana","Owen County",3,22,212,119,93
050,18,119,"Indiana","Owen County",3,23,217,114,103
050,18,119,"Indiana","Owen County",3,24,228,117,111
050,18,119,"Indiana","Owen County",3,25,224,110,114
050,18,119,"Indiana","Owen County",3,26,230,116,114
050,18,119,"Indiana","Owen County",3,27,242,134,108
050,18,119,"Indiana","Owen County",3,28,227,114,113
050,18,119,"Indiana","Owen County",3,29,241,115,126
050,18,119,"Indiana","Owen County",3,30,250,112,138
050,18,119,"Indiana","Owen County",3,31,256,119,137
050,18,119,"Indiana","Owen County",3,32,251,134,117
050,18,119,"Indiana","Owen County",3,33,234,116,118
050,18,119,"Indiana","Owen County",3,34,246,125,121
050,18,119,"Indiana","Owen County",3,35,248,127,121
050,18,119,"Indiana","Owen County",3,36,243,114,129
050,18,119,"Indiana","Owen County",3,37,234,121,113
050,18,119,"Indiana","Owen County",3,38,239,126,113
050,18,119,"Indiana","Owen County",3,39,247,132,115
050,18,119,"Indiana","Owen County",3,40,236,124,112
050,18,119,"Indiana","Owen County",3,41,238,121,117
050,18,119,"Indiana","Owen County",3,42,252,131,121
050,18,119,"Indiana","Owen County",3,43,254,131,123
050,18,119,"Indiana","Owen County",3,44,249,125,124
050,18,119,"Indiana","Owen County",3,45,229,111,118
050,18,119,"Indiana","Owen County",3,46,248,122,126
050,18,119,"Indiana","Owen County",3,47,244,118,126
050,18,119,"Indiana","Owen County",3,48,275,142,133
050,18,119,"Indiana","Owen County",3,49,286,154,132
050,18,119,"Indiana","Owen County",3,50,288,148,140
050,18,119,"Indiana","Owen County",3,51,291,147,144
050,18,119,"Indiana","Owen County",3,52,306,154,152
050,18,119,"Indiana","Owen County",3,53,284,139,145
050,18,119,"Indiana","Owen County",3,54,293,155,138
050,18,119,"Indiana","Owen County",3,55,329,170,159
050,18,119,"Indiana","Owen County",3,56,360,178,182
050,18,119,"Indiana","Owen County",3,57,360,184,176
050,18,119,"Indiana","Owen County",3,58,372,191,181
050,18,119,"Indiana","Owen County",3,59,372,183,189
050,18,119,"Indiana","Owen County",3,60,377,198,179
050,18,119,"Indiana","Owen County",3,61,359,182,177
050,18,119,"Indiana","Owen County",3,62,374,185,189
050,18,119,"Indiana","Owen County",3,63,354,182,172
050,18,119,"Indiana","Owen County",3,64,327,164,163
050,18,119,"Indiana","Owen County",3,65,316,168,148
050,18,119,"Indiana","Owen County",3,66,329,165,164
050,18,119,"Indiana","Owen County",3,67,298,149,149
050,18,119,"Indiana","Owen County",3,68,302,149,153
050,18,119,"Indiana","Owen County",3,69,306,152,154
050,18,119,"Indiana","Owen County",3,70,281,128,153
050,18,119,"Indiana","Owen County",3,71,252,119,133
050,18,119,"Indiana","Owen County",3,72,246,127,119
050,18,119,"Indiana","Owen County",3,73,225,110,115
050,18,119,"Indiana","Owen County",3,74,234,116,118
050,18,119,"Indiana","Owen County",3,75,174,91,83
050,18,119,"Indiana","Owen County",3,76,159,82,77
050,18,119,"Indiana","Owen County",3,77,149,75,74
050,18,119,"Indiana","Owen County",3,78,158,74,84
050,18,119,"Indiana","Owen County",3,79,123,60,63
050,18,119,"Indiana","Owen County",3,80,111,56,55
050,18,119,"Indiana","Owen County",3,81,104,54,50
050,18,119,"Indiana","Owen County",3,82,101,49,52
050,18,119,"Indiana","Owen County",3,83,79,41,38
050,18,119,"Indiana","Owen County",3,84,70,30,40
050,18,119,"Indiana","Owen County",3,85,364,131,233
050,18,119,"Indiana","Owen County",4,0,110,54,56
050,18,119,"Indiana","Owen County",4,1,266,123,143
050,18,119,"Indiana","Owen County",4,2,224,115,109
050,18,119,"Indiana","Owen County",4,3,246,126,120
050,18,119,"Indiana","Owen County",4,4,252,130,122
050,18,119,"Indiana","Owen County",4,5,224,117,107
050,18,119,"Indiana","Owen County",4,6,231,119,112
050,18,119,"Indiana","Owen County",4,7,243,133,110
050,18,119,"Indiana","Owen County",4,8,237,115,122
050,18,119,"Indiana","Owen County",4,9,224,118,106
050,18,119,"Indiana","Owen County",4,10,259,130,129
050,18,119,"Indiana","Owen County",4,11,239,132,107
050,18,119,"Indiana","Owen County",4,12,249,132,117
050,18,119,"Indiana","Owen County",4,13,252,128,124
050,18,119,"Indiana","Owen County",4,14,270,141,129
050,18,119,"Indiana","Owen County",4,15,271,135,136
050,18,119,"Indiana","Owen County",4,16,292,155,137
050,18,119,"Indiana","Owen County",4,17,286,144,142
050,18,119,"Indiana","Owen County",4,18,234,124,110
050,18,119,"Indiana","Owen County",4,19,172,92,80
050,18,119,"Indiana","Owen County",4,20,199,103,96
050,18,119,"Indiana","Owen County",4,21,227,114,113
050,18,119,"Indiana","Owen County",4,22,214,113,101
050,18,119,"Indiana","Owen County",4,23,219,129,90
050,18,119,"Indiana","Owen County",4,24,218,115,103
050,18,119,"Indiana","Owen County",4,25,225,122,103
050,18,119,"Indiana","Owen County",4,26,218,107,111
050,18,119,"Indiana","Owen County",4,27,222,116,106
050,18,119,"Indiana","Owen County",4,28,241,136,105
050,18,119,"Indiana","Owen County",4,29,217,110,107
050,18,119,"Indiana","Owen County",4,30,243,119,124
050,18,119,"Indiana","Owen County",4,31,249,111,138
050,18,119,"Indiana","Owen County",4,32,259,121,138
050,18,119,"Indiana","Owen County",4,33,259,128,131
050,18,119,"Indiana","Owen County",4,34,243,124,119
050,18,119,"Indiana","Owen County",4,35,252,129,123
050,18,119,"Indiana","Owen County",4,36,248,123,125
050,18,119,"Indiana","Owen County",4,37,253,123,130
050,18,119,"Indiana","Owen County",4,38,234,118,116
050,18,119,"Indiana","Owen County",4,39,240,125,115
050,18,119,"Indiana","Owen County",4,40,263,137,126
050,18,119,"Indiana","Owen County",4,41,246,134,112
050,18,119,"Indiana","Owen County",4,42,239,120,119
050,18,119,"Indiana","Owen County",4,43,250,133,117
050,18,119,"Indiana","Owen County",4,44,259,132,127
050,18,119,"Indiana","Owen County",4,45,269,134,135
050,18,119,"Indiana","Owen County",4,46,220,103,117
050,18,119,"Indiana","Owen County",4,47,242,116,126
050,18,119,"Indiana","Owen County",4,48,252,125,127
050,18,119,"Indiana","Owen County",4,49,278,143,135
050,18,119,"Indiana","Owen County",4,50,284,157,127
050,18,119,"Indiana","Owen County",4,51,282,142,140
050,18,119,"Indiana","Owen County",4,52,299,154,145
050,18,119,"Indiana","Owen County",4,53,308,154,154
050,18,119,"Indiana","Owen County",4,54,285,142,143
050,18,119,"Indiana","Owen County",4,55,304,160,144
050,18,119,"Indiana","Owen County",4,56,332,171,161
050,18,119,"Indiana","Owen County",4,57,356,168,188
050,18,119,"Indiana","Owen County",4,58,366,188,178
050,18,119,"Indiana","Owen County",4,59,373,192,181
050,18,119,"Indiana","Owen County",4,60,362,182,180
050,18,119,"Indiana","Owen County",4,61,373,192,181
050,18,119,"Indiana","Owen County",4,62,346,175,171
050,18,119,"Indiana","Owen County",4,63,375,190,185
050,18,119,"Indiana","Owen County",4,64,361,179,182
050,18,119,"Indiana","Owen County",4,65,320,159,161
050,18,119,"Indiana","Owen County",4,66,311,166,145
050,18,119,"Indiana","Owen County",4,67,330,166,164
050,18,119,"Indiana","Owen County",4,68,295,148,147
050,18,119,"Indiana","Owen County",4,69,309,155,154
050,18,119,"Indiana","Owen County",4,70,288,146,142
050,18,119,"Indiana","Owen County",4,71,276,128,148
050,18,119,"Indiana","Owen County",4,72,246,113,133
050,18,119,"Indiana","Owen County",4,73,240,124,116
050,18,119,"Indiana","Owen County",4,74,210,102,108
050,18,119,"Indiana","Owen County",4,75,225,112,113
050,18,119,"Indiana","Owen County",4,76,172,90,82
050,18,119,"Indiana","Owen County",4,77,149,77,72
050,18,119,"Indiana","Owen County",4,78,140,65,75
050,18,119,"Indiana","Owen County",4,79,133,60,73
050,18,119,"Indiana","Owen County",4,80,121,58,63
050,18,119,"Indiana","Owen County",4,81,98,49,49
050,18,119,"Indiana","Owen County",4,82,97,52,45
050,18,119,"Indiana","Owen County",4,83,94,42,52
050,18,119,"Indiana","Owen County",4,84,79,40,39
050,18,119,"Indiana","Owen County",4,85,369,135,234
050,18,119,"Indiana","Owen County",5,0,53,24,29
050,18,119,"Indiana","Owen County",5,1,140,70,70
050,18,119,"Indiana","Owen County",5,2,266,125,141
050,18,119,"Indiana","Owen County",5,3,242,125,117
050,18,119,"Indiana","Owen County",5,4,266,132,134
050,18,119,"Indiana","Owen County",5,5,258,133,125
050,18,119,"Indiana","Owen County",5,6,222,119,103
050,18,119,"Indiana","Owen County",5,7,231,123,108
050,18,119,"Indiana","Owen County",5,8,255,132,123
050,18,119,"Indiana","Owen County",5,9,231,119,112
050,18,119,"Indiana","Owen County",5,10,242,129,113
050,18,119,"Indiana","Owen County",5,11,268,135,133
050,18,119,"Indiana","Owen County",5,12,254,142,112
050,18,119,"Indiana","Owen County",5,13,242,129,113
050,18,119,"Indiana","Owen County",5,14,249,130,119
050,18,119,"Indiana","Owen County",5,15,276,148,128
050,18,119,"Indiana","Owen County",5,16,279,135,144
050,18,119,"Indiana","Owen County",5,17,288,153,135
050,18,119,"Indiana","Owen County",5,18,246,132,114
050,18,119,"Indiana","Owen County",5,19,184,106,78
050,18,119,"Indiana","Owen County",5,20,178,97,81
050,18,119,"Indiana","Owen County",5,21,215,114,101
050,18,119,"Indiana","Owen County",5,22,229,120,109
050,18,119,"Indiana","Owen County",5,23,225,115,110
050,18,119,"Indiana","Owen County",5,24,233,132,101
050,18,119,"Indiana","Owen County",5,25,225,114,111
050,18,119,"Indiana","Owen County",5,26,231,129,102
050,18,119,"Indiana","Owen County",5,27,237,113,124
050,18,119,"Indiana","Owen County",5,28,228,120,108
050,18,119,"Indiana","Owen County",5,29,243,140,103
050,18,119,"Indiana","Owen County",5,30,233,118,115
050,18,119,"Indiana","Owen County",5,31,247,120,127
050,18,119,"Indiana","Owen County",5,32,256,122,134
050,18,119,"Indiana","Owen County",5,33,259,122,137
050,18,119,"Indiana","Owen County",5,34,262,127,135
050,18,119,"Indiana","Owen County",5,35,245,125,120
050,18,119,"Indiana","Owen County",5,36,264,139,125
050,18,119,"Indiana","Owen County",5,37,242,122,120
050,18,119,"Indiana","Owen County",5,38,245,116,129
050,18,119,"Indiana","Owen County",5,39,240,119,121
050,18,119,"Indiana","Owen County",5,40,251,121,130
050,18,119,"Indiana","Owen County",5,41,261,132,129
050,18,119,"Indiana","Owen County",5,42,243,129,114
050,18,119,"Indiana","Owen County",5,43,246,124,122
050,18,119,"Indiana","Owen County",5,44,241,128,113
050,18,119,"Indiana","Owen County",5,45,260,136,124
050,18,119,"Indiana","Owen County",5,46,267,133,134
050,18,119,"Indiana","Owen County",5,47,222,104,118
050,18,119,"Indiana","Owen County",5,48,244,113,131
050,18,119,"Indiana","Owen County",5,49,256,122,134
050,18,119,"Indiana","Owen County",5,50,277,150,127
050,18,119,"Indiana","Owen County",5,51,293,160,133
050,18,119,"Indiana","Owen County",5,52,304,154,150
050,18,119,"Indiana","Owen County",5,53,313,155,158
050,18,119,"Indiana","Owen County",5,54,294,141,153
050,18,119,"Indiana","Owen County",5,55,293,148,145
050,18,119,"Indiana","Owen County",5,56,291,153,138
050,18,119,"Indiana","Owen County",5,57,328,172,156
050,18,119,"Indiana","Owen County",5,58,364,169,195
050,18,119,"Indiana","Owen County",5,59,364,184,180
050,18,119,"Indiana","Owen County",5,60,368,195,173
050,18,119,"Indiana","Owen County",5,61,368,187,181
050,18,119,"Indiana","Owen County",5,62,381,193,188
050,18,119,"Indiana","Owen County",5,63,351,181,170
050,18,119,"Indiana","Owen County",5,64,381,190,191
050,18,119,"Indiana","Owen County",5,65,347,171,176
050,18,119,"Indiana","Owen County",5,66,313,154,159
050,18,119,"Indiana","Owen County",5,67,306,165,141
050,18,119,"Indiana","Owen County",5,68,332,163,169
050,18,119,"Indiana","Owen County",5,69,290,147,143
050,18,119,"Indiana","Owen County",5,70,290,149,141
050,18,119,"Indiana","Owen County",5,71,282,143,139
050,18,119,"Indiana","Owen County",5,72,268,123,145
050,18,119,"Indiana","Owen County",5,73,241,111,130
050,18,119,"Indiana","Owen County",5,74,232,119,113
050,18,119,"Indiana","Owen County",5,75,204,98,106
050,18,119,"Indiana","Owen County",5,76,222,111,111
050,18,119,"Indiana","Owen County",5,77,157,79,78
050,18,119,"Indiana","Owen County",5,78,145,73,72
050,18,119,"Indiana","Owen County",5,79,127,56,71
050,18,119,"Indiana","Owen County",5,80,128,58,70
050,18,119,"Indiana","Owen County",5,81,108,48,60
050,18,119,"Indiana","Owen County",5,82,94,46,48
050,18,119,"Indiana","Owen County",5,83,82,46,36
050,18,119,"Indiana","Owen County",5,84,92,39,53
050,18,119,"Indiana","Owen County",5,85,382,146,236
050,18,121,"Indiana","Parke County",1,0,188,98,90
050,18,121,"Indiana","Parke County",1,1,211,108,103
050,18,121,"Indiana","Parke County",1,2,182,94,88
050,18,121,"Indiana","Parke County",1,3,196,100,96
050,18,121,"Indiana","Parke County",1,4,210,112,98
050,18,121,"Indiana","Parke County",1,5,207,111,96
050,18,121,"Indiana","Parke County",1,6,190,88,102
050,18,121,"Indiana","Parke County",1,7,198,96,102
050,18,121,"Indiana","Parke County",1,8,172,98,74
050,18,121,"Indiana","Parke County",1,9,190,111,79
050,18,121,"Indiana","Parke County",1,10,194,99,95
050,18,121,"Indiana","Parke County",1,11,210,111,99
050,18,121,"Indiana","Parke County",1,12,207,108,99
050,18,121,"Indiana","Parke County",1,13,216,125,91
050,18,121,"Indiana","Parke County",1,14,204,115,89
050,18,121,"Indiana","Parke County",1,15,223,110,113
050,18,121,"Indiana","Parke County",1,16,218,105,113
050,18,121,"Indiana","Parke County",1,17,205,110,95
050,18,121,"Indiana","Parke County",1,18,168,88,80
050,18,121,"Indiana","Parke County",1,19,130,62,68
050,18,121,"Indiana","Parke County",1,20,152,73,79
050,18,121,"Indiana","Parke County",1,21,178,85,93
050,18,121,"Indiana","Parke County",1,22,172,85,87
050,18,121,"Indiana","Parke County",1,23,185,79,106
050,18,121,"Indiana","Parke County",1,24,181,71,110
050,18,121,"Indiana","Parke County",1,25,194,81,113
050,18,121,"Indiana","Parke County",1,26,198,78,120
050,18,121,"Indiana","Parke County",1,27,199,85,114
050,18,121,"Indiana","Parke County",1,28,203,87,116
050,18,121,"Indiana","Parke County",1,29,215,88,127
050,18,121,"Indiana","Parke County",1,30,220,105,115
050,18,121,"Indiana","Parke County",1,31,182,88,94
050,18,121,"Indiana","Parke County",1,32,195,79,116
050,18,121,"Indiana","Parke County",1,33,191,81,110
050,18,121,"Indiana","Parke County",1,34,197,81,116
050,18,121,"Indiana","Parke County",1,35,195,84,111
050,18,121,"Indiana","Parke County",1,36,201,87,114
050,18,121,"Indiana","Parke County",1,37,189,82,107
050,18,121,"Indiana","Parke County",1,38,191,86,105
050,18,121,"Indiana","Parke County",1,39,186,81,105
050,18,121,"Indiana","Parke County",1,40,171,70,101
050,18,121,"Indiana","Parke County",1,41,153,69,84
050,18,121,"Indiana","Parke County",1,42,155,68,87
050,18,121,"Indiana","Parke County",1,43,165,69,96
050,18,121,"Indiana","Parke County",1,44,190,85,105
050,18,121,"Indiana","Parke County",1,45,173,83,90
050,18,121,"Indiana","Parke County",1,46,206,97,109
050,18,121,"Indiana","Parke County",1,47,186,85,101
050,18,121,"Indiana","Parke County",1,48,195,88,107
050,18,121,"Indiana","Parke County",1,49,198,101,97
050,18,121,"Indiana","Parke County",1,50,205,98,107
050,18,121,"Indiana","Parke County",1,51,184,92,92
050,18,121,"Indiana","Parke County",1,52,190,85,105
050,18,121,"Indiana","Parke County",1,53,205,99,106
050,18,121,"Indiana","Parke County",1,54,192,100,92
050,18,121,"Indiana","Parke County",1,55,218,118,100
050,18,121,"Indiana","Parke County",1,56,244,118,126
050,18,121,"Indiana","Parke County",1,57,233,107,126
050,18,121,"Indiana","Parke County",1,58,247,111,136
050,18,121,"Indiana","Parke County",1,59,253,125,128
050,18,121,"Indiana","Parke County",1,60,265,136,129
050,18,121,"Indiana","Parke County",1,61,244,127,117
050,18,121,"Indiana","Parke County",1,62,252,131,121
050,18,121,"Indiana","Parke County",1,63,233,121,112
050,18,121,"Indiana","Parke County",1,64,229,108,121
050,18,121,"Indiana","Parke County",1,65,209,104,105
050,18,121,"Indiana","Parke County",1,66,214,111,103
050,18,121,"Indiana","Parke County",1,67,223,118,105
050,18,121,"Indiana","Parke County",1,68,216,103,113
050,18,121,"Indiana","Parke County",1,69,201,96,105
050,18,121,"Indiana","Parke County",1,70,192,89,103
050,18,121,"Indiana","Parke County",1,71,191,85,106
050,18,121,"Indiana","Parke County",1,72,195,104,91
050,18,121,"Indiana","Parke County",1,73,184,103,81
050,18,121,"Indiana","Parke County",1,74,129,64,65
050,18,121,"Indiana","Parke County",1,75,129,73,56
050,18,121,"Indiana","Parke County",1,76,131,68,63
050,18,121,"Indiana","Parke County",1,77,126,56,70
050,18,121,"Indiana","Parke County",1,78,105,49,56
050,18,121,"Indiana","Parke County",1,79,96,48,48
050,18,121,"Indiana","Parke County",1,80,85,39,46
050,18,121,"Indiana","Parke County",1,81,84,44,40
050,18,121,"Indiana","Parke County",1,82,71,37,34
050,18,121,"Indiana","Parke County",1,83,55,26,29
050,18,121,"Indiana","Parke County",1,84,61,31,30
050,18,121,"Indiana","Parke County",1,85,321,117,204
050,18,121,"Indiana","Parke County",2,0,185,92,93
050,18,121,"Indiana","Parke County",2,1,203,104,99
050,18,121,"Indiana","Parke County",2,2,189,97,92
050,18,121,"Indiana","Parke County",2,3,192,99,93
050,18,121,"Indiana","Parke County",2,4,208,110,98
050,18,121,"Indiana","Parke County",2,5,208,112,96
050,18,121,"Indiana","Parke County",2,6,194,94,100
050,18,121,"Indiana","Parke County",2,7,195,94,101
050,18,121,"Indiana","Parke County",2,8,176,96,80
050,18,121,"Indiana","Parke County",2,9,185,107,78
050,18,121,"Indiana","Parke County",2,10,193,101,92
050,18,121,"Indiana","Parke County",2,11,201,104,97
050,18,121,"Indiana","Parke County",2,12,206,108,98
050,18,121,"Indiana","Parke County",2,13,214,121,93
050,18,121,"Indiana","Parke County",2,14,210,120,90
050,18,121,"Indiana","Parke County",2,15,219,111,108
050,18,121,"Indiana","Parke County",2,16,219,105,114
050,18,121,"Indiana","Parke County",2,17,210,111,99
050,18,121,"Indiana","Parke County",2,18,170,90,80
050,18,121,"Indiana","Parke County",2,19,131,64,67
050,18,121,"Indiana","Parke County",2,20,155,73,82
050,18,121,"Indiana","Parke County",2,21,173,83,90
050,18,121,"Indiana","Parke County",2,22,177,86,91
050,18,121,"Indiana","Parke County",2,23,184,80,104
050,18,121,"Indiana","Parke County",2,24,185,73,112
050,18,121,"Indiana","Parke County",2,25,190,79,111
050,18,121,"Indiana","Parke County",2,26,199,79,120
050,18,121,"Indiana","Parke County",2,27,198,83,115
050,18,121,"Indiana","Parke County",2,28,201,86,115
050,18,121,"Indiana","Parke County",2,29,215,88,127
050,18,121,"Indiana","Parke County",2,30,219,105,114
050,18,121,"Indiana","Parke County",2,31,187,89,98
050,18,121,"Indiana","Parke County",2,32,193,80,113
050,18,121,"Indiana","Parke County",2,33,191,81,110
050,18,121,"Indiana","Parke County",2,34,196,81,115
050,18,121,"Indiana","Parke County",2,35,196,84,112
050,18,121,"Indiana","Parke County",2,36,202,87,115
050,18,121,"Indiana","Parke County",2,37,192,84,108
050,18,121,"Indiana","Parke County",2,38,189,87,102
050,18,121,"Indiana","Parke County",2,39,187,82,105
050,18,121,"Indiana","Parke County",2,40,178,73,105
050,18,121,"Indiana","Parke County",2,41,155,69,86
050,18,121,"Indiana","Parke County",2,42,153,68,85
050,18,121,"Indiana","Parke County",2,43,165,70,95
050,18,121,"Indiana","Parke County",2,44,185,80,105
050,18,121,"Indiana","Parke County",2,45,172,82,90
050,18,121,"Indiana","Parke County",2,46,197,92,105
050,18,121,"Indiana","Parke County",2,47,191,88,103
050,18,121,"Indiana","Parke County",2,48,189,86,103
050,18,121,"Indiana","Parke County",2,49,199,99,100
050,18,121,"Indiana","Parke County",2,50,205,101,104
050,18,121,"Indiana","Parke County",2,51,186,92,94
050,18,121,"Indiana","Parke County",2,52,190,88,102
050,18,121,"Indiana","Parke County",2,53,199,94,105
050,18,121,"Indiana","Parke County",2,54,196,100,96
050,18,121,"Indiana","Parke County",2,55,209,113,96
050,18,121,"Indiana","Parke County",2,56,240,120,120
050,18,121,"Indiana","Parke County",2,57,238,112,126
050,18,121,"Indiana","Parke County",2,58,245,111,134
050,18,121,"Indiana","Parke County",2,59,251,122,129
050,18,121,"Indiana","Parke County",2,60,262,134,128
050,18,121,"Indiana","Parke County",2,61,247,128,119
050,18,121,"Indiana","Parke County",2,62,251,130,121
050,18,121,"Indiana","Parke County",2,63,242,125,117
050,18,121,"Indiana","Parke County",2,64,229,111,118
050,18,121,"Indiana","Parke County",2,65,213,104,109
050,18,121,"Indiana","Parke County",2,66,214,110,104
050,18,121,"Indiana","Parke County",2,67,221,116,105
050,18,121,"Indiana","Parke County",2,68,215,106,109
050,18,121,"Indiana","Parke County",2,69,203,97,106
050,18,121,"Indiana","Parke County",2,70,194,90,104
050,18,121,"Indiana","Parke County",2,71,191,86,105
050,18,121,"Indiana","Parke County",2,72,189,96,93
050,18,121,"Indiana","Parke County",2,73,196,108,88
050,18,121,"Indiana","Parke County",2,74,134,69,65
050,18,121,"Indiana","Parke County",2,75,128,70,58
050,18,121,"Indiana","Parke County",2,76,128,68,60
050,18,121,"Indiana","Parke County",2,77,129,60,69
050,18,121,"Indiana","Parke County",2,78,108,49,59
050,18,121,"Indiana","Parke County",2,79,96,48,48
050,18,121,"Indiana","Parke County",2,80,86,40,46
050,18,121,"Indiana","Parke County",2,81,83,42,41
050,18,121,"Indiana","Parke County",2,82,72,39,33
050,18,121,"Indiana","Parke County",2,83,58,28,30
050,18,121,"Indiana","Parke County",2,84,60,30,30
050,18,121,"Indiana","Parke County",2,85,321,119,202
050,18,121,"Indiana","Parke County",3,0,204,96,108
050,18,121,"Indiana","Parke County",3,1,190,96,94
050,18,121,"Indiana","Parke County",3,2,209,110,99
050,18,121,"Indiana","Parke County",3,3,210,105,105
050,18,121,"Indiana","Parke County",3,4,193,100,93
050,18,121,"Indiana","Parke County",3,5,230,121,109
050,18,121,"Indiana","Parke County",3,6,209,109,100
050,18,121,"Indiana","Parke County",3,7,191,93,98
050,18,121,"Indiana","Parke County",3,8,203,102,101
050,18,121,"Indiana","Parke County",3,9,175,98,77
050,18,121,"Indiana","Parke County",3,10,201,117,84
050,18,121,"Indiana","Parke County",3,11,209,110,99
050,18,121,"Indiana","Parke County",3,12,206,102,104
050,18,121,"Indiana","Parke County",3,13,225,122,103
050,18,121,"Indiana","Parke County",3,14,215,120,95
050,18,121,"Indiana","Parke County",3,15,217,124,93
050,18,121,"Indiana","Parke County",3,16,223,108,115
050,18,121,"Indiana","Parke County",3,17,222,99,123
050,18,121,"Indiana","Parke County",3,18,183,98,85
050,18,121,"Indiana","Parke County",3,19,131,68,63
050,18,121,"Indiana","Parke County",3,20,157,65,92
050,18,121,"Indiana","Parke County",3,21,172,78,94
050,18,121,"Indiana","Parke County",3,22,185,88,97
050,18,121,"Indiana","Parke County",3,23,196,90,106
050,18,121,"Indiana","Parke County",3,24,191,77,114
050,18,121,"Indiana","Parke County",3,25,183,79,104
050,18,121,"Indiana","Parke County",3,26,195,81,114
050,18,121,"Indiana","Parke County",3,27,211,89,122
050,18,121,"Indiana","Parke County",3,28,207,89,118
050,18,121,"Indiana","Parke County",3,29,220,88,132
050,18,121,"Indiana","Parke County",3,30,215,101,114
050,18,121,"Indiana","Parke County",3,31,217,108,109
050,18,121,"Indiana","Parke County",3,32,197,87,110
050,18,121,"Indiana","Parke County",3,33,192,86,106
050,18,121,"Indiana","Parke County",3,34,204,80,124
050,18,121,"Indiana","Parke County",3,35,196,83,113
050,18,121,"Indiana","Parke County",3,36,203,83,120
050,18,121,"Indiana","Parke County",3,37,209,91,118
050,18,121,"Indiana","Parke County",3,38,188,85,103
050,18,121,"Indiana","Parke County",3,39,188,85,103
050,18,121,"Indiana","Parke County",3,40,203,81,122
050,18,121,"Indiana","Parke County",3,41,181,77,104
050,18,121,"Indiana","Parke County",3,42,156,69,87
050,18,121,"Indiana","Parke County",3,43,160,67,93
050,18,121,"Indiana","Parke County",3,44,186,73,113
050,18,121,"Indiana","Parke County",3,45,170,80,90
050,18,121,"Indiana","Parke County",3,46,170,83,87
050,18,121,"Indiana","Parke County",3,47,199,93,106
050,18,121,"Indiana","Parke County",3,48,186,86,100
050,18,121,"Indiana","Parke County",3,49,193,90,103
050,18,121,"Indiana","Parke County",3,50,195,101,94
050,18,121,"Indiana","Parke County",3,51,218,110,108
050,18,121,"Indiana","Parke County",3,52,194,96,98
050,18,121,"Indiana","Parke County",3,53,182,82,100
050,18,121,"Indiana","Parke County",3,54,215,105,110
050,18,121,"Indiana","Parke County",3,55,198,98,100
050,18,121,"Indiana","Parke County",3,56,212,115,97
050,18,121,"Indiana","Parke County",3,57,234,119,115
050,18,121,"Indiana","Parke County",3,58,241,110,131
050,18,121,"Indiana","Parke County",3,59,249,115,134
050,18,121,"Indiana","Parke County",3,60,245,122,123
050,18,121,"Indiana","Parke County",3,61,257,128,129
050,18,121,"Indiana","Parke County",3,62,240,124,116
050,18,121,"Indiana","Parke County",3,63,251,130,121
050,18,121,"Indiana","Parke County",3,64,241,126,115
050,18,121,"Indiana","Parke County",3,65,233,116,117
050,18,121,"Indiana","Parke County",3,66,221,107,114
050,18,121,"Indiana","Parke County",3,67,217,112,105
050,18,121,"Indiana","Parke County",3,68,220,118,102
050,18,121,"Indiana","Parke County",3,69,209,103,106
050,18,121,"Indiana","Parke County",3,70,207,99,108
050,18,121,"Indiana","Parke County",3,71,184,86,98
050,18,121,"Indiana","Parke County",3,72,186,84,102
050,18,121,"Indiana","Parke County",3,73,175,88,87
050,18,121,"Indiana","Parke County",3,74,189,102,87
050,18,121,"Indiana","Parke County",3,75,126,63,63
050,18,121,"Indiana","Parke County",3,76,118,66,52
050,18,121,"Indiana","Parke County",3,77,122,62,60
050,18,121,"Indiana","Parke County",3,78,127,58,69
050,18,121,"Indiana","Parke County",3,79,100,43,57
050,18,121,"Indiana","Parke County",3,80,91,45,46
050,18,121,"Indiana","Parke County",3,81,85,38,47
050,18,121,"Indiana","Parke County",3,82,77,38,39
050,18,121,"Indiana","Parke County",3,83,60,34,26
050,18,121,"Indiana","Parke County",3,84,53,25,28
050,18,121,"Indiana","Parke County",3,85,338,128,210
050,18,121,"Indiana","Parke County",4,0,213,121,92
050,18,121,"Indiana","Parke County",4,1,205,91,114
050,18,121,"Indiana","Parke County",4,2,187,96,91
050,18,121,"Indiana","Parke County",4,3,197,97,100
050,18,121,"Indiana","Parke County",4,4,209,104,105
050,18,121,"Indiana","Parke County",4,5,198,102,96
050,18,121,"Indiana","Parke County",4,6,221,112,109
050,18,121,"Indiana","Parke County",4,7,208,110,98
050,18,121,"Indiana","Parke County",4,8,193,98,95
050,18,121,"Indiana","Parke County",4,9,210,101,109
050,18,121,"Indiana","Parke County",4,10,174,96,78
050,18,121,"Indiana","Parke County",4,11,204,122,82
050,18,121,"Indiana","Parke County",4,12,206,109,97
050,18,121,"Indiana","Parke County",4,13,216,109,107
050,18,121,"Indiana","Parke County",4,14,209,109,100
050,18,121,"Indiana","Parke County",4,15,220,115,105
050,18,121,"Indiana","Parke County",4,16,224,130,94
050,18,121,"Indiana","Parke County",4,17,221,107,114
050,18,121,"Indiana","Parke County",4,18,188,90,98
050,18,121,"Indiana","Parke County",4,19,133,70,63
050,18,121,"Indiana","Parke County",4,20,148,73,75
050,18,121,"Indiana","Parke County",4,21,163,69,94
050,18,121,"Indiana","Parke County",4,22,177,79,98
050,18,121,"Indiana","Parke County",4,23,187,88,99
050,18,121,"Indiana","Parke County",4,24,193,84,109
050,18,121,"Indiana","Parke County",4,25,189,81,108
050,18,121,"Indiana","Parke County",4,26,185,77,108
050,18,121,"Indiana","Parke County",4,27,192,82,110
050,18,121,"Indiana","Parke County",4,28,209,88,121
050,18,121,"Indiana","Parke County",4,29,212,88,124
050,18,121,"Indiana","Parke County",4,30,215,95,120
050,18,121,"Indiana","Parke County",4,31,205,98,107
050,18,121,"Indiana","Parke County",4,32,212,105,107
050,18,121,"Indiana","Parke County",4,33,190,91,99
050,18,121,"Indiana","Parke County",4,34,191,81,110
050,18,121,"Indiana","Parke County",4,35,190,71,119
050,18,121,"Indiana","Parke County",4,36,203,84,119
050,18,121,"Indiana","Parke County",4,37,204,86,118
050,18,121,"Indiana","Parke County",4,38,199,94,105
050,18,121,"Indiana","Parke County",4,39,188,85,103
050,18,121,"Indiana","Parke County",4,40,198,88,110
050,18,121,"Indiana","Parke County",4,41,186,77,109
050,18,121,"Indiana","Parke County",4,42,177,76,101
050,18,121,"Indiana","Parke County",4,43,152,66,86
050,18,121,"Indiana","Parke County",4,44,171,68,103
050,18,121,"Indiana","Parke County",4,45,172,73,99
050,18,121,"Indiana","Parke County",4,46,166,79,87
050,18,121,"Indiana","Parke County",4,47,174,87,87
050,18,121,"Indiana","Parke County",4,48,196,91,105
050,18,121,"Indiana","Parke County",4,49,176,83,93
050,18,121,"Indiana","Parke County",4,50,190,90,100
050,18,121,"Indiana","Parke County",4,51,195,108,87
050,18,121,"Indiana","Parke County",4,52,219,111,108
050,18,121,"Indiana","Parke County",4,53,187,89,98
050,18,121,"Indiana","Parke County",4,54,187,84,103
050,18,121,"Indiana","Parke County",4,55,202,98,104
050,18,121,"Indiana","Parke County",4,56,202,99,103
050,18,121,"Indiana","Parke County",4,57,211,114,97
050,18,121,"Indiana","Parke County",4,58,237,118,119
050,18,121,"Indiana","Parke County",4,59,241,111,130
050,18,121,"Indiana","Parke County",4,60,246,115,131
050,18,121,"Indiana","Parke County",4,61,250,124,126
050,18,121,"Indiana","Parke County",4,62,260,128,132
050,18,121,"Indiana","Parke County",4,63,234,121,113
050,18,121,"Indiana","Parke County",4,64,246,127,119
050,18,121,"Indiana","Parke County",4,65,245,128,117
050,18,121,"Indiana","Parke County",4,66,230,116,114
050,18,121,"Indiana","Parke County",4,67,217,106,111
050,18,121,"Indiana","Parke County",4,68,213,111,102
050,18,121,"Indiana","Parke County",4,69,214,112,102
050,18,121,"Indiana","Parke County",4,70,209,102,107
050,18,121,"Indiana","Parke County",4,71,192,97,95
050,18,121,"Indiana","Parke County",4,72,173,78,95
050,18,121,"Indiana","Parke County",4,73,172,75,97
050,18,121,"Indiana","Parke County",4,74,169,86,83
050,18,121,"Indiana","Parke County",4,75,179,101,78
050,18,121,"Indiana","Parke County",4,76,123,60,63
050,18,121,"Indiana","Parke County",4,77,118,65,53
050,18,121,"Indiana","Parke County",4,78,120,65,55
050,18,121,"Indiana","Parke County",4,79,117,51,66
050,18,121,"Indiana","Parke County",4,80,97,40,57
050,18,121,"Indiana","Parke County",4,81,82,40,42
050,18,121,"Indiana","Parke County",4,82,82,37,45
050,18,121,"Indiana","Parke County",4,83,65,31,34
050,18,121,"Indiana","Parke County",4,84,54,30,24
050,18,121,"Indiana","Parke County",4,85,333,131,202
050,18,121,"Indiana","Parke County",5,0,204,115,89
050,18,121,"Indiana","Parke County",5,1,216,125,91
050,18,121,"Indiana","Parke County",5,2,195,86,109
050,18,121,"Indiana","Parke County",5,3,186,99,87
050,18,121,"Indiana","Parke County",5,4,202,102,100
050,18,121,"Indiana","Parke County",5,5,227,113,114
050,18,121,"Indiana","Parke County",5,6,202,101,101
050,18,121,"Indiana","Parke County",5,7,221,113,108
050,18,121,"Indiana","Parke County",5,8,216,115,101
050,18,121,"Indiana","Parke County",5,9,198,101,97
050,18,121,"Indiana","Parke County",5,10,222,107,115
050,18,121,"Indiana","Parke County",5,11,175,95,80
050,18,121,"Indiana","Parke County",5,12,212,123,89
050,18,121,"Indiana","Parke County",5,13,216,114,102
050,18,121,"Indiana","Parke County",5,14,218,108,110
050,18,121,"Indiana","Parke County",5,15,211,109,102
050,18,121,"Indiana","Parke County",5,16,224,119,105
050,18,121,"Indiana","Parke County",5,17,233,131,102
050,18,121,"Indiana","Parke County",5,18,183,93,90
050,18,121,"Indiana","Parke County",5,19,148,66,82
050,18,121,"Indiana","Parke County",5,20,156,81,75
050,18,121,"Indiana","Parke County",5,21,175,85,90
050,18,121,"Indiana","Parke County",5,22,175,79,96
050,18,121,"Indiana","Parke County",5,23,173,74,99
050,18,121,"Indiana","Parke County",5,24,197,84,113
050,18,121,"Indiana","Parke County",5,25,198,99,99
050,18,121,"Indiana","Parke County",5,26,205,85,120
050,18,121,"Indiana","Parke County",5,27,187,80,107
050,18,121,"Indiana","Parke County",5,28,191,82,109
050,18,121,"Indiana","Parke County",5,29,213,82,131
050,18,121,"Indiana","Parke County",5,30,215,96,119
050,18,121,"Indiana","Parke County",5,31,200,85,115
050,18,121,"Indiana","Parke County",5,32,207,91,116
050,18,121,"Indiana","Parke County",5,33,199,99,100
050,18,121,"Indiana","Parke County",5,34,189,88,101
050,18,121,"Indiana","Parke County",5,35,184,81,103
050,18,121,"Indiana","Parke County",5,36,197,72,125
050,18,121,"Indiana","Parke County",5,37,197,83,114
050,18,121,"Indiana","Parke County",5,38,193,83,110
050,18,121,"Indiana","Parke County",5,39,200,94,106
050,18,121,"Indiana","Parke County",5,40,204,91,113
050,18,121,"Indiana","Parke County",5,41,187,91,96
050,18,121,"Indiana","Parke County",5,42,179,76,103
050,18,121,"Indiana","Parke County",5,43,183,80,103
050,18,121,"Indiana","Parke County",5,44,170,73,97
050,18,121,"Indiana","Parke County",5,45,163,69,94
050,18,121,"Indiana","Parke County",5,46,175,72,103
050,18,121,"Indiana","Parke County",5,47,172,84,88
050,18,121,"Indiana","Parke County",5,48,168,84,84
050,18,121,"Indiana","Parke County",5,49,193,92,101
050,18,121,"Indiana","Parke County",5,50,161,76,85
050,18,121,"Indiana","Parke County",5,51,187,90,97
050,18,121,"Indiana","Parke County",5,52,199,105,94
050,18,121,"Indiana","Parke County",5,53,215,108,107
050,18,121,"Indiana","Parke County",5,54,196,93,103
050,18,121,"Indiana","Parke County",5,55,180,80,100
050,18,121,"Indiana","Parke County",5,56,215,103,112
050,18,121,"Indiana","Parke County",5,57,199,98,101
050,18,121,"Indiana","Parke County",5,58,217,111,106
050,18,121,"Indiana","Parke County",5,59,232,118,114
050,18,121,"Indiana","Parke County",5,60,238,110,128
050,18,121,"Indiana","Parke County",5,61,245,113,132
050,18,121,"Indiana","Parke County",5,62,250,126,124
050,18,121,"Indiana","Parke County",5,63,261,126,135
050,18,121,"Indiana","Parke County",5,64,243,129,114
050,18,121,"Indiana","Parke County",5,65,250,127,123
050,18,121,"Indiana","Parke County",5,66,245,127,118
050,18,121,"Indiana","Parke County",5,67,226,114,112
050,18,121,"Indiana","Parke County",5,68,216,104,112
050,18,121,"Indiana","Parke County",5,69,210,111,99
050,18,121,"Indiana","Parke County",5,70,206,108,98
050,18,121,"Indiana","Parke County",5,71,202,100,102
050,18,121,"Indiana","Parke County",5,72,183,91,92
050,18,121,"Indiana","Parke County",5,73,164,72,92
050,18,121,"Indiana","Parke County",5,74,167,72,95
050,18,121,"Indiana","Parke County",5,75,153,79,74
050,18,121,"Indiana","Parke County",5,76,174,95,79
050,18,121,"Indiana","Parke County",5,77,120,59,61
050,18,121,"Indiana","Parke County",5,78,114,65,49
050,18,121,"Indiana","Parke County",5,79,114,60,54
050,18,121,"Indiana","Parke County",5,80,110,49,61
050,18,121,"Indiana","Parke County",5,81,95,40,55
050,18,121,"Indiana","Parke County",5,82,76,37,39
050,18,121,"Indiana","Parke County",5,83,69,30,39
050,18,121,"Indiana","Parke County",5,84,60,27,33
050,18,121,"Indiana","Parke County",5,85,338,142,196
050,18,123,"Indiana","Perry County",1,0,204,107,97
050,18,123,"Indiana","Perry County",1,1,212,119,93
050,18,123,"Indiana","Perry County",1,2,205,110,95
050,18,123,"Indiana","Perry County",1,3,221,126,95
050,18,123,"Indiana","Perry County",1,4,235,112,123
050,18,123,"Indiana","Perry County",1,5,227,112,115
050,18,123,"Indiana","Perry County",1,6,195,105,90
050,18,123,"Indiana","Perry County",1,7,222,125,97
050,18,123,"Indiana","Perry County",1,8,226,122,104
050,18,123,"Indiana","Perry County",1,9,225,124,101
050,18,123,"Indiana","Perry County",1,10,233,117,116
050,18,123,"Indiana","Perry County",1,11,245,129,116
050,18,123,"Indiana","Perry County",1,12,239,125,114
050,18,123,"Indiana","Perry County",1,13,256,124,132
050,18,123,"Indiana","Perry County",1,14,267,136,131
050,18,123,"Indiana","Perry County",1,15,236,125,111
050,18,123,"Indiana","Perry County",1,16,247,131,116
050,18,123,"Indiana","Perry County",1,17,231,122,109
050,18,123,"Indiana","Perry County",1,18,191,103,88
050,18,123,"Indiana","Perry County",1,19,181,103,78
050,18,123,"Indiana","Perry County",1,20,199,132,67
050,18,123,"Indiana","Perry County",1,21,210,133,77
050,18,123,"Indiana","Perry County",1,22,197,127,70
050,18,123,"Indiana","Perry County",1,23,230,139,91
050,18,123,"Indiana","Perry County",1,24,243,145,98
050,18,123,"Indiana","Perry County",1,25,255,155,100
050,18,123,"Indiana","Perry County",1,26,257,166,91
050,18,123,"Indiana","Perry County",1,27,264,157,107
050,18,123,"Indiana","Perry County",1,28,274,169,105
050,18,123,"Indiana","Perry County",1,29,243,151,92
050,18,123,"Indiana","Perry County",1,30,248,154,94
050,18,123,"Indiana","Perry County",1,31,245,149,96
050,18,123,"Indiana","Perry County",1,32,262,146,116
050,18,123,"Indiana","Perry County",1,33,221,127,94
050,18,123,"Indiana","Perry County",1,34,224,134,90
050,18,123,"Indiana","Perry County",1,35,259,157,102
050,18,123,"Indiana","Perry County",1,36,230,137,93
050,18,123,"Indiana","Perry County",1,37,264,160,104
050,18,123,"Indiana","Perry County",1,38,245,136,109
050,18,123,"Indiana","Perry County",1,39,255,156,99
050,18,123,"Indiana","Perry County",1,40,248,144,104
050,18,123,"Indiana","Perry County",1,41,249,152,97
050,18,123,"Indiana","Perry County",1,42,234,128,106
050,18,123,"Indiana","Perry County",1,43,249,149,100
050,18,123,"Indiana","Perry County",1,44,223,131,92
050,18,123,"Indiana","Perry County",1,45,207,101,106
050,18,123,"Indiana","Perry County",1,46,226,122,104
050,18,123,"Indiana","Perry County",1,47,248,147,101
050,18,123,"Indiana","Perry County",1,48,257,152,105
050,18,123,"Indiana","Perry County",1,49,231,133,98
050,18,123,"Indiana","Perry County",1,50,228,120,108
050,18,123,"Indiana","Perry County",1,51,225,123,102
050,18,123,"Indiana","Perry County",1,52,213,118,95
050,18,123,"Indiana","Perry County",1,53,238,135,103
050,18,123,"Indiana","Perry County",1,54,239,140,99
050,18,123,"Indiana","Perry County",1,55,260,136,124
050,18,123,"Indiana","Perry County",1,56,254,133,121
050,18,123,"Indiana","Perry County",1,57,274,146,128
050,18,123,"Indiana","Perry County",1,58,291,153,138
050,18,123,"Indiana","Perry County",1,59,303,159,144
050,18,123,"Indiana","Perry County",1,60,276,134,142
050,18,123,"Indiana","Perry County",1,61,278,134,144
050,18,123,"Indiana","Perry County",1,62,284,142,142
050,18,123,"Indiana","Perry County",1,63,271,134,137
050,18,123,"Indiana","Perry County",1,64,277,147,130
050,18,123,"Indiana","Perry County",1,65,244,125,119
050,18,123,"Indiana","Perry County",1,66,241,120,121
050,18,123,"Indiana","Perry County",1,67,251,126,125
050,18,123,"Indiana","Perry County",1,68,234,115,119
050,18,123,"Indiana","Perry County",1,69,224,119,105
050,18,123,"Indiana","Perry County",1,70,221,119,102
050,18,123,"Indiana","Perry County",1,71,216,108,108
050,18,123,"Indiana","Perry County",1,72,196,101,95
050,18,123,"Indiana","Perry County",1,73,195,94,101
050,18,123,"Indiana","Perry County",1,74,142,70,72
050,18,123,"Indiana","Perry County",1,75,144,66,78
050,18,123,"Indiana","Perry County",1,76,119,51,68
050,18,123,"Indiana","Perry County",1,77,120,56,64
050,18,123,"Indiana","Perry County",1,78,115,62,53
050,18,123,"Indiana","Perry County",1,79,105,47,58
050,18,123,"Indiana","Perry County",1,80,75,33,42
050,18,123,"Indiana","Perry County",1,81,82,32,50
050,18,123,"Indiana","Perry County",1,82,81,34,47
050,18,123,"Indiana","Perry County",1,83,71,35,36
050,18,123,"Indiana","Perry County",1,84,74,31,43
050,18,123,"Indiana","Perry County",1,85,414,150,264
050,18,123,"Indiana","Perry County",2,0,198,103,95
050,18,123,"Indiana","Perry County",2,1,208,115,93
050,18,123,"Indiana","Perry County",2,2,206,113,93
050,18,123,"Indiana","Perry County",2,3,217,122,95
050,18,123,"Indiana","Perry County",2,4,234,117,117
050,18,123,"Indiana","Perry County",2,5,227,111,116
050,18,123,"Indiana","Perry County",2,6,204,107,97
050,18,123,"Indiana","Perry County",2,7,217,122,95
050,18,123,"Indiana","Perry County",2,8,223,122,101
050,18,123,"Indiana","Perry County",2,9,226,124,102
050,18,123,"Indiana","Perry County",2,10,235,121,114
050,18,123,"Indiana","Perry County",2,11,241,125,116
050,18,123,"Indiana","Perry County",2,12,243,128,115
050,18,123,"Indiana","Perry County",2,13,253,125,128
050,18,123,"Indiana","Perry County",2,14,264,134,130
050,18,123,"Indiana","Perry County",2,15,242,128,114
050,18,123,"Indiana","Perry County",2,16,245,129,116
050,18,123,"Indiana","Perry County",2,17,234,124,110
050,18,123,"Indiana","Perry County",2,18,192,103,89
050,18,123,"Indiana","Perry County",2,19,177,101,76
050,18,123,"Indiana","Perry County",2,20,205,133,72
050,18,123,"Indiana","Perry County",2,21,207,133,74
050,18,123,"Indiana","Perry County",2,22,201,129,72
050,18,123,"Indiana","Perry County",2,23,227,139,88
050,18,123,"Indiana","Perry County",2,24,240,144,96
050,18,123,"Indiana","Perry County",2,25,255,155,100
050,18,123,"Indiana","Perry County",2,26,258,164,94
050,18,123,"Indiana","Perry County",2,27,259,156,103
050,18,123,"Indiana","Perry County",2,28,277,171,106
050,18,123,"Indiana","Perry County",2,29,246,150,96
050,18,123,"Indiana","Perry County",2,30,253,158,95
050,18,123,"Indiana","Perry County",2,31,242,147,95
050,18,123,"Indiana","Perry County",2,32,258,146,112
050,18,123,"Indiana","Perry County",2,33,226,127,99
050,18,123,"Indiana","Perry County",2,34,224,133,91
050,18,123,"Indiana","Perry County",2,35,256,157,99
050,18,123,"Indiana","Perry County",2,36,235,139,96
050,18,123,"Indiana","Perry County",2,37,257,156,101
050,18,123,"Indiana","Perry County",2,38,248,140,108
050,18,123,"Indiana","Perry County",2,39,253,152,101
050,18,123,"Indiana","Perry County",2,40,249,146,103
050,18,123,"Indiana","Perry County",2,41,250,151,99
050,18,123,"Indiana","Perry County",2,42,233,131,102
050,18,123,"Indiana","Perry County",2,43,248,146,102
050,18,123,"Indiana","Perry County",2,44,230,135,95
050,18,123,"Indiana","Perry County",2,45,211,107,104
050,18,123,"Indiana","Perry County",2,46,223,120,103
050,18,123,"Indiana","Perry County",2,47,242,140,102
050,18,123,"Indiana","Perry County",2,48,249,146,103
050,18,123,"Indiana","Perry County",2,49,240,139,101
050,18,123,"Indiana","Perry County",2,50,231,124,107
050,18,123,"Indiana","Perry County",2,51,223,121,102
050,18,123,"Indiana","Perry County",2,52,214,117,97
050,18,123,"Indiana","Perry County",2,53,229,129,100
050,18,123,"Indiana","Perry County",2,54,236,136,100
050,18,123,"Indiana","Perry County",2,55,257,138,119
050,18,123,"Indiana","Perry County",2,56,252,129,123
050,18,123,"Indiana","Perry County",2,57,271,144,127
050,18,123,"Indiana","Perry County",2,58,285,149,136
050,18,123,"Indiana","Perry County",2,59,302,158,144
050,18,123,"Indiana","Perry County",2,60,280,139,141
050,18,123,"Indiana","Perry County",2,61,275,132,143
050,18,123,"Indiana","Perry County",2,62,282,139,143
050,18,123,"Indiana","Perry County",2,63,277,138,139
050,18,123,"Indiana","Perry County",2,64,274,143,131
050,18,123,"Indiana","Perry County",2,65,250,130,120
050,18,123,"Indiana","Perry County",2,66,241,121,120
050,18,123,"Indiana","Perry County",2,67,246,123,123
050,18,123,"Indiana","Perry County",2,68,236,117,119
050,18,123,"Indiana","Perry County",2,69,227,118,109
050,18,123,"Indiana","Perry County",2,70,220,119,101
050,18,123,"Indiana","Perry County",2,71,217,111,106
050,18,123,"Indiana","Perry County",2,72,196,101,95
050,18,123,"Indiana","Perry County",2,73,202,99,103
050,18,123,"Indiana","Perry County",2,74,145,69,76
050,18,123,"Indiana","Perry County",2,75,142,67,75
050,18,123,"Indiana","Perry County",2,76,123,53,70
050,18,123,"Indiana","Perry County",2,77,121,56,65
050,18,123,"Indiana","Perry County",2,78,113,58,55
050,18,123,"Indiana","Perry County",2,79,108,50,58
050,18,123,"Indiana","Perry County",2,80,81,35,46
050,18,123,"Indiana","Perry County",2,81,79,31,48
050,18,123,"Indiana","Perry County",2,82,79,31,48
050,18,123,"Indiana","Perry County",2,83,70,35,35
050,18,123,"Indiana","Perry County",2,84,71,30,41
050,18,123,"Indiana","Perry County",2,85,412,149,263
050,18,123,"Indiana","Perry County",3,0,179,99,80
050,18,123,"Indiana","Perry County",3,1,220,117,103
050,18,123,"Indiana","Perry County",3,2,208,114,94
050,18,123,"Indiana","Perry County",3,3,201,110,91
050,18,123,"Indiana","Perry County",3,4,213,119,94
050,18,123,"Indiana","Perry County",3,5,231,117,114
050,18,123,"Indiana","Perry County",3,6,230,107,123
050,18,123,"Indiana","Perry County",3,7,206,106,100
050,18,123,"Indiana","Perry County",3,8,208,121,87
050,18,123,"Indiana","Perry County",3,9,218,122,96
050,18,123,"Indiana","Perry County",3,10,214,117,97
050,18,123,"Indiana","Perry County",3,11,228,119,109
050,18,123,"Indiana","Perry County",3,12,233,121,112
050,18,123,"Indiana","Perry County",3,13,246,134,112
050,18,123,"Indiana","Perry County",3,14,254,126,128
050,18,123,"Indiana","Perry County",3,15,260,128,132
050,18,123,"Indiana","Perry County",3,16,237,125,112
050,18,123,"Indiana","Perry County",3,17,254,131,123
050,18,123,"Indiana","Perry County",3,18,205,113,92
050,18,123,"Indiana","Perry County",3,19,171,102,69
050,18,123,"Indiana","Perry County",3,20,229,142,87
050,18,123,"Indiana","Perry County",3,21,210,135,75
050,18,123,"Indiana","Perry County",3,22,217,134,83
050,18,123,"Indiana","Perry County",3,23,217,141,76
050,18,123,"Indiana","Perry County",3,24,238,146,92
050,18,123,"Indiana","Perry County",3,25,256,160,96
050,18,123,"Indiana","Perry County",3,26,272,168,104
050,18,123,"Indiana","Perry County",3,27,275,176,99
050,18,123,"Indiana","Perry County",3,28,278,184,94
050,18,123,"Indiana","Perry County",3,29,253,149,104
050,18,123,"Indiana","Perry County",3,30,278,177,101
050,18,123,"Indiana","Perry County",3,31,253,158,95
050,18,123,"Indiana","Perry County",3,32,249,156,93
050,18,123,"Indiana","Perry County",3,33,244,132,112
050,18,123,"Indiana","Perry County",3,34,235,137,98
050,18,123,"Indiana","Perry County",3,35,241,147,94
050,18,123,"Indiana","Perry County",3,36,257,158,99
050,18,123,"Indiana","Perry County",3,37,256,156,100
050,18,123,"Indiana","Perry County",3,38,263,158,105
050,18,123,"Indiana","Perry County",3,39,265,159,106
050,18,123,"Indiana","Perry County",3,40,260,152,108
050,18,123,"Indiana","Perry County",3,41,266,160,106
050,18,123,"Indiana","Perry County",3,42,251,147,104
050,18,123,"Indiana","Perry County",3,43,245,143,102
050,18,123,"Indiana","Perry County",3,44,247,149,98
050,18,123,"Indiana","Perry County",3,45,223,125,98
050,18,123,"Indiana","Perry County",3,46,231,125,106
050,18,123,"Indiana","Perry County",3,47,225,121,104
050,18,123,"Indiana","Perry County",3,48,227,124,103
050,18,123,"Indiana","Perry County",3,49,253,154,99
050,18,123,"Indiana","Perry County",3,50,244,145,99
050,18,123,"Indiana","Perry County",3,51,230,122,108
050,18,123,"Indiana","Perry County",3,52,231,126,105
050,18,123,"Indiana","Perry County",3,53,214,119,95
050,18,123,"Indiana","Perry County",3,54,220,124,96
050,18,123,"Indiana","Perry County",3,55,243,139,104
050,18,123,"Indiana","Perry County",3,56,261,140,121
050,18,123,"Indiana","Perry County",3,57,266,143,123
050,18,123,"Indiana","Perry County",3,58,262,138,124
050,18,123,"Indiana","Perry County",3,59,286,149,137
050,18,123,"Indiana","Perry County",3,60,300,157,143
050,18,123,"Indiana","Perry County",3,61,269,130,139
050,18,123,"Indiana","Perry County",3,62,270,133,137
050,18,123,"Indiana","Perry County",3,63,277,136,141
050,18,123,"Indiana","Perry County",3,64,273,137,136
050,18,123,"Indiana","Perry County",3,65,271,139,132
050,18,123,"Indiana","Perry County",3,66,245,124,121
050,18,123,"Indiana","Perry County",3,67,239,118,121
050,18,123,"Indiana","Perry County",3,68,241,121,120
050,18,123,"Indiana","Perry County",3,69,223,110,113
050,18,123,"Indiana","Perry County",3,70,224,117,107
050,18,123,"Indiana","Perry County",3,71,212,112,100
050,18,123,"Indiana","Perry County",3,72,210,111,99
050,18,123,"Indiana","Perry County",3,73,184,93,91
050,18,123,"Indiana","Perry County",3,74,204,98,106
050,18,123,"Indiana","Perry County",3,75,140,68,72
050,18,123,"Indiana","Perry County",3,76,140,67,73
050,18,123,"Indiana","Perry County",3,77,117,49,68
050,18,123,"Indiana","Perry County",3,78,115,55,60
050,18,123,"Indiana","Perry County",3,79,112,54,58
050,18,123,"Indiana","Perry County",3,80,99,45,54
050,18,123,"Indiana","Perry County",3,81,79,35,44
050,18,123,"Indiana","Perry County",3,82,69,27,42
050,18,123,"Indiana","Perry County",3,83,69,32,37
050,18,123,"Indiana","Perry County",3,84,72,31,41
050,18,123,"Indiana","Perry County",3,85,393,149,244
050,18,123,"Indiana","Perry County",4,0,176,99,77
050,18,123,"Indiana","Perry County",4,1,198,109,89
050,18,123,"Indiana","Perry County",4,2,219,115,104
050,18,123,"Indiana","Perry County",4,3,210,116,94
050,18,123,"Indiana","Perry County",4,4,204,105,99
050,18,123,"Indiana","Perry County",4,5,220,122,98
050,18,123,"Indiana","Perry County",4,6,238,118,120
050,18,123,"Indiana","Perry County",4,7,224,111,113
050,18,123,"Indiana","Perry County",4,8,194,103,91
050,18,123,"Indiana","Perry County",4,9,216,119,97
050,18,123,"Indiana","Perry County",4,10,216,117,99
050,18,123,"Indiana","Perry County",4,11,221,121,100
050,18,123,"Indiana","Perry County",4,12,223,111,112
050,18,123,"Indiana","Perry County",4,13,234,127,107
050,18,123,"Indiana","Perry County",4,14,238,127,111
050,18,123,"Indiana","Perry County",4,15,257,131,126
050,18,123,"Indiana","Perry County",4,16,252,132,120
050,18,123,"Indiana","Perry County",4,17,234,122,112
050,18,123,"Indiana","Perry County",4,18,214,120,94
050,18,123,"Indiana","Perry County",4,19,170,101,69
050,18,123,"Indiana","Perry County",4,20,200,128,72
050,18,123,"Indiana","Perry County",4,21,223,146,77
050,18,123,"Indiana","Perry County",4,22,210,133,77
050,18,123,"Indiana","Perry County",4,23,238,139,99
050,18,123,"Indiana","Perry County",4,24,220,138,82
050,18,123,"Indiana","Perry County",4,25,244,152,92
050,18,123,"Indiana","Perry County",4,26,249,149,100
050,18,123,"Indiana","Perry County",4,27,258,159,99
050,18,123,"Indiana","Perry County",4,28,283,187,96
050,18,123,"Indiana","Perry County",4,29,251,158,93
050,18,123,"Indiana","Perry County",4,30,267,159,108
050,18,123,"Indiana","Perry County",4,31,261,159,102
050,18,123,"Indiana","Perry County",4,32,251,157,94
050,18,123,"Indiana","Perry County",4,33,229,139,90
050,18,123,"Indiana","Perry County",4,34,242,138,104
050,18,123,"Indiana","Perry County",4,35,242,145,97
050,18,123,"Indiana","Perry County",4,36,228,136,92
050,18,123,"Indiana","Perry County",4,37,261,164,97
050,18,123,"Indiana","Perry County",4,38,229,133,96
050,18,123,"Indiana","Perry County",4,39,261,152,109
050,18,123,"Indiana","Perry County",4,40,250,145,105
050,18,123,"Indiana","Perry County",4,41,270,160,110
050,18,123,"Indiana","Perry County",4,42,261,150,111
050,18,123,"Indiana","Perry County",4,43,245,144,101
050,18,123,"Indiana","Perry County",4,44,237,137,100
050,18,123,"Indiana","Perry County",4,45,233,133,100
050,18,123,"Indiana","Perry County",4,46,238,139,99
050,18,123,"Indiana","Perry County",4,47,250,139,111
050,18,123,"Indiana","Perry County",4,48,211,103,108
050,18,123,"Indiana","Perry County",4,49,234,130,104
050,18,123,"Indiana","Perry County",4,50,257,154,103
050,18,123,"Indiana","Perry County",4,51,247,147,100
050,18,123,"Indiana","Perry County",4,52,233,119,114
050,18,123,"Indiana","Perry County",4,53,238,129,109
050,18,123,"Indiana","Perry County",4,54,205,109,96
050,18,123,"Indiana","Perry County",4,55,225,128,97
050,18,123,"Indiana","Perry County",4,56,234,132,102
050,18,123,"Indiana","Perry County",4,57,277,155,122
050,18,123,"Indiana","Perry County",4,58,251,131,120
050,18,123,"Indiana","Perry County",4,59,273,148,125
050,18,123,"Indiana","Perry County",4,60,286,150,136
050,18,123,"Indiana","Perry County",4,61,298,152,146
050,18,123,"Indiana","Perry County",4,62,266,130,136
050,18,123,"Indiana","Perry County",4,63,271,133,138
050,18,123,"Indiana","Perry County",4,64,284,141,143
050,18,123,"Indiana","Perry County",4,65,271,136,135
050,18,123,"Indiana","Perry County",4,66,266,137,129
050,18,123,"Indiana","Perry County",4,67,241,116,125
050,18,123,"Indiana","Perry County",4,68,231,114,117
050,18,123,"Indiana","Perry County",4,69,234,117,117
050,18,123,"Indiana","Perry County",4,70,218,109,109
050,18,123,"Indiana","Perry County",4,71,215,109,106
050,18,123,"Indiana","Perry County",4,72,210,111,99
050,18,123,"Indiana","Perry County",4,73,198,107,91
050,18,123,"Indiana","Perry County",4,74,189,91,98
050,18,123,"Indiana","Perry County",4,75,190,91,99
050,18,123,"Indiana","Perry County",4,76,140,68,72
050,18,123,"Indiana","Perry County",4,77,132,65,67
050,18,123,"Indiana","Perry County",4,78,111,48,63
050,18,123,"Indiana","Perry County",4,79,109,50,59
050,18,123,"Indiana","Perry County",4,80,102,48,54
050,18,123,"Indiana","Perry County",4,81,97,44,53
050,18,123,"Indiana","Perry County",4,82,72,31,41
050,18,123,"Indiana","Perry County",4,83,60,27,33
050,18,123,"Indiana","Perry County",4,84,68,26,42
050,18,123,"Indiana","Perry County",4,85,374,146,228
050,18,123,"Indiana","Perry County",5,0,164,94,70
050,18,123,"Indiana","Perry County",5,1,168,96,72
050,18,123,"Indiana","Perry County",5,2,204,116,88
050,18,123,"Indiana","Perry County",5,3,215,113,102
050,18,123,"Indiana","Perry County",5,4,213,115,98
050,18,123,"Indiana","Perry County",5,5,214,110,104
050,18,123,"Indiana","Perry County",5,6,220,124,96
050,18,123,"Indiana","Perry County",5,7,236,114,122
050,18,123,"Indiana","Perry County",5,8,233,112,121
050,18,123,"Indiana","Perry County",5,9,205,110,95
050,18,123,"Indiana","Perry County",5,10,214,124,90
050,18,123,"Indiana","Perry County",5,11,217,118,99
050,18,123,"Indiana","Perry County",5,12,221,119,102
050,18,123,"Indiana","Perry County",5,13,228,116,112
050,18,123,"Indiana","Perry County",5,14,226,120,106
050,18,123,"Indiana","Perry County",5,15,237,130,107
050,18,123,"Indiana","Perry County",5,16,262,132,130
050,18,123,"Indiana","Perry County",5,17,250,128,122
050,18,123,"Indiana","Perry County",5,18,203,110,93
050,18,123,"Indiana","Perry County",5,19,188,110,78
050,18,123,"Indiana","Perry County",5,20,206,133,73
050,18,123,"Indiana","Perry County",5,21,212,133,79
050,18,123,"Indiana","Perry County",5,22,231,146,85
050,18,123,"Indiana","Perry County",5,23,232,149,83
050,18,123,"Indiana","Perry County",5,24,255,151,104
050,18,123,"Indiana","Perry County",5,25,241,152,89
050,18,123,"Indiana","Perry County",5,26,246,160,86
050,18,123,"Indiana","Perry County",5,27,244,148,96
050,18,123,"Indiana","Perry County",5,28,278,175,103
050,18,123,"Indiana","Perry County",5,29,255,158,97
050,18,123,"Indiana","Perry County",5,30,263,169,94
050,18,123,"Indiana","Perry County",5,31,252,144,108
050,18,123,"Indiana","Perry County",5,32,267,167,100
050,18,123,"Indiana","Perry County",5,33,241,144,97
050,18,123,"Indiana","Perry County",5,34,228,137,91
050,18,123,"Indiana","Perry County",5,35,256,149,107
050,18,123,"Indiana","Perry County",5,36,239,143,96
050,18,123,"Indiana","Perry County",5,37,236,141,95
050,18,123,"Indiana","Perry County",5,38,239,146,93
050,18,123,"Indiana","Perry County",5,39,233,134,99
050,18,123,"Indiana","Perry County",5,40,255,150,105
050,18,123,"Indiana","Perry County",5,41,259,155,104
050,18,123,"Indiana","Perry County",5,42,263,152,111
050,18,123,"Indiana","Perry County",5,43,270,161,109
050,18,123,"Indiana","Perry County",5,44,252,150,102
050,18,123,"Indiana","Perry County",5,45,226,125,101
050,18,123,"Indiana","Perry County",5,46,246,146,100
050,18,123,"Indiana","Perry County",5,47,251,151,100
050,18,123,"Indiana","Perry County",5,48,232,122,110
050,18,123,"Indiana","Perry County",5,49,212,106,106
050,18,123,"Indiana","Perry County",5,50,230,126,104
050,18,123,"Indiana","Perry County",5,51,254,147,107
050,18,123,"Indiana","Perry County",5,52,246,143,103
050,18,123,"Indiana","Perry County",5,53,234,120,114
050,18,123,"Indiana","Perry County",5,54,230,121,109
050,18,123,"Indiana","Perry County",5,55,210,114,96
050,18,123,"Indiana","Perry County",5,56,209,114,95
050,18,123,"Indiana","Perry County",5,57,244,140,104
050,18,123,"Indiana","Perry County",5,58,269,147,122
050,18,123,"Indiana","Perry County",5,59,250,136,114
050,18,123,"Indiana","Perry County",5,60,280,152,128
050,18,123,"Indiana","Perry County",5,61,273,141,132
050,18,123,"Indiana","Perry County",5,62,289,151,138
050,18,123,"Indiana","Perry County",5,63,262,124,138
050,18,123,"Indiana","Perry County",5,64,271,133,138
050,18,123,"Indiana","Perry County",5,65,275,135,140
050,18,123,"Indiana","Perry County",5,66,266,133,133
050,18,123,"Indiana","Perry County",5,67,258,129,129
050,18,123,"Indiana","Perry County",5,68,233,116,117
050,18,123,"Indiana","Perry County",5,69,226,108,118
050,18,123,"Indiana","Perry County",5,70,229,115,114
050,18,123,"Indiana","Perry County",5,71,213,104,109
050,18,123,"Indiana","Perry County",5,72,205,103,102
050,18,123,"Indiana","Perry County",5,73,202,108,94
050,18,123,"Indiana","Perry County",5,74,202,107,95
050,18,123,"Indiana","Perry County",5,75,177,86,91
050,18,123,"Indiana","Perry County",5,76,185,90,95
050,18,123,"Indiana","Perry County",5,77,132,66,66
050,18,123,"Indiana","Perry County",5,78,125,64,61
050,18,123,"Indiana","Perry County",5,79,108,43,65
050,18,123,"Indiana","Perry County",5,80,98,44,54
050,18,123,"Indiana","Perry County",5,81,103,48,55
050,18,123,"Indiana","Perry County",5,82,91,40,51
050,18,123,"Indiana","Perry County",5,83,61,30,31
050,18,123,"Indiana","Perry County",5,84,61,24,37
050,18,123,"Indiana","Perry County",5,85,370,145,225
050,18,125,"Indiana","Pike County",1,0,148,75,73
050,18,125,"Indiana","Pike County",1,1,153,69,84
050,18,125,"Indiana","Pike County",1,2,152,73,79
050,18,125,"Indiana","Pike County",1,3,136,71,65
050,18,125,"Indiana","Pike County",1,4,141,68,73
050,18,125,"Indiana","Pike County",1,5,155,73,82
050,18,125,"Indiana","Pike County",1,6,154,81,73
050,18,125,"Indiana","Pike County",1,7,147,80,67
050,18,125,"Indiana","Pike County",1,8,148,74,74
050,18,125,"Indiana","Pike County",1,9,159,80,79
050,18,125,"Indiana","Pike County",1,10,151,72,79
050,18,125,"Indiana","Pike County",1,11,141,67,74
050,18,125,"Indiana","Pike County",1,12,163,86,77
050,18,125,"Indiana","Pike County",1,13,164,94,70
050,18,125,"Indiana","Pike County",1,14,171,84,87
050,18,125,"Indiana","Pike County",1,15,156,74,82
050,18,125,"Indiana","Pike County",1,16,156,73,83
050,18,125,"Indiana","Pike County",1,17,153,76,77
050,18,125,"Indiana","Pike County",1,18,134,79,55
050,18,125,"Indiana","Pike County",1,19,112,62,50
050,18,125,"Indiana","Pike County",1,20,117,59,58
050,18,125,"Indiana","Pike County",1,21,119,52,67
050,18,125,"Indiana","Pike County",1,22,116,58,58
050,18,125,"Indiana","Pike County",1,23,115,58,57
050,18,125,"Indiana","Pike County",1,24,114,60,54
050,18,125,"Indiana","Pike County",1,25,127,69,58
050,18,125,"Indiana","Pike County",1,26,138,71,67
050,18,125,"Indiana","Pike County",1,27,134,64,70
050,18,125,"Indiana","Pike County",1,28,156,78,78
050,18,125,"Indiana","Pike County",1,29,152,84,68
050,18,125,"Indiana","Pike County",1,30,151,81,70
050,18,125,"Indiana","Pike County",1,31,138,65,73
050,18,125,"Indiana","Pike County",1,32,131,68,63
050,18,125,"Indiana","Pike County",1,33,126,67,59
050,18,125,"Indiana","Pike County",1,34,145,76,69
050,18,125,"Indiana","Pike County",1,35,132,69,63
050,18,125,"Indiana","Pike County",1,36,127,67,60
050,18,125,"Indiana","Pike County",1,37,157,80,77
050,18,125,"Indiana","Pike County",1,38,143,73,70
050,18,125,"Indiana","Pike County",1,39,150,82,68
050,18,125,"Indiana","Pike County",1,40,137,63,74
050,18,125,"Indiana","Pike County",1,41,112,60,52
050,18,125,"Indiana","Pike County",1,42,130,69,61
050,18,125,"Indiana","Pike County",1,43,128,66,62
050,18,125,"Indiana","Pike County",1,44,138,68,70
050,18,125,"Indiana","Pike County",1,45,160,88,72
050,18,125,"Indiana","Pike County",1,46,150,77,73
050,18,125,"Indiana","Pike County",1,47,150,82,68
050,18,125,"Indiana","Pike County",1,48,156,85,71
050,18,125,"Indiana","Pike County",1,49,174,84,90
050,18,125,"Indiana","Pike County",1,50,159,79,80
050,18,125,"Indiana","Pike County",1,51,155,75,80
050,18,125,"Indiana","Pike County",1,52,151,73,78
050,18,125,"Indiana","Pike County",1,53,136,77,59
050,18,125,"Indiana","Pike County",1,54,160,89,71
050,18,125,"Indiana","Pike County",1,55,170,87,83
050,18,125,"Indiana","Pike County",1,56,201,102,99
050,18,125,"Indiana","Pike County",1,57,195,94,101
050,18,125,"Indiana","Pike County",1,58,199,97,102
050,18,125,"Indiana","Pike County",1,59,197,93,104
050,18,125,"Indiana","Pike County",1,60,186,100,86
050,18,125,"Indiana","Pike County",1,61,178,88,90
050,18,125,"Indiana","Pike County",1,62,209,107,102
050,18,125,"Indiana","Pike County",1,63,190,100,90
050,18,125,"Indiana","Pike County",1,64,180,92,88
050,18,125,"Indiana","Pike County",1,65,164,91,73
050,18,125,"Indiana","Pike County",1,66,162,87,75
050,18,125,"Indiana","Pike County",1,67,155,87,68
050,18,125,"Indiana","Pike County",1,68,145,76,69
050,18,125,"Indiana","Pike County",1,69,139,67,72
050,18,125,"Indiana","Pike County",1,70,141,71,70
050,18,125,"Indiana","Pike County",1,71,158,84,74
050,18,125,"Indiana","Pike County",1,72,141,64,77
050,18,125,"Indiana","Pike County",1,73,140,67,73
050,18,125,"Indiana","Pike County",1,74,99,38,61
050,18,125,"Indiana","Pike County",1,75,96,51,45
050,18,125,"Indiana","Pike County",1,76,89,42,47
050,18,125,"Indiana","Pike County",1,77,103,44,59
050,18,125,"Indiana","Pike County",1,78,86,43,43
050,18,125,"Indiana","Pike County",1,79,77,41,36
050,18,125,"Indiana","Pike County",1,80,68,30,38
050,18,125,"Indiana","Pike County",1,81,66,29,37
050,18,125,"Indiana","Pike County",1,82,62,29,33
050,18,125,"Indiana","Pike County",1,83,62,28,34
050,18,125,"Indiana","Pike County",1,84,51,20,31
050,18,125,"Indiana","Pike County",1,85,266,95,171
050,18,125,"Indiana","Pike County",2,0,144,74,70
050,18,125,"Indiana","Pike County",2,1,152,71,81
050,18,125,"Indiana","Pike County",2,2,154,73,81
050,18,125,"Indiana","Pike County",2,3,140,70,70
050,18,125,"Indiana","Pike County",2,4,142,69,73
050,18,125,"Indiana","Pike County",2,5,154,74,80
050,18,125,"Indiana","Pike County",2,6,158,82,76
050,18,125,"Indiana","Pike County",2,7,149,80,69
050,18,125,"Indiana","Pike County",2,8,148,75,73
050,18,125,"Indiana","Pike County",2,9,156,79,77
050,18,125,"Indiana","Pike County",2,10,153,74,79
050,18,125,"Indiana","Pike County",2,11,144,68,76
050,18,125,"Indiana","Pike County",2,12,157,82,75
050,18,125,"Indiana","Pike County",2,13,163,92,71
050,18,125,"Indiana","Pike County",2,14,169,86,83
050,18,125,"Indiana","Pike County",2,15,160,77,83
050,18,125,"Indiana","Pike County",2,16,153,72,81
050,18,125,"Indiana","Pike County",2,17,152,76,76
050,18,125,"Indiana","Pike County",2,18,133,76,57
050,18,125,"Indiana","Pike County",2,19,110,63,47
050,18,125,"Indiana","Pike County",2,20,118,60,58
050,18,125,"Indiana","Pike County",2,21,119,54,65
050,18,125,"Indiana","Pike County",2,22,120,59,61
050,18,125,"Indiana","Pike County",2,23,117,60,57
050,18,125,"Indiana","Pike County",2,24,114,59,55
050,18,125,"Indiana","Pike County",2,25,125,69,56
050,18,125,"Indiana","Pike County",2,26,135,71,64
050,18,125,"Indiana","Pike County",2,27,137,67,70
050,18,125,"Indiana","Pike County",2,28,154,77,77
050,18,125,"Indiana","Pike County",2,29,152,82,70
050,18,125,"Indiana","Pike County",2,30,152,82,70
050,18,125,"Indiana","Pike County",2,31,143,69,74
050,18,125,"Indiana","Pike County",2,32,132,68,64
050,18,125,"Indiana","Pike County",2,33,127,67,60
050,18,125,"Indiana","Pike County",2,34,142,75,67
050,18,125,"Indiana","Pike County",2,35,136,71,65
050,18,125,"Indiana","Pike County",2,36,130,68,62
050,18,125,"Indiana","Pike County",2,37,150,78,72
050,18,125,"Indiana","Pike County",2,38,149,76,73
050,18,125,"Indiana","Pike County",2,39,148,80,68
050,18,125,"Indiana","Pike County",2,40,139,68,71
050,18,125,"Indiana","Pike County",2,41,116,60,56
050,18,125,"Indiana","Pike County",2,42,124,66,58
050,18,125,"Indiana","Pike County",2,43,129,67,62
050,18,125,"Indiana","Pike County",2,44,136,68,68
050,18,125,"Indiana","Pike County",2,45,154,83,71
050,18,125,"Indiana","Pike County",2,46,152,79,73
050,18,125,"Indiana","Pike County",2,47,149,80,69
050,18,125,"Indiana","Pike County",2,48,155,84,71
050,18,125,"Indiana","Pike County",2,49,168,84,84
050,18,125,"Indiana","Pike County",2,50,162,80,82
050,18,125,"Indiana","Pike County",2,51,156,75,81
050,18,125,"Indiana","Pike County",2,52,147,70,77
050,18,125,"Indiana","Pike County",2,53,141,78,63
050,18,125,"Indiana","Pike County",2,54,154,86,68
050,18,125,"Indiana","Pike County",2,55,169,88,81
050,18,125,"Indiana","Pike County",2,56,195,99,96
050,18,125,"Indiana","Pike County",2,57,197,95,102
050,18,125,"Indiana","Pike County",2,58,197,97,100
050,18,125,"Indiana","Pike County",2,59,201,95,106
050,18,125,"Indiana","Pike County",2,60,187,98,89
050,18,125,"Indiana","Pike County",2,61,179,91,88
050,18,125,"Indiana","Pike County",2,62,199,101,98
050,18,125,"Indiana","Pike County",2,63,197,104,93
050,18,125,"Indiana","Pike County",2,64,179,93,86
050,18,125,"Indiana","Pike County",2,65,169,92,77
050,18,125,"Indiana","Pike County",2,66,161,88,73
050,18,125,"Indiana","Pike County",2,67,156,87,69
050,18,125,"Indiana","Pike County",2,68,146,77,69
050,18,125,"Indiana","Pike County",2,69,141,69,72
050,18,125,"Indiana","Pike County",2,70,140,69,71
050,18,125,"Indiana","Pike County",2,71,153,81,72
050,18,125,"Indiana","Pike County",2,72,142,67,75
050,18,125,"Indiana","Pike County",2,73,147,68,79
050,18,125,"Indiana","Pike County",2,74,97,40,57
050,18,125,"Indiana","Pike County",2,75,95,48,47
050,18,125,"Indiana","Pike County",2,76,87,41,46
050,18,125,"Indiana","Pike County",2,77,101,44,57
050,18,125,"Indiana","Pike County",2,78,87,43,44
050,18,125,"Indiana","Pike County",2,79,78,40,38
050,18,125,"Indiana","Pike County",2,80,69,32,37
050,18,125,"Indiana","Pike County",2,81,65,28,37
050,18,125,"Indiana","Pike County",2,82,63,29,34
050,18,125,"Indiana","Pike County",2,83,61,28,33
050,18,125,"Indiana","Pike County",2,84,52,21,31
050,18,125,"Indiana","Pike County",2,85,266,94,172
050,18,125,"Indiana","Pike County",3,0,126,73,53
050,18,125,"Indiana","Pike County",3,1,140,68,72
050,18,125,"Indiana","Pike County",3,2,151,64,87
050,18,125,"Indiana","Pike County",3,3,150,72,78
050,18,125,"Indiana","Pike County",3,4,139,70,69
050,18,125,"Indiana","Pike County",3,5,145,73,72
050,18,125,"Indiana","Pike County",3,6,149,71,78
050,18,125,"Indiana","Pike County",3,7,159,88,71
050,18,125,"Indiana","Pike County",3,8,140,74,66
050,18,125,"Indiana","Pike County",3,9,146,77,69
050,18,125,"Indiana","Pike County",3,10,153,74,79
050,18,125,"Indiana","Pike County",3,11,150,71,79
050,18,125,"Indiana","Pike County",3,12,143,70,73
050,18,125,"Indiana","Pike County",3,13,151,77,74
050,18,125,"Indiana","Pike County",3,14,164,89,75
050,18,125,"Indiana","Pike County",3,15,172,89,83
050,18,125,"Indiana","Pike County",3,16,154,76,78
050,18,125,"Indiana","Pike County",3,17,160,72,88
050,18,125,"Indiana","Pike County",3,18,133,74,59
050,18,125,"Indiana","Pike County",3,19,99,58,41
050,18,125,"Indiana","Pike County",3,20,114,64,50
050,18,125,"Indiana","Pike County",3,21,129,66,63
050,18,125,"Indiana","Pike County",3,22,126,56,70
050,18,125,"Indiana","Pike County",3,23,118,62,56
050,18,125,"Indiana","Pike County",3,24,108,61,47
050,18,125,"Indiana","Pike County",3,25,127,65,62
050,18,125,"Indiana","Pike County",3,26,128,69,59
050,18,125,"Indiana","Pike County",3,27,135,72,63
050,18,125,"Indiana","Pike County",3,28,131,64,67
050,18,125,"Indiana","Pike County",3,29,156,74,82
050,18,125,"Indiana","Pike County",3,30,148,83,65
050,18,125,"Indiana","Pike County",3,31,139,73,66
050,18,125,"Indiana","Pike County",3,32,154,79,75
050,18,125,"Indiana","Pike County",3,33,129,68,61
050,18,125,"Indiana","Pike County",3,34,135,69,66
050,18,125,"Indiana","Pike County",3,35,139,76,63
050,18,125,"Indiana","Pike County",3,36,137,71,66
050,18,125,"Indiana","Pike County",3,37,133,66,67
050,18,125,"Indiana","Pike County",3,38,146,75,71
050,18,125,"Indiana","Pike County",3,39,145,76,69
050,18,125,"Indiana","Pike County",3,40,148,82,66
050,18,125,"Indiana","Pike County",3,41,141,67,74
050,18,125,"Indiana","Pike County",3,42,120,61,59
050,18,125,"Indiana","Pike County",3,43,126,67,59
050,18,125,"Indiana","Pike County",3,44,137,70,67
050,18,125,"Indiana","Pike County",3,45,137,69,68
050,18,125,"Indiana","Pike County",3,46,158,83,75
050,18,125,"Indiana","Pike County",3,47,154,77,77
050,18,125,"Indiana","Pike County",3,48,147,77,70
050,18,125,"Indiana","Pike County",3,49,143,76,67
050,18,125,"Indiana","Pike County",3,50,169,84,85
050,18,125,"Indiana","Pike County",3,51,165,82,83
050,18,125,"Indiana","Pike County",3,52,160,78,82
050,18,125,"Indiana","Pike County",3,53,147,72,75
050,18,125,"Indiana","Pike County",3,54,145,79,66
050,18,125,"Indiana","Pike County",3,55,157,85,72
050,18,125,"Indiana","Pike County",3,56,168,86,82
050,18,125,"Indiana","Pike County",3,57,196,97,99
050,18,125,"Indiana","Pike County",3,58,196,100,96
050,18,125,"Indiana","Pike County",3,59,200,97,103
050,18,125,"Indiana","Pike County",3,60,194,94,100
050,18,125,"Indiana","Pike County",3,61,183,97,86
050,18,125,"Indiana","Pike County",3,62,179,91,88
050,18,125,"Indiana","Pike County",3,63,204,104,100
050,18,125,"Indiana","Pike County",3,64,200,103,97
050,18,125,"Indiana","Pike County",3,65,171,87,84
050,18,125,"Indiana","Pike County",3,66,164,92,72
050,18,125,"Indiana","Pike County",3,67,155,83,72
050,18,125,"Indiana","Pike County",3,68,154,85,69
050,18,125,"Indiana","Pike County",3,69,145,78,67
050,18,125,"Indiana","Pike County",3,70,139,64,75
050,18,125,"Indiana","Pike County",3,71,135,71,64
050,18,125,"Indiana","Pike County",3,72,143,73,70
050,18,125,"Indiana","Pike County",3,73,139,66,73
050,18,125,"Indiana","Pike County",3,74,138,63,75
050,18,125,"Indiana","Pike County",3,75,96,42,54
050,18,125,"Indiana","Pike County",3,76,94,44,50
050,18,125,"Indiana","Pike County",3,77,87,38,49
050,18,125,"Indiana","Pike County",3,78,88,42,46
050,18,125,"Indiana","Pike County",3,79,75,37,38
050,18,125,"Indiana","Pike County",3,80,72,41,31
050,18,125,"Indiana","Pike County",3,81,67,30,37
050,18,125,"Indiana","Pike County",3,82,61,28,33
050,18,125,"Indiana","Pike County",3,83,61,26,35
050,18,125,"Indiana","Pike County",3,84,53,23,30
050,18,125,"Indiana","Pike County",3,85,258,89,169
050,18,125,"Indiana","Pike County",4,0,130,73,57
050,18,125,"Indiana","Pike County",4,1,139,82,57
050,18,125,"Indiana","Pike County",4,2,139,68,71
050,18,125,"Indiana","Pike County",4,3,154,67,87
050,18,125,"Indiana","Pike County",4,4,155,73,82
050,18,125,"Indiana","Pike County",4,5,133,68,65
050,18,125,"Indiana","Pike County",4,6,151,76,75
050,18,125,"Indiana","Pike County",4,7,155,75,80
050,18,125,"Indiana","Pike County",4,8,159,91,68
050,18,125,"Indiana","Pike County",4,9,141,77,64
050,18,125,"Indiana","Pike County",4,10,148,78,70
050,18,125,"Indiana","Pike County",4,11,165,82,83
050,18,125,"Indiana","Pike County",4,12,148,74,74
050,18,125,"Indiana","Pike County",4,13,146,71,75
050,18,125,"Indiana","Pike County",4,14,147,76,71
050,18,125,"Indiana","Pike County",4,15,166,90,76
050,18,125,"Indiana","Pike County",4,16,164,86,78
050,18,125,"Indiana","Pike County",4,17,154,76,78
050,18,125,"Indiana","Pike County",4,18,133,62,71
050,18,125,"Indiana","Pike County",4,19,96,48,48
050,18,125,"Indiana","Pike County",4,20,104,60,44
050,18,125,"Indiana","Pike County",4,21,124,66,58
050,18,125,"Indiana","Pike County",4,22,131,68,63
050,18,125,"Indiana","Pike County",4,23,133,55,78
050,18,125,"Indiana","Pike County",4,24,114,58,56
050,18,125,"Indiana","Pike County",4,25,117,63,54
050,18,125,"Indiana","Pike County",4,26,128,67,61
050,18,125,"Indiana","Pike County",4,27,139,78,61
050,18,125,"Indiana","Pike County",4,28,133,65,68
050,18,125,"Indiana","Pike County",4,29,134,64,70
050,18,125,"Indiana","Pike County",4,30,150,76,74
050,18,125,"Indiana","Pike County",4,31,147,83,64
050,18,125,"Indiana","Pike County",4,32,145,77,68
050,18,125,"Indiana","Pike County",4,33,162,84,78
050,18,125,"Indiana","Pike County",4,34,132,72,60
050,18,125,"Indiana","Pike County",4,35,126,63,63
050,18,125,"Indiana","Pike County",4,36,134,76,58
050,18,125,"Indiana","Pike County",4,37,136,69,67
050,18,125,"Indiana","Pike County",4,38,138,70,68
050,18,125,"Indiana","Pike County",4,39,142,77,65
050,18,125,"Indiana","Pike County",4,40,150,80,70
050,18,125,"Indiana","Pike County",4,41,148,83,65
050,18,125,"Indiana","Pike County",4,42,141,68,73
050,18,125,"Indiana","Pike County",4,43,112,55,57
050,18,125,"Indiana","Pike County",4,44,135,73,62
050,18,125,"Indiana","Pike County",4,45,139,69,70
050,18,125,"Indiana","Pike County",4,46,136,68,68
050,18,125,"Indiana","Pike County",4,47,157,77,80
050,18,125,"Indiana","Pike County",4,48,152,77,75
050,18,125,"Indiana","Pike County",4,49,148,74,74
050,18,125,"Indiana","Pike County",4,50,145,80,65
050,18,125,"Indiana","Pike County",4,51,173,90,83
050,18,125,"Indiana","Pike County",4,52,160,76,84
050,18,125,"Indiana","Pike County",4,53,156,77,79
050,18,125,"Indiana","Pike County",4,54,150,75,75
050,18,125,"Indiana","Pike County",4,55,143,80,63
050,18,125,"Indiana","Pike County",4,56,160,86,74
050,18,125,"Indiana","Pike County",4,57,173,84,89
050,18,125,"Indiana","Pike County",4,58,183,94,89
050,18,125,"Indiana","Pike County",4,59,199,100,99
050,18,125,"Indiana","Pike County",4,60,202,100,102
050,18,125,"Indiana","Pike County",4,61,188,95,93
050,18,125,"Indiana","Pike County",4,62,178,94,84
050,18,125,"Indiana","Pike County",4,63,174,86,88
050,18,125,"Indiana","Pike County",4,64,197,103,94
050,18,125,"Indiana","Pike County",4,65,183,94,89
050,18,125,"Indiana","Pike County",4,66,168,86,82
050,18,125,"Indiana","Pike County",4,67,159,91,68
050,18,125,"Indiana","Pike County",4,68,155,83,72
050,18,125,"Indiana","Pike County",4,69,155,86,69
050,18,125,"Indiana","Pike County",4,70,150,80,70
050,18,125,"Indiana","Pike County",4,71,134,64,70
050,18,125,"Indiana","Pike County",4,72,132,67,65
050,18,125,"Indiana","Pike County",4,73,140,74,66
050,18,125,"Indiana","Pike County",4,74,131,59,72
050,18,125,"Indiana","Pike County",4,75,130,61,69
050,18,125,"Indiana","Pike County",4,76,91,35,56
050,18,125,"Indiana","Pike County",4,77,93,41,52
050,18,125,"Indiana","Pike County",4,78,78,38,40
050,18,125,"Indiana","Pike County",4,79,80,39,41
050,18,125,"Indiana","Pike County",4,80,67,35,32
050,18,125,"Indiana","Pike County",4,81,70,39,31
050,18,125,"Indiana","Pike County",4,82,65,31,34
050,18,125,"Indiana","Pike County",4,83,56,23,33
050,18,125,"Indiana","Pike County",4,84,51,21,30
050,18,125,"Indiana","Pike County",4,85,264,90,174
050,18,125,"Indiana","Pike County",5,0,130,73,57
050,18,125,"Indiana","Pike County",5,1,125,69,56
050,18,125,"Indiana","Pike County",5,2,138,78,60
050,18,125,"Indiana","Pike County",5,3,145,74,71
050,18,125,"Indiana","Pike County",5,4,164,72,92
050,18,125,"Indiana","Pike County",5,5,156,74,82
050,18,125,"Indiana","Pike County",5,6,130,68,62
050,18,125,"Indiana","Pike County",5,7,149,72,77
050,18,125,"Indiana","Pike County",5,8,152,71,81
050,18,125,"Indiana","Pike County",5,9,158,87,71
050,18,125,"Indiana","Pike County",5,10,150,82,68
050,18,125,"Indiana","Pike County",5,11,147,74,73
050,18,125,"Indiana","Pike County",5,12,167,84,83
050,18,125,"Indiana","Pike County",5,13,147,73,74
050,18,125,"Indiana","Pike County",5,14,148,70,78
050,18,125,"Indiana","Pike County",5,15,155,78,77
050,18,125,"Indiana","Pike County",5,16,169,93,76
050,18,125,"Indiana","Pike County",5,17,159,86,73
050,18,125,"Indiana","Pike County",5,18,143,66,77
050,18,125,"Indiana","Pike County",5,19,105,49,56
050,18,125,"Indiana","Pike County",5,20,97,47,50
050,18,125,"Indiana","Pike County",5,21,115,66,49
050,18,125,"Indiana","Pike County",5,22,138,74,64
050,18,125,"Indiana","Pike County",5,23,131,68,63
050,18,125,"Indiana","Pike County",5,24,130,58,72
050,18,125,"Indiana","Pike County",5,25,110,54,56
050,18,125,"Indiana","Pike County",5,26,113,67,46
050,18,125,"Indiana","Pike County",5,27,122,60,62
050,18,125,"Indiana","Pike County",5,28,143,76,67
050,18,125,"Indiana","Pike County",5,29,132,65,67
050,18,125,"Indiana","Pike County",5,30,140,71,69
050,18,125,"Indiana","Pike County",5,31,146,76,70
050,18,125,"Indiana","Pike County",5,32,150,83,67
050,18,125,"Indiana","Pike County",5,33,142,76,66
050,18,125,"Indiana","Pike County",5,34,163,88,75
050,18,125,"Indiana","Pike County",5,35,140,74,66
050,18,125,"Indiana","Pike County",5,36,131,65,66
050,18,125,"Indiana","Pike County",5,37,134,77,57
050,18,125,"Indiana","Pike County",5,38,144,74,70
050,18,125,"Indiana","Pike County",5,39,130,67,63
050,18,125,"Indiana","Pike County",5,40,143,75,68
050,18,125,"Indiana","Pike County",5,41,163,86,77
050,18,125,"Indiana","Pike County",5,42,152,84,68
050,18,125,"Indiana","Pike County",5,43,136,65,71
050,18,125,"Indiana","Pike County",5,44,114,57,57
050,18,125,"Indiana","Pike County",5,45,131,69,62
050,18,125,"Indiana","Pike County",5,46,135,69,66
050,18,125,"Indiana","Pike County",5,47,129,67,62
050,18,125,"Indiana","Pike County",5,48,160,78,82
050,18,125,"Indiana","Pike County",5,49,153,76,77
050,18,125,"Indiana","Pike County",5,50,145,72,73
050,18,125,"Indiana","Pike County",5,51,149,84,65
050,18,125,"Indiana","Pike County",5,52,170,89,81
050,18,125,"Indiana","Pike County",5,53,166,81,85
050,18,125,"Indiana","Pike County",5,54,155,77,78
050,18,125,"Indiana","Pike County",5,55,150,75,75
050,18,125,"Indiana","Pike County",5,56,135,77,58
050,18,125,"Indiana","Pike County",5,57,161,83,78
050,18,125,"Indiana","Pike County",5,58,165,84,81
050,18,125,"Indiana","Pike County",5,59,180,91,89
050,18,125,"Indiana","Pike County",5,60,196,97,99
050,18,125,"Indiana","Pike County",5,61,198,97,101
050,18,125,"Indiana","Pike County",5,62,183,93,90
050,18,125,"Indiana","Pike County",5,63,177,92,85
050,18,125,"Indiana","Pike County",5,64,173,88,85
050,18,125,"Indiana","Pike County",5,65,190,102,88
050,18,125,"Indiana","Pike County",5,66,186,92,94
050,18,125,"Indiana","Pike County",5,67,163,83,80
050,18,125,"Indiana","Pike County",5,68,155,88,67
050,18,125,"Indiana","Pike County",5,69,157,86,71
050,18,125,"Indiana","Pike County",5,70,157,83,74
050,18,125,"Indiana","Pike County",5,71,143,78,65
050,18,125,"Indiana","Pike County",5,72,129,60,69
050,18,125,"Indiana","Pike County",5,73,126,64,62
050,18,125,"Indiana","Pike County",5,74,133,68,65
050,18,125,"Indiana","Pike County",5,75,119,56,63
050,18,125,"Indiana","Pike County",5,76,122,50,72
050,18,125,"Indiana","Pike County",5,77,91,34,57
050,18,125,"Indiana","Pike County",5,78,82,38,44
050,18,125,"Indiana","Pike County",5,79,68,34,34
050,18,125,"Indiana","Pike County",5,80,69,36,33
050,18,125,"Indiana","Pike County",5,81,63,32,31
050,18,125,"Indiana","Pike County",5,82,67,39,28
050,18,125,"Indiana","Pike County",5,83,59,26,33
050,18,125,"Indiana","Pike County",5,84,48,19,29
050,18,125,"Indiana","Pike County",5,85,272,91,181
050,18,127,"Indiana","Porter County",1,0,1658,843,815
050,18,127,"Indiana","Porter County",1,1,1720,837,883
050,18,127,"Indiana","Porter County",1,2,1801,937,864
050,18,127,"Indiana","Porter County",1,3,1887,975,912
050,18,127,"Indiana","Porter County",1,4,2014,993,1021
050,18,127,"Indiana","Porter County",1,5,2050,1054,996
050,18,127,"Indiana","Porter County",1,6,2065,1073,992
050,18,127,"Indiana","Porter County",1,7,2037,1034,1003
050,18,127,"Indiana","Porter County",1,8,2104,1118,986
050,18,127,"Indiana","Porter County",1,9,2054,1091,963
050,18,127,"Indiana","Porter County",1,10,2177,1135,1042
050,18,127,"Indiana","Porter County",1,11,2253,1150,1103
050,18,127,"Indiana","Porter County",1,12,2306,1168,1138
050,18,127,"Indiana","Porter County",1,13,2367,1204,1163
050,18,127,"Indiana","Porter County",1,14,2355,1216,1139
050,18,127,"Indiana","Porter County",1,15,2346,1219,1127
050,18,127,"Indiana","Porter County",1,16,2430,1252,1178
050,18,127,"Indiana","Porter County",1,17,2402,1246,1156
050,18,127,"Indiana","Porter County",1,18,2288,1222,1066
050,18,127,"Indiana","Porter County",1,19,2253,1190,1063
050,18,127,"Indiana","Porter County",1,20,2255,1140,1115
050,18,127,"Indiana","Porter County",1,21,2207,1116,1091
050,18,127,"Indiana","Porter County",1,22,2078,1062,1016
050,18,127,"Indiana","Porter County",1,23,2023,1044,979
050,18,127,"Indiana","Porter County",1,24,2037,1015,1022
050,18,127,"Indiana","Porter County",1,25,1993,998,995
050,18,127,"Indiana","Porter County",1,26,2006,1018,988
050,18,127,"Indiana","Porter County",1,27,2098,1078,1020
050,18,127,"Indiana","Porter County",1,28,2042,1038,1004
050,18,127,"Indiana","Porter County",1,29,2080,1035,1045
050,18,127,"Indiana","Porter County",1,30,2050,1032,1018
050,18,127,"Indiana","Porter County",1,31,2002,982,1020
050,18,127,"Indiana","Porter County",1,32,2044,1016,1028
050,18,127,"Indiana","Porter County",1,33,2129,1062,1067
050,18,127,"Indiana","Porter County",1,34,2211,1101,1110
050,18,127,"Indiana","Porter County",1,35,2291,1157,1134
050,18,127,"Indiana","Porter County",1,36,2259,1120,1139
050,18,127,"Indiana","Porter County",1,37,2435,1223,1212
050,18,127,"Indiana","Porter County",1,38,2391,1183,1208
050,18,127,"Indiana","Porter County",1,39,2466,1245,1221
050,18,127,"Indiana","Porter County",1,40,2379,1178,1201
050,18,127,"Indiana","Porter County",1,41,2358,1166,1192
050,18,127,"Indiana","Porter County",1,42,2317,1160,1157
050,18,127,"Indiana","Porter County",1,43,2254,1128,1126
050,18,127,"Indiana","Porter County",1,44,2178,1110,1068
050,18,127,"Indiana","Porter County",1,45,2165,1091,1074
050,18,127,"Indiana","Porter County",1,46,2113,1040,1073
050,18,127,"Indiana","Porter County",1,47,2151,1068,1083
050,18,127,"Indiana","Porter County",1,48,2338,1211,1127
050,18,127,"Indiana","Porter County",1,49,2552,1291,1261
050,18,127,"Indiana","Porter County",1,50,2299,1155,1144
050,18,127,"Indiana","Porter County",1,51,2144,1075,1069
050,18,127,"Indiana","Porter County",1,52,2087,1056,1031
050,18,127,"Indiana","Porter County",1,53,2225,1087,1138
050,18,127,"Indiana","Porter County",1,54,2255,1122,1133
050,18,127,"Indiana","Porter County",1,55,2285,1140,1145
050,18,127,"Indiana","Porter County",1,56,2304,1154,1150
050,18,127,"Indiana","Porter County",1,57,2330,1138,1192
050,18,127,"Indiana","Porter County",1,58,2415,1167,1248
050,18,127,"Indiana","Porter County",1,59,2522,1195,1327
050,18,127,"Indiana","Porter County",1,60,2477,1189,1288
050,18,127,"Indiana","Porter County",1,61,2507,1226,1281
050,18,127,"Indiana","Porter County",1,62,2486,1194,1292
050,18,127,"Indiana","Porter County",1,63,2447,1177,1270
050,18,127,"Indiana","Porter County",1,64,2381,1173,1208
050,18,127,"Indiana","Porter County",1,65,2327,1145,1182
050,18,127,"Indiana","Porter County",1,66,2188,1096,1092
050,18,127,"Indiana","Porter County",1,67,2081,1024,1057
050,18,127,"Indiana","Porter County",1,68,2024,1003,1021
050,18,127,"Indiana","Porter County",1,69,1873,908,965
050,18,127,"Indiana","Porter County",1,70,1806,853,953
050,18,127,"Indiana","Porter County",1,71,1696,799,897
050,18,127,"Indiana","Porter County",1,72,1665,808,857
050,18,127,"Indiana","Porter County",1,73,1674,789,885
050,18,127,"Indiana","Porter County",1,74,1186,582,604
050,18,127,"Indiana","Porter County",1,75,1135,530,605
050,18,127,"Indiana","Porter County",1,76,1063,493,570
050,18,127,"Indiana","Porter County",1,77,1089,504,585
050,18,127,"Indiana","Porter County",1,78,874,400,474
050,18,127,"Indiana","Porter County",1,79,764,357,407
050,18,127,"Indiana","Porter County",1,80,733,338,395
050,18,127,"Indiana","Porter County",1,81,697,295,402
050,18,127,"Indiana","Porter County",1,82,630,248,382
050,18,127,"Indiana","Porter County",1,83,548,202,346
050,18,127,"Indiana","Porter County",1,84,481,179,302
050,18,127,"Indiana","Porter County",1,85,3040,993,2047
050,18,127,"Indiana","Porter County",2,0,1658,842,816
050,18,127,"Indiana","Porter County",2,1,1715,841,874
050,18,127,"Indiana","Porter County",2,2,1803,921,882
050,18,127,"Indiana","Porter County",2,3,1866,963,903
050,18,127,"Indiana","Porter County",2,4,1999,997,1002
050,18,127,"Indiana","Porter County",2,5,2055,1045,1010
050,18,127,"Indiana","Porter County",2,6,2075,1075,1000
050,18,127,"Indiana","Porter County",2,7,2046,1047,999
050,18,127,"Indiana","Porter County",2,8,2089,1097,992
050,18,127,"Indiana","Porter County",2,9,2072,1100,972
050,18,127,"Indiana","Porter County",2,10,2153,1126,1027
050,18,127,"Indiana","Porter County",2,11,2231,1141,1090
050,18,127,"Indiana","Porter County",2,12,2305,1168,1137
050,18,127,"Indiana","Porter County",2,13,2353,1199,1154
050,18,127,"Indiana","Porter County",2,14,2359,1210,1149
050,18,127,"Indiana","Porter County",2,15,2352,1218,1134
050,18,127,"Indiana","Porter County",2,16,2409,1243,1166
050,18,127,"Indiana","Porter County",2,17,2409,1248,1161
050,18,127,"Indiana","Porter County",2,18,2256,1200,1056
050,18,127,"Indiana","Porter County",2,19,2254,1193,1061
050,18,127,"Indiana","Porter County",2,20,2282,1160,1122
050,18,127,"Indiana","Porter County",2,21,2219,1121,1098
050,18,127,"Indiana","Porter County",2,22,2087,1072,1015
050,18,127,"Indiana","Porter County",2,23,2027,1041,986
050,18,127,"Indiana","Porter County",2,24,2030,1018,1012
050,18,127,"Indiana","Porter County",2,25,2009,1002,1007
050,18,127,"Indiana","Porter County",2,26,2023,1024,999
050,18,127,"Indiana","Porter County",2,27,2073,1063,1010
050,18,127,"Indiana","Porter County",2,28,2062,1048,1014
050,18,127,"Indiana","Porter County",2,29,2072,1039,1033
050,18,127,"Indiana","Porter County",2,30,2075,1039,1036
050,18,127,"Indiana","Porter County",2,31,2005,991,1014
050,18,127,"Indiana","Porter County",2,32,2030,1004,1026
050,18,127,"Indiana","Porter County",2,33,2115,1052,1063
050,18,127,"Indiana","Porter County",2,34,2206,1099,1107
050,18,127,"Indiana","Porter County",2,35,2283,1148,1135
050,18,127,"Indiana","Porter County",2,36,2266,1128,1138
050,18,127,"Indiana","Porter County",2,37,2399,1202,1197
050,18,127,"Indiana","Porter County",2,38,2422,1200,1222
050,18,127,"Indiana","Porter County",2,39,2441,1225,1216
050,18,127,"Indiana","Porter County",2,40,2418,1206,1212
050,18,127,"Indiana","Porter County",2,41,2360,1169,1191
050,18,127,"Indiana","Porter County",2,42,2317,1161,1156
050,18,127,"Indiana","Porter County",2,43,2282,1143,1139
050,18,127,"Indiana","Porter County",2,44,2179,1103,1076
050,18,127,"Indiana","Porter County",2,45,2178,1099,1079
050,18,127,"Indiana","Porter County",2,46,2119,1047,1072
050,18,127,"Indiana","Porter County",2,47,2139,1062,1077
050,18,127,"Indiana","Porter County",2,48,2292,1174,1118
050,18,127,"Indiana","Porter County",2,49,2511,1277,1234
050,18,127,"Indiana","Porter County",2,50,2363,1189,1174
050,18,127,"Indiana","Porter County",2,51,2180,1090,1090
050,18,127,"Indiana","Porter County",2,52,2096,1057,1039
050,18,127,"Indiana","Porter County",2,53,2194,1079,1115
050,18,127,"Indiana","Porter County",2,54,2234,1106,1128
050,18,127,"Indiana","Porter County",2,55,2272,1131,1141
050,18,127,"Indiana","Porter County",2,56,2300,1151,1149
050,18,127,"Indiana","Porter County",2,57,2324,1141,1183
050,18,127,"Indiana","Porter County",2,58,2393,1157,1236
050,18,127,"Indiana","Porter County",2,59,2499,1188,1311
050,18,127,"Indiana","Porter County",2,60,2481,1188,1293
050,18,127,"Indiana","Porter County",2,61,2487,1207,1280
050,18,127,"Indiana","Porter County",2,62,2481,1197,1284
050,18,127,"Indiana","Porter County",2,63,2478,1191,1287
050,18,127,"Indiana","Porter County",2,64,2376,1163,1213
050,18,127,"Indiana","Porter County",2,65,2328,1145,1183
050,18,127,"Indiana","Porter County",2,66,2225,1109,1116
050,18,127,"Indiana","Porter County",2,67,2101,1039,1062
050,18,127,"Indiana","Porter County",2,68,2009,994,1015
050,18,127,"Indiana","Porter County",2,69,1909,924,985
050,18,127,"Indiana","Porter County",2,70,1797,852,945
050,18,127,"Indiana","Porter County",2,71,1714,808,906
050,18,127,"Indiana","Porter County",2,72,1637,787,850
050,18,127,"Indiana","Porter County",2,73,1739,824,915
050,18,127,"Indiana","Porter County",2,74,1219,590,629
050,18,127,"Indiana","Porter County",2,75,1140,541,599
050,18,127,"Indiana","Porter County",2,76,1061,498,563
050,18,127,"Indiana","Porter County",2,77,1089,509,580
050,18,127,"Indiana","Porter County",2,78,895,405,490
050,18,127,"Indiana","Porter County",2,79,780,364,416
050,18,127,"Indiana","Porter County",2,80,737,341,396
050,18,127,"Indiana","Porter County",2,81,688,295,393
050,18,127,"Indiana","Porter County",2,82,639,255,384
050,18,127,"Indiana","Porter County",2,83,552,206,346
050,18,127,"Indiana","Porter County",2,84,490,182,308
050,18,127,"Indiana","Porter County",2,85,3031,988,2043
050,18,127,"Indiana","Porter County",3,0,1587,822,765
050,18,127,"Indiana","Porter County",3,1,1719,889,830
050,18,127,"Indiana","Porter County",3,2,1805,907,898
050,18,127,"Indiana","Porter County",3,3,1836,937,899
050,18,127,"Indiana","Porter County",3,4,1856,949,907
050,18,127,"Indiana","Porter County",3,5,2066,1037,1029
050,18,127,"Indiana","Porter County",3,6,2087,1067,1020
050,18,127,"Indiana","Porter County",3,7,2102,1098,1004
050,18,127,"Indiana","Porter County",3,8,2066,1071,995
050,18,127,"Indiana","Porter County",3,9,2138,1115,1023
050,18,127,"Indiana","Porter County",3,10,2077,1105,972
050,18,127,"Indiana","Porter County",3,11,2204,1151,1053
050,18,127,"Indiana","Porter County",3,12,2238,1137,1101
050,18,127,"Indiana","Porter County",3,13,2338,1194,1144
050,18,127,"Indiana","Porter County",3,14,2400,1224,1176
050,18,127,"Indiana","Porter County",3,15,2369,1221,1148
050,18,127,"Indiana","Porter County",3,16,2377,1235,1142
050,18,127,"Indiana","Porter County",3,17,2436,1265,1171
050,18,127,"Indiana","Porter County",3,18,2198,1146,1052
050,18,127,"Indiana","Porter County",3,19,2230,1180,1050
050,18,127,"Indiana","Porter County",3,20,2311,1179,1132
050,18,127,"Indiana","Porter County",3,21,2266,1140,1126
050,18,127,"Indiana","Porter County",3,22,2164,1106,1058
050,18,127,"Indiana","Porter County",3,23,2039,1028,1011
050,18,127,"Indiana","Porter County",3,24,2038,1049,989
050,18,127,"Indiana","Porter County",3,25,2068,1026,1042
050,18,127,"Indiana","Porter County",3,26,2059,1024,1035
050,18,127,"Indiana","Porter County",3,27,2069,1052,1017
050,18,127,"Indiana","Porter County",3,28,2092,1091,1001
050,18,127,"Indiana","Porter County",3,29,2081,1055,1026
050,18,127,"Indiana","Porter County",3,30,2127,1062,1065
050,18,127,"Indiana","Porter County",3,31,2111,1058,1053
050,18,127,"Indiana","Porter County",3,32,2037,1015,1022
050,18,127,"Indiana","Porter County",3,33,2061,1021,1040
050,18,127,"Indiana","Porter County",3,34,2199,1111,1088
050,18,127,"Indiana","Porter County",3,35,2254,1117,1137
050,18,127,"Indiana","Porter County",3,36,2294,1154,1140
050,18,127,"Indiana","Porter County",3,37,2338,1165,1173
050,18,127,"Indiana","Porter County",3,38,2454,1214,1240
050,18,127,"Indiana","Porter County",3,39,2452,1205,1247
050,18,127,"Indiana","Porter County",3,40,2469,1246,1223
050,18,127,"Indiana","Porter County",3,41,2458,1214,1244
050,18,127,"Indiana","Porter County",3,42,2389,1192,1197
050,18,127,"Indiana","Porter County",3,43,2302,1154,1148
050,18,127,"Indiana","Porter County",3,44,2295,1163,1132
050,18,127,"Indiana","Porter County",3,45,2216,1101,1115
050,18,127,"Indiana","Porter County",3,46,2231,1125,1106
050,18,127,"Indiana","Porter County",3,47,2126,1060,1066
050,18,127,"Indiana","Porter County",3,48,2155,1075,1080
050,18,127,"Indiana","Porter County",3,49,2295,1164,1131
050,18,127,"Indiana","Porter County",3,50,2512,1284,1228
050,18,127,"Indiana","Porter County",3,51,2378,1196,1182
050,18,127,"Indiana","Porter County",3,52,2171,1100,1071
050,18,127,"Indiana","Porter County",3,53,2096,1050,1046
050,18,127,"Indiana","Porter County",3,54,2185,1075,1110
050,18,127,"Indiana","Porter County",3,55,2249,1111,1138
050,18,127,"Indiana","Porter County",3,56,2279,1144,1135
050,18,127,"Indiana","Porter County",3,57,2305,1147,1158
050,18,127,"Indiana","Porter County",3,58,2324,1151,1173
050,18,127,"Indiana","Porter County",3,59,2388,1163,1225
050,18,127,"Indiana","Porter County",3,60,2447,1161,1286
050,18,127,"Indiana","Porter County",3,61,2442,1159,1283
050,18,127,"Indiana","Porter County",3,62,2457,1202,1255
050,18,127,"Indiana","Porter County",3,63,2464,1174,1290
050,18,127,"Indiana","Porter County",3,64,2428,1162,1266
050,18,127,"Indiana","Porter County",3,65,2346,1142,1204
050,18,127,"Indiana","Porter County",3,66,2280,1117,1163
050,18,127,"Indiana","Porter County",3,67,2193,1093,1100
050,18,127,"Indiana","Porter County",3,68,2049,1004,1045
050,18,127,"Indiana","Porter County",3,69,1965,961,1004
050,18,127,"Indiana","Porter County",3,70,1860,895,965
050,18,127,"Indiana","Porter County",3,71,1772,842,930
050,18,127,"Indiana","Porter County",3,72,1667,776,891
050,18,127,"Indiana","Porter County",3,73,1611,776,835
050,18,127,"Indiana","Porter County",3,74,1693,801,892
050,18,127,"Indiana","Porter County",3,75,1171,558,613
050,18,127,"Indiana","Porter County",3,76,1102,521,581
050,18,127,"Indiana","Porter County",3,77,1015,477,538
050,18,127,"Indiana","Porter County",3,78,1036,469,567
050,18,127,"Indiana","Porter County",3,79,854,386,468
050,18,127,"Indiana","Porter County",3,80,768,358,410
050,18,127,"Indiana","Porter County",3,81,693,309,384
050,18,127,"Indiana","Porter County",3,82,659,276,383
050,18,127,"Indiana","Porter County",3,83,592,230,362
050,18,127,"Indiana","Porter County",3,84,515,190,325
050,18,127,"Indiana","Porter County",3,85,3006,958,2048
050,18,127,"Indiana","Porter County",4,0,1679,892,787
050,18,127,"Indiana","Porter County",4,1,1619,840,779
050,18,127,"Indiana","Porter County",4,2,1787,916,871
050,18,127,"Indiana","Porter County",4,3,1827,921,906
050,18,127,"Indiana","Porter County",4,4,1871,950,921
050,18,127,"Indiana","Porter County",4,5,1914,983,931
050,18,127,"Indiana","Porter County",4,6,2108,1062,1046
050,18,127,"Indiana","Porter County",4,7,2139,1099,1040
050,18,127,"Indiana","Porter County",4,8,2155,1125,1030
050,18,127,"Indiana","Porter County",4,9,2105,1074,1031
050,18,127,"Indiana","Porter County",4,10,2131,1106,1025
050,18,127,"Indiana","Porter County",4,11,2119,1119,1000
050,18,127,"Indiana","Porter County",4,12,2237,1172,1065
050,18,127,"Indiana","Porter County",4,13,2217,1121,1096
050,18,127,"Indiana","Porter County",4,14,2350,1200,1150
050,18,127,"Indiana","Porter County",4,15,2397,1228,1169
050,18,127,"Indiana","Porter County",4,16,2362,1213,1149
050,18,127,"Indiana","Porter County",4,17,2380,1238,1142
050,18,127,"Indiana","Porter County",4,18,2208,1166,1042
050,18,127,"Indiana","Porter County",4,19,2136,1136,1000
050,18,127,"Indiana","Porter County",4,20,2224,1149,1075
050,18,127,"Indiana","Porter County",4,21,2312,1152,1160
050,18,127,"Indiana","Porter County",4,22,2194,1098,1096
050,18,127,"Indiana","Porter County",4,23,2070,1035,1035
050,18,127,"Indiana","Porter County",4,24,1991,1005,986
050,18,127,"Indiana","Porter County",4,25,2008,1022,986
050,18,127,"Indiana","Porter County",4,26,2061,1035,1026
050,18,127,"Indiana","Porter County",4,27,2116,1067,1049
050,18,127,"Indiana","Porter County",4,28,2050,1030,1020
050,18,127,"Indiana","Porter County",4,29,2121,1093,1028
050,18,127,"Indiana","Porter County",4,30,2140,1066,1074
050,18,127,"Indiana","Porter County",4,31,2163,1078,1085
050,18,127,"Indiana","Porter County",4,32,2135,1078,1057
050,18,127,"Indiana","Porter County",4,33,2099,1042,1057
050,18,127,"Indiana","Porter County",4,34,2136,1058,1078
050,18,127,"Indiana","Porter County",4,35,2208,1096,1112
050,18,127,"Indiana","Porter County",4,36,2284,1148,1136
050,18,127,"Indiana","Porter County",4,37,2326,1160,1166
050,18,127,"Indiana","Porter County",4,38,2368,1193,1175
050,18,127,"Indiana","Porter County",4,39,2478,1222,1256
050,18,127,"Indiana","Porter County",4,40,2457,1188,1269
050,18,127,"Indiana","Porter County",4,41,2513,1260,1253
050,18,127,"Indiana","Porter County",4,42,2491,1248,1243
050,18,127,"Indiana","Porter County",4,43,2370,1178,1192
050,18,127,"Indiana","Porter County",4,44,2303,1168,1135
050,18,127,"Indiana","Porter County",4,45,2288,1165,1123
050,18,127,"Indiana","Porter County",4,46,2211,1095,1116
050,18,127,"Indiana","Porter County",4,47,2247,1143,1104
050,18,127,"Indiana","Porter County",4,48,2116,1043,1073
050,18,127,"Indiana","Porter County",4,49,2154,1065,1089
050,18,127,"Indiana","Porter County",4,50,2262,1153,1109
050,18,127,"Indiana","Porter County",4,51,2540,1292,1248
050,18,127,"Indiana","Porter County",4,52,2360,1187,1173
050,18,127,"Indiana","Porter County",4,53,2156,1094,1062
050,18,127,"Indiana","Porter County",4,54,2073,1040,1033
050,18,127,"Indiana","Porter County",4,55,2147,1060,1087
050,18,127,"Indiana","Porter County",4,56,2216,1070,1146
050,18,127,"Indiana","Porter County",4,57,2244,1127,1117
050,18,127,"Indiana","Porter County",4,58,2249,1131,1118
050,18,127,"Indiana","Porter County",4,59,2292,1116,1176
050,18,127,"Indiana","Porter County",4,60,2358,1144,1214
050,18,127,"Indiana","Porter County",4,61,2409,1146,1263
050,18,127,"Indiana","Porter County",4,62,2420,1144,1276
050,18,127,"Indiana","Porter County",4,63,2410,1167,1243
050,18,127,"Indiana","Porter County",4,64,2430,1152,1278
050,18,127,"Indiana","Porter County",4,65,2395,1130,1265
050,18,127,"Indiana","Porter County",4,66,2320,1123,1197
050,18,127,"Indiana","Porter County",4,67,2264,1112,1152
050,18,127,"Indiana","Porter County",4,68,2141,1053,1088
050,18,127,"Indiana","Porter County",4,69,2011,987,1024
050,18,127,"Indiana","Porter County",4,70,1918,928,990
050,18,127,"Indiana","Porter County",4,71,1826,864,962
050,18,127,"Indiana","Porter County",4,72,1721,814,907
050,18,127,"Indiana","Porter County",4,73,1632,749,883
050,18,127,"Indiana","Porter County",4,74,1554,751,803
050,18,127,"Indiana","Porter County",4,75,1598,750,848
050,18,127,"Indiana","Porter County",4,76,1129,533,596
050,18,127,"Indiana","Porter County",4,77,1063,504,559
050,18,127,"Indiana","Porter County",4,78,945,430,515
050,18,127,"Indiana","Porter County",4,79,981,444,537
050,18,127,"Indiana","Porter County",4,80,840,380,460
050,18,127,"Indiana","Porter County",4,81,717,328,389
050,18,127,"Indiana","Porter County",4,82,634,282,352
050,18,127,"Indiana","Porter County",4,83,613,252,361
050,18,127,"Indiana","Porter County",4,84,557,210,347
050,18,127,"Indiana","Porter County",4,85,3048,966,2082
050,18,127,"Indiana","Porter County",5,0,1695,900,795
050,18,127,"Indiana","Porter County",5,1,1727,916,811
050,18,127,"Indiana","Porter County",5,2,1683,870,813
050,18,127,"Indiana","Porter County",5,3,1842,954,888
050,18,127,"Indiana","Porter County",5,4,1857,945,912
050,18,127,"Indiana","Porter County",5,5,1899,965,934
050,18,127,"Indiana","Porter County",5,6,1924,969,955
050,18,127,"Indiana","Porter County",5,7,2127,1061,1066
050,18,127,"Indiana","Porter County",5,8,2156,1111,1045
050,18,127,"Indiana","Porter County",5,9,2183,1144,1039
050,18,127,"Indiana","Porter County",5,10,2115,1087,1028
050,18,127,"Indiana","Porter County",5,11,2146,1134,1012
050,18,127,"Indiana","Porter County",5,12,2100,1105,995
050,18,127,"Indiana","Porter County",5,13,2222,1164,1058
050,18,127,"Indiana","Porter County",5,14,2245,1131,1114
050,18,127,"Indiana","Porter County",5,15,2340,1209,1131
050,18,127,"Indiana","Porter County",5,16,2424,1234,1190
050,18,127,"Indiana","Porter County",5,17,2346,1213,1133
050,18,127,"Indiana","Porter County",5,18,2181,1144,1037
050,18,127,"Indiana","Porter County",5,19,2160,1157,1003
050,18,127,"Indiana","Porter County",5,20,2196,1128,1068
050,18,127,"Indiana","Porter County",5,21,2255,1150,1105
050,18,127,"Indiana","Porter County",5,22,2277,1127,1150
050,18,127,"Indiana","Porter County",5,23,2110,1058,1052
050,18,127,"Indiana","Porter County",5,24,2017,1009,1008
050,18,127,"Indiana","Porter County",5,25,1965,1001,964
050,18,127,"Indiana","Porter County",5,26,2056,1064,992
050,18,127,"Indiana","Porter County",5,27,2046,1011,1035
050,18,127,"Indiana","Porter County",5,28,2115,1079,1036
050,18,127,"Indiana","Porter County",5,29,2047,1029,1018
050,18,127,"Indiana","Porter County",5,30,2192,1116,1076
050,18,127,"Indiana","Porter County",5,31,2190,1091,1099
050,18,127,"Indiana","Porter County",5,32,2184,1093,1091
050,18,127,"Indiana","Porter County",5,33,2160,1093,1067
050,18,127,"Indiana","Porter County",5,34,2167,1081,1086
050,18,127,"Indiana","Porter County",5,35,2137,1057,1080
050,18,127,"Indiana","Porter County",5,36,2213,1110,1103
050,18,127,"Indiana","Porter County",5,37,2280,1137,1143
050,18,127,"Indiana","Porter County",5,38,2314,1163,1151
050,18,127,"Indiana","Porter County",5,39,2372,1205,1167
050,18,127,"Indiana","Porter County",5,40,2480,1239,1241
050,18,127,"Indiana","Porter County",5,41,2468,1194,1274
050,18,127,"Indiana","Porter County",5,42,2535,1269,1266
050,18,127,"Indiana","Porter County",5,43,2470,1227,1243
050,18,127,"Indiana","Porter County",5,44,2389,1197,1192
050,18,127,"Indiana","Porter County",5,45,2319,1176,1143
050,18,127,"Indiana","Porter County",5,46,2282,1150,1132
050,18,127,"Indiana","Porter County",5,47,2212,1106,1106
050,18,127,"Indiana","Porter County",5,48,2256,1146,1110
050,18,127,"Indiana","Porter County",5,49,2110,1037,1073
050,18,127,"Indiana","Porter County",5,50,2119,1051,1068
050,18,127,"Indiana","Porter County",5,51,2290,1161,1129
050,18,127,"Indiana","Porter County",5,52,2586,1317,1269
050,18,127,"Indiana","Porter County",5,53,2337,1171,1166
050,18,127,"Indiana","Porter County",5,54,2155,1107,1048
050,18,127,"Indiana","Porter County",5,55,2059,1040,1019
050,18,127,"Indiana","Porter County",5,56,2104,1030,1074
050,18,127,"Indiana","Porter County",5,57,2205,1054,1151
050,18,127,"Indiana","Porter County",5,58,2227,1125,1102
050,18,127,"Indiana","Porter County",5,59,2263,1132,1131
050,18,127,"Indiana","Porter County",5,60,2258,1086,1172
050,18,127,"Indiana","Porter County",5,61,2310,1116,1194
050,18,127,"Indiana","Porter County",5,62,2379,1140,1239
050,18,127,"Indiana","Porter County",5,63,2377,1112,1265
050,18,127,"Indiana","Porter County",5,64,2379,1155,1224
050,18,127,"Indiana","Porter County",5,65,2397,1133,1264
050,18,127,"Indiana","Porter County",5,66,2350,1105,1245
050,18,127,"Indiana","Porter County",5,67,2299,1114,1185
050,18,127,"Indiana","Porter County",5,68,2224,1083,1141
050,18,127,"Indiana","Porter County",5,69,2104,1036,1068
050,18,127,"Indiana","Porter County",5,70,1987,971,1016
050,18,127,"Indiana","Porter County",5,71,1890,905,985
050,18,127,"Indiana","Porter County",5,72,1791,840,951
050,18,127,"Indiana","Porter County",5,73,1692,796,896
050,18,127,"Indiana","Porter County",5,74,1576,725,851
050,18,127,"Indiana","Porter County",5,75,1494,721,773
050,18,127,"Indiana","Porter County",5,76,1555,717,838
050,18,127,"Indiana","Porter County",5,77,1089,506,583
050,18,127,"Indiana","Porter County",5,78,1003,456,547
050,18,127,"Indiana","Porter County",5,79,903,414,489
050,18,127,"Indiana","Porter County",5,80,968,437,531
050,18,127,"Indiana","Porter County",5,81,790,351,439
050,18,127,"Indiana","Porter County",5,82,665,297,368
050,18,127,"Indiana","Porter County",5,83,599,262,337
050,18,127,"Indiana","Porter County",5,84,573,234,339
050,18,127,"Indiana","Porter County",5,85,3152,1019,2133
050,18,129,"Indiana","Posey County",1,0,268,140,128
050,18,129,"Indiana","Posey County",1,1,275,142,133
050,18,129,"Indiana","Posey County",1,2,270,138,132
050,18,129,"Indiana","Posey County",1,3,262,140,122
050,18,129,"Indiana","Posey County",1,4,287,159,128
050,18,129,"Indiana","Posey County",1,5,304,153,151
050,18,129,"Indiana","Posey County",1,6,299,147,152
050,18,129,"Indiana","Posey County",1,7,334,157,177
050,18,129,"Indiana","Posey County",1,8,343,164,179
050,18,129,"Indiana","Posey County",1,9,323,171,152
050,18,129,"Indiana","Posey County",1,10,326,155,171
050,18,129,"Indiana","Posey County",1,11,342,173,169
050,18,129,"Indiana","Posey County",1,12,331,167,164
050,18,129,"Indiana","Posey County",1,13,327,172,155
050,18,129,"Indiana","Posey County",1,14,333,177,156
050,18,129,"Indiana","Posey County",1,15,327,181,146
050,18,129,"Indiana","Posey County",1,16,355,194,161
050,18,129,"Indiana","Posey County",1,17,310,174,136
050,18,129,"Indiana","Posey County",1,18,280,158,122
050,18,129,"Indiana","Posey County",1,19,215,114,101
050,18,129,"Indiana","Posey County",1,20,228,116,112
050,18,129,"Indiana","Posey County",1,21,247,120,127
050,18,129,"Indiana","Posey County",1,22,261,127,134
050,18,129,"Indiana","Posey County",1,23,255,128,127
050,18,129,"Indiana","Posey County",1,24,267,130,137
050,18,129,"Indiana","Posey County",1,25,282,135,147
050,18,129,"Indiana","Posey County",1,26,272,147,125
050,18,129,"Indiana","Posey County",1,27,260,141,119
050,18,129,"Indiana","Posey County",1,28,278,141,137
050,18,129,"Indiana","Posey County",1,29,276,132,144
050,18,129,"Indiana","Posey County",1,30,294,149,145
050,18,129,"Indiana","Posey County",1,31,315,167,148
050,18,129,"Indiana","Posey County",1,32,301,153,148
050,18,129,"Indiana","Posey County",1,33,289,140,149
050,18,129,"Indiana","Posey County",1,34,326,164,162
050,18,129,"Indiana","Posey County",1,35,295,149,146
050,18,129,"Indiana","Posey County",1,36,267,127,140
050,18,129,"Indiana","Posey County",1,37,305,149,156
050,18,129,"Indiana","Posey County",1,38,303,162,141
050,18,129,"Indiana","Posey County",1,39,314,159,155
050,18,129,"Indiana","Posey County",1,40,323,169,154
050,18,129,"Indiana","Posey County",1,41,317,165,152
050,18,129,"Indiana","Posey County",1,42,318,176,142
050,18,129,"Indiana","Posey County",1,43,272,140,132
050,18,129,"Indiana","Posey County",1,44,287,143,144
050,18,129,"Indiana","Posey County",1,45,292,149,143
050,18,129,"Indiana","Posey County",1,46,272,131,141
050,18,129,"Indiana","Posey County",1,47,291,149,142
050,18,129,"Indiana","Posey County",1,48,320,164,156
050,18,129,"Indiana","Posey County",1,49,346,185,161
050,18,129,"Indiana","Posey County",1,50,341,166,175
050,18,129,"Indiana","Posey County",1,51,299,149,150
050,18,129,"Indiana","Posey County",1,52,301,155,146
050,18,129,"Indiana","Posey County",1,53,315,148,167
050,18,129,"Indiana","Posey County",1,54,349,171,178
050,18,129,"Indiana","Posey County",1,55,374,196,178
050,18,129,"Indiana","Posey County",1,56,402,206,196
050,18,129,"Indiana","Posey County",1,57,378,184,194
050,18,129,"Indiana","Posey County",1,58,392,193,199
050,18,129,"Indiana","Posey County",1,59,405,209,196
050,18,129,"Indiana","Posey County",1,60,400,209,191
050,18,129,"Indiana","Posey County",1,61,444,227,217
050,18,129,"Indiana","Posey County",1,62,421,226,195
050,18,129,"Indiana","Posey County",1,63,379,199,180
050,18,129,"Indiana","Posey County",1,64,376,196,180
050,18,129,"Indiana","Posey County",1,65,384,198,186
050,18,129,"Indiana","Posey County",1,66,368,186,182
050,18,129,"Indiana","Posey County",1,67,353,183,170
050,18,129,"Indiana","Posey County",1,68,324,170,154
050,18,129,"Indiana","Posey County",1,69,306,158,148
050,18,129,"Indiana","Posey County",1,70,266,120,146
050,18,129,"Indiana","Posey County",1,71,284,130,154
050,18,129,"Indiana","Posey County",1,72,271,130,141
050,18,129,"Indiana","Posey County",1,73,256,122,134
050,18,129,"Indiana","Posey County",1,74,176,81,95
050,18,129,"Indiana","Posey County",1,75,183,85,98
050,18,129,"Indiana","Posey County",1,76,176,82,94
050,18,129,"Indiana","Posey County",1,77,179,86,93
050,18,129,"Indiana","Posey County",1,78,158,65,93
050,18,129,"Indiana","Posey County",1,79,139,68,71
050,18,129,"Indiana","Posey County",1,80,116,57,59
050,18,129,"Indiana","Posey County",1,81,112,50,62
050,18,129,"Indiana","Posey County",1,82,102,49,53
050,18,129,"Indiana","Posey County",1,83,99,38,61
050,18,129,"Indiana","Posey County",1,84,92,38,54
050,18,129,"Indiana","Posey County",1,85,514,165,349
050,18,129,"Indiana","Posey County",2,0,253,134,119
050,18,129,"Indiana","Posey County",2,1,273,140,133
050,18,129,"Indiana","Posey County",2,2,272,140,132
050,18,129,"Indiana","Posey County",2,3,264,141,123
050,18,129,"Indiana","Posey County",2,4,282,155,127
050,18,129,"Indiana","Posey County",2,5,303,156,147
050,18,129,"Indiana","Posey County",2,6,302,147,155
050,18,129,"Indiana","Posey County",2,7,328,155,173
050,18,129,"Indiana","Posey County",2,8,341,163,178
050,18,129,"Indiana","Posey County",2,9,328,170,158
050,18,129,"Indiana","Posey County",2,10,326,159,167
050,18,129,"Indiana","Posey County",2,11,335,167,168
050,18,129,"Indiana","Posey County",2,12,335,169,166
050,18,129,"Indiana","Posey County",2,13,328,171,157
050,18,129,"Indiana","Posey County",2,14,328,174,154
050,18,129,"Indiana","Posey County",2,15,329,180,149
050,18,129,"Indiana","Posey County",2,16,346,190,156
050,18,129,"Indiana","Posey County",2,17,319,178,141
050,18,129,"Indiana","Posey County",2,18,273,154,119
050,18,129,"Indiana","Posey County",2,19,217,118,99
050,18,129,"Indiana","Posey County",2,20,232,119,113
050,18,129,"Indiana","Posey County",2,21,242,117,125
050,18,129,"Indiana","Posey County",2,22,259,127,132
050,18,129,"Indiana","Posey County",2,23,255,127,128
050,18,129,"Indiana","Posey County",2,24,264,130,134
050,18,129,"Indiana","Posey County",2,25,279,134,145
050,18,129,"Indiana","Posey County",2,26,275,145,130
050,18,129,"Indiana","Posey County",2,27,262,140,122
050,18,129,"Indiana","Posey County",2,28,275,142,133
050,18,129,"Indiana","Posey County",2,29,276,134,142
050,18,129,"Indiana","Posey County",2,30,292,147,145
050,18,129,"Indiana","Posey County",2,31,309,163,146
050,18,129,"Indiana","Posey County",2,32,302,155,147
050,18,129,"Indiana","Posey County",2,33,292,144,148
050,18,129,"Indiana","Posey County",2,34,320,160,160
050,18,129,"Indiana","Posey County",2,35,305,154,151
050,18,129,"Indiana","Posey County",2,36,270,129,141
050,18,129,"Indiana","Posey County",2,37,295,143,152
050,18,129,"Indiana","Posey County",2,38,304,159,145
050,18,129,"Indiana","Posey County",2,39,311,158,153
050,18,129,"Indiana","Posey County",2,40,323,167,156
050,18,129,"Indiana","Posey County",2,41,317,165,152
050,18,129,"Indiana","Posey County",2,42,319,174,145
050,18,129,"Indiana","Posey County",2,43,286,150,136
050,18,129,"Indiana","Posey County",2,44,281,141,140
050,18,129,"Indiana","Posey County",2,45,291,146,145
050,18,129,"Indiana","Posey County",2,46,276,135,141
050,18,129,"Indiana","Posey County",2,47,287,145,142
050,18,129,"Indiana","Posey County",2,48,312,160,152
050,18,129,"Indiana","Posey County",2,49,341,180,161
050,18,129,"Indiana","Posey County",2,50,342,170,172
050,18,129,"Indiana","Posey County",2,51,309,154,155
050,18,129,"Indiana","Posey County",2,52,301,154,147
050,18,129,"Indiana","Posey County",2,53,312,150,162
050,18,129,"Indiana","Posey County",2,54,338,165,173
050,18,129,"Indiana","Posey County",2,55,365,188,177
050,18,129,"Indiana","Posey County",2,56,395,203,192
050,18,129,"Indiana","Posey County",2,57,382,189,193
050,18,129,"Indiana","Posey County",2,58,384,188,196
050,18,129,"Indiana","Posey County",2,59,403,205,198
050,18,129,"Indiana","Posey County",2,60,395,206,189
050,18,129,"Indiana","Posey County",2,61,430,220,210
050,18,129,"Indiana","Posey County",2,62,424,224,200
050,18,129,"Indiana","Posey County",2,63,393,208,185
050,18,129,"Indiana","Posey County",2,64,373,195,178
050,18,129,"Indiana","Posey County",2,65,380,196,184
050,18,129,"Indiana","Posey County",2,66,369,187,182
050,18,129,"Indiana","Posey County",2,67,354,183,171
050,18,129,"Indiana","Posey County",2,68,327,170,157
050,18,129,"Indiana","Posey County",2,69,312,163,149
050,18,129,"Indiana","Posey County",2,70,274,130,144
050,18,129,"Indiana","Posey County",2,71,280,127,153
050,18,129,"Indiana","Posey County",2,72,268,127,141
050,18,129,"Indiana","Posey County",2,73,270,129,141
050,18,129,"Indiana","Posey County",2,74,181,84,97
050,18,129,"Indiana","Posey County",2,75,183,85,98
050,18,129,"Indiana","Posey County",2,76,174,81,93
050,18,129,"Indiana","Posey County",2,77,182,86,96
050,18,129,"Indiana","Posey County",2,78,158,66,92
050,18,129,"Indiana","Posey County",2,79,142,67,75
050,18,129,"Indiana","Posey County",2,80,123,60,63
050,18,129,"Indiana","Posey County",2,81,113,52,61
050,18,129,"Indiana","Posey County",2,82,106,50,56
050,18,129,"Indiana","Posey County",2,83,97,36,61
050,18,129,"Indiana","Posey County",2,84,94,38,56
050,18,129,"Indiana","Posey County",2,85,518,166,352
050,18,129,"Indiana","Posey County",3,0,238,108,130
050,18,129,"Indiana","Posey County",3,1,247,121,126
050,18,129,"Indiana","Posey County",3,2,257,125,132
050,18,129,"Indiana","Posey County",3,3,277,148,129
050,18,129,"Indiana","Posey County",3,4,273,147,126
050,18,129,"Indiana","Posey County",3,5,284,154,130
050,18,129,"Indiana","Posey County",3,6,328,173,155
050,18,129,"Indiana","Posey County",3,7,293,145,148
050,18,129,"Indiana","Posey County",3,8,325,153,172
050,18,129,"Indiana","Posey County",3,9,345,159,186
050,18,129,"Indiana","Posey County",3,10,339,172,167
050,18,129,"Indiana","Posey County",3,11,339,168,171
050,18,129,"Indiana","Posey County",3,12,335,170,165
050,18,129,"Indiana","Posey County",3,13,347,173,174
050,18,129,"Indiana","Posey County",3,14,333,176,157
050,18,129,"Indiana","Posey County",3,15,336,176,160
050,18,129,"Indiana","Posey County",3,16,339,181,158
050,18,129,"Indiana","Posey County",3,17,343,187,156
050,18,129,"Indiana","Posey County",3,18,272,160,112
050,18,129,"Indiana","Posey County",3,19,205,123,82
050,18,129,"Indiana","Posey County",3,20,224,117,107
050,18,129,"Indiana","Posey County",3,21,228,120,108
050,18,129,"Indiana","Posey County",3,22,259,127,132
050,18,129,"Indiana","Posey County",3,23,241,123,118
050,18,129,"Indiana","Posey County",3,24,245,129,116
050,18,129,"Indiana","Posey County",3,25,273,130,143
050,18,129,"Indiana","Posey County",3,26,289,142,147
050,18,129,"Indiana","Posey County",3,27,257,133,124
050,18,129,"Indiana","Posey County",3,28,249,133,116
050,18,129,"Indiana","Posey County",3,29,278,147,131
050,18,129,"Indiana","Posey County",3,30,275,132,143
050,18,129,"Indiana","Posey County",3,31,302,156,146
050,18,129,"Indiana","Posey County",3,32,305,155,150
050,18,129,"Indiana","Posey County",3,33,316,157,159
050,18,129,"Indiana","Posey County",3,34,287,142,145
050,18,129,"Indiana","Posey County",3,35,329,172,157
050,18,129,"Indiana","Posey County",3,36,299,149,150
050,18,129,"Indiana","Posey County",3,37,278,131,147
050,18,129,"Indiana","Posey County",3,38,305,153,152
050,18,129,"Indiana","Posey County",3,39,314,163,151
050,18,129,"Indiana","Posey County",3,40,311,160,151
050,18,129,"Indiana","Posey County",3,41,327,169,158
050,18,129,"Indiana","Posey County",3,42,326,170,156
050,18,129,"Indiana","Posey County",3,43,319,175,144
050,18,129,"Indiana","Posey County",3,44,297,157,140
050,18,129,"Indiana","Posey County",3,45,284,142,142
050,18,129,"Indiana","Posey County",3,46,298,150,148
050,18,129,"Indiana","Posey County",3,47,265,131,134
050,18,129,"Indiana","Posey County",3,48,292,147,145
050,18,129,"Indiana","Posey County",3,49,306,157,149
050,18,129,"Indiana","Posey County",3,50,335,173,162
050,18,129,"Indiana","Posey County",3,51,340,174,166
050,18,129,"Indiana","Posey County",3,52,305,156,149
050,18,129,"Indiana","Posey County",3,53,301,150,151
050,18,129,"Indiana","Posey County",3,54,314,156,158
050,18,129,"Indiana","Posey County",3,55,344,165,179
050,18,129,"Indiana","Posey County",3,56,358,183,175
050,18,129,"Indiana","Posey County",3,57,380,194,186
050,18,129,"Indiana","Posey County",3,58,385,193,192
050,18,129,"Indiana","Posey County",3,59,381,185,196
050,18,129,"Indiana","Posey County",3,60,403,205,198
050,18,129,"Indiana","Posey County",3,61,386,199,187
050,18,129,"Indiana","Posey County",3,62,421,216,205
050,18,129,"Indiana","Posey County",3,63,417,217,200
050,18,129,"Indiana","Posey County",3,64,372,195,177
050,18,129,"Indiana","Posey County",3,65,371,192,179
050,18,129,"Indiana","Posey County",3,66,371,193,178
050,18,129,"Indiana","Posey County",3,67,373,191,182
050,18,129,"Indiana","Posey County",3,68,351,182,169
050,18,129,"Indiana","Posey County",3,69,323,166,157
050,18,129,"Indiana","Posey County",3,70,300,160,140
050,18,129,"Indiana","Posey County",3,71,277,130,147
050,18,129,"Indiana","Posey County",3,72,275,125,150
050,18,129,"Indiana","Posey County",3,73,258,123,135
050,18,129,"Indiana","Posey County",3,74,265,127,138
050,18,129,"Indiana","Posey County",3,75,180,83,97
050,18,129,"Indiana","Posey County",3,76,172,77,95
050,18,129,"Indiana","Posey County",3,77,169,77,92
050,18,129,"Indiana","Posey County",3,78,178,84,94
050,18,129,"Indiana","Posey County",3,79,146,59,87
050,18,129,"Indiana","Posey County",3,80,128,57,71
050,18,129,"Indiana","Posey County",3,81,118,57,61
050,18,129,"Indiana","Posey County",3,82,113,55,58
050,18,129,"Indiana","Posey County",3,83,97,44,53
050,18,129,"Indiana","Posey County",3,84,92,34,58
050,18,129,"Indiana","Posey County",3,85,533,178,355
050,18,129,"Indiana","Posey County",4,0,212,101,111
050,18,129,"Indiana","Posey County",4,1,255,117,138
050,18,129,"Indiana","Posey County",4,2,244,113,131
050,18,129,"Indiana","Posey County",4,3,267,129,138
050,18,129,"Indiana","Posey County",4,4,284,146,138
050,18,129,"Indiana","Posey County",4,5,268,145,123
050,18,129,"Indiana","Posey County",4,6,288,158,130
050,18,129,"Indiana","Posey County",4,7,316,167,149
050,18,129,"Indiana","Posey County",4,8,294,145,149
050,18,129,"Indiana","Posey County",4,9,336,164,172
050,18,129,"Indiana","Posey County",4,10,338,155,183
050,18,129,"Indiana","Posey County",4,11,338,179,159
050,18,129,"Indiana","Posey County",4,12,339,159,180
050,18,129,"Indiana","Posey County",4,13,330,167,163
050,18,129,"Indiana","Posey County",4,14,344,164,180
050,18,129,"Indiana","Posey County",4,15,340,179,161
050,18,129,"Indiana","Posey County",4,16,349,180,169
050,18,129,"Indiana","Posey County",4,17,327,173,154
050,18,129,"Indiana","Posey County",4,18,295,172,123
050,18,129,"Indiana","Posey County",4,19,213,128,85
050,18,129,"Indiana","Posey County",4,20,219,128,91
050,18,129,"Indiana","Posey County",4,21,227,114,113
050,18,129,"Indiana","Posey County",4,22,237,130,107
050,18,129,"Indiana","Posey County",4,23,241,122,119
050,18,129,"Indiana","Posey County",4,24,255,134,121
050,18,129,"Indiana","Posey County",4,25,232,124,108
050,18,129,"Indiana","Posey County",4,26,270,131,139
050,18,129,"Indiana","Posey County",4,27,305,146,159
050,18,129,"Indiana","Posey County",4,28,262,138,124
050,18,129,"Indiana","Posey County",4,29,241,130,111
050,18,129,"Indiana","Posey County",4,30,285,157,128
050,18,129,"Indiana","Posey County",4,31,261,125,136
050,18,129,"Indiana","Posey County",4,32,304,160,144
050,18,129,"Indiana","Posey County",4,33,320,163,157
050,18,129,"Indiana","Posey County",4,34,316,157,159
050,18,129,"Indiana","Posey County",4,35,297,154,143
050,18,129,"Indiana","Posey County",4,36,325,163,162
050,18,129,"Indiana","Posey County",4,37,309,157,152
050,18,129,"Indiana","Posey County",4,38,284,138,146
050,18,129,"Indiana","Posey County",4,39,298,147,151
050,18,129,"Indiana","Posey County",4,40,324,168,156
050,18,129,"Indiana","Posey County",4,41,313,157,156
050,18,129,"Indiana","Posey County",4,42,330,173,157
050,18,129,"Indiana","Posey County",4,43,327,177,150
050,18,129,"Indiana","Posey County",4,44,309,175,134
050,18,129,"Indiana","Posey County",4,45,298,157,141
050,18,129,"Indiana","Posey County",4,46,280,142,138
050,18,129,"Indiana","Posey County",4,47,297,149,148
050,18,129,"Indiana","Posey County",4,48,277,137,140
050,18,129,"Indiana","Posey County",4,49,291,143,148
050,18,129,"Indiana","Posey County",4,50,306,157,149
050,18,129,"Indiana","Posey County",4,51,337,173,164
050,18,129,"Indiana","Posey County",4,52,342,181,161
050,18,129,"Indiana","Posey County",4,53,300,151,149
050,18,129,"Indiana","Posey County",4,54,295,143,152
050,18,129,"Indiana","Posey County",4,55,313,153,160
050,18,129,"Indiana","Posey County",4,56,339,164,175
050,18,129,"Indiana","Posey County",4,57,352,174,178
050,18,129,"Indiana","Posey County",4,58,378,193,185
050,18,129,"Indiana","Posey County",4,59,384,199,185
050,18,129,"Indiana","Posey County",4,60,372,178,194
050,18,129,"Indiana","Posey County",4,61,413,208,205
050,18,129,"Indiana","Posey County",4,62,376,200,176
050,18,129,"Indiana","Posey County",4,63,417,214,203
050,18,129,"Indiana","Posey County",4,64,414,211,203
050,18,129,"Indiana","Posey County",4,65,366,191,175
050,18,129,"Indiana","Posey County",4,66,366,191,175
050,18,129,"Indiana","Posey County",4,67,370,194,176
050,18,129,"Indiana","Posey County",4,68,368,187,181
050,18,129,"Indiana","Posey County",4,69,344,178,166
050,18,129,"Indiana","Posey County",4,70,314,160,154
050,18,129,"Indiana","Posey County",4,71,301,159,142
050,18,129,"Indiana","Posey County",4,72,280,131,149
050,18,129,"Indiana","Posey County",4,73,264,117,147
050,18,129,"Indiana","Posey County",4,74,254,123,131
050,18,129,"Indiana","Posey County",4,75,260,123,137
050,18,129,"Indiana","Posey County",4,76,166,76,90
050,18,129,"Indiana","Posey County",4,77,171,76,95
050,18,129,"Indiana","Posey County",4,78,156,68,88
050,18,129,"Indiana","Posey County",4,79,168,78,90
050,18,129,"Indiana","Posey County",4,80,136,53,83
050,18,129,"Indiana","Posey County",4,81,116,50,66
050,18,129,"Indiana","Posey County",4,82,107,53,54
050,18,129,"Indiana","Posey County",4,83,107,50,57
050,18,129,"Indiana","Posey County",4,84,91,42,49
050,18,129,"Indiana","Posey County",4,85,544,182,362
050,18,129,"Indiana","Posey County",5,0,203,97,106
050,18,129,"Indiana","Posey County",5,1,216,97,119
050,18,129,"Indiana","Posey County",5,2,247,120,127
050,18,129,"Indiana","Posey County",5,3,267,131,136
050,18,129,"Indiana","Posey County",5,4,273,130,143
050,18,129,"Indiana","Posey County",5,5,277,142,135
050,18,129,"Indiana","Posey County",5,6,270,146,124
050,18,129,"Indiana","Posey County",5,7,285,161,124
050,18,129,"Indiana","Posey County",5,8,321,178,143
050,18,129,"Indiana","Posey County",5,9,300,143,157
050,18,129,"Indiana","Posey County",5,10,332,155,177
050,18,129,"Indiana","Posey County",5,11,337,159,178
050,18,129,"Indiana","Posey County",5,12,327,174,153
050,18,129,"Indiana","Posey County",5,13,332,158,174
050,18,129,"Indiana","Posey County",5,14,327,166,161
050,18,129,"Indiana","Posey County",5,15,342,163,179
050,18,129,"Indiana","Posey County",5,16,345,181,164
050,18,129,"Indiana","Posey County",5,17,354,182,172
050,18,129,"Indiana","Posey County",5,18,266,149,117
050,18,129,"Indiana","Posey County",5,19,234,137,97
050,18,129,"Indiana","Posey County",5,20,221,131,90
050,18,129,"Indiana","Posey County",5,21,233,139,94
050,18,129,"Indiana","Posey County",5,22,254,132,122
050,18,129,"Indiana","Posey County",5,23,249,135,114
050,18,129,"Indiana","Posey County",5,24,250,130,120
050,18,129,"Indiana","Posey County",5,25,250,130,120
050,18,129,"Indiana","Posey County",5,26,233,119,114
050,18,129,"Indiana","Posey County",5,27,272,122,150
050,18,129,"Indiana","Posey County",5,28,318,157,161
050,18,129,"Indiana","Posey County",5,29,269,135,134
050,18,129,"Indiana","Posey County",5,30,248,134,114
050,18,129,"Indiana","Posey County",5,31,266,143,123
050,18,129,"Indiana","Posey County",5,32,266,127,139
050,18,129,"Indiana","Posey County",5,33,306,160,146
050,18,129,"Indiana","Posey County",5,34,316,156,160
050,18,129,"Indiana","Posey County",5,35,318,163,155
050,18,129,"Indiana","Posey County",5,36,288,142,146
050,18,129,"Indiana","Posey County",5,37,323,163,160
050,18,129,"Indiana","Posey County",5,38,321,163,158
050,18,129,"Indiana","Posey County",5,39,287,132,155
050,18,129,"Indiana","Posey County",5,40,302,148,154
050,18,129,"Indiana","Posey County",5,41,326,167,159
050,18,129,"Indiana","Posey County",5,42,315,160,155
050,18,129,"Indiana","Posey County",5,43,326,174,152
050,18,129,"Indiana","Posey County",5,44,325,178,147
050,18,129,"Indiana","Posey County",5,45,315,179,136
050,18,129,"Indiana","Posey County",5,46,298,154,144
050,18,129,"Indiana","Posey County",5,47,281,139,142
050,18,129,"Indiana","Posey County",5,48,307,155,152
050,18,129,"Indiana","Posey County",5,49,274,136,138
050,18,129,"Indiana","Posey County",5,50,289,143,146
050,18,129,"Indiana","Posey County",5,51,307,157,150
050,18,129,"Indiana","Posey County",5,52,346,178,168
050,18,129,"Indiana","Posey County",5,53,336,177,159
050,18,129,"Indiana","Posey County",5,54,304,157,147
050,18,129,"Indiana","Posey County",5,55,290,144,146
050,18,129,"Indiana","Posey County",5,56,314,154,160
050,18,129,"Indiana","Posey County",5,57,337,164,173
050,18,129,"Indiana","Posey County",5,58,345,172,173
050,18,129,"Indiana","Posey County",5,59,376,191,185
050,18,129,"Indiana","Posey County",5,60,383,199,184
050,18,129,"Indiana","Posey County",5,61,372,176,196
050,18,129,"Indiana","Posey County",5,62,406,206,200
050,18,129,"Indiana","Posey County",5,63,379,204,175
050,18,129,"Indiana","Posey County",5,64,413,213,200
050,18,129,"Indiana","Posey County",5,65,405,204,201
050,18,129,"Indiana","Posey County",5,66,361,189,172
050,18,129,"Indiana","Posey County",5,67,366,192,174
050,18,129,"Indiana","Posey County",5,68,358,186,172
050,18,129,"Indiana","Posey County",5,69,359,182,177
050,18,129,"Indiana","Posey County",5,70,331,171,160
050,18,129,"Indiana","Posey County",5,71,313,157,156
050,18,129,"Indiana","Posey County",5,72,295,159,136
050,18,129,"Indiana","Posey County",5,73,268,125,143
050,18,129,"Indiana","Posey County",5,74,264,115,149
050,18,129,"Indiana","Posey County",5,75,252,122,130
050,18,129,"Indiana","Posey County",5,76,237,115,122
050,18,129,"Indiana","Posey County",5,77,163,73,90
050,18,129,"Indiana","Posey County",5,78,162,70,92
050,18,129,"Indiana","Posey County",5,79,143,62,81
050,18,129,"Indiana","Posey County",5,80,157,73,84
050,18,129,"Indiana","Posey County",5,81,130,50,80
050,18,129,"Indiana","Posey County",5,82,109,50,59
050,18,129,"Indiana","Posey County",5,83,96,47,49
050,18,129,"Indiana","Posey County",5,84,102,46,56
050,18,129,"Indiana","Posey County",5,85,560,200,360
050,18,131,"Indiana","Pulaski County",1,0,121,61,60
050,18,131,"Indiana","Pulaski County",1,1,133,61,72
050,18,131,"Indiana","Pulaski County",1,2,130,59,71
050,18,131,"Indiana","Pulaski County",1,3,144,73,71
050,18,131,"Indiana","Pulaski County",1,4,131,62,69
050,18,131,"Indiana","Pulaski County",1,5,144,75,69
050,18,131,"Indiana","Pulaski County",1,6,134,66,68
050,18,131,"Indiana","Pulaski County",1,7,154,80,74
050,18,131,"Indiana","Pulaski County",1,8,131,71,60
050,18,131,"Indiana","Pulaski County",1,9,142,87,55
050,18,131,"Indiana","Pulaski County",1,10,160,93,67
050,18,131,"Indiana","Pulaski County",1,11,175,90,85
050,18,131,"Indiana","Pulaski County",1,12,188,94,94
050,18,131,"Indiana","Pulaski County",1,13,186,106,80
050,18,131,"Indiana","Pulaski County",1,14,180,101,79
050,18,131,"Indiana","Pulaski County",1,15,186,97,89
050,18,131,"Indiana","Pulaski County",1,16,194,94,100
050,18,131,"Indiana","Pulaski County",1,17,179,85,94
050,18,131,"Indiana","Pulaski County",1,18,145,75,70
050,18,131,"Indiana","Pulaski County",1,19,113,67,46
050,18,131,"Indiana","Pulaski County",1,20,117,64,53
050,18,131,"Indiana","Pulaski County",1,21,139,78,61
050,18,131,"Indiana","Pulaski County",1,22,133,71,62
050,18,131,"Indiana","Pulaski County",1,23,130,70,60
050,18,131,"Indiana","Pulaski County",1,24,124,63,61
050,18,131,"Indiana","Pulaski County",1,25,151,69,82
050,18,131,"Indiana","Pulaski County",1,26,149,76,73
050,18,131,"Indiana","Pulaski County",1,27,119,62,57
050,18,131,"Indiana","Pulaski County",1,28,150,78,72
050,18,131,"Indiana","Pulaski County",1,29,155,85,70
050,18,131,"Indiana","Pulaski County",1,30,116,58,58
050,18,131,"Indiana","Pulaski County",1,31,138,69,69
050,18,131,"Indiana","Pulaski County",1,32,123,63,60
050,18,131,"Indiana","Pulaski County",1,33,135,81,54
050,18,131,"Indiana","Pulaski County",1,34,148,81,67
050,18,131,"Indiana","Pulaski County",1,35,153,71,82
050,18,131,"Indiana","Pulaski County",1,36,135,66,69
050,18,131,"Indiana","Pulaski County",1,37,149,82,67
050,18,131,"Indiana","Pulaski County",1,38,138,75,63
050,18,131,"Indiana","Pulaski County",1,39,150,81,69
050,18,131,"Indiana","Pulaski County",1,40,140,70,70
050,18,131,"Indiana","Pulaski County",1,41,141,79,62
050,18,131,"Indiana","Pulaski County",1,42,146,83,63
050,18,131,"Indiana","Pulaski County",1,43,138,72,66
050,18,131,"Indiana","Pulaski County",1,44,142,68,74
050,18,131,"Indiana","Pulaski County",1,45,146,71,75
050,18,131,"Indiana","Pulaski County",1,46,151,80,71
050,18,131,"Indiana","Pulaski County",1,47,155,86,69
050,18,131,"Indiana","Pulaski County",1,48,152,84,68
050,18,131,"Indiana","Pulaski County",1,49,156,73,83
050,18,131,"Indiana","Pulaski County",1,50,144,67,77
050,18,131,"Indiana","Pulaski County",1,51,143,81,62
050,18,131,"Indiana","Pulaski County",1,52,144,71,73
050,18,131,"Indiana","Pulaski County",1,53,166,75,91
050,18,131,"Indiana","Pulaski County",1,54,180,82,98
050,18,131,"Indiana","Pulaski County",1,55,195,92,103
050,18,131,"Indiana","Pulaski County",1,56,191,99,92
050,18,131,"Indiana","Pulaski County",1,57,180,93,87
050,18,131,"Indiana","Pulaski County",1,58,182,88,94
050,18,131,"Indiana","Pulaski County",1,59,184,102,82
050,18,131,"Indiana","Pulaski County",1,60,188,105,83
050,18,131,"Indiana","Pulaski County",1,61,168,80,88
050,18,131,"Indiana","Pulaski County",1,62,195,103,92
050,18,131,"Indiana","Pulaski County",1,63,194,108,86
050,18,131,"Indiana","Pulaski County",1,64,169,80,89
050,18,131,"Indiana","Pulaski County",1,65,173,86,87
050,18,131,"Indiana","Pulaski County",1,66,172,86,86
050,18,131,"Indiana","Pulaski County",1,67,170,73,97
050,18,131,"Indiana","Pulaski County",1,68,174,85,89
050,18,131,"Indiana","Pulaski County",1,69,143,70,73
050,18,131,"Indiana","Pulaski County",1,70,144,82,62
050,18,131,"Indiana","Pulaski County",1,71,126,69,57
050,18,131,"Indiana","Pulaski County",1,72,137,67,70
050,18,131,"Indiana","Pulaski County",1,73,128,63,65
050,18,131,"Indiana","Pulaski County",1,74,87,40,47
050,18,131,"Indiana","Pulaski County",1,75,105,48,57
050,18,131,"Indiana","Pulaski County",1,76,101,47,54
050,18,131,"Indiana","Pulaski County",1,77,101,49,52
050,18,131,"Indiana","Pulaski County",1,78,100,55,45
050,18,131,"Indiana","Pulaski County",1,79,97,49,48
050,18,131,"Indiana","Pulaski County",1,80,74,38,36
050,18,131,"Indiana","Pulaski County",1,81,70,36,34
050,18,131,"Indiana","Pulaski County",1,82,61,29,32
050,18,131,"Indiana","Pulaski County",1,83,62,25,37
050,18,131,"Indiana","Pulaski County",1,84,55,25,30
050,18,131,"Indiana","Pulaski County",1,85,322,106,216
050,18,131,"Indiana","Pulaski County",2,0,120,55,65
050,18,131,"Indiana","Pulaski County",2,1,132,61,71
050,18,131,"Indiana","Pulaski County",2,2,133,61,72
050,18,131,"Indiana","Pulaski County",2,3,140,69,71
050,18,131,"Indiana","Pulaski County",2,4,135,66,69
050,18,131,"Indiana","Pulaski County",2,5,141,72,69
050,18,131,"Indiana","Pulaski County",2,6,137,67,70
050,18,131,"Indiana","Pulaski County",2,7,147,75,72
050,18,131,"Indiana","Pulaski County",2,8,136,72,64
050,18,131,"Indiana","Pulaski County",2,9,137,82,55
050,18,131,"Indiana","Pulaski County",2,10,155,91,64
050,18,131,"Indiana","Pulaski County",2,11,173,91,82
050,18,131,"Indiana","Pulaski County",2,12,186,95,91
050,18,131,"Indiana","Pulaski County",2,13,184,103,81
050,18,131,"Indiana","Pulaski County",2,14,180,101,79
050,18,131,"Indiana","Pulaski County",2,15,186,99,87
050,18,131,"Indiana","Pulaski County",2,16,193,96,97
050,18,131,"Indiana","Pulaski County",2,17,184,88,96
050,18,131,"Indiana","Pulaski County",2,18,144,74,70
050,18,131,"Indiana","Pulaski County",2,19,113,64,49
050,18,131,"Indiana","Pulaski County",2,20,118,65,53
050,18,131,"Indiana","Pulaski County",2,21,135,75,60
050,18,131,"Indiana","Pulaski County",2,22,138,75,63
050,18,131,"Indiana","Pulaski County",2,23,131,69,62
050,18,131,"Indiana","Pulaski County",2,24,128,65,63
050,18,131,"Indiana","Pulaski County",2,25,150,71,79
050,18,131,"Indiana","Pulaski County",2,26,150,76,74
050,18,131,"Indiana","Pulaski County",2,27,126,66,60
050,18,131,"Indiana","Pulaski County",2,28,145,76,69
050,18,131,"Indiana","Pulaski County",2,29,153,83,70
050,18,131,"Indiana","Pulaski County",2,30,127,65,62
050,18,131,"Indiana","Pulaski County",2,31,133,66,67
050,18,131,"Indiana","Pulaski County",2,32,127,64,63
050,18,131,"Indiana","Pulaski County",2,33,134,77,57
050,18,131,"Indiana","Pulaski County",2,34,145,81,64
050,18,131,"Indiana","Pulaski County",2,35,152,74,78
050,18,131,"Indiana","Pulaski County",2,36,139,67,72
050,18,131,"Indiana","Pulaski County",2,37,148,79,69
050,18,131,"Indiana","Pulaski County",2,38,141,77,64
050,18,131,"Indiana","Pulaski County",2,39,148,81,67
050,18,131,"Indiana","Pulaski County",2,40,144,75,69
050,18,131,"Indiana","Pulaski County",2,41,140,77,63
050,18,131,"Indiana","Pulaski County",2,42,144,82,62
050,18,131,"Indiana","Pulaski County",2,43,139,75,64
050,18,131,"Indiana","Pulaski County",2,44,139,68,71
050,18,131,"Indiana","Pulaski County",2,45,146,71,75
050,18,131,"Indiana","Pulaski County",2,46,149,78,71
050,18,131,"Indiana","Pulaski County",2,47,152,84,68
050,18,131,"Indiana","Pulaski County",2,48,153,84,69
050,18,131,"Indiana","Pulaski County",2,49,155,76,79
050,18,131,"Indiana","Pulaski County",2,50,146,69,77
050,18,131,"Indiana","Pulaski County",2,51,141,77,64
050,18,131,"Indiana","Pulaski County",2,52,140,72,68
050,18,131,"Indiana","Pulaski County",2,53,159,73,86
050,18,131,"Indiana","Pulaski County",2,54,177,81,96
050,18,131,"Indiana","Pulaski County",2,55,190,89,101
050,18,131,"Indiana","Pulaski County",2,56,190,97,93
050,18,131,"Indiana","Pulaski County",2,57,184,96,88
050,18,131,"Indiana","Pulaski County",2,58,181,89,92
050,18,131,"Indiana","Pulaski County",2,59,186,100,86
050,18,131,"Indiana","Pulaski County",2,60,187,104,83
050,18,131,"Indiana","Pulaski County",2,61,174,85,89
050,18,131,"Indiana","Pulaski County",2,62,188,97,91
050,18,131,"Indiana","Pulaski County",2,63,197,108,89
050,18,131,"Indiana","Pulaski County",2,64,172,84,88
050,18,131,"Indiana","Pulaski County",2,65,171,84,87
050,18,131,"Indiana","Pulaski County",2,66,173,86,87
050,18,131,"Indiana","Pulaski County",2,67,169,76,93
050,18,131,"Indiana","Pulaski County",2,68,171,81,90
050,18,131,"Indiana","Pulaski County",2,69,151,74,77
050,18,131,"Indiana","Pulaski County",2,70,142,79,63
050,18,131,"Indiana","Pulaski County",2,71,131,72,59
050,18,131,"Indiana","Pulaski County",2,72,134,68,66
050,18,131,"Indiana","Pulaski County",2,73,135,67,68
050,18,131,"Indiana","Pulaski County",2,74,90,42,48
050,18,131,"Indiana","Pulaski County",2,75,101,44,57
050,18,131,"Indiana","Pulaski County",2,76,98,46,52
050,18,131,"Indiana","Pulaski County",2,77,105,49,56
050,18,131,"Indiana","Pulaski County",2,78,96,51,45
050,18,131,"Indiana","Pulaski County",2,79,96,48,48
050,18,131,"Indiana","Pulaski County",2,80,77,40,37
050,18,131,"Indiana","Pulaski County",2,81,70,37,33
050,18,131,"Indiana","Pulaski County",2,82,62,29,33
050,18,131,"Indiana","Pulaski County",2,83,63,26,37
050,18,131,"Indiana","Pulaski County",2,84,55,24,31
050,18,131,"Indiana","Pulaski County",2,85,328,111,217
050,18,131,"Indiana","Pulaski County",3,0,126,58,68
050,18,131,"Indiana","Pulaski County",3,1,123,51,72
050,18,131,"Indiana","Pulaski County",3,2,128,61,67
050,18,131,"Indiana","Pulaski County",3,3,141,70,71
050,18,131,"Indiana","Pulaski County",3,4,134,64,70
050,18,131,"Indiana","Pulaski County",3,5,139,68,71
050,18,131,"Indiana","Pulaski County",3,6,134,69,65
050,18,131,"Indiana","Pulaski County",3,7,134,61,73
050,18,131,"Indiana","Pulaski County",3,8,159,84,75
050,18,131,"Indiana","Pulaski County",3,9,133,72,61
050,18,131,"Indiana","Pulaski County",3,10,137,84,53
050,18,131,"Indiana","Pulaski County",3,11,149,85,64
050,18,131,"Indiana","Pulaski County",3,12,172,96,76
050,18,131,"Indiana","Pulaski County",3,13,185,92,93
050,18,131,"Indiana","Pulaski County",3,14,192,106,86
050,18,131,"Indiana","Pulaski County",3,15,176,97,79
050,18,131,"Indiana","Pulaski County",3,16,184,98,86
050,18,131,"Indiana","Pulaski County",3,17,188,95,93
050,18,131,"Indiana","Pulaski County",3,18,150,72,78
050,18,131,"Indiana","Pulaski County",3,19,103,51,52
050,18,131,"Indiana","Pulaski County",3,20,117,62,55
050,18,131,"Indiana","Pulaski County",3,21,114,65,49
050,18,131,"Indiana","Pulaski County",3,22,133,71,62
050,18,131,"Indiana","Pulaski County",3,23,132,76,56
050,18,131,"Indiana","Pulaski County",3,24,128,66,62
050,18,131,"Indiana","Pulaski County",3,25,133,73,60
050,18,131,"Indiana","Pulaski County",3,26,140,61,79
050,18,131,"Indiana","Pulaski County",3,27,148,74,74
050,18,131,"Indiana","Pulaski County",3,28,133,69,64
050,18,131,"Indiana","Pulaski County",3,29,149,75,74
050,18,131,"Indiana","Pulaski County",3,30,150,81,69
050,18,131,"Indiana","Pulaski County",3,31,124,66,58
050,18,131,"Indiana","Pulaski County",3,32,132,68,64
050,18,131,"Indiana","Pulaski County",3,33,124,61,63
050,18,131,"Indiana","Pulaski County",3,34,135,80,55
050,18,131,"Indiana","Pulaski County",3,35,148,84,64
050,18,131,"Indiana","Pulaski County",3,36,154,75,79
050,18,131,"Indiana","Pulaski County",3,37,135,67,68
050,18,131,"Indiana","Pulaski County",3,38,147,80,67
050,18,131,"Indiana","Pulaski County",3,39,136,72,64
050,18,131,"Indiana","Pulaski County",3,40,146,78,68
050,18,131,"Indiana","Pulaski County",3,41,146,73,73
050,18,131,"Indiana","Pulaski County",3,42,135,75,60
050,18,131,"Indiana","Pulaski County",3,43,140,80,60
050,18,131,"Indiana","Pulaski County",3,44,140,77,63
050,18,131,"Indiana","Pulaski County",3,45,143,68,75
050,18,131,"Indiana","Pulaski County",3,46,147,70,77
050,18,131,"Indiana","Pulaski County",3,47,142,75,67
050,18,131,"Indiana","Pulaski County",3,48,148,82,66
050,18,131,"Indiana","Pulaski County",3,49,154,84,70
050,18,131,"Indiana","Pulaski County",3,50,158,78,80
050,18,131,"Indiana","Pulaski County",3,51,144,68,76
050,18,131,"Indiana","Pulaski County",3,52,148,81,67
050,18,131,"Indiana","Pulaski County",3,53,144,73,71
050,18,131,"Indiana","Pulaski County",3,54,161,79,82
050,18,131,"Indiana","Pulaski County",3,55,174,82,92
050,18,131,"Indiana","Pulaski County",3,56,189,93,96
050,18,131,"Indiana","Pulaski County",3,57,183,96,87
050,18,131,"Indiana","Pulaski County",3,58,173,86,87
050,18,131,"Indiana","Pulaski County",3,59,183,94,89
050,18,131,"Indiana","Pulaski County",3,60,186,103,83
050,18,131,"Indiana","Pulaski County",3,61,181,101,80
050,18,131,"Indiana","Pulaski County",3,62,180,90,90
050,18,131,"Indiana","Pulaski County",3,63,186,99,87
050,18,131,"Indiana","Pulaski County",3,64,196,104,92
050,18,131,"Indiana","Pulaski County",3,65,165,81,84
050,18,131,"Indiana","Pulaski County",3,66,173,81,92
050,18,131,"Indiana","Pulaski County",3,67,174,86,88
050,18,131,"Indiana","Pulaski County",3,68,167,77,90
050,18,131,"Indiana","Pulaski County",3,69,163,78,85
050,18,131,"Indiana","Pulaski County",3,70,147,71,76
050,18,131,"Indiana","Pulaski County",3,71,133,72,61
050,18,131,"Indiana","Pulaski County",3,72,128,71,57
050,18,131,"Indiana","Pulaski County",3,73,120,62,58
050,18,131,"Indiana","Pulaski County",3,74,132,62,70
050,18,131,"Indiana","Pulaski County",3,75,92,39,53
050,18,131,"Indiana","Pulaski County",3,76,99,49,50
050,18,131,"Indiana","Pulaski County",3,77,96,43,53
050,18,131,"Indiana","Pulaski County",3,78,91,41,50
050,18,131,"Indiana","Pulaski County",3,79,101,48,53
050,18,131,"Indiana","Pulaski County",3,80,81,43,38
050,18,131,"Indiana","Pulaski County",3,81,75,40,35
050,18,131,"Indiana","Pulaski County",3,82,60,33,27
050,18,131,"Indiana","Pulaski County",3,83,67,28,39
050,18,131,"Indiana","Pulaski County",3,84,53,19,34
050,18,131,"Indiana","Pulaski County",3,85,317,108,209
050,18,131,"Indiana","Pulaski County",4,0,119,58,61
050,18,131,"Indiana","Pulaski County",4,1,138,72,66
050,18,131,"Indiana","Pulaski County",4,2,122,48,74
050,18,131,"Indiana","Pulaski County",4,3,128,60,68
050,18,131,"Indiana","Pulaski County",4,4,162,70,92
050,18,131,"Indiana","Pulaski County",4,5,138,69,69
050,18,131,"Indiana","Pulaski County",4,6,141,65,76
050,18,131,"Indiana","Pulaski County",4,7,145,75,70
050,18,131,"Indiana","Pulaski County",4,8,136,70,66
050,18,131,"Indiana","Pulaski County",4,9,157,78,79
050,18,131,"Indiana","Pulaski County",4,10,136,67,69
050,18,131,"Indiana","Pulaski County",4,11,136,80,56
050,18,131,"Indiana","Pulaski County",4,12,166,93,73
050,18,131,"Indiana","Pulaski County",4,13,173,96,77
050,18,131,"Indiana","Pulaski County",4,14,189,96,93
050,18,131,"Indiana","Pulaski County",4,15,198,107,91
050,18,131,"Indiana","Pulaski County",4,16,182,97,85
050,18,131,"Indiana","Pulaski County",4,17,189,106,83
050,18,131,"Indiana","Pulaski County",4,18,165,87,78
050,18,131,"Indiana","Pulaski County",4,19,116,56,60
050,18,131,"Indiana","Pulaski County",4,20,104,53,51
050,18,131,"Indiana","Pulaski County",4,21,115,61,54
050,18,131,"Indiana","Pulaski County",4,22,117,63,54
050,18,131,"Indiana","Pulaski County",4,23,133,70,63
050,18,131,"Indiana","Pulaski County",4,24,136,82,54
050,18,131,"Indiana","Pulaski County",4,25,130,65,65
050,18,131,"Indiana","Pulaski County",4,26,136,69,67
050,18,131,"Indiana","Pulaski County",4,27,139,60,79
050,18,131,"Indiana","Pulaski County",4,28,158,77,81
050,18,131,"Indiana","Pulaski County",4,29,147,72,75
050,18,131,"Indiana","Pulaski County",4,30,142,71,71
050,18,131,"Indiana","Pulaski County",4,31,152,83,69
050,18,131,"Indiana","Pulaski County",4,32,133,64,69
050,18,131,"Indiana","Pulaski County",4,33,127,64,63
050,18,131,"Indiana","Pulaski County",4,34,128,63,65
050,18,131,"Indiana","Pulaski County",4,35,142,82,60
050,18,131,"Indiana","Pulaski County",4,36,146,82,64
050,18,131,"Indiana","Pulaski County",4,37,158,80,78
050,18,131,"Indiana","Pulaski County",4,38,140,72,68
050,18,131,"Indiana","Pulaski County",4,39,150,82,68
050,18,131,"Indiana","Pulaski County",4,40,136,68,68
050,18,131,"Indiana","Pulaski County",4,41,151,84,67
050,18,131,"Indiana","Pulaski County",4,42,143,72,71
050,18,131,"Indiana","Pulaski County",4,43,140,75,65
050,18,131,"Indiana","Pulaski County",4,44,147,81,66
050,18,131,"Indiana","Pulaski County",4,45,140,77,63
050,18,131,"Indiana","Pulaski County",4,46,145,67,78
050,18,131,"Indiana","Pulaski County",4,47,142,65,77
050,18,131,"Indiana","Pulaski County",4,48,148,80,68
050,18,131,"Indiana","Pulaski County",4,49,149,84,65
050,18,131,"Indiana","Pulaski County",4,50,157,84,73
050,18,131,"Indiana","Pulaski County",4,51,159,75,84
050,18,131,"Indiana","Pulaski County",4,52,151,70,81
050,18,131,"Indiana","Pulaski County",4,53,151,80,71
050,18,131,"Indiana","Pulaski County",4,54,136,67,69
050,18,131,"Indiana","Pulaski County",4,55,165,79,86
050,18,131,"Indiana","Pulaski County",4,56,168,80,88
050,18,131,"Indiana","Pulaski County",4,57,189,97,92
050,18,131,"Indiana","Pulaski County",4,58,182,92,90
050,18,131,"Indiana","Pulaski County",4,59,184,89,95
050,18,131,"Indiana","Pulaski County",4,60,182,94,88
050,18,131,"Indiana","Pulaski County",4,61,186,103,83
050,18,131,"Indiana","Pulaski County",4,62,173,98,75
050,18,131,"Indiana","Pulaski County",4,63,181,89,92
050,18,131,"Indiana","Pulaski County",4,64,188,102,86
050,18,131,"Indiana","Pulaski County",4,65,186,97,89
050,18,131,"Indiana","Pulaski County",4,66,160,77,83
050,18,131,"Indiana","Pulaski County",4,67,173,77,96
050,18,131,"Indiana","Pulaski County",4,68,172,86,86
050,18,131,"Indiana","Pulaski County",4,69,159,76,83
050,18,131,"Indiana","Pulaski County",4,70,158,78,80
050,18,131,"Indiana","Pulaski County",4,71,139,68,71
050,18,131,"Indiana","Pulaski County",4,72,136,74,62
050,18,131,"Indiana","Pulaski County",4,73,117,66,51
050,18,131,"Indiana","Pulaski County",4,74,115,58,57
050,18,131,"Indiana","Pulaski County",4,75,134,61,73
050,18,131,"Indiana","Pulaski County",4,76,84,38,46
050,18,131,"Indiana","Pulaski County",4,77,94,44,50
050,18,131,"Indiana","Pulaski County",4,78,89,39,50
050,18,131,"Indiana","Pulaski County",4,79,96,39,57
050,18,131,"Indiana","Pulaski County",4,80,87,43,44
050,18,131,"Indiana","Pulaski County",4,81,78,42,36
050,18,131,"Indiana","Pulaski County",4,82,64,36,28
050,18,131,"Indiana","Pulaski County",4,83,68,32,36
050,18,131,"Indiana","Pulaski County",4,84,58,26,32
050,18,131,"Indiana","Pulaski County",4,85,320,102,218
050,18,131,"Indiana","Pulaski County",5,0,122,59,63
050,18,131,"Indiana","Pulaski County",5,1,123,48,75
050,18,131,"Indiana","Pulaski County",5,2,137,67,70
050,18,131,"Indiana","Pulaski County",5,3,123,49,74
050,18,131,"Indiana","Pulaski County",5,4,127,60,67
050,18,131,"Indiana","Pulaski County",5,5,156,70,86
050,18,131,"Indiana","Pulaski County",5,6,135,73,62
050,18,131,"Indiana","Pulaski County",5,7,142,65,77
050,18,131,"Indiana","Pulaski County",5,8,148,76,72
050,18,131,"Indiana","Pulaski County",5,9,132,69,63
050,18,131,"Indiana","Pulaski County",5,10,163,80,83
050,18,131,"Indiana","Pulaski County",5,11,146,72,74
050,18,131,"Indiana","Pulaski County",5,12,137,86,51
050,18,131,"Indiana","Pulaski County",5,13,158,91,67
050,18,131,"Indiana","Pulaski County",5,14,176,98,78
050,18,131,"Indiana","Pulaski County",5,15,196,91,105
050,18,131,"Indiana","Pulaski County",5,16,203,112,91
050,18,131,"Indiana","Pulaski County",5,17,182,100,82
050,18,131,"Indiana","Pulaski County",5,18,162,92,70
050,18,131,"Indiana","Pulaski County",5,19,128,68,60
050,18,131,"Indiana","Pulaski County",5,20,126,59,67
050,18,131,"Indiana","Pulaski County",5,21,107,57,50
050,18,131,"Indiana","Pulaski County",5,22,123,68,55
050,18,131,"Indiana","Pulaski County",5,23,117,58,59
050,18,131,"Indiana","Pulaski County",5,24,127,66,61
050,18,131,"Indiana","Pulaski County",5,25,129,74,55
050,18,131,"Indiana","Pulaski County",5,26,127,67,60
050,18,131,"Indiana","Pulaski County",5,27,122,63,59
050,18,131,"Indiana","Pulaski County",5,28,144,64,80
050,18,131,"Indiana","Pulaski County",5,29,150,69,81
050,18,131,"Indiana","Pulaski County",5,30,142,67,75
050,18,131,"Indiana","Pulaski County",5,31,145,74,71
050,18,131,"Indiana","Pulaski County",5,32,148,85,63
050,18,131,"Indiana","Pulaski County",5,33,139,67,72
050,18,131,"Indiana","Pulaski County",5,34,132,68,64
050,18,131,"Indiana","Pulaski County",5,35,133,62,71
050,18,131,"Indiana","Pulaski County",5,36,143,80,63
050,18,131,"Indiana","Pulaski County",5,37,143,77,66
050,18,131,"Indiana","Pulaski County",5,38,154,75,79
050,18,131,"Indiana","Pulaski County",5,39,140,74,66
050,18,131,"Indiana","Pulaski County",5,40,151,82,69
050,18,131,"Indiana","Pulaski County",5,41,143,74,69
050,18,131,"Indiana","Pulaski County",5,42,165,92,73
050,18,131,"Indiana","Pulaski County",5,43,150,77,73
050,18,131,"Indiana","Pulaski County",5,44,141,77,64
050,18,131,"Indiana","Pulaski County",5,45,149,81,68
050,18,131,"Indiana","Pulaski County",5,46,150,81,69
050,18,131,"Indiana","Pulaski County",5,47,137,64,73
050,18,131,"Indiana","Pulaski County",5,48,147,70,77
050,18,131,"Indiana","Pulaski County",5,49,154,83,71
050,18,131,"Indiana","Pulaski County",5,50,143,79,64
050,18,131,"Indiana","Pulaski County",5,51,160,85,75
050,18,131,"Indiana","Pulaski County",5,52,158,72,86
050,18,131,"Indiana","Pulaski County",5,53,153,70,83
050,18,131,"Indiana","Pulaski County",5,54,154,84,70
050,18,131,"Indiana","Pulaski County",5,55,140,69,71
050,18,131,"Indiana","Pulaski County",5,56,163,77,86
050,18,131,"Indiana","Pulaski County",5,57,167,79,88
050,18,131,"Indiana","Pulaski County",5,58,188,97,91
050,18,131,"Indiana","Pulaski County",5,59,185,93,92
050,18,131,"Indiana","Pulaski County",5,60,182,92,90
050,18,131,"Indiana","Pulaski County",5,61,184,94,90
050,18,131,"Indiana","Pulaski County",5,62,180,100,80
050,18,131,"Indiana","Pulaski County",5,63,168,94,74
050,18,131,"Indiana","Pulaski County",5,64,179,88,91
050,18,131,"Indiana","Pulaski County",5,65,184,98,86
050,18,131,"Indiana","Pulaski County",5,66,187,97,90
050,18,131,"Indiana","Pulaski County",5,67,153,72,81
050,18,131,"Indiana","Pulaski County",5,68,164,74,90
050,18,131,"Indiana","Pulaski County",5,69,156,79,77
050,18,131,"Indiana","Pulaski County",5,70,152,76,76
050,18,131,"Indiana","Pulaski County",5,71,153,76,77
050,18,131,"Indiana","Pulaski County",5,72,138,67,71
050,18,131,"Indiana","Pulaski County",5,73,131,72,59
050,18,131,"Indiana","Pulaski County",5,74,111,62,49
050,18,131,"Indiana","Pulaski County",5,75,112,55,57
050,18,131,"Indiana","Pulaski County",5,76,123,59,64
050,18,131,"Indiana","Pulaski County",5,77,83,36,47
050,18,131,"Indiana","Pulaski County",5,78,83,38,45
050,18,131,"Indiana","Pulaski County",5,79,92,35,57
050,18,131,"Indiana","Pulaski County",5,80,82,35,47
050,18,131,"Indiana","Pulaski County",5,81,84,44,40
050,18,131,"Indiana","Pulaski County",5,82,66,39,27
050,18,131,"Indiana","Pulaski County",5,83,68,33,35
050,18,131,"Indiana","Pulaski County",5,84,60,29,31
050,18,131,"Indiana","Pulaski County",5,85,325,103,222
050,18,133,"Indiana","Putnam County",1,0,369,187,182
050,18,133,"Indiana","Putnam County",1,1,382,188,194
050,18,133,"Indiana","Putnam County",1,2,362,184,178
050,18,133,"Indiana","Putnam County",1,3,358,182,176
050,18,133,"Indiana","Putnam County",1,4,389,198,191
050,18,133,"Indiana","Putnam County",1,5,373,194,179
050,18,133,"Indiana","Putnam County",1,6,393,217,176
050,18,133,"Indiana","Putnam County",1,7,402,218,184
050,18,133,"Indiana","Putnam County",1,8,393,203,190
050,18,133,"Indiana","Putnam County",1,9,406,201,205
050,18,133,"Indiana","Putnam County",1,10,428,220,208
050,18,133,"Indiana","Putnam County",1,11,414,213,201
050,18,133,"Indiana","Putnam County",1,12,445,219,226
050,18,133,"Indiana","Putnam County",1,13,437,225,212
050,18,133,"Indiana","Putnam County",1,14,424,217,207
050,18,133,"Indiana","Putnam County",1,15,433,219,214
050,18,133,"Indiana","Putnam County",1,16,442,227,215
050,18,133,"Indiana","Putnam County",1,17,437,220,217
050,18,133,"Indiana","Putnam County",1,18,573,292,281
050,18,133,"Indiana","Putnam County",1,19,844,414,430
050,18,133,"Indiana","Putnam County",1,20,767,390,377
050,18,133,"Indiana","Putnam County",1,21,830,418,412
050,18,133,"Indiana","Putnam County",1,22,714,379,335
050,18,133,"Indiana","Putnam County",1,23,471,275,196
050,18,133,"Indiana","Putnam County",1,24,450,273,177
050,18,133,"Indiana","Putnam County",1,25,448,284,164
050,18,133,"Indiana","Putnam County",1,26,462,281,181
050,18,133,"Indiana","Putnam County",1,27,506,310,196
050,18,133,"Indiana","Putnam County",1,28,518,311,207
050,18,133,"Indiana","Putnam County",1,29,499,287,212
050,18,133,"Indiana","Putnam County",1,30,470,269,201
050,18,133,"Indiana","Putnam County",1,31,459,277,182
050,18,133,"Indiana","Putnam County",1,32,415,244,171
050,18,133,"Indiana","Putnam County",1,33,431,233,198
050,18,133,"Indiana","Putnam County",1,34,406,227,179
050,18,133,"Indiana","Putnam County",1,35,423,226,197
050,18,133,"Indiana","Putnam County",1,36,466,270,196
050,18,133,"Indiana","Putnam County",1,37,453,262,191
050,18,133,"Indiana","Putnam County",1,38,392,232,160
050,18,133,"Indiana","Putnam County",1,39,417,235,182
050,18,133,"Indiana","Putnam County",1,40,440,247,193
050,18,133,"Indiana","Putnam County",1,41,453,251,202
050,18,133,"Indiana","Putnam County",1,42,431,231,200
050,18,133,"Indiana","Putnam County",1,43,425,235,190
050,18,133,"Indiana","Putnam County",1,44,413,220,193
050,18,133,"Indiana","Putnam County",1,45,435,240,195
050,18,133,"Indiana","Putnam County",1,46,420,229,191
050,18,133,"Indiana","Putnam County",1,47,427,245,182
050,18,133,"Indiana","Putnam County",1,48,465,239,226
050,18,133,"Indiana","Putnam County",1,49,486,254,232
050,18,133,"Indiana","Putnam County",1,50,488,248,240
050,18,133,"Indiana","Putnam County",1,51,490,272,218
050,18,133,"Indiana","Putnam County",1,52,471,249,222
050,18,133,"Indiana","Putnam County",1,53,458,253,205
050,18,133,"Indiana","Putnam County",1,54,456,250,206
050,18,133,"Indiana","Putnam County",1,55,517,266,251
050,18,133,"Indiana","Putnam County",1,56,558,286,272
050,18,133,"Indiana","Putnam County",1,57,536,288,248
050,18,133,"Indiana","Putnam County",1,58,525,289,236
050,18,133,"Indiana","Putnam County",1,59,499,258,241
050,18,133,"Indiana","Putnam County",1,60,506,248,258
050,18,133,"Indiana","Putnam County",1,61,536,260,276
050,18,133,"Indiana","Putnam County",1,62,520,263,257
050,18,133,"Indiana","Putnam County",1,63,447,229,218
050,18,133,"Indiana","Putnam County",1,64,454,251,203
050,18,133,"Indiana","Putnam County",1,65,449,241,208
050,18,133,"Indiana","Putnam County",1,66,413,206,207
050,18,133,"Indiana","Putnam County",1,67,407,212,195
050,18,133,"Indiana","Putnam County",1,68,399,203,196
050,18,133,"Indiana","Putnam County",1,69,366,183,183
050,18,133,"Indiana","Putnam County",1,70,337,167,170
050,18,133,"Indiana","Putnam County",1,71,345,168,177
050,18,133,"Indiana","Putnam County",1,72,340,147,193
050,18,133,"Indiana","Putnam County",1,73,333,161,172
050,18,133,"Indiana","Putnam County",1,74,240,116,124
050,18,133,"Indiana","Putnam County",1,75,243,109,134
050,18,133,"Indiana","Putnam County",1,76,240,108,132
050,18,133,"Indiana","Putnam County",1,77,224,100,124
050,18,133,"Indiana","Putnam County",1,78,214,87,127
050,18,133,"Indiana","Putnam County",1,79,210,99,111
050,18,133,"Indiana","Putnam County",1,80,162,77,85
050,18,133,"Indiana","Putnam County",1,81,169,73,96
050,18,133,"Indiana","Putnam County",1,82,145,62,83
050,18,133,"Indiana","Putnam County",1,83,126,56,70
050,18,133,"Indiana","Putnam County",1,84,124,44,80
050,18,133,"Indiana","Putnam County",1,85,691,263,428
050,18,133,"Indiana","Putnam County",2,0,362,189,173
050,18,133,"Indiana","Putnam County",2,1,376,186,190
050,18,133,"Indiana","Putnam County",2,2,364,182,182
050,18,133,"Indiana","Putnam County",2,3,354,180,174
050,18,133,"Indiana","Putnam County",2,4,385,196,189
050,18,133,"Indiana","Putnam County",2,5,376,195,181
050,18,133,"Indiana","Putnam County",2,6,388,211,177
050,18,133,"Indiana","Putnam County",2,7,398,215,183
050,18,133,"Indiana","Putnam County",2,8,393,204,189
050,18,133,"Indiana","Putnam County",2,9,407,204,203
050,18,133,"Indiana","Putnam County",2,10,421,215,206
050,18,133,"Indiana","Putnam County",2,11,413,212,201
050,18,133,"Indiana","Putnam County",2,12,440,219,221
050,18,133,"Indiana","Putnam County",2,13,437,222,215
050,18,133,"Indiana","Putnam County",2,14,428,218,210
050,18,133,"Indiana","Putnam County",2,15,428,217,211
050,18,133,"Indiana","Putnam County",2,16,439,224,215
050,18,133,"Indiana","Putnam County",2,17,441,222,219
050,18,133,"Indiana","Putnam County",2,18,563,285,278
050,18,133,"Indiana","Putnam County",2,19,840,412,428
050,18,133,"Indiana","Putnam County",2,20,773,394,379
050,18,133,"Indiana","Putnam County",2,21,829,421,408
050,18,133,"Indiana","Putnam County",2,22,710,377,333
050,18,133,"Indiana","Putnam County",2,23,470,274,196
050,18,133,"Indiana","Putnam County",2,24,446,269,177
050,18,133,"Indiana","Putnam County",2,25,458,290,168
050,18,133,"Indiana","Putnam County",2,26,460,282,178
050,18,133,"Indiana","Putnam County",2,27,501,309,192
050,18,133,"Indiana","Putnam County",2,28,513,307,206
050,18,133,"Indiana","Putnam County",2,29,508,296,212
050,18,133,"Indiana","Putnam County",2,30,478,273,205
050,18,133,"Indiana","Putnam County",2,31,461,276,185
050,18,133,"Indiana","Putnam County",2,32,421,248,173
050,18,133,"Indiana","Putnam County",2,33,416,231,185
050,18,133,"Indiana","Putnam County",2,34,413,228,185
050,18,133,"Indiana","Putnam County",2,35,417,224,193
050,18,133,"Indiana","Putnam County",2,36,454,261,193
050,18,133,"Indiana","Putnam County",2,37,457,265,192
050,18,133,"Indiana","Putnam County",2,38,406,239,167
050,18,133,"Indiana","Putnam County",2,39,410,234,176
050,18,133,"Indiana","Putnam County",2,40,439,247,192
050,18,133,"Indiana","Putnam County",2,41,451,251,200
050,18,133,"Indiana","Putnam County",2,42,433,232,201
050,18,133,"Indiana","Putnam County",2,43,429,234,195
050,18,133,"Indiana","Putnam County",2,44,410,220,190
050,18,133,"Indiana","Putnam County",2,45,431,236,195
050,18,133,"Indiana","Putnam County",2,46,424,234,190
050,18,133,"Indiana","Putnam County",2,47,423,241,182
050,18,133,"Indiana","Putnam County",2,48,452,239,213
050,18,133,"Indiana","Putnam County",2,49,486,253,233
050,18,133,"Indiana","Putnam County",2,50,491,253,238
050,18,133,"Indiana","Putnam County",2,51,484,264,220
050,18,133,"Indiana","Putnam County",2,52,473,252,221
050,18,133,"Indiana","Putnam County",2,53,459,248,211
050,18,133,"Indiana","Putnam County",2,54,455,249,206
050,18,133,"Indiana","Putnam County",2,55,501,260,241
050,18,133,"Indiana","Putnam County",2,56,548,280,268
050,18,133,"Indiana","Putnam County",2,57,543,287,256
050,18,133,"Indiana","Putnam County",2,58,527,287,240
050,18,133,"Indiana","Putnam County",2,59,505,265,240
050,18,133,"Indiana","Putnam County",2,60,503,247,256
050,18,133,"Indiana","Putnam County",2,61,528,257,271
050,18,133,"Indiana","Putnam County",2,62,521,260,261
050,18,133,"Indiana","Putnam County",2,63,466,236,230
050,18,133,"Indiana","Putnam County",2,64,447,243,204
050,18,133,"Indiana","Putnam County",2,65,446,240,206
050,18,133,"Indiana","Putnam County",2,66,422,215,207
050,18,133,"Indiana","Putnam County",2,67,402,206,196
050,18,133,"Indiana","Putnam County",2,68,398,204,194
050,18,133,"Indiana","Putnam County",2,69,373,186,187
050,18,133,"Indiana","Putnam County",2,70,344,172,172
050,18,133,"Indiana","Putnam County",2,71,341,165,176
050,18,133,"Indiana","Putnam County",2,72,336,149,187
050,18,133,"Indiana","Putnam County",2,73,349,165,184
050,18,133,"Indiana","Putnam County",2,74,241,116,125
050,18,133,"Indiana","Putnam County",2,75,243,110,133
050,18,133,"Indiana","Putnam County",2,76,237,105,132
050,18,133,"Indiana","Putnam County",2,77,232,104,128
050,18,133,"Indiana","Putnam County",2,78,209,85,124
050,18,133,"Indiana","Putnam County",2,79,205,94,111
050,18,133,"Indiana","Putnam County",2,80,173,83,90
050,18,133,"Indiana","Putnam County",2,81,165,71,94
050,18,133,"Indiana","Putnam County",2,82,148,63,85
050,18,133,"Indiana","Putnam County",2,83,129,57,72
050,18,133,"Indiana","Putnam County",2,84,120,46,74
050,18,133,"Indiana","Putnam County",2,85,693,262,431
050,18,133,"Indiana","Putnam County",3,0,347,177,170
050,18,133,"Indiana","Putnam County",3,1,387,203,184
050,18,133,"Indiana","Putnam County",3,2,378,181,197
050,18,133,"Indiana","Putnam County",3,3,368,182,186
050,18,133,"Indiana","Putnam County",3,4,367,195,172
050,18,133,"Indiana","Putnam County",3,5,386,197,189
050,18,133,"Indiana","Putnam County",3,6,402,206,196
050,18,133,"Indiana","Putnam County",3,7,400,213,187
050,18,133,"Indiana","Putnam County",3,8,413,226,187
050,18,133,"Indiana","Putnam County",3,9,391,206,185
050,18,133,"Indiana","Putnam County",3,10,423,212,211
050,18,133,"Indiana","Putnam County",3,11,417,209,208
050,18,133,"Indiana","Putnam County",3,12,423,227,196
050,18,133,"Indiana","Putnam County",3,13,456,227,229
050,18,133,"Indiana","Putnam County",3,14,434,225,209
050,18,133,"Indiana","Putnam County",3,15,428,219,209
050,18,133,"Indiana","Putnam County",3,16,419,221,198
050,18,133,"Indiana","Putnam County",3,17,449,233,216
050,18,133,"Indiana","Putnam County",3,18,568,276,292
050,18,133,"Indiana","Putnam County",3,19,823,396,427
050,18,133,"Indiana","Putnam County",3,20,775,404,371
050,18,133,"Indiana","Putnam County",3,21,835,438,397
050,18,133,"Indiana","Putnam County",3,22,688,377,311
050,18,133,"Indiana","Putnam County",3,23,452,272,180
050,18,133,"Indiana","Putnam County",3,24,461,270,191
050,18,133,"Indiana","Putnam County",3,25,516,321,195
050,18,133,"Indiana","Putnam County",3,26,477,301,176
050,18,133,"Indiana","Putnam County",3,27,510,326,184
050,18,133,"Indiana","Putnam County",3,28,484,303,181
050,18,133,"Indiana","Putnam County",3,29,524,316,208
050,18,133,"Indiana","Putnam County",3,30,538,320,218
050,18,133,"Indiana","Putnam County",3,31,475,277,198
050,18,133,"Indiana","Putnam County",3,32,445,259,186
050,18,133,"Indiana","Putnam County",3,33,434,257,177
050,18,133,"Indiana","Putnam County",3,34,439,235,204
050,18,133,"Indiana","Putnam County",3,35,403,212,191
050,18,133,"Indiana","Putnam County",3,36,443,239,204
050,18,133,"Indiana","Putnam County",3,37,468,269,199
050,18,133,"Indiana","Putnam County",3,38,474,281,193
050,18,133,"Indiana","Putnam County",3,39,412,247,165
050,18,133,"Indiana","Putnam County",3,40,425,250,175
050,18,133,"Indiana","Putnam County",3,41,451,255,196
050,18,133,"Indiana","Putnam County",3,42,447,249,198
050,18,133,"Indiana","Putnam County",3,43,446,240,206
050,18,133,"Indiana","Putnam County",3,44,435,246,189
050,18,133,"Indiana","Putnam County",3,45,413,223,190
050,18,133,"Indiana","Putnam County",3,46,435,241,194
050,18,133,"Indiana","Putnam County",3,47,432,241,191
050,18,133,"Indiana","Putnam County",3,48,413,222,191
050,18,133,"Indiana","Putnam County",3,49,454,241,213
050,18,133,"Indiana","Putnam County",3,50,479,259,220
050,18,133,"Indiana","Putnam County",3,51,488,257,231
050,18,133,"Indiana","Putnam County",3,52,474,256,218
050,18,133,"Indiana","Putnam County",3,53,467,251,216
050,18,133,"Indiana","Putnam County",3,54,472,256,216
050,18,133,"Indiana","Putnam County",3,55,438,241,197
050,18,133,"Indiana","Putnam County",3,56,506,261,245
050,18,133,"Indiana","Putnam County",3,57,535,271,264
050,18,133,"Indiana","Putnam County",3,58,544,285,259
050,18,133,"Indiana","Putnam County",3,59,515,285,230
050,18,133,"Indiana","Putnam County",3,60,492,254,238
050,18,133,"Indiana","Putnam County",3,61,517,256,261
050,18,133,"Indiana","Putnam County",3,62,518,256,262
050,18,133,"Indiana","Putnam County",3,63,522,261,261
050,18,133,"Indiana","Putnam County",3,64,460,236,224
050,18,133,"Indiana","Putnam County",3,65,452,249,203
050,18,133,"Indiana","Putnam County",3,66,434,229,205
050,18,133,"Indiana","Putnam County",3,67,411,208,203
050,18,133,"Indiana","Putnam County",3,68,397,204,193
050,18,133,"Indiana","Putnam County",3,69,388,200,188
050,18,133,"Indiana","Putnam County",3,70,361,176,185
050,18,133,"Indiana","Putnam County",3,71,342,173,169
050,18,133,"Indiana","Putnam County",3,72,324,156,168
050,18,133,"Indiana","Putnam County",3,73,321,140,181
050,18,133,"Indiana","Putnam County",3,74,338,161,177
050,18,133,"Indiana","Putnam County",3,75,228,115,113
050,18,133,"Indiana","Putnam County",3,76,235,100,135
050,18,133,"Indiana","Putnam County",3,77,228,101,127
050,18,133,"Indiana","Putnam County",3,78,229,96,133
050,18,133,"Indiana","Putnam County",3,79,194,79,115
050,18,133,"Indiana","Putnam County",3,80,181,84,97
050,18,133,"Indiana","Putnam County",3,81,168,81,87
050,18,133,"Indiana","Putnam County",3,82,153,68,85
050,18,133,"Indiana","Putnam County",3,83,141,57,84
050,18,133,"Indiana","Putnam County",3,84,112,47,65
050,18,133,"Indiana","Putnam County",3,85,696,264,432
050,18,133,"Indiana","Putnam County",4,0,341,176,165
050,18,133,"Indiana","Putnam County",4,1,384,196,188
050,18,133,"Indiana","Putnam County",4,2,400,206,194
050,18,133,"Indiana","Putnam County",4,3,376,188,188
050,18,133,"Indiana","Putnam County",4,4,375,179,196
050,18,133,"Indiana","Putnam County",4,5,368,191,177
050,18,133,"Indiana","Putnam County",4,6,403,202,201
050,18,133,"Indiana","Putnam County",4,7,401,205,196
050,18,133,"Indiana","Putnam County",4,8,422,226,196
050,18,133,"Indiana","Putnam County",4,9,426,232,194
050,18,133,"Indiana","Putnam County",4,10,389,206,183
050,18,133,"Indiana","Putnam County",4,11,435,220,215
050,18,133,"Indiana","Putnam County",4,12,425,216,209
050,18,133,"Indiana","Putnam County",4,13,423,225,198
050,18,133,"Indiana","Putnam County",4,14,460,221,239
050,18,133,"Indiana","Putnam County",4,15,447,239,208
050,18,133,"Indiana","Putnam County",4,16,441,222,219
050,18,133,"Indiana","Putnam County",4,17,428,222,206
050,18,133,"Indiana","Putnam County",4,18,568,297,271
050,18,133,"Indiana","Putnam County",4,19,829,394,435
050,18,133,"Indiana","Putnam County",4,20,766,392,374
050,18,133,"Indiana","Putnam County",4,21,846,442,404
050,18,133,"Indiana","Putnam County",4,22,712,397,315
050,18,133,"Indiana","Putnam County",4,23,443,274,169
050,18,133,"Indiana","Putnam County",4,24,437,240,197
050,18,133,"Indiana","Putnam County",4,25,493,294,199
050,18,133,"Indiana","Putnam County",4,26,527,322,205
050,18,133,"Indiana","Putnam County",4,27,497,322,175
050,18,133,"Indiana","Putnam County",4,28,502,310,192
050,18,133,"Indiana","Putnam County",4,29,515,321,194
050,18,133,"Indiana","Putnam County",4,30,540,329,211
050,18,133,"Indiana","Putnam County",4,31,539,309,230
050,18,133,"Indiana","Putnam County",4,32,468,266,202
050,18,133,"Indiana","Putnam County",4,33,456,258,198
050,18,133,"Indiana","Putnam County",4,34,434,253,181
050,18,133,"Indiana","Putnam County",4,35,428,221,207
050,18,133,"Indiana","Putnam County",4,36,416,222,194
050,18,133,"Indiana","Putnam County",4,37,460,243,217
050,18,133,"Indiana","Putnam County",4,38,437,249,188
050,18,133,"Indiana","Putnam County",4,39,487,284,203
050,18,133,"Indiana","Putnam County",4,40,403,242,161
050,18,133,"Indiana","Putnam County",4,41,428,252,176
050,18,133,"Indiana","Putnam County",4,42,440,238,202
050,18,133,"Indiana","Putnam County",4,43,441,242,199
050,18,133,"Indiana","Putnam County",4,44,431,223,208
050,18,133,"Indiana","Putnam County",4,45,442,253,189
050,18,133,"Indiana","Putnam County",4,46,416,236,180
050,18,133,"Indiana","Putnam County",4,47,426,245,181
050,18,133,"Indiana","Putnam County",4,48,408,212,196
050,18,133,"Indiana","Putnam County",4,49,411,217,194
050,18,133,"Indiana","Putnam County",4,50,479,260,219
050,18,133,"Indiana","Putnam County",4,51,462,248,214
050,18,133,"Indiana","Putnam County",4,52,488,246,242
050,18,133,"Indiana","Putnam County",4,53,487,257,230
050,18,133,"Indiana","Putnam County",4,54,469,250,219
050,18,133,"Indiana","Putnam County",4,55,463,248,215
050,18,133,"Indiana","Putnam County",4,56,435,243,192
050,18,133,"Indiana","Putnam County",4,57,501,257,244
050,18,133,"Indiana","Putnam County",4,58,557,283,274
050,18,133,"Indiana","Putnam County",4,59,527,278,249
050,18,133,"Indiana","Putnam County",4,60,504,271,233
050,18,133,"Indiana","Putnam County",4,61,485,245,240
050,18,133,"Indiana","Putnam County",4,62,513,256,257
050,18,133,"Indiana","Putnam County",4,63,506,243,263
050,18,133,"Indiana","Putnam County",4,64,521,256,265
050,18,133,"Indiana","Putnam County",4,65,467,239,228
050,18,133,"Indiana","Putnam County",4,66,435,241,194
050,18,133,"Indiana","Putnam County",4,67,425,224,201
050,18,133,"Indiana","Putnam County",4,68,419,215,204
050,18,133,"Indiana","Putnam County",4,69,387,189,198
050,18,133,"Indiana","Putnam County",4,70,376,191,185
050,18,133,"Indiana","Putnam County",4,71,359,180,179
050,18,133,"Indiana","Putnam County",4,72,342,167,175
050,18,133,"Indiana","Putnam County",4,73,313,150,163
050,18,133,"Indiana","Putnam County",4,74,303,132,171
050,18,133,"Indiana","Putnam County",4,75,322,154,168
050,18,133,"Indiana","Putnam County",4,76,220,109,111
050,18,133,"Indiana","Putnam County",4,77,224,95,129
050,18,133,"Indiana","Putnam County",4,78,231,99,132
050,18,133,"Indiana","Putnam County",4,79,205,88,117
050,18,133,"Indiana","Putnam County",4,80,178,70,108
050,18,133,"Indiana","Putnam County",4,81,181,83,98
050,18,133,"Indiana","Putnam County",4,82,150,72,78
050,18,133,"Indiana","Putnam County",4,83,147,61,86
050,18,133,"Indiana","Putnam County",4,84,122,47,75
050,18,133,"Indiana","Putnam County",4,85,701,273,428
050,18,133,"Indiana","Putnam County",5,0,346,179,167
050,18,133,"Indiana","Putnam County",5,1,348,169,179
050,18,133,"Indiana","Putnam County",5,2,399,209,190
050,18,133,"Indiana","Putnam County",5,3,391,202,189
050,18,133,"Indiana","Putnam County",5,4,377,192,185
050,18,133,"Indiana","Putnam County",5,5,402,200,202
050,18,133,"Indiana","Putnam County",5,6,369,197,172
050,18,133,"Indiana","Putnam County",5,7,409,206,203
050,18,133,"Indiana","Putnam County",5,8,401,210,191
050,18,133,"Indiana","Putnam County",5,9,416,231,185
050,18,133,"Indiana","Putnam County",5,10,427,235,192
050,18,133,"Indiana","Putnam County",5,11,409,218,191
050,18,133,"Indiana","Putnam County",5,12,446,230,216
050,18,133,"Indiana","Putnam County",5,13,426,213,213
050,18,133,"Indiana","Putnam County",5,14,435,231,204
050,18,133,"Indiana","Putnam County",5,15,493,245,248
050,18,133,"Indiana","Putnam County",5,16,448,235,213
050,18,133,"Indiana","Putnam County",5,17,446,217,229
050,18,133,"Indiana","Putnam County",5,18,542,275,267
050,18,133,"Indiana","Putnam County",5,19,845,419,426
050,18,133,"Indiana","Putnam County",5,20,775,388,387
050,18,133,"Indiana","Putnam County",5,21,832,427,405
050,18,133,"Indiana","Putnam County",5,22,726,400,326
050,18,133,"Indiana","Putnam County",5,23,466,293,173
050,18,133,"Indiana","Putnam County",5,24,412,256,156
050,18,133,"Indiana","Putnam County",5,25,453,270,183
050,18,133,"Indiana","Putnam County",5,26,493,293,200
050,18,133,"Indiana","Putnam County",5,27,553,344,209
050,18,133,"Indiana","Putnam County",5,28,490,308,182
050,18,133,"Indiana","Putnam County",5,29,526,324,202
050,18,133,"Indiana","Putnam County",5,30,524,319,205
050,18,133,"Indiana","Putnam County",5,31,539,322,217
050,18,133,"Indiana","Putnam County",5,32,530,286,244
050,18,133,"Indiana","Putnam County",5,33,466,260,206
050,18,133,"Indiana","Putnam County",5,34,463,268,195
050,18,133,"Indiana","Putnam County",5,35,423,247,176
050,18,133,"Indiana","Putnam County",5,36,443,236,207
050,18,133,"Indiana","Putnam County",5,37,433,226,207
050,18,133,"Indiana","Putnam County",5,38,466,248,218
050,18,133,"Indiana","Putnam County",5,39,449,257,192
050,18,133,"Indiana","Putnam County",5,40,485,285,200
050,18,133,"Indiana","Putnam County",5,41,408,247,161
050,18,133,"Indiana","Putnam County",5,42,428,240,188
050,18,133,"Indiana","Putnam County",5,43,444,242,202
050,18,133,"Indiana","Putnam County",5,44,438,232,206
050,18,133,"Indiana","Putnam County",5,45,431,229,202
050,18,133,"Indiana","Putnam County",5,46,449,265,184
050,18,133,"Indiana","Putnam County",5,47,415,235,180
050,18,133,"Indiana","Putnam County",5,48,404,234,170
050,18,133,"Indiana","Putnam County",5,49,425,229,196
050,18,133,"Indiana","Putnam County",5,50,426,227,199
050,18,133,"Indiana","Putnam County",5,51,477,258,219
050,18,133,"Indiana","Putnam County",5,52,455,236,219
050,18,133,"Indiana","Putnam County",5,53,497,248,249
050,18,133,"Indiana","Putnam County",5,54,485,256,229
050,18,133,"Indiana","Putnam County",5,55,451,231,220
050,18,133,"Indiana","Putnam County",5,56,453,240,213
050,18,133,"Indiana","Putnam County",5,57,450,249,201
050,18,133,"Indiana","Putnam County",5,58,514,263,251
050,18,133,"Indiana","Putnam County",5,59,557,281,276
050,18,133,"Indiana","Putnam County",5,60,514,272,242
050,18,133,"Indiana","Putnam County",5,61,511,277,234
050,18,133,"Indiana","Putnam County",5,62,487,249,238
050,18,133,"Indiana","Putnam County",5,63,505,248,257
050,18,133,"Indiana","Putnam County",5,64,508,244,264
050,18,133,"Indiana","Putnam County",5,65,517,255,262
050,18,133,"Indiana","Putnam County",5,66,445,229,216
050,18,133,"Indiana","Putnam County",5,67,423,231,192
050,18,133,"Indiana","Putnam County",5,68,429,228,201
050,18,133,"Indiana","Putnam County",5,69,403,197,206
050,18,133,"Indiana","Putnam County",5,70,377,179,198
050,18,133,"Indiana","Putnam County",5,71,369,189,180
050,18,133,"Indiana","Putnam County",5,72,357,179,178
050,18,133,"Indiana","Putnam County",5,73,322,154,168
050,18,133,"Indiana","Putnam County",5,74,306,147,159
050,18,133,"Indiana","Putnam County",5,75,299,133,166
050,18,133,"Indiana","Putnam County",5,76,306,147,159
050,18,133,"Indiana","Putnam County",5,77,212,109,103
050,18,133,"Indiana","Putnam County",5,78,219,89,130
050,18,133,"Indiana","Putnam County",5,79,210,97,113
050,18,133,"Indiana","Putnam County",5,80,185,80,105
050,18,133,"Indiana","Putnam County",5,81,169,66,103
050,18,133,"Indiana","Putnam County",5,82,164,75,89
050,18,133,"Indiana","Putnam County",5,83,143,67,76
050,18,133,"Indiana","Putnam County",5,84,128,51,77
050,18,133,"Indiana","Putnam County",5,85,730,288,442
050,18,135,"Indiana","Randolph County",1,0,269,138,131
050,18,135,"Indiana","Randolph County",1,1,266,143,123
050,18,135,"Indiana","Randolph County",1,2,270,150,120
050,18,135,"Indiana","Randolph County",1,3,297,153,144
050,18,135,"Indiana","Randolph County",1,4,295,152,143
050,18,135,"Indiana","Randolph County",1,5,293,147,146
050,18,135,"Indiana","Randolph County",1,6,295,155,140
050,18,135,"Indiana","Randolph County",1,7,327,153,174
050,18,135,"Indiana","Randolph County",1,8,323,165,158
050,18,135,"Indiana","Randolph County",1,9,294,145,149
050,18,135,"Indiana","Randolph County",1,10,287,145,142
050,18,135,"Indiana","Randolph County",1,11,325,160,165
050,18,135,"Indiana","Randolph County",1,12,353,170,183
050,18,135,"Indiana","Randolph County",1,13,352,183,169
050,18,135,"Indiana","Randolph County",1,14,312,163,149
050,18,135,"Indiana","Randolph County",1,15,341,177,164
050,18,135,"Indiana","Randolph County",1,16,359,188,171
050,18,135,"Indiana","Randolph County",1,17,346,178,168
050,18,135,"Indiana","Randolph County",1,18,296,160,136
050,18,135,"Indiana","Randolph County",1,19,249,129,120
050,18,135,"Indiana","Randolph County",1,20,272,145,127
050,18,135,"Indiana","Randolph County",1,21,270,136,134
050,18,135,"Indiana","Randolph County",1,22,271,147,124
050,18,135,"Indiana","Randolph County",1,23,270,142,128
050,18,135,"Indiana","Randolph County",1,24,267,141,126
050,18,135,"Indiana","Randolph County",1,25,271,138,133
050,18,135,"Indiana","Randolph County",1,26,257,124,133
050,18,135,"Indiana","Randolph County",1,27,282,149,133
050,18,135,"Indiana","Randolph County",1,28,274,142,132
050,18,135,"Indiana","Randolph County",1,29,257,130,127
050,18,135,"Indiana","Randolph County",1,30,277,140,137
050,18,135,"Indiana","Randolph County",1,31,266,124,142
050,18,135,"Indiana","Randolph County",1,32,254,132,122
050,18,135,"Indiana","Randolph County",1,33,247,133,114
050,18,135,"Indiana","Randolph County",1,34,250,135,115
050,18,135,"Indiana","Randolph County",1,35,263,148,115
050,18,135,"Indiana","Randolph County",1,36,274,146,128
050,18,135,"Indiana","Randolph County",1,37,249,123,126
050,18,135,"Indiana","Randolph County",1,38,260,116,144
050,18,135,"Indiana","Randolph County",1,39,291,133,158
050,18,135,"Indiana","Randolph County",1,40,294,151,143
050,18,135,"Indiana","Randolph County",1,41,299,147,152
050,18,135,"Indiana","Randolph County",1,42,304,145,159
050,18,135,"Indiana","Randolph County",1,43,286,145,141
050,18,135,"Indiana","Randolph County",1,44,274,133,141
050,18,135,"Indiana","Randolph County",1,45,292,144,148
050,18,135,"Indiana","Randolph County",1,46,286,141,145
050,18,135,"Indiana","Randolph County",1,47,326,169,157
050,18,135,"Indiana","Randolph County",1,48,344,185,159
050,18,135,"Indiana","Randolph County",1,49,342,177,165
050,18,135,"Indiana","Randolph County",1,50,321,164,157
050,18,135,"Indiana","Randolph County",1,51,302,165,137
050,18,135,"Indiana","Randolph County",1,52,290,157,133
050,18,135,"Indiana","Randolph County",1,53,295,153,142
050,18,135,"Indiana","Randolph County",1,54,340,172,168
050,18,135,"Indiana","Randolph County",1,55,352,171,181
050,18,135,"Indiana","Randolph County",1,56,350,171,179
050,18,135,"Indiana","Randolph County",1,57,341,174,167
050,18,135,"Indiana","Randolph County",1,58,378,193,185
050,18,135,"Indiana","Randolph County",1,59,351,174,177
050,18,135,"Indiana","Randolph County",1,60,353,178,175
050,18,135,"Indiana","Randolph County",1,61,355,174,181
050,18,135,"Indiana","Randolph County",1,62,348,160,188
050,18,135,"Indiana","Randolph County",1,63,349,166,183
050,18,135,"Indiana","Randolph County",1,64,335,170,165
050,18,135,"Indiana","Randolph County",1,65,322,174,148
050,18,135,"Indiana","Randolph County",1,66,315,163,152
050,18,135,"Indiana","Randolph County",1,67,286,136,150
050,18,135,"Indiana","Randolph County",1,68,287,134,153
050,18,135,"Indiana","Randolph County",1,69,283,128,155
050,18,135,"Indiana","Randolph County",1,70,266,130,136
050,18,135,"Indiana","Randolph County",1,71,266,128,138
050,18,135,"Indiana","Randolph County",1,72,281,132,149
050,18,135,"Indiana","Randolph County",1,73,264,129,135
050,18,135,"Indiana","Randolph County",1,74,181,85,96
050,18,135,"Indiana","Randolph County",1,75,209,100,109
050,18,135,"Indiana","Randolph County",1,76,201,96,105
050,18,135,"Indiana","Randolph County",1,77,192,84,108
050,18,135,"Indiana","Randolph County",1,78,183,80,103
050,18,135,"Indiana","Randolph County",1,79,145,68,77
050,18,135,"Indiana","Randolph County",1,80,146,72,74
050,18,135,"Indiana","Randolph County",1,81,152,61,91
050,18,135,"Indiana","Randolph County",1,82,126,55,71
050,18,135,"Indiana","Randolph County",1,83,95,38,57
050,18,135,"Indiana","Randolph County",1,84,110,45,65
050,18,135,"Indiana","Randolph County",1,85,620,223,397
050,18,135,"Indiana","Randolph County",2,0,271,142,129
050,18,135,"Indiana","Randolph County",2,1,264,140,124
050,18,135,"Indiana","Randolph County",2,2,266,146,120
050,18,135,"Indiana","Randolph County",2,3,287,151,136
050,18,135,"Indiana","Randolph County",2,4,292,150,142
050,18,135,"Indiana","Randolph County",2,5,292,146,146
050,18,135,"Indiana","Randolph County",2,6,295,153,142
050,18,135,"Indiana","Randolph County",2,7,318,154,164
050,18,135,"Indiana","Randolph County",2,8,323,161,162
050,18,135,"Indiana","Randolph County",2,9,299,149,150
050,18,135,"Indiana","Randolph County",2,10,286,142,144
050,18,135,"Indiana","Randolph County",2,11,316,156,160
050,18,135,"Indiana","Randolph County",2,12,346,169,177
050,18,135,"Indiana","Randolph County",2,13,351,180,171
050,18,135,"Indiana","Randolph County",2,14,318,166,152
050,18,135,"Indiana","Randolph County",2,15,335,175,160
050,18,135,"Indiana","Randolph County",2,16,353,184,169
050,18,135,"Indiana","Randolph County",2,17,347,180,167
050,18,135,"Indiana","Randolph County",2,18,292,157,135
050,18,135,"Indiana","Randolph County",2,19,244,129,115
050,18,135,"Indiana","Randolph County",2,20,269,143,126
050,18,135,"Indiana","Randolph County",2,21,271,139,132
050,18,135,"Indiana","Randolph County",2,22,269,143,126
050,18,135,"Indiana","Randolph County",2,23,269,142,127
050,18,135,"Indiana","Randolph County",2,24,269,143,126
050,18,135,"Indiana","Randolph County",2,25,270,141,129
050,18,135,"Indiana","Randolph County",2,26,261,127,134
050,18,135,"Indiana","Randolph County",2,27,272,142,130
050,18,135,"Indiana","Randolph County",2,28,273,143,130
050,18,135,"Indiana","Randolph County",2,29,262,133,129
050,18,135,"Indiana","Randolph County",2,30,270,135,135
050,18,135,"Indiana","Randolph County",2,31,263,127,136
050,18,135,"Indiana","Randolph County",2,32,254,127,127
050,18,135,"Indiana","Randolph County",2,33,250,132,118
050,18,135,"Indiana","Randolph County",2,34,250,135,115
050,18,135,"Indiana","Randolph County",2,35,263,146,117
050,18,135,"Indiana","Randolph County",2,36,269,146,123
050,18,135,"Indiana","Randolph County",2,37,258,130,128
050,18,135,"Indiana","Randolph County",2,38,258,116,142
050,18,135,"Indiana","Randolph County",2,39,281,129,152
050,18,135,"Indiana","Randolph County",2,40,296,148,148
050,18,135,"Indiana","Randolph County",2,41,297,147,150
050,18,135,"Indiana","Randolph County",2,42,299,143,156
050,18,135,"Indiana","Randolph County",2,43,292,146,146
050,18,135,"Indiana","Randolph County",2,44,274,135,139
050,18,135,"Indiana","Randolph County",2,45,289,143,146
050,18,135,"Indiana","Randolph County",2,46,286,141,145
050,18,135,"Indiana","Randolph County",2,47,314,160,154
050,18,135,"Indiana","Randolph County",2,48,337,180,157
050,18,135,"Indiana","Randolph County",2,49,343,179,164
050,18,135,"Indiana","Randolph County",2,50,326,166,160
050,18,135,"Indiana","Randolph County",2,51,306,165,141
050,18,135,"Indiana","Randolph County",2,52,291,158,133
050,18,135,"Indiana","Randolph County",2,53,293,154,139
050,18,135,"Indiana","Randolph County",2,54,330,168,162
050,18,135,"Indiana","Randolph County",2,55,349,169,180
050,18,135,"Indiana","Randolph County",2,56,352,173,179
050,18,135,"Indiana","Randolph County",2,57,339,173,166
050,18,135,"Indiana","Randolph County",2,58,364,186,178
050,18,135,"Indiana","Randolph County",2,59,360,180,180
050,18,135,"Indiana","Randolph County",2,60,351,177,174
050,18,135,"Indiana","Randolph County",2,61,349,171,178
050,18,135,"Indiana","Randolph County",2,62,346,161,185
050,18,135,"Indiana","Randolph County",2,63,352,167,185
050,18,135,"Indiana","Randolph County",2,64,336,168,168
050,18,135,"Indiana","Randolph County",2,65,325,173,152
050,18,135,"Indiana","Randolph County",2,66,314,164,150
050,18,135,"Indiana","Randolph County",2,67,288,141,147
050,18,135,"Indiana","Randolph County",2,68,286,133,153
050,18,135,"Indiana","Randolph County",2,69,287,131,156
050,18,135,"Indiana","Randolph County",2,70,268,130,138
050,18,135,"Indiana","Randolph County",2,71,266,128,138
050,18,135,"Indiana","Randolph County",2,72,273,128,145
050,18,135,"Indiana","Randolph County",2,73,278,135,143
050,18,135,"Indiana","Randolph County",2,74,188,89,99
050,18,135,"Indiana","Randolph County",2,75,204,97,107
050,18,135,"Indiana","Randolph County",2,76,200,96,104
050,18,135,"Indiana","Randolph County",2,77,199,89,110
050,18,135,"Indiana","Randolph County",2,78,175,75,100
050,18,135,"Indiana","Randolph County",2,79,154,70,84
050,18,135,"Indiana","Randolph County",2,80,144,71,73
050,18,135,"Indiana","Randolph County",2,81,148,62,86
050,18,135,"Indiana","Randolph County",2,82,129,56,73
050,18,135,"Indiana","Randolph County",2,83,101,40,61
050,18,135,"Indiana","Randolph County",2,84,102,40,62
050,18,135,"Indiana","Randolph County",2,85,619,226,393
050,18,135,"Indiana","Randolph County",3,0,279,136,143
050,18,135,"Indiana","Randolph County",3,1,266,139,127
050,18,135,"Indiana","Randolph County",3,2,262,138,124
050,18,135,"Indiana","Randolph County",3,3,275,155,120
050,18,135,"Indiana","Randolph County",3,4,307,163,144
050,18,135,"Indiana","Randolph County",3,5,299,153,146
050,18,135,"Indiana","Randolph County",3,6,295,150,145
050,18,135,"Indiana","Randolph County",3,7,312,177,135
050,18,135,"Indiana","Randolph County",3,8,314,156,158
050,18,135,"Indiana","Randolph County",3,9,330,159,171
050,18,135,"Indiana","Randolph County",3,10,310,154,156
050,18,135,"Indiana","Randolph County",3,11,294,148,146
050,18,135,"Indiana","Randolph County",3,12,317,159,158
050,18,135,"Indiana","Randolph County",3,13,336,168,168
050,18,135,"Indiana","Randolph County",3,14,342,169,173
050,18,135,"Indiana","Randolph County",3,15,326,167,159
050,18,135,"Indiana","Randolph County",3,16,341,172,169
050,18,135,"Indiana","Randolph County",3,17,348,178,170
050,18,135,"Indiana","Randolph County",3,18,293,156,137
050,18,135,"Indiana","Randolph County",3,19,231,124,107
050,18,135,"Indiana","Randolph County",3,20,258,136,122
050,18,135,"Indiana","Randolph County",3,21,292,154,138
050,18,135,"Indiana","Randolph County",3,22,295,143,152
050,18,135,"Indiana","Randolph County",3,23,258,135,123
050,18,135,"Indiana","Randolph County",3,24,286,140,146
050,18,135,"Indiana","Randolph County",3,25,271,140,131
050,18,135,"Indiana","Randolph County",3,26,265,134,131
050,18,135,"Indiana","Randolph County",3,27,263,130,133
050,18,135,"Indiana","Randolph County",3,28,280,155,125
050,18,135,"Indiana","Randolph County",3,29,273,142,131
050,18,135,"Indiana","Randolph County",3,30,262,138,124
050,18,135,"Indiana","Randolph County",3,31,274,136,138
050,18,135,"Indiana","Randolph County",3,32,272,125,147
050,18,135,"Indiana","Randolph County",3,33,257,127,130
050,18,135,"Indiana","Randolph County",3,34,262,144,118
050,18,135,"Indiana","Randolph County",3,35,251,136,115
050,18,135,"Indiana","Randolph County",3,36,269,150,119
050,18,135,"Indiana","Randolph County",3,37,279,151,128
050,18,135,"Indiana","Randolph County",3,38,254,128,126
050,18,135,"Indiana","Randolph County",3,39,269,123,146
050,18,135,"Indiana","Randolph County",3,40,274,124,150
050,18,135,"Indiana","Randolph County",3,41,302,152,150
050,18,135,"Indiana","Randolph County",3,42,292,143,149
050,18,135,"Indiana","Randolph County",3,43,298,138,160
050,18,135,"Indiana","Randolph County",3,44,285,145,140
050,18,135,"Indiana","Randolph County",3,45,277,137,140
050,18,135,"Indiana","Randolph County",3,46,286,143,143
050,18,135,"Indiana","Randolph County",3,47,296,147,149
050,18,135,"Indiana","Randolph County",3,48,314,167,147
050,18,135,"Indiana","Randolph County",3,49,339,177,162
050,18,135,"Indiana","Randolph County",3,50,332,169,163
050,18,135,"Indiana","Randolph County",3,51,328,171,157
050,18,135,"Indiana","Randolph County",3,52,312,171,141
050,18,135,"Indiana","Randolph County",3,53,292,156,136
050,18,135,"Indiana","Randolph County",3,54,296,151,145
050,18,135,"Indiana","Randolph County",3,55,332,165,167
050,18,135,"Indiana","Randolph County",3,56,345,171,174
050,18,135,"Indiana","Randolph County",3,57,354,170,184
050,18,135,"Indiana","Randolph County",3,58,336,165,171
050,18,135,"Indiana","Randolph County",3,59,367,185,182
050,18,135,"Indiana","Randolph County",3,60,352,180,172
050,18,135,"Indiana","Randolph County",3,61,348,176,172
050,18,135,"Indiana","Randolph County",3,62,345,171,174
050,18,135,"Indiana","Randolph County",3,63,339,162,177
050,18,135,"Indiana","Randolph County",3,64,336,157,179
050,18,135,"Indiana","Randolph County",3,65,330,161,169
050,18,135,"Indiana","Randolph County",3,66,311,162,149
050,18,135,"Indiana","Randolph County",3,67,305,157,148
050,18,135,"Indiana","Randolph County",3,68,275,133,142
050,18,135,"Indiana","Randolph County",3,69,282,129,153
050,18,135,"Indiana","Randolph County",3,70,274,125,149
050,18,135,"Indiana","Randolph County",3,71,259,124,135
050,18,135,"Indiana","Randolph County",3,72,262,125,137
050,18,135,"Indiana","Randolph County",3,73,265,125,140
050,18,135,"Indiana","Randolph County",3,74,268,131,137
050,18,135,"Indiana","Randolph County",3,75,175,81,94
050,18,135,"Indiana","Randolph County",3,76,203,97,106
050,18,135,"Indiana","Randolph County",3,77,185,88,97
050,18,135,"Indiana","Randolph County",3,78,192,84,108
050,18,135,"Indiana","Randolph County",3,79,167,68,99
050,18,135,"Indiana","Randolph County",3,80,139,63,76
050,18,135,"Indiana","Randolph County",3,81,135,67,68
050,18,135,"Indiana","Randolph County",3,82,134,58,76
050,18,135,"Indiana","Randolph County",3,83,121,48,73
050,18,135,"Indiana","Randolph County",3,84,92,36,56
050,18,135,"Indiana","Randolph County",3,85,591,218,373
050,18,135,"Indiana","Randolph County",4,0,286,142,144
050,18,135,"Indiana","Randolph County",4,1,298,148,150
050,18,135,"Indiana","Randolph County",4,2,264,139,125
050,18,135,"Indiana","Randolph County",4,3,264,143,121
050,18,135,"Indiana","Randolph County",4,4,283,156,127
050,18,135,"Indiana","Randolph County",4,5,308,166,142
050,18,135,"Indiana","Randolph County",4,6,301,152,149
050,18,135,"Indiana","Randolph County",4,7,305,151,154
050,18,135,"Indiana","Randolph County",4,8,313,170,143
050,18,135,"Indiana","Randolph County",4,9,315,153,162
050,18,135,"Indiana","Randolph County",4,10,332,164,168
050,18,135,"Indiana","Randolph County",4,11,324,166,158
050,18,135,"Indiana","Randolph County",4,12,281,136,145
050,18,135,"Indiana","Randolph County",4,13,317,161,156
050,18,135,"Indiana","Randolph County",4,14,344,174,170
050,18,135,"Indiana","Randolph County",4,15,346,168,178
050,18,135,"Indiana","Randolph County",4,16,328,170,158
050,18,135,"Indiana","Randolph County",4,17,331,171,160
050,18,135,"Indiana","Randolph County",4,18,298,160,138
050,18,135,"Indiana","Randolph County",4,19,223,124,99
050,18,135,"Indiana","Randolph County",4,20,235,130,105
050,18,135,"Indiana","Randolph County",4,21,261,135,126
050,18,135,"Indiana","Randolph County",4,22,296,157,139
050,18,135,"Indiana","Randolph County",4,23,308,148,160
050,18,135,"Indiana","Randolph County",4,24,273,137,136
050,18,135,"Indiana","Randolph County",4,25,284,150,134
050,18,135,"Indiana","Randolph County",4,26,269,132,137
050,18,135,"Indiana","Randolph County",4,27,270,136,134
050,18,135,"Indiana","Randolph County",4,28,279,139,140
050,18,135,"Indiana","Randolph County",4,29,277,156,121
050,18,135,"Indiana","Randolph County",4,30,292,155,137
050,18,135,"Indiana","Randolph County",4,31,271,146,125
050,18,135,"Indiana","Randolph County",4,32,278,135,143
050,18,135,"Indiana","Randolph County",4,33,283,134,149
050,18,135,"Indiana","Randolph County",4,34,252,129,123
050,18,135,"Indiana","Randolph County",4,35,262,143,119
050,18,135,"Indiana","Randolph County",4,36,253,130,123
050,18,135,"Indiana","Randolph County",4,37,261,145,116
050,18,135,"Indiana","Randolph County",4,38,279,156,123
050,18,135,"Indiana","Randolph County",4,39,248,129,119
050,18,135,"Indiana","Randolph County",4,40,265,126,139
050,18,135,"Indiana","Randolph County",4,41,273,125,148
050,18,135,"Indiana","Randolph County",4,42,303,153,150
050,18,135,"Indiana","Randolph County",4,43,287,136,151
050,18,135,"Indiana","Randolph County",4,44,302,147,155
050,18,135,"Indiana","Randolph County",4,45,287,148,139
050,18,135,"Indiana","Randolph County",4,46,278,136,142
050,18,135,"Indiana","Randolph County",4,47,286,143,143
050,18,135,"Indiana","Randolph County",4,48,286,144,142
050,18,135,"Indiana","Randolph County",4,49,316,164,152
050,18,135,"Indiana","Randolph County",4,50,351,187,164
050,18,135,"Indiana","Randolph County",4,51,331,166,165
050,18,135,"Indiana","Randolph County",4,52,335,174,161
050,18,135,"Indiana","Randolph County",4,53,315,171,144
050,18,135,"Indiana","Randolph County",4,54,292,155,137
050,18,135,"Indiana","Randolph County",4,55,293,146,147
050,18,135,"Indiana","Randolph County",4,56,322,166,156
050,18,135,"Indiana","Randolph County",4,57,344,170,174
050,18,135,"Indiana","Randolph County",4,58,354,172,182
050,18,135,"Indiana","Randolph County",4,59,328,159,169
050,18,135,"Indiana","Randolph County",4,60,356,176,180
050,18,135,"Indiana","Randolph County",4,61,349,178,171
050,18,135,"Indiana","Randolph County",4,62,329,169,160
050,18,135,"Indiana","Randolph County",4,63,336,160,176
050,18,135,"Indiana","Randolph County",4,64,333,162,171
050,18,135,"Indiana","Randolph County",4,65,328,150,178
050,18,135,"Indiana","Randolph County",4,66,326,156,170
050,18,135,"Indiana","Randolph County",4,67,304,154,150
050,18,135,"Indiana","Randolph County",4,68,302,150,152
050,18,135,"Indiana","Randolph County",4,69,274,129,145
050,18,135,"Indiana","Randolph County",4,70,271,126,145
050,18,135,"Indiana","Randolph County",4,71,275,125,150
050,18,135,"Indiana","Randolph County",4,72,253,122,131
050,18,135,"Indiana","Randolph County",4,73,256,127,129
050,18,135,"Indiana","Randolph County",4,74,254,118,136
050,18,135,"Indiana","Randolph County",4,75,247,122,125
050,18,135,"Indiana","Randolph County",4,76,168,79,89
050,18,135,"Indiana","Randolph County",4,77,186,87,99
050,18,135,"Indiana","Randolph County",4,78,173,78,95
050,18,135,"Indiana","Randolph County",4,79,186,76,110
050,18,135,"Indiana","Randolph County",4,80,149,59,90
050,18,135,"Indiana","Randolph County",4,81,132,59,73
050,18,135,"Indiana","Randolph County",4,82,122,62,60
050,18,135,"Indiana","Randolph County",4,83,128,49,79
050,18,135,"Indiana","Randolph County",4,84,112,48,64
050,18,135,"Indiana","Randolph County",4,85,561,206,355
050,18,135,"Indiana","Randolph County",5,0,286,142,144
050,18,135,"Indiana","Randolph County",5,1,294,149,145
050,18,135,"Indiana","Randolph County",5,2,295,143,152
050,18,135,"Indiana","Randolph County",5,3,263,139,124
050,18,135,"Indiana","Randolph County",5,4,278,152,126
050,18,135,"Indiana","Randolph County",5,5,288,152,136
050,18,135,"Indiana","Randolph County",5,6,314,170,144
050,18,135,"Indiana","Randolph County",5,7,302,145,157
050,18,135,"Indiana","Randolph County",5,8,303,157,146
050,18,135,"Indiana","Randolph County",5,9,316,178,138
050,18,135,"Indiana","Randolph County",5,10,321,157,164
050,18,135,"Indiana","Randolph County",5,11,333,180,153
050,18,135,"Indiana","Randolph County",5,12,309,153,156
050,18,135,"Indiana","Randolph County",5,13,287,144,143
050,18,135,"Indiana","Randolph County",5,14,304,154,150
050,18,135,"Indiana","Randolph County",5,15,337,175,162
050,18,135,"Indiana","Randolph County",5,16,334,164,170
050,18,135,"Indiana","Randolph County",5,17,330,178,152
050,18,135,"Indiana","Randolph County",5,18,279,148,131
050,18,135,"Indiana","Randolph County",5,19,228,122,106
050,18,135,"Indiana","Randolph County",5,20,243,137,106
050,18,135,"Indiana","Randolph County",5,21,236,132,104
050,18,135,"Indiana","Randolph County",5,22,275,139,136
050,18,135,"Indiana","Randolph County",5,23,309,168,141
050,18,135,"Indiana","Randolph County",5,24,311,159,152
050,18,135,"Indiana","Randolph County",5,25,272,131,141
050,18,135,"Indiana","Randolph County",5,26,280,151,129
050,18,135,"Indiana","Randolph County",5,27,260,134,126
050,18,135,"Indiana","Randolph County",5,28,264,132,132
050,18,135,"Indiana","Randolph County",5,29,283,142,141
050,18,135,"Indiana","Randolph County",5,30,295,159,136
050,18,135,"Indiana","Randolph County",5,31,292,154,138
050,18,135,"Indiana","Randolph County",5,32,264,140,124
050,18,135,"Indiana","Randolph County",5,33,276,142,134
050,18,135,"Indiana","Randolph County",5,34,284,136,148
050,18,135,"Indiana","Randolph County",5,35,259,134,125
050,18,135,"Indiana","Randolph County",5,36,271,147,124
050,18,135,"Indiana","Randolph County",5,37,243,124,119
050,18,135,"Indiana","Randolph County",5,38,269,149,120
050,18,135,"Indiana","Randolph County",5,39,273,154,119
050,18,135,"Indiana","Randolph County",5,40,245,129,116
050,18,135,"Indiana","Randolph County",5,41,272,128,144
050,18,135,"Indiana","Randolph County",5,42,264,119,145
050,18,135,"Indiana","Randolph County",5,43,296,148,148
050,18,135,"Indiana","Randolph County",5,44,284,138,146
050,18,135,"Indiana","Randolph County",5,45,307,151,156
050,18,135,"Indiana","Randolph County",5,46,284,145,139
050,18,135,"Indiana","Randolph County",5,47,272,134,138
050,18,135,"Indiana","Randolph County",5,48,296,147,149
050,18,135,"Indiana","Randolph County",5,49,284,144,140
050,18,135,"Indiana","Randolph County",5,50,304,160,144
050,18,135,"Indiana","Randolph County",5,51,346,180,166
050,18,135,"Indiana","Randolph County",5,52,332,171,161
050,18,135,"Indiana","Randolph County",5,53,342,177,165
050,18,135,"Indiana","Randolph County",5,54,315,172,143
050,18,135,"Indiana","Randolph County",5,55,282,147,135
050,18,135,"Indiana","Randolph County",5,56,289,142,147
050,18,135,"Indiana","Randolph County",5,57,324,163,161
050,18,135,"Indiana","Randolph County",5,58,337,165,172
050,18,135,"Indiana","Randolph County",5,59,347,168,179
050,18,135,"Indiana","Randolph County",5,60,319,154,165
050,18,135,"Indiana","Randolph County",5,61,352,174,178
050,18,135,"Indiana","Randolph County",5,62,338,173,165
050,18,135,"Indiana","Randolph County",5,63,329,170,159
050,18,135,"Indiana","Randolph County",5,64,321,156,165
050,18,135,"Indiana","Randolph County",5,65,319,153,166
050,18,135,"Indiana","Randolph County",5,66,325,145,180
050,18,135,"Indiana","Randolph County",5,67,325,152,173
050,18,135,"Indiana","Randolph County",5,68,295,144,151
050,18,135,"Indiana","Randolph County",5,69,301,148,153
050,18,135,"Indiana","Randolph County",5,70,266,124,142
050,18,135,"Indiana","Randolph County",5,71,267,124,143
050,18,135,"Indiana","Randolph County",5,72,272,122,150
050,18,135,"Indiana","Randolph County",5,73,249,124,125
050,18,135,"Indiana","Randolph County",5,74,246,120,126
050,18,135,"Indiana","Randolph County",5,75,237,110,127
050,18,135,"Indiana","Randolph County",5,76,241,119,122
050,18,135,"Indiana","Randolph County",5,77,156,72,84
050,18,135,"Indiana","Randolph County",5,78,180,82,98
050,18,135,"Indiana","Randolph County",5,79,166,72,94
050,18,135,"Indiana","Randolph County",5,80,169,69,100
050,18,135,"Indiana","Randolph County",5,81,139,53,86
050,18,135,"Indiana","Randolph County",5,82,122,58,64
050,18,135,"Indiana","Randolph County",5,83,115,54,61
050,18,135,"Indiana","Randolph County",5,84,115,44,71
050,18,135,"Indiana","Randolph County",5,85,570,214,356
050,18,137,"Indiana","Ripley County",1,0,388,202,186
050,18,137,"Indiana","Ripley County",1,1,376,200,176
050,18,137,"Indiana","Ripley County",1,2,361,196,165
050,18,137,"Indiana","Ripley County",1,3,356,184,172
050,18,137,"Indiana","Ripley County",1,4,374,199,175
050,18,137,"Indiana","Ripley County",1,5,332,179,153
050,18,137,"Indiana","Ripley County",1,6,348,174,174
050,18,137,"Indiana","Ripley County",1,7,362,180,182
050,18,137,"Indiana","Ripley County",1,8,336,182,154
050,18,137,"Indiana","Ripley County",1,9,344,183,161
050,18,137,"Indiana","Ripley County",1,10,396,200,196
050,18,137,"Indiana","Ripley County",1,11,410,216,194
050,18,137,"Indiana","Ripley County",1,12,411,213,198
050,18,137,"Indiana","Ripley County",1,13,428,224,204
050,18,137,"Indiana","Ripley County",1,14,411,220,191
050,18,137,"Indiana","Ripley County",1,15,411,216,195
050,18,137,"Indiana","Ripley County",1,16,429,227,202
050,18,137,"Indiana","Ripley County",1,17,450,242,208
050,18,137,"Indiana","Ripley County",1,18,374,212,162
050,18,137,"Indiana","Ripley County",1,19,295,159,136
050,18,137,"Indiana","Ripley County",1,20,317,160,157
050,18,137,"Indiana","Ripley County",1,21,317,159,158
050,18,137,"Indiana","Ripley County",1,22,339,179,160
050,18,137,"Indiana","Ripley County",1,23,352,182,170
050,18,137,"Indiana","Ripley County",1,24,370,202,168
050,18,137,"Indiana","Ripley County",1,25,360,185,175
050,18,137,"Indiana","Ripley County",1,26,359,181,178
050,18,137,"Indiana","Ripley County",1,27,358,179,179
050,18,137,"Indiana","Ripley County",1,28,352,191,161
050,18,137,"Indiana","Ripley County",1,29,322,175,147
050,18,137,"Indiana","Ripley County",1,30,305,150,155
050,18,137,"Indiana","Ripley County",1,31,285,136,149
050,18,137,"Indiana","Ripley County",1,32,282,140,142
050,18,137,"Indiana","Ripley County",1,33,302,144,158
050,18,137,"Indiana","Ripley County",1,34,299,146,153
050,18,137,"Indiana","Ripley County",1,35,311,149,162
050,18,137,"Indiana","Ripley County",1,36,302,143,159
050,18,137,"Indiana","Ripley County",1,37,338,180,158
050,18,137,"Indiana","Ripley County",1,38,358,182,176
050,18,137,"Indiana","Ripley County",1,39,380,186,194
050,18,137,"Indiana","Ripley County",1,40,349,153,196
050,18,137,"Indiana","Ripley County",1,41,331,165,166
050,18,137,"Indiana","Ripley County",1,42,320,171,149
050,18,137,"Indiana","Ripley County",1,43,347,185,162
050,18,137,"Indiana","Ripley County",1,44,343,178,165
050,18,137,"Indiana","Ripley County",1,45,341,169,172
050,18,137,"Indiana","Ripley County",1,46,330,153,177
050,18,137,"Indiana","Ripley County",1,47,355,169,186
050,18,137,"Indiana","Ripley County",1,48,383,176,207
050,18,137,"Indiana","Ripley County",1,49,403,192,211
050,18,137,"Indiana","Ripley County",1,50,407,211,196
050,18,137,"Indiana","Ripley County",1,51,381,204,177
050,18,137,"Indiana","Ripley County",1,52,374,196,178
050,18,137,"Indiana","Ripley County",1,53,397,200,197
050,18,137,"Indiana","Ripley County",1,54,411,208,203
050,18,137,"Indiana","Ripley County",1,55,398,199,199
050,18,137,"Indiana","Ripley County",1,56,418,212,206
050,18,137,"Indiana","Ripley County",1,57,403,199,204
050,18,137,"Indiana","Ripley County",1,58,434,212,222
050,18,137,"Indiana","Ripley County",1,59,410,206,204
050,18,137,"Indiana","Ripley County",1,60,401,191,210
050,18,137,"Indiana","Ripley County",1,61,413,206,207
050,18,137,"Indiana","Ripley County",1,62,381,195,186
050,18,137,"Indiana","Ripley County",1,63,383,191,192
050,18,137,"Indiana","Ripley County",1,64,362,183,179
050,18,137,"Indiana","Ripley County",1,65,371,186,185
050,18,137,"Indiana","Ripley County",1,66,371,187,184
050,18,137,"Indiana","Ripley County",1,67,333,160,173
050,18,137,"Indiana","Ripley County",1,68,335,168,167
050,18,137,"Indiana","Ripley County",1,69,318,156,162
050,18,137,"Indiana","Ripley County",1,70,294,139,155
050,18,137,"Indiana","Ripley County",1,71,276,130,146
050,18,137,"Indiana","Ripley County",1,72,303,148,155
050,18,137,"Indiana","Ripley County",1,73,292,130,162
050,18,137,"Indiana","Ripley County",1,74,202,97,105
050,18,137,"Indiana","Ripley County",1,75,220,105,115
050,18,137,"Indiana","Ripley County",1,76,223,113,110
050,18,137,"Indiana","Ripley County",1,77,207,104,103
050,18,137,"Indiana","Ripley County",1,78,174,83,91
050,18,137,"Indiana","Ripley County",1,79,160,78,82
050,18,137,"Indiana","Ripley County",1,80,136,58,78
050,18,137,"Indiana","Ripley County",1,81,128,50,78
050,18,137,"Indiana","Ripley County",1,82,133,49,84
050,18,137,"Indiana","Ripley County",1,83,109,52,57
050,18,137,"Indiana","Ripley County",1,84,105,52,53
050,18,137,"Indiana","Ripley County",1,85,620,205,415
050,18,137,"Indiana","Ripley County",2,0,388,197,191
050,18,137,"Indiana","Ripley County",2,1,377,198,179
050,18,137,"Indiana","Ripley County",2,2,365,197,168
050,18,137,"Indiana","Ripley County",2,3,359,188,171
050,18,137,"Indiana","Ripley County",2,4,370,195,175
050,18,137,"Indiana","Ripley County",2,5,344,185,159
050,18,137,"Indiana","Ripley County",2,6,348,177,171
050,18,137,"Indiana","Ripley County",2,7,358,179,179
050,18,137,"Indiana","Ripley County",2,8,338,180,158
050,18,137,"Indiana","Ripley County",2,9,342,183,159
050,18,137,"Indiana","Ripley County",2,10,383,196,187
050,18,137,"Indiana","Ripley County",2,11,403,210,193
050,18,137,"Indiana","Ripley County",2,12,415,216,199
050,18,137,"Indiana","Ripley County",2,13,424,222,202
050,18,137,"Indiana","Ripley County",2,14,414,222,192
050,18,137,"Indiana","Ripley County",2,15,410,216,194
050,18,137,"Indiana","Ripley County",2,16,428,226,202
050,18,137,"Indiana","Ripley County",2,17,449,242,207
050,18,137,"Indiana","Ripley County",2,18,373,210,163
050,18,137,"Indiana","Ripley County",2,19,298,161,137
050,18,137,"Indiana","Ripley County",2,20,320,163,157
050,18,137,"Indiana","Ripley County",2,21,317,159,158
050,18,137,"Indiana","Ripley County",2,22,340,177,163
050,18,137,"Indiana","Ripley County",2,23,348,180,168
050,18,137,"Indiana","Ripley County",2,24,369,200,169
050,18,137,"Indiana","Ripley County",2,25,360,189,171
050,18,137,"Indiana","Ripley County",2,26,360,182,178
050,18,137,"Indiana","Ripley County",2,27,359,182,177
050,18,137,"Indiana","Ripley County",2,28,354,189,165
050,18,137,"Indiana","Ripley County",2,29,328,177,151
050,18,137,"Indiana","Ripley County",2,30,310,155,155
050,18,137,"Indiana","Ripley County",2,31,288,139,149
050,18,137,"Indiana","Ripley County",2,32,281,136,145
050,18,137,"Indiana","Ripley County",2,33,299,143,156
050,18,137,"Indiana","Ripley County",2,34,304,149,155
050,18,137,"Indiana","Ripley County",2,35,306,147,159
050,18,137,"Indiana","Ripley County",2,36,307,147,160
050,18,137,"Indiana","Ripley County",2,37,330,171,159
050,18,137,"Indiana","Ripley County",2,38,356,184,172
050,18,137,"Indiana","Ripley County",2,39,371,184,187
050,18,137,"Indiana","Ripley County",2,40,359,161,198
050,18,137,"Indiana","Ripley County",2,41,336,162,174
050,18,137,"Indiana","Ripley County",2,42,318,168,150
050,18,137,"Indiana","Ripley County",2,43,341,181,160
050,18,137,"Indiana","Ripley County",2,44,340,178,162
050,18,137,"Indiana","Ripley County",2,45,342,170,172
050,18,137,"Indiana","Ripley County",2,46,330,155,175
050,18,137,"Indiana","Ripley County",2,47,347,162,185
050,18,137,"Indiana","Ripley County",2,48,374,175,199
050,18,137,"Indiana","Ripley County",2,49,401,189,212
050,18,137,"Indiana","Ripley County",2,50,407,208,199
050,18,137,"Indiana","Ripley County",2,51,387,206,181
050,18,137,"Indiana","Ripley County",2,52,374,197,177
050,18,137,"Indiana","Ripley County",2,53,392,200,192
050,18,137,"Indiana","Ripley County",2,54,404,202,202
050,18,137,"Indiana","Ripley County",2,55,402,202,200
050,18,137,"Indiana","Ripley County",2,56,414,210,204
050,18,137,"Indiana","Ripley County",2,57,405,201,204
050,18,137,"Indiana","Ripley County",2,58,425,207,218
050,18,137,"Indiana","Ripley County",2,59,417,208,209
050,18,137,"Indiana","Ripley County",2,60,402,194,208
050,18,137,"Indiana","Ripley County",2,61,406,200,206
050,18,137,"Indiana","Ripley County",2,62,389,198,191
050,18,137,"Indiana","Ripley County",2,63,386,194,192
050,18,137,"Indiana","Ripley County",2,64,362,182,180
050,18,137,"Indiana","Ripley County",2,65,367,183,184
050,18,137,"Indiana","Ripley County",2,66,369,186,183
050,18,137,"Indiana","Ripley County",2,67,339,164,175
050,18,137,"Indiana","Ripley County",2,68,332,165,167
050,18,137,"Indiana","Ripley County",2,69,320,159,161
050,18,137,"Indiana","Ripley County",2,70,294,139,155
050,18,137,"Indiana","Ripley County",2,71,283,134,149
050,18,137,"Indiana","Ripley County",2,72,290,140,150
050,18,137,"Indiana","Ripley County",2,73,305,139,166
050,18,137,"Indiana","Ripley County",2,74,206,97,109
050,18,137,"Indiana","Ripley County",2,75,219,104,115
050,18,137,"Indiana","Ripley County",2,76,216,108,108
050,18,137,"Indiana","Ripley County",2,77,214,107,107
050,18,137,"Indiana","Ripley County",2,78,178,86,92
050,18,137,"Indiana","Ripley County",2,79,160,77,83
050,18,137,"Indiana","Ripley County",2,80,140,60,80
050,18,137,"Indiana","Ripley County",2,81,126,51,75
050,18,137,"Indiana","Ripley County",2,82,131,47,84
050,18,137,"Indiana","Ripley County",2,83,110,50,60
050,18,137,"Indiana","Ripley County",2,84,105,52,53
050,18,137,"Indiana","Ripley County",2,85,623,208,415
050,18,137,"Indiana","Ripley County",3,0,339,176,163
050,18,137,"Indiana","Ripley County",3,1,383,196,187
050,18,137,"Indiana","Ripley County",3,2,367,191,176
050,18,137,"Indiana","Ripley County",3,3,373,195,178
050,18,137,"Indiana","Ripley County",3,4,365,194,171
050,18,137,"Indiana","Ripley County",3,5,373,198,175
050,18,137,"Indiana","Ripley County",3,6,354,188,166
050,18,137,"Indiana","Ripley County",3,7,347,183,164
050,18,137,"Indiana","Ripley County",3,8,367,192,175
050,18,137,"Indiana","Ripley County",3,9,334,174,160
050,18,137,"Indiana","Ripley County",3,10,352,188,164
050,18,137,"Indiana","Ripley County",3,11,394,203,191
050,18,137,"Indiana","Ripley County",3,12,388,205,183
050,18,137,"Indiana","Ripley County",3,13,420,230,190
050,18,137,"Indiana","Ripley County",3,14,420,226,194
050,18,137,"Indiana","Ripley County",3,15,426,228,198
050,18,137,"Indiana","Ripley County",3,16,403,209,194
050,18,137,"Indiana","Ripley County",3,17,426,224,202
050,18,137,"Indiana","Ripley County",3,18,376,215,161
050,18,137,"Indiana","Ripley County",3,19,294,166,128
050,18,137,"Indiana","Ripley County",3,20,326,171,155
050,18,137,"Indiana","Ripley County",3,21,333,168,165
050,18,137,"Indiana","Ripley County",3,22,340,169,171
050,18,137,"Indiana","Ripley County",3,23,347,179,168
050,18,137,"Indiana","Ripley County",3,24,353,187,166
050,18,137,"Indiana","Ripley County",3,25,341,188,153
050,18,137,"Indiana","Ripley County",3,26,357,182,175
050,18,137,"Indiana","Ripley County",3,27,352,186,166
050,18,137,"Indiana","Ripley County",3,28,370,183,187
050,18,137,"Indiana","Ripley County",3,29,356,187,169
050,18,137,"Indiana","Ripley County",3,30,343,186,157
050,18,137,"Indiana","Ripley County",3,31,326,160,166
050,18,137,"Indiana","Ripley County",3,32,297,148,149
050,18,137,"Indiana","Ripley County",3,33,274,137,137
050,18,137,"Indiana","Ripley County",3,34,304,145,159
050,18,137,"Indiana","Ripley County",3,35,295,141,154
050,18,137,"Indiana","Ripley County",3,36,293,140,153
050,18,137,"Indiana","Ripley County",3,37,295,141,154
050,18,137,"Indiana","Ripley County",3,38,339,177,162
050,18,137,"Indiana","Ripley County",3,39,365,189,176
050,18,137,"Indiana","Ripley County",3,40,368,182,186
050,18,137,"Indiana","Ripley County",3,41,371,168,203
050,18,137,"Indiana","Ripley County",3,42,340,167,173
050,18,137,"Indiana","Ripley County",3,43,329,170,159
050,18,137,"Indiana","Ripley County",3,44,345,183,162
050,18,137,"Indiana","Ripley County",3,45,344,182,162
050,18,137,"Indiana","Ripley County",3,46,356,179,177
050,18,137,"Indiana","Ripley County",3,47,332,158,174
050,18,137,"Indiana","Ripley County",3,48,347,166,181
050,18,137,"Indiana","Ripley County",3,49,363,170,193
050,18,137,"Indiana","Ripley County",3,50,413,196,217
050,18,137,"Indiana","Ripley County",3,51,394,199,195
050,18,137,"Indiana","Ripley County",3,52,380,203,177
050,18,137,"Indiana","Ripley County",3,53,376,196,180
050,18,137,"Indiana","Ripley County",3,54,402,206,196
050,18,137,"Indiana","Ripley County",3,55,411,202,209
050,18,137,"Indiana","Ripley County",3,56,409,203,206
050,18,137,"Indiana","Ripley County",3,57,410,206,204
050,18,137,"Indiana","Ripley County",3,58,413,204,209
050,18,137,"Indiana","Ripley County",3,59,431,212,219
050,18,137,"Indiana","Ripley County",3,60,419,205,214
050,18,137,"Indiana","Ripley County",3,61,414,204,210
050,18,137,"Indiana","Ripley County",3,62,399,195,204
050,18,137,"Indiana","Ripley County",3,63,377,189,188
050,18,137,"Indiana","Ripley County",3,64,388,202,186
050,18,137,"Indiana","Ripley County",3,65,362,177,185
050,18,137,"Indiana","Ripley County",3,66,363,184,179
050,18,137,"Indiana","Ripley County",3,67,348,171,177
050,18,137,"Indiana","Ripley County",3,68,331,160,171
050,18,137,"Indiana","Ripley County",3,69,320,158,162
050,18,137,"Indiana","Ripley County",3,70,321,162,159
050,18,137,"Indiana","Ripley County",3,71,286,134,152
050,18,137,"Indiana","Ripley County",3,72,267,124,143
050,18,137,"Indiana","Ripley County",3,73,274,134,140
050,18,137,"Indiana","Ripley County",3,74,298,136,162
050,18,137,"Indiana","Ripley County",3,75,211,100,111
050,18,137,"Indiana","Ripley County",3,76,201,94,107
050,18,137,"Indiana","Ripley County",3,77,201,98,103
050,18,137,"Indiana","Ripley County",3,78,205,102,103
050,18,137,"Indiana","Ripley County",3,79,164,77,87
050,18,137,"Indiana","Ripley County",3,80,150,72,78
050,18,137,"Indiana","Ripley County",3,81,129,55,74
050,18,137,"Indiana","Ripley County",3,82,122,41,81
050,18,137,"Indiana","Ripley County",3,83,111,41,70
050,18,137,"Indiana","Ripley County",3,84,98,43,55
050,18,137,"Indiana","Ripley County",3,85,615,207,408
050,18,137,"Indiana","Ripley County",4,0,335,186,149
050,18,137,"Indiana","Ripley County",4,1,357,186,171
050,18,137,"Indiana","Ripley County",4,2,398,206,192
050,18,137,"Indiana","Ripley County",4,3,375,196,179
050,18,137,"Indiana","Ripley County",4,4,372,202,170
050,18,137,"Indiana","Ripley County",4,5,389,198,191
050,18,137,"Indiana","Ripley County",4,6,382,209,173
050,18,137,"Indiana","Ripley County",4,7,369,195,174
050,18,137,"Indiana","Ripley County",4,8,354,179,175
050,18,137,"Indiana","Ripley County",4,9,372,190,182
050,18,137,"Indiana","Ripley County",4,10,345,179,166
050,18,137,"Indiana","Ripley County",4,11,351,191,160
050,18,137,"Indiana","Ripley County",4,12,393,207,186
050,18,137,"Indiana","Ripley County",4,13,404,214,190
050,18,137,"Indiana","Ripley County",4,14,413,220,193
050,18,137,"Indiana","Ripley County",4,15,421,223,198
050,18,137,"Indiana","Ripley County",4,16,438,235,203
050,18,137,"Indiana","Ripley County",4,17,406,216,190
050,18,137,"Indiana","Ripley County",4,18,358,189,169
050,18,137,"Indiana","Ripley County",4,19,289,172,117
050,18,137,"Indiana","Ripley County",4,20,302,171,131
050,18,137,"Indiana","Ripley County",4,21,347,183,164
050,18,137,"Indiana","Ripley County",4,22,336,174,162
050,18,137,"Indiana","Ripley County",4,23,331,156,175
050,18,137,"Indiana","Ripley County",4,24,350,183,167
050,18,137,"Indiana","Ripley County",4,25,337,170,167
050,18,137,"Indiana","Ripley County",4,26,334,177,157
050,18,137,"Indiana","Ripley County",4,27,346,180,166
050,18,137,"Indiana","Ripley County",4,28,347,186,161
050,18,137,"Indiana","Ripley County",4,29,377,188,189
050,18,137,"Indiana","Ripley County",4,30,384,203,181
050,18,137,"Indiana","Ripley County",4,31,349,191,158
050,18,137,"Indiana","Ripley County",4,32,332,162,170
050,18,137,"Indiana","Ripley County",4,33,301,148,153
050,18,137,"Indiana","Ripley County",4,34,295,156,139
050,18,137,"Indiana","Ripley County",4,35,309,143,166
050,18,137,"Indiana","Ripley County",4,36,309,144,165
050,18,137,"Indiana","Ripley County",4,37,302,141,161
050,18,137,"Indiana","Ripley County",4,38,300,142,158
050,18,137,"Indiana","Ripley County",4,39,339,176,163
050,18,137,"Indiana","Ripley County",4,40,380,198,182
050,18,137,"Indiana","Ripley County",4,41,374,178,196
050,18,137,"Indiana","Ripley County",4,42,361,166,195
050,18,137,"Indiana","Ripley County",4,43,350,174,176
050,18,137,"Indiana","Ripley County",4,44,320,167,153
050,18,137,"Indiana","Ripley County",4,45,348,184,164
050,18,137,"Indiana","Ripley County",4,46,350,186,164
050,18,137,"Indiana","Ripley County",4,47,348,177,171
050,18,137,"Indiana","Ripley County",4,48,325,155,170
050,18,137,"Indiana","Ripley County",4,49,348,162,186
050,18,137,"Indiana","Ripley County",4,50,370,175,195
050,18,137,"Indiana","Ripley County",4,51,394,192,202
050,18,137,"Indiana","Ripley County",4,52,391,196,195
050,18,137,"Indiana","Ripley County",4,53,379,202,177
050,18,137,"Indiana","Ripley County",4,54,372,200,172
050,18,137,"Indiana","Ripley County",4,55,398,204,194
050,18,137,"Indiana","Ripley County",4,56,415,200,215
050,18,137,"Indiana","Ripley County",4,57,408,204,204
050,18,137,"Indiana","Ripley County",4,58,405,204,201
050,18,137,"Indiana","Ripley County",4,59,408,199,209
050,18,137,"Indiana","Ripley County",4,60,426,210,216
050,18,137,"Indiana","Ripley County",4,61,418,205,213
050,18,137,"Indiana","Ripley County",4,62,408,200,208
050,18,137,"Indiana","Ripley County",4,63,389,193,196
050,18,137,"Indiana","Ripley County",4,64,388,202,186
050,18,137,"Indiana","Ripley County",4,65,387,194,193
050,18,137,"Indiana","Ripley County",4,66,347,174,173
050,18,137,"Indiana","Ripley County",4,67,350,177,173
050,18,137,"Indiana","Ripley County",4,68,353,173,180
050,18,137,"Indiana","Ripley County",4,69,310,148,162
050,18,137,"Indiana","Ripley County",4,70,304,150,154
050,18,137,"Indiana","Ripley County",4,71,315,159,156
050,18,137,"Indiana","Ripley County",4,72,277,126,151
050,18,137,"Indiana","Ripley County",4,73,251,118,133
050,18,137,"Indiana","Ripley County",4,74,261,129,132
050,18,137,"Indiana","Ripley County",4,75,294,133,161
050,18,137,"Indiana","Ripley County",4,76,189,91,98
050,18,137,"Indiana","Ripley County",4,77,183,82,101
050,18,137,"Indiana","Ripley County",4,78,187,94,93
050,18,137,"Indiana","Ripley County",4,79,194,93,101
050,18,137,"Indiana","Ripley County",4,80,158,70,88
050,18,137,"Indiana","Ripley County",4,81,143,68,75
050,18,137,"Indiana","Ripley County",4,82,120,43,77
050,18,137,"Indiana","Ripley County",4,83,98,36,62
050,18,137,"Indiana","Ripley County",4,84,98,34,64
050,18,137,"Indiana","Ripley County",4,85,590,194,396
050,18,137,"Indiana","Ripley County",5,0,333,183,150
050,18,137,"Indiana","Ripley County",5,1,342,194,148
050,18,137,"Indiana","Ripley County",5,2,354,189,165
050,18,137,"Indiana","Ripley County",5,3,407,212,195
050,18,137,"Indiana","Ripley County",5,4,367,198,169
050,18,137,"Indiana","Ripley County",5,5,388,209,179
050,18,137,"Indiana","Ripley County",5,6,405,206,199
050,18,137,"Indiana","Ripley County",5,7,388,212,176
050,18,137,"Indiana","Ripley County",5,8,382,209,173
050,18,137,"Indiana","Ripley County",5,9,369,196,173
050,18,137,"Indiana","Ripley County",5,10,377,195,182
050,18,137,"Indiana","Ripley County",5,11,359,189,170
050,18,137,"Indiana","Ripley County",5,12,378,202,176
050,18,137,"Indiana","Ripley County",5,13,408,213,195
050,18,137,"Indiana","Ripley County",5,14,409,220,189
050,18,137,"Indiana","Ripley County",5,15,436,235,201
050,18,137,"Indiana","Ripley County",5,16,418,223,195
050,18,137,"Indiana","Ripley County",5,17,444,238,206
050,18,137,"Indiana","Ripley County",5,18,355,197,158
050,18,137,"Indiana","Ripley County",5,19,282,155,127
050,18,137,"Indiana","Ripley County",5,20,321,191,130
050,18,137,"Indiana","Ripley County",5,21,313,173,140
050,18,137,"Indiana","Ripley County",5,22,386,203,183
050,18,137,"Indiana","Ripley County",5,23,332,163,169
050,18,137,"Indiana","Ripley County",5,24,341,167,174
050,18,137,"Indiana","Ripley County",5,25,340,182,158
050,18,137,"Indiana","Ripley County",5,26,335,177,158
050,18,137,"Indiana","Ripley County",5,27,335,178,157
050,18,137,"Indiana","Ripley County",5,28,341,179,162
050,18,137,"Indiana","Ripley County",5,29,354,191,163
050,18,137,"Indiana","Ripley County",5,30,385,194,191
050,18,137,"Indiana","Ripley County",5,31,368,199,169
050,18,137,"Indiana","Ripley County",5,32,364,196,168
050,18,137,"Indiana","Ripley County",5,33,334,161,173
050,18,137,"Indiana","Ripley County",5,34,313,163,150
050,18,137,"Indiana","Ripley County",5,35,295,148,147
050,18,137,"Indiana","Ripley County",5,36,310,146,164
050,18,137,"Indiana","Ripley County",5,37,315,146,169
050,18,137,"Indiana","Ripley County",5,38,319,156,163
050,18,137,"Indiana","Ripley County",5,39,311,151,160
050,18,137,"Indiana","Ripley County",5,40,347,184,163
050,18,137,"Indiana","Ripley County",5,41,397,207,190
050,18,137,"Indiana","Ripley County",5,42,369,177,192
050,18,137,"Indiana","Ripley County",5,43,352,159,193
050,18,137,"Indiana","Ripley County",5,44,356,180,176
050,18,137,"Indiana","Ripley County",5,45,324,167,157
050,18,137,"Indiana","Ripley County",5,46,359,193,166
050,18,137,"Indiana","Ripley County",5,47,351,182,169
050,18,137,"Indiana","Ripley County",5,48,344,174,170
050,18,137,"Indiana","Ripley County",5,49,330,163,167
050,18,137,"Indiana","Ripley County",5,50,354,166,188
050,18,137,"Indiana","Ripley County",5,51,363,177,186
050,18,137,"Indiana","Ripley County",5,52,393,188,205
050,18,137,"Indiana","Ripley County",5,53,384,193,191
050,18,137,"Indiana","Ripley County",5,54,371,195,176
050,18,137,"Indiana","Ripley County",5,55,370,194,176
050,18,137,"Indiana","Ripley County",5,56,399,202,197
050,18,137,"Indiana","Ripley County",5,57,409,197,212
050,18,137,"Indiana","Ripley County",5,58,405,203,202
050,18,137,"Indiana","Ripley County",5,59,399,203,196
050,18,137,"Indiana","Ripley County",5,60,397,194,203
050,18,137,"Indiana","Ripley County",5,61,429,216,213
050,18,137,"Indiana","Ripley County",5,62,408,197,211
050,18,137,"Indiana","Ripley County",5,63,415,199,216
050,18,137,"Indiana","Ripley County",5,64,391,197,194
050,18,137,"Indiana","Ripley County",5,65,375,195,180
050,18,137,"Indiana","Ripley County",5,66,377,193,184
050,18,137,"Indiana","Ripley County",5,67,335,167,168
050,18,137,"Indiana","Ripley County",5,68,360,177,183
050,18,137,"Indiana","Ripley County",5,69,335,158,177
050,18,137,"Indiana","Ripley County",5,70,309,146,163
050,18,137,"Indiana","Ripley County",5,71,299,148,151
050,18,137,"Indiana","Ripley County",5,72,303,151,152
050,18,137,"Indiana","Ripley County",5,73,255,119,136
050,18,137,"Indiana","Ripley County",5,74,237,112,125
050,18,137,"Indiana","Ripley County",5,75,265,127,138
050,18,137,"Indiana","Ripley County",5,76,277,126,151
050,18,137,"Indiana","Ripley County",5,77,177,82,95
050,18,137,"Indiana","Ripley County",5,78,177,83,94
050,18,137,"Indiana","Ripley County",5,79,183,91,92
050,18,137,"Indiana","Ripley County",5,80,184,86,98
050,18,137,"Indiana","Ripley County",5,81,143,63,80
050,18,137,"Indiana","Ripley County",5,82,137,57,80
050,18,137,"Indiana","Ripley County",5,83,99,40,59
050,18,137,"Indiana","Ripley County",5,84,87,32,55
050,18,137,"Indiana","Ripley County",5,85,584,181,403
050,18,139,"Indiana","Rush County",1,0,189,98,91
050,18,139,"Indiana","Rush County",1,1,198,104,94
050,18,139,"Indiana","Rush County",1,2,179,86,93
050,18,139,"Indiana","Rush County",1,3,194,92,102
050,18,139,"Indiana","Rush County",1,4,203,113,90
050,18,139,"Indiana","Rush County",1,5,204,100,104
050,18,139,"Indiana","Rush County",1,6,193,103,90
050,18,139,"Indiana","Rush County",1,7,201,99,102
050,18,139,"Indiana","Rush County",1,8,195,94,101
050,18,139,"Indiana","Rush County",1,9,192,102,90
050,18,139,"Indiana","Rush County",1,10,216,115,101
050,18,139,"Indiana","Rush County",1,11,213,113,100
050,18,139,"Indiana","Rush County",1,12,241,123,118
050,18,139,"Indiana","Rush County",1,13,240,114,126
050,18,139,"Indiana","Rush County",1,14,208,100,108
050,18,139,"Indiana","Rush County",1,15,254,128,126
050,18,139,"Indiana","Rush County",1,16,256,134,122
050,18,139,"Indiana","Rush County",1,17,248,122,126
050,18,139,"Indiana","Rush County",1,18,200,103,97
050,18,139,"Indiana","Rush County",1,19,163,88,75
050,18,139,"Indiana","Rush County",1,20,165,80,85
050,18,139,"Indiana","Rush County",1,21,169,87,82
050,18,139,"Indiana","Rush County",1,22,172,77,95
050,18,139,"Indiana","Rush County",1,23,201,106,95
050,18,139,"Indiana","Rush County",1,24,196,105,91
050,18,139,"Indiana","Rush County",1,25,196,97,99
050,18,139,"Indiana","Rush County",1,26,214,98,116
050,18,139,"Indiana","Rush County",1,27,195,99,96
050,18,139,"Indiana","Rush County",1,28,197,105,92
050,18,139,"Indiana","Rush County",1,29,192,87,105
050,18,139,"Indiana","Rush County",1,30,186,84,102
050,18,139,"Indiana","Rush County",1,31,197,100,97
050,18,139,"Indiana","Rush County",1,32,187,84,103
050,18,139,"Indiana","Rush County",1,33,186,88,98
050,18,139,"Indiana","Rush County",1,34,181,96,85
050,18,139,"Indiana","Rush County",1,35,178,90,88
050,18,139,"Indiana","Rush County",1,36,192,101,91
050,18,139,"Indiana","Rush County",1,37,202,103,99
050,18,139,"Indiana","Rush County",1,38,193,84,109
050,18,139,"Indiana","Rush County",1,39,179,91,88
050,18,139,"Indiana","Rush County",1,40,189,97,92
050,18,139,"Indiana","Rush County",1,41,200,97,103
050,18,139,"Indiana","Rush County",1,42,191,89,102
050,18,139,"Indiana","Rush County",1,43,193,94,99
050,18,139,"Indiana","Rush County",1,44,189,102,87
050,18,139,"Indiana","Rush County",1,45,189,102,87
050,18,139,"Indiana","Rush County",1,46,199,102,97
050,18,139,"Indiana","Rush County",1,47,219,112,107
050,18,139,"Indiana","Rush County",1,48,208,109,99
050,18,139,"Indiana","Rush County",1,49,241,123,118
050,18,139,"Indiana","Rush County",1,50,223,112,111
050,18,139,"Indiana","Rush County",1,51,238,116,122
050,18,139,"Indiana","Rush County",1,52,217,108,109
050,18,139,"Indiana","Rush County",1,53,213,97,116
050,18,139,"Indiana","Rush County",1,54,250,127,123
050,18,139,"Indiana","Rush County",1,55,256,141,115
050,18,139,"Indiana","Rush County",1,56,250,138,112
050,18,139,"Indiana","Rush County",1,57,244,127,117
050,18,139,"Indiana","Rush County",1,58,260,139,121
050,18,139,"Indiana","Rush County",1,59,253,123,130
050,18,139,"Indiana","Rush County",1,60,254,126,128
050,18,139,"Indiana","Rush County",1,61,253,124,129
050,18,139,"Indiana","Rush County",1,62,260,139,121
050,18,139,"Indiana","Rush County",1,63,246,129,117
050,18,139,"Indiana","Rush County",1,64,238,121,117
050,18,139,"Indiana","Rush County",1,65,217,104,113
050,18,139,"Indiana","Rush County",1,66,225,117,108
050,18,139,"Indiana","Rush County",1,67,208,105,103
050,18,139,"Indiana","Rush County",1,68,180,81,99
050,18,139,"Indiana","Rush County",1,69,170,70,100
050,18,139,"Indiana","Rush County",1,70,162,77,85
050,18,139,"Indiana","Rush County",1,71,158,77,81
050,18,139,"Indiana","Rush County",1,72,184,92,92
050,18,139,"Indiana","Rush County",1,73,170,79,91
050,18,139,"Indiana","Rush County",1,74,125,56,69
050,18,139,"Indiana","Rush County",1,75,117,58,59
050,18,139,"Indiana","Rush County",1,76,105,48,57
050,18,139,"Indiana","Rush County",1,77,126,60,66
050,18,139,"Indiana","Rush County",1,78,106,48,58
050,18,139,"Indiana","Rush County",1,79,102,44,58
050,18,139,"Indiana","Rush County",1,80,90,37,53
050,18,139,"Indiana","Rush County",1,81,88,37,51
050,18,139,"Indiana","Rush County",1,82,82,36,46
050,18,139,"Indiana","Rush County",1,83,74,32,42
050,18,139,"Indiana","Rush County",1,84,69,28,41
050,18,139,"Indiana","Rush County",1,85,352,121,231
050,18,139,"Indiana","Rush County",2,0,195,98,97
050,18,139,"Indiana","Rush County",2,1,194,100,94
050,18,139,"Indiana","Rush County",2,2,181,88,93
050,18,139,"Indiana","Rush County",2,3,190,92,98
050,18,139,"Indiana","Rush County",2,4,203,107,96
050,18,139,"Indiana","Rush County",2,5,204,105,99
050,18,139,"Indiana","Rush County",2,6,195,102,93
050,18,139,"Indiana","Rush County",2,7,199,100,99
050,18,139,"Indiana","Rush County",2,8,193,95,98
050,18,139,"Indiana","Rush County",2,9,194,100,94
050,18,139,"Indiana","Rush County",2,10,211,112,99
050,18,139,"Indiana","Rush County",2,11,214,113,101
050,18,139,"Indiana","Rush County",2,12,236,121,115
050,18,139,"Indiana","Rush County",2,13,239,116,123
050,18,139,"Indiana","Rush County",2,14,217,104,113
050,18,139,"Indiana","Rush County",2,15,246,123,123
050,18,139,"Indiana","Rush County",2,16,257,134,123
050,18,139,"Indiana","Rush County",2,17,249,125,124
050,18,139,"Indiana","Rush County",2,18,201,104,97
050,18,139,"Indiana","Rush County",2,19,164,87,77
050,18,139,"Indiana","Rush County",2,20,169,84,85
050,18,139,"Indiana","Rush County",2,21,172,87,85
050,18,139,"Indiana","Rush County",2,22,174,81,93
050,18,139,"Indiana","Rush County",2,23,198,101,97
050,18,139,"Indiana","Rush County",2,24,196,105,91
050,18,139,"Indiana","Rush County",2,25,198,101,97
050,18,139,"Indiana","Rush County",2,26,208,97,111
050,18,139,"Indiana","Rush County",2,27,200,100,100
050,18,139,"Indiana","Rush County",2,28,199,105,94
050,18,139,"Indiana","Rush County",2,29,193,91,102
050,18,139,"Indiana","Rush County",2,30,187,84,103
050,18,139,"Indiana","Rush County",2,31,194,96,98
050,18,139,"Indiana","Rush County",2,32,189,87,102
050,18,139,"Indiana","Rush County",2,33,190,89,101
050,18,139,"Indiana","Rush County",2,34,184,96,88
050,18,139,"Indiana","Rush County",2,35,180,91,89
050,18,139,"Indiana","Rush County",2,36,189,98,91
050,18,139,"Indiana","Rush County",2,37,201,104,97
050,18,139,"Indiana","Rush County",2,38,196,89,107
050,18,139,"Indiana","Rush County",2,39,184,90,94
050,18,139,"Indiana","Rush County",2,40,188,96,92
050,18,139,"Indiana","Rush County",2,41,197,97,100
050,18,139,"Indiana","Rush County",2,42,192,90,102
050,18,139,"Indiana","Rush County",2,43,193,94,99
050,18,139,"Indiana","Rush County",2,44,188,98,90
050,18,139,"Indiana","Rush County",2,45,192,104,88
050,18,139,"Indiana","Rush County",2,46,202,106,96
050,18,139,"Indiana","Rush County",2,47,211,109,102
050,18,139,"Indiana","Rush County",2,48,210,109,101
050,18,139,"Indiana","Rush County",2,49,231,119,112
050,18,139,"Indiana","Rush County",2,50,227,114,113
050,18,139,"Indiana","Rush County",2,51,233,114,119
050,18,139,"Indiana","Rush County",2,52,220,109,111
050,18,139,"Indiana","Rush County",2,53,214,100,114
050,18,139,"Indiana","Rush County",2,54,239,119,120
050,18,139,"Indiana","Rush County",2,55,254,137,117
050,18,139,"Indiana","Rush County",2,56,250,138,112
050,18,139,"Indiana","Rush County",2,57,244,129,115
050,18,139,"Indiana","Rush County",2,58,258,136,122
050,18,139,"Indiana","Rush County",2,59,258,129,129
050,18,139,"Indiana","Rush County",2,60,256,125,131
050,18,139,"Indiana","Rush County",2,61,254,125,129
050,18,139,"Indiana","Rush County",2,62,255,133,122
050,18,139,"Indiana","Rush County",2,63,249,132,117
050,18,139,"Indiana","Rush County",2,64,237,121,116
050,18,139,"Indiana","Rush County",2,65,218,106,112
050,18,139,"Indiana","Rush County",2,66,223,115,108
050,18,139,"Indiana","Rush County",2,67,211,107,104
050,18,139,"Indiana","Rush County",2,68,182,83,99
050,18,139,"Indiana","Rush County",2,69,172,72,100
050,18,139,"Indiana","Rush County",2,70,163,76,87
050,18,139,"Indiana","Rush County",2,71,160,78,82
050,18,139,"Indiana","Rush County",2,72,171,85,86
050,18,139,"Indiana","Rush County",2,73,182,87,95
050,18,139,"Indiana","Rush County",2,74,128,58,70
050,18,139,"Indiana","Rush County",2,75,118,58,60
050,18,139,"Indiana","Rush County",2,76,106,50,56
050,18,139,"Indiana","Rush County",2,77,125,59,66
050,18,139,"Indiana","Rush County",2,78,106,50,56
050,18,139,"Indiana","Rush County",2,79,99,43,56
050,18,139,"Indiana","Rush County",2,80,93,39,54
050,18,139,"Indiana","Rush County",2,81,88,37,51
050,18,139,"Indiana","Rush County",2,82,84,36,48
050,18,139,"Indiana","Rush County",2,83,75,32,43
050,18,139,"Indiana","Rush County",2,84,72,29,43
050,18,139,"Indiana","Rush County",2,85,352,120,232
050,18,139,"Indiana","Rush County",3,0,176,94,82
050,18,139,"Indiana","Rush County",3,1,188,102,86
050,18,139,"Indiana","Rush County",3,2,190,93,97
050,18,139,"Indiana","Rush County",3,3,175,91,84
050,18,139,"Indiana","Rush County",3,4,182,92,90
050,18,139,"Indiana","Rush County",3,5,201,105,96
050,18,139,"Indiana","Rush County",3,6,210,108,102
050,18,139,"Indiana","Rush County",3,7,191,98,93
050,18,139,"Indiana","Rush County",3,8,202,102,100
050,18,139,"Indiana","Rush County",3,9,211,104,107
050,18,139,"Indiana","Rush County",3,10,194,98,96
050,18,139,"Indiana","Rush County",3,11,214,113,101
050,18,139,"Indiana","Rush County",3,12,226,119,107
050,18,139,"Indiana","Rush County",3,13,236,119,117
050,18,139,"Indiana","Rush County",3,14,231,113,118
050,18,139,"Indiana","Rush County",3,15,213,105,108
050,18,139,"Indiana","Rush County",3,16,240,121,119
050,18,139,"Indiana","Rush County",3,17,250,128,122
050,18,139,"Indiana","Rush County",3,18,208,114,94
050,18,139,"Indiana","Rush County",3,19,157,84,73
050,18,139,"Indiana","Rush County",3,20,173,87,86
050,18,139,"Indiana","Rush County",3,21,178,85,93
050,18,139,"Indiana","Rush County",3,22,183,91,92
050,18,139,"Indiana","Rush County",3,23,179,78,101
050,18,139,"Indiana","Rush County",3,24,190,102,88
050,18,139,"Indiana","Rush County",3,25,205,104,101
050,18,139,"Indiana","Rush County",3,26,202,106,96
050,18,139,"Indiana","Rush County",3,27,204,94,110
050,18,139,"Indiana","Rush County",3,28,192,95,97
050,18,139,"Indiana","Rush County",3,29,195,98,97
050,18,139,"Indiana","Rush County",3,30,201,94,107
050,18,139,"Indiana","Rush County",3,31,187,88,99
050,18,139,"Indiana","Rush County",3,32,201,101,100
050,18,139,"Indiana","Rush County",3,33,206,95,111
050,18,139,"Indiana","Rush County",3,34,187,87,100
050,18,139,"Indiana","Rush County",3,35,181,90,91
050,18,139,"Indiana","Rush County",3,36,182,93,89
050,18,139,"Indiana","Rush County",3,37,182,94,88
050,18,139,"Indiana","Rush County",3,38,204,112,92
050,18,139,"Indiana","Rush County",3,39,203,91,112
050,18,139,"Indiana","Rush County",3,40,178,85,93
050,18,139,"Indiana","Rush County",3,41,188,94,94
050,18,139,"Indiana","Rush County",3,42,196,98,98
050,18,139,"Indiana","Rush County",3,43,195,87,108
050,18,139,"Indiana","Rush County",3,44,199,98,101
050,18,139,"Indiana","Rush County",3,45,179,93,86
050,18,139,"Indiana","Rush County",3,46,195,105,90
050,18,139,"Indiana","Rush County",3,47,198,104,94
050,18,139,"Indiana","Rush County",3,48,224,117,107
050,18,139,"Indiana","Rush County",3,49,208,104,104
050,18,139,"Indiana","Rush County",3,50,230,117,113
050,18,139,"Indiana","Rush County",3,51,233,117,116
050,18,139,"Indiana","Rush County",3,52,225,110,115
050,18,139,"Indiana","Rush County",3,53,220,108,112
050,18,139,"Indiana","Rush County",3,54,212,98,114
050,18,139,"Indiana","Rush County",3,55,234,120,114
050,18,139,"Indiana","Rush County",3,56,253,139,114
050,18,139,"Indiana","Rush County",3,57,253,137,116
050,18,139,"Indiana","Rush County",3,58,243,127,116
050,18,139,"Indiana","Rush County",3,59,246,130,116
050,18,139,"Indiana","Rush County",3,60,266,134,132
050,18,139,"Indiana","Rush County",3,61,248,118,130
050,18,139,"Indiana","Rush County",3,62,245,119,126
050,18,139,"Indiana","Rush County",3,63,248,130,118
050,18,139,"Indiana","Rush County",3,64,247,130,117
050,18,139,"Indiana","Rush County",3,65,229,114,115
050,18,139,"Indiana","Rush County",3,66,216,105,111
050,18,139,"Indiana","Rush County",3,67,216,112,104
050,18,139,"Indiana","Rush County",3,68,210,105,105
050,18,139,"Indiana","Rush County",3,69,179,81,98
050,18,139,"Indiana","Rush County",3,70,170,72,98
050,18,139,"Indiana","Rush County",3,71,154,71,83
050,18,139,"Indiana","Rush County",3,72,158,73,85
050,18,139,"Indiana","Rush County",3,73,167,80,87
050,18,139,"Indiana","Rush County",3,74,178,86,92
050,18,139,"Indiana","Rush County",3,75,120,55,65
050,18,139,"Indiana","Rush County",3,76,112,53,59
050,18,139,"Indiana","Rush County",3,77,99,46,53
050,18,139,"Indiana","Rush County",3,78,123,55,68
050,18,139,"Indiana","Rush County",3,79,93,42,51
050,18,139,"Indiana","Rush County",3,80,95,42,53
050,18,139,"Indiana","Rush County",3,81,84,36,48
050,18,139,"Indiana","Rush County",3,82,84,36,48
050,18,139,"Indiana","Rush County",3,83,75,34,41
050,18,139,"Indiana","Rush County",3,84,70,29,41
050,18,139,"Indiana","Rush County",3,85,354,129,225
050,18,139,"Indiana","Rush County",4,0,206,110,96
050,18,139,"Indiana","Rush County",4,1,195,103,92
050,18,139,"Indiana","Rush County",4,2,197,104,93
050,18,139,"Indiana","Rush County",4,3,194,97,97
050,18,139,"Indiana","Rush County",4,4,181,95,86
050,18,139,"Indiana","Rush County",4,5,186,91,95
050,18,139,"Indiana","Rush County",4,6,195,96,99
050,18,139,"Indiana","Rush County",4,7,198,103,95
050,18,139,"Indiana","Rush County",4,8,197,100,97
050,18,139,"Indiana","Rush County",4,9,196,99,97
050,18,139,"Indiana","Rush County",4,10,212,104,108
050,18,139,"Indiana","Rush County",4,11,210,102,108
050,18,139,"Indiana","Rush County",4,12,212,112,100
050,18,139,"Indiana","Rush County",4,13,224,112,112
050,18,139,"Indiana","Rush County",4,14,244,122,122
050,18,139,"Indiana","Rush County",4,15,237,114,123
050,18,139,"Indiana","Rush County",4,16,213,97,116
050,18,139,"Indiana","Rush County",4,17,246,123,123
050,18,139,"Indiana","Rush County",4,18,195,99,96
050,18,139,"Indiana","Rush County",4,19,147,82,65
050,18,139,"Indiana","Rush County",4,20,159,83,76
050,18,139,"Indiana","Rush County",4,21,179,83,96
050,18,139,"Indiana","Rush County",4,22,183,93,90
050,18,139,"Indiana","Rush County",4,23,196,99,97
050,18,139,"Indiana","Rush County",4,24,173,78,95
050,18,139,"Indiana","Rush County",4,25,197,112,85
050,18,139,"Indiana","Rush County",4,26,210,114,96
050,18,139,"Indiana","Rush County",4,27,204,106,98
050,18,139,"Indiana","Rush County",4,28,210,102,108
050,18,139,"Indiana","Rush County",4,29,193,94,99
050,18,139,"Indiana","Rush County",4,30,202,105,97
050,18,139,"Indiana","Rush County",4,31,205,93,112
050,18,139,"Indiana","Rush County",4,32,187,87,100
050,18,139,"Indiana","Rush County",4,33,196,93,103
050,18,139,"Indiana","Rush County",4,34,204,95,109
050,18,139,"Indiana","Rush County",4,35,189,89,100
050,18,139,"Indiana","Rush County",4,36,191,92,99
050,18,139,"Indiana","Rush County",4,37,191,97,94
050,18,139,"Indiana","Rush County",4,38,180,94,86
050,18,139,"Indiana","Rush County",4,39,196,109,87
050,18,139,"Indiana","Rush County",4,40,197,88,109
050,18,139,"Indiana","Rush County",4,41,186,94,92
050,18,139,"Indiana","Rush County",4,42,182,92,90
050,18,139,"Indiana","Rush County",4,43,200,100,100
050,18,139,"Indiana","Rush County",4,44,195,88,107
050,18,139,"Indiana","Rush County",4,45,198,98,100
050,18,139,"Indiana","Rush County",4,46,175,90,85
050,18,139,"Indiana","Rush County",4,47,194,105,89
050,18,139,"Indiana","Rush County",4,48,201,104,97
050,18,139,"Indiana","Rush County",4,49,221,115,106
050,18,139,"Indiana","Rush County",4,50,211,105,106
050,18,139,"Indiana","Rush County",4,51,231,117,114
050,18,139,"Indiana","Rush County",4,52,227,114,113
050,18,139,"Indiana","Rush County",4,53,234,116,118
050,18,139,"Indiana","Rush County",4,54,221,107,114
050,18,139,"Indiana","Rush County",4,55,206,92,114
050,18,139,"Indiana","Rush County",4,56,232,116,116
050,18,139,"Indiana","Rush County",4,57,247,135,112
050,18,139,"Indiana","Rush County",4,58,252,138,114
050,18,139,"Indiana","Rush County",4,59,237,121,116
050,18,139,"Indiana","Rush County",4,60,254,132,122
050,18,139,"Indiana","Rush County",4,61,252,126,126
050,18,139,"Indiana","Rush County",4,62,244,114,130
050,18,139,"Indiana","Rush County",4,63,247,121,126
050,18,139,"Indiana","Rush County",4,64,241,130,111
050,18,139,"Indiana","Rush County",4,65,235,122,113
050,18,139,"Indiana","Rush County",4,66,232,114,118
050,18,139,"Indiana","Rush County",4,67,200,100,100
050,18,139,"Indiana","Rush County",4,68,209,108,101
050,18,139,"Indiana","Rush County",4,69,202,99,103
050,18,139,"Indiana","Rush County",4,70,180,82,98
050,18,139,"Indiana","Rush County",4,71,162,72,90
050,18,139,"Indiana","Rush County",4,72,148,63,85
050,18,139,"Indiana","Rush County",4,73,155,69,86
050,18,139,"Indiana","Rush County",4,74,159,78,81
050,18,139,"Indiana","Rush County",4,75,166,82,84
050,18,139,"Indiana","Rush County",4,76,112,55,57
050,18,139,"Indiana","Rush County",4,77,110,51,59
050,18,139,"Indiana","Rush County",4,78,96,41,55
050,18,139,"Indiana","Rush County",4,79,116,53,63
050,18,139,"Indiana","Rush County",4,80,89,40,49
050,18,139,"Indiana","Rush County",4,81,93,41,52
050,18,139,"Indiana","Rush County",4,82,80,35,45
050,18,139,"Indiana","Rush County",4,83,77,34,43
050,18,139,"Indiana","Rush County",4,84,72,30,42
050,18,139,"Indiana","Rush County",4,85,364,137,227
050,18,139,"Indiana","Rush County",5,0,208,111,97
050,18,139,"Indiana","Rush County",5,1,189,102,87
050,18,139,"Indiana","Rush County",5,2,197,108,89
050,18,139,"Indiana","Rush County",5,3,200,100,100
050,18,139,"Indiana","Rush County",5,4,206,103,103
050,18,139,"Indiana","Rush County",5,5,188,89,99
050,18,139,"Indiana","Rush County",5,6,197,95,102
050,18,139,"Indiana","Rush County",5,7,213,112,101
050,18,139,"Indiana","Rush County",5,8,212,110,102
050,18,139,"Indiana","Rush County",5,9,200,103,97
050,18,139,"Indiana","Rush County",5,10,204,94,110
050,18,139,"Indiana","Rush County",5,11,217,111,106
050,18,139,"Indiana","Rush County",5,12,203,96,107
050,18,139,"Indiana","Rush County",5,13,214,112,102
050,18,139,"Indiana","Rush County",5,14,232,122,110
050,18,139,"Indiana","Rush County",5,15,249,129,120
050,18,139,"Indiana","Rush County",5,16,240,111,129
050,18,139,"Indiana","Rush County",5,17,211,100,111
050,18,139,"Indiana","Rush County",5,18,204,110,94
050,18,139,"Indiana","Rush County",5,19,147,74,73
050,18,139,"Indiana","Rush County",5,20,161,90,71
050,18,139,"Indiana","Rush County",5,21,176,89,87
050,18,139,"Indiana","Rush County",5,22,195,86,109
050,18,139,"Indiana","Rush County",5,23,193,102,91
050,18,139,"Indiana","Rush County",5,24,197,96,101
050,18,139,"Indiana","Rush County",5,25,185,93,92
050,18,139,"Indiana","Rush County",5,26,214,124,90
050,18,139,"Indiana","Rush County",5,27,227,118,109
050,18,139,"Indiana","Rush County",5,28,209,106,103
050,18,139,"Indiana","Rush County",5,29,208,96,112
050,18,139,"Indiana","Rush County",5,30,199,98,101
050,18,139,"Indiana","Rush County",5,31,199,99,100
050,18,139,"Indiana","Rush County",5,32,210,92,118
050,18,139,"Indiana","Rush County",5,33,202,91,111
050,18,139,"Indiana","Rush County",5,34,207,104,103
050,18,139,"Indiana","Rush County",5,35,211,101,110
050,18,139,"Indiana","Rush County",5,36,198,92,106
050,18,139,"Indiana","Rush County",5,37,201,100,101
050,18,139,"Indiana","Rush County",5,38,199,105,94
050,18,139,"Indiana","Rush County",5,39,179,94,85
050,18,139,"Indiana","Rush County",5,40,197,107,90
050,18,139,"Indiana","Rush County",5,41,196,88,108
050,18,139,"Indiana","Rush County",5,42,197,96,101
050,18,139,"Indiana","Rush County",5,43,182,92,90
050,18,139,"Indiana","Rush County",5,44,199,101,98
050,18,139,"Indiana","Rush County",5,45,186,86,100
050,18,139,"Indiana","Rush County",5,46,194,98,96
050,18,139,"Indiana","Rush County",5,47,172,85,87
050,18,139,"Indiana","Rush County",5,48,188,105,83
050,18,139,"Indiana","Rush County",5,49,198,100,98
050,18,139,"Indiana","Rush County",5,50,218,111,107
050,18,139,"Indiana","Rush County",5,51,221,110,111
050,18,139,"Indiana","Rush County",5,52,224,113,111
050,18,139,"Indiana","Rush County",5,53,230,111,119
050,18,139,"Indiana","Rush County",5,54,232,111,121
050,18,139,"Indiana","Rush County",5,55,216,104,112
050,18,139,"Indiana","Rush County",5,56,199,91,108
050,18,139,"Indiana","Rush County",5,57,231,115,116
050,18,139,"Indiana","Rush County",5,58,255,137,118
050,18,139,"Indiana","Rush County",5,59,247,136,111
050,18,139,"Indiana","Rush County",5,60,242,126,116
050,18,139,"Indiana","Rush County",5,61,251,132,119
050,18,139,"Indiana","Rush County",5,62,253,124,129
050,18,139,"Indiana","Rush County",5,63,246,112,134
050,18,139,"Indiana","Rush County",5,64,242,118,124
050,18,139,"Indiana","Rush County",5,65,227,119,108
050,18,139,"Indiana","Rush County",5,66,237,123,114
050,18,139,"Indiana","Rush County",5,67,222,112,110
050,18,139,"Indiana","Rush County",5,68,205,103,102
050,18,139,"Indiana","Rush County",5,69,202,104,98
050,18,139,"Indiana","Rush County",5,70,198,96,102
050,18,139,"Indiana","Rush County",5,71,169,80,89
050,18,139,"Indiana","Rush County",5,72,155,68,87
050,18,139,"Indiana","Rush County",5,73,144,60,84
050,18,139,"Indiana","Rush County",5,74,150,69,81
050,18,139,"Indiana","Rush County",5,75,150,74,76
050,18,139,"Indiana","Rush County",5,76,155,78,77
050,18,139,"Indiana","Rush County",5,77,108,52,56
050,18,139,"Indiana","Rush County",5,78,104,45,59
050,18,139,"Indiana","Rush County",5,79,90,37,53
050,18,139,"Indiana","Rush County",5,80,115,50,65
050,18,139,"Indiana","Rush County",5,81,85,39,46
050,18,139,"Indiana","Rush County",5,82,89,43,46
050,18,139,"Indiana","Rush County",5,83,72,32,40
050,18,139,"Indiana","Rush County",5,84,77,30,47
050,18,139,"Indiana","Rush County",5,85,376,146,230
050,18,141,"Indiana","St. Joseph County",1,0,3477,1782,1695
050,18,141,"Indiana","St. Joseph County",1,1,3464,1808,1656
050,18,141,"Indiana","St. Joseph County",1,2,3378,1733,1645
050,18,141,"Indiana","St. Joseph County",1,3,3467,1796,1671
050,18,141,"Indiana","St. Joseph County",1,4,3472,1744,1728
050,18,141,"Indiana","St. Joseph County",1,5,3469,1714,1755
050,18,141,"Indiana","St. Joseph County",1,6,3439,1798,1641
050,18,141,"Indiana","St. Joseph County",1,7,3644,1845,1799
050,18,141,"Indiana","St. Joseph County",1,8,3512,1780,1732
050,18,141,"Indiana","St. Joseph County",1,9,3539,1761,1778
050,18,141,"Indiana","St. Joseph County",1,10,3503,1771,1732
050,18,141,"Indiana","St. Joseph County",1,11,3704,1867,1837
050,18,141,"Indiana","St. Joseph County",1,12,3748,1919,1829
050,18,141,"Indiana","St. Joseph County",1,13,3765,1919,1846
050,18,141,"Indiana","St. Joseph County",1,14,3624,1875,1749
050,18,141,"Indiana","St. Joseph County",1,15,3650,1907,1743
050,18,141,"Indiana","St. Joseph County",1,16,3697,1943,1754
050,18,141,"Indiana","St. Joseph County",1,17,3616,1866,1750
050,18,141,"Indiana","St. Joseph County",1,18,4233,2119,2114
050,18,141,"Indiana","St. Joseph County",1,19,5517,2596,2921
050,18,141,"Indiana","St. Joseph County",1,20,5128,2431,2697
050,18,141,"Indiana","St. Joseph County",1,21,4781,2276,2505
050,18,141,"Indiana","St. Joseph County",1,22,4008,1927,2081
050,18,141,"Indiana","St. Joseph County",1,23,3462,1675,1787
050,18,141,"Indiana","St. Joseph County",1,24,3461,1708,1753
050,18,141,"Indiana","St. Joseph County",1,25,3628,1841,1787
050,18,141,"Indiana","St. Joseph County",1,26,3678,1865,1813
050,18,141,"Indiana","St. Joseph County",1,27,3846,1950,1896
050,18,141,"Indiana","St. Joseph County",1,28,3880,1939,1941
050,18,141,"Indiana","St. Joseph County",1,29,3763,1862,1901
050,18,141,"Indiana","St. Joseph County",1,30,3603,1786,1817
050,18,141,"Indiana","St. Joseph County",1,31,3590,1777,1813
050,18,141,"Indiana","St. Joseph County",1,32,3517,1756,1761
050,18,141,"Indiana","St. Joseph County",1,33,3467,1730,1737
050,18,141,"Indiana","St. Joseph County",1,34,3419,1729,1690
050,18,141,"Indiana","St. Joseph County",1,35,3444,1754,1690
050,18,141,"Indiana","St. Joseph County",1,36,3318,1691,1627
050,18,141,"Indiana","St. Joseph County",1,37,3405,1722,1683
050,18,141,"Indiana","St. Joseph County",1,38,3426,1731,1695
050,18,141,"Indiana","St. Joseph County",1,39,3452,1682,1770
050,18,141,"Indiana","St. Joseph County",1,40,3285,1603,1682
050,18,141,"Indiana","St. Joseph County",1,41,3249,1645,1604
050,18,141,"Indiana","St. Joseph County",1,42,3207,1639,1568
050,18,141,"Indiana","St. Joseph County",1,43,3058,1512,1546
050,18,141,"Indiana","St. Joseph County",1,44,2920,1405,1515
050,18,141,"Indiana","St. Joseph County",1,45,2968,1472,1496
050,18,141,"Indiana","St. Joseph County",1,46,2949,1463,1486
050,18,141,"Indiana","St. Joseph County",1,47,3045,1484,1561
050,18,141,"Indiana","St. Joseph County",1,48,3222,1561,1661
050,18,141,"Indiana","St. Joseph County",1,49,3428,1672,1756
050,18,141,"Indiana","St. Joseph County",1,50,3249,1609,1640
050,18,141,"Indiana","St. Joseph County",1,51,3108,1528,1580
050,18,141,"Indiana","St. Joseph County",1,52,3056,1547,1509
050,18,141,"Indiana","St. Joseph County",1,53,3148,1557,1591
050,18,141,"Indiana","St. Joseph County",1,54,3062,1470,1592
050,18,141,"Indiana","St. Joseph County",1,55,3217,1547,1670
050,18,141,"Indiana","St. Joseph County",1,56,3439,1685,1754
050,18,141,"Indiana","St. Joseph County",1,57,3364,1630,1734
050,18,141,"Indiana","St. Joseph County",1,58,3398,1672,1726
050,18,141,"Indiana","St. Joseph County",1,59,3453,1687,1766
050,18,141,"Indiana","St. Joseph County",1,60,3390,1667,1723
050,18,141,"Indiana","St. Joseph County",1,61,3375,1653,1722
050,18,141,"Indiana","St. Joseph County",1,62,3437,1696,1741
050,18,141,"Indiana","St. Joseph County",1,63,3382,1666,1716
050,18,141,"Indiana","St. Joseph County",1,64,3317,1608,1709
050,18,141,"Indiana","St. Joseph County",1,65,3203,1547,1656
050,18,141,"Indiana","St. Joseph County",1,66,3134,1482,1652
050,18,141,"Indiana","St. Joseph County",1,67,3043,1469,1574
050,18,141,"Indiana","St. Joseph County",1,68,2952,1411,1541
050,18,141,"Indiana","St. Joseph County",1,69,2738,1309,1429
050,18,141,"Indiana","St. Joseph County",1,70,2574,1240,1334
050,18,141,"Indiana","St. Joseph County",1,71,2417,1118,1299
050,18,141,"Indiana","St. Joseph County",1,72,2291,1051,1240
050,18,141,"Indiana","St. Joseph County",1,73,2268,1064,1204
050,18,141,"Indiana","St. Joseph County",1,74,1591,745,846
050,18,141,"Indiana","St. Joseph County",1,75,1565,723,842
050,18,141,"Indiana","St. Joseph County",1,76,1605,714,891
050,18,141,"Indiana","St. Joseph County",1,77,1564,685,879
050,18,141,"Indiana","St. Joseph County",1,78,1349,604,745
050,18,141,"Indiana","St. Joseph County",1,79,1203,518,685
050,18,141,"Indiana","St. Joseph County",1,80,1061,436,625
050,18,141,"Indiana","St. Joseph County",1,81,1030,434,596
050,18,141,"Indiana","St. Joseph County",1,82,927,387,540
050,18,141,"Indiana","St. Joseph County",1,83,865,336,529
050,18,141,"Indiana","St. Joseph County",1,84,823,339,484
050,18,141,"Indiana","St. Joseph County",1,85,5793,1964,3829
050,18,141,"Indiana","St. Joseph County",2,0,3382,1745,1637
050,18,141,"Indiana","St. Joseph County",2,1,3451,1788,1663
050,18,141,"Indiana","St. Joseph County",2,2,3399,1749,1650
050,18,141,"Indiana","St. Joseph County",2,3,3424,1766,1658
050,18,141,"Indiana","St. Joseph County",2,4,3474,1750,1724
050,18,141,"Indiana","St. Joseph County",2,5,3462,1718,1744
050,18,141,"Indiana","St. Joseph County",2,6,3445,1774,1671
050,18,141,"Indiana","St. Joseph County",2,7,3580,1824,1756
050,18,141,"Indiana","St. Joseph County",2,8,3531,1786,1745
050,18,141,"Indiana","St. Joseph County",2,9,3527,1762,1765
050,18,141,"Indiana","St. Joseph County",2,10,3512,1763,1749
050,18,141,"Indiana","St. Joseph County",2,11,3641,1834,1807
050,18,141,"Indiana","St. Joseph County",2,12,3758,1915,1843
050,18,141,"Indiana","St. Joseph County",2,13,3751,1913,1838
050,18,141,"Indiana","St. Joseph County",2,14,3657,1884,1773
050,18,141,"Indiana","St. Joseph County",2,15,3646,1904,1742
050,18,141,"Indiana","St. Joseph County",2,16,3690,1937,1753
050,18,141,"Indiana","St. Joseph County",2,17,3633,1883,1750
050,18,141,"Indiana","St. Joseph County",2,18,4213,2105,2108
050,18,141,"Indiana","St. Joseph County",2,19,5505,2591,2914
050,18,141,"Indiana","St. Joseph County",2,20,5179,2457,2722
050,18,141,"Indiana","St. Joseph County",2,21,4792,2274,2518
050,18,141,"Indiana","St. Joseph County",2,22,4007,1941,2066
050,18,141,"Indiana","St. Joseph County",2,23,3465,1684,1781
050,18,141,"Indiana","St. Joseph County",2,24,3469,1702,1767
050,18,141,"Indiana","St. Joseph County",2,25,3602,1813,1789
050,18,141,"Indiana","St. Joseph County",2,26,3666,1859,1807
050,18,141,"Indiana","St. Joseph County",2,27,3791,1924,1867
050,18,141,"Indiana","St. Joseph County",2,28,3857,1932,1925
050,18,141,"Indiana","St. Joseph County",2,29,3778,1876,1902
050,18,141,"Indiana","St. Joseph County",2,30,3653,1807,1846
050,18,141,"Indiana","St. Joseph County",2,31,3577,1771,1806
050,18,141,"Indiana","St. Joseph County",2,32,3524,1753,1771
050,18,141,"Indiana","St. Joseph County",2,33,3478,1740,1738
050,18,141,"Indiana","St. Joseph County",2,34,3429,1728,1701
050,18,141,"Indiana","St. Joseph County",2,35,3448,1751,1697
050,18,141,"Indiana","St. Joseph County",2,36,3331,1697,1634
050,18,141,"Indiana","St. Joseph County",2,37,3390,1719,1671
050,18,141,"Indiana","St. Joseph County",2,38,3426,1730,1696
050,18,141,"Indiana","St. Joseph County",2,39,3419,1679,1740
050,18,141,"Indiana","St. Joseph County",2,40,3337,1627,1710
050,18,141,"Indiana","St. Joseph County",2,41,3252,1635,1617
050,18,141,"Indiana","St. Joseph County",2,42,3199,1634,1565
050,18,141,"Indiana","St. Joseph County",2,43,3098,1543,1555
050,18,141,"Indiana","St. Joseph County",2,44,2921,1418,1503
050,18,141,"Indiana","St. Joseph County",2,45,2967,1463,1504
050,18,141,"Indiana","St. Joseph County",2,46,2940,1458,1482
050,18,141,"Indiana","St. Joseph County",2,47,3008,1474,1534
050,18,141,"Indiana","St. Joseph County",2,48,3169,1533,1636
050,18,141,"Indiana","St. Joseph County",2,49,3383,1645,1738
050,18,141,"Indiana","St. Joseph County",2,50,3293,1625,1668
050,18,141,"Indiana","St. Joseph County",2,51,3125,1537,1588
050,18,141,"Indiana","St. Joseph County",2,52,3055,1535,1520
050,18,141,"Indiana","St. Joseph County",2,53,3130,1558,1572
050,18,141,"Indiana","St. Joseph County",2,54,3069,1482,1587
050,18,141,"Indiana","St. Joseph County",2,55,3170,1520,1650
050,18,141,"Indiana","St. Joseph County",2,56,3392,1654,1738
050,18,141,"Indiana","St. Joseph County",2,57,3371,1641,1730
050,18,141,"Indiana","St. Joseph County",2,58,3372,1652,1720
050,18,141,"Indiana","St. Joseph County",2,59,3444,1689,1755
050,18,141,"Indiana","St. Joseph County",2,60,3388,1663,1725
050,18,141,"Indiana","St. Joseph County",2,61,3340,1634,1706
050,18,141,"Indiana","St. Joseph County",2,62,3400,1668,1732
050,18,141,"Indiana","St. Joseph County",2,63,3399,1672,1727
050,18,141,"Indiana","St. Joseph County",2,64,3304,1610,1694
050,18,141,"Indiana","St. Joseph County",2,65,3210,1553,1657
050,18,141,"Indiana","St. Joseph County",2,66,3144,1494,1650
050,18,141,"Indiana","St. Joseph County",2,67,3038,1456,1582
050,18,141,"Indiana","St. Joseph County",2,68,2948,1409,1539
050,18,141,"Indiana","St. Joseph County",2,69,2789,1332,1457
050,18,141,"Indiana","St. Joseph County",2,70,2585,1240,1345
050,18,141,"Indiana","St. Joseph County",2,71,2436,1140,1296
050,18,141,"Indiana","St. Joseph County",2,72,2269,1039,1230
050,18,141,"Indiana","St. Joseph County",2,73,2354,1094,1260
050,18,141,"Indiana","St. Joseph County",2,74,1650,772,878
050,18,141,"Indiana","St. Joseph County",2,75,1567,726,841
050,18,141,"Indiana","St. Joseph County",2,76,1575,706,869
050,18,141,"Indiana","St. Joseph County",2,77,1583,692,891
050,18,141,"Indiana","St. Joseph County",2,78,1361,604,757
050,18,141,"Indiana","St. Joseph County",2,79,1221,526,695
050,18,141,"Indiana","St. Joseph County",2,80,1083,453,630
050,18,141,"Indiana","St. Joseph County",2,81,1019,432,587
050,18,141,"Indiana","St. Joseph County",2,82,941,394,547
050,18,141,"Indiana","St. Joseph County",2,83,858,335,523
050,18,141,"Indiana","St. Joseph County",2,84,820,338,482
050,18,141,"Indiana","St. Joseph County",2,85,5743,1951,3792
050,18,141,"Indiana","St. Joseph County",3,0,3155,1617,1538
050,18,141,"Indiana","St. Joseph County",3,1,3368,1735,1633
050,18,141,"Indiana","St. Joseph County",3,2,3454,1803,1651
050,18,141,"Indiana","St. Joseph County",3,3,3395,1759,1636
050,18,141,"Indiana","St. Joseph County",3,4,3431,1774,1657
050,18,141,"Indiana","St. Joseph County",3,5,3460,1752,1708
050,18,141,"Indiana","St. Joseph County",3,6,3477,1724,1753
050,18,141,"Indiana","St. Joseph County",3,7,3453,1801,1652
050,18,141,"Indiana","St. Joseph County",3,8,3576,1852,1724
050,18,141,"Indiana","St. Joseph County",3,9,3518,1789,1729
050,18,141,"Indiana","St. Joseph County",3,10,3490,1767,1723
050,18,141,"Indiana","St. Joseph County",3,11,3461,1740,1721
050,18,141,"Indiana","St. Joseph County",3,12,3674,1853,1821
050,18,141,"Indiana","St. Joseph County",3,13,3749,1908,1841
050,18,141,"Indiana","St. Joseph County",3,14,3728,1904,1824
050,18,141,"Indiana","St. Joseph County",3,15,3669,1881,1788
050,18,141,"Indiana","St. Joseph County",3,16,3648,1900,1748
050,18,141,"Indiana","St. Joseph County",3,17,3673,1919,1754
050,18,141,"Indiana","St. Joseph County",3,18,4267,2127,2140
050,18,141,"Indiana","St. Joseph County",3,19,5440,2537,2903
050,18,141,"Indiana","St. Joseph County",3,20,5205,2473,2732
050,18,141,"Indiana","St. Joseph County",3,21,4867,2293,2574
050,18,141,"Indiana","St. Joseph County",3,22,4024,2010,2014
050,18,141,"Indiana","St. Joseph County",3,23,3557,1778,1779
050,18,141,"Indiana","St. Joseph County",3,24,3599,1745,1854
050,18,141,"Indiana","St. Joseph County",3,25,3531,1713,1818
050,18,141,"Indiana","St. Joseph County",3,26,3603,1799,1804
050,18,141,"Indiana","St. Joseph County",3,27,3720,1875,1845
050,18,141,"Indiana","St. Joseph County",3,28,3743,1891,1852
050,18,141,"Indiana","St. Joseph County",3,29,3895,1959,1936
050,18,141,"Indiana","St. Joseph County",3,30,3728,1863,1865
050,18,141,"Indiana","St. Joseph County",3,31,3630,1800,1830
050,18,141,"Indiana","St. Joseph County",3,32,3496,1708,1788
050,18,141,"Indiana","St. Joseph County",3,33,3489,1727,1762
050,18,141,"Indiana","St. Joseph County",3,34,3465,1735,1730
050,18,141,"Indiana","St. Joseph County",3,35,3434,1719,1715
050,18,141,"Indiana","St. Joseph County",3,36,3437,1733,1704
050,18,141,"Indiana","St. Joseph County",3,37,3335,1715,1620
050,18,141,"Indiana","St. Joseph County",3,38,3333,1689,1644
050,18,141,"Indiana","St. Joseph County",3,39,3430,1754,1676
050,18,141,"Indiana","St. Joseph County",3,40,3425,1670,1755
050,18,141,"Indiana","St. Joseph County",3,41,3314,1620,1694
050,18,141,"Indiana","St. Joseph County",3,42,3240,1619,1621
050,18,141,"Indiana","St. Joseph County",3,43,3171,1627,1544
050,18,141,"Indiana","St. Joseph County",3,44,3068,1526,1542
050,18,141,"Indiana","St. Joseph County",3,45,2918,1404,1514
050,18,141,"Indiana","St. Joseph County",3,46,2892,1419,1473
050,18,141,"Indiana","St. Joseph County",3,47,2958,1466,1492
050,18,141,"Indiana","St. Joseph County",3,48,3000,1461,1539
050,18,141,"Indiana","St. Joseph County",3,49,3143,1515,1628
050,18,141,"Indiana","St. Joseph County",3,50,3349,1628,1721
050,18,141,"Indiana","St. Joseph County",3,51,3316,1619,1697
050,18,141,"Indiana","St. Joseph County",3,52,3068,1514,1554
050,18,141,"Indiana","St. Joseph County",3,53,3038,1539,1499
050,18,141,"Indiana","St. Joseph County",3,54,3078,1524,1554
050,18,141,"Indiana","St. Joseph County",3,55,2988,1444,1544
050,18,141,"Indiana","St. Joseph County",3,56,3159,1517,1642
050,18,141,"Indiana","St. Joseph County",3,57,3363,1625,1738
050,18,141,"Indiana","St. Joseph County",3,58,3326,1632,1694
050,18,141,"Indiana","St. Joseph County",3,59,3326,1628,1698
050,18,141,"Indiana","St. Joseph County",3,60,3399,1662,1737
050,18,141,"Indiana","St. Joseph County",3,61,3286,1619,1667
050,18,141,"Indiana","St. Joseph County",3,62,3284,1581,1703
050,18,141,"Indiana","St. Joseph County",3,63,3316,1602,1714
050,18,141,"Indiana","St. Joseph County",3,64,3346,1644,1702
050,18,141,"Indiana","St. Joseph County",3,65,3231,1561,1670
050,18,141,"Indiana","St. Joseph County",3,66,3136,1503,1633
050,18,141,"Indiana","St. Joseph County",3,67,3030,1425,1605
050,18,141,"Indiana","St. Joseph County",3,68,2964,1398,1566
050,18,141,"Indiana","St. Joseph County",3,69,2884,1363,1521
050,18,141,"Indiana","St. Joseph County",3,70,2703,1276,1427
050,18,141,"Indiana","St. Joseph County",3,71,2492,1197,1295
050,18,141,"Indiana","St. Joseph County",3,72,2354,1100,1254
050,18,141,"Indiana","St. Joseph County",3,73,2190,1008,1182
050,18,141,"Indiana","St. Joseph County",3,74,2288,1047,1241
050,18,141,"Indiana","St. Joseph County",3,75,1580,734,846
050,18,141,"Indiana","St. Joseph County",3,76,1496,683,813
050,18,141,"Indiana","St. Joseph County",3,77,1480,660,820
050,18,141,"Indiana","St. Joseph County",3,78,1506,645,861
050,18,141,"Indiana","St. Joseph County",3,79,1287,562,725
050,18,141,"Indiana","St. Joseph County",3,80,1144,481,663
050,18,141,"Indiana","St. Joseph County",3,81,1033,430,603
050,18,141,"Indiana","St. Joseph County",3,82,920,390,530
050,18,141,"Indiana","St. Joseph County",3,83,868,342,526
050,18,141,"Indiana","St. Joseph County",3,84,825,328,497
050,18,141,"Indiana","St. Joseph County",3,85,5497,1872,3625
050,18,141,"Indiana","St. Joseph County",4,0,3224,1670,1554
050,18,141,"Indiana","St. Joseph County",4,1,3144,1590,1554
050,18,141,"Indiana","St. Joseph County",4,2,3373,1745,1628
050,18,141,"Indiana","St. Joseph County",4,3,3469,1804,1665
050,18,141,"Indiana","St. Joseph County",4,4,3432,1792,1640
050,18,141,"Indiana","St. Joseph County",4,5,3448,1777,1671
050,18,141,"Indiana","St. Joseph County",4,6,3475,1751,1724
050,18,141,"Indiana","St. Joseph County",4,7,3498,1744,1754
050,18,141,"Indiana","St. Joseph County",4,8,3468,1832,1636
050,18,141,"Indiana","St. Joseph County",4,9,3599,1850,1749
050,18,141,"Indiana","St. Joseph County",4,10,3529,1806,1723
050,18,141,"Indiana","St. Joseph County",4,11,3498,1773,1725
050,18,141,"Indiana","St. Joseph County",4,12,3468,1748,1720
050,18,141,"Indiana","St. Joseph County",4,13,3632,1846,1786
050,18,141,"Indiana","St. Joseph County",4,14,3776,1921,1855
050,18,141,"Indiana","St. Joseph County",4,15,3758,1918,1840
050,18,141,"Indiana","St. Joseph County",4,16,3701,1874,1827
050,18,141,"Indiana","St. Joseph County",4,17,3659,1890,1769
050,18,141,"Indiana","St. Joseph County",4,18,4274,2154,2120
050,18,141,"Indiana","St. Joseph County",4,19,5362,2518,2844
050,18,141,"Indiana","St. Joseph County",4,20,5047,2385,2662
050,18,141,"Indiana","St. Joseph County",4,21,4863,2315,2548
050,18,141,"Indiana","St. Joseph County",4,22,4142,2029,2113
050,18,141,"Indiana","St. Joseph County",4,23,3645,1873,1772
050,18,141,"Indiana","St. Joseph County",4,24,3594,1798,1796
050,18,141,"Indiana","St. Joseph County",4,25,3634,1759,1875
050,18,141,"Indiana","St. Joseph County",4,26,3549,1728,1821
050,18,141,"Indiana","St. Joseph County",4,27,3678,1824,1854
050,18,141,"Indiana","St. Joseph County",4,28,3669,1852,1817
050,18,141,"Indiana","St. Joseph County",4,29,3721,1923,1798
050,18,141,"Indiana","St. Joseph County",4,30,3792,1917,1875
050,18,141,"Indiana","St. Joseph County",4,31,3706,1845,1861
050,18,141,"Indiana","St. Joseph County",4,32,3604,1770,1834
050,18,141,"Indiana","St. Joseph County",4,33,3459,1691,1768
050,18,141,"Indiana","St. Joseph County",4,34,3483,1716,1767
050,18,141,"Indiana","St. Joseph County",4,35,3431,1708,1723
050,18,141,"Indiana","St. Joseph County",4,36,3420,1691,1729
050,18,141,"Indiana","St. Joseph County",4,37,3417,1701,1716
050,18,141,"Indiana","St. Joseph County",4,38,3329,1719,1610
050,18,141,"Indiana","St. Joseph County",4,39,3346,1675,1671
050,18,141,"Indiana","St. Joseph County",4,40,3404,1729,1675
050,18,141,"Indiana","St. Joseph County",4,41,3390,1660,1730
050,18,141,"Indiana","St. Joseph County",4,42,3303,1601,1702
050,18,141,"Indiana","St. Joseph County",4,43,3207,1592,1615
050,18,141,"Indiana","St. Joseph County",4,44,3172,1631,1541
050,18,141,"Indiana","St. Joseph County",4,45,3075,1513,1562
050,18,141,"Indiana","St. Joseph County",4,46,2888,1401,1487
050,18,141,"Indiana","St. Joseph County",4,47,2924,1430,1494
050,18,141,"Indiana","St. Joseph County",4,48,2958,1452,1506
050,18,141,"Indiana","St. Joseph County",4,49,2967,1423,1544
050,18,141,"Indiana","St. Joseph County",4,50,3117,1509,1608
050,18,141,"Indiana","St. Joseph County",4,51,3321,1606,1715
050,18,141,"Indiana","St. Joseph County",4,52,3314,1614,1700
050,18,141,"Indiana","St. Joseph County",4,53,3054,1513,1541
050,18,141,"Indiana","St. Joseph County",4,54,3024,1525,1499
050,18,141,"Indiana","St. Joseph County",4,55,2995,1500,1495
050,18,141,"Indiana","St. Joseph County",4,56,2935,1424,1511
050,18,141,"Indiana","St. Joseph County",4,57,3111,1494,1617
050,18,141,"Indiana","St. Joseph County",4,58,3317,1613,1704
050,18,141,"Indiana","St. Joseph County",4,59,3272,1593,1679
050,18,141,"Indiana","St. Joseph County",4,60,3318,1608,1710
050,18,141,"Indiana","St. Joseph County",4,61,3324,1621,1703
050,18,141,"Indiana","St. Joseph County",4,62,3237,1568,1669
050,18,141,"Indiana","St. Joseph County",4,63,3225,1538,1687
050,18,141,"Indiana","St. Joseph County",4,64,3227,1572,1655
050,18,141,"Indiana","St. Joseph County",4,65,3272,1614,1658
050,18,141,"Indiana","St. Joseph County",4,66,3162,1507,1655
050,18,141,"Indiana","St. Joseph County",4,67,3038,1442,1596
050,18,141,"Indiana","St. Joseph County",4,68,2962,1377,1585
050,18,141,"Indiana","St. Joseph County",4,69,2915,1350,1565
050,18,141,"Indiana","St. Joseph County",4,70,2820,1323,1497
050,18,141,"Indiana","St. Joseph County",4,71,2614,1240,1374
050,18,141,"Indiana","St. Joseph County",4,72,2427,1154,1273
050,18,141,"Indiana","St. Joseph County",4,73,2249,1049,1200
050,18,141,"Indiana","St. Joseph County",4,74,2140,968,1172
050,18,141,"Indiana","St. Joseph County",4,75,2204,994,1210
050,18,141,"Indiana","St. Joseph County",4,76,1511,696,815
050,18,141,"Indiana","St. Joseph County",4,77,1424,648,776
050,18,141,"Indiana","St. Joseph County",4,78,1394,622,772
050,18,141,"Indiana","St. Joseph County",4,79,1448,611,837
050,18,141,"Indiana","St. Joseph County",4,80,1215,518,697
050,18,141,"Indiana","St. Joseph County",4,81,1097,464,633
050,18,141,"Indiana","St. Joseph County",4,82,951,388,563
050,18,141,"Indiana","St. Joseph County",4,83,859,350,509
050,18,141,"Indiana","St. Joseph County",4,84,826,330,496
050,18,141,"Indiana","St. Joseph County",4,85,5359,1808,3551
050,18,141,"Indiana","St. Joseph County",5,0,3243,1679,1564
050,18,141,"Indiana","St. Joseph County",5,1,3225,1695,1530
050,18,141,"Indiana","St. Joseph County",5,2,3164,1600,1564
050,18,141,"Indiana","St. Joseph County",5,3,3388,1730,1658
050,18,141,"Indiana","St. Joseph County",5,4,3512,1827,1685
050,18,141,"Indiana","St. Joseph County",5,5,3437,1789,1648
050,18,141,"Indiana","St. Joseph County",5,6,3506,1812,1694
050,18,141,"Indiana","St. Joseph County",5,7,3511,1780,1731
050,18,141,"Indiana","St. Joseph County",5,8,3534,1759,1775
050,18,141,"Indiana","St. Joseph County",5,9,3497,1858,1639
050,18,141,"Indiana","St. Joseph County",5,10,3629,1873,1756
050,18,141,"Indiana","St. Joseph County",5,11,3519,1805,1714
050,18,141,"Indiana","St. Joseph County",5,12,3494,1774,1720
050,18,141,"Indiana","St. Joseph County",5,13,3498,1766,1732
050,18,141,"Indiana","St. Joseph County",5,14,3668,1869,1799
050,18,141,"Indiana","St. Joseph County",5,15,3792,1934,1858
050,18,141,"Indiana","St. Joseph County",5,16,3786,1928,1858
050,18,141,"Indiana","St. Joseph County",5,17,3716,1878,1838
050,18,141,"Indiana","St. Joseph County",5,18,4261,2135,2126
050,18,141,"Indiana","St. Joseph County",5,19,5436,2579,2857
050,18,141,"Indiana","St. Joseph County",5,20,5056,2392,2664
050,18,141,"Indiana","St. Joseph County",5,21,4756,2249,2507
050,18,141,"Indiana","St. Joseph County",5,22,4166,2056,2110
050,18,141,"Indiana","St. Joseph County",5,23,3687,1861,1826
050,18,141,"Indiana","St. Joseph County",5,24,3683,1855,1828
050,18,141,"Indiana","St. Joseph County",5,25,3598,1803,1795
050,18,141,"Indiana","St. Joseph County",5,26,3615,1730,1885
050,18,141,"Indiana","St. Joseph County",5,27,3576,1730,1846
050,18,141,"Indiana","St. Joseph County",5,28,3643,1810,1833
050,18,141,"Indiana","St. Joseph County",5,29,3585,1842,1743
050,18,141,"Indiana","St. Joseph County",5,30,3699,1908,1791
050,18,141,"Indiana","St. Joseph County",5,31,3758,1895,1863
050,18,141,"Indiana","St. Joseph County",5,32,3697,1851,1846
050,18,141,"Indiana","St. Joseph County",5,33,3578,1753,1825
050,18,141,"Indiana","St. Joseph County",5,34,3473,1687,1786
050,18,141,"Indiana","St. Joseph County",5,35,3455,1697,1758
050,18,141,"Indiana","St. Joseph County",5,36,3404,1692,1712
050,18,141,"Indiana","St. Joseph County",5,37,3400,1682,1718
050,18,141,"Indiana","St. Joseph County",5,38,3435,1718,1717
050,18,141,"Indiana","St. Joseph County",5,39,3313,1692,1621
050,18,141,"Indiana","St. Joseph County",5,40,3313,1659,1654
050,18,141,"Indiana","St. Joseph County",5,41,3388,1723,1665
050,18,141,"Indiana","St. Joseph County",5,42,3368,1652,1716
050,18,141,"Indiana","St. Joseph County",5,43,3296,1581,1715
050,18,141,"Indiana","St. Joseph County",5,44,3211,1583,1628
050,18,141,"Indiana","St. Joseph County",5,45,3169,1636,1533
050,18,141,"Indiana","St. Joseph County",5,46,3046,1492,1554
050,18,141,"Indiana","St. Joseph County",5,47,2909,1412,1497
050,18,141,"Indiana","St. Joseph County",5,48,2910,1411,1499
050,18,141,"Indiana","St. Joseph County",5,49,2931,1420,1511
050,18,141,"Indiana","St. Joseph County",5,50,2924,1411,1513
050,18,141,"Indiana","St. Joseph County",5,51,3101,1497,1604
050,18,141,"Indiana","St. Joseph County",5,52,3317,1610,1707
050,18,141,"Indiana","St. Joseph County",5,53,3286,1611,1675
050,18,141,"Indiana","St. Joseph County",5,54,3029,1496,1533
050,18,141,"Indiana","St. Joseph County",5,55,2961,1485,1476
050,18,141,"Indiana","St. Joseph County",5,56,3001,1490,1511
050,18,141,"Indiana","St. Joseph County",5,57,2874,1396,1478
050,18,141,"Indiana","St. Joseph County",5,58,3095,1488,1607
050,18,141,"Indiana","St. Joseph County",5,59,3261,1581,1680
050,18,141,"Indiana","St. Joseph County",5,60,3234,1557,1677
050,18,141,"Indiana","St. Joseph County",5,61,3230,1563,1667
050,18,141,"Indiana","St. Joseph County",5,62,3273,1582,1691
050,18,141,"Indiana","St. Joseph County",5,63,3148,1521,1627
050,18,141,"Indiana","St. Joseph County",5,64,3153,1505,1648
050,18,141,"Indiana","St. Joseph County",5,65,3134,1526,1608
050,18,141,"Indiana","St. Joseph County",5,66,3230,1585,1645
050,18,141,"Indiana","St. Joseph County",5,67,3094,1452,1642
050,18,141,"Indiana","St. Joseph County",5,68,2985,1408,1577
050,18,141,"Indiana","St. Joseph County",5,69,2907,1332,1575
050,18,141,"Indiana","St. Joseph County",5,70,2843,1303,1540
050,18,141,"Indiana","St. Joseph County",5,71,2730,1287,1443
050,18,141,"Indiana","St. Joseph County",5,72,2564,1216,1348
050,18,141,"Indiana","St. Joseph County",5,73,2346,1117,1229
050,18,141,"Indiana","St. Joseph County",5,74,2232,1019,1213
050,18,141,"Indiana","St. Joseph County",5,75,2062,921,1141
050,18,141,"Indiana","St. Joseph County",5,76,2136,958,1178
050,18,141,"Indiana","St. Joseph County",5,77,1442,675,767
050,18,141,"Indiana","St. Joseph County",5,78,1363,618,745
050,18,141,"Indiana","St. Joseph County",5,79,1349,595,754
050,18,141,"Indiana","St. Joseph County",5,80,1378,574,804
050,18,141,"Indiana","St. Joseph County",5,81,1174,505,669
050,18,141,"Indiana","St. Joseph County",5,82,1022,426,596
050,18,141,"Indiana","St. Joseph County",5,83,894,344,550
050,18,141,"Indiana","St. Joseph County",5,84,827,344,483
050,18,141,"Indiana","St. Joseph County",5,85,5315,1790,3525
050,18,143,"Indiana","Scott County",1,0,266,135,131
050,18,143,"Indiana","Scott County",1,1,260,128,132
050,18,143,"Indiana","Scott County",1,2,279,139,140
050,18,143,"Indiana","Scott County",1,3,288,145,143
050,18,143,"Indiana","Scott County",1,4,296,146,150
050,18,143,"Indiana","Scott County",1,5,305,168,137
050,18,143,"Indiana","Scott County",1,6,298,159,139
050,18,143,"Indiana","Scott County",1,7,302,148,154
050,18,143,"Indiana","Scott County",1,8,307,156,151
050,18,143,"Indiana","Scott County",1,9,291,133,158
050,18,143,"Indiana","Scott County",1,10,296,152,144
050,18,143,"Indiana","Scott County",1,11,345,174,171
050,18,143,"Indiana","Scott County",1,12,333,156,177
050,18,143,"Indiana","Scott County",1,13,357,163,194
050,18,143,"Indiana","Scott County",1,14,315,151,164
050,18,143,"Indiana","Scott County",1,15,314,148,166
050,18,143,"Indiana","Scott County",1,16,311,153,158
050,18,143,"Indiana","Scott County",1,17,327,174,153
050,18,143,"Indiana","Scott County",1,18,273,139,134
050,18,143,"Indiana","Scott County",1,19,215,117,98
050,18,143,"Indiana","Scott County",1,20,247,131,116
050,18,143,"Indiana","Scott County",1,21,262,136,126
050,18,143,"Indiana","Scott County",1,22,287,145,142
050,18,143,"Indiana","Scott County",1,23,294,135,159
050,18,143,"Indiana","Scott County",1,24,315,145,170
050,18,143,"Indiana","Scott County",1,25,289,144,145
050,18,143,"Indiana","Scott County",1,26,299,160,139
050,18,143,"Indiana","Scott County",1,27,326,170,156
050,18,143,"Indiana","Scott County",1,28,314,147,167
050,18,143,"Indiana","Scott County",1,29,333,165,168
050,18,143,"Indiana","Scott County",1,30,341,177,164
050,18,143,"Indiana","Scott County",1,31,307,152,155
050,18,143,"Indiana","Scott County",1,32,279,146,133
050,18,143,"Indiana","Scott County",1,33,264,130,134
050,18,143,"Indiana","Scott County",1,34,280,129,151
050,18,143,"Indiana","Scott County",1,35,287,153,134
050,18,143,"Indiana","Scott County",1,36,289,152,137
050,18,143,"Indiana","Scott County",1,37,274,142,132
050,18,143,"Indiana","Scott County",1,38,314,150,164
050,18,143,"Indiana","Scott County",1,39,287,140,147
050,18,143,"Indiana","Scott County",1,40,282,144,138
050,18,143,"Indiana","Scott County",1,41,286,131,155
050,18,143,"Indiana","Scott County",1,42,305,147,158
050,18,143,"Indiana","Scott County",1,43,319,152,167
050,18,143,"Indiana","Scott County",1,44,304,138,166
050,18,143,"Indiana","Scott County",1,45,323,151,172
050,18,143,"Indiana","Scott County",1,46,321,163,158
050,18,143,"Indiana","Scott County",1,47,333,166,167
050,18,143,"Indiana","Scott County",1,48,346,176,170
050,18,143,"Indiana","Scott County",1,49,372,195,177
050,18,143,"Indiana","Scott County",1,50,359,195,164
050,18,143,"Indiana","Scott County",1,51,345,166,179
050,18,143,"Indiana","Scott County",1,52,308,164,144
050,18,143,"Indiana","Scott County",1,53,348,192,156
050,18,143,"Indiana","Scott County",1,54,360,182,178
050,18,143,"Indiana","Scott County",1,55,340,176,164
050,18,143,"Indiana","Scott County",1,56,351,192,159
050,18,143,"Indiana","Scott County",1,57,395,197,198
050,18,143,"Indiana","Scott County",1,58,395,187,208
050,18,143,"Indiana","Scott County",1,59,351,168,183
050,18,143,"Indiana","Scott County",1,60,355,180,175
050,18,143,"Indiana","Scott County",1,61,350,173,177
050,18,143,"Indiana","Scott County",1,62,323,157,166
050,18,143,"Indiana","Scott County",1,63,316,153,163
050,18,143,"Indiana","Scott County",1,64,293,147,146
050,18,143,"Indiana","Scott County",1,65,305,147,158
050,18,143,"Indiana","Scott County",1,66,322,163,159
050,18,143,"Indiana","Scott County",1,67,272,139,133
050,18,143,"Indiana","Scott County",1,68,264,138,126
050,18,143,"Indiana","Scott County",1,69,250,116,134
050,18,143,"Indiana","Scott County",1,70,245,117,128
050,18,143,"Indiana","Scott County",1,71,231,107,124
050,18,143,"Indiana","Scott County",1,72,232,108,124
050,18,143,"Indiana","Scott County",1,73,263,120,143
050,18,143,"Indiana","Scott County",1,74,182,89,93
050,18,143,"Indiana","Scott County",1,75,160,71,89
050,18,143,"Indiana","Scott County",1,76,178,73,105
050,18,143,"Indiana","Scott County",1,77,164,73,91
050,18,143,"Indiana","Scott County",1,78,136,61,75
050,18,143,"Indiana","Scott County",1,79,134,53,81
050,18,143,"Indiana","Scott County",1,80,107,44,63
050,18,143,"Indiana","Scott County",1,81,92,36,56
050,18,143,"Indiana","Scott County",1,82,88,32,56
050,18,143,"Indiana","Scott County",1,83,87,32,55
050,18,143,"Indiana","Scott County",1,84,83,32,51
050,18,143,"Indiana","Scott County",1,85,347,130,217
050,18,143,"Indiana","Scott County",2,0,274,138,136
050,18,143,"Indiana","Scott County",2,1,263,130,133
050,18,143,"Indiana","Scott County",2,2,275,136,139
050,18,143,"Indiana","Scott County",2,3,284,142,142
050,18,143,"Indiana","Scott County",2,4,297,148,149
050,18,143,"Indiana","Scott County",2,5,305,164,141
050,18,143,"Indiana","Scott County",2,6,300,162,138
050,18,143,"Indiana","Scott County",2,7,304,152,152
050,18,143,"Indiana","Scott County",2,8,305,153,152
050,18,143,"Indiana","Scott County",2,9,292,136,156
050,18,143,"Indiana","Scott County",2,10,295,148,147
050,18,143,"Indiana","Scott County",2,11,332,168,164
050,18,143,"Indiana","Scott County",2,12,339,162,177
050,18,143,"Indiana","Scott County",2,13,349,160,189
050,18,143,"Indiana","Scott County",2,14,326,153,173
050,18,143,"Indiana","Scott County",2,15,315,149,166
050,18,143,"Indiana","Scott County",2,16,311,151,160
050,18,143,"Indiana","Scott County",2,17,323,169,154
050,18,143,"Indiana","Scott County",2,18,272,142,130
050,18,143,"Indiana","Scott County",2,19,217,115,102
050,18,143,"Indiana","Scott County",2,20,249,130,119
050,18,143,"Indiana","Scott County",2,21,263,136,127
050,18,143,"Indiana","Scott County",2,22,283,143,140
050,18,143,"Indiana","Scott County",2,23,298,139,159
050,18,143,"Indiana","Scott County",2,24,315,146,169
050,18,143,"Indiana","Scott County",2,25,292,143,149
050,18,143,"Indiana","Scott County",2,26,299,158,141
050,18,143,"Indiana","Scott County",2,27,320,166,154
050,18,143,"Indiana","Scott County",2,28,321,154,167
050,18,143,"Indiana","Scott County",2,29,331,163,168
050,18,143,"Indiana","Scott County",2,30,341,174,167
050,18,143,"Indiana","Scott County",2,31,313,156,157
050,18,143,"Indiana","Scott County",2,32,284,147,137
050,18,143,"Indiana","Scott County",2,33,268,135,133
050,18,143,"Indiana","Scott County",2,34,278,129,149
050,18,143,"Indiana","Scott County",2,35,290,150,140
050,18,143,"Indiana","Scott County",2,36,284,149,135
050,18,143,"Indiana","Scott County",2,37,277,144,133
050,18,143,"Indiana","Scott County",2,38,306,150,156
050,18,143,"Indiana","Scott County",2,39,289,140,149
050,18,143,"Indiana","Scott County",2,40,284,144,140
050,18,143,"Indiana","Scott County",2,41,282,133,149
050,18,143,"Indiana","Scott County",2,42,297,142,155
050,18,143,"Indiana","Scott County",2,43,317,152,165
050,18,143,"Indiana","Scott County",2,44,306,140,166
050,18,143,"Indiana","Scott County",2,45,317,147,170
050,18,143,"Indiana","Scott County",2,46,320,159,161
050,18,143,"Indiana","Scott County",2,47,327,164,163
050,18,143,"Indiana","Scott County",2,48,339,171,168
050,18,143,"Indiana","Scott County",2,49,370,194,176
050,18,143,"Indiana","Scott County",2,50,359,193,166
050,18,143,"Indiana","Scott County",2,51,346,170,176
050,18,143,"Indiana","Scott County",2,52,318,165,153
050,18,143,"Indiana","Scott County",2,53,338,186,152
050,18,143,"Indiana","Scott County",2,54,354,184,170
050,18,143,"Indiana","Scott County",2,55,341,176,165
050,18,143,"Indiana","Scott County",2,56,350,190,160
050,18,143,"Indiana","Scott County",2,57,387,197,190
050,18,143,"Indiana","Scott County",2,58,394,189,205
050,18,143,"Indiana","Scott County",2,59,362,172,190
050,18,143,"Indiana","Scott County",2,60,353,178,175
050,18,143,"Indiana","Scott County",2,61,347,172,175
050,18,143,"Indiana","Scott County",2,62,328,160,168
050,18,143,"Indiana","Scott County",2,63,320,155,165
050,18,143,"Indiana","Scott County",2,64,294,145,149
050,18,143,"Indiana","Scott County",2,65,303,147,156
050,18,143,"Indiana","Scott County",2,66,314,158,156
050,18,143,"Indiana","Scott County",2,67,283,144,139
050,18,143,"Indiana","Scott County",2,68,262,134,128
050,18,143,"Indiana","Scott County",2,69,254,121,133
050,18,143,"Indiana","Scott County",2,70,244,117,127
050,18,143,"Indiana","Scott County",2,71,234,109,125
050,18,143,"Indiana","Scott County",2,72,225,105,120
050,18,143,"Indiana","Scott County",2,73,269,123,146
050,18,143,"Indiana","Scott County",2,74,187,90,97
050,18,143,"Indiana","Scott County",2,75,164,74,90
050,18,143,"Indiana","Scott County",2,76,170,67,103
050,18,143,"Indiana","Scott County",2,77,166,73,93
050,18,143,"Indiana","Scott County",2,78,139,63,76
050,18,143,"Indiana","Scott County",2,79,132,53,79
050,18,143,"Indiana","Scott County",2,80,107,43,64
050,18,143,"Indiana","Scott County",2,81,94,38,56
050,18,143,"Indiana","Scott County",2,82,89,32,57
050,18,143,"Indiana","Scott County",2,83,84,32,52
050,18,143,"Indiana","Scott County",2,84,82,31,51
050,18,143,"Indiana","Scott County",2,85,346,127,219
050,18,143,"Indiana","Scott County",3,0,286,138,148
050,18,143,"Indiana","Scott County",3,1,281,137,144
050,18,143,"Indiana","Scott County",3,2,249,125,124
050,18,143,"Indiana","Scott County",3,3,274,133,141
050,18,143,"Indiana","Scott County",3,4,283,132,151
050,18,143,"Indiana","Scott County",3,5,299,148,151
050,18,143,"Indiana","Scott County",3,6,301,158,143
050,18,143,"Indiana","Scott County",3,7,305,162,143
050,18,143,"Indiana","Scott County",3,8,317,163,154
050,18,143,"Indiana","Scott County",3,9,302,152,150
050,18,143,"Indiana","Scott County",3,10,299,138,161
050,18,143,"Indiana","Scott County",3,11,290,150,140
050,18,143,"Indiana","Scott County",3,12,325,158,167
050,18,143,"Indiana","Scott County",3,13,337,164,173
050,18,143,"Indiana","Scott County",3,14,347,165,182
050,18,143,"Indiana","Scott County",3,15,327,158,169
050,18,143,"Indiana","Scott County",3,16,322,159,163
050,18,143,"Indiana","Scott County",3,17,319,157,162
050,18,143,"Indiana","Scott County",3,18,271,143,128
050,18,143,"Indiana","Scott County",3,19,225,119,106
050,18,143,"Indiana","Scott County",3,20,236,124,112
050,18,143,"Indiana","Scott County",3,21,276,142,134
050,18,143,"Indiana","Scott County",3,22,288,146,142
050,18,143,"Indiana","Scott County",3,23,308,150,158
050,18,143,"Indiana","Scott County",3,24,326,160,166
050,18,143,"Indiana","Scott County",3,25,319,148,171
050,18,143,"Indiana","Scott County",3,26,298,149,149
050,18,143,"Indiana","Scott County",3,27,312,163,149
050,18,143,"Indiana","Scott County",3,28,330,173,157
050,18,143,"Indiana","Scott County",3,29,314,152,162
050,18,143,"Indiana","Scott County",3,30,338,167,171
050,18,143,"Indiana","Scott County",3,31,341,170,171
050,18,143,"Indiana","Scott County",3,32,301,149,152
050,18,143,"Indiana","Scott County",3,33,279,143,136
050,18,143,"Indiana","Scott County",3,34,253,131,122
050,18,143,"Indiana","Scott County",3,35,267,119,148
050,18,143,"Indiana","Scott County",3,36,300,155,145
050,18,143,"Indiana","Scott County",3,37,285,148,137
050,18,143,"Indiana","Scott County",3,38,275,137,138
050,18,143,"Indiana","Scott County",3,39,308,150,158
050,18,143,"Indiana","Scott County",3,40,314,158,156
050,18,143,"Indiana","Scott County",3,41,288,143,145
050,18,143,"Indiana","Scott County",3,42,286,134,152
050,18,143,"Indiana","Scott County",3,43,311,142,169
050,18,143,"Indiana","Scott County",3,44,316,149,167
050,18,143,"Indiana","Scott County",3,45,301,143,158
050,18,143,"Indiana","Scott County",3,46,320,156,164
050,18,143,"Indiana","Scott County",3,47,317,160,157
050,18,143,"Indiana","Scott County",3,48,324,159,165
050,18,143,"Indiana","Scott County",3,49,347,177,170
050,18,143,"Indiana","Scott County",3,50,369,196,173
050,18,143,"Indiana","Scott County",3,51,350,187,163
050,18,143,"Indiana","Scott County",3,52,356,181,175
050,18,143,"Indiana","Scott County",3,53,319,166,153
050,18,143,"Indiana","Scott County",3,54,339,185,154
050,18,143,"Indiana","Scott County",3,55,353,184,169
050,18,143,"Indiana","Scott County",3,56,332,170,162
050,18,143,"Indiana","Scott County",3,57,337,183,154
050,18,143,"Indiana","Scott County",3,58,384,190,194
050,18,143,"Indiana","Scott County",3,59,380,179,201
050,18,143,"Indiana","Scott County",3,60,374,181,193
050,18,143,"Indiana","Scott County",3,61,340,170,170
050,18,143,"Indiana","Scott County",3,62,335,168,167
050,18,143,"Indiana","Scott County",3,63,323,161,162
050,18,143,"Indiana","Scott County",3,64,312,149,163
050,18,143,"Indiana","Scott County",3,65,278,134,144
050,18,143,"Indiana","Scott County",3,66,294,148,146
050,18,143,"Indiana","Scott County",3,67,320,156,164
050,18,143,"Indiana","Scott County",3,68,268,128,140
050,18,143,"Indiana","Scott County",3,69,255,129,126
050,18,143,"Indiana","Scott County",3,70,242,116,126
050,18,143,"Indiana","Scott County",3,71,231,109,122
050,18,143,"Indiana","Scott County",3,72,223,105,118
050,18,143,"Indiana","Scott County",3,73,216,93,123
050,18,143,"Indiana","Scott County",3,74,257,119,138
050,18,143,"Indiana","Scott County",3,75,181,85,96
050,18,143,"Indiana","Scott County",3,76,153,68,85
050,18,143,"Indiana","Scott County",3,77,148,60,88
050,18,143,"Indiana","Scott County",3,78,157,70,87
050,18,143,"Indiana","Scott County",3,79,125,57,68
050,18,143,"Indiana","Scott County",3,80,120,46,74
050,18,143,"Indiana","Scott County",3,81,105,42,63
050,18,143,"Indiana","Scott County",3,82,89,31,58
050,18,143,"Indiana","Scott County",3,83,93,37,56
050,18,143,"Indiana","Scott County",3,84,72,26,46
050,18,143,"Indiana","Scott County",3,85,355,132,223
050,18,143,"Indiana","Scott County",4,0,275,130,145
050,18,143,"Indiana","Scott County",4,1,296,137,159
050,18,143,"Indiana","Scott County",4,2,284,141,143
050,18,143,"Indiana","Scott County",4,3,260,127,133
050,18,143,"Indiana","Scott County",4,4,286,145,141
050,18,143,"Indiana","Scott County",4,5,297,141,156
050,18,143,"Indiana","Scott County",4,6,334,173,161
050,18,143,"Indiana","Scott County",4,7,300,153,147
050,18,143,"Indiana","Scott County",4,8,307,173,134
050,18,143,"Indiana","Scott County",4,9,321,161,160
050,18,143,"Indiana","Scott County",4,10,300,150,150
050,18,143,"Indiana","Scott County",4,11,309,136,173
050,18,143,"Indiana","Scott County",4,12,283,140,143
050,18,143,"Indiana","Scott County",4,13,323,162,161
050,18,143,"Indiana","Scott County",4,14,346,173,173
050,18,143,"Indiana","Scott County",4,15,359,164,195
050,18,143,"Indiana","Scott County",4,16,329,158,171
050,18,143,"Indiana","Scott County",4,17,328,152,176
050,18,143,"Indiana","Scott County",4,18,255,137,118
050,18,143,"Indiana","Scott County",4,19,212,118,94
050,18,143,"Indiana","Scott County",4,20,231,120,111
050,18,143,"Indiana","Scott County",4,21,243,126,117
050,18,143,"Indiana","Scott County",4,22,288,149,139
050,18,143,"Indiana","Scott County",4,23,308,151,157
050,18,143,"Indiana","Scott County",4,24,328,161,167
050,18,143,"Indiana","Scott County",4,25,331,177,154
050,18,143,"Indiana","Scott County",4,26,304,144,160
050,18,143,"Indiana","Scott County",4,27,308,152,156
050,18,143,"Indiana","Scott County",4,28,313,158,155
050,18,143,"Indiana","Scott County",4,29,336,186,150
050,18,143,"Indiana","Scott County",4,30,318,159,159
050,18,143,"Indiana","Scott County",4,31,338,163,175
050,18,143,"Indiana","Scott County",4,32,345,173,172
050,18,143,"Indiana","Scott County",4,33,306,148,158
050,18,143,"Indiana","Scott County",4,34,274,138,136
050,18,143,"Indiana","Scott County",4,35,263,136,127
050,18,143,"Indiana","Scott County",4,36,280,127,153
050,18,143,"Indiana","Scott County",4,37,312,160,152
050,18,143,"Indiana","Scott County",4,38,296,150,146
050,18,143,"Indiana","Scott County",4,39,265,134,131
050,18,143,"Indiana","Scott County",4,40,318,154,164
050,18,143,"Indiana","Scott County",4,41,319,162,157
050,18,143,"Indiana","Scott County",4,42,273,136,137
050,18,143,"Indiana","Scott County",4,43,292,135,157
050,18,143,"Indiana","Scott County",4,44,317,138,179
050,18,143,"Indiana","Scott County",4,45,328,156,172
050,18,143,"Indiana","Scott County",4,46,296,142,154
050,18,143,"Indiana","Scott County",4,47,312,148,164
050,18,143,"Indiana","Scott County",4,48,324,163,161
050,18,143,"Indiana","Scott County",4,49,336,163,173
050,18,143,"Indiana","Scott County",4,50,346,178,168
050,18,143,"Indiana","Scott County",4,51,366,191,175
050,18,143,"Indiana","Scott County",4,52,353,190,163
050,18,143,"Indiana","Scott County",4,53,354,178,176
050,18,143,"Indiana","Scott County",4,54,316,167,149
050,18,143,"Indiana","Scott County",4,55,341,181,160
050,18,143,"Indiana","Scott County",4,56,344,177,167
050,18,143,"Indiana","Scott County",4,57,320,162,158
050,18,143,"Indiana","Scott County",4,58,337,180,157
050,18,143,"Indiana","Scott County",4,59,382,184,198
050,18,143,"Indiana","Scott County",4,60,376,176,200
050,18,143,"Indiana","Scott County",4,61,367,178,189
050,18,143,"Indiana","Scott County",4,62,347,167,180
050,18,143,"Indiana","Scott County",4,63,334,169,165
050,18,143,"Indiana","Scott County",4,64,310,151,159
050,18,143,"Indiana","Scott County",4,65,301,139,162
050,18,143,"Indiana","Scott County",4,66,274,135,139
050,18,143,"Indiana","Scott County",4,67,291,148,143
050,18,143,"Indiana","Scott County",4,68,308,150,158
050,18,143,"Indiana","Scott County",4,69,261,122,139
050,18,143,"Indiana","Scott County",4,70,240,122,118
050,18,143,"Indiana","Scott County",4,71,219,102,117
050,18,143,"Indiana","Scott County",4,72,213,101,112
050,18,143,"Indiana","Scott County",4,73,225,105,120
050,18,143,"Indiana","Scott County",4,74,199,85,114
050,18,143,"Indiana","Scott County",4,75,249,112,137
050,18,143,"Indiana","Scott County",4,76,175,82,93
050,18,143,"Indiana","Scott County",4,77,133,62,71
050,18,143,"Indiana","Scott County",4,78,138,58,80
050,18,143,"Indiana","Scott County",4,79,146,63,83
050,18,143,"Indiana","Scott County",4,80,108,50,58
050,18,143,"Indiana","Scott County",4,81,108,42,66
050,18,143,"Indiana","Scott County",4,82,104,41,63
050,18,143,"Indiana","Scott County",4,83,86,34,52
050,18,143,"Indiana","Scott County",4,84,79,29,50
050,18,143,"Indiana","Scott County",4,85,344,118,226
050,18,143,"Indiana","Scott County",5,0,272,128,144
050,18,143,"Indiana","Scott County",5,1,273,131,142
050,18,143,"Indiana","Scott County",5,2,301,146,155
050,18,143,"Indiana","Scott County",5,3,296,154,142
050,18,143,"Indiana","Scott County",5,4,258,123,135
050,18,143,"Indiana","Scott County",5,5,296,152,144
050,18,143,"Indiana","Scott County",5,6,297,139,158
050,18,143,"Indiana","Scott County",5,7,324,172,152
050,18,143,"Indiana","Scott County",5,8,316,159,157
050,18,143,"Indiana","Scott County",5,9,316,176,140
050,18,143,"Indiana","Scott County",5,10,328,161,167
050,18,143,"Indiana","Scott County",5,11,312,147,165
050,18,143,"Indiana","Scott County",5,12,311,139,172
050,18,143,"Indiana","Scott County",5,13,294,150,144
050,18,143,"Indiana","Scott County",5,14,339,177,162
050,18,143,"Indiana","Scott County",5,15,356,178,178
050,18,143,"Indiana","Scott County",5,16,371,169,202
050,18,143,"Indiana","Scott County",5,17,329,159,170
050,18,143,"Indiana","Scott County",5,18,262,129,133
050,18,143,"Indiana","Scott County",5,19,211,114,97
050,18,143,"Indiana","Scott County",5,20,224,121,103
050,18,143,"Indiana","Scott County",5,21,255,126,129
050,18,143,"Indiana","Scott County",5,22,288,139,149
050,18,143,"Indiana","Scott County",5,23,307,157,150
050,18,143,"Indiana","Scott County",5,24,303,147,156
050,18,143,"Indiana","Scott County",5,25,315,155,160
050,18,143,"Indiana","Scott County",5,26,319,177,142
050,18,143,"Indiana","Scott County",5,27,319,151,168
050,18,143,"Indiana","Scott County",5,28,303,144,159
050,18,143,"Indiana","Scott County",5,29,309,158,151
050,18,143,"Indiana","Scott County",5,30,335,175,160
050,18,143,"Indiana","Scott County",5,31,319,160,159
050,18,143,"Indiana","Scott County",5,32,341,157,184
050,18,143,"Indiana","Scott County",5,33,346,174,172
050,18,143,"Indiana","Scott County",5,34,311,149,162
050,18,143,"Indiana","Scott County",5,35,267,133,134
050,18,143,"Indiana","Scott County",5,36,273,141,132
050,18,143,"Indiana","Scott County",5,37,298,137,161
050,18,143,"Indiana","Scott County",5,38,313,154,159
050,18,143,"Indiana","Scott County",5,39,297,146,151
050,18,143,"Indiana","Scott County",5,40,266,138,128
050,18,143,"Indiana","Scott County",5,41,317,153,164
050,18,143,"Indiana","Scott County",5,42,323,162,161
050,18,143,"Indiana","Scott County",5,43,285,138,147
050,18,143,"Indiana","Scott County",5,44,299,133,166
050,18,143,"Indiana","Scott County",5,45,332,153,179
050,18,143,"Indiana","Scott County",5,46,331,161,170
050,18,143,"Indiana","Scott County",5,47,305,143,162
050,18,143,"Indiana","Scott County",5,48,317,149,168
050,18,143,"Indiana","Scott County",5,49,336,170,166
050,18,143,"Indiana","Scott County",5,50,332,160,172
050,18,143,"Indiana","Scott County",5,51,351,179,172
050,18,143,"Indiana","Scott County",5,52,371,196,175
050,18,143,"Indiana","Scott County",5,53,353,193,160
050,18,143,"Indiana","Scott County",5,54,348,182,166
050,18,143,"Indiana","Scott County",5,55,324,162,162
050,18,143,"Indiana","Scott County",5,56,340,175,165
050,18,143,"Indiana","Scott County",5,57,339,175,164
050,18,143,"Indiana","Scott County",5,58,329,164,165
050,18,143,"Indiana","Scott County",5,59,329,172,157
050,18,143,"Indiana","Scott County",5,60,384,187,197
050,18,143,"Indiana","Scott County",5,61,364,170,194
050,18,143,"Indiana","Scott County",5,62,371,180,191
050,18,143,"Indiana","Scott County",5,63,342,164,178
050,18,143,"Indiana","Scott County",5,64,322,165,157
050,18,143,"Indiana","Scott County",5,65,303,146,157
050,18,143,"Indiana","Scott County",5,66,294,138,156
050,18,143,"Indiana","Scott County",5,67,277,136,141
050,18,143,"Indiana","Scott County",5,68,285,141,144
050,18,143,"Indiana","Scott County",5,69,299,139,160
050,18,143,"Indiana","Scott County",5,70,256,119,137
050,18,143,"Indiana","Scott County",5,71,227,115,112
050,18,143,"Indiana","Scott County",5,72,207,96,111
050,18,143,"Indiana","Scott County",5,73,206,94,112
050,18,143,"Indiana","Scott County",5,74,210,100,110
050,18,143,"Indiana","Scott County",5,75,189,78,111
050,18,143,"Indiana","Scott County",5,76,234,103,131
050,18,143,"Indiana","Scott County",5,77,157,76,81
050,18,143,"Indiana","Scott County",5,78,128,63,65
050,18,143,"Indiana","Scott County",5,79,124,53,71
050,18,143,"Indiana","Scott County",5,80,125,52,73
050,18,143,"Indiana","Scott County",5,81,103,51,52
050,18,143,"Indiana","Scott County",5,82,99,36,63
050,18,143,"Indiana","Scott County",5,83,100,43,57
050,18,143,"Indiana","Scott County",5,84,71,26,45
050,18,143,"Indiana","Scott County",5,85,349,110,239
050,18,145,"Indiana","Shelby County",1,0,487,250,237
050,18,145,"Indiana","Shelby County",1,1,493,245,248
050,18,145,"Indiana","Shelby County",1,2,508,267,241
050,18,145,"Indiana","Shelby County",1,3,541,286,255
050,18,145,"Indiana","Shelby County",1,4,550,282,268
050,18,145,"Indiana","Shelby County",1,5,548,280,268
050,18,145,"Indiana","Shelby County",1,6,544,290,254
050,18,145,"Indiana","Shelby County",1,7,539,291,248
050,18,145,"Indiana","Shelby County",1,8,559,298,261
050,18,145,"Indiana","Shelby County",1,9,556,265,291
050,18,145,"Indiana","Shelby County",1,10,578,283,295
050,18,145,"Indiana","Shelby County",1,11,595,307,288
050,18,145,"Indiana","Shelby County",1,12,629,318,311
050,18,145,"Indiana","Shelby County",1,13,624,327,297
050,18,145,"Indiana","Shelby County",1,14,633,323,310
050,18,145,"Indiana","Shelby County",1,15,652,331,321
050,18,145,"Indiana","Shelby County",1,16,624,320,304
050,18,145,"Indiana","Shelby County",1,17,629,320,309
050,18,145,"Indiana","Shelby County",1,18,532,303,229
050,18,145,"Indiana","Shelby County",1,19,424,219,205
050,18,145,"Indiana","Shelby County",1,20,465,237,228
050,18,145,"Indiana","Shelby County",1,21,451,238,213
050,18,145,"Indiana","Shelby County",1,22,490,250,240
050,18,145,"Indiana","Shelby County",1,23,520,251,269
050,18,145,"Indiana","Shelby County",1,24,518,259,259
050,18,145,"Indiana","Shelby County",1,25,534,280,254
050,18,145,"Indiana","Shelby County",1,26,536,281,255
050,18,145,"Indiana","Shelby County",1,27,550,267,283
050,18,145,"Indiana","Shelby County",1,28,533,266,267
050,18,145,"Indiana","Shelby County",1,29,557,285,272
050,18,145,"Indiana","Shelby County",1,30,564,286,278
050,18,145,"Indiana","Shelby County",1,31,538,278,260
050,18,145,"Indiana","Shelby County",1,32,525,282,243
050,18,145,"Indiana","Shelby County",1,33,529,260,269
050,18,145,"Indiana","Shelby County",1,34,529,272,257
050,18,145,"Indiana","Shelby County",1,35,527,260,267
050,18,145,"Indiana","Shelby County",1,36,529,257,272
050,18,145,"Indiana","Shelby County",1,37,529,247,282
050,18,145,"Indiana","Shelby County",1,38,554,297,257
050,18,145,"Indiana","Shelby County",1,39,553,287,266
050,18,145,"Indiana","Shelby County",1,40,538,270,268
050,18,145,"Indiana","Shelby County",1,41,527,272,255
050,18,145,"Indiana","Shelby County",1,42,539,280,259
050,18,145,"Indiana","Shelby County",1,43,552,280,272
050,18,145,"Indiana","Shelby County",1,44,530,279,251
050,18,145,"Indiana","Shelby County",1,45,568,298,270
050,18,145,"Indiana","Shelby County",1,46,581,303,278
050,18,145,"Indiana","Shelby County",1,47,569,295,274
050,18,145,"Indiana","Shelby County",1,48,606,317,289
050,18,145,"Indiana","Shelby County",1,49,629,324,305
050,18,145,"Indiana","Shelby County",1,50,584,276,308
050,18,145,"Indiana","Shelby County",1,51,585,283,302
050,18,145,"Indiana","Shelby County",1,52,588,290,298
050,18,145,"Indiana","Shelby County",1,53,600,307,293
050,18,145,"Indiana","Shelby County",1,54,651,326,325
050,18,145,"Indiana","Shelby County",1,55,697,343,354
050,18,145,"Indiana","Shelby County",1,56,670,320,350
050,18,145,"Indiana","Shelby County",1,57,691,332,359
050,18,145,"Indiana","Shelby County",1,58,703,363,340
050,18,145,"Indiana","Shelby County",1,59,685,358,327
050,18,145,"Indiana","Shelby County",1,60,663,335,328
050,18,145,"Indiana","Shelby County",1,61,652,327,325
050,18,145,"Indiana","Shelby County",1,62,714,361,353
050,18,145,"Indiana","Shelby County",1,63,639,317,322
050,18,145,"Indiana","Shelby County",1,64,608,301,307
050,18,145,"Indiana","Shelby County",1,65,586,295,291
050,18,145,"Indiana","Shelby County",1,66,542,273,269
050,18,145,"Indiana","Shelby County",1,67,520,250,270
050,18,145,"Indiana","Shelby County",1,68,520,257,263
050,18,145,"Indiana","Shelby County",1,69,487,256,231
050,18,145,"Indiana","Shelby County",1,70,466,227,239
050,18,145,"Indiana","Shelby County",1,71,434,204,230
050,18,145,"Indiana","Shelby County",1,72,422,203,219
050,18,145,"Indiana","Shelby County",1,73,444,211,233
050,18,145,"Indiana","Shelby County",1,74,286,132,154
050,18,145,"Indiana","Shelby County",1,75,275,123,152
050,18,145,"Indiana","Shelby County",1,76,298,134,164
050,18,145,"Indiana","Shelby County",1,77,295,124,171
050,18,145,"Indiana","Shelby County",1,78,240,110,130
050,18,145,"Indiana","Shelby County",1,79,247,107,140
050,18,145,"Indiana","Shelby County",1,80,238,105,133
050,18,145,"Indiana","Shelby County",1,81,221,103,118
050,18,145,"Indiana","Shelby County",1,82,187,74,113
050,18,145,"Indiana","Shelby County",1,83,147,59,88
050,18,145,"Indiana","Shelby County",1,84,143,55,88
050,18,145,"Indiana","Shelby County",1,85,906,285,621
050,18,145,"Indiana","Shelby County",2,0,496,259,237
050,18,145,"Indiana","Shelby County",2,1,494,247,247
050,18,145,"Indiana","Shelby County",2,2,506,263,243
050,18,145,"Indiana","Shelby County",2,3,531,280,251
050,18,145,"Indiana","Shelby County",2,4,546,282,264
050,18,145,"Indiana","Shelby County",2,5,547,280,267
050,18,145,"Indiana","Shelby County",2,6,548,291,257
050,18,145,"Indiana","Shelby County",2,7,542,294,248
050,18,145,"Indiana","Shelby County",2,8,552,292,260
050,18,145,"Indiana","Shelby County",2,9,557,273,284
050,18,145,"Indiana","Shelby County",2,10,576,281,295
050,18,145,"Indiana","Shelby County",2,11,593,301,292
050,18,145,"Indiana","Shelby County",2,12,629,318,311
050,18,145,"Indiana","Shelby County",2,13,626,323,303
050,18,145,"Indiana","Shelby County",2,14,634,325,309
050,18,145,"Indiana","Shelby County",2,15,647,329,318
050,18,145,"Indiana","Shelby County",2,16,632,323,309
050,18,145,"Indiana","Shelby County",2,17,629,324,305
050,18,145,"Indiana","Shelby County",2,18,528,294,234
050,18,145,"Indiana","Shelby County",2,19,428,226,202
050,18,145,"Indiana","Shelby County",2,20,474,241,233
050,18,145,"Indiana","Shelby County",2,21,459,241,218
050,18,145,"Indiana","Shelby County",2,22,491,249,242
050,18,145,"Indiana","Shelby County",2,23,515,254,261
050,18,145,"Indiana","Shelby County",2,24,516,258,258
050,18,145,"Indiana","Shelby County",2,25,532,278,254
050,18,145,"Indiana","Shelby County",2,26,536,280,256
050,18,145,"Indiana","Shelby County",2,27,540,266,274
050,18,145,"Indiana","Shelby County",2,28,538,269,269
050,18,145,"Indiana","Shelby County",2,29,551,279,272
050,18,145,"Indiana","Shelby County",2,30,567,289,278
050,18,145,"Indiana","Shelby County",2,31,543,282,261
050,18,145,"Indiana","Shelby County",2,32,531,280,251
050,18,145,"Indiana","Shelby County",2,33,523,262,261
050,18,145,"Indiana","Shelby County",2,34,527,268,259
050,18,145,"Indiana","Shelby County",2,35,536,266,270
050,18,145,"Indiana","Shelby County",2,36,524,256,268
050,18,145,"Indiana","Shelby County",2,37,534,251,283
050,18,145,"Indiana","Shelby County",2,38,555,289,266
050,18,145,"Indiana","Shelby County",2,39,553,289,264
050,18,145,"Indiana","Shelby County",2,40,545,276,269
050,18,145,"Indiana","Shelby County",2,41,532,273,259
050,18,145,"Indiana","Shelby County",2,42,538,279,259
050,18,145,"Indiana","Shelby County",2,43,550,281,269
050,18,145,"Indiana","Shelby County",2,44,532,278,254
050,18,145,"Indiana","Shelby County",2,45,565,294,271
050,18,145,"Indiana","Shelby County",2,46,576,301,275
050,18,145,"Indiana","Shelby County",2,47,571,296,275
050,18,145,"Indiana","Shelby County",2,48,600,313,287
050,18,145,"Indiana","Shelby County",2,49,627,322,305
050,18,145,"Indiana","Shelby County",2,50,592,289,303
050,18,145,"Indiana","Shelby County",2,51,586,284,302
050,18,145,"Indiana","Shelby County",2,52,580,285,295
050,18,145,"Indiana","Shelby County",2,53,593,300,293
050,18,145,"Indiana","Shelby County",2,54,635,321,314
050,18,145,"Indiana","Shelby County",2,55,683,339,344
050,18,145,"Indiana","Shelby County",2,56,675,326,349
050,18,145,"Indiana","Shelby County",2,57,687,331,356
050,18,145,"Indiana","Shelby County",2,58,699,354,345
050,18,145,"Indiana","Shelby County",2,59,689,359,330
050,18,145,"Indiana","Shelby County",2,60,658,335,323
050,18,145,"Indiana","Shelby County",2,61,646,326,320
050,18,145,"Indiana","Shelby County",2,62,696,352,344
050,18,145,"Indiana","Shelby County",2,63,658,328,330
050,18,145,"Indiana","Shelby County",2,64,610,303,307
050,18,145,"Indiana","Shelby County",2,65,588,293,295
050,18,145,"Indiana","Shelby County",2,66,551,277,274
050,18,145,"Indiana","Shelby County",2,67,525,255,270
050,18,145,"Indiana","Shelby County",2,68,519,257,262
050,18,145,"Indiana","Shelby County",2,69,495,255,240
050,18,145,"Indiana","Shelby County",2,70,468,233,235
050,18,145,"Indiana","Shelby County",2,71,435,206,229
050,18,145,"Indiana","Shelby County",2,72,411,195,216
050,18,145,"Indiana","Shelby County",2,73,455,213,242
050,18,145,"Indiana","Shelby County",2,74,302,141,161
050,18,145,"Indiana","Shelby County",2,75,279,125,154
050,18,145,"Indiana","Shelby County",2,76,285,128,157
050,18,145,"Indiana","Shelby County",2,77,307,130,177
050,18,145,"Indiana","Shelby County",2,78,245,110,135
050,18,145,"Indiana","Shelby County",2,79,242,106,136
050,18,145,"Indiana","Shelby County",2,80,240,106,134
050,18,145,"Indiana","Shelby County",2,81,218,100,118
050,18,145,"Indiana","Shelby County",2,82,188,79,109
050,18,145,"Indiana","Shelby County",2,83,152,60,92
050,18,145,"Indiana","Shelby County",2,84,139,55,84
050,18,145,"Indiana","Shelby County",2,85,907,287,620
050,18,145,"Indiana","Shelby County",3,0,456,230,226
050,18,145,"Indiana","Shelby County",3,1,509,272,237
050,18,145,"Indiana","Shelby County",3,2,520,261,259
050,18,145,"Indiana","Shelby County",3,3,507,262,245
050,18,145,"Indiana","Shelby County",3,4,529,276,253
050,18,145,"Indiana","Shelby County",3,5,562,290,272
050,18,145,"Indiana","Shelby County",3,6,552,279,273
050,18,145,"Indiana","Shelby County",3,7,566,299,267
050,18,145,"Indiana","Shelby County",3,8,553,302,251
050,18,145,"Indiana","Shelby County",3,9,554,291,263
050,18,145,"Indiana","Shelby County",3,10,572,289,283
050,18,145,"Indiana","Shelby County",3,11,596,285,311
050,18,145,"Indiana","Shelby County",3,12,583,302,281
050,18,145,"Indiana","Shelby County",3,13,617,308,309
050,18,145,"Indiana","Shelby County",3,14,619,322,297
050,18,145,"Indiana","Shelby County",3,15,626,327,299
050,18,145,"Indiana","Shelby County",3,16,629,328,301
050,18,145,"Indiana","Shelby County",3,17,627,328,299
050,18,145,"Indiana","Shelby County",3,18,552,300,252
050,18,145,"Indiana","Shelby County",3,19,411,227,184
050,18,145,"Indiana","Shelby County",3,20,495,259,236
050,18,145,"Indiana","Shelby County",3,21,510,254,256
050,18,145,"Indiana","Shelby County",3,22,500,250,250
050,18,145,"Indiana","Shelby County",3,23,511,253,258
050,18,145,"Indiana","Shelby County",3,24,514,265,249
050,18,145,"Indiana","Shelby County",3,25,513,256,257
050,18,145,"Indiana","Shelby County",3,26,523,273,250
050,18,145,"Indiana","Shelby County",3,27,544,279,265
050,18,145,"Indiana","Shelby County",3,28,560,278,282
050,18,145,"Indiana","Shelby County",3,29,524,268,256
050,18,145,"Indiana","Shelby County",3,30,553,286,267
050,18,145,"Indiana","Shelby County",3,31,568,292,276
050,18,145,"Indiana","Shelby County",3,32,561,284,277
050,18,145,"Indiana","Shelby County",3,33,562,299,263
050,18,145,"Indiana","Shelby County",3,34,531,264,267
050,18,145,"Indiana","Shelby County",3,35,523,259,264
050,18,145,"Indiana","Shelby County",3,36,538,270,268
050,18,145,"Indiana","Shelby County",3,37,511,255,256
050,18,145,"Indiana","Shelby County",3,38,527,242,285
050,18,145,"Indiana","Shelby County",3,39,570,291,279
050,18,145,"Indiana","Shelby County",3,40,537,286,251
050,18,145,"Indiana","Shelby County",3,41,550,281,269
050,18,145,"Indiana","Shelby County",3,42,521,270,251
050,18,145,"Indiana","Shelby County",3,43,540,283,257
050,18,145,"Indiana","Shelby County",3,44,545,285,260
050,18,145,"Indiana","Shelby County",3,45,538,280,258
050,18,145,"Indiana","Shelby County",3,46,543,280,263
050,18,145,"Indiana","Shelby County",3,47,568,301,267
050,18,145,"Indiana","Shelby County",3,48,572,296,276
050,18,145,"Indiana","Shelby County",3,49,615,320,295
050,18,145,"Indiana","Shelby County",3,50,617,326,291
050,18,145,"Indiana","Shelby County",3,51,597,288,309
050,18,145,"Indiana","Shelby County",3,52,578,273,305
050,18,145,"Indiana","Shelby County",3,53,564,273,291
050,18,145,"Indiana","Shelby County",3,54,594,298,296
050,18,145,"Indiana","Shelby County",3,55,644,326,318
050,18,145,"Indiana","Shelby County",3,56,675,329,346
050,18,145,"Indiana","Shelby County",3,57,682,329,353
050,18,145,"Indiana","Shelby County",3,58,675,328,347
050,18,145,"Indiana","Shelby County",3,59,678,348,330
050,18,145,"Indiana","Shelby County",3,60,682,355,327
050,18,145,"Indiana","Shelby County",3,61,639,325,314
050,18,145,"Indiana","Shelby County",3,62,646,324,322
050,18,145,"Indiana","Shelby County",3,63,690,350,340
050,18,145,"Indiana","Shelby County",3,64,653,320,333
050,18,145,"Indiana","Shelby County",3,65,609,301,308
050,18,145,"Indiana","Shelby County",3,66,587,293,294
050,18,145,"Indiana","Shelby County",3,67,546,277,269
050,18,145,"Indiana","Shelby County",3,68,524,256,268
050,18,145,"Indiana","Shelby County",3,69,503,247,256
050,18,145,"Indiana","Shelby County",3,70,489,251,238
050,18,145,"Indiana","Shelby County",3,71,451,224,227
050,18,145,"Indiana","Shelby County",3,72,428,200,228
050,18,145,"Indiana","Shelby County",3,73,400,190,210
050,18,145,"Indiana","Shelby County",3,74,435,206,229
050,18,145,"Indiana","Shelby County",3,75,295,135,160
050,18,145,"Indiana","Shelby County",3,76,264,114,150
050,18,145,"Indiana","Shelby County",3,77,285,123,162
050,18,145,"Indiana","Shelby County",3,78,294,123,171
050,18,145,"Indiana","Shelby County",3,79,233,100,133
050,18,145,"Indiana","Shelby County",3,80,233,102,131
050,18,145,"Indiana","Shelby County",3,81,215,97,118
050,18,145,"Indiana","Shelby County",3,82,202,90,112
050,18,145,"Indiana","Shelby County",3,83,163,72,91
050,18,145,"Indiana","Shelby County",3,84,142,52,90
050,18,145,"Indiana","Shelby County",3,85,882,286,596
050,18,145,"Indiana","Shelby County",4,0,480,233,247
050,18,145,"Indiana","Shelby County",4,1,468,233,235
050,18,145,"Indiana","Shelby County",4,2,509,272,237
050,18,145,"Indiana","Shelby County",4,3,537,264,273
050,18,145,"Indiana","Shelby County",4,4,517,268,249
050,18,145,"Indiana","Shelby County",4,5,551,299,252
050,18,145,"Indiana","Shelby County",4,6,589,310,279
050,18,145,"Indiana","Shelby County",4,7,562,291,271
050,18,145,"Indiana","Shelby County",4,8,558,288,270
050,18,145,"Indiana","Shelby County",4,9,565,300,265
050,18,145,"Indiana","Shelby County",4,10,564,300,264
050,18,145,"Indiana","Shelby County",4,11,570,284,286
050,18,145,"Indiana","Shelby County",4,12,608,288,320
050,18,145,"Indiana","Shelby County",4,13,582,314,268
050,18,145,"Indiana","Shelby County",4,14,637,318,319
050,18,145,"Indiana","Shelby County",4,15,621,323,298
050,18,145,"Indiana","Shelby County",4,16,609,320,289
050,18,145,"Indiana","Shelby County",4,17,627,328,299
050,18,145,"Indiana","Shelby County",4,18,532,291,241
050,18,145,"Indiana","Shelby County",4,19,428,232,196
050,18,145,"Indiana","Shelby County",4,20,452,249,203
050,18,145,"Indiana","Shelby County",4,21,490,263,227
050,18,145,"Indiana","Shelby County",4,22,542,266,276
050,18,145,"Indiana","Shelby County",4,23,489,251,238
050,18,145,"Indiana","Shelby County",4,24,497,258,239
050,18,145,"Indiana","Shelby County",4,25,496,269,227
050,18,145,"Indiana","Shelby County",4,26,538,274,264
050,18,145,"Indiana","Shelby County",4,27,506,259,247
050,18,145,"Indiana","Shelby County",4,28,563,278,285
050,18,145,"Indiana","Shelby County",4,29,558,272,286
050,18,145,"Indiana","Shelby County",4,30,542,287,255
050,18,145,"Indiana","Shelby County",4,31,571,299,272
050,18,145,"Indiana","Shelby County",4,32,579,295,284
050,18,145,"Indiana","Shelby County",4,33,568,292,276
050,18,145,"Indiana","Shelby County",4,34,558,294,264
050,18,145,"Indiana","Shelby County",4,35,521,249,272
050,18,145,"Indiana","Shelby County",4,36,540,276,264
050,18,145,"Indiana","Shelby County",4,37,531,262,269
050,18,145,"Indiana","Shelby County",4,38,532,269,263
050,18,145,"Indiana","Shelby County",4,39,532,246,286
050,18,145,"Indiana","Shelby County",4,40,568,288,280
050,18,145,"Indiana","Shelby County",4,41,543,293,250
050,18,145,"Indiana","Shelby County",4,42,581,300,281
050,18,145,"Indiana","Shelby County",4,43,519,269,250
050,18,145,"Indiana","Shelby County",4,44,531,279,252
050,18,145,"Indiana","Shelby County",4,45,547,283,264
050,18,145,"Indiana","Shelby County",4,46,552,289,263
050,18,145,"Indiana","Shelby County",4,47,550,283,267
050,18,145,"Indiana","Shelby County",4,48,575,306,269
050,18,145,"Indiana","Shelby County",4,49,570,290,280
050,18,145,"Indiana","Shelby County",4,50,623,334,289
050,18,145,"Indiana","Shelby County",4,51,624,328,296
050,18,145,"Indiana","Shelby County",4,52,580,284,296
050,18,145,"Indiana","Shelby County",4,53,561,267,294
050,18,145,"Indiana","Shelby County",4,54,560,273,287
050,18,145,"Indiana","Shelby County",4,55,596,297,299
050,18,145,"Indiana","Shelby County",4,56,640,322,318
050,18,145,"Indiana","Shelby County",4,57,667,332,335
050,18,145,"Indiana","Shelby County",4,58,668,316,352
050,18,145,"Indiana","Shelby County",4,59,665,324,341
050,18,145,"Indiana","Shelby County",4,60,662,337,325
050,18,145,"Indiana","Shelby County",4,61,687,357,330
050,18,145,"Indiana","Shelby County",4,62,632,315,317
050,18,145,"Indiana","Shelby County",4,63,638,334,304
050,18,145,"Indiana","Shelby County",4,64,685,348,337
050,18,145,"Indiana","Shelby County",4,65,638,309,329
050,18,145,"Indiana","Shelby County",4,66,596,293,303
050,18,145,"Indiana","Shelby County",4,67,567,275,292
050,18,145,"Indiana","Shelby County",4,68,545,276,269
050,18,145,"Indiana","Shelby County",4,69,517,248,269
050,18,145,"Indiana","Shelby County",4,70,492,239,253
050,18,145,"Indiana","Shelby County",4,71,477,247,230
050,18,145,"Indiana","Shelby County",4,72,442,217,225
050,18,145,"Indiana","Shelby County",4,73,416,191,225
050,18,145,"Indiana","Shelby County",4,74,386,178,208
050,18,145,"Indiana","Shelby County",4,75,422,200,222
050,18,145,"Indiana","Shelby County",4,76,268,123,145
050,18,145,"Indiana","Shelby County",4,77,264,107,157
050,18,145,"Indiana","Shelby County",4,78,275,119,156
050,18,145,"Indiana","Shelby County",4,79,270,112,158
050,18,145,"Indiana","Shelby County",4,80,220,92,128
050,18,145,"Indiana","Shelby County",4,81,215,91,124
050,18,145,"Indiana","Shelby County",4,82,203,90,113
050,18,145,"Indiana","Shelby County",4,83,192,86,106
050,18,145,"Indiana","Shelby County",4,84,146,61,85
050,18,145,"Indiana","Shelby County",4,85,895,296,599
050,18,145,"Indiana","Shelby County",5,0,477,231,246
050,18,145,"Indiana","Shelby County",5,1,479,241,238
050,18,145,"Indiana","Shelby County",5,2,465,227,238
050,18,145,"Indiana","Shelby County",5,3,538,291,247
050,18,145,"Indiana","Shelby County",5,4,545,268,277
050,18,145,"Indiana","Shelby County",5,5,523,270,253
050,18,145,"Indiana","Shelby County",5,6,549,301,248
050,18,145,"Indiana","Shelby County",5,7,574,306,268
050,18,145,"Indiana","Shelby County",5,8,561,290,271
050,18,145,"Indiana","Shelby County",5,9,559,282,277
050,18,145,"Indiana","Shelby County",5,10,565,304,261
050,18,145,"Indiana","Shelby County",5,11,585,307,278
050,18,145,"Indiana","Shelby County",5,12,563,280,283
050,18,145,"Indiana","Shelby County",5,13,617,298,319
050,18,145,"Indiana","Shelby County",5,14,555,290,265
050,18,145,"Indiana","Shelby County",5,15,623,307,316
050,18,145,"Indiana","Shelby County",5,16,627,329,298
050,18,145,"Indiana","Shelby County",5,17,620,326,294
050,18,145,"Indiana","Shelby County",5,18,531,295,236
050,18,145,"Indiana","Shelby County",5,19,410,223,187
050,18,145,"Indiana","Shelby County",5,20,470,255,215
050,18,145,"Indiana","Shelby County",5,21,448,238,210
050,18,145,"Indiana","Shelby County",5,22,545,284,261
050,18,145,"Indiana","Shelby County",5,23,569,278,291
050,18,145,"Indiana","Shelby County",5,24,494,254,240
050,18,145,"Indiana","Shelby County",5,25,545,282,263
050,18,145,"Indiana","Shelby County",5,26,505,270,235
050,18,145,"Indiana","Shelby County",5,27,548,277,271
050,18,145,"Indiana","Shelby County",5,28,532,276,256
050,18,145,"Indiana","Shelby County",5,29,561,278,283
050,18,145,"Indiana","Shelby County",5,30,575,283,292
050,18,145,"Indiana","Shelby County",5,31,520,273,247
050,18,145,"Indiana","Shelby County",5,32,558,286,272
050,18,145,"Indiana","Shelby County",5,33,561,287,274
050,18,145,"Indiana","Shelby County",5,34,564,279,285
050,18,145,"Indiana","Shelby County",5,35,555,296,259
050,18,145,"Indiana","Shelby County",5,36,528,251,277
050,18,145,"Indiana","Shelby County",5,37,556,278,278
050,18,145,"Indiana","Shelby County",5,38,526,261,265
050,18,145,"Indiana","Shelby County",5,39,539,274,265
050,18,145,"Indiana","Shelby County",5,40,534,240,294
050,18,145,"Indiana","Shelby County",5,41,561,294,267
050,18,145,"Indiana","Shelby County",5,42,551,294,257
050,18,145,"Indiana","Shelby County",5,43,566,294,272
050,18,145,"Indiana","Shelby County",5,44,522,266,256
050,18,145,"Indiana","Shelby County",5,45,541,281,260
050,18,145,"Indiana","Shelby County",5,46,535,272,263
050,18,145,"Indiana","Shelby County",5,47,544,286,258
050,18,145,"Indiana","Shelby County",5,48,568,297,271
050,18,145,"Indiana","Shelby County",5,49,577,306,271
050,18,145,"Indiana","Shelby County",5,50,560,293,267
050,18,145,"Indiana","Shelby County",5,51,632,338,294
050,18,145,"Indiana","Shelby County",5,52,623,322,301
050,18,145,"Indiana","Shelby County",5,53,576,279,297
050,18,145,"Indiana","Shelby County",5,54,558,263,295
050,18,145,"Indiana","Shelby County",5,55,578,290,288
050,18,145,"Indiana","Shelby County",5,56,592,293,299
050,18,145,"Indiana","Shelby County",5,57,645,330,315
050,18,145,"Indiana","Shelby County",5,58,668,330,338
050,18,145,"Indiana","Shelby County",5,59,654,308,346
050,18,145,"Indiana","Shelby County",5,60,650,312,338
050,18,145,"Indiana","Shelby County",5,61,649,326,323
050,18,145,"Indiana","Shelby County",5,62,669,345,324
050,18,145,"Indiana","Shelby County",5,63,614,309,305
050,18,145,"Indiana","Shelby County",5,64,625,328,297
050,18,145,"Indiana","Shelby County",5,65,678,340,338
050,18,145,"Indiana","Shelby County",5,66,624,302,322
050,18,145,"Indiana","Shelby County",5,67,596,286,310
050,18,145,"Indiana","Shelby County",5,68,552,266,286
050,18,145,"Indiana","Shelby County",5,69,533,265,268
050,18,145,"Indiana","Shelby County",5,70,506,238,268
050,18,145,"Indiana","Shelby County",5,71,479,236,243
050,18,145,"Indiana","Shelby County",5,72,473,249,224
050,18,145,"Indiana","Shelby County",5,73,433,207,226
050,18,145,"Indiana","Shelby County",5,74,401,180,221
050,18,145,"Indiana","Shelby County",5,75,376,172,204
050,18,145,"Indiana","Shelby County",5,76,399,187,212
050,18,145,"Indiana","Shelby County",5,77,266,120,146
050,18,145,"Indiana","Shelby County",5,78,251,101,150
050,18,145,"Indiana","Shelby County",5,79,262,114,148
050,18,145,"Indiana","Shelby County",5,80,263,111,152
050,18,145,"Indiana","Shelby County",5,81,202,85,117
050,18,145,"Indiana","Shelby County",5,82,199,81,118
050,18,145,"Indiana","Shelby County",5,83,190,85,105
050,18,145,"Indiana","Shelby County",5,84,170,73,97
050,18,145,"Indiana","Shelby County",5,85,921,316,605
050,18,147,"Indiana","Spencer County",1,0,177,90,87
050,18,147,"Indiana","Spencer County",1,1,186,95,91
050,18,147,"Indiana","Spencer County",1,2,194,103,91
050,18,147,"Indiana","Spencer County",1,3,208,100,108
050,18,147,"Indiana","Spencer County",1,4,226,100,126
050,18,147,"Indiana","Spencer County",1,5,237,121,116
050,18,147,"Indiana","Spencer County",1,6,240,124,116
050,18,147,"Indiana","Spencer County",1,7,225,114,111
050,18,147,"Indiana","Spencer County",1,8,235,110,125
050,18,147,"Indiana","Spencer County",1,9,247,127,120
050,18,147,"Indiana","Spencer County",1,10,247,133,114
050,18,147,"Indiana","Spencer County",1,11,261,133,128
050,18,147,"Indiana","Spencer County",1,12,291,154,137
050,18,147,"Indiana","Spencer County",1,13,273,132,141
050,18,147,"Indiana","Spencer County",1,14,261,133,128
050,18,147,"Indiana","Spencer County",1,15,269,149,120
050,18,147,"Indiana","Spencer County",1,16,286,149,137
050,18,147,"Indiana","Spencer County",1,17,257,135,122
050,18,147,"Indiana","Spencer County",1,18,242,129,113
050,18,147,"Indiana","Spencer County",1,19,183,93,90
050,18,147,"Indiana","Spencer County",1,20,196,96,100
050,18,147,"Indiana","Spencer County",1,21,200,105,95
050,18,147,"Indiana","Spencer County",1,22,214,116,98
050,18,147,"Indiana","Spencer County",1,23,214,103,111
050,18,147,"Indiana","Spencer County",1,24,209,103,106
050,18,147,"Indiana","Spencer County",1,25,207,101,106
050,18,147,"Indiana","Spencer County",1,26,217,116,101
050,18,147,"Indiana","Spencer County",1,27,214,109,105
050,18,147,"Indiana","Spencer County",1,28,197,102,95
050,18,147,"Indiana","Spencer County",1,29,211,116,95
050,18,147,"Indiana","Spencer County",1,30,210,110,100
050,18,147,"Indiana","Spencer County",1,31,205,108,97
050,18,147,"Indiana","Spencer County",1,32,217,101,116
050,18,147,"Indiana","Spencer County",1,33,205,105,100
050,18,147,"Indiana","Spencer County",1,34,204,107,97
050,18,147,"Indiana","Spencer County",1,35,226,119,107
050,18,147,"Indiana","Spencer County",1,36,235,128,107
050,18,147,"Indiana","Spencer County",1,37,225,118,107
050,18,147,"Indiana","Spencer County",1,38,216,113,103
050,18,147,"Indiana","Spencer County",1,39,228,121,107
050,18,147,"Indiana","Spencer County",1,40,237,124,113
050,18,147,"Indiana","Spencer County",1,41,240,122,118
050,18,147,"Indiana","Spencer County",1,42,242,124,118
050,18,147,"Indiana","Spencer County",1,43,242,126,116
050,18,147,"Indiana","Spencer County",1,44,237,118,119
050,18,147,"Indiana","Spencer County",1,45,231,112,119
050,18,147,"Indiana","Spencer County",1,46,222,113,109
050,18,147,"Indiana","Spencer County",1,47,231,112,119
050,18,147,"Indiana","Spencer County",1,48,255,123,132
050,18,147,"Indiana","Spencer County",1,49,278,144,134
050,18,147,"Indiana","Spencer County",1,50,265,138,127
050,18,147,"Indiana","Spencer County",1,51,244,139,105
050,18,147,"Indiana","Spencer County",1,52,253,141,112
050,18,147,"Indiana","Spencer County",1,53,277,151,126
050,18,147,"Indiana","Spencer County",1,54,294,147,147
050,18,147,"Indiana","Spencer County",1,55,312,147,165
050,18,147,"Indiana","Spencer County",1,56,327,170,157
050,18,147,"Indiana","Spencer County",1,57,316,158,158
050,18,147,"Indiana","Spencer County",1,58,342,170,172
050,18,147,"Indiana","Spencer County",1,59,346,176,170
050,18,147,"Indiana","Spencer County",1,60,319,176,143
050,18,147,"Indiana","Spencer County",1,61,301,156,145
050,18,147,"Indiana","Spencer County",1,62,320,162,158
050,18,147,"Indiana","Spencer County",1,63,300,152,148
050,18,147,"Indiana","Spencer County",1,64,276,133,143
050,18,147,"Indiana","Spencer County",1,65,276,131,145
050,18,147,"Indiana","Spencer County",1,66,279,153,126
050,18,147,"Indiana","Spencer County",1,67,248,130,118
050,18,147,"Indiana","Spencer County",1,68,243,123,120
050,18,147,"Indiana","Spencer County",1,69,233,115,118
050,18,147,"Indiana","Spencer County",1,70,223,113,110
050,18,147,"Indiana","Spencer County",1,71,246,127,119
050,18,147,"Indiana","Spencer County",1,72,235,110,125
050,18,147,"Indiana","Spencer County",1,73,224,118,106
050,18,147,"Indiana","Spencer County",1,74,157,81,76
050,18,147,"Indiana","Spencer County",1,75,155,78,77
050,18,147,"Indiana","Spencer County",1,76,150,68,82
050,18,147,"Indiana","Spencer County",1,77,148,74,74
050,18,147,"Indiana","Spencer County",1,78,128,63,65
050,18,147,"Indiana","Spencer County",1,79,120,60,60
050,18,147,"Indiana","Spencer County",1,80,116,55,61
050,18,147,"Indiana","Spencer County",1,81,104,44,60
050,18,147,"Indiana","Spencer County",1,82,97,53,44
050,18,147,"Indiana","Spencer County",1,83,73,33,40
050,18,147,"Indiana","Spencer County",1,84,58,27,31
050,18,147,"Indiana","Spencer County",1,85,397,155,242
050,18,147,"Indiana","Spencer County",2,0,195,100,95
050,18,147,"Indiana","Spencer County",2,1,184,94,90
050,18,147,"Indiana","Spencer County",2,2,195,102,93
050,18,147,"Indiana","Spencer County",2,3,203,98,105
050,18,147,"Indiana","Spencer County",2,4,224,102,122
050,18,147,"Indiana","Spencer County",2,5,235,117,118
050,18,147,"Indiana","Spencer County",2,6,241,124,117
050,18,147,"Indiana","Spencer County",2,7,229,116,113
050,18,147,"Indiana","Spencer County",2,8,234,111,123
050,18,147,"Indiana","Spencer County",2,9,245,124,121
050,18,147,"Indiana","Spencer County",2,10,249,132,117
050,18,147,"Indiana","Spencer County",2,11,257,133,124
050,18,147,"Indiana","Spencer County",2,12,286,149,137
050,18,147,"Indiana","Spencer County",2,13,276,136,140
050,18,147,"Indiana","Spencer County",2,14,266,135,131
050,18,147,"Indiana","Spencer County",2,15,270,147,123
050,18,147,"Indiana","Spencer County",2,16,279,148,131
050,18,147,"Indiana","Spencer County",2,17,264,138,126
050,18,147,"Indiana","Spencer County",2,18,230,124,106
050,18,147,"Indiana","Spencer County",2,19,186,95,91
050,18,147,"Indiana","Spencer County",2,20,198,96,102
050,18,147,"Indiana","Spencer County",2,21,203,105,98
050,18,147,"Indiana","Spencer County",2,22,211,112,99
050,18,147,"Indiana","Spencer County",2,23,212,105,107
050,18,147,"Indiana","Spencer County",2,24,210,102,108
050,18,147,"Indiana","Spencer County",2,25,207,102,105
050,18,147,"Indiana","Spencer County",2,26,214,113,101
050,18,147,"Indiana","Spencer County",2,27,215,111,104
050,18,147,"Indiana","Spencer County",2,28,202,104,98
050,18,147,"Indiana","Spencer County",2,29,209,113,96
050,18,147,"Indiana","Spencer County",2,30,212,113,99
050,18,147,"Indiana","Spencer County",2,31,205,107,98
050,18,147,"Indiana","Spencer County",2,32,217,105,112
050,18,147,"Indiana","Spencer County",2,33,208,104,104
050,18,147,"Indiana","Spencer County",2,34,206,106,100
050,18,147,"Indiana","Spencer County",2,35,222,117,105
050,18,147,"Indiana","Spencer County",2,36,230,124,106
050,18,147,"Indiana","Spencer County",2,37,228,122,106
050,18,147,"Indiana","Spencer County",2,38,220,115,105
050,18,147,"Indiana","Spencer County",2,39,224,119,105
050,18,147,"Indiana","Spencer County",2,40,235,122,113
050,18,147,"Indiana","Spencer County",2,41,240,123,117
050,18,147,"Indiana","Spencer County",2,42,243,125,118
050,18,147,"Indiana","Spencer County",2,43,245,129,116
050,18,147,"Indiana","Spencer County",2,44,236,118,118
050,18,147,"Indiana","Spencer County",2,45,234,114,120
050,18,147,"Indiana","Spencer County",2,46,222,110,112
050,18,147,"Indiana","Spencer County",2,47,229,113,116
050,18,147,"Indiana","Spencer County",2,48,247,119,128
050,18,147,"Indiana","Spencer County",2,49,275,141,134
050,18,147,"Indiana","Spencer County",2,50,268,140,128
050,18,147,"Indiana","Spencer County",2,51,246,137,109
050,18,147,"Indiana","Spencer County",2,52,248,139,109
050,18,147,"Indiana","Spencer County",2,53,272,149,123
050,18,147,"Indiana","Spencer County",2,54,291,148,143
050,18,147,"Indiana","Spencer County",2,55,308,146,162
050,18,147,"Indiana","Spencer County",2,56,325,166,159
050,18,147,"Indiana","Spencer County",2,57,319,161,158
050,18,147,"Indiana","Spencer County",2,58,337,168,169
050,18,147,"Indiana","Spencer County",2,59,346,174,172
050,18,147,"Indiana","Spencer County",2,60,323,173,150
050,18,147,"Indiana","Spencer County",2,61,302,158,144
050,18,147,"Indiana","Spencer County",2,62,316,162,154
050,18,147,"Indiana","Spencer County",2,63,307,156,151
050,18,147,"Indiana","Spencer County",2,64,280,136,144
050,18,147,"Indiana","Spencer County",2,65,274,131,143
050,18,147,"Indiana","Spencer County",2,66,278,148,130
050,18,147,"Indiana","Spencer County",2,67,259,137,122
050,18,147,"Indiana","Spencer County",2,68,243,124,119
050,18,147,"Indiana","Spencer County",2,69,239,119,120
050,18,147,"Indiana","Spencer County",2,70,220,108,112
050,18,147,"Indiana","Spencer County",2,71,242,125,117
050,18,147,"Indiana","Spencer County",2,72,229,109,120
050,18,147,"Indiana","Spencer County",2,73,237,122,115
050,18,147,"Indiana","Spencer County",2,74,160,83,77
050,18,147,"Indiana","Spencer County",2,75,158,81,77
050,18,147,"Indiana","Spencer County",2,76,145,67,78
050,18,147,"Indiana","Spencer County",2,77,151,74,77
050,18,147,"Indiana","Spencer County",2,78,131,65,66
050,18,147,"Indiana","Spencer County",2,79,122,62,60
050,18,147,"Indiana","Spencer County",2,80,115,55,60
050,18,147,"Indiana","Spencer County",2,81,104,44,60
050,18,147,"Indiana","Spencer County",2,82,98,51,47
050,18,147,"Indiana","Spencer County",2,83,74,34,40
050,18,147,"Indiana","Spencer County",2,84,60,28,32
050,18,147,"Indiana","Spencer County",2,85,399,157,242
050,18,147,"Indiana","Spencer County",3,0,215,105,110
050,18,147,"Indiana","Spencer County",3,1,199,107,92
050,18,147,"Indiana","Spencer County",3,2,198,107,91
050,18,147,"Indiana","Spencer County",3,3,204,103,101
050,18,147,"Indiana","Spencer County",3,4,210,101,109
050,18,147,"Indiana","Spencer County",3,5,233,109,124
050,18,147,"Indiana","Spencer County",3,6,244,119,125
050,18,147,"Indiana","Spencer County",3,7,244,126,118
050,18,147,"Indiana","Spencer County",3,8,231,120,111
050,18,147,"Indiana","Spencer County",3,9,230,109,121
050,18,147,"Indiana","Spencer County",3,10,252,130,122
050,18,147,"Indiana","Spencer County",3,11,247,131,116
050,18,147,"Indiana","Spencer County",3,12,257,132,125
050,18,147,"Indiana","Spencer County",3,13,285,142,143
050,18,147,"Indiana","Spencer County",3,14,270,138,132
050,18,147,"Indiana","Spencer County",3,15,270,140,130
050,18,147,"Indiana","Spencer County",3,16,267,140,127
050,18,147,"Indiana","Spencer County",3,17,272,150,122
050,18,147,"Indiana","Spencer County",3,18,221,120,101
050,18,147,"Indiana","Spencer County",3,19,186,99,87
050,18,147,"Indiana","Spencer County",3,20,187,90,97
050,18,147,"Indiana","Spencer County",3,21,212,105,107
050,18,147,"Indiana","Spencer County",3,22,208,103,105
050,18,147,"Indiana","Spencer County",3,23,216,117,99
050,18,147,"Indiana","Spencer County",3,24,228,110,118
050,18,147,"Indiana","Spencer County",3,25,197,97,100
050,18,147,"Indiana","Spencer County",3,26,189,93,96
050,18,147,"Indiana","Spencer County",3,27,211,106,105
050,18,147,"Indiana","Spencer County",3,28,236,114,122
050,18,147,"Indiana","Spencer County",3,29,220,117,103
050,18,147,"Indiana","Spencer County",3,30,211,117,94
050,18,147,"Indiana","Spencer County",3,31,212,106,106
050,18,147,"Indiana","Spencer County",3,32,206,108,98
050,18,147,"Indiana","Spencer County",3,33,223,109,114
050,18,147,"Indiana","Spencer County",3,34,216,104,112
050,18,147,"Indiana","Spencer County",3,35,215,116,99
050,18,147,"Indiana","Spencer County",3,36,211,111,100
050,18,147,"Indiana","Spencer County",3,37,227,127,100
050,18,147,"Indiana","Spencer County",3,38,236,122,114
050,18,147,"Indiana","Spencer County",3,39,224,120,104
050,18,147,"Indiana","Spencer County",3,40,218,112,106
050,18,147,"Indiana","Spencer County",3,41,243,128,115
050,18,147,"Indiana","Spencer County",3,42,239,124,115
050,18,147,"Indiana","Spencer County",3,43,251,136,115
050,18,147,"Indiana","Spencer County",3,44,246,129,117
050,18,147,"Indiana","Spencer County",3,45,237,122,115
050,18,147,"Indiana","Spencer County",3,46,230,108,122
050,18,147,"Indiana","Spencer County",3,47,232,113,119
050,18,147,"Indiana","Spencer County",3,48,226,111,115
050,18,147,"Indiana","Spencer County",3,49,254,125,129
050,18,147,"Indiana","Spencer County",3,50,269,140,129
050,18,147,"Indiana","Spencer County",3,51,260,135,125
050,18,147,"Indiana","Spencer County",3,52,240,134,106
050,18,147,"Indiana","Spencer County",3,53,250,140,110
050,18,147,"Indiana","Spencer County",3,54,273,150,123
050,18,147,"Indiana","Spencer County",3,55,280,141,139
050,18,147,"Indiana","Spencer County",3,56,316,154,162
050,18,147,"Indiana","Spencer County",3,57,317,155,162
050,18,147,"Indiana","Spencer County",3,58,321,164,157
050,18,147,"Indiana","Spencer County",3,59,336,166,170
050,18,147,"Indiana","Spencer County",3,60,338,167,171
050,18,147,"Indiana","Spencer County",3,61,316,168,148
050,18,147,"Indiana","Spencer County",3,62,300,156,144
050,18,147,"Indiana","Spencer County",3,63,320,159,161
050,18,147,"Indiana","Spencer County",3,64,303,149,154
050,18,147,"Indiana","Spencer County",3,65,275,132,143
050,18,147,"Indiana","Spencer County",3,66,274,129,145
050,18,147,"Indiana","Spencer County",3,67,273,147,126
050,18,147,"Indiana","Spencer County",3,68,262,138,124
050,18,147,"Indiana","Spencer County",3,69,240,123,117
050,18,147,"Indiana","Spencer County",3,70,227,109,118
050,18,147,"Indiana","Spencer County",3,71,223,113,110
050,18,147,"Indiana","Spencer County",3,72,223,112,111
050,18,147,"Indiana","Spencer County",3,73,220,103,117
050,18,147,"Indiana","Spencer County",3,74,234,119,115
050,18,147,"Indiana","Spencer County",3,75,161,85,76
050,18,147,"Indiana","Spencer County",3,76,135,65,70
050,18,147,"Indiana","Spencer County",3,77,147,72,75
050,18,147,"Indiana","Spencer County",3,78,138,66,72
050,18,147,"Indiana","Spencer County",3,79,135,71,64
050,18,147,"Indiana","Spencer County",3,80,111,50,61
050,18,147,"Indiana","Spencer County",3,81,101,48,53
050,18,147,"Indiana","Spencer County",3,82,101,46,55
050,18,147,"Indiana","Spencer County",3,83,87,43,44
050,18,147,"Indiana","Spencer County",3,84,62,29,33
050,18,147,"Indiana","Spencer County",3,85,377,158,219
050,18,147,"Indiana","Spencer County",4,0,192,104,88
050,18,147,"Indiana","Spencer County",4,1,227,106,121
050,18,147,"Indiana","Spencer County",4,2,202,109,93
050,18,147,"Indiana","Spencer County",4,3,197,107,90
050,18,147,"Indiana","Spencer County",4,4,209,109,100
050,18,147,"Indiana","Spencer County",4,5,217,110,107
050,18,147,"Indiana","Spencer County",4,6,230,108,122
050,18,147,"Indiana","Spencer County",4,7,253,122,131
050,18,147,"Indiana","Spencer County",4,8,244,123,121
050,18,147,"Indiana","Spencer County",4,9,236,124,112
050,18,147,"Indiana","Spencer County",4,10,230,114,116
050,18,147,"Indiana","Spencer County",4,11,255,132,123
050,18,147,"Indiana","Spencer County",4,12,244,136,108
050,18,147,"Indiana","Spencer County",4,13,257,129,128
050,18,147,"Indiana","Spencer County",4,14,296,151,145
050,18,147,"Indiana","Spencer County",4,15,271,136,135
050,18,147,"Indiana","Spencer County",4,16,265,129,136
050,18,147,"Indiana","Spencer County",4,17,282,157,125
050,18,147,"Indiana","Spencer County",4,18,232,133,99
050,18,147,"Indiana","Spencer County",4,19,170,93,77
050,18,147,"Indiana","Spencer County",4,20,197,102,95
050,18,147,"Indiana","Spencer County",4,21,202,94,108
050,18,147,"Indiana","Spencer County",4,22,218,111,107
050,18,147,"Indiana","Spencer County",4,23,194,102,92
050,18,147,"Indiana","Spencer County",4,24,213,119,94
050,18,147,"Indiana","Spencer County",4,25,222,103,119
050,18,147,"Indiana","Spencer County",4,26,212,107,105
050,18,147,"Indiana","Spencer County",4,27,180,87,93
050,18,147,"Indiana","Spencer County",4,28,216,108,108
050,18,147,"Indiana","Spencer County",4,29,238,124,114
050,18,147,"Indiana","Spencer County",4,30,234,113,121
050,18,147,"Indiana","Spencer County",4,31,221,122,99
050,18,147,"Indiana","Spencer County",4,32,212,107,105
050,18,147,"Indiana","Spencer County",4,33,212,116,96
050,18,147,"Indiana","Spencer County",4,34,223,105,118
050,18,147,"Indiana","Spencer County",4,35,221,109,112
050,18,147,"Indiana","Spencer County",4,36,213,111,102
050,18,147,"Indiana","Spencer County",4,37,211,114,97
050,18,147,"Indiana","Spencer County",4,38,238,128,110
050,18,147,"Indiana","Spencer County",4,39,252,136,116
050,18,147,"Indiana","Spencer County",4,40,230,117,113
050,18,147,"Indiana","Spencer County",4,41,223,118,105
050,18,147,"Indiana","Spencer County",4,42,246,130,116
050,18,147,"Indiana","Spencer County",4,43,253,131,122
050,18,147,"Indiana","Spencer County",4,44,244,135,109
050,18,147,"Indiana","Spencer County",4,45,250,135,115
050,18,147,"Indiana","Spencer County",4,46,234,115,119
050,18,147,"Indiana","Spencer County",4,47,233,107,126
050,18,147,"Indiana","Spencer County",4,48,231,111,120
050,18,147,"Indiana","Spencer County",4,49,238,125,113
050,18,147,"Indiana","Spencer County",4,50,254,126,128
050,18,147,"Indiana","Spencer County",4,51,271,137,134
050,18,147,"Indiana","Spencer County",4,52,253,131,122
050,18,147,"Indiana","Spencer County",4,53,243,135,108
050,18,147,"Indiana","Spencer County",4,54,258,152,106
050,18,147,"Indiana","Spencer County",4,55,267,144,123
050,18,147,"Indiana","Spencer County",4,56,274,145,129
050,18,147,"Indiana","Spencer County",4,57,316,153,163
050,18,147,"Indiana","Spencer County",4,58,321,159,162
050,18,147,"Indiana","Spencer County",4,59,310,158,152
050,18,147,"Indiana","Spencer County",4,60,335,159,176
050,18,147,"Indiana","Spencer County",4,61,329,159,170
050,18,147,"Indiana","Spencer County",4,62,314,167,147
050,18,147,"Indiana","Spencer County",4,63,290,152,138
050,18,147,"Indiana","Spencer County",4,64,316,157,159
050,18,147,"Indiana","Spencer County",4,65,296,145,151
050,18,147,"Indiana","Spencer County",4,66,272,133,139
050,18,147,"Indiana","Spencer County",4,67,278,133,145
050,18,147,"Indiana","Spencer County",4,68,266,144,122
050,18,147,"Indiana","Spencer County",4,69,254,132,122
050,18,147,"Indiana","Spencer County",4,70,232,118,114
050,18,147,"Indiana","Spencer County",4,71,232,116,116
050,18,147,"Indiana","Spencer County",4,72,214,105,109
050,18,147,"Indiana","Spencer County",4,73,215,106,109
050,18,147,"Indiana","Spencer County",4,74,209,99,110
050,18,147,"Indiana","Spencer County",4,75,230,119,111
050,18,147,"Indiana","Spencer County",4,76,140,74,66
050,18,147,"Indiana","Spencer County",4,77,130,65,65
050,18,147,"Indiana","Spencer County",4,78,133,63,70
050,18,147,"Indiana","Spencer County",4,79,140,67,73
050,18,147,"Indiana","Spencer County",4,80,123,59,64
050,18,147,"Indiana","Spencer County",4,81,103,44,59
050,18,147,"Indiana","Spencer County",4,82,91,46,45
050,18,147,"Indiana","Spencer County",4,83,90,34,56
050,18,147,"Indiana","Spencer County",4,84,66,29,37
050,18,147,"Indiana","Spencer County",4,85,364,159,205
050,18,147,"Indiana","Spencer County",5,0,184,98,86
050,18,147,"Indiana","Spencer County",5,1,201,115,86
050,18,147,"Indiana","Spencer County",5,2,230,101,129
050,18,147,"Indiana","Spencer County",5,3,209,108,101
050,18,147,"Indiana","Spencer County",5,4,196,110,86
050,18,147,"Indiana","Spencer County",5,5,212,106,106
050,18,147,"Indiana","Spencer County",5,6,229,113,116
050,18,147,"Indiana","Spencer County",5,7,234,111,123
050,18,147,"Indiana","Spencer County",5,8,245,123,122
050,18,147,"Indiana","Spencer County",5,9,255,129,126
050,18,147,"Indiana","Spencer County",5,10,239,122,117
050,18,147,"Indiana","Spencer County",5,11,232,117,115
050,18,147,"Indiana","Spencer County",5,12,258,132,126
050,18,147,"Indiana","Spencer County",5,13,246,134,112
050,18,147,"Indiana","Spencer County",5,14,265,135,130
050,18,147,"Indiana","Spencer County",5,15,299,155,144
050,18,147,"Indiana","Spencer County",5,16,278,150,128
050,18,147,"Indiana","Spencer County",5,17,272,140,132
050,18,147,"Indiana","Spencer County",5,18,237,133,104
050,18,147,"Indiana","Spencer County",5,19,179,105,74
050,18,147,"Indiana","Spencer County",5,20,176,93,83
050,18,147,"Indiana","Spencer County",5,21,204,107,97
050,18,147,"Indiana","Spencer County",5,22,223,99,124
050,18,147,"Indiana","Spencer County",5,23,222,109,113
050,18,147,"Indiana","Spencer County",5,24,207,113,94
050,18,147,"Indiana","Spencer County",5,25,222,129,93
050,18,147,"Indiana","Spencer County",5,26,223,103,120
050,18,147,"Indiana","Spencer County",5,27,215,111,104
050,18,147,"Indiana","Spencer County",5,28,180,87,93
050,18,147,"Indiana","Spencer County",5,29,229,111,118
050,18,147,"Indiana","Spencer County",5,30,245,124,121
050,18,147,"Indiana","Spencer County",5,31,221,110,111
050,18,147,"Indiana","Spencer County",5,32,227,127,100
050,18,147,"Indiana","Spencer County",5,33,220,109,111
050,18,147,"Indiana","Spencer County",5,34,223,124,99
050,18,147,"Indiana","Spencer County",5,35,223,105,118
050,18,147,"Indiana","Spencer County",5,36,218,102,116
050,18,147,"Indiana","Spencer County",5,37,219,117,102
050,18,147,"Indiana","Spencer County",5,38,220,118,102
050,18,147,"Indiana","Spencer County",5,39,246,134,112
050,18,147,"Indiana","Spencer County",5,40,247,130,117
050,18,147,"Indiana","Spencer County",5,41,226,112,114
050,18,147,"Indiana","Spencer County",5,42,219,114,105
050,18,147,"Indiana","Spencer County",5,43,257,138,119
050,18,147,"Indiana","Spencer County",5,44,247,134,113
050,18,147,"Indiana","Spencer County",5,45,250,140,110
050,18,147,"Indiana","Spencer County",5,46,246,133,113
050,18,147,"Indiana","Spencer County",5,47,235,118,117
050,18,147,"Indiana","Spencer County",5,48,231,107,124
050,18,147,"Indiana","Spencer County",5,49,233,111,122
050,18,147,"Indiana","Spencer County",5,50,235,123,112
050,18,147,"Indiana","Spencer County",5,51,248,124,124
050,18,147,"Indiana","Spencer County",5,52,279,140,139
050,18,147,"Indiana","Spencer County",5,53,250,127,123
050,18,147,"Indiana","Spencer County",5,54,253,138,115
050,18,147,"Indiana","Spencer County",5,55,261,154,107
050,18,147,"Indiana","Spencer County",5,56,272,153,119
050,18,147,"Indiana","Spencer County",5,57,285,151,134
050,18,147,"Indiana","Spencer County",5,58,312,153,159
050,18,147,"Indiana","Spencer County",5,59,321,163,158
050,18,147,"Indiana","Spencer County",5,60,303,151,152
050,18,147,"Indiana","Spencer County",5,61,327,153,174
050,18,147,"Indiana","Spencer County",5,62,336,160,176
050,18,147,"Indiana","Spencer County",5,63,309,161,148
050,18,147,"Indiana","Spencer County",5,64,283,146,137
050,18,147,"Indiana","Spencer County",5,65,315,156,159
050,18,147,"Indiana","Spencer County",5,66,292,139,153
050,18,147,"Indiana","Spencer County",5,67,281,138,143
050,18,147,"Indiana","Spencer County",5,68,271,131,140
050,18,147,"Indiana","Spencer County",5,69,261,140,121
050,18,147,"Indiana","Spencer County",5,70,245,128,117
050,18,147,"Indiana","Spencer County",5,71,232,123,109
050,18,147,"Indiana","Spencer County",5,72,224,105,119
050,18,147,"Indiana","Spencer County",5,73,205,98,107
050,18,147,"Indiana","Spencer County",5,74,206,102,104
050,18,147,"Indiana","Spencer County",5,75,208,101,107
050,18,147,"Indiana","Spencer County",5,76,208,104,104
050,18,147,"Indiana","Spencer County",5,77,136,76,60
050,18,147,"Indiana","Spencer County",5,78,119,57,62
050,18,147,"Indiana","Spencer County",5,79,134,67,67
050,18,147,"Indiana","Spencer County",5,80,129,55,74
050,18,147,"Indiana","Spencer County",5,81,111,53,58
050,18,147,"Indiana","Spencer County",5,82,93,43,50
050,18,147,"Indiana","Spencer County",5,83,75,33,42
050,18,147,"Indiana","Spencer County",5,84,72,25,47
050,18,147,"Indiana","Spencer County",5,85,365,167,198
050,18,149,"Indiana","Starke County",1,0,268,136,132
050,18,149,"Indiana","Starke County",1,1,282,145,137
050,18,149,"Indiana","Starke County",1,2,265,150,115
050,18,149,"Indiana","Starke County",1,3,249,130,119
050,18,149,"Indiana","Starke County",1,4,286,157,129
050,18,149,"Indiana","Starke County",1,5,292,157,135
050,18,149,"Indiana","Starke County",1,6,271,147,124
050,18,149,"Indiana","Starke County",1,7,285,138,147
050,18,149,"Indiana","Starke County",1,8,291,148,143
050,18,149,"Indiana","Starke County",1,9,283,141,142
050,18,149,"Indiana","Starke County",1,10,301,164,137
050,18,149,"Indiana","Starke County",1,11,309,160,149
050,18,149,"Indiana","Starke County",1,12,348,190,158
050,18,149,"Indiana","Starke County",1,13,335,191,144
050,18,149,"Indiana","Starke County",1,14,315,150,165
050,18,149,"Indiana","Starke County",1,15,333,167,166
050,18,149,"Indiana","Starke County",1,16,319,163,156
050,18,149,"Indiana","Starke County",1,17,311,146,165
050,18,149,"Indiana","Starke County",1,18,276,127,149
050,18,149,"Indiana","Starke County",1,19,211,109,102
050,18,149,"Indiana","Starke County",1,20,232,117,115
050,18,149,"Indiana","Starke County",1,21,233,119,114
050,18,149,"Indiana","Starke County",1,22,244,126,118
050,18,149,"Indiana","Starke County",1,23,244,132,112
050,18,149,"Indiana","Starke County",1,24,268,143,125
050,18,149,"Indiana","Starke County",1,25,271,137,134
050,18,149,"Indiana","Starke County",1,26,258,131,127
050,18,149,"Indiana","Starke County",1,27,271,127,144
050,18,149,"Indiana","Starke County",1,28,282,140,142
050,18,149,"Indiana","Starke County",1,29,322,164,158
050,18,149,"Indiana","Starke County",1,30,275,125,150
050,18,149,"Indiana","Starke County",1,31,282,142,140
050,18,149,"Indiana","Starke County",1,32,267,134,133
050,18,149,"Indiana","Starke County",1,33,231,117,114
050,18,149,"Indiana","Starke County",1,34,245,121,124
050,18,149,"Indiana","Starke County",1,35,252,115,137
050,18,149,"Indiana","Starke County",1,36,249,127,122
050,18,149,"Indiana","Starke County",1,37,266,123,143
050,18,149,"Indiana","Starke County",1,38,287,146,141
050,18,149,"Indiana","Starke County",1,39,276,146,130
050,18,149,"Indiana","Starke County",1,40,277,146,131
050,18,149,"Indiana","Starke County",1,41,283,151,132
050,18,149,"Indiana","Starke County",1,42,304,153,151
050,18,149,"Indiana","Starke County",1,43,258,127,131
050,18,149,"Indiana","Starke County",1,44,253,129,124
050,18,149,"Indiana","Starke County",1,45,249,122,127
050,18,149,"Indiana","Starke County",1,46,266,137,129
050,18,149,"Indiana","Starke County",1,47,287,156,131
050,18,149,"Indiana","Starke County",1,48,319,165,154
050,18,149,"Indiana","Starke County",1,49,322,157,165
050,18,149,"Indiana","Starke County",1,50,316,157,159
050,18,149,"Indiana","Starke County",1,51,311,151,160
050,18,149,"Indiana","Starke County",1,52,275,139,136
050,18,149,"Indiana","Starke County",1,53,291,147,144
050,18,149,"Indiana","Starke County",1,54,308,161,147
050,18,149,"Indiana","Starke County",1,55,319,157,162
050,18,149,"Indiana","Starke County",1,56,321,148,173
050,18,149,"Indiana","Starke County",1,57,344,164,180
050,18,149,"Indiana","Starke County",1,58,366,175,191
050,18,149,"Indiana","Starke County",1,59,339,185,154
050,18,149,"Indiana","Starke County",1,60,343,180,163
050,18,149,"Indiana","Starke County",1,61,368,182,186
050,18,149,"Indiana","Starke County",1,62,364,185,179
050,18,149,"Indiana","Starke County",1,63,375,182,193
050,18,149,"Indiana","Starke County",1,64,347,183,164
050,18,149,"Indiana","Starke County",1,65,370,198,172
050,18,149,"Indiana","Starke County",1,66,318,148,170
050,18,149,"Indiana","Starke County",1,67,311,156,155
050,18,149,"Indiana","Starke County",1,68,307,162,145
050,18,149,"Indiana","Starke County",1,69,292,152,140
050,18,149,"Indiana","Starke County",1,70,268,138,130
050,18,149,"Indiana","Starke County",1,71,250,120,130
050,18,149,"Indiana","Starke County",1,72,219,95,124
050,18,149,"Indiana","Starke County",1,73,234,112,122
050,18,149,"Indiana","Starke County",1,74,183,88,95
050,18,149,"Indiana","Starke County",1,75,183,89,94
050,18,149,"Indiana","Starke County",1,76,179,85,94
050,18,149,"Indiana","Starke County",1,77,188,85,103
050,18,149,"Indiana","Starke County",1,78,144,60,84
050,18,149,"Indiana","Starke County",1,79,146,67,79
050,18,149,"Indiana","Starke County",1,80,116,54,62
050,18,149,"Indiana","Starke County",1,81,122,60,62
050,18,149,"Indiana","Starke County",1,82,113,46,67
050,18,149,"Indiana","Starke County",1,83,94,42,52
050,18,149,"Indiana","Starke County",1,84,81,42,39
050,18,149,"Indiana","Starke County",1,85,375,169,206
050,18,149,"Indiana","Starke County",2,0,266,142,124
050,18,149,"Indiana","Starke County",2,1,278,145,133
050,18,149,"Indiana","Starke County",2,2,268,149,119
050,18,149,"Indiana","Starke County",2,3,254,137,117
050,18,149,"Indiana","Starke County",2,4,277,152,125
050,18,149,"Indiana","Starke County",2,5,290,157,133
050,18,149,"Indiana","Starke County",2,6,277,149,128
050,18,149,"Indiana","Starke County",2,7,283,141,142
050,18,149,"Indiana","Starke County",2,8,288,144,144
050,18,149,"Indiana","Starke County",2,9,286,143,143
050,18,149,"Indiana","Starke County",2,10,296,158,138
050,18,149,"Indiana","Starke County",2,11,307,160,147
050,18,149,"Indiana","Starke County",2,12,343,184,159
050,18,149,"Indiana","Starke County",2,13,338,190,148
050,18,149,"Indiana","Starke County",2,14,320,160,160
050,18,149,"Indiana","Starke County",2,15,330,163,167
050,18,149,"Indiana","Starke County",2,16,325,165,160
050,18,149,"Indiana","Starke County",2,17,314,149,165
050,18,149,"Indiana","Starke County",2,18,268,127,141
050,18,149,"Indiana","Starke County",2,19,215,108,107
050,18,149,"Indiana","Starke County",2,20,235,118,117
050,18,149,"Indiana","Starke County",2,21,235,118,117
050,18,149,"Indiana","Starke County",2,22,247,127,120
050,18,149,"Indiana","Starke County",2,23,248,134,114
050,18,149,"Indiana","Starke County",2,24,261,141,120
050,18,149,"Indiana","Starke County",2,25,268,139,129
050,18,149,"Indiana","Starke County",2,26,265,135,130
050,18,149,"Indiana","Starke County",2,27,264,126,138
050,18,149,"Indiana","Starke County",2,28,278,136,142
050,18,149,"Indiana","Starke County",2,29,313,158,155
050,18,149,"Indiana","Starke County",2,30,289,135,154
050,18,149,"Indiana","Starke County",2,31,284,140,144
050,18,149,"Indiana","Starke County",2,32,269,135,134
050,18,149,"Indiana","Starke County",2,33,238,121,117
050,18,149,"Indiana","Starke County",2,34,244,120,124
050,18,149,"Indiana","Starke County",2,35,251,117,134
050,18,149,"Indiana","Starke County",2,36,247,122,125
050,18,149,"Indiana","Starke County",2,37,263,125,138
050,18,149,"Indiana","Starke County",2,38,282,140,142
050,18,149,"Indiana","Starke County",2,39,278,146,132
050,18,149,"Indiana","Starke County",2,40,278,147,131
050,18,149,"Indiana","Starke County",2,41,282,147,135
050,18,149,"Indiana","Starke County",2,42,299,153,146
050,18,149,"Indiana","Starke County",2,43,272,135,137
050,18,149,"Indiana","Starke County",2,44,253,128,125
050,18,149,"Indiana","Starke County",2,45,253,126,127
050,18,149,"Indiana","Starke County",2,46,262,133,129
050,18,149,"Indiana","Starke County",2,47,280,150,130
050,18,149,"Indiana","Starke County",2,48,311,162,149
050,18,149,"Indiana","Starke County",2,49,324,160,164
050,18,149,"Indiana","Starke County",2,50,318,158,160
050,18,149,"Indiana","Starke County",2,51,310,153,157
050,18,149,"Indiana","Starke County",2,52,284,142,142
050,18,149,"Indiana","Starke County",2,53,290,146,144
050,18,149,"Indiana","Starke County",2,54,299,154,145
050,18,149,"Indiana","Starke County",2,55,315,157,158
050,18,149,"Indiana","Starke County",2,56,323,151,172
050,18,149,"Indiana","Starke County",2,57,339,160,179
050,18,149,"Indiana","Starke County",2,58,360,172,188
050,18,149,"Indiana","Starke County",2,59,345,182,163
050,18,149,"Indiana","Starke County",2,60,338,178,160
050,18,149,"Indiana","Starke County",2,61,361,182,179
050,18,149,"Indiana","Starke County",2,62,367,187,180
050,18,149,"Indiana","Starke County",2,63,376,186,190
050,18,149,"Indiana","Starke County",2,64,353,182,171
050,18,149,"Indiana","Starke County",2,65,366,195,171
050,18,149,"Indiana","Starke County",2,66,331,160,171
050,18,149,"Indiana","Starke County",2,67,311,153,158
050,18,149,"Indiana","Starke County",2,68,302,156,146
050,18,149,"Indiana","Starke County",2,69,296,155,141
050,18,149,"Indiana","Starke County",2,70,270,141,129
050,18,149,"Indiana","Starke County",2,71,255,126,129
050,18,149,"Indiana","Starke County",2,72,223,100,123
050,18,149,"Indiana","Starke County",2,73,243,114,129
050,18,149,"Indiana","Starke County",2,74,177,85,92
050,18,149,"Indiana","Starke County",2,75,181,87,94
050,18,149,"Indiana","Starke County",2,76,179,86,93
050,18,149,"Indiana","Starke County",2,77,187,86,101
050,18,149,"Indiana","Starke County",2,78,151,66,85
050,18,149,"Indiana","Starke County",2,79,143,63,80
050,18,149,"Indiana","Starke County",2,80,121,57,64
050,18,149,"Indiana","Starke County",2,81,119,57,62
050,18,149,"Indiana","Starke County",2,82,116,50,66
050,18,149,"Indiana","Starke County",2,83,94,43,51
050,18,149,"Indiana","Starke County",2,84,82,41,41
050,18,149,"Indiana","Starke County",2,85,375,172,203
050,18,149,"Indiana","Starke County",3,0,245,118,127
050,18,149,"Indiana","Starke County",3,1,273,149,124
050,18,149,"Indiana","Starke County",3,2,283,142,141
050,18,149,"Indiana","Starke County",3,3,275,149,126
050,18,149,"Indiana","Starke County",3,4,253,139,114
050,18,149,"Indiana","Starke County",3,5,278,148,130
050,18,149,"Indiana","Starke County",3,6,302,163,139
050,18,149,"Indiana","Starke County",3,7,282,146,136
050,18,149,"Indiana","Starke County",3,8,293,150,143
050,18,149,"Indiana","Starke County",3,9,295,156,139
050,18,149,"Indiana","Starke County",3,10,278,139,139
050,18,149,"Indiana","Starke County",3,11,297,152,145
050,18,149,"Indiana","Starke County",3,12,321,171,150
050,18,149,"Indiana","Starke County",3,13,350,189,161
050,18,149,"Indiana","Starke County",3,14,336,191,145
050,18,149,"Indiana","Starke County",3,15,339,166,173
050,18,149,"Indiana","Starke County",3,16,321,154,167
050,18,149,"Indiana","Starke County",3,17,324,166,158
050,18,149,"Indiana","Starke County",3,18,273,137,136
050,18,149,"Indiana","Starke County",3,19,200,97,103
050,18,149,"Indiana","Starke County",3,20,238,120,118
050,18,149,"Indiana","Starke County",3,21,245,118,127
050,18,149,"Indiana","Starke County",3,22,243,126,117
050,18,149,"Indiana","Starke County",3,23,240,125,115
050,18,149,"Indiana","Starke County",3,24,249,134,115
050,18,149,"Indiana","Starke County",3,25,262,141,121
050,18,149,"Indiana","Starke County",3,26,263,132,131
050,18,149,"Indiana","Starke County",3,27,267,140,127
050,18,149,"Indiana","Starke County",3,28,266,128,138
050,18,149,"Indiana","Starke County",3,29,261,123,138
050,18,149,"Indiana","Starke County",3,30,312,158,154
050,18,149,"Indiana","Starke County",3,31,276,126,150
050,18,149,"Indiana","Starke County",3,32,287,147,140
050,18,149,"Indiana","Starke County",3,33,274,137,137
050,18,149,"Indiana","Starke County",3,34,245,126,119
050,18,149,"Indiana","Starke County",3,35,239,117,122
050,18,149,"Indiana","Starke County",3,36,251,120,131
050,18,149,"Indiana","Starke County",3,37,249,126,123
050,18,149,"Indiana","Starke County",3,38,263,125,138
050,18,149,"Indiana","Starke County",3,39,269,131,138
050,18,149,"Indiana","Starke County",3,40,272,148,124
050,18,149,"Indiana","Starke County",3,41,267,144,123
050,18,149,"Indiana","Starke County",3,42,294,153,141
050,18,149,"Indiana","Starke County",3,43,304,163,141
050,18,149,"Indiana","Starke County",3,44,274,136,138
050,18,149,"Indiana","Starke County",3,45,251,126,125
050,18,149,"Indiana","Starke County",3,46,251,128,123
050,18,149,"Indiana","Starke County",3,47,272,134,138
050,18,149,"Indiana","Starke County",3,48,275,145,130
050,18,149,"Indiana","Starke County",3,49,307,159,148
050,18,149,"Indiana","Starke County",3,50,327,164,163
050,18,149,"Indiana","Starke County",3,51,324,160,164
050,18,149,"Indiana","Starke County",3,52,318,158,160
050,18,149,"Indiana","Starke County",3,53,281,141,140
050,18,149,"Indiana","Starke County",3,54,292,148,144
050,18,149,"Indiana","Starke County",3,55,296,150,146
050,18,149,"Indiana","Starke County",3,56,317,156,161
050,18,149,"Indiana","Starke County",3,57,323,157,166
050,18,149,"Indiana","Starke County",3,58,333,161,172
050,18,149,"Indiana","Starke County",3,59,362,173,189
050,18,149,"Indiana","Starke County",3,60,341,177,164
050,18,149,"Indiana","Starke County",3,61,329,177,152
050,18,149,"Indiana","Starke County",3,62,359,180,179
050,18,149,"Indiana","Starke County",3,63,371,185,186
050,18,149,"Indiana","Starke County",3,64,364,177,187
050,18,149,"Indiana","Starke County",3,65,345,168,177
050,18,149,"Indiana","Starke County",3,66,360,191,169
050,18,149,"Indiana","Starke County",3,67,336,164,172
050,18,149,"Indiana","Starke County",3,68,308,154,154
050,18,149,"Indiana","Starke County",3,69,290,146,144
050,18,149,"Indiana","Starke County",3,70,299,160,139
050,18,149,"Indiana","Starke County",3,71,267,141,126
050,18,149,"Indiana","Starke County",3,72,247,120,127
050,18,149,"Indiana","Starke County",3,73,215,95,120
050,18,149,"Indiana","Starke County",3,74,234,106,128
050,18,149,"Indiana","Starke County",3,75,162,76,86
050,18,149,"Indiana","Starke County",3,76,171,81,90
050,18,149,"Indiana","Starke County",3,77,160,78,82
050,18,149,"Indiana","Starke County",3,78,180,82,98
050,18,149,"Indiana","Starke County",3,79,145,62,83
050,18,149,"Indiana","Starke County",3,80,132,55,77
050,18,149,"Indiana","Starke County",3,81,111,53,58
050,18,149,"Indiana","Starke County",3,82,107,50,57
050,18,149,"Indiana","Starke County",3,83,111,48,63
050,18,149,"Indiana","Starke County",3,84,89,40,49
050,18,149,"Indiana","Starke County",3,85,383,178,205
050,18,149,"Indiana","Starke County",4,0,232,115,117
050,18,149,"Indiana","Starke County",4,1,264,131,133
050,18,149,"Indiana","Starke County",4,2,275,156,119
050,18,149,"Indiana","Starke County",4,3,272,134,138
050,18,149,"Indiana","Starke County",4,4,273,146,127
050,18,149,"Indiana","Starke County",4,5,258,144,114
050,18,149,"Indiana","Starke County",4,6,267,144,123
050,18,149,"Indiana","Starke County",4,7,300,159,141
050,18,149,"Indiana","Starke County",4,8,276,144,132
050,18,149,"Indiana","Starke County",4,9,293,153,140
050,18,149,"Indiana","Starke County",4,10,291,149,142
050,18,149,"Indiana","Starke County",4,11,283,140,143
050,18,149,"Indiana","Starke County",4,12,293,151,142
050,18,149,"Indiana","Starke County",4,13,315,160,155
050,18,149,"Indiana","Starke County",4,14,343,182,161
050,18,149,"Indiana","Starke County",4,15,312,174,138
050,18,149,"Indiana","Starke County",4,16,326,162,164
050,18,149,"Indiana","Starke County",4,17,316,148,168
050,18,149,"Indiana","Starke County",4,18,260,136,124
050,18,149,"Indiana","Starke County",4,19,198,96,102
050,18,149,"Indiana","Starke County",4,20,218,100,118
050,18,149,"Indiana","Starke County",4,21,249,124,125
050,18,149,"Indiana","Starke County",4,22,239,120,119
050,18,149,"Indiana","Starke County",4,23,246,131,115
050,18,149,"Indiana","Starke County",4,24,254,137,117
050,18,149,"Indiana","Starke County",4,25,261,141,120
050,18,149,"Indiana","Starke County",4,26,266,148,118
050,18,149,"Indiana","Starke County",4,27,261,126,135
050,18,149,"Indiana","Starke County",4,28,254,126,128
050,18,149,"Indiana","Starke County",4,29,261,128,133
050,18,149,"Indiana","Starke County",4,30,274,130,144
050,18,149,"Indiana","Starke County",4,31,308,157,151
050,18,149,"Indiana","Starke County",4,32,280,127,153
050,18,149,"Indiana","Starke County",4,33,275,134,141
050,18,149,"Indiana","Starke County",4,34,277,143,134
050,18,149,"Indiana","Starke County",4,35,246,124,122
050,18,149,"Indiana","Starke County",4,36,248,124,124
050,18,149,"Indiana","Starke County",4,37,253,124,129
050,18,149,"Indiana","Starke County",4,38,259,133,126
050,18,149,"Indiana","Starke County",4,39,275,139,136
050,18,149,"Indiana","Starke County",4,40,270,135,135
050,18,149,"Indiana","Starke County",4,41,273,151,122
050,18,149,"Indiana","Starke County",4,42,260,137,123
050,18,149,"Indiana","Starke County",4,43,283,152,131
050,18,149,"Indiana","Starke County",4,44,301,162,139
050,18,149,"Indiana","Starke County",4,45,275,138,137
050,18,149,"Indiana","Starke County",4,46,248,125,123
050,18,149,"Indiana","Starke County",4,47,252,128,124
050,18,149,"Indiana","Starke County",4,48,273,139,134
050,18,149,"Indiana","Starke County",4,49,273,140,133
050,18,149,"Indiana","Starke County",4,50,311,161,150
050,18,149,"Indiana","Starke County",4,51,326,165,161
050,18,149,"Indiana","Starke County",4,52,321,156,165
050,18,149,"Indiana","Starke County",4,53,318,155,163
050,18,149,"Indiana","Starke County",4,54,279,137,142
050,18,149,"Indiana","Starke County",4,55,294,151,143
050,18,149,"Indiana","Starke County",4,56,297,149,148
050,18,149,"Indiana","Starke County",4,57,313,150,163
050,18,149,"Indiana","Starke County",4,58,329,157,172
050,18,149,"Indiana","Starke County",4,59,341,162,179
050,18,149,"Indiana","Starke County",4,60,366,179,187
050,18,149,"Indiana","Starke County",4,61,343,176,167
050,18,149,"Indiana","Starke County",4,62,328,175,153
050,18,149,"Indiana","Starke County",4,63,351,179,172
050,18,149,"Indiana","Starke County",4,64,364,176,188
050,18,149,"Indiana","Starke County",4,65,354,168,186
050,18,149,"Indiana","Starke County",4,66,340,169,171
050,18,149,"Indiana","Starke County",4,67,364,193,171
050,18,149,"Indiana","Starke County",4,68,335,164,171
050,18,149,"Indiana","Starke County",4,69,299,144,155
050,18,149,"Indiana","Starke County",4,70,280,139,141
050,18,149,"Indiana","Starke County",4,71,292,157,135
050,18,149,"Indiana","Starke County",4,72,255,134,121
050,18,149,"Indiana","Starke County",4,73,240,118,122
050,18,149,"Indiana","Starke County",4,74,213,93,120
050,18,149,"Indiana","Starke County",4,75,217,99,118
050,18,149,"Indiana","Starke County",4,76,156,70,86
050,18,149,"Indiana","Starke County",4,77,154,76,78
050,18,149,"Indiana","Starke County",4,78,152,74,78
050,18,149,"Indiana","Starke County",4,79,173,78,95
050,18,149,"Indiana","Starke County",4,80,136,59,77
050,18,149,"Indiana","Starke County",4,81,123,51,72
050,18,149,"Indiana","Starke County",4,82,95,46,49
050,18,149,"Indiana","Starke County",4,83,98,47,51
050,18,149,"Indiana","Starke County",4,84,100,47,53
050,18,149,"Indiana","Starke County",4,85,387,173,214
050,18,149,"Indiana","Starke County",5,0,234,116,118
050,18,149,"Indiana","Starke County",5,1,224,112,112
050,18,149,"Indiana","Starke County",5,2,270,139,131
050,18,149,"Indiana","Starke County",5,3,273,150,123
050,18,149,"Indiana","Starke County",5,4,270,134,136
050,18,149,"Indiana","Starke County",5,5,284,148,136
050,18,149,"Indiana","Starke County",5,6,261,137,124
050,18,149,"Indiana","Starke County",5,7,266,140,126
050,18,149,"Indiana","Starke County",5,8,306,163,143
050,18,149,"Indiana","Starke County",5,9,293,160,133
050,18,149,"Indiana","Starke County",5,10,301,162,139
050,18,149,"Indiana","Starke County",5,11,301,148,153
050,18,149,"Indiana","Starke County",5,12,287,139,148
050,18,149,"Indiana","Starke County",5,13,298,154,144
050,18,149,"Indiana","Starke County",5,14,311,149,162
050,18,149,"Indiana","Starke County",5,15,339,185,154
050,18,149,"Indiana","Starke County",5,16,315,175,140
050,18,149,"Indiana","Starke County",5,17,323,159,164
050,18,149,"Indiana","Starke County",5,18,261,129,132
050,18,149,"Indiana","Starke County",5,19,202,106,96
050,18,149,"Indiana","Starke County",5,20,210,103,107
050,18,149,"Indiana","Starke County",5,21,225,109,116
050,18,149,"Indiana","Starke County",5,22,274,130,144
050,18,149,"Indiana","Starke County",5,23,247,127,120
050,18,149,"Indiana","Starke County",5,24,253,140,113
050,18,149,"Indiana","Starke County",5,25,252,134,118
050,18,149,"Indiana","Starke County",5,26,268,147,121
050,18,149,"Indiana","Starke County",5,27,262,151,111
050,18,149,"Indiana","Starke County",5,28,266,133,133
050,18,149,"Indiana","Starke County",5,29,253,125,128
050,18,149,"Indiana","Starke County",5,30,266,129,137
050,18,149,"Indiana","Starke County",5,31,262,117,145
050,18,149,"Indiana","Starke County",5,32,297,156,141
050,18,149,"Indiana","Starke County",5,33,283,128,155
050,18,149,"Indiana","Starke County",5,34,273,134,139
050,18,149,"Indiana","Starke County",5,35,284,147,137
050,18,149,"Indiana","Starke County",5,36,255,130,125
050,18,149,"Indiana","Starke County",5,37,251,127,124
050,18,149,"Indiana","Starke County",5,38,248,126,122
050,18,149,"Indiana","Starke County",5,39,265,134,131
050,18,149,"Indiana","Starke County",5,40,281,140,141
050,18,149,"Indiana","Starke County",5,41,287,136,151
050,18,149,"Indiana","Starke County",5,42,273,150,123
050,18,149,"Indiana","Starke County",5,43,251,133,118
050,18,149,"Indiana","Starke County",5,44,289,153,136
050,18,149,"Indiana","Starke County",5,45,295,155,140
050,18,149,"Indiana","Starke County",5,46,271,133,138
050,18,149,"Indiana","Starke County",5,47,250,121,129
050,18,149,"Indiana","Starke County",5,48,255,130,125
050,18,149,"Indiana","Starke County",5,49,267,137,130
050,18,149,"Indiana","Starke County",5,50,274,140,134
050,18,149,"Indiana","Starke County",5,51,310,168,142
050,18,149,"Indiana","Starke County",5,52,345,183,162
050,18,149,"Indiana","Starke County",5,53,321,158,163
050,18,149,"Indiana","Starke County",5,54,316,159,157
050,18,149,"Indiana","Starke County",5,55,277,135,142
050,18,149,"Indiana","Starke County",5,56,299,154,145
050,18,149,"Indiana","Starke County",5,57,292,147,145
050,18,149,"Indiana","Starke County",5,58,310,149,161
050,18,149,"Indiana","Starke County",5,59,328,157,171
050,18,149,"Indiana","Starke County",5,60,341,162,179
050,18,149,"Indiana","Starke County",5,61,364,177,187
050,18,149,"Indiana","Starke County",5,62,347,175,172
050,18,149,"Indiana","Starke County",5,63,320,167,153
050,18,149,"Indiana","Starke County",5,64,343,175,168
050,18,149,"Indiana","Starke County",5,65,344,161,183
050,18,149,"Indiana","Starke County",5,66,356,169,187
050,18,149,"Indiana","Starke County",5,67,335,169,166
050,18,149,"Indiana","Starke County",5,68,356,189,167
050,18,149,"Indiana","Starke County",5,69,324,155,169
050,18,149,"Indiana","Starke County",5,70,289,135,154
050,18,149,"Indiana","Starke County",5,71,277,139,138
050,18,149,"Indiana","Starke County",5,72,279,149,130
050,18,149,"Indiana","Starke County",5,73,249,133,116
050,18,149,"Indiana","Starke County",5,74,228,111,117
050,18,149,"Indiana","Starke County",5,75,204,87,117
050,18,149,"Indiana","Starke County",5,76,216,99,117
050,18,149,"Indiana","Starke County",5,77,145,65,80
050,18,149,"Indiana","Starke County",5,78,149,72,77
050,18,149,"Indiana","Starke County",5,79,145,67,78
050,18,149,"Indiana","Starke County",5,80,163,73,90
050,18,149,"Indiana","Starke County",5,81,131,57,74
050,18,149,"Indiana","Starke County",5,82,108,44,64
050,18,149,"Indiana","Starke County",5,83,91,44,47
050,18,149,"Indiana","Starke County",5,84,91,45,46
050,18,149,"Indiana","Starke County",5,85,407,180,227
050,18,151,"Indiana","Steuben County",1,0,381,190,191
050,18,151,"Indiana","Steuben County",1,1,372,186,186
050,18,151,"Indiana","Steuben County",1,2,353,182,171
050,18,151,"Indiana","Steuben County",1,3,374,194,180
050,18,151,"Indiana","Steuben County",1,4,418,212,206
050,18,151,"Indiana","Steuben County",1,5,386,205,181
050,18,151,"Indiana","Steuben County",1,6,362,200,162
050,18,151,"Indiana","Steuben County",1,7,369,195,174
050,18,151,"Indiana","Steuben County",1,8,359,167,192
050,18,151,"Indiana","Steuben County",1,9,356,178,178
050,18,151,"Indiana","Steuben County",1,10,363,174,189
050,18,151,"Indiana","Steuben County",1,11,376,190,186
050,18,151,"Indiana","Steuben County",1,12,399,204,195
050,18,151,"Indiana","Steuben County",1,13,418,210,208
050,18,151,"Indiana","Steuben County",1,14,405,214,191
050,18,151,"Indiana","Steuben County",1,15,430,226,204
050,18,151,"Indiana","Steuben County",1,16,445,231,214
050,18,151,"Indiana","Steuben County",1,17,429,196,233
050,18,151,"Indiana","Steuben County",1,18,544,278,266
050,18,151,"Indiana","Steuben County",1,19,808,522,286
050,18,151,"Indiana","Steuben County",1,20,701,440,261
050,18,151,"Indiana","Steuben County",1,21,548,337,211
050,18,151,"Indiana","Steuben County",1,22,519,304,215
050,18,151,"Indiana","Steuben County",1,23,382,211,171
050,18,151,"Indiana","Steuben County",1,24,356,189,167
050,18,151,"Indiana","Steuben County",1,25,365,189,176
050,18,151,"Indiana","Steuben County",1,26,364,185,179
050,18,151,"Indiana","Steuben County",1,27,359,184,175
050,18,151,"Indiana","Steuben County",1,28,346,166,180
050,18,151,"Indiana","Steuben County",1,29,377,191,186
050,18,151,"Indiana","Steuben County",1,30,349,174,175
050,18,151,"Indiana","Steuben County",1,31,350,185,165
050,18,151,"Indiana","Steuben County",1,32,367,185,182
050,18,151,"Indiana","Steuben County",1,33,341,174,167
050,18,151,"Indiana","Steuben County",1,34,344,171,173
050,18,151,"Indiana","Steuben County",1,35,341,174,167
050,18,151,"Indiana","Steuben County",1,36,334,161,173
050,18,151,"Indiana","Steuben County",1,37,339,172,167
050,18,151,"Indiana","Steuben County",1,38,351,190,161
050,18,151,"Indiana","Steuben County",1,39,345,188,157
050,18,151,"Indiana","Steuben County",1,40,361,183,178
050,18,151,"Indiana","Steuben County",1,41,336,172,164
050,18,151,"Indiana","Steuben County",1,42,355,172,183
050,18,151,"Indiana","Steuben County",1,43,356,186,170
050,18,151,"Indiana","Steuben County",1,44,338,173,165
050,18,151,"Indiana","Steuben County",1,45,364,183,181
050,18,151,"Indiana","Steuben County",1,46,368,190,178
050,18,151,"Indiana","Steuben County",1,47,392,187,205
050,18,151,"Indiana","Steuben County",1,48,425,220,205
050,18,151,"Indiana","Steuben County",1,49,475,247,228
050,18,151,"Indiana","Steuben County",1,50,428,220,208
050,18,151,"Indiana","Steuben County",1,51,429,220,209
050,18,151,"Indiana","Steuben County",1,52,408,208,200
050,18,151,"Indiana","Steuben County",1,53,456,227,229
050,18,151,"Indiana","Steuben County",1,54,492,256,236
050,18,151,"Indiana","Steuben County",1,55,534,278,256
050,18,151,"Indiana","Steuben County",1,56,506,251,255
050,18,151,"Indiana","Steuben County",1,57,489,249,240
050,18,151,"Indiana","Steuben County",1,58,518,257,261
050,18,151,"Indiana","Steuben County",1,59,528,267,261
050,18,151,"Indiana","Steuben County",1,60,521,279,242
050,18,151,"Indiana","Steuben County",1,61,544,275,269
050,18,151,"Indiana","Steuben County",1,62,543,276,267
050,18,151,"Indiana","Steuben County",1,63,512,252,260
050,18,151,"Indiana","Steuben County",1,64,521,260,261
050,18,151,"Indiana","Steuben County",1,65,523,268,255
050,18,151,"Indiana","Steuben County",1,66,507,258,249
050,18,151,"Indiana","Steuben County",1,67,481,233,248
050,18,151,"Indiana","Steuben County",1,68,489,237,252
050,18,151,"Indiana","Steuben County",1,69,456,211,245
050,18,151,"Indiana","Steuben County",1,70,453,221,232
050,18,151,"Indiana","Steuben County",1,71,411,217,194
050,18,151,"Indiana","Steuben County",1,72,410,211,199
050,18,151,"Indiana","Steuben County",1,73,408,193,215
050,18,151,"Indiana","Steuben County",1,74,266,131,135
050,18,151,"Indiana","Steuben County",1,75,281,140,141
050,18,151,"Indiana","Steuben County",1,76,281,133,148
050,18,151,"Indiana","Steuben County",1,77,271,129,142
050,18,151,"Indiana","Steuben County",1,78,231,117,114
050,18,151,"Indiana","Steuben County",1,79,194,96,98
050,18,151,"Indiana","Steuben County",1,80,169,83,86
050,18,151,"Indiana","Steuben County",1,81,165,77,88
050,18,151,"Indiana","Steuben County",1,82,147,69,78
050,18,151,"Indiana","Steuben County",1,83,148,64,84
050,18,151,"Indiana","Steuben County",1,84,134,58,76
050,18,151,"Indiana","Steuben County",1,85,690,249,441
050,18,151,"Indiana","Steuben County",2,0,370,191,179
050,18,151,"Indiana","Steuben County",2,1,372,187,185
050,18,151,"Indiana","Steuben County",2,2,359,184,175
050,18,151,"Indiana","Steuben County",2,3,367,189,178
050,18,151,"Indiana","Steuben County",2,4,409,208,201
050,18,151,"Indiana","Steuben County",2,5,394,207,187
050,18,151,"Indiana","Steuben County",2,6,367,202,165
050,18,151,"Indiana","Steuben County",2,7,369,197,172
050,18,151,"Indiana","Steuben County",2,8,359,172,187
050,18,151,"Indiana","Steuben County",2,9,357,175,182
050,18,151,"Indiana","Steuben County",2,10,364,175,189
050,18,151,"Indiana","Steuben County",2,11,372,185,187
050,18,151,"Indiana","Steuben County",2,12,396,201,195
050,18,151,"Indiana","Steuben County",2,13,410,206,204
050,18,151,"Indiana","Steuben County",2,14,406,212,194
050,18,151,"Indiana","Steuben County",2,15,423,222,201
050,18,151,"Indiana","Steuben County",2,16,442,229,213
050,18,151,"Indiana","Steuben County",2,17,436,207,229
050,18,151,"Indiana","Steuben County",2,18,536,274,262
050,18,151,"Indiana","Steuben County",2,19,801,515,286
050,18,151,"Indiana","Steuben County",2,20,712,448,264
050,18,151,"Indiana","Steuben County",2,21,556,342,214
050,18,151,"Indiana","Steuben County",2,22,508,298,210
050,18,151,"Indiana","Steuben County",2,23,386,213,173
050,18,151,"Indiana","Steuben County",2,24,360,189,171
050,18,151,"Indiana","Steuben County",2,25,359,183,176
050,18,151,"Indiana","Steuben County",2,26,361,184,177
050,18,151,"Indiana","Steuben County",2,27,356,183,173
050,18,151,"Indiana","Steuben County",2,28,350,173,177
050,18,151,"Indiana","Steuben County",2,29,370,184,186
050,18,151,"Indiana","Steuben County",2,30,357,179,178
050,18,151,"Indiana","Steuben County",2,31,350,183,167
050,18,151,"Indiana","Steuben County",2,32,362,184,178
050,18,151,"Indiana","Steuben County",2,33,344,175,169
050,18,151,"Indiana","Steuben County",2,34,341,169,172
050,18,151,"Indiana","Steuben County",2,35,343,173,170
050,18,151,"Indiana","Steuben County",2,36,334,163,171
050,18,151,"Indiana","Steuben County",2,37,336,168,168
050,18,151,"Indiana","Steuben County",2,38,351,188,163
050,18,151,"Indiana","Steuben County",2,39,348,190,158
050,18,151,"Indiana","Steuben County",2,40,360,186,174
050,18,151,"Indiana","Steuben County",2,41,343,174,169
050,18,151,"Indiana","Steuben County",2,42,349,172,177
050,18,151,"Indiana","Steuben County",2,43,360,184,176
050,18,151,"Indiana","Steuben County",2,44,337,173,164
050,18,151,"Indiana","Steuben County",2,45,360,182,178
050,18,151,"Indiana","Steuben County",2,46,365,186,179
050,18,151,"Indiana","Steuben County",2,47,384,188,196
050,18,151,"Indiana","Steuben County",2,48,416,212,204
050,18,151,"Indiana","Steuben County",2,49,466,242,224
050,18,151,"Indiana","Steuben County",2,50,440,225,215
050,18,151,"Indiana","Steuben County",2,51,427,220,207
050,18,151,"Indiana","Steuben County",2,52,412,210,202
050,18,151,"Indiana","Steuben County",2,53,445,223,222
050,18,151,"Indiana","Steuben County",2,54,483,250,233
050,18,151,"Indiana","Steuben County",2,55,527,274,253
050,18,151,"Indiana","Steuben County",2,56,517,260,257
050,18,151,"Indiana","Steuben County",2,57,493,248,245
050,18,151,"Indiana","Steuben County",2,58,511,256,255
050,18,151,"Indiana","Steuben County",2,59,532,269,263
050,18,151,"Indiana","Steuben County",2,60,523,275,248
050,18,151,"Indiana","Steuben County",2,61,538,273,265
050,18,151,"Indiana","Steuben County",2,62,544,275,269
050,18,151,"Indiana","Steuben County",2,63,527,260,267
050,18,151,"Indiana","Steuben County",2,64,517,256,261
050,18,151,"Indiana","Steuben County",2,65,521,265,256
050,18,151,"Indiana","Steuben County",2,66,510,260,250
050,18,151,"Indiana","Steuben County",2,67,483,237,246
050,18,151,"Indiana","Steuben County",2,68,481,234,247
050,18,151,"Indiana","Steuben County",2,69,466,217,249
050,18,151,"Indiana","Steuben County",2,70,452,217,235
050,18,151,"Indiana","Steuben County",2,71,423,219,204
050,18,151,"Indiana","Steuben County",2,72,393,205,188
050,18,151,"Indiana","Steuben County",2,73,426,204,222
050,18,151,"Indiana","Steuben County",2,74,277,137,140
050,18,151,"Indiana","Steuben County",2,75,273,138,135
050,18,151,"Indiana","Steuben County",2,76,277,132,145
050,18,151,"Indiana","Steuben County",2,77,276,133,143
050,18,151,"Indiana","Steuben County",2,78,237,118,119
050,18,151,"Indiana","Steuben County",2,79,201,101,100
050,18,151,"Indiana","Steuben County",2,80,174,85,89
050,18,151,"Indiana","Steuben County",2,81,165,78,87
050,18,151,"Indiana","Steuben County",2,82,152,71,81
050,18,151,"Indiana","Steuben County",2,83,147,64,83
050,18,151,"Indiana","Steuben County",2,84,137,59,78
050,18,151,"Indiana","Steuben County",2,85,701,253,448
050,18,151,"Indiana","Steuben County",3,0,342,172,170
050,18,151,"Indiana","Steuben County",3,1,383,195,188
050,18,151,"Indiana","Steuben County",3,2,370,185,185
050,18,151,"Indiana","Steuben County",3,3,355,182,173
050,18,151,"Indiana","Steuben County",3,4,380,201,179
050,18,151,"Indiana","Steuben County",3,5,401,207,194
050,18,151,"Indiana","Steuben County",3,6,393,217,176
050,18,151,"Indiana","Steuben County",3,7,374,196,178
050,18,151,"Indiana","Steuben County",3,8,371,191,180
050,18,151,"Indiana","Steuben County",3,9,357,173,184
050,18,151,"Indiana","Steuben County",3,10,375,188,187
050,18,151,"Indiana","Steuben County",3,11,366,179,187
050,18,151,"Indiana","Steuben County",3,12,366,179,187
050,18,151,"Indiana","Steuben County",3,13,390,203,187
050,18,151,"Indiana","Steuben County",3,14,407,212,195
050,18,151,"Indiana","Steuben County",3,15,404,212,192
050,18,151,"Indiana","Steuben County",3,16,430,225,205
050,18,151,"Indiana","Steuben County",3,17,437,236,201
050,18,151,"Indiana","Steuben County",3,18,532,281,251
050,18,151,"Indiana","Steuben County",3,19,802,502,300
050,18,151,"Indiana","Steuben County",3,20,722,457,265
050,18,151,"Indiana","Steuben County",3,21,581,349,232
050,18,151,"Indiana","Steuben County",3,22,483,274,209
050,18,151,"Indiana","Steuben County",3,23,397,221,176
050,18,151,"Indiana","Steuben County",3,24,357,190,167
050,18,151,"Indiana","Steuben County",3,25,348,184,164
050,18,151,"Indiana","Steuben County",3,26,342,168,174
050,18,151,"Indiana","Steuben County",3,27,360,192,168
050,18,151,"Indiana","Steuben County",3,28,354,187,167
050,18,151,"Indiana","Steuben County",3,29,370,181,189
050,18,151,"Indiana","Steuben County",3,30,382,189,193
050,18,151,"Indiana","Steuben County",3,31,372,181,191
050,18,151,"Indiana","Steuben County",3,32,366,188,178
050,18,151,"Indiana","Steuben County",3,33,393,210,183
050,18,151,"Indiana","Steuben County",3,34,362,178,184
050,18,151,"Indiana","Steuben County",3,35,357,178,179
050,18,151,"Indiana","Steuben County",3,36,346,179,167
050,18,151,"Indiana","Steuben County",3,37,323,159,164
050,18,151,"Indiana","Steuben County",3,38,340,172,168
050,18,151,"Indiana","Steuben County",3,39,358,193,165
050,18,151,"Indiana","Steuben County",3,40,350,188,162
050,18,151,"Indiana","Steuben County",3,41,361,182,179
050,18,151,"Indiana","Steuben County",3,42,341,169,172
050,18,151,"Indiana","Steuben County",3,43,339,163,176
050,18,151,"Indiana","Steuben County",3,44,356,185,171
050,18,151,"Indiana","Steuben County",3,45,337,170,167
050,18,151,"Indiana","Steuben County",3,46,373,185,188
050,18,151,"Indiana","Steuben County",3,47,377,194,183
050,18,151,"Indiana","Steuben County",3,48,389,189,200
050,18,151,"Indiana","Steuben County",3,49,426,214,212
050,18,151,"Indiana","Steuben County",3,50,475,248,227
050,18,151,"Indiana","Steuben County",3,51,442,227,215
050,18,151,"Indiana","Steuben County",3,52,433,229,204
050,18,151,"Indiana","Steuben County",3,53,429,216,213
050,18,151,"Indiana","Steuben County",3,54,462,231,231
050,18,151,"Indiana","Steuben County",3,55,494,257,237
050,18,151,"Indiana","Steuben County",3,56,557,296,261
050,18,151,"Indiana","Steuben County",3,57,519,260,259
050,18,151,"Indiana","Steuben County",3,58,496,254,242
050,18,151,"Indiana","Steuben County",3,59,507,254,253
050,18,151,"Indiana","Steuben County",3,60,541,276,265
050,18,151,"Indiana","Steuben County",3,61,545,282,263
050,18,151,"Indiana","Steuben County",3,62,548,277,271
050,18,151,"Indiana","Steuben County",3,63,536,264,272
050,18,151,"Indiana","Steuben County",3,64,537,262,275
050,18,151,"Indiana","Steuben County",3,65,516,247,269
050,18,151,"Indiana","Steuben County",3,66,519,267,252
050,18,151,"Indiana","Steuben County",3,67,500,253,247
050,18,151,"Indiana","Steuben County",3,68,475,238,237
050,18,151,"Indiana","Steuben County",3,69,476,235,241
050,18,151,"Indiana","Steuben County",3,70,458,209,249
050,18,151,"Indiana","Steuben County",3,71,431,201,230
050,18,151,"Indiana","Steuben County",3,72,409,209,200
050,18,151,"Indiana","Steuben County",3,73,382,199,183
050,18,151,"Indiana","Steuben County",3,74,416,205,211
050,18,151,"Indiana","Steuben County",3,75,279,139,140
050,18,151,"Indiana","Steuben County",3,76,262,129,133
050,18,151,"Indiana","Steuben County",3,77,263,125,138
050,18,151,"Indiana","Steuben County",3,78,267,135,132
050,18,151,"Indiana","Steuben County",3,79,228,111,117
050,18,151,"Indiana","Steuben County",3,80,197,97,100
050,18,151,"Indiana","Steuben County",3,81,162,78,84
050,18,151,"Indiana","Steuben County",3,82,154,73,81
050,18,151,"Indiana","Steuben County",3,83,138,60,78
050,18,151,"Indiana","Steuben County",3,84,141,55,86
050,18,151,"Indiana","Steuben County",3,85,711,268,443
050,18,151,"Indiana","Steuben County",4,0,353,179,174
050,18,151,"Indiana","Steuben County",4,1,348,171,177
050,18,151,"Indiana","Steuben County",4,2,372,197,175
050,18,151,"Indiana","Steuben County",4,3,369,172,197
050,18,151,"Indiana","Steuben County",4,4,359,181,178
050,18,151,"Indiana","Steuben County",4,5,387,205,182
050,18,151,"Indiana","Steuben County",4,6,411,224,187
050,18,151,"Indiana","Steuben County",4,7,394,216,178
050,18,151,"Indiana","Steuben County",4,8,386,202,184
050,18,151,"Indiana","Steuben County",4,9,368,189,179
050,18,151,"Indiana","Steuben County",4,10,359,170,189
050,18,151,"Indiana","Steuben County",4,11,366,183,183
050,18,151,"Indiana","Steuben County",4,12,371,186,185
050,18,151,"Indiana","Steuben County",4,13,368,180,188
050,18,151,"Indiana","Steuben County",4,14,398,210,188
050,18,151,"Indiana","Steuben County",4,15,408,215,193
050,18,151,"Indiana","Steuben County",4,16,392,202,190
050,18,151,"Indiana","Steuben County",4,17,429,225,204
050,18,151,"Indiana","Steuben County",4,18,528,296,232
050,18,151,"Indiana","Steuben County",4,19,781,509,272
050,18,151,"Indiana","Steuben County",4,20,706,432,274
050,18,151,"Indiana","Steuben County",4,21,575,366,209
050,18,151,"Indiana","Steuben County",4,22,503,287,216
050,18,151,"Indiana","Steuben County",4,23,358,190,168
050,18,151,"Indiana","Steuben County",4,24,381,198,183
050,18,151,"Indiana","Steuben County",4,25,349,194,155
050,18,151,"Indiana","Steuben County",4,26,340,172,168
050,18,151,"Indiana","Steuben County",4,27,343,169,174
050,18,151,"Indiana","Steuben County",4,28,353,189,164
050,18,151,"Indiana","Steuben County",4,29,360,192,168
050,18,151,"Indiana","Steuben County",4,30,362,181,181
050,18,151,"Indiana","Steuben County",4,31,385,185,200
050,18,151,"Indiana","Steuben County",4,32,382,188,194
050,18,151,"Indiana","Steuben County",4,33,367,186,181
050,18,151,"Indiana","Steuben County",4,34,405,213,192
050,18,151,"Indiana","Steuben County",4,35,366,178,188
050,18,151,"Indiana","Steuben County",4,36,358,177,181
050,18,151,"Indiana","Steuben County",4,37,335,176,159
050,18,151,"Indiana","Steuben County",4,38,325,158,167
050,18,151,"Indiana","Steuben County",4,39,349,181,168
050,18,151,"Indiana","Steuben County",4,40,368,192,176
050,18,151,"Indiana","Steuben County",4,41,355,192,163
050,18,151,"Indiana","Steuben County",4,42,369,188,181
050,18,151,"Indiana","Steuben County",4,43,340,173,167
050,18,151,"Indiana","Steuben County",4,44,335,159,176
050,18,151,"Indiana","Steuben County",4,45,364,190,174
050,18,151,"Indiana","Steuben County",4,46,345,175,170
050,18,151,"Indiana","Steuben County",4,47,361,180,181
050,18,151,"Indiana","Steuben County",4,48,386,197,189
050,18,151,"Indiana","Steuben County",4,49,401,201,200
050,18,151,"Indiana","Steuben County",4,50,443,225,218
050,18,151,"Indiana","Steuben County",4,51,461,239,222
050,18,151,"Indiana","Steuben County",4,52,447,228,219
050,18,151,"Indiana","Steuben County",4,53,427,230,197
050,18,151,"Indiana","Steuben County",4,54,425,209,216
050,18,151,"Indiana","Steuben County",4,55,455,227,228
050,18,151,"Indiana","Steuben County",4,56,492,256,236
050,18,151,"Indiana","Steuben County",4,57,554,297,257
050,18,151,"Indiana","Steuben County",4,58,534,267,267
050,18,151,"Indiana","Steuben County",4,59,500,254,246
050,18,151,"Indiana","Steuben County",4,60,519,259,260
050,18,151,"Indiana","Steuben County",4,61,539,278,261
050,18,151,"Indiana","Steuben County",4,62,559,292,267
050,18,151,"Indiana","Steuben County",4,63,551,279,272
050,18,151,"Indiana","Steuben County",4,64,543,267,276
050,18,151,"Indiana","Steuben County",4,65,537,265,272
050,18,151,"Indiana","Steuben County",4,66,523,253,270
050,18,151,"Indiana","Steuben County",4,67,525,274,251
050,18,151,"Indiana","Steuben County",4,68,501,255,246
050,18,151,"Indiana","Steuben County",4,69,479,240,239
050,18,151,"Indiana","Steuben County",4,70,465,225,240
050,18,151,"Indiana","Steuben County",4,71,443,201,242
050,18,151,"Indiana","Steuben County",4,72,424,192,232
050,18,151,"Indiana","Steuben County",4,73,403,208,195
050,18,151,"Indiana","Steuben County",4,74,381,196,185
050,18,151,"Indiana","Steuben County",4,75,402,196,206
050,18,151,"Indiana","Steuben County",4,76,264,130,134
050,18,151,"Indiana","Steuben County",4,77,247,120,127
050,18,151,"Indiana","Steuben County",4,78,245,117,128
050,18,151,"Indiana","Steuben County",4,79,248,122,126
050,18,151,"Indiana","Steuben County",4,80,220,106,114
050,18,151,"Indiana","Steuben County",4,81,176,85,91
050,18,151,"Indiana","Steuben County",4,82,149,69,80
050,18,151,"Indiana","Steuben County",4,83,148,69,79
050,18,151,"Indiana","Steuben County",4,84,132,55,77
050,18,151,"Indiana","Steuben County",4,85,738,278,460
050,18,151,"Indiana","Steuben County",5,0,354,181,173
050,18,151,"Indiana","Steuben County",5,1,325,180,145
050,18,151,"Indiana","Steuben County",5,2,355,179,176
050,18,151,"Indiana","Steuben County",5,3,366,190,176
050,18,151,"Indiana","Steuben County",5,4,375,185,190
050,18,151,"Indiana","Steuben County",5,5,364,182,182
050,18,151,"Indiana","Steuben County",5,6,393,209,184
050,18,151,"Indiana","Steuben County",5,7,406,227,179
050,18,151,"Indiana","Steuben County",5,8,402,231,171
050,18,151,"Indiana","Steuben County",5,9,372,196,176
050,18,151,"Indiana","Steuben County",5,10,373,188,185
050,18,151,"Indiana","Steuben County",5,11,357,169,188
050,18,151,"Indiana","Steuben County",5,12,379,190,189
050,18,151,"Indiana","Steuben County",5,13,373,185,188
050,18,151,"Indiana","Steuben County",5,14,382,187,195
050,18,151,"Indiana","Steuben County",5,15,401,216,185
050,18,151,"Indiana","Steuben County",5,16,413,222,191
050,18,151,"Indiana","Steuben County",5,17,416,217,199
050,18,151,"Indiana","Steuben County",5,18,525,289,236
050,18,151,"Indiana","Steuben County",5,19,793,521,272
050,18,151,"Indiana","Steuben County",5,20,711,456,255
050,18,151,"Indiana","Steuben County",5,21,554,336,218
050,18,151,"Indiana","Steuben County",5,22,530,316,214
050,18,151,"Indiana","Steuben County",5,23,385,197,188
050,18,151,"Indiana","Steuben County",5,24,330,161,169
050,18,151,"Indiana","Steuben County",5,25,359,185,174
050,18,151,"Indiana","Steuben County",5,26,349,184,165
050,18,151,"Indiana","Steuben County",5,27,337,169,168
050,18,151,"Indiana","Steuben County",5,28,337,170,167
050,18,151,"Indiana","Steuben County",5,29,369,199,170
050,18,151,"Indiana","Steuben County",5,30,353,185,168
050,18,151,"Indiana","Steuben County",5,31,372,189,183
050,18,151,"Indiana","Steuben County",5,32,384,184,200
050,18,151,"Indiana","Steuben County",5,33,400,200,200
050,18,151,"Indiana","Steuben County",5,34,361,184,177
050,18,151,"Indiana","Steuben County",5,35,393,205,188
050,18,151,"Indiana","Steuben County",5,36,374,187,187
050,18,151,"Indiana","Steuben County",5,37,347,163,184
050,18,151,"Indiana","Steuben County",5,38,339,173,166
050,18,151,"Indiana","Steuben County",5,39,331,167,164
050,18,151,"Indiana","Steuben County",5,40,363,182,181
050,18,151,"Indiana","Steuben County",5,41,370,200,170
050,18,151,"Indiana","Steuben County",5,42,355,195,160
050,18,151,"Indiana","Steuben County",5,43,364,190,174
050,18,151,"Indiana","Steuben County",5,44,346,173,173
050,18,151,"Indiana","Steuben County",5,45,342,166,176
050,18,151,"Indiana","Steuben County",5,46,372,187,185
050,18,151,"Indiana","Steuben County",5,47,359,185,174
050,18,151,"Indiana","Steuben County",5,48,371,187,184
050,18,151,"Indiana","Steuben County",5,49,382,193,189
050,18,151,"Indiana","Steuben County",5,50,408,199,209
050,18,151,"Indiana","Steuben County",5,51,436,221,215
050,18,151,"Indiana","Steuben County",5,52,475,249,226
050,18,151,"Indiana","Steuben County",5,53,455,225,230
050,18,151,"Indiana","Steuben County",5,54,441,237,204
050,18,151,"Indiana","Steuben County",5,55,440,225,215
050,18,151,"Indiana","Steuben County",5,56,452,228,224
050,18,151,"Indiana","Steuben County",5,57,483,251,232
050,18,151,"Indiana","Steuben County",5,58,551,293,258
050,18,151,"Indiana","Steuben County",5,59,527,264,263
050,18,151,"Indiana","Steuben County",5,60,518,267,251
050,18,151,"Indiana","Steuben County",5,61,529,267,262
050,18,151,"Indiana","Steuben County",5,62,527,272,255
050,18,151,"Indiana","Steuben County",5,63,544,285,259
050,18,151,"Indiana","Steuben County",5,64,543,266,277
050,18,151,"Indiana","Steuben County",5,65,537,266,271
050,18,151,"Indiana","Steuben County",5,66,533,259,274
050,18,151,"Indiana","Steuben County",5,67,508,239,269
050,18,151,"Indiana","Steuben County",5,68,532,279,253
050,18,151,"Indiana","Steuben County",5,69,503,259,244
050,18,151,"Indiana","Steuben County",5,70,482,241,241
050,18,151,"Indiana","Steuben County",5,71,450,215,235
050,18,151,"Indiana","Steuben County",5,72,429,190,239
050,18,151,"Indiana","Steuben County",5,73,411,185,226
050,18,151,"Indiana","Steuben County",5,74,396,205,191
050,18,151,"Indiana","Steuben County",5,75,366,183,183
050,18,151,"Indiana","Steuben County",5,76,391,188,203
050,18,151,"Indiana","Steuben County",5,77,248,120,128
050,18,151,"Indiana","Steuben County",5,78,242,118,124
050,18,151,"Indiana","Steuben County",5,79,233,109,124
050,18,151,"Indiana","Steuben County",5,80,243,120,123
050,18,151,"Indiana","Steuben County",5,81,207,98,109
050,18,151,"Indiana","Steuben County",5,82,159,76,83
050,18,151,"Indiana","Steuben County",5,83,136,63,73
050,18,151,"Indiana","Steuben County",5,84,142,67,75
050,18,151,"Indiana","Steuben County",5,85,777,300,477
050,18,153,"Indiana","Sullivan County",1,0,209,106,103
050,18,153,"Indiana","Sullivan County",1,1,208,109,99
050,18,153,"Indiana","Sullivan County",1,2,218,120,98
050,18,153,"Indiana","Sullivan County",1,3,214,118,96
050,18,153,"Indiana","Sullivan County",1,4,201,107,94
050,18,153,"Indiana","Sullivan County",1,5,238,128,110
050,18,153,"Indiana","Sullivan County",1,6,221,112,109
050,18,153,"Indiana","Sullivan County",1,7,223,121,102
050,18,153,"Indiana","Sullivan County",1,8,235,122,113
050,18,153,"Indiana","Sullivan County",1,9,205,113,92
050,18,153,"Indiana","Sullivan County",1,10,212,112,100
050,18,153,"Indiana","Sullivan County",1,11,215,114,101
050,18,153,"Indiana","Sullivan County",1,12,228,120,108
050,18,153,"Indiana","Sullivan County",1,13,228,117,111
050,18,153,"Indiana","Sullivan County",1,14,221,110,111
050,18,153,"Indiana","Sullivan County",1,15,242,129,113
050,18,153,"Indiana","Sullivan County",1,16,248,127,121
050,18,153,"Indiana","Sullivan County",1,17,267,158,109
050,18,153,"Indiana","Sullivan County",1,18,246,152,94
050,18,153,"Indiana","Sullivan County",1,19,211,127,84
050,18,153,"Indiana","Sullivan County",1,20,213,132,81
050,18,153,"Indiana","Sullivan County",1,21,230,145,85
050,18,153,"Indiana","Sullivan County",1,22,250,158,92
050,18,153,"Indiana","Sullivan County",1,23,263,163,100
050,18,153,"Indiana","Sullivan County",1,24,280,173,107
050,18,153,"Indiana","Sullivan County",1,25,293,181,112
050,18,153,"Indiana","Sullivan County",1,26,262,167,95
050,18,153,"Indiana","Sullivan County",1,27,300,193,107
050,18,153,"Indiana","Sullivan County",1,28,318,191,127
050,18,153,"Indiana","Sullivan County",1,29,320,194,126
050,18,153,"Indiana","Sullivan County",1,30,292,172,120
050,18,153,"Indiana","Sullivan County",1,31,298,192,106
050,18,153,"Indiana","Sullivan County",1,32,285,183,102
050,18,153,"Indiana","Sullivan County",1,33,260,156,104
050,18,153,"Indiana","Sullivan County",1,34,279,169,110
050,18,153,"Indiana","Sullivan County",1,35,280,171,109
050,18,153,"Indiana","Sullivan County",1,36,262,158,104
050,18,153,"Indiana","Sullivan County",1,37,271,161,110
050,18,153,"Indiana","Sullivan County",1,38,280,173,107
050,18,153,"Indiana","Sullivan County",1,39,288,171,117
050,18,153,"Indiana","Sullivan County",1,40,274,155,119
050,18,153,"Indiana","Sullivan County",1,41,292,176,116
050,18,153,"Indiana","Sullivan County",1,42,288,173,115
050,18,153,"Indiana","Sullivan County",1,43,282,161,121
050,18,153,"Indiana","Sullivan County",1,44,279,162,117
050,18,153,"Indiana","Sullivan County",1,45,273,159,114
050,18,153,"Indiana","Sullivan County",1,46,291,173,118
050,18,153,"Indiana","Sullivan County",1,47,297,174,123
050,18,153,"Indiana","Sullivan County",1,48,287,167,120
050,18,153,"Indiana","Sullivan County",1,49,296,176,120
050,18,153,"Indiana","Sullivan County",1,50,271,163,108
050,18,153,"Indiana","Sullivan County",1,51,267,152,115
050,18,153,"Indiana","Sullivan County",1,52,283,156,127
050,18,153,"Indiana","Sullivan County",1,53,281,155,126
050,18,153,"Indiana","Sullivan County",1,54,279,145,134
050,18,153,"Indiana","Sullivan County",1,55,290,149,141
050,18,153,"Indiana","Sullivan County",1,56,283,143,140
050,18,153,"Indiana","Sullivan County",1,57,274,135,139
050,18,153,"Indiana","Sullivan County",1,58,294,153,141
050,18,153,"Indiana","Sullivan County",1,59,288,144,144
050,18,153,"Indiana","Sullivan County",1,60,282,147,135
050,18,153,"Indiana","Sullivan County",1,61,261,135,126
050,18,153,"Indiana","Sullivan County",1,62,260,135,125
050,18,153,"Indiana","Sullivan County",1,63,287,146,141
050,18,153,"Indiana","Sullivan County",1,64,275,135,140
050,18,153,"Indiana","Sullivan County",1,65,254,127,127
050,18,153,"Indiana","Sullivan County",1,66,252,144,108
050,18,153,"Indiana","Sullivan County",1,67,249,130,119
050,18,153,"Indiana","Sullivan County",1,68,231,114,117
050,18,153,"Indiana","Sullivan County",1,69,213,97,116
050,18,153,"Indiana","Sullivan County",1,70,208,89,119
050,18,153,"Indiana","Sullivan County",1,71,227,111,116
050,18,153,"Indiana","Sullivan County",1,72,213,103,110
050,18,153,"Indiana","Sullivan County",1,73,229,108,121
050,18,153,"Indiana","Sullivan County",1,74,161,75,86
050,18,153,"Indiana","Sullivan County",1,75,164,80,84
050,18,153,"Indiana","Sullivan County",1,76,155,68,87
050,18,153,"Indiana","Sullivan County",1,77,141,58,83
050,18,153,"Indiana","Sullivan County",1,78,129,60,69
050,18,153,"Indiana","Sullivan County",1,79,99,41,58
050,18,153,"Indiana","Sullivan County",1,80,99,42,57
050,18,153,"Indiana","Sullivan County",1,81,82,33,49
050,18,153,"Indiana","Sullivan County",1,82,80,29,51
050,18,153,"Indiana","Sullivan County",1,83,75,24,51
050,18,153,"Indiana","Sullivan County",1,84,70,30,40
050,18,153,"Indiana","Sullivan County",1,85,432,150,282
050,18,153,"Indiana","Sullivan County",2,0,203,98,105
050,18,153,"Indiana","Sullivan County",2,1,206,107,99
050,18,153,"Indiana","Sullivan County",2,2,215,118,97
050,18,153,"Indiana","Sullivan County",2,3,212,118,94
050,18,153,"Indiana","Sullivan County",2,4,206,110,96
050,18,153,"Indiana","Sullivan County",2,5,230,123,107
050,18,153,"Indiana","Sullivan County",2,6,226,117,109
050,18,153,"Indiana","Sullivan County",2,7,223,118,105
050,18,153,"Indiana","Sullivan County",2,8,230,121,109
050,18,153,"Indiana","Sullivan County",2,9,211,114,97
050,18,153,"Indiana","Sullivan County",2,10,210,112,98
050,18,153,"Indiana","Sullivan County",2,11,211,112,99
050,18,153,"Indiana","Sullivan County",2,12,227,120,107
050,18,153,"Indiana","Sullivan County",2,13,228,118,110
050,18,153,"Indiana","Sullivan County",2,14,222,112,110
050,18,153,"Indiana","Sullivan County",2,15,239,126,113
050,18,153,"Indiana","Sullivan County",2,16,249,130,119
050,18,153,"Indiana","Sullivan County",2,17,272,161,111
050,18,153,"Indiana","Sullivan County",2,18,238,147,91
050,18,153,"Indiana","Sullivan County",2,19,209,127,82
050,18,153,"Indiana","Sullivan County",2,20,219,135,84
050,18,153,"Indiana","Sullivan County",2,21,228,142,86
050,18,153,"Indiana","Sullivan County",2,22,251,159,92
050,18,153,"Indiana","Sullivan County",2,23,266,165,101
050,18,153,"Indiana","Sullivan County",2,24,283,176,107
050,18,153,"Indiana","Sullivan County",2,25,291,178,113
050,18,153,"Indiana","Sullivan County",2,26,270,171,99
050,18,153,"Indiana","Sullivan County",2,27,298,194,104
050,18,153,"Indiana","Sullivan County",2,28,312,191,121
050,18,153,"Indiana","Sullivan County",2,29,317,191,126
050,18,153,"Indiana","Sullivan County",2,30,294,174,120
050,18,153,"Indiana","Sullivan County",2,31,302,192,110
050,18,153,"Indiana","Sullivan County",2,32,283,181,102
050,18,153,"Indiana","Sullivan County",2,33,265,162,103
050,18,153,"Indiana","Sullivan County",2,34,271,163,108
050,18,153,"Indiana","Sullivan County",2,35,280,171,109
050,18,153,"Indiana","Sullivan County",2,36,264,159,105
050,18,153,"Indiana","Sullivan County",2,37,271,162,109
050,18,153,"Indiana","Sullivan County",2,38,281,172,109
050,18,153,"Indiana","Sullivan County",2,39,284,169,115
050,18,153,"Indiana","Sullivan County",2,40,277,158,119
050,18,153,"Indiana","Sullivan County",2,41,292,175,117
050,18,153,"Indiana","Sullivan County",2,42,289,175,114
050,18,153,"Indiana","Sullivan County",2,43,277,158,119
050,18,153,"Indiana","Sullivan County",2,44,280,164,116
050,18,153,"Indiana","Sullivan County",2,45,274,158,116
050,18,153,"Indiana","Sullivan County",2,46,287,171,116
050,18,153,"Indiana","Sullivan County",2,47,296,174,122
050,18,153,"Indiana","Sullivan County",2,48,288,169,119
050,18,153,"Indiana","Sullivan County",2,49,294,173,121
050,18,153,"Indiana","Sullivan County",2,50,277,165,112
050,18,153,"Indiana","Sullivan County",2,51,267,154,113
050,18,153,"Indiana","Sullivan County",2,52,278,155,123
050,18,153,"Indiana","Sullivan County",2,53,282,154,128
050,18,153,"Indiana","Sullivan County",2,54,277,145,132
050,18,153,"Indiana","Sullivan County",2,55,285,148,137
050,18,153,"Indiana","Sullivan County",2,56,284,144,140
050,18,153,"Indiana","Sullivan County",2,57,280,139,141
050,18,153,"Indiana","Sullivan County",2,58,292,151,141
050,18,153,"Indiana","Sullivan County",2,59,288,146,142
050,18,153,"Indiana","Sullivan County",2,60,282,146,136
050,18,153,"Indiana","Sullivan County",2,61,264,136,128
050,18,153,"Indiana","Sullivan County",2,62,261,135,126
050,18,153,"Indiana","Sullivan County",2,63,282,144,138
050,18,153,"Indiana","Sullivan County",2,64,276,136,140
050,18,153,"Indiana","Sullivan County",2,65,258,129,129
050,18,153,"Indiana","Sullivan County",2,66,252,140,112
050,18,153,"Indiana","Sullivan County",2,67,245,131,114
050,18,153,"Indiana","Sullivan County",2,68,234,117,117
050,18,153,"Indiana","Sullivan County",2,69,219,102,117
050,18,153,"Indiana","Sullivan County",2,70,210,91,119
050,18,153,"Indiana","Sullivan County",2,71,223,105,118
050,18,153,"Indiana","Sullivan County",2,72,210,103,107
050,18,153,"Indiana","Sullivan County",2,73,236,113,123
050,18,153,"Indiana","Sullivan County",2,74,163,77,86
050,18,153,"Indiana","Sullivan County",2,75,163,79,84
050,18,153,"Indiana","Sullivan County",2,76,154,70,84
050,18,153,"Indiana","Sullivan County",2,77,145,60,85
050,18,153,"Indiana","Sullivan County",2,78,129,58,71
050,18,153,"Indiana","Sullivan County",2,79,102,45,57
050,18,153,"Indiana","Sullivan County",2,80,100,43,57
050,18,153,"Indiana","Sullivan County",2,81,82,32,50
050,18,153,"Indiana","Sullivan County",2,82,83,31,52
050,18,153,"Indiana","Sullivan County",2,83,74,25,49
050,18,153,"Indiana","Sullivan County",2,84,72,30,42
050,18,153,"Indiana","Sullivan County",2,85,432,150,282
050,18,153,"Indiana","Sullivan County",3,0,212,114,98
050,18,153,"Indiana","Sullivan County",3,1,200,92,108
050,18,153,"Indiana","Sullivan County",3,2,199,96,103
050,18,153,"Indiana","Sullivan County",3,3,214,114,100
050,18,153,"Indiana","Sullivan County",3,4,208,112,96
050,18,153,"Indiana","Sullivan County",3,5,198,109,89
050,18,153,"Indiana","Sullivan County",3,6,221,113,108
050,18,153,"Indiana","Sullivan County",3,7,220,110,110
050,18,153,"Indiana","Sullivan County",3,8,227,119,108
050,18,153,"Indiana","Sullivan County",3,9,234,125,109
050,18,153,"Indiana","Sullivan County",3,10,208,112,96
050,18,153,"Indiana","Sullivan County",3,11,217,115,102
050,18,153,"Indiana","Sullivan County",3,12,206,107,99
050,18,153,"Indiana","Sullivan County",3,13,235,129,106
050,18,153,"Indiana","Sullivan County",3,14,206,113,93
050,18,153,"Indiana","Sullivan County",3,15,235,120,115
050,18,153,"Indiana","Sullivan County",3,16,228,122,106
050,18,153,"Indiana","Sullivan County",3,17,279,161,118
050,18,153,"Indiana","Sullivan County",3,18,225,136,89
050,18,153,"Indiana","Sullivan County",3,19,194,122,72
050,18,153,"Indiana","Sullivan County",3,20,219,139,80
050,18,153,"Indiana","Sullivan County",3,21,231,138,93
050,18,153,"Indiana","Sullivan County",3,22,243,153,90
050,18,153,"Indiana","Sullivan County",3,23,271,172,99
050,18,153,"Indiana","Sullivan County",3,24,275,174,101
050,18,153,"Indiana","Sullivan County",3,25,278,173,105
050,18,153,"Indiana","Sullivan County",3,26,274,164,110
050,18,153,"Indiana","Sullivan County",3,27,313,209,104
050,18,153,"Indiana","Sullivan County",3,28,315,208,107
050,18,153,"Indiana","Sullivan County",3,29,312,191,121
050,18,153,"Indiana","Sullivan County",3,30,303,179,124
050,18,153,"Indiana","Sullivan County",3,31,315,195,120
050,18,153,"Indiana","Sullivan County",3,32,302,189,113
050,18,153,"Indiana","Sullivan County",3,33,287,185,102
050,18,153,"Indiana","Sullivan County",3,34,270,161,109
050,18,153,"Indiana","Sullivan County",3,35,268,162,106
050,18,153,"Indiana","Sullivan County",3,36,277,167,110
050,18,153,"Indiana","Sullivan County",3,37,285,172,113
050,18,153,"Indiana","Sullivan County",3,38,275,170,105
050,18,153,"Indiana","Sullivan County",3,39,277,162,115
050,18,153,"Indiana","Sullivan County",3,40,273,156,117
050,18,153,"Indiana","Sullivan County",3,41,303,183,120
050,18,153,"Indiana","Sullivan County",3,42,304,186,118
050,18,153,"Indiana","Sullivan County",3,43,263,155,108
050,18,153,"Indiana","Sullivan County",3,44,293,174,119
050,18,153,"Indiana","Sullivan County",3,45,274,153,121
050,18,153,"Indiana","Sullivan County",3,46,284,169,115
050,18,153,"Indiana","Sullivan County",3,47,277,162,115
050,18,153,"Indiana","Sullivan County",3,48,301,181,120
050,18,153,"Indiana","Sullivan County",3,49,283,164,119
050,18,153,"Indiana","Sullivan County",3,50,283,167,116
050,18,153,"Indiana","Sullivan County",3,51,269,157,112
050,18,153,"Indiana","Sullivan County",3,52,262,153,109
050,18,153,"Indiana","Sullivan County",3,53,282,152,130
050,18,153,"Indiana","Sullivan County",3,54,274,152,122
050,18,153,"Indiana","Sullivan County",3,55,271,143,128
050,18,153,"Indiana","Sullivan County",3,56,277,140,137
050,18,153,"Indiana","Sullivan County",3,57,283,144,139
050,18,153,"Indiana","Sullivan County",3,58,292,149,143
050,18,153,"Indiana","Sullivan County",3,59,286,143,143
050,18,153,"Indiana","Sullivan County",3,60,282,144,138
050,18,153,"Indiana","Sullivan County",3,61,273,138,135
050,18,153,"Indiana","Sullivan County",3,62,264,135,129
050,18,153,"Indiana","Sullivan County",3,63,258,132,126
050,18,153,"Indiana","Sullivan County",3,64,274,138,136
050,18,153,"Indiana","Sullivan County",3,65,274,134,140
050,18,153,"Indiana","Sullivan County",3,66,254,127,127
050,18,153,"Indiana","Sullivan County",3,67,246,136,110
050,18,153,"Indiana","Sullivan County",3,68,245,134,111
050,18,153,"Indiana","Sullivan County",3,69,232,118,114
050,18,153,"Indiana","Sullivan County",3,70,216,102,114
050,18,153,"Indiana","Sullivan County",3,71,205,87,118
050,18,153,"Indiana","Sullivan County",3,72,207,96,111
050,18,153,"Indiana","Sullivan County",3,73,203,98,105
050,18,153,"Indiana","Sullivan County",3,74,229,104,125
050,18,153,"Indiana","Sullivan County",3,75,149,70,79
050,18,153,"Indiana","Sullivan County",3,76,161,75,86
050,18,153,"Indiana","Sullivan County",3,77,138,64,74
050,18,153,"Indiana","Sullivan County",3,78,145,58,87
050,18,153,"Indiana","Sullivan County",3,79,118,55,63
050,18,153,"Indiana","Sullivan County",3,80,102,44,58
050,18,153,"Indiana","Sullivan County",3,81,87,35,52
050,18,153,"Indiana","Sullivan County",3,82,80,29,51
050,18,153,"Indiana","Sullivan County",3,83,68,22,46
050,18,153,"Indiana","Sullivan County",3,84,73,30,43
050,18,153,"Indiana","Sullivan County",3,85,404,148,256
050,18,153,"Indiana","Sullivan County",4,0,206,105,101
050,18,153,"Indiana","Sullivan County",4,1,214,114,100
050,18,153,"Indiana","Sullivan County",4,2,199,87,112
050,18,153,"Indiana","Sullivan County",4,3,201,101,100
050,18,153,"Indiana","Sullivan County",4,4,204,108,96
050,18,153,"Indiana","Sullivan County",4,5,200,102,98
050,18,153,"Indiana","Sullivan County",4,6,194,103,91
050,18,153,"Indiana","Sullivan County",4,7,213,115,98
050,18,153,"Indiana","Sullivan County",4,8,226,112,114
050,18,153,"Indiana","Sullivan County",4,9,220,118,102
050,18,153,"Indiana","Sullivan County",4,10,228,119,109
050,18,153,"Indiana","Sullivan County",4,11,204,112,92
050,18,153,"Indiana","Sullivan County",4,12,214,110,104
050,18,153,"Indiana","Sullivan County",4,13,206,111,95
050,18,153,"Indiana","Sullivan County",4,14,232,126,106
050,18,153,"Indiana","Sullivan County",4,15,207,113,94
050,18,153,"Indiana","Sullivan County",4,16,238,119,119
050,18,153,"Indiana","Sullivan County",4,17,267,164,103
050,18,153,"Indiana","Sullivan County",4,18,233,139,94
050,18,153,"Indiana","Sullivan County",4,19,185,118,67
050,18,153,"Indiana","Sullivan County",4,20,203,130,73
050,18,153,"Indiana","Sullivan County",4,21,224,142,82
050,18,153,"Indiana","Sullivan County",4,22,257,161,96
050,18,153,"Indiana","Sullivan County",4,23,255,160,95
050,18,153,"Indiana","Sullivan County",4,24,280,182,98
050,18,153,"Indiana","Sullivan County",4,25,280,176,104
050,18,153,"Indiana","Sullivan County",4,26,266,155,111
050,18,153,"Indiana","Sullivan County",4,27,305,192,113
050,18,153,"Indiana","Sullivan County",4,28,308,204,104
050,18,153,"Indiana","Sullivan County",4,29,304,201,103
050,18,153,"Indiana","Sullivan County",4,30,300,178,122
050,18,153,"Indiana","Sullivan County",4,31,312,190,122
050,18,153,"Indiana","Sullivan County",4,32,306,182,124
050,18,153,"Indiana","Sullivan County",4,33,299,181,118
050,18,153,"Indiana","Sullivan County",4,34,286,181,105
050,18,153,"Indiana","Sullivan County",4,35,271,155,116
050,18,153,"Indiana","Sullivan County",4,36,257,151,106
050,18,153,"Indiana","Sullivan County",4,37,278,167,111
050,18,153,"Indiana","Sullivan County",4,38,288,180,108
050,18,153,"Indiana","Sullivan County",4,39,257,154,103
050,18,153,"Indiana","Sullivan County",4,40,271,149,122
050,18,153,"Indiana","Sullivan County",4,41,297,180,117
050,18,153,"Indiana","Sullivan County",4,42,322,193,129
050,18,153,"Indiana","Sullivan County",4,43,273,162,111
050,18,153,"Indiana","Sullivan County",4,44,271,164,107
050,18,153,"Indiana","Sullivan County",4,45,278,160,118
050,18,153,"Indiana","Sullivan County",4,46,278,158,120
050,18,153,"Indiana","Sullivan County",4,47,277,164,113
050,18,153,"Indiana","Sullivan County",4,48,277,161,116
050,18,153,"Indiana","Sullivan County",4,49,292,168,124
050,18,153,"Indiana","Sullivan County",4,50,283,161,122
050,18,153,"Indiana","Sullivan County",4,51,275,159,116
050,18,153,"Indiana","Sullivan County",4,52,266,154,112
050,18,153,"Indiana","Sullivan County",4,53,263,147,116
050,18,153,"Indiana","Sullivan County",4,54,271,152,119
050,18,153,"Indiana","Sullivan County",4,55,275,149,126
050,18,153,"Indiana","Sullivan County",4,56,255,131,124
050,18,153,"Indiana","Sullivan County",4,57,279,139,140
050,18,153,"Indiana","Sullivan County",4,58,290,150,140
050,18,153,"Indiana","Sullivan County",4,59,290,145,145
050,18,153,"Indiana","Sullivan County",4,60,286,145,141
050,18,153,"Indiana","Sullivan County",4,61,277,140,137
050,18,153,"Indiana","Sullivan County",4,62,274,136,138
050,18,153,"Indiana","Sullivan County",4,63,260,131,129
050,18,153,"Indiana","Sullivan County",4,64,261,131,130
050,18,153,"Indiana","Sullivan County",4,65,266,133,133
050,18,153,"Indiana","Sullivan County",4,66,267,132,135
050,18,153,"Indiana","Sullivan County",4,67,250,123,127
050,18,153,"Indiana","Sullivan County",4,68,243,133,110
050,18,153,"Indiana","Sullivan County",4,69,240,129,111
050,18,153,"Indiana","Sullivan County",4,70,223,113,110
050,18,153,"Indiana","Sullivan County",4,71,213,102,111
050,18,153,"Indiana","Sullivan County",4,72,190,77,113
050,18,153,"Indiana","Sullivan County",4,73,200,92,108
050,18,153,"Indiana","Sullivan County",4,74,198,92,106
050,18,153,"Indiana","Sullivan County",4,75,220,100,120
050,18,153,"Indiana","Sullivan County",4,76,144,64,80
050,18,153,"Indiana","Sullivan County",4,77,149,69,80
050,18,153,"Indiana","Sullivan County",4,78,134,63,71
050,18,153,"Indiana","Sullivan County",4,79,134,55,79
050,18,153,"Indiana","Sullivan County",4,80,121,60,61
050,18,153,"Indiana","Sullivan County",4,81,86,34,52
050,18,153,"Indiana","Sullivan County",4,82,87,33,54
050,18,153,"Indiana","Sullivan County",4,83,72,24,48
050,18,153,"Indiana","Sullivan County",4,84,74,27,47
050,18,153,"Indiana","Sullivan County",4,85,392,144,248
050,18,153,"Indiana","Sullivan County",5,0,206,106,100
050,18,153,"Indiana","Sullivan County",5,1,217,112,105
050,18,153,"Indiana","Sullivan County",5,2,227,123,104
050,18,153,"Indiana","Sullivan County",5,3,185,83,102
050,18,153,"Indiana","Sullivan County",5,4,204,111,93
050,18,153,"Indiana","Sullivan County",5,5,205,106,99
050,18,153,"Indiana","Sullivan County",5,6,198,105,93
050,18,153,"Indiana","Sullivan County",5,7,207,114,93
050,18,153,"Indiana","Sullivan County",5,8,215,115,100
050,18,153,"Indiana","Sullivan County",5,9,221,108,113
050,18,153,"Indiana","Sullivan County",5,10,222,121,101
050,18,153,"Indiana","Sullivan County",5,11,226,123,103
050,18,153,"Indiana","Sullivan County",5,12,219,118,101
050,18,153,"Indiana","Sullivan County",5,13,217,115,102
050,18,153,"Indiana","Sullivan County",5,14,200,105,95
050,18,153,"Indiana","Sullivan County",5,15,237,127,110
050,18,153,"Indiana","Sullivan County",5,16,202,110,92
050,18,153,"Indiana","Sullivan County",5,17,277,158,119
050,18,153,"Indiana","Sullivan County",5,18,225,142,83
050,18,153,"Indiana","Sullivan County",5,19,195,118,77
050,18,153,"Indiana","Sullivan County",5,20,209,131,78
050,18,153,"Indiana","Sullivan County",5,21,220,140,80
050,18,153,"Indiana","Sullivan County",5,22,243,158,85
050,18,153,"Indiana","Sullivan County",5,23,283,170,113
050,18,153,"Indiana","Sullivan County",5,24,278,175,103
050,18,153,"Indiana","Sullivan County",5,25,276,168,108
050,18,153,"Indiana","Sullivan County",5,26,291,181,110
050,18,153,"Indiana","Sullivan County",5,27,281,178,103
050,18,153,"Indiana","Sullivan County",5,28,294,181,113
050,18,153,"Indiana","Sullivan County",5,29,313,198,115
050,18,153,"Indiana","Sullivan County",5,30,292,188,104
050,18,153,"Indiana","Sullivan County",5,31,323,197,126
050,18,153,"Indiana","Sullivan County",5,32,313,191,122
050,18,153,"Indiana","Sullivan County",5,33,305,185,120
050,18,153,"Indiana","Sullivan County",5,34,288,172,116
050,18,153,"Indiana","Sullivan County",5,35,278,174,104
050,18,153,"Indiana","Sullivan County",5,36,267,153,114
050,18,153,"Indiana","Sullivan County",5,37,267,157,110
050,18,153,"Indiana","Sullivan County",5,38,287,175,112
050,18,153,"Indiana","Sullivan County",5,39,273,164,109
050,18,153,"Indiana","Sullivan County",5,40,250,141,109
050,18,153,"Indiana","Sullivan County",5,41,291,168,123
050,18,153,"Indiana","Sullivan County",5,42,300,185,115
050,18,153,"Indiana","Sullivan County",5,43,292,167,125
050,18,153,"Indiana","Sullivan County",5,44,289,175,114
050,18,153,"Indiana","Sullivan County",5,45,258,150,108
050,18,153,"Indiana","Sullivan County",5,46,288,173,115
050,18,153,"Indiana","Sullivan County",5,47,282,154,128
050,18,153,"Indiana","Sullivan County",5,48,270,162,108
050,18,153,"Indiana","Sullivan County",5,49,277,158,119
050,18,153,"Indiana","Sullivan County",5,50,284,162,122
050,18,153,"Indiana","Sullivan County",5,51,278,156,122
050,18,153,"Indiana","Sullivan County",5,52,278,158,120
050,18,153,"Indiana","Sullivan County",5,53,273,154,119
050,18,153,"Indiana","Sullivan County",5,54,252,145,107
050,18,153,"Indiana","Sullivan County",5,55,279,158,121
050,18,153,"Indiana","Sullivan County",5,56,252,130,122
050,18,153,"Indiana","Sullivan County",5,57,252,129,123
050,18,153,"Indiana","Sullivan County",5,58,291,145,146
050,18,153,"Indiana","Sullivan County",5,59,282,141,141
050,18,153,"Indiana","Sullivan County",5,60,283,146,137
050,18,153,"Indiana","Sullivan County",5,61,278,136,142
050,18,153,"Indiana","Sullivan County",5,62,280,139,141
050,18,153,"Indiana","Sullivan County",5,63,273,132,141
050,18,153,"Indiana","Sullivan County",5,64,256,126,130
050,18,153,"Indiana","Sullivan County",5,65,256,127,129
050,18,153,"Indiana","Sullivan County",5,66,261,131,130
050,18,153,"Indiana","Sullivan County",5,67,261,127,134
050,18,153,"Indiana","Sullivan County",5,68,249,125,124
050,18,153,"Indiana","Sullivan County",5,69,238,129,109
050,18,153,"Indiana","Sullivan County",5,70,236,127,109
050,18,153,"Indiana","Sullivan County",5,71,217,113,104
050,18,153,"Indiana","Sullivan County",5,72,197,92,105
050,18,153,"Indiana","Sullivan County",5,73,187,76,111
050,18,153,"Indiana","Sullivan County",5,74,198,88,110
050,18,153,"Indiana","Sullivan County",5,75,184,86,98
050,18,153,"Indiana","Sullivan County",5,76,217,98,119
050,18,153,"Indiana","Sullivan County",5,77,127,57,70
050,18,153,"Indiana","Sullivan County",5,78,149,70,79
050,18,153,"Indiana","Sullivan County",5,79,123,60,63
050,18,153,"Indiana","Sullivan County",5,80,137,59,78
050,18,153,"Indiana","Sullivan County",5,81,104,50,54
050,18,153,"Indiana","Sullivan County",5,82,86,32,54
050,18,153,"Indiana","Sullivan County",5,83,78,30,48
050,18,153,"Indiana","Sullivan County",5,84,78,29,49
050,18,153,"Indiana","Sullivan County",5,85,400,146,254
050,18,155,"Indiana","Switzerland County",1,0,101,52,49
050,18,155,"Indiana","Switzerland County",1,1,102,53,49
050,18,155,"Indiana","Switzerland County",1,2,111,65,46
050,18,155,"Indiana","Switzerland County",1,3,101,56,45
050,18,155,"Indiana","Switzerland County",1,4,131,67,64
050,18,155,"Indiana","Switzerland County",1,5,131,64,67
050,18,155,"Indiana","Switzerland County",1,6,133,62,71
050,18,155,"Indiana","Switzerland County",1,7,122,63,59
050,18,155,"Indiana","Switzerland County",1,8,121,64,57
050,18,155,"Indiana","Switzerland County",1,9,138,74,64
050,18,155,"Indiana","Switzerland County",1,10,164,96,68
050,18,155,"Indiana","Switzerland County",1,11,155,88,67
050,18,155,"Indiana","Switzerland County",1,12,153,84,69
050,18,155,"Indiana","Switzerland County",1,13,151,78,73
050,18,155,"Indiana","Switzerland County",1,14,136,78,58
050,18,155,"Indiana","Switzerland County",1,15,131,76,55
050,18,155,"Indiana","Switzerland County",1,16,144,78,66
050,18,155,"Indiana","Switzerland County",1,17,145,79,66
050,18,155,"Indiana","Switzerland County",1,18,103,54,49
050,18,155,"Indiana","Switzerland County",1,19,91,49,42
050,18,155,"Indiana","Switzerland County",1,20,96,53,43
050,18,155,"Indiana","Switzerland County",1,21,94,51,43
050,18,155,"Indiana","Switzerland County",1,22,101,58,43
050,18,155,"Indiana","Switzerland County",1,23,93,56,37
050,18,155,"Indiana","Switzerland County",1,24,94,56,38
050,18,155,"Indiana","Switzerland County",1,25,98,51,47
050,18,155,"Indiana","Switzerland County",1,26,84,45,39
050,18,155,"Indiana","Switzerland County",1,27,108,56,52
050,18,155,"Indiana","Switzerland County",1,28,101,50,51
050,18,155,"Indiana","Switzerland County",1,29,116,62,54
050,18,155,"Indiana","Switzerland County",1,30,106,46,60
050,18,155,"Indiana","Switzerland County",1,31,110,48,62
050,18,155,"Indiana","Switzerland County",1,32,99,52,47
050,18,155,"Indiana","Switzerland County",1,33,98,48,50
050,18,155,"Indiana","Switzerland County",1,34,97,52,45
050,18,155,"Indiana","Switzerland County",1,35,112,54,58
050,18,155,"Indiana","Switzerland County",1,36,122,54,68
050,18,155,"Indiana","Switzerland County",1,37,123,61,62
050,18,155,"Indiana","Switzerland County",1,38,129,73,56
050,18,155,"Indiana","Switzerland County",1,39,114,61,53
050,18,155,"Indiana","Switzerland County",1,40,112,57,55
050,18,155,"Indiana","Switzerland County",1,41,126,64,62
050,18,155,"Indiana","Switzerland County",1,42,129,68,61
050,18,155,"Indiana","Switzerland County",1,43,117,58,59
050,18,155,"Indiana","Switzerland County",1,44,116,64,52
050,18,155,"Indiana","Switzerland County",1,45,113,59,54
050,18,155,"Indiana","Switzerland County",1,46,114,61,53
050,18,155,"Indiana","Switzerland County",1,47,116,62,54
050,18,155,"Indiana","Switzerland County",1,48,124,67,57
050,18,155,"Indiana","Switzerland County",1,49,127,74,53
050,18,155,"Indiana","Switzerland County",1,50,140,74,66
050,18,155,"Indiana","Switzerland County",1,51,137,68,69
050,18,155,"Indiana","Switzerland County",1,52,126,65,61
050,18,155,"Indiana","Switzerland County",1,53,153,81,72
050,18,155,"Indiana","Switzerland County",1,54,138,73,65
050,18,155,"Indiana","Switzerland County",1,55,146,69,77
050,18,155,"Indiana","Switzerland County",1,56,161,78,83
050,18,155,"Indiana","Switzerland County",1,57,159,76,83
050,18,155,"Indiana","Switzerland County",1,58,129,70,59
050,18,155,"Indiana","Switzerland County",1,59,150,75,75
050,18,155,"Indiana","Switzerland County",1,60,141,84,57
050,18,155,"Indiana","Switzerland County",1,61,154,79,75
050,18,155,"Indiana","Switzerland County",1,62,143,77,66
050,18,155,"Indiana","Switzerland County",1,63,146,83,63
050,18,155,"Indiana","Switzerland County",1,64,137,71,66
050,18,155,"Indiana","Switzerland County",1,65,121,57,64
050,18,155,"Indiana","Switzerland County",1,66,113,57,56
050,18,155,"Indiana","Switzerland County",1,67,126,72,54
050,18,155,"Indiana","Switzerland County",1,68,113,52,61
050,18,155,"Indiana","Switzerland County",1,69,102,57,45
050,18,155,"Indiana","Switzerland County",1,70,101,63,38
050,18,155,"Indiana","Switzerland County",1,71,95,50,45
050,18,155,"Indiana","Switzerland County",1,72,91,50,41
050,18,155,"Indiana","Switzerland County",1,73,104,53,51
050,18,155,"Indiana","Switzerland County",1,74,69,33,36
050,18,155,"Indiana","Switzerland County",1,75,83,36,47
050,18,155,"Indiana","Switzerland County",1,76,74,39,35
050,18,155,"Indiana","Switzerland County",1,77,75,38,37
050,18,155,"Indiana","Switzerland County",1,78,58,27,31
050,18,155,"Indiana","Switzerland County",1,79,50,24,26
050,18,155,"Indiana","Switzerland County",1,80,42,24,18
050,18,155,"Indiana","Switzerland County",1,81,46,28,18
050,18,155,"Indiana","Switzerland County",1,82,50,29,21
050,18,155,"Indiana","Switzerland County",1,83,56,23,33
050,18,155,"Indiana","Switzerland County",1,84,33,11,22
050,18,155,"Indiana","Switzerland County",1,85,145,51,94
050,18,155,"Indiana","Switzerland County",2,0,103,55,48
050,18,155,"Indiana","Switzerland County",2,1,102,54,48
050,18,155,"Indiana","Switzerland County",2,2,106,61,45
050,18,155,"Indiana","Switzerland County",2,3,102,58,44
050,18,155,"Indiana","Switzerland County",2,4,123,64,59
050,18,155,"Indiana","Switzerland County",2,5,130,63,67
050,18,155,"Indiana","Switzerland County",2,6,132,62,70
050,18,155,"Indiana","Switzerland County",2,7,123,62,61
050,18,155,"Indiana","Switzerland County",2,8,120,63,57
050,18,155,"Indiana","Switzerland County",2,9,133,72,61
050,18,155,"Indiana","Switzerland County",2,10,155,90,65
050,18,155,"Indiana","Switzerland County",2,11,156,90,66
050,18,155,"Indiana","Switzerland County",2,12,154,85,69
050,18,155,"Indiana","Switzerland County",2,13,150,80,70
050,18,155,"Indiana","Switzerland County",2,14,138,78,60
050,18,155,"Indiana","Switzerland County",2,15,129,74,55
050,18,155,"Indiana","Switzerland County",2,16,140,76,64
050,18,155,"Indiana","Switzerland County",2,17,144,78,66
050,18,155,"Indiana","Switzerland County",2,18,107,57,50
050,18,155,"Indiana","Switzerland County",2,19,89,48,41
050,18,155,"Indiana","Switzerland County",2,20,96,53,43
050,18,155,"Indiana","Switzerland County",2,21,96,52,44
050,18,155,"Indiana","Switzerland County",2,22,104,60,44
050,18,155,"Indiana","Switzerland County",2,23,95,57,38
050,18,155,"Indiana","Switzerland County",2,24,93,56,37
050,18,155,"Indiana","Switzerland County",2,25,96,51,45
050,18,155,"Indiana","Switzerland County",2,26,89,47,42
050,18,155,"Indiana","Switzerland County",2,27,103,54,49
050,18,155,"Indiana","Switzerland County",2,28,102,51,51
050,18,155,"Indiana","Switzerland County",2,29,113,60,53
050,18,155,"Indiana","Switzerland County",2,30,110,51,59
050,18,155,"Indiana","Switzerland County",2,31,109,48,61
050,18,155,"Indiana","Switzerland County",2,32,102,51,51
050,18,155,"Indiana","Switzerland County",2,33,98,50,48
050,18,155,"Indiana","Switzerland County",2,34,97,51,46
050,18,155,"Indiana","Switzerland County",2,35,109,54,55
050,18,155,"Indiana","Switzerland County",2,36,118,53,65
050,18,155,"Indiana","Switzerland County",2,37,123,59,64
050,18,155,"Indiana","Switzerland County",2,38,129,70,59
050,18,155,"Indiana","Switzerland County",2,39,116,63,53
050,18,155,"Indiana","Switzerland County",2,40,112,57,55
050,18,155,"Indiana","Switzerland County",2,41,120,61,59
050,18,155,"Indiana","Switzerland County",2,42,128,67,61
050,18,155,"Indiana","Switzerland County",2,43,122,61,61
050,18,155,"Indiana","Switzerland County",2,44,116,62,54
050,18,155,"Indiana","Switzerland County",2,45,115,61,54
050,18,155,"Indiana","Switzerland County",2,46,113,60,53
050,18,155,"Indiana","Switzerland County",2,47,114,61,53
050,18,155,"Indiana","Switzerland County",2,48,123,66,57
050,18,155,"Indiana","Switzerland County",2,49,128,74,54
050,18,155,"Indiana","Switzerland County",2,50,138,75,63
050,18,155,"Indiana","Switzerland County",2,51,137,68,69
050,18,155,"Indiana","Switzerland County",2,52,128,66,62
050,18,155,"Indiana","Switzerland County",2,53,148,77,71
050,18,155,"Indiana","Switzerland County",2,54,141,75,66
050,18,155,"Indiana","Switzerland County",2,55,143,69,74
050,18,155,"Indiana","Switzerland County",2,56,158,76,82
050,18,155,"Indiana","Switzerland County",2,57,159,76,83
050,18,155,"Indiana","Switzerland County",2,58,135,70,65
050,18,155,"Indiana","Switzerland County",2,59,146,75,71
050,18,155,"Indiana","Switzerland County",2,60,143,82,61
050,18,155,"Indiana","Switzerland County",2,61,150,80,70
050,18,155,"Indiana","Switzerland County",2,62,144,76,68
050,18,155,"Indiana","Switzerland County",2,63,146,82,64
050,18,155,"Indiana","Switzerland County",2,64,138,73,65
050,18,155,"Indiana","Switzerland County",2,65,125,60,65
050,18,155,"Indiana","Switzerland County",2,66,116,59,57
050,18,155,"Indiana","Switzerland County",2,67,122,69,53
050,18,155,"Indiana","Switzerland County",2,68,115,57,58
050,18,155,"Indiana","Switzerland County",2,69,106,57,49
050,18,155,"Indiana","Switzerland County",2,70,99,60,39
050,18,155,"Indiana","Switzerland County",2,71,98,54,44
050,18,155,"Indiana","Switzerland County",2,72,89,48,41
050,18,155,"Indiana","Switzerland County",2,73,105,55,50
050,18,155,"Indiana","Switzerland County",2,74,71,34,37
050,18,155,"Indiana","Switzerland County",2,75,81,36,45
050,18,155,"Indiana","Switzerland County",2,76,76,38,38
050,18,155,"Indiana","Switzerland County",2,77,77,40,37
050,18,155,"Indiana","Switzerland County",2,78,60,29,31
050,18,155,"Indiana","Switzerland County",2,79,52,25,27
050,18,155,"Indiana","Switzerland County",2,80,44,24,20
050,18,155,"Indiana","Switzerland County",2,81,44,27,17
050,18,155,"Indiana","Switzerland County",2,82,48,29,19
050,18,155,"Indiana","Switzerland County",2,83,55,25,30
050,18,155,"Indiana","Switzerland County",2,84,39,14,25
050,18,155,"Indiana","Switzerland County",2,85,147,52,95
050,18,155,"Indiana","Switzerland County",3,0,133,78,55
050,18,155,"Indiana","Switzerland County",3,1,111,55,56
050,18,155,"Indiana","Switzerland County",3,2,102,56,46
050,18,155,"Indiana","Switzerland County",3,3,113,60,53
050,18,155,"Indiana","Switzerland County",3,4,102,52,50
050,18,155,"Indiana","Switzerland County",3,5,122,64,58
050,18,155,"Indiana","Switzerland County",3,6,139,65,74
050,18,155,"Indiana","Switzerland County",3,7,137,69,68
050,18,155,"Indiana","Switzerland County",3,8,126,60,66
050,18,155,"Indiana","Switzerland County",3,9,126,66,60
050,18,155,"Indiana","Switzerland County",3,10,129,67,62
050,18,155,"Indiana","Switzerland County",3,11,148,85,63
050,18,155,"Indiana","Switzerland County",3,12,155,91,64
050,18,155,"Indiana","Switzerland County",3,13,159,89,70
050,18,155,"Indiana","Switzerland County",3,14,155,85,70
050,18,155,"Indiana","Switzerland County",3,15,138,76,62
050,18,155,"Indiana","Switzerland County",3,16,128,70,58
050,18,155,"Indiana","Switzerland County",3,17,141,78,63
050,18,155,"Indiana","Switzerland County",3,18,115,65,50
050,18,155,"Indiana","Switzerland County",3,19,88,47,41
050,18,155,"Indiana","Switzerland County",3,20,91,50,41
050,18,155,"Indiana","Switzerland County",3,21,103,54,49
050,18,155,"Indiana","Switzerland County",3,22,101,54,47
050,18,155,"Indiana","Switzerland County",3,23,103,56,47
050,18,155,"Indiana","Switzerland County",3,24,103,63,40
050,18,155,"Indiana","Switzerland County",3,25,95,54,41
050,18,155,"Indiana","Switzerland County",3,26,109,59,50
050,18,155,"Indiana","Switzerland County",3,27,94,54,40
050,18,155,"Indiana","Switzerland County",3,28,104,54,50
050,18,155,"Indiana","Switzerland County",3,29,95,47,48
050,18,155,"Indiana","Switzerland County",3,30,117,62,55
050,18,155,"Indiana","Switzerland County",3,31,111,47,64
050,18,155,"Indiana","Switzerland County",3,32,109,48,61
050,18,155,"Indiana","Switzerland County",3,33,106,54,52
050,18,155,"Indiana","Switzerland County",3,34,104,55,49
050,18,155,"Indiana","Switzerland County",3,35,108,57,51
050,18,155,"Indiana","Switzerland County",3,36,113,55,58
050,18,155,"Indiana","Switzerland County",3,37,123,55,68
050,18,155,"Indiana","Switzerland County",3,38,121,57,64
050,18,155,"Indiana","Switzerland County",3,39,126,69,57
050,18,155,"Indiana","Switzerland County",3,40,116,63,53
050,18,155,"Indiana","Switzerland County",3,41,114,59,55
050,18,155,"Indiana","Switzerland County",3,42,124,60,64
050,18,155,"Indiana","Switzerland County",3,43,131,73,58
050,18,155,"Indiana","Switzerland County",3,44,117,58,59
050,18,155,"Indiana","Switzerland County",3,45,115,61,54
050,18,155,"Indiana","Switzerland County",3,46,127,67,60
050,18,155,"Indiana","Switzerland County",3,47,115,62,53
050,18,155,"Indiana","Switzerland County",3,48,109,58,51
050,18,155,"Indiana","Switzerland County",3,49,124,64,60
050,18,155,"Indiana","Switzerland County",3,50,131,75,56
050,18,155,"Indiana","Switzerland County",3,51,144,81,63
050,18,155,"Indiana","Switzerland County",3,52,135,67,68
050,18,155,"Indiana","Switzerland County",3,53,127,66,61
050,18,155,"Indiana","Switzerland County",3,54,144,80,64
050,18,155,"Indiana","Switzerland County",3,55,148,81,67
050,18,155,"Indiana","Switzerland County",3,56,142,69,73
050,18,155,"Indiana","Switzerland County",3,57,158,76,82
050,18,155,"Indiana","Switzerland County",3,58,161,81,80
050,18,155,"Indiana","Switzerland County",3,59,136,72,64
050,18,155,"Indiana","Switzerland County",3,60,142,71,71
050,18,155,"Indiana","Switzerland County",3,61,142,83,59
050,18,155,"Indiana","Switzerland County",3,62,150,78,72
050,18,155,"Indiana","Switzerland County",3,63,143,74,69
050,18,155,"Indiana","Switzerland County",3,64,141,81,60
050,18,155,"Indiana","Switzerland County",3,65,134,73,61
050,18,155,"Indiana","Switzerland County",3,66,129,64,65
050,18,155,"Indiana","Switzerland County",3,67,113,56,57
050,18,155,"Indiana","Switzerland County",3,68,119,66,53
050,18,155,"Indiana","Switzerland County",3,69,110,55,55
050,18,155,"Indiana","Switzerland County",3,70,109,62,47
050,18,155,"Indiana","Switzerland County",3,71,102,62,40
050,18,155,"Indiana","Switzerland County",3,72,89,48,41
050,18,155,"Indiana","Switzerland County",3,73,90,48,42
050,18,155,"Indiana","Switzerland County",3,74,101,52,49
050,18,155,"Indiana","Switzerland County",3,75,69,34,35
050,18,155,"Indiana","Switzerland County",3,76,78,37,41
050,18,155,"Indiana","Switzerland County",3,77,71,31,40
050,18,155,"Indiana","Switzerland County",3,78,72,41,31
050,18,155,"Indiana","Switzerland County",3,79,58,28,30
050,18,155,"Indiana","Switzerland County",3,80,44,20,24
050,18,155,"Indiana","Switzerland County",3,81,43,24,19
050,18,155,"Indiana","Switzerland County",3,82,38,23,15
050,18,155,"Indiana","Switzerland County",3,83,41,24,17
050,18,155,"Indiana","Switzerland County",3,84,51,24,27
050,18,155,"Indiana","Switzerland County",3,85,169,61,108
050,18,155,"Indiana","Switzerland County",4,0,119,65,54
050,18,155,"Indiana","Switzerland County",4,1,139,80,59
050,18,155,"Indiana","Switzerland County",4,2,116,60,56
050,18,155,"Indiana","Switzerland County",4,3,111,66,45
050,18,155,"Indiana","Switzerland County",4,4,118,63,55
050,18,155,"Indiana","Switzerland County",4,5,103,52,51
050,18,155,"Indiana","Switzerland County",4,6,117,66,51
050,18,155,"Indiana","Switzerland County",4,7,131,59,72
050,18,155,"Indiana","Switzerland County",4,8,137,70,67
050,18,155,"Indiana","Switzerland County",4,9,131,59,72
050,18,155,"Indiana","Switzerland County",4,10,129,69,60
050,18,155,"Indiana","Switzerland County",4,11,134,74,60
050,18,155,"Indiana","Switzerland County",4,12,146,85,61
050,18,155,"Indiana","Switzerland County",4,13,150,88,62
050,18,155,"Indiana","Switzerland County",4,14,165,91,74
050,18,155,"Indiana","Switzerland County",4,15,148,79,69
050,18,155,"Indiana","Switzerland County",4,16,147,85,62
050,18,155,"Indiana","Switzerland County",4,17,126,73,53
050,18,155,"Indiana","Switzerland County",4,18,119,68,51
050,18,155,"Indiana","Switzerland County",4,19,89,50,39
050,18,155,"Indiana","Switzerland County",4,20,96,52,44
050,18,155,"Indiana","Switzerland County",4,21,95,50,45
050,18,155,"Indiana","Switzerland County",4,22,106,53,53
050,18,155,"Indiana","Switzerland County",4,23,112,67,45
050,18,155,"Indiana","Switzerland County",4,24,99,55,44
050,18,155,"Indiana","Switzerland County",4,25,100,60,40
050,18,155,"Indiana","Switzerland County",4,26,96,54,42
050,18,155,"Indiana","Switzerland County",4,27,103,55,48
050,18,155,"Indiana","Switzerland County",4,28,92,52,40
050,18,155,"Indiana","Switzerland County",4,29,98,51,47
050,18,155,"Indiana","Switzerland County",4,30,95,43,52
050,18,155,"Indiana","Switzerland County",4,31,131,70,61
050,18,155,"Indiana","Switzerland County",4,32,109,48,61
050,18,155,"Indiana","Switzerland County",4,33,117,48,69
050,18,155,"Indiana","Switzerland County",4,34,111,54,57
050,18,155,"Indiana","Switzerland County",4,35,108,60,48
050,18,155,"Indiana","Switzerland County",4,36,108,57,51
050,18,155,"Indiana","Switzerland County",4,37,114,55,59
050,18,155,"Indiana","Switzerland County",4,38,123,55,68
050,18,155,"Indiana","Switzerland County",4,39,122,56,66
050,18,155,"Indiana","Switzerland County",4,40,133,70,63
050,18,155,"Indiana","Switzerland County",4,41,122,65,57
050,18,155,"Indiana","Switzerland County",4,42,110,57,53
050,18,155,"Indiana","Switzerland County",4,43,129,63,66
050,18,155,"Indiana","Switzerland County",4,44,132,74,58
050,18,155,"Indiana","Switzerland County",4,45,121,59,62
050,18,155,"Indiana","Switzerland County",4,46,120,62,58
050,18,155,"Indiana","Switzerland County",4,47,129,70,59
050,18,155,"Indiana","Switzerland County",4,48,125,63,62
050,18,155,"Indiana","Switzerland County",4,49,111,58,53
050,18,155,"Indiana","Switzerland County",4,50,125,65,60
050,18,155,"Indiana","Switzerland County",4,51,134,75,59
050,18,155,"Indiana","Switzerland County",4,52,148,83,65
050,18,155,"Indiana","Switzerland County",4,53,140,67,73
050,18,155,"Indiana","Switzerland County",4,54,125,64,61
050,18,155,"Indiana","Switzerland County",4,55,147,85,62
050,18,155,"Indiana","Switzerland County",4,56,149,80,69
050,18,155,"Indiana","Switzerland County",4,57,148,75,73
050,18,155,"Indiana","Switzerland County",4,58,156,74,82
050,18,155,"Indiana","Switzerland County",4,59,158,79,79
050,18,155,"Indiana","Switzerland County",4,60,143,76,67
050,18,155,"Indiana","Switzerland County",4,61,142,75,67
050,18,155,"Indiana","Switzerland County",4,62,145,81,64
050,18,155,"Indiana","Switzerland County",4,63,152,77,75
050,18,155,"Indiana","Switzerland County",4,64,142,73,69
050,18,155,"Indiana","Switzerland County",4,65,145,83,62
050,18,155,"Indiana","Switzerland County",4,66,136,73,63
050,18,155,"Indiana","Switzerland County",4,67,134,67,67
050,18,155,"Indiana","Switzerland County",4,68,116,56,60
050,18,155,"Indiana","Switzerland County",4,69,117,64,53
050,18,155,"Indiana","Switzerland County",4,70,117,61,56
050,18,155,"Indiana","Switzerland County",4,71,111,62,49
050,18,155,"Indiana","Switzerland County",4,72,93,55,38
050,18,155,"Indiana","Switzerland County",4,73,84,44,40
050,18,155,"Indiana","Switzerland County",4,74,87,45,42
050,18,155,"Indiana","Switzerland County",4,75,99,52,47
050,18,155,"Indiana","Switzerland County",4,76,67,34,33
050,18,155,"Indiana","Switzerland County",4,77,70,30,40
050,18,155,"Indiana","Switzerland County",4,78,65,29,36
050,18,155,"Indiana","Switzerland County",4,79,73,42,31
050,18,155,"Indiana","Switzerland County",4,80,50,24,26
050,18,155,"Indiana","Switzerland County",4,81,42,20,22
050,18,155,"Indiana","Switzerland County",4,82,40,22,18
050,18,155,"Indiana","Switzerland County",4,83,36,22,14
050,18,155,"Indiana","Switzerland County",4,84,36,21,15
050,18,155,"Indiana","Switzerland County",4,85,195,74,121
050,18,155,"Indiana","Switzerland County",5,0,110,61,49
050,18,155,"Indiana","Switzerland County",5,1,122,70,52
050,18,155,"Indiana","Switzerland County",5,2,133,73,60
050,18,155,"Indiana","Switzerland County",5,3,111,56,55
050,18,155,"Indiana","Switzerland County",5,4,120,71,49
050,18,155,"Indiana","Switzerland County",5,5,114,63,51
050,18,155,"Indiana","Switzerland County",5,6,105,55,50
050,18,155,"Indiana","Switzerland County",5,7,124,67,57
050,18,155,"Indiana","Switzerland County",5,8,142,71,71
050,18,155,"Indiana","Switzerland County",5,9,139,74,65
050,18,155,"Indiana","Switzerland County",5,10,140,65,75
050,18,155,"Indiana","Switzerland County",5,11,122,63,59
050,18,155,"Indiana","Switzerland County",5,12,133,69,64
050,18,155,"Indiana","Switzerland County",5,13,152,89,63
050,18,155,"Indiana","Switzerland County",5,14,148,86,62
050,18,155,"Indiana","Switzerland County",5,15,163,84,79
050,18,155,"Indiana","Switzerland County",5,16,157,83,74
050,18,155,"Indiana","Switzerland County",5,17,132,69,63
050,18,155,"Indiana","Switzerland County",5,18,112,62,50
050,18,155,"Indiana","Switzerland County",5,19,88,48,40
050,18,155,"Indiana","Switzerland County",5,20,91,52,39
050,18,155,"Indiana","Switzerland County",5,21,94,49,45
050,18,155,"Indiana","Switzerland County",5,22,93,53,40
050,18,155,"Indiana","Switzerland County",5,23,94,45,49
050,18,155,"Indiana","Switzerland County",5,24,106,69,37
050,18,155,"Indiana","Switzerland County",5,25,115,60,55
050,18,155,"Indiana","Switzerland County",5,26,96,55,41
050,18,155,"Indiana","Switzerland County",5,27,95,55,40
050,18,155,"Indiana","Switzerland County",5,28,110,56,54
050,18,155,"Indiana","Switzerland County",5,29,91,53,38
050,18,155,"Indiana","Switzerland County",5,30,110,57,53
050,18,155,"Indiana","Switzerland County",5,31,104,48,56
050,18,155,"Indiana","Switzerland County",5,32,121,61,60
050,18,155,"Indiana","Switzerland County",5,33,113,52,61
050,18,155,"Indiana","Switzerland County",5,34,114,47,67
050,18,155,"Indiana","Switzerland County",5,35,110,54,56
050,18,155,"Indiana","Switzerland County",5,36,102,57,45
050,18,155,"Indiana","Switzerland County",5,37,109,57,52
050,18,155,"Indiana","Switzerland County",5,38,112,57,55
050,18,155,"Indiana","Switzerland County",5,39,124,53,71
050,18,155,"Indiana","Switzerland County",5,40,123,60,63
050,18,155,"Indiana","Switzerland County",5,41,136,71,65
050,18,155,"Indiana","Switzerland County",5,42,123,64,59
050,18,155,"Indiana","Switzerland County",5,43,118,63,55
050,18,155,"Indiana","Switzerland County",5,44,124,57,67
050,18,155,"Indiana","Switzerland County",5,45,127,71,56
050,18,155,"Indiana","Switzerland County",5,46,119,56,63
050,18,155,"Indiana","Switzerland County",5,47,119,60,59
050,18,155,"Indiana","Switzerland County",5,48,124,67,57
050,18,155,"Indiana","Switzerland County",5,49,123,64,59
050,18,155,"Indiana","Switzerland County",5,50,107,59,48
050,18,155,"Indiana","Switzerland County",5,51,120,62,58
050,18,155,"Indiana","Switzerland County",5,52,143,80,63
050,18,155,"Indiana","Switzerland County",5,53,152,79,73
050,18,155,"Indiana","Switzerland County",5,54,142,68,74
050,18,155,"Indiana","Switzerland County",5,55,127,71,56
050,18,155,"Indiana","Switzerland County",5,56,146,84,62
050,18,155,"Indiana","Switzerland County",5,57,152,78,74
050,18,155,"Indiana","Switzerland County",5,58,151,77,74
050,18,155,"Indiana","Switzerland County",5,59,154,71,83
050,18,155,"Indiana","Switzerland County",5,60,157,74,83
050,18,155,"Indiana","Switzerland County",5,61,145,80,65
050,18,155,"Indiana","Switzerland County",5,62,142,76,66
050,18,155,"Indiana","Switzerland County",5,63,140,80,60
050,18,155,"Indiana","Switzerland County",5,64,151,77,74
050,18,155,"Indiana","Switzerland County",5,65,139,72,67
050,18,155,"Indiana","Switzerland County",5,66,149,83,66
050,18,155,"Indiana","Switzerland County",5,67,137,74,63
050,18,155,"Indiana","Switzerland County",5,68,134,65,69
050,18,155,"Indiana","Switzerland County",5,69,107,50,57
050,18,155,"Indiana","Switzerland County",5,70,115,62,53
050,18,155,"Indiana","Switzerland County",5,71,118,60,58
050,18,155,"Indiana","Switzerland County",5,72,104,57,47
050,18,155,"Indiana","Switzerland County",5,73,93,55,38
050,18,155,"Indiana","Switzerland County",5,74,82,41,41
050,18,155,"Indiana","Switzerland County",5,75,86,45,41
050,18,155,"Indiana","Switzerland County",5,76,97,52,45
050,18,155,"Indiana","Switzerland County",5,77,63,31,32
050,18,155,"Indiana","Switzerland County",5,78,60,26,34
050,18,155,"Indiana","Switzerland County",5,79,66,31,35
050,18,155,"Indiana","Switzerland County",5,80,61,34,27
050,18,155,"Indiana","Switzerland County",5,81,49,24,25
050,18,155,"Indiana","Switzerland County",5,82,39,19,20
050,18,155,"Indiana","Switzerland County",5,83,42,23,19
050,18,155,"Indiana","Switzerland County",5,84,31,19,12
050,18,155,"Indiana","Switzerland County",5,85,211,85,126
050,18,157,"Indiana","Tippecanoe County",1,0,2032,1042,990
050,18,157,"Indiana","Tippecanoe County",1,1,2037,1023,1014
050,18,157,"Indiana","Tippecanoe County",1,2,2144,1084,1060
050,18,157,"Indiana","Tippecanoe County",1,3,2114,1105,1009
050,18,157,"Indiana","Tippecanoe County",1,4,2159,1115,1044
050,18,157,"Indiana","Tippecanoe County",1,5,2153,1087,1066
050,18,157,"Indiana","Tippecanoe County",1,6,2073,1022,1051
050,18,157,"Indiana","Tippecanoe County",1,7,2156,1086,1070
050,18,157,"Indiana","Tippecanoe County",1,8,2166,1128,1038
050,18,157,"Indiana","Tippecanoe County",1,9,2085,1075,1010
050,18,157,"Indiana","Tippecanoe County",1,10,2209,1119,1090
050,18,157,"Indiana","Tippecanoe County",1,11,2186,1109,1077
050,18,157,"Indiana","Tippecanoe County",1,12,2260,1153,1107
050,18,157,"Indiana","Tippecanoe County",1,13,2188,1083,1105
050,18,157,"Indiana","Tippecanoe County",1,14,2117,1068,1049
050,18,157,"Indiana","Tippecanoe County",1,15,2111,1091,1020
050,18,157,"Indiana","Tippecanoe County",1,16,2132,1092,1040
050,18,157,"Indiana","Tippecanoe County",1,17,2259,1177,1082
050,18,157,"Indiana","Tippecanoe County",1,18,3874,2019,1855
050,18,157,"Indiana","Tippecanoe County",1,19,8179,4541,3638
050,18,157,"Indiana","Tippecanoe County",1,20,8683,4865,3818
050,18,157,"Indiana","Tippecanoe County",1,21,7738,4211,3527
050,18,157,"Indiana","Tippecanoe County",1,22,6684,3994,2690
050,18,157,"Indiana","Tippecanoe County",1,23,4924,2806,2118
050,18,157,"Indiana","Tippecanoe County",1,24,3685,2092,1593
050,18,157,"Indiana","Tippecanoe County",1,25,3278,1705,1573
050,18,157,"Indiana","Tippecanoe County",1,26,3060,1646,1414
050,18,157,"Indiana","Tippecanoe County",1,27,2844,1501,1343
050,18,157,"Indiana","Tippecanoe County",1,28,2777,1433,1344
050,18,157,"Indiana","Tippecanoe County",1,29,2678,1385,1293
050,18,157,"Indiana","Tippecanoe County",1,30,2568,1316,1252
050,18,157,"Indiana","Tippecanoe County",1,31,2435,1291,1144
050,18,157,"Indiana","Tippecanoe County",1,32,2305,1214,1091
050,18,157,"Indiana","Tippecanoe County",1,33,2196,1134,1062
050,18,157,"Indiana","Tippecanoe County",1,34,2167,1106,1061
050,18,157,"Indiana","Tippecanoe County",1,35,2165,1130,1035
050,18,157,"Indiana","Tippecanoe County",1,36,2134,1126,1008
050,18,157,"Indiana","Tippecanoe County",1,37,2032,1027,1005
050,18,157,"Indiana","Tippecanoe County",1,38,2113,1104,1009
050,18,157,"Indiana","Tippecanoe County",1,39,2022,1028,994
050,18,157,"Indiana","Tippecanoe County",1,40,2102,1058,1044
050,18,157,"Indiana","Tippecanoe County",1,41,1984,995,989
050,18,157,"Indiana","Tippecanoe County",1,42,1991,983,1008
050,18,157,"Indiana","Tippecanoe County",1,43,1908,974,934
050,18,157,"Indiana","Tippecanoe County",1,44,1765,913,852
050,18,157,"Indiana","Tippecanoe County",1,45,1731,841,890
050,18,157,"Indiana","Tippecanoe County",1,46,1740,874,866
050,18,157,"Indiana","Tippecanoe County",1,47,1797,921,876
050,18,157,"Indiana","Tippecanoe County",1,48,1822,927,895
050,18,157,"Indiana","Tippecanoe County",1,49,1950,991,959
050,18,157,"Indiana","Tippecanoe County",1,50,1842,899,943
050,18,157,"Indiana","Tippecanoe County",1,51,1779,866,913
050,18,157,"Indiana","Tippecanoe County",1,52,1726,867,859
050,18,157,"Indiana","Tippecanoe County",1,53,1745,871,874
050,18,157,"Indiana","Tippecanoe County",1,54,1746,877,869
050,18,157,"Indiana","Tippecanoe County",1,55,1824,907,917
050,18,157,"Indiana","Tippecanoe County",1,56,1873,931,942
050,18,157,"Indiana","Tippecanoe County",1,57,1824,920,904
050,18,157,"Indiana","Tippecanoe County",1,58,1813,887,926
050,18,157,"Indiana","Tippecanoe County",1,59,1810,868,942
050,18,157,"Indiana","Tippecanoe County",1,60,1754,847,907
050,18,157,"Indiana","Tippecanoe County",1,61,1783,876,907
050,18,157,"Indiana","Tippecanoe County",1,62,1768,843,925
050,18,157,"Indiana","Tippecanoe County",1,63,1685,809,876
050,18,157,"Indiana","Tippecanoe County",1,64,1639,784,855
050,18,157,"Indiana","Tippecanoe County",1,65,1604,755,849
050,18,157,"Indiana","Tippecanoe County",1,66,1576,729,847
050,18,157,"Indiana","Tippecanoe County",1,67,1530,708,822
050,18,157,"Indiana","Tippecanoe County",1,68,1480,699,781
050,18,157,"Indiana","Tippecanoe County",1,69,1324,611,713
050,18,157,"Indiana","Tippecanoe County",1,70,1236,591,645
050,18,157,"Indiana","Tippecanoe County",1,71,1216,572,644
050,18,157,"Indiana","Tippecanoe County",1,72,1194,539,655
050,18,157,"Indiana","Tippecanoe County",1,73,1166,534,632
050,18,157,"Indiana","Tippecanoe County",1,74,830,367,463
050,18,157,"Indiana","Tippecanoe County",1,75,795,353,442
050,18,157,"Indiana","Tippecanoe County",1,76,797,383,414
050,18,157,"Indiana","Tippecanoe County",1,77,794,359,435
050,18,157,"Indiana","Tippecanoe County",1,78,669,303,366
050,18,157,"Indiana","Tippecanoe County",1,79,574,246,328
050,18,157,"Indiana","Tippecanoe County",1,80,556,242,314
050,18,157,"Indiana","Tippecanoe County",1,81,549,238,311
050,18,157,"Indiana","Tippecanoe County",1,82,465,206,259
050,18,157,"Indiana","Tippecanoe County",1,83,438,185,253
050,18,157,"Indiana","Tippecanoe County",1,84,415,176,239
050,18,157,"Indiana","Tippecanoe County",1,85,2524,900,1624
050,18,157,"Indiana","Tippecanoe County",2,0,2011,1023,988
050,18,157,"Indiana","Tippecanoe County",2,1,2030,1022,1008
050,18,157,"Indiana","Tippecanoe County",2,2,2116,1071,1045
050,18,157,"Indiana","Tippecanoe County",2,3,2112,1096,1016
050,18,157,"Indiana","Tippecanoe County",2,4,2146,1108,1038
050,18,157,"Indiana","Tippecanoe County",2,5,2154,1095,1059
050,18,157,"Indiana","Tippecanoe County",2,6,2096,1043,1053
050,18,157,"Indiana","Tippecanoe County",2,7,2137,1074,1063
050,18,157,"Indiana","Tippecanoe County",2,8,2150,1110,1040
050,18,157,"Indiana","Tippecanoe County",2,9,2106,1089,1017
050,18,157,"Indiana","Tippecanoe County",2,10,2183,1109,1074
050,18,157,"Indiana","Tippecanoe County",2,11,2188,1110,1078
050,18,157,"Indiana","Tippecanoe County",2,12,2242,1140,1102
050,18,157,"Indiana","Tippecanoe County",2,13,2198,1094,1104
050,18,157,"Indiana","Tippecanoe County",2,14,2137,1074,1063
050,18,157,"Indiana","Tippecanoe County",2,15,2117,1087,1030
050,18,157,"Indiana","Tippecanoe County",2,16,2142,1098,1044
050,18,157,"Indiana","Tippecanoe County",2,17,2231,1161,1070
050,18,157,"Indiana","Tippecanoe County",2,18,3839,1996,1843
050,18,157,"Indiana","Tippecanoe County",2,19,8151,4510,3641
050,18,157,"Indiana","Tippecanoe County",2,20,8789,4923,3866
050,18,157,"Indiana","Tippecanoe County",2,21,7730,4195,3535
050,18,157,"Indiana","Tippecanoe County",2,22,6641,3965,2676
050,18,157,"Indiana","Tippecanoe County",2,23,4927,2800,2127
050,18,157,"Indiana","Tippecanoe County",2,24,3658,2070,1588
050,18,157,"Indiana","Tippecanoe County",2,25,3243,1692,1551
050,18,157,"Indiana","Tippecanoe County",2,26,3046,1633,1413
050,18,157,"Indiana","Tippecanoe County",2,27,2819,1485,1334
050,18,157,"Indiana","Tippecanoe County",2,28,2759,1430,1329
050,18,157,"Indiana","Tippecanoe County",2,29,2682,1384,1298
050,18,157,"Indiana","Tippecanoe County",2,30,2586,1332,1254
050,18,157,"Indiana","Tippecanoe County",2,31,2439,1284,1155
050,18,157,"Indiana","Tippecanoe County",2,32,2323,1226,1097
050,18,157,"Indiana","Tippecanoe County",2,33,2207,1142,1065
050,18,157,"Indiana","Tippecanoe County",2,34,2165,1107,1058
050,18,157,"Indiana","Tippecanoe County",2,35,2168,1123,1045
050,18,157,"Indiana","Tippecanoe County",2,36,2123,1113,1010
050,18,157,"Indiana","Tippecanoe County",2,37,2067,1053,1014
050,18,157,"Indiana","Tippecanoe County",2,38,2103,1089,1014
050,18,157,"Indiana","Tippecanoe County",2,39,2036,1041,995
050,18,157,"Indiana","Tippecanoe County",2,40,2098,1060,1038
050,18,157,"Indiana","Tippecanoe County",2,41,2010,1010,1000
050,18,157,"Indiana","Tippecanoe County",2,42,1982,986,996
050,18,157,"Indiana","Tippecanoe County",2,43,1941,985,956
050,18,157,"Indiana","Tippecanoe County",2,44,1781,916,865
050,18,157,"Indiana","Tippecanoe County",2,45,1749,862,887
050,18,157,"Indiana","Tippecanoe County",2,46,1732,862,870
050,18,157,"Indiana","Tippecanoe County",2,47,1781,909,872
050,18,157,"Indiana","Tippecanoe County",2,48,1818,925,893
050,18,157,"Indiana","Tippecanoe County",2,49,1920,974,946
050,18,157,"Indiana","Tippecanoe County",2,50,1864,918,946
050,18,157,"Indiana","Tippecanoe County",2,51,1793,874,919
050,18,157,"Indiana","Tippecanoe County",2,52,1731,860,871
050,18,157,"Indiana","Tippecanoe County",2,53,1743,871,872
050,18,157,"Indiana","Tippecanoe County",2,54,1744,874,870
050,18,157,"Indiana","Tippecanoe County",2,55,1808,897,911
050,18,157,"Indiana","Tippecanoe County",2,56,1861,922,939
050,18,157,"Indiana","Tippecanoe County",2,57,1837,924,913
050,18,157,"Indiana","Tippecanoe County",2,58,1813,891,922
050,18,157,"Indiana","Tippecanoe County",2,59,1814,874,940
050,18,157,"Indiana","Tippecanoe County",2,60,1764,849,915
050,18,157,"Indiana","Tippecanoe County",2,61,1774,867,907
050,18,157,"Indiana","Tippecanoe County",2,62,1772,851,921
050,18,157,"Indiana","Tippecanoe County",2,63,1718,824,894
050,18,157,"Indiana","Tippecanoe County",2,64,1632,779,853
050,18,157,"Indiana","Tippecanoe County",2,65,1603,760,843
050,18,157,"Indiana","Tippecanoe County",2,66,1583,734,849
050,18,157,"Indiana","Tippecanoe County",2,67,1527,708,819
050,18,157,"Indiana","Tippecanoe County",2,68,1480,695,785
050,18,157,"Indiana","Tippecanoe County",2,69,1368,635,733
050,18,157,"Indiana","Tippecanoe County",2,70,1249,593,656
050,18,157,"Indiana","Tippecanoe County",2,71,1212,570,642
050,18,157,"Indiana","Tippecanoe County",2,72,1173,532,641
050,18,157,"Indiana","Tippecanoe County",2,73,1228,562,666
050,18,157,"Indiana","Tippecanoe County",2,74,857,382,475
050,18,157,"Indiana","Tippecanoe County",2,75,805,359,446
050,18,157,"Indiana","Tippecanoe County",2,76,787,372,415
050,18,157,"Indiana","Tippecanoe County",2,77,804,370,434
050,18,157,"Indiana","Tippecanoe County",2,78,682,309,373
050,18,157,"Indiana","Tippecanoe County",2,79,588,255,333
050,18,157,"Indiana","Tippecanoe County",2,80,562,245,317
050,18,157,"Indiana","Tippecanoe County",2,81,548,237,311
050,18,157,"Indiana","Tippecanoe County",2,82,479,213,266
050,18,157,"Indiana","Tippecanoe County",2,83,435,184,251
050,18,157,"Indiana","Tippecanoe County",2,84,417,176,241
050,18,157,"Indiana","Tippecanoe County",2,85,2523,907,1616
050,18,157,"Indiana","Tippecanoe County",3,0,2010,1028,982
050,18,157,"Indiana","Tippecanoe County",3,1,2029,1053,976
050,18,157,"Indiana","Tippecanoe County",3,2,2047,1012,1035
050,18,157,"Indiana","Tippecanoe County",3,3,2167,1100,1067
050,18,157,"Indiana","Tippecanoe County",3,4,2081,1083,998
050,18,157,"Indiana","Tippecanoe County",3,5,2181,1104,1077
050,18,157,"Indiana","Tippecanoe County",3,6,2156,1102,1054
050,18,157,"Indiana","Tippecanoe County",3,7,2119,1065,1054
050,18,157,"Indiana","Tippecanoe County",3,8,2133,1079,1054
050,18,157,"Indiana","Tippecanoe County",3,9,2155,1118,1037
050,18,157,"Indiana","Tippecanoe County",3,10,2065,1071,994
050,18,157,"Indiana","Tippecanoe County",3,11,2154,1091,1063
050,18,157,"Indiana","Tippecanoe County",3,12,2148,1074,1074
050,18,157,"Indiana","Tippecanoe County",3,13,2243,1142,1101
050,18,157,"Indiana","Tippecanoe County",3,14,2174,1089,1085
050,18,157,"Indiana","Tippecanoe County",3,15,2150,1095,1055
050,18,157,"Indiana","Tippecanoe County",3,16,2122,1100,1022
050,18,157,"Indiana","Tippecanoe County",3,17,2192,1136,1056
050,18,157,"Indiana","Tippecanoe County",3,18,3824,2015,1809
050,18,157,"Indiana","Tippecanoe County",3,19,8200,4544,3656
050,18,157,"Indiana","Tippecanoe County",3,20,8995,5047,3948
050,18,157,"Indiana","Tippecanoe County",3,21,7887,4286,3601
050,18,157,"Indiana","Tippecanoe County",3,22,6677,3993,2684
050,18,157,"Indiana","Tippecanoe County",3,23,4886,2737,2149
050,18,157,"Indiana","Tippecanoe County",3,24,3723,2098,1625
050,18,157,"Indiana","Tippecanoe County",3,25,3165,1688,1477
050,18,157,"Indiana","Tippecanoe County",3,26,2908,1558,1350
050,18,157,"Indiana","Tippecanoe County",3,27,2865,1510,1355
050,18,157,"Indiana","Tippecanoe County",3,28,2746,1433,1313
050,18,157,"Indiana","Tippecanoe County",3,29,2698,1418,1280
050,18,157,"Indiana","Tippecanoe County",3,30,2648,1360,1288
050,18,157,"Indiana","Tippecanoe County",3,31,2577,1337,1240
050,18,157,"Indiana","Tippecanoe County",3,32,2391,1242,1149
050,18,157,"Indiana","Tippecanoe County",3,33,2294,1197,1097
050,18,157,"Indiana","Tippecanoe County",3,34,2199,1160,1039
050,18,157,"Indiana","Tippecanoe County",3,35,2131,1086,1045
050,18,157,"Indiana","Tippecanoe County",3,36,2116,1093,1023
050,18,157,"Indiana","Tippecanoe County",3,37,2081,1077,1004
050,18,157,"Indiana","Tippecanoe County",3,38,2046,1057,989
050,18,157,"Indiana","Tippecanoe County",3,39,2080,1069,1011
050,18,157,"Indiana","Tippecanoe County",3,40,2031,1018,1013
050,18,157,"Indiana","Tippecanoe County",3,41,2050,1019,1031
050,18,157,"Indiana","Tippecanoe County",3,42,1991,996,995
050,18,157,"Indiana","Tippecanoe County",3,43,1975,968,1007
050,18,157,"Indiana","Tippecanoe County",3,44,1947,990,957
050,18,157,"Indiana","Tippecanoe County",3,45,1783,920,863
050,18,157,"Indiana","Tippecanoe County",3,46,1752,866,886
050,18,157,"Indiana","Tippecanoe County",3,47,1725,855,870
050,18,157,"Indiana","Tippecanoe County",3,48,1798,913,885
050,18,157,"Indiana","Tippecanoe County",3,49,1790,902,888
050,18,157,"Indiana","Tippecanoe County",3,50,1912,970,942
050,18,157,"Indiana","Tippecanoe County",3,51,1874,919,955
050,18,157,"Indiana","Tippecanoe County",3,52,1787,864,923
050,18,157,"Indiana","Tippecanoe County",3,53,1713,850,863
050,18,157,"Indiana","Tippecanoe County",3,54,1716,857,859
050,18,157,"Indiana","Tippecanoe County",3,55,1734,865,869
050,18,157,"Indiana","Tippecanoe County",3,56,1779,877,902
050,18,157,"Indiana","Tippecanoe County",3,57,1849,923,926
050,18,157,"Indiana","Tippecanoe County",3,58,1797,890,907
050,18,157,"Indiana","Tippecanoe County",3,59,1807,882,925
050,18,157,"Indiana","Tippecanoe County",3,60,1796,863,933
050,18,157,"Indiana","Tippecanoe County",3,61,1744,833,911
050,18,157,"Indiana","Tippecanoe County",3,62,1754,847,907
050,18,157,"Indiana","Tippecanoe County",3,63,1742,841,901
050,18,157,"Indiana","Tippecanoe County",3,64,1691,804,887
050,18,157,"Indiana","Tippecanoe County",3,65,1607,773,834
050,18,157,"Indiana","Tippecanoe County",3,66,1571,739,832
050,18,157,"Indiana","Tippecanoe County",3,67,1538,714,824
050,18,157,"Indiana","Tippecanoe County",3,68,1495,681,814
050,18,157,"Indiana","Tippecanoe County",3,69,1463,685,778
050,18,157,"Indiana","Tippecanoe County",3,70,1327,616,711
050,18,157,"Indiana","Tippecanoe County",3,71,1221,575,646
050,18,157,"Indiana","Tippecanoe County",3,72,1171,550,621
050,18,157,"Indiana","Tippecanoe County",3,73,1145,513,632
050,18,157,"Indiana","Tippecanoe County",3,74,1197,548,649
050,18,157,"Indiana","Tippecanoe County",3,75,817,355,462
050,18,157,"Indiana","Tippecanoe County",3,76,783,343,440
050,18,157,"Indiana","Tippecanoe County",3,77,757,350,407
050,18,157,"Indiana","Tippecanoe County",3,78,772,354,418
050,18,157,"Indiana","Tippecanoe County",3,79,642,285,357
050,18,157,"Indiana","Tippecanoe County",3,80,575,255,320
050,18,157,"Indiana","Tippecanoe County",3,81,526,222,304
050,18,157,"Indiana","Tippecanoe County",3,82,480,204,276
050,18,157,"Indiana","Tippecanoe County",3,83,452,197,255
050,18,157,"Indiana","Tippecanoe County",3,84,402,169,233
050,18,157,"Indiana","Tippecanoe County",3,85,2482,893,1589
050,18,157,"Indiana","Tippecanoe County",4,0,2027,1034,993
050,18,157,"Indiana","Tippecanoe County",4,1,2019,1026,993
050,18,157,"Indiana","Tippecanoe County",4,2,2063,1069,994
050,18,157,"Indiana","Tippecanoe County",4,3,2011,995,1016
050,18,157,"Indiana","Tippecanoe County",4,4,2154,1086,1068
050,18,157,"Indiana","Tippecanoe County",4,5,2075,1077,998
050,18,157,"Indiana","Tippecanoe County",4,6,2185,1110,1075
050,18,157,"Indiana","Tippecanoe County",4,7,2146,1105,1041
050,18,157,"Indiana","Tippecanoe County",4,8,2116,1078,1038
050,18,157,"Indiana","Tippecanoe County",4,9,2116,1071,1045
050,18,157,"Indiana","Tippecanoe County",4,10,2162,1126,1036
050,18,157,"Indiana","Tippecanoe County",4,11,2063,1061,1002
050,18,157,"Indiana","Tippecanoe County",4,12,2131,1068,1063
050,18,157,"Indiana","Tippecanoe County",4,13,2146,1076,1070
050,18,157,"Indiana","Tippecanoe County",4,14,2285,1174,1111
050,18,157,"Indiana","Tippecanoe County",4,15,2186,1100,1086
050,18,157,"Indiana","Tippecanoe County",4,16,2185,1122,1063
050,18,157,"Indiana","Tippecanoe County",4,17,2258,1223,1035
050,18,157,"Indiana","Tippecanoe County",4,18,3847,2053,1794
050,18,157,"Indiana","Tippecanoe County",4,19,8053,4489,3564
050,18,157,"Indiana","Tippecanoe County",4,20,8906,4986,3920
050,18,157,"Indiana","Tippecanoe County",4,21,8190,4406,3784
050,18,157,"Indiana","Tippecanoe County",4,22,6868,4095,2773
050,18,157,"Indiana","Tippecanoe County",4,23,4935,2786,2149
050,18,157,"Indiana","Tippecanoe County",4,24,3544,1958,1586
050,18,157,"Indiana","Tippecanoe County",4,25,3234,1728,1506
050,18,157,"Indiana","Tippecanoe County",4,26,2906,1561,1345
050,18,157,"Indiana","Tippecanoe County",4,27,2642,1396,1246
050,18,157,"Indiana","Tippecanoe County",4,28,2733,1416,1317
050,18,157,"Indiana","Tippecanoe County",4,29,2695,1417,1278
050,18,157,"Indiana","Tippecanoe County",4,30,2601,1378,1223
050,18,157,"Indiana","Tippecanoe County",4,31,2601,1356,1245
050,18,157,"Indiana","Tippecanoe County",4,32,2537,1305,1232
050,18,157,"Indiana","Tippecanoe County",4,33,2354,1205,1149
050,18,157,"Indiana","Tippecanoe County",4,34,2228,1147,1081
050,18,157,"Indiana","Tippecanoe County",4,35,2174,1139,1035
050,18,157,"Indiana","Tippecanoe County",4,36,2065,1053,1012
050,18,157,"Indiana","Tippecanoe County",4,37,2101,1076,1025
050,18,157,"Indiana","Tippecanoe County",4,38,2059,1066,993
050,18,157,"Indiana","Tippecanoe County",4,39,2059,1041,1018
050,18,157,"Indiana","Tippecanoe County",4,40,2072,1067,1005
050,18,157,"Indiana","Tippecanoe County",4,41,2011,1009,1002
050,18,157,"Indiana","Tippecanoe County",4,42,2029,1008,1021
050,18,157,"Indiana","Tippecanoe County",4,43,1959,977,982
050,18,157,"Indiana","Tippecanoe County",4,44,1972,969,1003
050,18,157,"Indiana","Tippecanoe County",4,45,1948,996,952
050,18,157,"Indiana","Tippecanoe County",4,46,1771,906,865
050,18,157,"Indiana","Tippecanoe County",4,47,1770,864,906
050,18,157,"Indiana","Tippecanoe County",4,48,1729,856,873
050,18,157,"Indiana","Tippecanoe County",4,49,1777,892,885
050,18,157,"Indiana","Tippecanoe County",4,50,1789,892,897
050,18,157,"Indiana","Tippecanoe County",4,51,1887,954,933
050,18,157,"Indiana","Tippecanoe County",4,52,1874,913,961
050,18,157,"Indiana","Tippecanoe County",4,53,1777,861,916
050,18,157,"Indiana","Tippecanoe County",4,54,1702,837,865
050,18,157,"Indiana","Tippecanoe County",4,55,1726,858,868
050,18,157,"Indiana","Tippecanoe County",4,56,1709,856,853
050,18,157,"Indiana","Tippecanoe County",4,57,1715,852,863
050,18,157,"Indiana","Tippecanoe County",4,58,1821,897,924
050,18,157,"Indiana","Tippecanoe County",4,59,1785,891,894
050,18,157,"Indiana","Tippecanoe County",4,60,1770,862,908
050,18,157,"Indiana","Tippecanoe County",4,61,1751,833,918
050,18,157,"Indiana","Tippecanoe County",4,62,1724,814,910
050,18,157,"Indiana","Tippecanoe County",4,63,1712,826,886
050,18,157,"Indiana","Tippecanoe County",4,64,1712,829,883
050,18,157,"Indiana","Tippecanoe County",4,65,1650,777,873
050,18,157,"Indiana","Tippecanoe County",4,66,1591,758,833
050,18,157,"Indiana","Tippecanoe County",4,67,1528,720,808
050,18,157,"Indiana","Tippecanoe County",4,68,1505,691,814
050,18,157,"Indiana","Tippecanoe County",4,69,1480,670,810
050,18,157,"Indiana","Tippecanoe County",4,70,1429,670,759
050,18,157,"Indiana","Tippecanoe County",4,71,1298,590,708
050,18,157,"Indiana","Tippecanoe County",4,72,1175,549,626
050,18,157,"Indiana","Tippecanoe County",4,73,1140,528,612
050,18,157,"Indiana","Tippecanoe County",4,74,1133,510,623
050,18,157,"Indiana","Tippecanoe County",4,75,1155,523,632
050,18,157,"Indiana","Tippecanoe County",4,76,792,344,448
050,18,157,"Indiana","Tippecanoe County",4,77,750,320,430
050,18,157,"Indiana","Tippecanoe County",4,78,741,344,397
050,18,157,"Indiana","Tippecanoe County",4,79,743,331,412
050,18,157,"Indiana","Tippecanoe County",4,80,637,286,351
050,18,157,"Indiana","Tippecanoe County",4,81,548,230,318
050,18,157,"Indiana","Tippecanoe County",4,82,480,196,284
050,18,157,"Indiana","Tippecanoe County",4,83,445,189,256
050,18,157,"Indiana","Tippecanoe County",4,84,414,179,235
050,18,157,"Indiana","Tippecanoe County",4,85,2451,891,1560
050,18,157,"Indiana","Tippecanoe County",5,0,2034,1040,994
050,18,157,"Indiana","Tippecanoe County",5,1,1942,998,944
050,18,157,"Indiana","Tippecanoe County",5,2,1985,995,990
050,18,157,"Indiana","Tippecanoe County",5,3,2016,1050,966
050,18,157,"Indiana","Tippecanoe County",5,4,2012,990,1022
050,18,157,"Indiana","Tippecanoe County",5,5,2086,1040,1046
050,18,157,"Indiana","Tippecanoe County",5,6,2078,1078,1000
050,18,157,"Indiana","Tippecanoe County",5,7,2186,1118,1068
050,18,157,"Indiana","Tippecanoe County",5,8,2150,1115,1035
050,18,157,"Indiana","Tippecanoe County",5,9,2113,1070,1043
050,18,157,"Indiana","Tippecanoe County",5,10,2130,1090,1040
050,18,157,"Indiana","Tippecanoe County",5,11,2144,1116,1028
050,18,157,"Indiana","Tippecanoe County",5,12,2069,1070,999
050,18,157,"Indiana","Tippecanoe County",5,13,2151,1079,1072
050,18,157,"Indiana","Tippecanoe County",5,14,2173,1101,1072
050,18,157,"Indiana","Tippecanoe County",5,15,2299,1172,1127
050,18,157,"Indiana","Tippecanoe County",5,16,2253,1154,1099
050,18,157,"Indiana","Tippecanoe County",5,17,2348,1248,1100
050,18,157,"Indiana","Tippecanoe County",5,18,3906,2125,1781
050,18,157,"Indiana","Tippecanoe County",5,19,8110,4536,3574
050,18,157,"Indiana","Tippecanoe County",5,20,8835,5000,3835
050,18,157,"Indiana","Tippecanoe County",5,21,8050,4354,3696
050,18,157,"Indiana","Tippecanoe County",5,22,7111,4210,2901
050,18,157,"Indiana","Tippecanoe County",5,23,5152,2954,2198
050,18,157,"Indiana","Tippecanoe County",5,24,3670,2063,1607
050,18,157,"Indiana","Tippecanoe County",5,25,2996,1535,1461
050,18,157,"Indiana","Tippecanoe County",5,26,2904,1575,1329
050,18,157,"Indiana","Tippecanoe County",5,27,2669,1413,1256
050,18,157,"Indiana","Tippecanoe County",5,28,2614,1360,1254
050,18,157,"Indiana","Tippecanoe County",5,29,2579,1351,1228
050,18,157,"Indiana","Tippecanoe County",5,30,2609,1382,1227
050,18,157,"Indiana","Tippecanoe County",5,31,2542,1342,1200
050,18,157,"Indiana","Tippecanoe County",5,32,2574,1329,1245
050,18,157,"Indiana","Tippecanoe County",5,33,2465,1244,1221
050,18,157,"Indiana","Tippecanoe County",5,34,2303,1176,1127
050,18,157,"Indiana","Tippecanoe County",5,35,2164,1103,1061
050,18,157,"Indiana","Tippecanoe County",5,36,2110,1089,1021
050,18,157,"Indiana","Tippecanoe County",5,37,2033,1031,1002
050,18,157,"Indiana","Tippecanoe County",5,38,2113,1094,1019
050,18,157,"Indiana","Tippecanoe County",5,39,2058,1058,1000
050,18,157,"Indiana","Tippecanoe County",5,40,2001,1005,996
050,18,157,"Indiana","Tippecanoe County",5,41,2066,1053,1013
050,18,157,"Indiana","Tippecanoe County",5,42,1993,1008,985
050,18,157,"Indiana","Tippecanoe County",5,43,2018,1016,1002
050,18,157,"Indiana","Tippecanoe County",5,44,1946,943,1003
050,18,157,"Indiana","Tippecanoe County",5,45,1964,955,1009
050,18,157,"Indiana","Tippecanoe County",5,46,1930,981,949
050,18,157,"Indiana","Tippecanoe County",5,47,1754,909,845
050,18,157,"Indiana","Tippecanoe County",5,48,1759,855,904
050,18,157,"Indiana","Tippecanoe County",5,49,1699,844,855
050,18,157,"Indiana","Tippecanoe County",5,50,1796,905,891
050,18,157,"Indiana","Tippecanoe County",5,51,1799,893,906
050,18,157,"Indiana","Tippecanoe County",5,52,1872,948,924
050,18,157,"Indiana","Tippecanoe County",5,53,1840,906,934
050,18,157,"Indiana","Tippecanoe County",5,54,1750,841,909
050,18,157,"Indiana","Tippecanoe County",5,55,1679,816,863
050,18,157,"Indiana","Tippecanoe County",5,56,1685,848,837
050,18,157,"Indiana","Tippecanoe County",5,57,1682,846,836
050,18,157,"Indiana","Tippecanoe County",5,58,1682,835,847
050,18,157,"Indiana","Tippecanoe County",5,59,1776,865,911
050,18,157,"Indiana","Tippecanoe County",5,60,1744,867,877
050,18,157,"Indiana","Tippecanoe County",5,61,1746,854,892
050,18,157,"Indiana","Tippecanoe County",5,62,1717,814,903
050,18,157,"Indiana","Tippecanoe County",5,63,1679,804,875
050,18,157,"Indiana","Tippecanoe County",5,64,1684,805,879
050,18,157,"Indiana","Tippecanoe County",5,65,1673,802,871
050,18,157,"Indiana","Tippecanoe County",5,66,1662,771,891
050,18,157,"Indiana","Tippecanoe County",5,67,1551,748,803
050,18,157,"Indiana","Tippecanoe County",5,68,1473,681,792
050,18,157,"Indiana","Tippecanoe County",5,69,1469,673,796
050,18,157,"Indiana","Tippecanoe County",5,70,1443,656,787
050,18,157,"Indiana","Tippecanoe County",5,71,1392,646,746
050,18,157,"Indiana","Tippecanoe County",5,72,1264,578,686
050,18,157,"Indiana","Tippecanoe County",5,73,1159,529,630
050,18,157,"Indiana","Tippecanoe County",5,74,1125,519,606
050,18,157,"Indiana","Tippecanoe County",5,75,1092,483,609
050,18,157,"Indiana","Tippecanoe County",5,76,1113,506,607
050,18,157,"Indiana","Tippecanoe County",5,77,764,323,441
050,18,157,"Indiana","Tippecanoe County",5,78,737,317,420
050,18,157,"Indiana","Tippecanoe County",5,79,705,318,387
050,18,157,"Indiana","Tippecanoe County",5,80,733,331,402
050,18,157,"Indiana","Tippecanoe County",5,81,608,262,346
050,18,157,"Indiana","Tippecanoe County",5,82,501,208,293
050,18,157,"Indiana","Tippecanoe County",5,83,457,187,270
050,18,157,"Indiana","Tippecanoe County",5,84,423,184,239
050,18,157,"Indiana","Tippecanoe County",5,85,2451,912,1539
050,18,159,"Indiana","Tipton County",1,0,141,72,69
050,18,159,"Indiana","Tipton County",1,1,156,83,73
050,18,159,"Indiana","Tipton County",1,2,179,94,85
050,18,159,"Indiana","Tipton County",1,3,179,83,96
050,18,159,"Indiana","Tipton County",1,4,172,86,86
050,18,159,"Indiana","Tipton County",1,5,182,95,87
050,18,159,"Indiana","Tipton County",1,6,169,90,79
050,18,159,"Indiana","Tipton County",1,7,162,92,70
050,18,159,"Indiana","Tipton County",1,8,174,96,78
050,18,159,"Indiana","Tipton County",1,9,155,69,86
050,18,159,"Indiana","Tipton County",1,10,165,82,83
050,18,159,"Indiana","Tipton County",1,11,180,90,90
050,18,159,"Indiana","Tipton County",1,12,193,106,87
050,18,159,"Indiana","Tipton County",1,13,190,108,82
050,18,159,"Indiana","Tipton County",1,14,193,91,102
050,18,159,"Indiana","Tipton County",1,15,195,89,106
050,18,159,"Indiana","Tipton County",1,16,194,97,97
050,18,159,"Indiana","Tipton County",1,17,217,111,106
050,18,159,"Indiana","Tipton County",1,18,168,90,78
050,18,159,"Indiana","Tipton County",1,19,150,85,65
050,18,159,"Indiana","Tipton County",1,20,156,87,69
050,18,159,"Indiana","Tipton County",1,21,167,90,77
050,18,159,"Indiana","Tipton County",1,22,166,89,77
050,18,159,"Indiana","Tipton County",1,23,157,83,74
050,18,159,"Indiana","Tipton County",1,24,175,89,86
050,18,159,"Indiana","Tipton County",1,25,159,84,75
050,18,159,"Indiana","Tipton County",1,26,180,92,88
050,18,159,"Indiana","Tipton County",1,27,194,100,94
050,18,159,"Indiana","Tipton County",1,28,195,106,89
050,18,159,"Indiana","Tipton County",1,29,187,101,86
050,18,159,"Indiana","Tipton County",1,30,184,98,86
050,18,159,"Indiana","Tipton County",1,31,168,88,80
050,18,159,"Indiana","Tipton County",1,32,168,88,80
050,18,159,"Indiana","Tipton County",1,33,160,75,85
050,18,159,"Indiana","Tipton County",1,34,171,80,91
050,18,159,"Indiana","Tipton County",1,35,168,80,88
050,18,159,"Indiana","Tipton County",1,36,149,75,74
050,18,159,"Indiana","Tipton County",1,37,144,77,67
050,18,159,"Indiana","Tipton County",1,38,149,73,76
050,18,159,"Indiana","Tipton County",1,39,159,82,77
050,18,159,"Indiana","Tipton County",1,40,171,81,90
050,18,159,"Indiana","Tipton County",1,41,189,95,94
050,18,159,"Indiana","Tipton County",1,42,152,79,73
050,18,159,"Indiana","Tipton County",1,43,170,89,81
050,18,159,"Indiana","Tipton County",1,44,165,83,82
050,18,159,"Indiana","Tipton County",1,45,184,88,96
050,18,159,"Indiana","Tipton County",1,46,185,94,91
050,18,159,"Indiana","Tipton County",1,47,199,98,101
050,18,159,"Indiana","Tipton County",1,48,212,101,111
050,18,159,"Indiana","Tipton County",1,49,218,112,106
050,18,159,"Indiana","Tipton County",1,50,250,131,119
050,18,159,"Indiana","Tipton County",1,51,230,124,106
050,18,159,"Indiana","Tipton County",1,52,194,108,86
050,18,159,"Indiana","Tipton County",1,53,203,104,99
050,18,159,"Indiana","Tipton County",1,54,209,106,103
050,18,159,"Indiana","Tipton County",1,55,219,112,107
050,18,159,"Indiana","Tipton County",1,56,224,108,116
050,18,159,"Indiana","Tipton County",1,57,225,112,113
050,18,159,"Indiana","Tipton County",1,58,248,123,125
050,18,159,"Indiana","Tipton County",1,59,237,114,123
050,18,159,"Indiana","Tipton County",1,60,233,114,119
050,18,159,"Indiana","Tipton County",1,61,226,112,114
050,18,159,"Indiana","Tipton County",1,62,236,129,107
050,18,159,"Indiana","Tipton County",1,63,224,121,103
050,18,159,"Indiana","Tipton County",1,64,227,120,107
050,18,159,"Indiana","Tipton County",1,65,230,124,106
050,18,159,"Indiana","Tipton County",1,66,205,107,98
050,18,159,"Indiana","Tipton County",1,67,191,94,97
050,18,159,"Indiana","Tipton County",1,68,189,95,94
050,18,159,"Indiana","Tipton County",1,69,179,80,99
050,18,159,"Indiana","Tipton County",1,70,189,93,96
050,18,159,"Indiana","Tipton County",1,71,156,79,77
050,18,159,"Indiana","Tipton County",1,72,168,81,87
050,18,159,"Indiana","Tipton County",1,73,184,81,103
050,18,159,"Indiana","Tipton County",1,74,152,77,75
050,18,159,"Indiana","Tipton County",1,75,136,67,69
050,18,159,"Indiana","Tipton County",1,76,149,70,79
050,18,159,"Indiana","Tipton County",1,77,139,66,73
050,18,159,"Indiana","Tipton County",1,78,114,55,59
050,18,159,"Indiana","Tipton County",1,79,99,46,53
050,18,159,"Indiana","Tipton County",1,80,105,52,53
050,18,159,"Indiana","Tipton County",1,81,89,47,42
050,18,159,"Indiana","Tipton County",1,82,74,33,41
050,18,159,"Indiana","Tipton County",1,83,57,25,32
050,18,159,"Indiana","Tipton County",1,84,61,29,32
050,18,159,"Indiana","Tipton County",1,85,391,122,269
050,18,159,"Indiana","Tipton County",2,0,159,83,76
050,18,159,"Indiana","Tipton County",2,1,153,80,73
050,18,159,"Indiana","Tipton County",2,2,175,93,82
050,18,159,"Indiana","Tipton County",2,3,178,86,92
050,18,159,"Indiana","Tipton County",2,4,177,87,90
050,18,159,"Indiana","Tipton County",2,5,182,94,88
050,18,159,"Indiana","Tipton County",2,6,173,92,81
050,18,159,"Indiana","Tipton County",2,7,165,93,72
050,18,159,"Indiana","Tipton County",2,8,172,95,77
050,18,159,"Indiana","Tipton County",2,9,162,78,84
050,18,159,"Indiana","Tipton County",2,10,163,78,85
050,18,159,"Indiana","Tipton County",2,11,175,86,89
050,18,159,"Indiana","Tipton County",2,12,195,104,91
050,18,159,"Indiana","Tipton County",2,13,192,108,84
050,18,159,"Indiana","Tipton County",2,14,191,95,96
050,18,159,"Indiana","Tipton County",2,15,193,88,105
050,18,159,"Indiana","Tipton County",2,16,196,95,101
050,18,159,"Indiana","Tipton County",2,17,211,106,105
050,18,159,"Indiana","Tipton County",2,18,169,90,79
050,18,159,"Indiana","Tipton County",2,19,148,81,67
050,18,159,"Indiana","Tipton County",2,20,159,88,71
050,18,159,"Indiana","Tipton County",2,21,167,91,76
050,18,159,"Indiana","Tipton County",2,22,167,89,78
050,18,159,"Indiana","Tipton County",2,23,162,85,77
050,18,159,"Indiana","Tipton County",2,24,168,85,83
050,18,159,"Indiana","Tipton County",2,25,164,85,79
050,18,159,"Indiana","Tipton County",2,26,179,93,86
050,18,159,"Indiana","Tipton County",2,27,195,102,93
050,18,159,"Indiana","Tipton County",2,28,200,107,93
050,18,159,"Indiana","Tipton County",2,29,191,103,88
050,18,159,"Indiana","Tipton County",2,30,186,98,88
050,18,159,"Indiana","Tipton County",2,31,173,92,81
050,18,159,"Indiana","Tipton County",2,32,167,87,80
050,18,159,"Indiana","Tipton County",2,33,164,80,84
050,18,159,"Indiana","Tipton County",2,34,173,81,92
050,18,159,"Indiana","Tipton County",2,35,171,81,90
050,18,159,"Indiana","Tipton County",2,36,151,75,76
050,18,159,"Indiana","Tipton County",2,37,148,78,70
050,18,159,"Indiana","Tipton County",2,38,149,76,73
050,18,159,"Indiana","Tipton County",2,39,157,81,76
050,18,159,"Indiana","Tipton County",2,40,169,82,87
050,18,159,"Indiana","Tipton County",2,41,186,94,92
050,18,159,"Indiana","Tipton County",2,42,159,81,78
050,18,159,"Indiana","Tipton County",2,43,166,87,79
050,18,159,"Indiana","Tipton County",2,44,165,84,81
050,18,159,"Indiana","Tipton County",2,45,181,87,94
050,18,159,"Indiana","Tipton County",2,46,183,92,91
050,18,159,"Indiana","Tipton County",2,47,196,98,98
050,18,159,"Indiana","Tipton County",2,48,207,100,107
050,18,159,"Indiana","Tipton County",2,49,221,112,109
050,18,159,"Indiana","Tipton County",2,50,241,126,115
050,18,159,"Indiana","Tipton County",2,51,233,125,108
050,18,159,"Indiana","Tipton County",2,52,199,111,88
050,18,159,"Indiana","Tipton County",2,53,201,105,96
050,18,159,"Indiana","Tipton County",2,54,206,105,101
050,18,159,"Indiana","Tipton County",2,55,216,110,106
050,18,159,"Indiana","Tipton County",2,56,223,110,113
050,18,159,"Indiana","Tipton County",2,57,225,112,113
050,18,159,"Indiana","Tipton County",2,58,243,120,123
050,18,159,"Indiana","Tipton County",2,59,239,116,123
050,18,159,"Indiana","Tipton County",2,60,231,113,118
050,18,159,"Indiana","Tipton County",2,61,227,112,115
050,18,159,"Indiana","Tipton County",2,62,231,123,108
050,18,159,"Indiana","Tipton County",2,63,228,123,105
050,18,159,"Indiana","Tipton County",2,64,224,120,104
050,18,159,"Indiana","Tipton County",2,65,228,122,106
050,18,159,"Indiana","Tipton County",2,66,212,111,101
050,18,159,"Indiana","Tipton County",2,67,193,97,96
050,18,159,"Indiana","Tipton County",2,68,190,96,94
050,18,159,"Indiana","Tipton County",2,69,182,84,98
050,18,159,"Indiana","Tipton County",2,70,186,90,96
050,18,159,"Indiana","Tipton County",2,71,164,82,82
050,18,159,"Indiana","Tipton County",2,72,162,78,84
050,18,159,"Indiana","Tipton County",2,73,187,85,102
050,18,159,"Indiana","Tipton County",2,74,151,74,77
050,18,159,"Indiana","Tipton County",2,75,139,69,70
050,18,159,"Indiana","Tipton County",2,76,143,69,74
050,18,159,"Indiana","Tipton County",2,77,139,68,71
050,18,159,"Indiana","Tipton County",2,78,118,56,62
050,18,159,"Indiana","Tipton County",2,79,102,47,55
050,18,159,"Indiana","Tipton County",2,80,103,51,52
050,18,159,"Indiana","Tipton County",2,81,90,49,41
050,18,159,"Indiana","Tipton County",2,82,77,35,42
050,18,159,"Indiana","Tipton County",2,83,60,27,33
050,18,159,"Indiana","Tipton County",2,84,53,25,28
050,18,159,"Indiana","Tipton County",2,85,393,125,268
050,18,159,"Indiana","Tipton County",3,0,159,86,73
050,18,159,"Indiana","Tipton County",3,1,155,78,77
050,18,159,"Indiana","Tipton County",3,2,150,75,75
050,18,159,"Indiana","Tipton County",3,3,179,99,80
050,18,159,"Indiana","Tipton County",3,4,173,77,96
050,18,159,"Indiana","Tipton County",3,5,184,90,94
050,18,159,"Indiana","Tipton County",3,6,175,85,90
050,18,159,"Indiana","Tipton County",3,7,179,94,85
050,18,159,"Indiana","Tipton County",3,8,170,93,77
050,18,159,"Indiana","Tipton County",3,9,172,95,77
050,18,159,"Indiana","Tipton County",3,10,161,81,80
050,18,159,"Indiana","Tipton County",3,11,167,79,88
050,18,159,"Indiana","Tipton County",3,12,175,91,84
050,18,159,"Indiana","Tipton County",3,13,194,102,92
050,18,159,"Indiana","Tipton County",3,14,197,111,86
050,18,159,"Indiana","Tipton County",3,15,205,101,104
050,18,159,"Indiana","Tipton County",3,16,203,90,113
050,18,159,"Indiana","Tipton County",3,17,203,106,97
050,18,159,"Indiana","Tipton County",3,18,170,89,81
050,18,159,"Indiana","Tipton County",3,19,135,73,62
050,18,159,"Indiana","Tipton County",3,20,159,91,68
050,18,159,"Indiana","Tipton County",3,21,160,87,73
050,18,159,"Indiana","Tipton County",3,22,174,88,86
050,18,159,"Indiana","Tipton County",3,23,169,92,77
050,18,159,"Indiana","Tipton County",3,24,154,80,74
050,18,159,"Indiana","Tipton County",3,25,166,82,84
050,18,159,"Indiana","Tipton County",3,26,154,73,81
050,18,159,"Indiana","Tipton County",3,27,178,95,83
050,18,159,"Indiana","Tipton County",3,28,198,98,100
050,18,159,"Indiana","Tipton County",3,29,199,107,92
050,18,159,"Indiana","Tipton County",3,30,192,101,91
050,18,159,"Indiana","Tipton County",3,31,193,99,94
050,18,159,"Indiana","Tipton County",3,32,169,91,78
050,18,159,"Indiana","Tipton County",3,33,161,84,77
050,18,159,"Indiana","Tipton County",3,34,169,78,91
050,18,159,"Indiana","Tipton County",3,35,176,85,91
050,18,159,"Indiana","Tipton County",3,36,181,84,97
050,18,159,"Indiana","Tipton County",3,37,158,80,78
050,18,159,"Indiana","Tipton County",3,38,149,82,67
050,18,159,"Indiana","Tipton County",3,39,150,77,73
050,18,159,"Indiana","Tipton County",3,40,157,78,79
050,18,159,"Indiana","Tipton County",3,41,174,89,85
050,18,159,"Indiana","Tipton County",3,42,190,96,94
050,18,159,"Indiana","Tipton County",3,43,163,83,80
050,18,159,"Indiana","Tipton County",3,44,171,92,79
050,18,159,"Indiana","Tipton County",3,45,161,84,77
050,18,159,"Indiana","Tipton County",3,46,183,85,98
050,18,159,"Indiana","Tipton County",3,47,185,92,93
050,18,159,"Indiana","Tipton County",3,48,191,97,94
050,18,159,"Indiana","Tipton County",3,49,207,94,113
050,18,159,"Indiana","Tipton County",3,50,213,108,105
050,18,159,"Indiana","Tipton County",3,51,246,128,118
050,18,159,"Indiana","Tipton County",3,52,225,122,103
050,18,159,"Indiana","Tipton County",3,53,204,117,87
050,18,159,"Indiana","Tipton County",3,54,202,104,98
050,18,159,"Indiana","Tipton County",3,55,216,113,103
050,18,159,"Indiana","Tipton County",3,56,212,107,105
050,18,159,"Indiana","Tipton County",3,57,220,110,110
050,18,159,"Indiana","Tipton County",3,58,225,111,114
050,18,159,"Indiana","Tipton County",3,59,235,116,119
050,18,159,"Indiana","Tipton County",3,60,239,112,127
050,18,159,"Indiana","Tipton County",3,61,242,117,125
050,18,159,"Indiana","Tipton County",3,62,224,115,109
050,18,159,"Indiana","Tipton County",3,63,232,124,108
050,18,159,"Indiana","Tipton County",3,64,221,118,103
050,18,159,"Indiana","Tipton County",3,65,221,118,103
050,18,159,"Indiana","Tipton County",3,66,223,122,101
050,18,159,"Indiana","Tipton County",3,67,211,105,106
050,18,159,"Indiana","Tipton County",3,68,186,95,91
050,18,159,"Indiana","Tipton County",3,69,182,90,92
050,18,159,"Indiana","Tipton County",3,70,184,83,101
050,18,159,"Indiana","Tipton County",3,71,183,88,95
050,18,159,"Indiana","Tipton County",3,72,159,80,79
050,18,159,"Indiana","Tipton County",3,73,155,78,77
050,18,159,"Indiana","Tipton County",3,74,184,83,101
050,18,159,"Indiana","Tipton County",3,75,141,68,73
050,18,159,"Indiana","Tipton County",3,76,139,69,70
050,18,159,"Indiana","Tipton County",3,77,136,63,73
050,18,159,"Indiana","Tipton County",3,78,134,67,67
050,18,159,"Indiana","Tipton County",3,79,116,54,62
050,18,159,"Indiana","Tipton County",3,80,99,43,56
050,18,159,"Indiana","Tipton County",3,81,90,47,43
050,18,159,"Indiana","Tipton County",3,82,93,48,45
050,18,159,"Indiana","Tipton County",3,83,69,31,38
050,18,159,"Indiana","Tipton County",3,84,49,23,26
050,18,159,"Indiana","Tipton County",3,85,387,126,261
050,18,159,"Indiana","Tipton County",4,0,149,84,65
050,18,159,"Indiana","Tipton County",4,1,171,93,78
050,18,159,"Indiana","Tipton County",4,2,162,84,78
050,18,159,"Indiana","Tipton County",4,3,147,78,69
050,18,159,"Indiana","Tipton County",4,4,175,94,81
050,18,159,"Indiana","Tipton County",4,5,172,78,94
050,18,159,"Indiana","Tipton County",4,6,185,90,95
050,18,159,"Indiana","Tipton County",4,7,173,87,86
050,18,159,"Indiana","Tipton County",4,8,173,93,80
050,18,159,"Indiana","Tipton County",4,9,172,92,80
050,18,159,"Indiana","Tipton County",4,10,168,97,71
050,18,159,"Indiana","Tipton County",4,11,163,80,83
050,18,159,"Indiana","Tipton County",4,12,163,77,86
050,18,159,"Indiana","Tipton County",4,13,184,96,88
050,18,159,"Indiana","Tipton County",4,14,202,111,91
050,18,159,"Indiana","Tipton County",4,15,193,108,85
050,18,159,"Indiana","Tipton County",4,16,212,104,108
050,18,159,"Indiana","Tipton County",4,17,206,93,113
050,18,159,"Indiana","Tipton County",4,18,161,88,73
050,18,159,"Indiana","Tipton County",4,19,136,72,64
050,18,159,"Indiana","Tipton County",4,20,141,80,61
050,18,159,"Indiana","Tipton County",4,21,158,92,66
050,18,159,"Indiana","Tipton County",4,22,164,83,81
050,18,159,"Indiana","Tipton County",4,23,176,95,81
050,18,159,"Indiana","Tipton County",4,24,164,89,75
050,18,159,"Indiana","Tipton County",4,25,165,85,80
050,18,159,"Indiana","Tipton County",4,26,164,81,83
050,18,159,"Indiana","Tipton County",4,27,153,75,78
050,18,159,"Indiana","Tipton County",4,28,184,96,88
050,18,159,"Indiana","Tipton County",4,29,198,105,93
050,18,159,"Indiana","Tipton County",4,30,213,112,101
050,18,159,"Indiana","Tipton County",4,31,181,94,87
050,18,159,"Indiana","Tipton County",4,32,190,95,95
050,18,159,"Indiana","Tipton County",4,33,171,91,80
050,18,159,"Indiana","Tipton County",4,34,158,83,75
050,18,159,"Indiana","Tipton County",4,35,179,83,96
050,18,159,"Indiana","Tipton County",4,36,174,84,90
050,18,159,"Indiana","Tipton County",4,37,185,83,102
050,18,159,"Indiana","Tipton County",4,38,152,78,74
050,18,159,"Indiana","Tipton County",4,39,143,79,64
050,18,159,"Indiana","Tipton County",4,40,158,83,75
050,18,159,"Indiana","Tipton County",4,41,158,82,76
050,18,159,"Indiana","Tipton County",4,42,179,89,90
050,18,159,"Indiana","Tipton County",4,43,192,95,97
050,18,159,"Indiana","Tipton County",4,44,164,77,87
050,18,159,"Indiana","Tipton County",4,45,172,91,81
050,18,159,"Indiana","Tipton County",4,46,165,85,80
050,18,159,"Indiana","Tipton County",4,47,184,87,97
050,18,159,"Indiana","Tipton County",4,48,191,95,96
050,18,159,"Indiana","Tipton County",4,49,184,92,92
050,18,159,"Indiana","Tipton County",4,50,213,100,113
050,18,159,"Indiana","Tipton County",4,51,219,115,104
050,18,159,"Indiana","Tipton County",4,52,246,129,117
050,18,159,"Indiana","Tipton County",4,53,231,123,108
050,18,159,"Indiana","Tipton County",4,54,206,121,85
050,18,159,"Indiana","Tipton County",4,55,205,106,99
050,18,159,"Indiana","Tipton County",4,56,209,107,102
050,18,159,"Indiana","Tipton County",4,57,215,109,106
050,18,159,"Indiana","Tipton County",4,58,214,107,107
050,18,159,"Indiana","Tipton County",4,59,223,111,112
050,18,159,"Indiana","Tipton County",4,60,240,123,117
050,18,159,"Indiana","Tipton County",4,61,231,111,120
050,18,159,"Indiana","Tipton County",4,62,243,121,122
050,18,159,"Indiana","Tipton County",4,63,218,111,107
050,18,159,"Indiana","Tipton County",4,64,216,116,100
050,18,159,"Indiana","Tipton County",4,65,211,110,101
050,18,159,"Indiana","Tipton County",4,66,217,114,103
050,18,159,"Indiana","Tipton County",4,67,217,118,99
050,18,159,"Indiana","Tipton County",4,68,207,103,104
050,18,159,"Indiana","Tipton County",4,69,177,89,88
050,18,159,"Indiana","Tipton County",4,70,185,91,94
050,18,159,"Indiana","Tipton County",4,71,180,81,99
050,18,159,"Indiana","Tipton County",4,72,176,80,96
050,18,159,"Indiana","Tipton County",4,73,154,81,73
050,18,159,"Indiana","Tipton County",4,74,149,72,77
050,18,159,"Indiana","Tipton County",4,75,174,76,98
050,18,159,"Indiana","Tipton County",4,76,131,66,65
050,18,159,"Indiana","Tipton County",4,77,126,60,66
050,18,159,"Indiana","Tipton County",4,78,129,60,69
050,18,159,"Indiana","Tipton County",4,79,127,61,66
050,18,159,"Indiana","Tipton County",4,80,107,49,58
050,18,159,"Indiana","Tipton County",4,81,85,39,46
050,18,159,"Indiana","Tipton County",4,82,89,43,46
050,18,159,"Indiana","Tipton County",4,83,88,44,44
050,18,159,"Indiana","Tipton County",4,84,62,29,33
050,18,159,"Indiana","Tipton County",4,85,378,125,253
050,18,159,"Indiana","Tipton County",5,0,146,81,65
050,18,159,"Indiana","Tipton County",5,1,154,84,70
050,18,159,"Indiana","Tipton County",5,2,175,92,83
050,18,159,"Indiana","Tipton County",5,3,165,88,77
050,18,159,"Indiana","Tipton County",5,4,144,70,74
050,18,159,"Indiana","Tipton County",5,5,175,92,83
050,18,159,"Indiana","Tipton County",5,6,170,78,92
050,18,159,"Indiana","Tipton County",5,7,181,91,90
050,18,159,"Indiana","Tipton County",5,8,174,86,88
050,18,159,"Indiana","Tipton County",5,9,182,101,81
050,18,159,"Indiana","Tipton County",5,10,171,88,83
050,18,159,"Indiana","Tipton County",5,11,165,93,72
050,18,159,"Indiana","Tipton County",5,12,169,85,84
050,18,159,"Indiana","Tipton County",5,13,160,76,84
050,18,159,"Indiana","Tipton County",5,14,174,90,84
050,18,159,"Indiana","Tipton County",5,15,198,107,91
050,18,159,"Indiana","Tipton County",5,16,188,106,82
050,18,159,"Indiana","Tipton County",5,17,214,103,111
050,18,159,"Indiana","Tipton County",5,18,170,83,87
050,18,159,"Indiana","Tipton County",5,19,126,68,58
050,18,159,"Indiana","Tipton County",5,20,142,71,71
050,18,159,"Indiana","Tipton County",5,21,147,80,67
050,18,159,"Indiana","Tipton County",5,22,164,93,71
050,18,159,"Indiana","Tipton County",5,23,174,86,88
050,18,159,"Indiana","Tipton County",5,24,192,103,89
050,18,159,"Indiana","Tipton County",5,25,161,85,76
050,18,159,"Indiana","Tipton County",5,26,174,93,81
050,18,159,"Indiana","Tipton County",5,27,152,75,77
050,18,159,"Indiana","Tipton County",5,28,166,82,84
050,18,159,"Indiana","Tipton County",5,29,173,94,79
050,18,159,"Indiana","Tipton County",5,30,181,93,88
050,18,159,"Indiana","Tipton County",5,31,223,117,106
050,18,159,"Indiana","Tipton County",5,32,177,95,82
050,18,159,"Indiana","Tipton County",5,33,186,91,95
050,18,159,"Indiana","Tipton County",5,34,174,94,80
050,18,159,"Indiana","Tipton County",5,35,162,87,75
050,18,159,"Indiana","Tipton County",5,36,179,84,95
050,18,159,"Indiana","Tipton County",5,37,182,86,96
050,18,159,"Indiana","Tipton County",5,38,177,79,98
050,18,159,"Indiana","Tipton County",5,39,156,80,76
050,18,159,"Indiana","Tipton County",5,40,140,77,63
050,18,159,"Indiana","Tipton County",5,41,162,84,78
050,18,159,"Indiana","Tipton County",5,42,157,80,77
050,18,159,"Indiana","Tipton County",5,43,175,89,86
050,18,159,"Indiana","Tipton County",5,44,193,98,95
050,18,159,"Indiana","Tipton County",5,45,153,73,80
050,18,159,"Indiana","Tipton County",5,46,171,94,77
050,18,159,"Indiana","Tipton County",5,47,162,84,78
050,18,159,"Indiana","Tipton County",5,48,190,90,100
050,18,159,"Indiana","Tipton County",5,49,200,98,102
050,18,159,"Indiana","Tipton County",5,50,179,92,87
050,18,159,"Indiana","Tipton County",5,51,215,103,112
050,18,159,"Indiana","Tipton County",5,52,218,115,103
050,18,159,"Indiana","Tipton County",5,53,236,124,112
050,18,159,"Indiana","Tipton County",5,54,237,126,111
050,18,159,"Indiana","Tipton County",5,55,212,126,86
050,18,159,"Indiana","Tipton County",5,56,193,100,93
050,18,159,"Indiana","Tipton County",5,57,204,101,103
050,18,159,"Indiana","Tipton County",5,58,216,109,107
050,18,159,"Indiana","Tipton County",5,59,203,99,104
050,18,159,"Indiana","Tipton County",5,60,229,114,115
050,18,159,"Indiana","Tipton County",5,61,236,121,115
050,18,159,"Indiana","Tipton County",5,62,237,116,121
050,18,159,"Indiana","Tipton County",5,63,240,116,124
050,18,159,"Indiana","Tipton County",5,64,207,106,101
050,18,159,"Indiana","Tipton County",5,65,213,114,99
050,18,159,"Indiana","Tipton County",5,66,212,110,102
050,18,159,"Indiana","Tipton County",5,67,211,111,100
050,18,159,"Indiana","Tipton County",5,68,215,114,101
050,18,159,"Indiana","Tipton County",5,69,203,101,102
050,18,159,"Indiana","Tipton County",5,70,180,94,86
050,18,159,"Indiana","Tipton County",5,71,189,90,99
050,18,159,"Indiana","Tipton County",5,72,173,76,97
050,18,159,"Indiana","Tipton County",5,73,176,82,94
050,18,159,"Indiana","Tipton County",5,74,151,76,75
050,18,159,"Indiana","Tipton County",5,75,136,63,73
050,18,159,"Indiana","Tipton County",5,76,161,71,90
050,18,159,"Indiana","Tipton County",5,77,119,57,62
050,18,159,"Indiana","Tipton County",5,78,121,55,66
050,18,159,"Indiana","Tipton County",5,79,129,57,72
050,18,159,"Indiana","Tipton County",5,80,120,56,64
050,18,159,"Indiana","Tipton County",5,81,91,43,48
050,18,159,"Indiana","Tipton County",5,82,88,37,51
050,18,159,"Indiana","Tipton County",5,83,81,38,43
050,18,159,"Indiana","Tipton County",5,84,80,43,37
050,18,159,"Indiana","Tipton County",5,85,399,140,259
050,18,161,"Indiana","Union County",1,0,70,36,34
050,18,161,"Indiana","Union County",1,1,72,32,40
050,18,161,"Indiana","Union County",1,2,73,37,36
050,18,161,"Indiana","Union County",1,3,82,44,38
050,18,161,"Indiana","Union County",1,4,91,43,48
050,18,161,"Indiana","Union County",1,5,81,38,43
050,18,161,"Indiana","Union County",1,6,87,42,45
050,18,161,"Indiana","Union County",1,7,69,39,30
050,18,161,"Indiana","Union County",1,8,76,44,32
050,18,161,"Indiana","Union County",1,9,77,41,36
050,18,161,"Indiana","Union County",1,10,88,45,43
050,18,161,"Indiana","Union County",1,11,84,39,45
050,18,161,"Indiana","Union County",1,12,76,41,35
050,18,161,"Indiana","Union County",1,13,82,48,34
050,18,161,"Indiana","Union County",1,14,94,52,42
050,18,161,"Indiana","Union County",1,15,94,47,47
050,18,161,"Indiana","Union County",1,16,106,59,47
050,18,161,"Indiana","Union County",1,17,94,55,39
050,18,161,"Indiana","Union County",1,18,73,37,36
050,18,161,"Indiana","Union County",1,19,62,35,27
050,18,161,"Indiana","Union County",1,20,73,37,36
050,18,161,"Indiana","Union County",1,21,84,44,40
050,18,161,"Indiana","Union County",1,22,95,45,50
050,18,161,"Indiana","Union County",1,23,88,40,48
050,18,161,"Indiana","Union County",1,24,68,36,32
050,18,161,"Indiana","Union County",1,25,79,43,36
050,18,161,"Indiana","Union County",1,26,85,46,39
050,18,161,"Indiana","Union County",1,27,100,57,43
050,18,161,"Indiana","Union County",1,28,99,48,51
050,18,161,"Indiana","Union County",1,29,90,40,50
050,18,161,"Indiana","Union County",1,30,80,39,41
050,18,161,"Indiana","Union County",1,31,67,30,37
050,18,161,"Indiana","Union County",1,32,70,37,33
050,18,161,"Indiana","Union County",1,33,75,36,39
050,18,161,"Indiana","Union County",1,34,64,29,35
050,18,161,"Indiana","Union County",1,35,76,39,37
050,18,161,"Indiana","Union County",1,36,71,40,31
050,18,161,"Indiana","Union County",1,37,72,34,38
050,18,161,"Indiana","Union County",1,38,86,46,40
050,18,161,"Indiana","Union County",1,39,92,49,43
050,18,161,"Indiana","Union County",1,40,92,43,49
050,18,161,"Indiana","Union County",1,41,82,39,43
050,18,161,"Indiana","Union County",1,42,90,37,53
050,18,161,"Indiana","Union County",1,43,81,38,43
050,18,161,"Indiana","Union County",1,44,64,27,37
050,18,161,"Indiana","Union County",1,45,82,36,46
050,18,161,"Indiana","Union County",1,46,82,38,44
050,18,161,"Indiana","Union County",1,47,72,39,33
050,18,161,"Indiana","Union County",1,48,96,47,49
050,18,161,"Indiana","Union County",1,49,112,52,60
050,18,161,"Indiana","Union County",1,50,91,41,50
050,18,161,"Indiana","Union County",1,51,104,55,49
050,18,161,"Indiana","Union County",1,52,109,54,55
050,18,161,"Indiana","Union County",1,53,100,50,50
050,18,161,"Indiana","Union County",1,54,102,53,49
050,18,161,"Indiana","Union County",1,55,107,51,56
050,18,161,"Indiana","Union County",1,56,107,46,61
050,18,161,"Indiana","Union County",1,57,115,57,58
050,18,161,"Indiana","Union County",1,58,115,58,57
050,18,161,"Indiana","Union County",1,59,119,61,58
050,18,161,"Indiana","Union County",1,60,106,53,53
050,18,161,"Indiana","Union County",1,61,103,45,58
050,18,161,"Indiana","Union County",1,62,102,51,51
050,18,161,"Indiana","Union County",1,63,104,59,45
050,18,161,"Indiana","Union County",1,64,103,57,46
050,18,161,"Indiana","Union County",1,65,94,47,47
050,18,161,"Indiana","Union County",1,66,94,45,49
050,18,161,"Indiana","Union County",1,67,95,46,49
050,18,161,"Indiana","Union County",1,68,87,46,41
050,18,161,"Indiana","Union County",1,69,74,36,38
050,18,161,"Indiana","Union County",1,70,91,41,50
050,18,161,"Indiana","Union County",1,71,95,47,48
050,18,161,"Indiana","Union County",1,72,98,45,53
050,18,161,"Indiana","Union County",1,73,85,41,44
050,18,161,"Indiana","Union County",1,74,49,25,24
050,18,161,"Indiana","Union County",1,75,54,23,31
050,18,161,"Indiana","Union County",1,76,42,21,21
050,18,161,"Indiana","Union County",1,77,55,25,30
050,18,161,"Indiana","Union County",1,78,49,24,25
050,18,161,"Indiana","Union County",1,79,46,22,24
050,18,161,"Indiana","Union County",1,80,44,20,24
050,18,161,"Indiana","Union County",1,81,36,17,19
050,18,161,"Indiana","Union County",1,82,25,12,13
050,18,161,"Indiana","Union County",1,83,27,11,16
050,18,161,"Indiana","Union County",1,84,20,7,13
050,18,161,"Indiana","Union County",1,85,143,53,90
050,18,161,"Indiana","Union County",2,0,74,37,37
050,18,161,"Indiana","Union County",2,1,71,32,39
050,18,161,"Indiana","Union County",2,2,75,37,38
050,18,161,"Indiana","Union County",2,3,80,42,38
050,18,161,"Indiana","Union County",2,4,89,43,46
050,18,161,"Indiana","Union County",2,5,85,40,45
050,18,161,"Indiana","Union County",2,6,88,42,46
050,18,161,"Indiana","Union County",2,7,75,41,34
050,18,161,"Indiana","Union County",2,8,73,42,31
050,18,161,"Indiana","Union County",2,9,77,42,35
050,18,161,"Indiana","Union County",2,10,86,44,42
050,18,161,"Indiana","Union County",2,11,84,40,44
050,18,161,"Indiana","Union County",2,12,79,41,38
050,18,161,"Indiana","Union County",2,13,79,45,34
050,18,161,"Indiana","Union County",2,14,88,48,40
050,18,161,"Indiana","Union County",2,15,95,49,46
050,18,161,"Indiana","Union County",2,16,103,57,46
050,18,161,"Indiana","Union County",2,17,95,55,40
050,18,161,"Indiana","Union County",2,18,75,40,35
050,18,161,"Indiana","Union County",2,19,61,33,28
050,18,161,"Indiana","Union County",2,20,72,37,35
050,18,161,"Indiana","Union County",2,21,82,43,39
050,18,161,"Indiana","Union County",2,22,94,45,49
050,18,161,"Indiana","Union County",2,23,90,41,49
050,18,161,"Indiana","Union County",2,24,74,38,36
050,18,161,"Indiana","Union County",2,25,76,41,35
050,18,161,"Indiana","Union County",2,26,82,45,37
050,18,161,"Indiana","Union County",2,27,97,54,43
050,18,161,"Indiana","Union County",2,28,99,50,49
050,18,161,"Indiana","Union County",2,29,93,42,51
050,18,161,"Indiana","Union County",2,30,82,39,43
050,18,161,"Indiana","Union County",2,31,71,33,38
050,18,161,"Indiana","Union County",2,32,70,36,34
050,18,161,"Indiana","Union County",2,33,75,37,38
050,18,161,"Indiana","Union County",2,34,65,30,35
050,18,161,"Indiana","Union County",2,35,73,36,37
050,18,161,"Indiana","Union County",2,36,71,39,32
050,18,161,"Indiana","Union County",2,37,71,35,36
050,18,161,"Indiana","Union County",2,38,82,43,39
050,18,161,"Indiana","Union County",2,39,91,49,42
050,18,161,"Indiana","Union County",2,40,92,45,47
050,18,161,"Indiana","Union County",2,41,85,41,44
050,18,161,"Indiana","Union County",2,42,88,38,50
050,18,161,"Indiana","Union County",2,43,84,39,45
050,18,161,"Indiana","Union County",2,44,67,29,38
050,18,161,"Indiana","Union County",2,45,76,33,43
050,18,161,"Indiana","Union County",2,46,81,37,44
050,18,161,"Indiana","Union County",2,47,74,38,36
050,18,161,"Indiana","Union County",2,48,89,45,44
050,18,161,"Indiana","Union County",2,49,108,51,57
050,18,161,"Indiana","Union County",2,50,96,44,52
050,18,161,"Indiana","Union County",2,51,100,52,48
050,18,161,"Indiana","Union County",2,52,107,54,53
050,18,161,"Indiana","Union County",2,53,102,51,51
050,18,161,"Indiana","Union County",2,54,100,52,48
050,18,161,"Indiana","Union County",2,55,106,51,55
050,18,161,"Indiana","Union County",2,56,108,48,60
050,18,161,"Indiana","Union County",2,57,113,54,59
050,18,161,"Indiana","Union County",2,58,113,56,57
050,18,161,"Indiana","Union County",2,59,117,60,57
050,18,161,"Indiana","Union County",2,60,107,53,54
050,18,161,"Indiana","Union County",2,61,103,47,56
050,18,161,"Indiana","Union County",2,62,101,50,51
050,18,161,"Indiana","Union County",2,63,105,57,48
050,18,161,"Indiana","Union County",2,64,104,58,46
050,18,161,"Indiana","Union County",2,65,97,49,48
050,18,161,"Indiana","Union County",2,66,94,45,49
050,18,161,"Indiana","Union County",2,67,95,46,49
050,18,161,"Indiana","Union County",2,68,89,46,43
050,18,161,"Indiana","Union County",2,69,79,39,40
050,18,161,"Indiana","Union County",2,70,85,38,47
050,18,161,"Indiana","Union County",2,71,95,46,49
050,18,161,"Indiana","Union County",2,72,96,46,50
050,18,161,"Indiana","Union County",2,73,91,43,48
050,18,161,"Indiana","Union County",2,74,54,27,27
050,18,161,"Indiana","Union County",2,75,52,22,30
050,18,161,"Indiana","Union County",2,76,44,21,23
050,18,161,"Indiana","Union County",2,77,52,24,28
050,18,161,"Indiana","Union County",2,78,47,23,24
050,18,161,"Indiana","Union County",2,79,47,23,24
050,18,161,"Indiana","Union County",2,80,43,19,24
050,18,161,"Indiana","Union County",2,81,37,18,19
050,18,161,"Indiana","Union County",2,82,28,13,15
050,18,161,"Indiana","Union County",2,83,26,11,15
050,18,161,"Indiana","Union County",2,84,19,7,12
050,18,161,"Indiana","Union County",2,85,144,52,92
050,18,161,"Indiana","Union County",3,0,77,45,32
050,18,161,"Indiana","Union County",3,1,77,44,33
050,18,161,"Indiana","Union County",3,2,68,31,37
050,18,161,"Indiana","Union County",3,3,80,39,41
050,18,161,"Indiana","Union County",3,4,77,38,39
050,18,161,"Indiana","Union County",3,5,90,46,44
050,18,161,"Indiana","Union County",3,6,89,41,48
050,18,161,"Indiana","Union County",3,7,84,39,45
050,18,161,"Indiana","Union County",3,8,74,42,32
050,18,161,"Indiana","Union County",3,9,72,40,32
050,18,161,"Indiana","Union County",3,10,84,48,36
050,18,161,"Indiana","Union County",3,11,80,41,39
050,18,161,"Indiana","Union County",3,12,87,45,42
050,18,161,"Indiana","Union County",3,13,81,41,40
050,18,161,"Indiana","Union County",3,14,83,48,35
050,18,161,"Indiana","Union County",3,15,90,48,42
050,18,161,"Indiana","Union County",3,16,100,52,48
050,18,161,"Indiana","Union County",3,17,98,55,43
050,18,161,"Indiana","Union County",3,18,84,50,34
050,18,161,"Indiana","Union County",3,19,60,33,27
050,18,161,"Indiana","Union County",3,20,64,35,29
050,18,161,"Indiana","Union County",3,21,78,37,41
050,18,161,"Indiana","Union County",3,22,90,43,47
050,18,161,"Indiana","Union County",3,23,87,44,43
050,18,161,"Indiana","Union County",3,24,87,44,43
050,18,161,"Indiana","Union County",3,25,66,34,32
050,18,161,"Indiana","Union County",3,26,69,35,34
050,18,161,"Indiana","Union County",3,27,80,40,40
050,18,161,"Indiana","Union County",3,28,97,58,39
050,18,161,"Indiana","Union County",3,29,90,46,44
050,18,161,"Indiana","Union County",3,30,92,42,50
050,18,161,"Indiana","Union County",3,31,88,38,50
050,18,161,"Indiana","Union County",3,32,74,35,39
050,18,161,"Indiana","Union County",3,33,61,33,28
050,18,161,"Indiana","Union County",3,34,78,37,41
050,18,161,"Indiana","Union County",3,35,61,25,36
050,18,161,"Indiana","Union County",3,36,81,42,39
050,18,161,"Indiana","Union County",3,37,79,41,38
050,18,161,"Indiana","Union County",3,38,72,34,38
050,18,161,"Indiana","Union County",3,39,79,43,36
050,18,161,"Indiana","Union County",3,40,88,47,41
050,18,161,"Indiana","Union County",3,41,95,45,50
050,18,161,"Indiana","Union County",3,42,83,41,42
050,18,161,"Indiana","Union County",3,43,84,37,47
050,18,161,"Indiana","Union County",3,44,83,35,48
050,18,161,"Indiana","Union County",3,45,71,31,40
050,18,161,"Indiana","Union County",3,46,72,32,40
050,18,161,"Indiana","Union County",3,47,81,36,45
050,18,161,"Indiana","Union County",3,48,72,38,34
050,18,161,"Indiana","Union County",3,49,88,43,45
050,18,161,"Indiana","Union County",3,50,107,50,57
050,18,161,"Indiana","Union County",3,51,96,45,51
050,18,161,"Indiana","Union County",3,52,98,52,46
050,18,161,"Indiana","Union County",3,53,101,51,50
050,18,161,"Indiana","Union County",3,54,96,49,47
050,18,161,"Indiana","Union County",3,55,92,47,45
050,18,161,"Indiana","Union County",3,56,106,51,55
050,18,161,"Indiana","Union County",3,57,103,44,59
050,18,161,"Indiana","Union County",3,58,114,55,59
050,18,161,"Indiana","Union County",3,59,112,55,57
050,18,161,"Indiana","Union County",3,60,117,59,58
050,18,161,"Indiana","Union County",3,61,105,54,51
050,18,161,"Indiana","Union County",3,62,99,47,52
050,18,161,"Indiana","Union County",3,63,106,53,53
050,18,161,"Indiana","Union County",3,64,105,54,51
050,18,161,"Indiana","Union County",3,65,103,55,48
050,18,161,"Indiana","Union County",3,66,98,47,51
050,18,161,"Indiana","Union County",3,67,91,44,47
050,18,161,"Indiana","Union County",3,68,96,47,49
050,18,161,"Indiana","Union County",3,69,85,44,41
050,18,161,"Indiana","Union County",3,70,77,39,38
050,18,161,"Indiana","Union County",3,71,80,35,45
050,18,161,"Indiana","Union County",3,72,93,45,48
050,18,161,"Indiana","Union County",3,73,90,44,46
050,18,161,"Indiana","Union County",3,74,90,41,49
050,18,161,"Indiana","Union County",3,75,52,26,26
050,18,161,"Indiana","Union County",3,76,47,19,28
050,18,161,"Indiana","Union County",3,77,42,21,21
050,18,161,"Indiana","Union County",3,78,46,21,25
050,18,161,"Indiana","Union County",3,79,44,22,22
050,18,161,"Indiana","Union County",3,80,46,22,24
050,18,161,"Indiana","Union County",3,81,43,19,24
050,18,161,"Indiana","Union County",3,82,31,13,18
050,18,161,"Indiana","Union County",3,83,27,11,16
050,18,161,"Indiana","Union County",3,84,22,11,11
050,18,161,"Indiana","Union County",3,85,133,48,85
050,18,161,"Indiana","Union County",4,0,72,41,31
050,18,161,"Indiana","Union County",4,1,76,45,31
050,18,161,"Indiana","Union County",4,2,76,44,32
050,18,161,"Indiana","Union County",4,3,69,33,36
050,18,161,"Indiana","Union County",4,4,80,42,38
050,18,161,"Indiana","Union County",4,5,77,39,38
050,18,161,"Indiana","Union County",4,6,96,51,45
050,18,161,"Indiana","Union County",4,7,91,44,47
050,18,161,"Indiana","Union County",4,8,91,41,50
050,18,161,"Indiana","Union County",4,9,78,45,33
050,18,161,"Indiana","Union County",4,10,81,47,34
050,18,161,"Indiana","Union County",4,11,82,45,37
050,18,161,"Indiana","Union County",4,12,78,39,39
050,18,161,"Indiana","Union County",4,13,85,43,42
050,18,161,"Indiana","Union County",4,14,79,44,35
050,18,161,"Indiana","Union County",4,15,87,48,39
050,18,161,"Indiana","Union County",4,16,88,45,43
050,18,161,"Indiana","Union County",4,17,97,45,52
050,18,161,"Indiana","Union County",4,18,87,48,39
050,18,161,"Indiana","Union County",4,19,64,39,25
050,18,161,"Indiana","Union County",4,20,63,36,27
050,18,161,"Indiana","Union County",4,21,60,31,29
050,18,161,"Indiana","Union County",4,22,73,34,39
050,18,161,"Indiana","Union County",4,23,73,34,39
050,18,161,"Indiana","Union County",4,24,87,46,41
050,18,161,"Indiana","Union County",4,25,76,39,37
050,18,161,"Indiana","Union County",4,26,65,36,29
050,18,161,"Indiana","Union County",4,27,63,30,33
050,18,161,"Indiana","Union County",4,28,86,39,47
050,18,161,"Indiana","Union County",4,29,89,54,35
050,18,161,"Indiana","Union County",4,30,85,45,40
050,18,161,"Indiana","Union County",4,31,85,38,47
050,18,161,"Indiana","Union County",4,32,85,39,46
050,18,161,"Indiana","Union County",4,33,75,37,38
050,18,161,"Indiana","Union County",4,34,66,33,33
050,18,161,"Indiana","Union County",4,35,75,35,40
050,18,161,"Indiana","Union County",4,36,65,29,36
050,18,161,"Indiana","Union County",4,37,78,37,41
050,18,161,"Indiana","Union County",4,38,74,41,33
050,18,161,"Indiana","Union County",4,39,70,33,37
050,18,161,"Indiana","Union County",4,40,79,45,34
050,18,161,"Indiana","Union County",4,41,88,46,42
050,18,161,"Indiana","Union County",4,42,94,43,51
050,18,161,"Indiana","Union County",4,43,89,46,43
050,18,161,"Indiana","Union County",4,44,84,38,46
050,18,161,"Indiana","Union County",4,45,83,38,45
050,18,161,"Indiana","Union County",4,46,74,34,40
050,18,161,"Indiana","Union County",4,47,74,34,40
050,18,161,"Indiana","Union County",4,48,82,36,46
050,18,161,"Indiana","Union County",4,49,80,41,39
050,18,161,"Indiana","Union County",4,50,81,38,43
050,18,161,"Indiana","Union County",4,51,109,54,55
050,18,161,"Indiana","Union County",4,52,98,47,51
050,18,161,"Indiana","Union County",4,53,96,53,43
050,18,161,"Indiana","Union County",4,54,101,50,51
050,18,161,"Indiana","Union County",4,55,104,53,51
050,18,161,"Indiana","Union County",4,56,95,50,45
050,18,161,"Indiana","Union County",4,57,107,51,56
050,18,161,"Indiana","Union County",4,58,106,48,58
050,18,161,"Indiana","Union County",4,59,109,49,60
050,18,161,"Indiana","Union County",4,60,114,56,58
050,18,161,"Indiana","Union County",4,61,112,57,55
050,18,161,"Indiana","Union County",4,62,106,57,49
050,18,161,"Indiana","Union County",4,63,101,47,54
050,18,161,"Indiana","Union County",4,64,104,53,51
050,18,161,"Indiana","Union County",4,65,100,52,48
050,18,161,"Indiana","Union County",4,66,107,56,51
050,18,161,"Indiana","Union County",4,67,92,46,46
050,18,161,"Indiana","Union County",4,68,88,40,48
050,18,161,"Indiana","Union County",4,69,88,42,46
050,18,161,"Indiana","Union County",4,70,84,45,39
050,18,161,"Indiana","Union County",4,71,73,35,38
050,18,161,"Indiana","Union County",4,72,82,38,44
050,18,161,"Indiana","Union County",4,73,90,42,48
050,18,161,"Indiana","Union County",4,74,88,44,44
050,18,161,"Indiana","Union County",4,75,87,38,49
050,18,161,"Indiana","Union County",4,76,49,24,25
050,18,161,"Indiana","Union County",4,77,42,16,26
050,18,161,"Indiana","Union County",4,78,41,20,21
050,18,161,"Indiana","Union County",4,79,42,20,22
050,18,161,"Indiana","Union County",4,80,43,21,22
050,18,161,"Indiana","Union County",4,81,43,22,21
050,18,161,"Indiana","Union County",4,82,40,16,24
050,18,161,"Indiana","Union County",4,83,31,13,18
050,18,161,"Indiana","Union County",4,84,25,12,13
050,18,161,"Indiana","Union County",4,85,135,53,82
050,18,161,"Indiana","Union County",5,0,62,35,27
050,18,161,"Indiana","Union County",5,1,69,39,30
050,18,161,"Indiana","Union County",5,2,75,44,31
050,18,161,"Indiana","Union County",5,3,78,44,34
050,18,161,"Indiana","Union County",5,4,70,35,35
050,18,161,"Indiana","Union County",5,5,80,43,37
050,18,161,"Indiana","Union County",5,6,77,37,40
050,18,161,"Indiana","Union County",5,7,101,50,51
050,18,161,"Indiana","Union County",5,8,90,44,46
050,18,161,"Indiana","Union County",5,9,88,43,45
050,18,161,"Indiana","Union County",5,10,80,45,35
050,18,161,"Indiana","Union County",5,11,82,44,38
050,18,161,"Indiana","Union County",5,12,83,46,37
050,18,161,"Indiana","Union County",5,13,71,36,35
050,18,161,"Indiana","Union County",5,14,87,45,42
050,18,161,"Indiana","Union County",5,15,80,44,36
050,18,161,"Indiana","Union County",5,16,87,46,41
050,18,161,"Indiana","Union County",5,17,96,47,49
050,18,161,"Indiana","Union County",5,18,75,37,38
050,18,161,"Indiana","Union County",5,19,68,37,31
050,18,161,"Indiana","Union County",5,20,63,37,26
050,18,161,"Indiana","Union County",5,21,67,37,30
050,18,161,"Indiana","Union County",5,22,63,32,31
050,18,161,"Indiana","Union County",5,23,77,36,41
050,18,161,"Indiana","Union County",5,24,82,42,40
050,18,161,"Indiana","Union County",5,25,87,43,44
050,18,161,"Indiana","Union County",5,26,81,46,35
050,18,161,"Indiana","Union County",5,27,74,45,29
050,18,161,"Indiana","Union County",5,28,70,35,35
050,18,161,"Indiana","Union County",5,29,87,39,48
050,18,161,"Indiana","Union County",5,30,94,55,39
050,18,161,"Indiana","Union County",5,31,91,50,41
050,18,161,"Indiana","Union County",5,32,84,38,46
050,18,161,"Indiana","Union County",5,33,80,35,45
050,18,161,"Indiana","Union County",5,34,73,30,43
050,18,161,"Indiana","Union County",5,35,71,34,37
050,18,161,"Indiana","Union County",5,36,75,35,40
050,18,161,"Indiana","Union County",5,37,72,31,41
050,18,161,"Indiana","Union County",5,38,84,38,46
050,18,161,"Indiana","Union County",5,39,74,37,37
050,18,161,"Indiana","Union County",5,40,68,31,37
050,18,161,"Indiana","Union County",5,41,89,51,38
050,18,161,"Indiana","Union County",5,42,95,52,43
050,18,161,"Indiana","Union County",5,43,90,42,48
050,18,161,"Indiana","Union County",5,44,86,43,43
050,18,161,"Indiana","Union County",5,45,84,38,46
050,18,161,"Indiana","Union County",5,46,80,39,41
050,18,161,"Indiana","Union County",5,47,73,33,40
050,18,161,"Indiana","Union County",5,48,68,32,36
050,18,161,"Indiana","Union County",5,49,82,35,47
050,18,161,"Indiana","Union County",5,50,80,38,42
050,18,161,"Indiana","Union County",5,51,84,41,43
050,18,161,"Indiana","Union County",5,52,104,51,53
050,18,161,"Indiana","Union County",5,53,97,45,52
050,18,161,"Indiana","Union County",5,54,94,51,43
050,18,161,"Indiana","Union County",5,55,106,51,55
050,18,161,"Indiana","Union County",5,56,107,55,52
050,18,161,"Indiana","Union County",5,57,97,53,44
050,18,161,"Indiana","Union County",5,58,102,52,50
050,18,161,"Indiana","Union County",5,59,101,44,57
050,18,161,"Indiana","Union County",5,60,111,48,63
050,18,161,"Indiana","Union County",5,61,110,54,56
050,18,161,"Indiana","Union County",5,62,110,56,54
050,18,161,"Indiana","Union County",5,63,107,57,50
050,18,161,"Indiana","Union County",5,64,102,48,54
050,18,161,"Indiana","Union County",5,65,103,53,50
050,18,161,"Indiana","Union County",5,66,103,49,54
050,18,161,"Indiana","Union County",5,67,104,56,48
050,18,161,"Indiana","Union County",5,68,91,44,47
050,18,161,"Indiana","Union County",5,69,82,36,46
050,18,161,"Indiana","Union County",5,70,89,44,45
050,18,161,"Indiana","Union County",5,71,78,43,35
050,18,161,"Indiana","Union County",5,72,74,37,37
050,18,161,"Indiana","Union County",5,73,80,36,44
050,18,161,"Indiana","Union County",5,74,86,42,44
050,18,161,"Indiana","Union County",5,75,80,39,41
050,18,161,"Indiana","Union County",5,76,85,37,48
050,18,161,"Indiana","Union County",5,77,44,21,23
050,18,161,"Indiana","Union County",5,78,41,15,26
050,18,161,"Indiana","Union County",5,79,38,19,19
050,18,161,"Indiana","Union County",5,80,39,18,21
050,18,161,"Indiana","Union County",5,81,40,21,19
050,18,161,"Indiana","Union County",5,82,41,20,21
050,18,161,"Indiana","Union County",5,83,37,15,22
050,18,161,"Indiana","Union County",5,84,27,13,14
050,18,161,"Indiana","Union County",5,85,136,57,79
050,18,163,"Indiana","Vanderburgh County",1,0,2051,1049,1002
050,18,163,"Indiana","Vanderburgh County",1,1,2077,1078,999
050,18,163,"Indiana","Vanderburgh County",1,2,2160,1123,1037
050,18,163,"Indiana","Vanderburgh County",1,3,2192,1152,1040
050,18,163,"Indiana","Vanderburgh County",1,4,2208,1133,1075
050,18,163,"Indiana","Vanderburgh County",1,5,2182,1135,1047
050,18,163,"Indiana","Vanderburgh County",1,6,2157,1132,1025
050,18,163,"Indiana","Vanderburgh County",1,7,2128,1085,1043
050,18,163,"Indiana","Vanderburgh County",1,8,2178,1090,1088
050,18,163,"Indiana","Vanderburgh County",1,9,2203,1089,1114
050,18,163,"Indiana","Vanderburgh County",1,10,2298,1197,1101
050,18,163,"Indiana","Vanderburgh County",1,11,2244,1119,1125
050,18,163,"Indiana","Vanderburgh County",1,12,2263,1126,1137
050,18,163,"Indiana","Vanderburgh County",1,13,2335,1165,1170
050,18,163,"Indiana","Vanderburgh County",1,14,2242,1118,1124
050,18,163,"Indiana","Vanderburgh County",1,15,2188,1104,1084
050,18,163,"Indiana","Vanderburgh County",1,16,2236,1135,1101
050,18,163,"Indiana","Vanderburgh County",1,17,2144,1097,1047
050,18,163,"Indiana","Vanderburgh County",1,18,2142,1080,1062
050,18,163,"Indiana","Vanderburgh County",1,19,2783,1300,1483
050,18,163,"Indiana","Vanderburgh County",1,20,2459,1177,1282
050,18,163,"Indiana","Vanderburgh County",1,21,2377,1163,1214
050,18,163,"Indiana","Vanderburgh County",1,22,2368,1133,1235
050,18,163,"Indiana","Vanderburgh County",1,23,2334,1147,1187
050,18,163,"Indiana","Vanderburgh County",1,24,2465,1215,1250
050,18,163,"Indiana","Vanderburgh County",1,25,2490,1251,1239
050,18,163,"Indiana","Vanderburgh County",1,26,2515,1256,1259
050,18,163,"Indiana","Vanderburgh County",1,27,2540,1294,1246
050,18,163,"Indiana","Vanderburgh County",1,28,2644,1314,1330
050,18,163,"Indiana","Vanderburgh County",1,29,2660,1301,1359
050,18,163,"Indiana","Vanderburgh County",1,30,2593,1264,1329
050,18,163,"Indiana","Vanderburgh County",1,31,2537,1258,1279
050,18,163,"Indiana","Vanderburgh County",1,32,2480,1237,1243
050,18,163,"Indiana","Vanderburgh County",1,33,2407,1185,1222
050,18,163,"Indiana","Vanderburgh County",1,34,2390,1196,1194
050,18,163,"Indiana","Vanderburgh County",1,35,2324,1220,1104
050,18,163,"Indiana","Vanderburgh County",1,36,2381,1219,1162
050,18,163,"Indiana","Vanderburgh County",1,37,2376,1197,1179
050,18,163,"Indiana","Vanderburgh County",1,38,2377,1213,1164
050,18,163,"Indiana","Vanderburgh County",1,39,2326,1196,1130
050,18,163,"Indiana","Vanderburgh County",1,40,2218,1118,1100
050,18,163,"Indiana","Vanderburgh County",1,41,2075,1034,1041
050,18,163,"Indiana","Vanderburgh County",1,42,2091,1074,1017
050,18,163,"Indiana","Vanderburgh County",1,43,1988,979,1009
050,18,163,"Indiana","Vanderburgh County",1,44,1933,963,970
050,18,163,"Indiana","Vanderburgh County",1,45,1901,941,960
050,18,163,"Indiana","Vanderburgh County",1,46,1950,981,969
050,18,163,"Indiana","Vanderburgh County",1,47,2020,1025,995
050,18,163,"Indiana","Vanderburgh County",1,48,2068,1044,1024
050,18,163,"Indiana","Vanderburgh County",1,49,2196,1085,1111
050,18,163,"Indiana","Vanderburgh County",1,50,2064,1033,1031
050,18,163,"Indiana","Vanderburgh County",1,51,2027,1023,1004
050,18,163,"Indiana","Vanderburgh County",1,52,2011,1007,1004
050,18,163,"Indiana","Vanderburgh County",1,53,2086,1010,1076
050,18,163,"Indiana","Vanderburgh County",1,54,2126,1039,1087
050,18,163,"Indiana","Vanderburgh County",1,55,2276,1106,1170
050,18,163,"Indiana","Vanderburgh County",1,56,2379,1162,1217
050,18,163,"Indiana","Vanderburgh County",1,57,2456,1169,1287
050,18,163,"Indiana","Vanderburgh County",1,58,2525,1215,1310
050,18,163,"Indiana","Vanderburgh County",1,59,2546,1247,1299
050,18,163,"Indiana","Vanderburgh County",1,60,2552,1273,1279
050,18,163,"Indiana","Vanderburgh County",1,61,2494,1208,1286
050,18,163,"Indiana","Vanderburgh County",1,62,2571,1222,1349
050,18,163,"Indiana","Vanderburgh County",1,63,2558,1234,1324
050,18,163,"Indiana","Vanderburgh County",1,64,2365,1171,1194
050,18,163,"Indiana","Vanderburgh County",1,65,2327,1120,1207
050,18,163,"Indiana","Vanderburgh County",1,66,2300,1103,1197
050,18,163,"Indiana","Vanderburgh County",1,67,2183,1056,1127
050,18,163,"Indiana","Vanderburgh County",1,68,2035,956,1079
050,18,163,"Indiana","Vanderburgh County",1,69,1796,864,932
050,18,163,"Indiana","Vanderburgh County",1,70,1767,829,938
050,18,163,"Indiana","Vanderburgh County",1,71,1714,793,921
050,18,163,"Indiana","Vanderburgh County",1,72,1609,737,872
050,18,163,"Indiana","Vanderburgh County",1,73,1630,724,906
050,18,163,"Indiana","Vanderburgh County",1,74,1159,504,655
050,18,163,"Indiana","Vanderburgh County",1,75,1125,502,623
050,18,163,"Indiana","Vanderburgh County",1,76,1090,482,608
050,18,163,"Indiana","Vanderburgh County",1,77,1107,482,625
050,18,163,"Indiana","Vanderburgh County",1,78,926,413,513
050,18,163,"Indiana","Vanderburgh County",1,79,871,370,501
050,18,163,"Indiana","Vanderburgh County",1,80,829,336,493
050,18,163,"Indiana","Vanderburgh County",1,81,806,314,492
050,18,163,"Indiana","Vanderburgh County",1,82,770,310,460
050,18,163,"Indiana","Vanderburgh County",1,83,670,256,414
050,18,163,"Indiana","Vanderburgh County",1,84,599,245,354
050,18,163,"Indiana","Vanderburgh County",1,85,3885,1233,2652
050,18,163,"Indiana","Vanderburgh County",2,0,2057,1074,983
050,18,163,"Indiana","Vanderburgh County",2,1,2069,1073,996
050,18,163,"Indiana","Vanderburgh County",2,2,2141,1116,1025
050,18,163,"Indiana","Vanderburgh County",2,3,2181,1142,1039
050,18,163,"Indiana","Vanderburgh County",2,4,2216,1144,1072
050,18,163,"Indiana","Vanderburgh County",2,5,2187,1135,1052
050,18,163,"Indiana","Vanderburgh County",2,6,2167,1137,1030
050,18,163,"Indiana","Vanderburgh County",2,7,2136,1098,1038
050,18,163,"Indiana","Vanderburgh County",2,8,2164,1087,1077
050,18,163,"Indiana","Vanderburgh County",2,9,2195,1088,1107
050,18,163,"Indiana","Vanderburgh County",2,10,2275,1170,1105
050,18,163,"Indiana","Vanderburgh County",2,11,2255,1139,1116
050,18,163,"Indiana","Vanderburgh County",2,12,2273,1131,1142
050,18,163,"Indiana","Vanderburgh County",2,13,2317,1155,1162
050,18,163,"Indiana","Vanderburgh County",2,14,2268,1130,1138
050,18,163,"Indiana","Vanderburgh County",2,15,2210,1109,1101
050,18,163,"Indiana","Vanderburgh County",2,16,2226,1130,1096
050,18,163,"Indiana","Vanderburgh County",2,17,2162,1107,1055
050,18,163,"Indiana","Vanderburgh County",2,18,2151,1075,1076
050,18,163,"Indiana","Vanderburgh County",2,19,2776,1299,1477
050,18,163,"Indiana","Vanderburgh County",2,20,2501,1201,1300
050,18,163,"Indiana","Vanderburgh County",2,21,2390,1168,1222
050,18,163,"Indiana","Vanderburgh County",2,22,2386,1144,1242
050,18,163,"Indiana","Vanderburgh County",2,23,2340,1146,1194
050,18,163,"Indiana","Vanderburgh County",2,24,2437,1201,1236
050,18,163,"Indiana","Vanderburgh County",2,25,2489,1246,1243
050,18,163,"Indiana","Vanderburgh County",2,26,2510,1258,1252
050,18,163,"Indiana","Vanderburgh County",2,27,2527,1278,1249
050,18,163,"Indiana","Vanderburgh County",2,28,2626,1318,1308
050,18,163,"Indiana","Vanderburgh County",2,29,2654,1298,1356
050,18,163,"Indiana","Vanderburgh County",2,30,2620,1278,1342
050,18,163,"Indiana","Vanderburgh County",2,31,2539,1253,1286
050,18,163,"Indiana","Vanderburgh County",2,32,2498,1246,1252
050,18,163,"Indiana","Vanderburgh County",2,33,2413,1189,1224
050,18,163,"Indiana","Vanderburgh County",2,34,2395,1199,1196
050,18,163,"Indiana","Vanderburgh County",2,35,2350,1221,1129
050,18,163,"Indiana","Vanderburgh County",2,36,2355,1210,1145
050,18,163,"Indiana","Vanderburgh County",2,37,2380,1204,1176
050,18,163,"Indiana","Vanderburgh County",2,38,2379,1210,1169
050,18,163,"Indiana","Vanderburgh County",2,39,2337,1203,1134
050,18,163,"Indiana","Vanderburgh County",2,40,2259,1141,1118
050,18,163,"Indiana","Vanderburgh County",2,41,2113,1056,1057
050,18,163,"Indiana","Vanderburgh County",2,42,2082,1060,1022
050,18,163,"Indiana","Vanderburgh County",2,43,2025,1007,1018
050,18,163,"Indiana","Vanderburgh County",2,44,1927,962,965
050,18,163,"Indiana","Vanderburgh County",2,45,1924,954,970
050,18,163,"Indiana","Vanderburgh County",2,46,1938,972,966
050,18,163,"Indiana","Vanderburgh County",2,47,1994,1011,983
050,18,163,"Indiana","Vanderburgh County",2,48,2055,1039,1016
050,18,163,"Indiana","Vanderburgh County",2,49,2178,1084,1094
050,18,163,"Indiana","Vanderburgh County",2,50,2095,1043,1052
050,18,163,"Indiana","Vanderburgh County",2,51,2031,1025,1006
050,18,163,"Indiana","Vanderburgh County",2,52,2011,1006,1005
050,18,163,"Indiana","Vanderburgh County",2,53,2066,1009,1057
050,18,163,"Indiana","Vanderburgh County",2,54,2106,1024,1082
050,18,163,"Indiana","Vanderburgh County",2,55,2236,1089,1147
050,18,163,"Indiana","Vanderburgh County",2,56,2354,1146,1208
050,18,163,"Indiana","Vanderburgh County",2,57,2435,1167,1268
050,18,163,"Indiana","Vanderburgh County",2,58,2496,1197,1299
050,18,163,"Indiana","Vanderburgh County",2,59,2548,1245,1303
050,18,163,"Indiana","Vanderburgh County",2,60,2546,1261,1285
050,18,163,"Indiana","Vanderburgh County",2,61,2491,1210,1281
050,18,163,"Indiana","Vanderburgh County",2,62,2546,1214,1332
050,18,163,"Indiana","Vanderburgh County",2,63,2567,1234,1333
050,18,163,"Indiana","Vanderburgh County",2,64,2386,1172,1214
050,18,163,"Indiana","Vanderburgh County",2,65,2323,1128,1195
050,18,163,"Indiana","Vanderburgh County",2,66,2300,1100,1200
050,18,163,"Indiana","Vanderburgh County",2,67,2198,1062,1136
050,18,163,"Indiana","Vanderburgh County",2,68,2041,964,1077
050,18,163,"Indiana","Vanderburgh County",2,69,1853,886,967
050,18,163,"Indiana","Vanderburgh County",2,70,1761,826,935
050,18,163,"Indiana","Vanderburgh County",2,71,1712,791,921
050,18,163,"Indiana","Vanderburgh County",2,72,1603,734,869
050,18,163,"Indiana","Vanderburgh County",2,73,1690,757,933
050,18,163,"Indiana","Vanderburgh County",2,74,1193,518,675
050,18,163,"Indiana","Vanderburgh County",2,75,1129,498,631
050,18,163,"Indiana","Vanderburgh County",2,76,1084,477,607
050,18,163,"Indiana","Vanderburgh County",2,77,1118,486,632
050,18,163,"Indiana","Vanderburgh County",2,78,942,416,526
050,18,163,"Indiana","Vanderburgh County",2,79,875,378,497
050,18,163,"Indiana","Vanderburgh County",2,80,834,339,495
050,18,163,"Indiana","Vanderburgh County",2,81,790,311,479
050,18,163,"Indiana","Vanderburgh County",2,82,761,301,460
050,18,163,"Indiana","Vanderburgh County",2,83,679,263,416
050,18,163,"Indiana","Vanderburgh County",2,84,600,241,359
050,18,163,"Indiana","Vanderburgh County",2,85,3889,1243,2646
050,18,163,"Indiana","Vanderburgh County",3,0,2035,1014,1021
050,18,163,"Indiana","Vanderburgh County",3,1,2073,1099,974
050,18,163,"Indiana","Vanderburgh County",3,2,2030,1049,981
050,18,163,"Indiana","Vanderburgh County",3,3,2132,1096,1036
050,18,163,"Indiana","Vanderburgh County",3,4,2144,1147,997
050,18,163,"Indiana","Vanderburgh County",3,5,2186,1129,1057
050,18,163,"Indiana","Vanderburgh County",3,6,2148,1098,1050
050,18,163,"Indiana","Vanderburgh County",3,7,2180,1147,1033
050,18,163,"Indiana","Vanderburgh County",3,8,2164,1112,1052
050,18,163,"Indiana","Vanderburgh County",3,9,2159,1093,1066
050,18,163,"Indiana","Vanderburgh County",3,10,2162,1060,1102
050,18,163,"Indiana","Vanderburgh County",3,11,2240,1162,1078
050,18,163,"Indiana","Vanderburgh County",3,12,2240,1123,1117
050,18,163,"Indiana","Vanderburgh County",3,13,2260,1123,1137
050,18,163,"Indiana","Vanderburgh County",3,14,2309,1169,1140
050,18,163,"Indiana","Vanderburgh County",3,15,2272,1111,1161
050,18,163,"Indiana","Vanderburgh County",3,16,2224,1133,1091
050,18,163,"Indiana","Vanderburgh County",3,17,2237,1142,1095
050,18,163,"Indiana","Vanderburgh County",3,18,2196,1072,1124
050,18,163,"Indiana","Vanderburgh County",3,19,2744,1286,1458
050,18,163,"Indiana","Vanderburgh County",3,20,2544,1234,1310
050,18,163,"Indiana","Vanderburgh County",3,21,2450,1205,1245
050,18,163,"Indiana","Vanderburgh County",3,22,2409,1172,1237
050,18,163,"Indiana","Vanderburgh County",3,23,2365,1148,1217
050,18,163,"Indiana","Vanderburgh County",3,24,2422,1175,1247
050,18,163,"Indiana","Vanderburgh County",3,25,2499,1253,1246
050,18,163,"Indiana","Vanderburgh County",3,26,2511,1268,1243
050,18,163,"Indiana","Vanderburgh County",3,27,2507,1246,1261
050,18,163,"Indiana","Vanderburgh County",3,28,2539,1298,1241
050,18,163,"Indiana","Vanderburgh County",3,29,2625,1315,1310
050,18,163,"Indiana","Vanderburgh County",3,30,2621,1282,1339
050,18,163,"Indiana","Vanderburgh County",3,31,2558,1256,1302
050,18,163,"Indiana","Vanderburgh County",3,32,2562,1271,1291
050,18,163,"Indiana","Vanderburgh County",3,33,2475,1245,1230
050,18,163,"Indiana","Vanderburgh County",3,34,2394,1184,1210
050,18,163,"Indiana","Vanderburgh County",3,35,2351,1178,1173
050,18,163,"Indiana","Vanderburgh County",3,36,2342,1205,1137
050,18,163,"Indiana","Vanderburgh County",3,37,2312,1179,1133
050,18,163,"Indiana","Vanderburgh County",3,38,2375,1204,1171
050,18,163,"Indiana","Vanderburgh County",3,39,2366,1207,1159
050,18,163,"Indiana","Vanderburgh County",3,40,2282,1144,1138
050,18,163,"Indiana","Vanderburgh County",3,41,2253,1127,1126
050,18,163,"Indiana","Vanderburgh County",3,42,2127,1060,1067
050,18,163,"Indiana","Vanderburgh County",3,43,2095,1065,1030
050,18,163,"Indiana","Vanderburgh County",3,44,2031,1018,1013
050,18,163,"Indiana","Vanderburgh County",3,45,1911,961,950
050,18,163,"Indiana","Vanderburgh County",3,46,1936,963,973
050,18,163,"Indiana","Vanderburgh County",3,47,1916,952,964
050,18,163,"Indiana","Vanderburgh County",3,48,1968,994,974
050,18,163,"Indiana","Vanderburgh County",3,49,2049,1063,986
050,18,163,"Indiana","Vanderburgh County",3,50,2169,1070,1099
050,18,163,"Indiana","Vanderburgh County",3,51,2110,1057,1053
050,18,163,"Indiana","Vanderburgh County",3,52,2026,1004,1022
050,18,163,"Indiana","Vanderburgh County",3,53,1985,986,999
050,18,163,"Indiana","Vanderburgh County",3,54,2041,1007,1034
050,18,163,"Indiana","Vanderburgh County",3,55,2091,1027,1064
050,18,163,"Indiana","Vanderburgh County",3,56,2208,1078,1130
050,18,163,"Indiana","Vanderburgh County",3,57,2295,1110,1185
050,18,163,"Indiana","Vanderburgh County",3,58,2411,1145,1266
050,18,163,"Indiana","Vanderburgh County",3,59,2481,1186,1295
050,18,163,"Indiana","Vanderburgh County",3,60,2517,1218,1299
050,18,163,"Indiana","Vanderburgh County",3,61,2510,1214,1296
050,18,163,"Indiana","Vanderburgh County",3,62,2440,1189,1251
050,18,163,"Indiana","Vanderburgh County",3,63,2521,1205,1316
050,18,163,"Indiana","Vanderburgh County",3,64,2505,1201,1304
050,18,163,"Indiana","Vanderburgh County",3,65,2354,1162,1192
050,18,163,"Indiana","Vanderburgh County",3,66,2291,1099,1192
050,18,163,"Indiana","Vanderburgh County",3,67,2230,1077,1153
050,18,163,"Indiana","Vanderburgh County",3,68,2133,1025,1108
050,18,163,"Indiana","Vanderburgh County",3,69,1983,939,1044
050,18,163,"Indiana","Vanderburgh County",3,70,1779,840,939
050,18,163,"Indiana","Vanderburgh County",3,71,1695,781,914
050,18,163,"Indiana","Vanderburgh County",3,72,1689,785,904
050,18,163,"Indiana","Vanderburgh County",3,73,1529,694,835
050,18,163,"Indiana","Vanderburgh County",3,74,1637,727,910
050,18,163,"Indiana","Vanderburgh County",3,75,1145,491,654
050,18,163,"Indiana","Vanderburgh County",3,76,1050,460,590
050,18,163,"Indiana","Vanderburgh County",3,77,1042,458,584
050,18,163,"Indiana","Vanderburgh County",3,78,1070,461,609
050,18,163,"Indiana","Vanderburgh County",3,79,900,392,508
050,18,163,"Indiana","Vanderburgh County",3,80,840,352,488
050,18,163,"Indiana","Vanderburgh County",3,81,753,294,459
050,18,163,"Indiana","Vanderburgh County",3,82,725,286,439
050,18,163,"Indiana","Vanderburgh County",3,83,698,267,431
050,18,163,"Indiana","Vanderburgh County",3,84,626,237,389
050,18,163,"Indiana","Vanderburgh County",3,85,3756,1213,2543
050,18,163,"Indiana","Vanderburgh County",4,0,2171,1076,1095
050,18,163,"Indiana","Vanderburgh County",4,1,2006,999,1007
050,18,163,"Indiana","Vanderburgh County",4,2,2088,1117,971
050,18,163,"Indiana","Vanderburgh County",4,3,2013,1030,983
050,18,163,"Indiana","Vanderburgh County",4,4,2101,1087,1014
050,18,163,"Indiana","Vanderburgh County",4,5,2122,1128,994
050,18,163,"Indiana","Vanderburgh County",4,6,2183,1133,1050
050,18,163,"Indiana","Vanderburgh County",4,7,2153,1127,1026
050,18,163,"Indiana","Vanderburgh County",4,8,2148,1124,1024
050,18,163,"Indiana","Vanderburgh County",4,9,2108,1083,1025
050,18,163,"Indiana","Vanderburgh County",4,10,2130,1089,1041
050,18,163,"Indiana","Vanderburgh County",4,11,2160,1074,1086
050,18,163,"Indiana","Vanderburgh County",4,12,2224,1143,1081
050,18,163,"Indiana","Vanderburgh County",4,13,2234,1120,1114
050,18,163,"Indiana","Vanderburgh County",4,14,2281,1134,1147
050,18,163,"Indiana","Vanderburgh County",4,15,2298,1174,1124
050,18,163,"Indiana","Vanderburgh County",4,16,2247,1103,1144
050,18,163,"Indiana","Vanderburgh County",4,17,2268,1150,1118
050,18,163,"Indiana","Vanderburgh County",4,18,2213,1078,1135
050,18,163,"Indiana","Vanderburgh County",4,19,2727,1274,1453
050,18,163,"Indiana","Vanderburgh County",4,20,2464,1200,1264
050,18,163,"Indiana","Vanderburgh County",4,21,2455,1203,1252
050,18,163,"Indiana","Vanderburgh County",4,22,2469,1215,1254
050,18,163,"Indiana","Vanderburgh County",4,23,2423,1193,1230
050,18,163,"Indiana","Vanderburgh County",4,24,2406,1184,1222
050,18,163,"Indiana","Vanderburgh County",4,25,2461,1206,1255
050,18,163,"Indiana","Vanderburgh County",4,26,2464,1235,1229
050,18,163,"Indiana","Vanderburgh County",4,27,2456,1257,1199
050,18,163,"Indiana","Vanderburgh County",4,28,2467,1224,1243
050,18,163,"Indiana","Vanderburgh County",4,29,2481,1271,1210
050,18,163,"Indiana","Vanderburgh County",4,30,2597,1313,1284
050,18,163,"Indiana","Vanderburgh County",4,31,2591,1255,1336
050,18,163,"Indiana","Vanderburgh County",4,32,2557,1270,1287
050,18,163,"Indiana","Vanderburgh County",4,33,2473,1233,1240
050,18,163,"Indiana","Vanderburgh County",4,34,2416,1224,1192
050,18,163,"Indiana","Vanderburgh County",4,35,2363,1180,1183
050,18,163,"Indiana","Vanderburgh County",4,36,2285,1139,1146
050,18,163,"Indiana","Vanderburgh County",4,37,2314,1199,1115
050,18,163,"Indiana","Vanderburgh County",4,38,2274,1147,1127
050,18,163,"Indiana","Vanderburgh County",4,39,2380,1214,1166
050,18,163,"Indiana","Vanderburgh County",4,40,2321,1158,1163
050,18,163,"Indiana","Vanderburgh County",4,41,2237,1128,1109
050,18,163,"Indiana","Vanderburgh County",4,42,2236,1124,1112
050,18,163,"Indiana","Vanderburgh County",4,43,2123,1049,1074
050,18,163,"Indiana","Vanderburgh County",4,44,2101,1075,1026
050,18,163,"Indiana","Vanderburgh County",4,45,1994,1001,993
050,18,163,"Indiana","Vanderburgh County",4,46,1949,980,969
050,18,163,"Indiana","Vanderburgh County",4,47,1921,944,977
050,18,163,"Indiana","Vanderburgh County",4,48,1876,932,944
050,18,163,"Indiana","Vanderburgh County",4,49,1972,1020,952
050,18,163,"Indiana","Vanderburgh County",4,50,2053,1047,1006
050,18,163,"Indiana","Vanderburgh County",4,51,2134,1049,1085
050,18,163,"Indiana","Vanderburgh County",4,52,2131,1064,1067
050,18,163,"Indiana","Vanderburgh County",4,53,2007,988,1019
050,18,163,"Indiana","Vanderburgh County",4,54,1971,979,992
050,18,163,"Indiana","Vanderburgh County",4,55,2030,1000,1030
050,18,163,"Indiana","Vanderburgh County",4,56,2069,1004,1065
050,18,163,"Indiana","Vanderburgh County",4,57,2155,1056,1099
050,18,163,"Indiana","Vanderburgh County",4,58,2268,1099,1169
050,18,163,"Indiana","Vanderburgh County",4,59,2375,1123,1252
050,18,163,"Indiana","Vanderburgh County",4,60,2487,1187,1300
050,18,163,"Indiana","Vanderburgh County",4,61,2484,1186,1298
050,18,163,"Indiana","Vanderburgh County",4,62,2458,1196,1262
050,18,163,"Indiana","Vanderburgh County",4,63,2404,1164,1240
050,18,163,"Indiana","Vanderburgh County",4,64,2455,1160,1295
050,18,163,"Indiana","Vanderburgh County",4,65,2461,1177,1284
050,18,163,"Indiana","Vanderburgh County",4,66,2307,1124,1183
050,18,163,"Indiana","Vanderburgh County",4,67,2233,1076,1157
050,18,163,"Indiana","Vanderburgh County",4,68,2165,1041,1124
050,18,163,"Indiana","Vanderburgh County",4,69,2081,991,1090
050,18,163,"Indiana","Vanderburgh County",4,70,1917,911,1006
050,18,163,"Indiana","Vanderburgh County",4,71,1725,799,926
050,18,163,"Indiana","Vanderburgh County",4,72,1656,767,889
050,18,163,"Indiana","Vanderburgh County",4,73,1625,749,876
050,18,163,"Indiana","Vanderburgh County",4,74,1477,673,804
050,18,163,"Indiana","Vanderburgh County",4,75,1594,709,885
050,18,163,"Indiana","Vanderburgh County",4,76,1064,455,609
050,18,163,"Indiana","Vanderburgh County",4,77,1002,431,571
050,18,163,"Indiana","Vanderburgh County",4,78,997,438,559
050,18,163,"Indiana","Vanderburgh County",4,79,1021,426,595
050,18,163,"Indiana","Vanderburgh County",4,80,855,363,492
050,18,163,"Indiana","Vanderburgh County",4,81,781,314,467
050,18,163,"Indiana","Vanderburgh County",4,82,695,275,420
050,18,163,"Indiana","Vanderburgh County",4,83,664,261,403
050,18,163,"Indiana","Vanderburgh County",4,84,639,245,394
050,18,163,"Indiana","Vanderburgh County",4,85,3722,1204,2518
050,18,163,"Indiana","Vanderburgh County",5,0,2160,1076,1084
050,18,163,"Indiana","Vanderburgh County",5,1,2146,1070,1076
050,18,163,"Indiana","Vanderburgh County",5,2,1992,972,1020
050,18,163,"Indiana","Vanderburgh County",5,3,2047,1085,962
050,18,163,"Indiana","Vanderburgh County",5,4,2034,1045,989
050,18,163,"Indiana","Vanderburgh County",5,5,2111,1104,1007
050,18,163,"Indiana","Vanderburgh County",5,6,2142,1135,1007
050,18,163,"Indiana","Vanderburgh County",5,7,2202,1139,1063
050,18,163,"Indiana","Vanderburgh County",5,8,2153,1121,1032
050,18,163,"Indiana","Vanderburgh County",5,9,2129,1122,1007
050,18,163,"Indiana","Vanderburgh County",5,10,2133,1109,1024
050,18,163,"Indiana","Vanderburgh County",5,11,2146,1084,1062
050,18,163,"Indiana","Vanderburgh County",5,12,2176,1075,1101
050,18,163,"Indiana","Vanderburgh County",5,13,2215,1137,1078
050,18,163,"Indiana","Vanderburgh County",5,14,2240,1129,1111
050,18,163,"Indiana","Vanderburgh County",5,15,2257,1119,1138
050,18,163,"Indiana","Vanderburgh County",5,16,2274,1160,1114
050,18,163,"Indiana","Vanderburgh County",5,17,2261,1104,1157
050,18,163,"Indiana","Vanderburgh County",5,18,2231,1108,1123
050,18,163,"Indiana","Vanderburgh County",5,19,2750,1275,1475
050,18,163,"Indiana","Vanderburgh County",5,20,2478,1200,1278
050,18,163,"Indiana","Vanderburgh County",5,21,2386,1184,1202
050,18,163,"Indiana","Vanderburgh County",5,22,2547,1222,1325
050,18,163,"Indiana","Vanderburgh County",5,23,2398,1204,1194
050,18,163,"Indiana","Vanderburgh County",5,24,2480,1227,1253
050,18,163,"Indiana","Vanderburgh County",5,25,2407,1191,1216
050,18,163,"Indiana","Vanderburgh County",5,26,2434,1220,1214
050,18,163,"Indiana","Vanderburgh County",5,27,2460,1246,1214
050,18,163,"Indiana","Vanderburgh County",5,28,2425,1232,1193
050,18,163,"Indiana","Vanderburgh County",5,29,2447,1197,1250
050,18,163,"Indiana","Vanderburgh County",5,30,2487,1252,1235
050,18,163,"Indiana","Vanderburgh County",5,31,2536,1267,1269
050,18,163,"Indiana","Vanderburgh County",5,32,2590,1253,1337
050,18,163,"Indiana","Vanderburgh County",5,33,2541,1256,1285
050,18,163,"Indiana","Vanderburgh County",5,34,2430,1224,1206
050,18,163,"Indiana","Vanderburgh County",5,35,2370,1208,1162
050,18,163,"Indiana","Vanderburgh County",5,36,2366,1184,1182
050,18,163,"Indiana","Vanderburgh County",5,37,2271,1126,1145
050,18,163,"Indiana","Vanderburgh County",5,38,2302,1186,1116
050,18,163,"Indiana","Vanderburgh County",5,39,2255,1122,1133
050,18,163,"Indiana","Vanderburgh County",5,40,2389,1207,1182
050,18,163,"Indiana","Vanderburgh County",5,41,2303,1157,1146
050,18,163,"Indiana","Vanderburgh County",5,42,2248,1142,1106
050,18,163,"Indiana","Vanderburgh County",5,43,2240,1126,1114
050,18,163,"Indiana","Vanderburgh County",5,44,2128,1057,1071
050,18,163,"Indiana","Vanderburgh County",5,45,2066,1039,1027
050,18,163,"Indiana","Vanderburgh County",5,46,1980,993,987
050,18,163,"Indiana","Vanderburgh County",5,47,1929,954,975
050,18,163,"Indiana","Vanderburgh County",5,48,1914,952,962
050,18,163,"Indiana","Vanderburgh County",5,49,1886,945,941
050,18,163,"Indiana","Vanderburgh County",5,50,1963,1001,962
050,18,163,"Indiana","Vanderburgh County",5,51,2031,1024,1007
050,18,163,"Indiana","Vanderburgh County",5,52,2123,1036,1087
050,18,163,"Indiana","Vanderburgh County",5,53,2132,1060,1072
050,18,163,"Indiana","Vanderburgh County",5,54,1969,971,998
050,18,163,"Indiana","Vanderburgh County",5,55,1993,984,1009
050,18,163,"Indiana","Vanderburgh County",5,56,2007,978,1029
050,18,163,"Indiana","Vanderburgh County",5,57,2010,967,1043
050,18,163,"Indiana","Vanderburgh County",5,58,2155,1053,1102
050,18,163,"Indiana","Vanderburgh County",5,59,2276,1110,1166
050,18,163,"Indiana","Vanderburgh County",5,60,2366,1124,1242
050,18,163,"Indiana","Vanderburgh County",5,61,2424,1151,1273
050,18,163,"Indiana","Vanderburgh County",5,62,2439,1162,1277
050,18,163,"Indiana","Vanderburgh County",5,63,2434,1170,1264
050,18,163,"Indiana","Vanderburgh County",5,64,2336,1133,1203
050,18,163,"Indiana","Vanderburgh County",5,65,2416,1131,1285
050,18,163,"Indiana","Vanderburgh County",5,66,2435,1158,1277
050,18,163,"Indiana","Vanderburgh County",5,67,2261,1089,1172
050,18,163,"Indiana","Vanderburgh County",5,68,2186,1039,1147
050,18,163,"Indiana","Vanderburgh County",5,69,2106,1013,1093
050,18,163,"Indiana","Vanderburgh County",5,70,2031,973,1058
050,18,163,"Indiana","Vanderburgh County",5,71,1853,874,979
050,18,163,"Indiana","Vanderburgh County",5,72,1693,790,903
050,18,163,"Indiana","Vanderburgh County",5,73,1602,732,870
050,18,163,"Indiana","Vanderburgh County",5,74,1582,726,856
050,18,163,"Indiana","Vanderburgh County",5,75,1452,654,798
050,18,163,"Indiana","Vanderburgh County",5,76,1523,676,847
050,18,163,"Indiana","Vanderburgh County",5,77,1033,439,594
050,18,163,"Indiana","Vanderburgh County",5,78,964,412,552
050,18,163,"Indiana","Vanderburgh County",5,79,958,416,542
050,18,163,"Indiana","Vanderburgh County",5,80,987,403,584
050,18,163,"Indiana","Vanderburgh County",5,81,808,331,477
050,18,163,"Indiana","Vanderburgh County",5,82,731,296,435
050,18,163,"Indiana","Vanderburgh County",5,83,653,257,396
050,18,163,"Indiana","Vanderburgh County",5,84,612,235,377
050,18,163,"Indiana","Vanderburgh County",5,85,3774,1226,2548
050,18,165,"Indiana","Vermillion County",1,0,173,87,86
050,18,165,"Indiana","Vermillion County",1,1,165,80,85
050,18,165,"Indiana","Vermillion County",1,2,173,81,92
050,18,165,"Indiana","Vermillion County",1,3,174,94,80
050,18,165,"Indiana","Vermillion County",1,4,167,87,80
050,18,165,"Indiana","Vermillion County",1,5,170,81,89
050,18,165,"Indiana","Vermillion County",1,6,188,96,92
050,18,165,"Indiana","Vermillion County",1,7,188,93,95
050,18,165,"Indiana","Vermillion County",1,8,197,105,92
050,18,165,"Indiana","Vermillion County",1,9,192,102,90
050,18,165,"Indiana","Vermillion County",1,10,189,98,91
050,18,165,"Indiana","Vermillion County",1,11,191,101,90
050,18,165,"Indiana","Vermillion County",1,12,191,91,100
050,18,165,"Indiana","Vermillion County",1,13,205,106,99
050,18,165,"Indiana","Vermillion County",1,14,220,121,99
050,18,165,"Indiana","Vermillion County",1,15,203,115,88
050,18,165,"Indiana","Vermillion County",1,16,220,123,97
050,18,165,"Indiana","Vermillion County",1,17,230,117,113
050,18,165,"Indiana","Vermillion County",1,18,179,98,81
050,18,165,"Indiana","Vermillion County",1,19,157,92,65
050,18,165,"Indiana","Vermillion County",1,20,187,105,82
050,18,165,"Indiana","Vermillion County",1,21,165,96,69
050,18,165,"Indiana","Vermillion County",1,22,165,92,73
050,18,165,"Indiana","Vermillion County",1,23,184,104,80
050,18,165,"Indiana","Vermillion County",1,24,178,92,86
050,18,165,"Indiana","Vermillion County",1,25,167,91,76
050,18,165,"Indiana","Vermillion County",1,26,191,97,94
050,18,165,"Indiana","Vermillion County",1,27,197,99,98
050,18,165,"Indiana","Vermillion County",1,28,191,98,93
050,18,165,"Indiana","Vermillion County",1,29,196,98,98
050,18,165,"Indiana","Vermillion County",1,30,158,83,75
050,18,165,"Indiana","Vermillion County",1,31,169,85,84
050,18,165,"Indiana","Vermillion County",1,32,169,91,78
050,18,165,"Indiana","Vermillion County",1,33,161,90,71
050,18,165,"Indiana","Vermillion County",1,34,161,84,77
050,18,165,"Indiana","Vermillion County",1,35,151,76,75
050,18,165,"Indiana","Vermillion County",1,36,162,77,85
050,18,165,"Indiana","Vermillion County",1,37,177,83,94
050,18,165,"Indiana","Vermillion County",1,38,170,89,81
050,18,165,"Indiana","Vermillion County",1,39,191,107,84
050,18,165,"Indiana","Vermillion County",1,40,195,100,95
050,18,165,"Indiana","Vermillion County",1,41,205,105,100
050,18,165,"Indiana","Vermillion County",1,42,198,101,97
050,18,165,"Indiana","Vermillion County",1,43,184,92,92
050,18,165,"Indiana","Vermillion County",1,44,179,89,90
050,18,165,"Indiana","Vermillion County",1,45,175,88,87
050,18,165,"Indiana","Vermillion County",1,46,166,80,86
050,18,165,"Indiana","Vermillion County",1,47,198,101,97
050,18,165,"Indiana","Vermillion County",1,48,222,114,108
050,18,165,"Indiana","Vermillion County",1,49,241,121,120
050,18,165,"Indiana","Vermillion County",1,50,218,110,108
050,18,165,"Indiana","Vermillion County",1,51,186,103,83
050,18,165,"Indiana","Vermillion County",1,52,187,102,85
050,18,165,"Indiana","Vermillion County",1,53,194,105,89
050,18,165,"Indiana","Vermillion County",1,54,195,95,100
050,18,165,"Indiana","Vermillion County",1,55,215,107,108
050,18,165,"Indiana","Vermillion County",1,56,211,105,106
050,18,165,"Indiana","Vermillion County",1,57,214,105,109
050,18,165,"Indiana","Vermillion County",1,58,222,103,119
050,18,165,"Indiana","Vermillion County",1,59,241,110,131
050,18,165,"Indiana","Vermillion County",1,60,229,114,115
050,18,165,"Indiana","Vermillion County",1,61,201,90,111
050,18,165,"Indiana","Vermillion County",1,62,209,100,109
050,18,165,"Indiana","Vermillion County",1,63,229,117,112
050,18,165,"Indiana","Vermillion County",1,64,217,97,120
050,18,165,"Indiana","Vermillion County",1,65,205,102,103
050,18,165,"Indiana","Vermillion County",1,66,224,107,117
050,18,165,"Indiana","Vermillion County",1,67,206,101,105
050,18,165,"Indiana","Vermillion County",1,68,203,99,104
050,18,165,"Indiana","Vermillion County",1,69,201,99,102
050,18,165,"Indiana","Vermillion County",1,70,182,92,90
050,18,165,"Indiana","Vermillion County",1,71,169,76,93
050,18,165,"Indiana","Vermillion County",1,72,177,83,94
050,18,165,"Indiana","Vermillion County",1,73,179,86,93
050,18,165,"Indiana","Vermillion County",1,74,120,61,59
050,18,165,"Indiana","Vermillion County",1,75,121,54,67
050,18,165,"Indiana","Vermillion County",1,76,117,60,57
050,18,165,"Indiana","Vermillion County",1,77,113,58,55
050,18,165,"Indiana","Vermillion County",1,78,101,46,55
050,18,165,"Indiana","Vermillion County",1,79,83,38,45
050,18,165,"Indiana","Vermillion County",1,80,79,34,45
050,18,165,"Indiana","Vermillion County",1,81,72,28,44
050,18,165,"Indiana","Vermillion County",1,82,64,26,38
050,18,165,"Indiana","Vermillion County",1,83,56,21,35
050,18,165,"Indiana","Vermillion County",1,84,54,19,35
050,18,165,"Indiana","Vermillion County",1,85,324,100,224
050,18,165,"Indiana","Vermillion County",2,0,175,88,87
050,18,165,"Indiana","Vermillion County",2,1,166,82,84
050,18,165,"Indiana","Vermillion County",2,2,171,82,89
050,18,165,"Indiana","Vermillion County",2,3,171,89,82
050,18,165,"Indiana","Vermillion County",2,4,169,88,81
050,18,165,"Indiana","Vermillion County",2,5,168,81,87
050,18,165,"Indiana","Vermillion County",2,6,186,93,93
050,18,165,"Indiana","Vermillion County",2,7,188,94,94
050,18,165,"Indiana","Vermillion County",2,8,194,101,93
050,18,165,"Indiana","Vermillion County",2,9,192,102,90
050,18,165,"Indiana","Vermillion County",2,10,190,99,91
050,18,165,"Indiana","Vermillion County",2,11,190,100,90
050,18,165,"Indiana","Vermillion County",2,12,192,95,97
050,18,165,"Indiana","Vermillion County",2,13,201,102,99
050,18,165,"Indiana","Vermillion County",2,14,213,116,97
050,18,165,"Indiana","Vermillion County",2,15,207,116,91
050,18,165,"Indiana","Vermillion County",2,16,217,120,97
050,18,165,"Indiana","Vermillion County",2,17,226,119,107
050,18,165,"Indiana","Vermillion County",2,18,180,98,82
050,18,165,"Indiana","Vermillion County",2,19,155,89,66
050,18,165,"Indiana","Vermillion County",2,20,183,104,79
050,18,165,"Indiana","Vermillion County",2,21,171,98,73
050,18,165,"Indiana","Vermillion County",2,22,165,93,72
050,18,165,"Indiana","Vermillion County",2,23,181,101,80
050,18,165,"Indiana","Vermillion County",2,24,178,96,82
050,18,165,"Indiana","Vermillion County",2,25,172,93,79
050,18,165,"Indiana","Vermillion County",2,26,186,97,89
050,18,165,"Indiana","Vermillion County",2,27,195,98,97
050,18,165,"Indiana","Vermillion County",2,28,193,99,94
050,18,165,"Indiana","Vermillion County",2,29,191,97,94
050,18,165,"Indiana","Vermillion County",2,30,169,87,82
050,18,165,"Indiana","Vermillion County",2,31,166,84,82
050,18,165,"Indiana","Vermillion County",2,32,167,89,78
050,18,165,"Indiana","Vermillion County",2,33,163,90,73
050,18,165,"Indiana","Vermillion County",2,34,159,84,75
050,18,165,"Indiana","Vermillion County",2,35,155,78,77
050,18,165,"Indiana","Vermillion County",2,36,160,78,82
050,18,165,"Indiana","Vermillion County",2,37,173,81,92
050,18,165,"Indiana","Vermillion County",2,38,171,88,83
050,18,165,"Indiana","Vermillion County",2,39,187,103,84
050,18,165,"Indiana","Vermillion County",2,40,195,102,93
050,18,165,"Indiana","Vermillion County",2,41,202,103,99
050,18,165,"Indiana","Vermillion County",2,42,196,101,95
050,18,165,"Indiana","Vermillion County",2,43,187,94,93
050,18,165,"Indiana","Vermillion County",2,44,179,90,89
050,18,165,"Indiana","Vermillion County",2,45,176,89,87
050,18,165,"Indiana","Vermillion County",2,46,166,81,85
050,18,165,"Indiana","Vermillion County",2,47,190,96,94
050,18,165,"Indiana","Vermillion County",2,48,218,113,105
050,18,165,"Indiana","Vermillion County",2,49,239,122,117
050,18,165,"Indiana","Vermillion County",2,50,220,111,109
050,18,165,"Indiana","Vermillion County",2,51,192,103,89
050,18,165,"Indiana","Vermillion County",2,52,186,101,85
050,18,165,"Indiana","Vermillion County",2,53,193,104,89
050,18,165,"Indiana","Vermillion County",2,54,194,97,97
050,18,165,"Indiana","Vermillion County",2,55,210,104,106
050,18,165,"Indiana","Vermillion County",2,56,210,103,107
050,18,165,"Indiana","Vermillion County",2,57,212,104,108
050,18,165,"Indiana","Vermillion County",2,58,219,103,116
050,18,165,"Indiana","Vermillion County",2,59,238,109,129
050,18,165,"Indiana","Vermillion County",2,60,228,110,118
050,18,165,"Indiana","Vermillion County",2,61,208,95,113
050,18,165,"Indiana","Vermillion County",2,62,208,97,111
050,18,165,"Indiana","Vermillion County",2,63,225,114,111
050,18,165,"Indiana","Vermillion County",2,64,217,101,116
050,18,165,"Indiana","Vermillion County",2,65,209,101,108
050,18,165,"Indiana","Vermillion County",2,66,220,106,114
050,18,165,"Indiana","Vermillion County",2,67,208,101,107
050,18,165,"Indiana","Vermillion County",2,68,203,99,104
050,18,165,"Indiana","Vermillion County",2,69,202,99,103
050,18,165,"Indiana","Vermillion County",2,70,184,93,91
050,18,165,"Indiana","Vermillion County",2,71,172,80,92
050,18,165,"Indiana","Vermillion County",2,72,172,80,92
050,18,165,"Indiana","Vermillion County",2,73,184,88,96
050,18,165,"Indiana","Vermillion County",2,74,125,62,63
050,18,165,"Indiana","Vermillion County",2,75,121,56,65
050,18,165,"Indiana","Vermillion County",2,76,117,58,59
050,18,165,"Indiana","Vermillion County",2,77,115,59,56
050,18,165,"Indiana","Vermillion County",2,78,102,48,54
050,18,165,"Indiana","Vermillion County",2,79,85,39,46
050,18,165,"Indiana","Vermillion County",2,80,77,33,44
050,18,165,"Indiana","Vermillion County",2,81,69,25,44
050,18,165,"Indiana","Vermillion County",2,82,65,25,40
050,18,165,"Indiana","Vermillion County",2,83,57,22,35
050,18,165,"Indiana","Vermillion County",2,84,54,20,34
050,18,165,"Indiana","Vermillion County",2,85,324,99,225
050,18,165,"Indiana","Vermillion County",3,0,165,89,76
050,18,165,"Indiana","Vermillion County",3,1,175,82,93
050,18,165,"Indiana","Vermillion County",3,2,165,81,84
050,18,165,"Indiana","Vermillion County",3,3,164,79,85
050,18,165,"Indiana","Vermillion County",3,4,160,87,73
050,18,165,"Indiana","Vermillion County",3,5,175,85,90
050,18,165,"Indiana","Vermillion County",3,6,175,84,91
050,18,165,"Indiana","Vermillion County",3,7,195,103,92
050,18,165,"Indiana","Vermillion County",3,8,191,96,95
050,18,165,"Indiana","Vermillion County",3,9,196,100,96
050,18,165,"Indiana","Vermillion County",3,10,197,103,94
050,18,165,"Indiana","Vermillion County",3,11,198,106,92
050,18,165,"Indiana","Vermillion County",3,12,191,100,91
050,18,165,"Indiana","Vermillion County",3,13,193,99,94
050,18,165,"Indiana","Vermillion County",3,14,208,102,106
050,18,165,"Indiana","Vermillion County",3,15,219,119,100
050,18,165,"Indiana","Vermillion County",3,16,204,116,88
050,18,165,"Indiana","Vermillion County",3,17,227,135,92
050,18,165,"Indiana","Vermillion County",3,18,201,113,88
050,18,165,"Indiana","Vermillion County",3,19,143,76,67
050,18,165,"Indiana","Vermillion County",3,20,159,94,65
050,18,165,"Indiana","Vermillion County",3,21,178,102,76
050,18,165,"Indiana","Vermillion County",3,22,184,104,80
050,18,165,"Indiana","Vermillion County",3,23,165,94,71
050,18,165,"Indiana","Vermillion County",3,24,171,90,81
050,18,165,"Indiana","Vermillion County",3,25,167,92,75
050,18,165,"Indiana","Vermillion County",3,26,185,92,93
050,18,165,"Indiana","Vermillion County",3,27,178,92,86
050,18,165,"Indiana","Vermillion County",3,28,196,98,98
050,18,165,"Indiana","Vermillion County",3,29,187,94,93
050,18,165,"Indiana","Vermillion County",3,30,180,91,89
050,18,165,"Indiana","Vermillion County",3,31,178,93,85
050,18,165,"Indiana","Vermillion County",3,32,172,85,87
050,18,165,"Indiana","Vermillion County",3,33,163,86,77
050,18,165,"Indiana","Vermillion County",3,34,166,88,78
050,18,165,"Indiana","Vermillion County",3,35,160,79,81
050,18,165,"Indiana","Vermillion County",3,36,161,79,82
050,18,165,"Indiana","Vermillion County",3,37,161,79,82
050,18,165,"Indiana","Vermillion County",3,38,186,87,99
050,18,165,"Indiana","Vermillion County",3,39,161,79,82
050,18,165,"Indiana","Vermillion County",3,40,186,103,83
050,18,165,"Indiana","Vermillion County",3,41,197,102,95
050,18,165,"Indiana","Vermillion County",3,42,201,105,96
050,18,165,"Indiana","Vermillion County",3,43,207,106,101
050,18,165,"Indiana","Vermillion County",3,44,190,96,94
050,18,165,"Indiana","Vermillion County",3,45,182,93,89
050,18,165,"Indiana","Vermillion County",3,46,185,88,97
050,18,165,"Indiana","Vermillion County",3,47,165,83,82
050,18,165,"Indiana","Vermillion County",3,48,189,95,94
050,18,165,"Indiana","Vermillion County",3,49,230,119,111
050,18,165,"Indiana","Vermillion County",3,50,243,126,117
050,18,165,"Indiana","Vermillion County",3,51,225,112,113
050,18,165,"Indiana","Vermillion County",3,52,192,103,89
050,18,165,"Indiana","Vermillion County",3,53,190,105,85
050,18,165,"Indiana","Vermillion County",3,54,192,103,89
050,18,165,"Indiana","Vermillion County",3,55,191,100,91
050,18,165,"Indiana","Vermillion County",3,56,212,101,111
050,18,165,"Indiana","Vermillion County",3,57,210,99,111
050,18,165,"Indiana","Vermillion County",3,58,215,103,112
050,18,165,"Indiana","Vermillion County",3,59,215,102,113
050,18,165,"Indiana","Vermillion County",3,60,240,108,132
050,18,165,"Indiana","Vermillion County",3,61,226,110,116
050,18,165,"Indiana","Vermillion County",3,62,211,96,115
050,18,165,"Indiana","Vermillion County",3,63,200,92,108
050,18,165,"Indiana","Vermillion County",3,64,220,112,108
050,18,165,"Indiana","Vermillion County",3,65,216,103,113
050,18,165,"Indiana","Vermillion County",3,66,208,100,108
050,18,165,"Indiana","Vermillion County",3,67,219,107,112
050,18,165,"Indiana","Vermillion County",3,68,201,97,104
050,18,165,"Indiana","Vermillion County",3,69,202,94,108
050,18,165,"Indiana","Vermillion County",3,70,196,96,100
050,18,165,"Indiana","Vermillion County",3,71,184,90,94
050,18,165,"Indiana","Vermillion County",3,72,169,79,90
050,18,165,"Indiana","Vermillion County",3,73,167,80,87
050,18,165,"Indiana","Vermillion County",3,74,177,84,93
050,18,165,"Indiana","Vermillion County",3,75,118,57,61
050,18,165,"Indiana","Vermillion County",3,76,106,48,58
050,18,165,"Indiana","Vermillion County",3,77,107,52,55
050,18,165,"Indiana","Vermillion County",3,78,109,54,55
050,18,165,"Indiana","Vermillion County",3,79,99,47,52
050,18,165,"Indiana","Vermillion County",3,80,74,34,40
050,18,165,"Indiana","Vermillion County",3,81,76,31,45
050,18,165,"Indiana","Vermillion County",3,82,65,22,43
050,18,165,"Indiana","Vermillion County",3,83,60,23,37
050,18,165,"Indiana","Vermillion County",3,84,54,20,34
050,18,165,"Indiana","Vermillion County",3,85,314,101,213
050,18,165,"Indiana","Vermillion County",4,0,167,85,82
050,18,165,"Indiana","Vermillion County",4,1,154,73,81
050,18,165,"Indiana","Vermillion County",4,2,177,89,88
050,18,165,"Indiana","Vermillion County",4,3,171,88,83
050,18,165,"Indiana","Vermillion County",4,4,165,80,85
050,18,165,"Indiana","Vermillion County",4,5,165,90,75
050,18,165,"Indiana","Vermillion County",4,6,170,82,88
050,18,165,"Indiana","Vermillion County",4,7,177,88,89
050,18,165,"Indiana","Vermillion County",4,8,199,103,96
050,18,165,"Indiana","Vermillion County",4,9,194,101,93
050,18,165,"Indiana","Vermillion County",4,10,206,110,96
050,18,165,"Indiana","Vermillion County",4,11,205,107,98
050,18,165,"Indiana","Vermillion County",4,12,198,110,88
050,18,165,"Indiana","Vermillion County",4,13,197,106,91
050,18,165,"Indiana","Vermillion County",4,14,202,103,99
050,18,165,"Indiana","Vermillion County",4,15,202,102,100
050,18,165,"Indiana","Vermillion County",4,16,217,120,97
050,18,165,"Indiana","Vermillion County",4,17,207,114,93
050,18,165,"Indiana","Vermillion County",4,18,194,120,74
050,18,165,"Indiana","Vermillion County",4,19,150,87,63
050,18,165,"Indiana","Vermillion County",4,20,151,82,69
050,18,165,"Indiana","Vermillion County",4,21,172,104,68
050,18,165,"Indiana","Vermillion County",4,22,188,107,81
050,18,165,"Indiana","Vermillion County",4,23,182,104,78
050,18,165,"Indiana","Vermillion County",4,24,173,98,75
050,18,165,"Indiana","Vermillion County",4,25,179,95,84
050,18,165,"Indiana","Vermillion County",4,26,164,94,70
050,18,165,"Indiana","Vermillion County",4,27,185,91,94
050,18,165,"Indiana","Vermillion County",4,28,175,91,84
050,18,165,"Indiana","Vermillion County",4,29,201,97,104
050,18,165,"Indiana","Vermillion County",4,30,191,97,94
050,18,165,"Indiana","Vermillion County",4,31,206,101,105
050,18,165,"Indiana","Vermillion County",4,32,181,94,87
050,18,165,"Indiana","Vermillion County",4,33,173,86,87
050,18,165,"Indiana","Vermillion County",4,34,165,89,76
050,18,165,"Indiana","Vermillion County",4,35,164,90,74
050,18,165,"Indiana","Vermillion County",4,36,161,77,84
050,18,165,"Indiana","Vermillion County",4,37,165,83,82
050,18,165,"Indiana","Vermillion County",4,38,163,81,82
050,18,165,"Indiana","Vermillion County",4,39,180,87,93
050,18,165,"Indiana","Vermillion County",4,40,153,71,82
050,18,165,"Indiana","Vermillion County",4,41,188,102,86
050,18,165,"Indiana","Vermillion County",4,42,199,103,96
050,18,165,"Indiana","Vermillion County",4,43,195,104,91
050,18,165,"Indiana","Vermillion County",4,44,208,106,102
050,18,165,"Indiana","Vermillion County",4,45,187,97,90
050,18,165,"Indiana","Vermillion County",4,46,193,98,95
050,18,165,"Indiana","Vermillion County",4,47,187,91,96
050,18,165,"Indiana","Vermillion County",4,48,170,83,87
050,18,165,"Indiana","Vermillion County",4,49,192,95,97
050,18,165,"Indiana","Vermillion County",4,50,227,115,112
050,18,165,"Indiana","Vermillion County",4,51,237,122,115
050,18,165,"Indiana","Vermillion County",4,52,224,112,112
050,18,165,"Indiana","Vermillion County",4,53,196,108,88
050,18,165,"Indiana","Vermillion County",4,54,195,103,92
050,18,165,"Indiana","Vermillion County",4,55,202,113,89
050,18,165,"Indiana","Vermillion County",4,56,192,100,92
050,18,165,"Indiana","Vermillion County",4,57,212,98,114
050,18,165,"Indiana","Vermillion County",4,58,208,97,111
050,18,165,"Indiana","Vermillion County",4,59,212,102,110
050,18,165,"Indiana","Vermillion County",4,60,214,102,112
050,18,165,"Indiana","Vermillion County",4,61,234,107,127
050,18,165,"Indiana","Vermillion County",4,62,227,108,119
050,18,165,"Indiana","Vermillion County",4,63,212,94,118
050,18,165,"Indiana","Vermillion County",4,64,194,90,104
050,18,165,"Indiana","Vermillion County",4,65,212,112,100
050,18,165,"Indiana","Vermillion County",4,66,210,101,109
050,18,165,"Indiana","Vermillion County",4,67,210,102,108
050,18,165,"Indiana","Vermillion County",4,68,214,105,109
050,18,165,"Indiana","Vermillion County",4,69,196,92,104
050,18,165,"Indiana","Vermillion County",4,70,190,90,100
050,18,165,"Indiana","Vermillion County",4,71,187,93,94
050,18,165,"Indiana","Vermillion County",4,72,176,89,87
050,18,165,"Indiana","Vermillion County",4,73,162,74,88
050,18,165,"Indiana","Vermillion County",4,74,158,74,84
050,18,165,"Indiana","Vermillion County",4,75,164,74,90
050,18,165,"Indiana","Vermillion County",4,76,112,51,61
050,18,165,"Indiana","Vermillion County",4,77,97,42,55
050,18,165,"Indiana","Vermillion County",4,78,103,49,54
050,18,165,"Indiana","Vermillion County",4,79,105,50,55
050,18,165,"Indiana","Vermillion County",4,80,86,39,47
050,18,165,"Indiana","Vermillion County",4,81,74,34,40
050,18,165,"Indiana","Vermillion County",4,82,76,28,48
050,18,165,"Indiana","Vermillion County",4,83,56,18,38
050,18,165,"Indiana","Vermillion County",4,84,56,20,36
050,18,165,"Indiana","Vermillion County",4,85,295,93,202
050,18,165,"Indiana","Vermillion County",5,0,169,86,83
050,18,165,"Indiana","Vermillion County",5,1,176,86,90
050,18,165,"Indiana","Vermillion County",5,2,159,72,87
050,18,165,"Indiana","Vermillion County",5,3,174,88,86
050,18,165,"Indiana","Vermillion County",5,4,174,87,87
050,18,165,"Indiana","Vermillion County",5,5,172,84,88
050,18,165,"Indiana","Vermillion County",5,6,165,92,73
050,18,165,"Indiana","Vermillion County",5,7,173,86,87
050,18,165,"Indiana","Vermillion County",5,8,170,83,87
050,18,165,"Indiana","Vermillion County",5,9,191,96,95
050,18,165,"Indiana","Vermillion County",5,10,201,100,101
050,18,165,"Indiana","Vermillion County",5,11,196,101,95
050,18,165,"Indiana","Vermillion County",5,12,200,106,94
050,18,165,"Indiana","Vermillion County",5,13,192,100,92
050,18,165,"Indiana","Vermillion County",5,14,196,107,89
050,18,165,"Indiana","Vermillion County",5,15,196,100,96
050,18,165,"Indiana","Vermillion County",5,16,202,103,99
050,18,165,"Indiana","Vermillion County",5,17,216,115,101
050,18,165,"Indiana","Vermillion County",5,18,167,96,71
050,18,165,"Indiana","Vermillion County",5,19,147,93,54
050,18,165,"Indiana","Vermillion County",5,20,159,87,72
050,18,165,"Indiana","Vermillion County",5,21,161,84,77
050,18,165,"Indiana","Vermillion County",5,22,185,110,75
050,18,165,"Indiana","Vermillion County",5,23,198,101,97
050,18,165,"Indiana","Vermillion County",5,24,187,112,75
050,18,165,"Indiana","Vermillion County",5,25,195,113,82
050,18,165,"Indiana","Vermillion County",5,26,199,104,95
050,18,165,"Indiana","Vermillion County",5,27,181,102,79
050,18,165,"Indiana","Vermillion County",5,28,171,82,89
050,18,165,"Indiana","Vermillion County",5,29,182,97,85
050,18,165,"Indiana","Vermillion County",5,30,197,100,97
050,18,165,"Indiana","Vermillion County",5,31,197,101,96
050,18,165,"Indiana","Vermillion County",5,32,200,97,103
050,18,165,"Indiana","Vermillion County",5,33,187,99,88
050,18,165,"Indiana","Vermillion County",5,34,175,86,89
050,18,165,"Indiana","Vermillion County",5,35,174,93,81
050,18,165,"Indiana","Vermillion County",5,36,168,91,77
050,18,165,"Indiana","Vermillion County",5,37,163,82,81
050,18,165,"Indiana","Vermillion County",5,38,167,84,83
050,18,165,"Indiana","Vermillion County",5,39,166,84,82
050,18,165,"Indiana","Vermillion County",5,40,178,84,94
050,18,165,"Indiana","Vermillion County",5,41,160,74,86
050,18,165,"Indiana","Vermillion County",5,42,187,102,85
050,18,165,"Indiana","Vermillion County",5,43,193,100,93
050,18,165,"Indiana","Vermillion County",5,44,193,104,89
050,18,165,"Indiana","Vermillion County",5,45,203,104,99
050,18,165,"Indiana","Vermillion County",5,46,181,97,84
050,18,165,"Indiana","Vermillion County",5,47,199,103,96
050,18,165,"Indiana","Vermillion County",5,48,187,90,97
050,18,165,"Indiana","Vermillion County",5,49,173,85,88
050,18,165,"Indiana","Vermillion County",5,50,193,96,97
050,18,165,"Indiana","Vermillion County",5,51,218,112,106
050,18,165,"Indiana","Vermillion County",5,52,242,126,116
050,18,165,"Indiana","Vermillion County",5,53,221,113,108
050,18,165,"Indiana","Vermillion County",5,54,192,109,83
050,18,165,"Indiana","Vermillion County",5,55,197,107,90
050,18,165,"Indiana","Vermillion County",5,56,196,108,88
050,18,165,"Indiana","Vermillion County",5,57,191,96,95
050,18,165,"Indiana","Vermillion County",5,58,213,99,114
050,18,165,"Indiana","Vermillion County",5,59,210,100,110
050,18,165,"Indiana","Vermillion County",5,60,216,103,113
050,18,165,"Indiana","Vermillion County",5,61,216,104,112
050,18,165,"Indiana","Vermillion County",5,62,234,108,126
050,18,165,"Indiana","Vermillion County",5,63,225,107,118
050,18,165,"Indiana","Vermillion County",5,64,206,94,112
050,18,165,"Indiana","Vermillion County",5,65,197,95,102
050,18,165,"Indiana","Vermillion County",5,66,203,107,96
050,18,165,"Indiana","Vermillion County",5,67,205,100,105
050,18,165,"Indiana","Vermillion County",5,68,199,99,100
050,18,165,"Indiana","Vermillion County",5,69,207,100,107
050,18,165,"Indiana","Vermillion County",5,70,190,89,101
050,18,165,"Indiana","Vermillion County",5,71,181,85,96
050,18,165,"Indiana","Vermillion County",5,72,176,88,88
050,18,165,"Indiana","Vermillion County",5,73,167,84,83
050,18,165,"Indiana","Vermillion County",5,74,157,73,84
050,18,165,"Indiana","Vermillion County",5,75,147,66,81
050,18,165,"Indiana","Vermillion County",5,76,156,69,87
050,18,165,"Indiana","Vermillion County",5,77,109,49,60
050,18,165,"Indiana","Vermillion County",5,78,93,41,52
050,18,165,"Indiana","Vermillion County",5,79,102,47,55
050,18,165,"Indiana","Vermillion County",5,80,93,43,50
050,18,165,"Indiana","Vermillion County",5,81,84,38,46
050,18,165,"Indiana","Vermillion County",5,82,70,30,40
050,18,165,"Indiana","Vermillion County",5,83,67,24,43
050,18,165,"Indiana","Vermillion County",5,84,52,15,37
050,18,165,"Indiana","Vermillion County",5,85,290,88,202
050,18,167,"Indiana","Vigo County",1,0,1103,571,532
050,18,167,"Indiana","Vigo County",1,1,1109,579,530
050,18,167,"Indiana","Vigo County",1,2,1194,605,589
050,18,167,"Indiana","Vigo County",1,3,1184,611,573
050,18,167,"Indiana","Vigo County",1,4,1228,636,592
050,18,167,"Indiana","Vigo County",1,5,1231,658,573
050,18,167,"Indiana","Vigo County",1,6,1251,663,588
050,18,167,"Indiana","Vigo County",1,7,1216,654,562
050,18,167,"Indiana","Vigo County",1,8,1185,633,552
050,18,167,"Indiana","Vigo County",1,9,1209,611,598
050,18,167,"Indiana","Vigo County",1,10,1202,618,584
050,18,167,"Indiana","Vigo County",1,11,1248,643,605
050,18,167,"Indiana","Vigo County",1,12,1299,681,618
050,18,167,"Indiana","Vigo County",1,13,1270,652,618
050,18,167,"Indiana","Vigo County",1,14,1259,650,609
050,18,167,"Indiana","Vigo County",1,15,1237,629,608
050,18,167,"Indiana","Vigo County",1,16,1256,639,617
050,18,167,"Indiana","Vigo County",1,17,1216,649,567
050,18,167,"Indiana","Vigo County",1,18,1523,805,718
050,18,167,"Indiana","Vigo County",1,19,2700,1437,1263
050,18,167,"Indiana","Vigo County",1,20,2734,1414,1320
050,18,167,"Indiana","Vigo County",1,21,2758,1374,1384
050,18,167,"Indiana","Vigo County",1,22,2346,1200,1146
050,18,167,"Indiana","Vigo County",1,23,2033,1067,966
050,18,167,"Indiana","Vigo County",1,24,1687,879,808
050,18,167,"Indiana","Vigo County",1,25,1499,806,693
050,18,167,"Indiana","Vigo County",1,26,1497,823,674
050,18,167,"Indiana","Vigo County",1,27,1481,781,700
050,18,167,"Indiana","Vigo County",1,28,1480,785,695
050,18,167,"Indiana","Vigo County",1,29,1405,762,643
050,18,167,"Indiana","Vigo County",1,30,1336,724,612
050,18,167,"Indiana","Vigo County",1,31,1211,650,561
050,18,167,"Indiana","Vigo County",1,32,1217,691,526
050,18,167,"Indiana","Vigo County",1,33,1243,699,544
050,18,167,"Indiana","Vigo County",1,34,1274,692,582
050,18,167,"Indiana","Vigo County",1,35,1281,690,591
050,18,167,"Indiana","Vigo County",1,36,1301,704,597
050,18,167,"Indiana","Vigo County",1,37,1324,729,595
050,18,167,"Indiana","Vigo County",1,38,1262,707,555
050,18,167,"Indiana","Vigo County",1,39,1259,658,601
050,18,167,"Indiana","Vigo County",1,40,1239,650,589
050,18,167,"Indiana","Vigo County",1,41,1188,636,552
050,18,167,"Indiana","Vigo County",1,42,1192,636,556
050,18,167,"Indiana","Vigo County",1,43,1127,589,538
050,18,167,"Indiana","Vigo County",1,44,1094,559,535
050,18,167,"Indiana","Vigo County",1,45,1126,590,536
050,18,167,"Indiana","Vigo County",1,46,1108,594,514
050,18,167,"Indiana","Vigo County",1,47,1194,620,574
050,18,167,"Indiana","Vigo County",1,48,1244,634,610
050,18,167,"Indiana","Vigo County",1,49,1321,686,635
050,18,167,"Indiana","Vigo County",1,50,1213,629,584
050,18,167,"Indiana","Vigo County",1,51,1221,651,570
050,18,167,"Indiana","Vigo County",1,52,1182,617,565
050,18,167,"Indiana","Vigo County",1,53,1220,630,590
050,18,167,"Indiana","Vigo County",1,54,1221,636,585
050,18,167,"Indiana","Vigo County",1,55,1253,639,614
050,18,167,"Indiana","Vigo County",1,56,1296,671,625
050,18,167,"Indiana","Vigo County",1,57,1276,632,644
050,18,167,"Indiana","Vigo County",1,58,1308,627,681
050,18,167,"Indiana","Vigo County",1,59,1289,633,656
050,18,167,"Indiana","Vigo County",1,60,1272,602,670
050,18,167,"Indiana","Vigo County",1,61,1283,621,662
050,18,167,"Indiana","Vigo County",1,62,1353,657,696
050,18,167,"Indiana","Vigo County",1,63,1280,624,656
050,18,167,"Indiana","Vigo County",1,64,1226,596,630
050,18,167,"Indiana","Vigo County",1,65,1245,605,640
050,18,167,"Indiana","Vigo County",1,66,1181,573,608
050,18,167,"Indiana","Vigo County",1,67,1143,523,620
050,18,167,"Indiana","Vigo County",1,68,1138,533,605
050,18,167,"Indiana","Vigo County",1,69,1038,483,555
050,18,167,"Indiana","Vigo County",1,70,1006,463,543
050,18,167,"Indiana","Vigo County",1,71,949,430,519
050,18,167,"Indiana","Vigo County",1,72,949,431,518
050,18,167,"Indiana","Vigo County",1,73,980,468,512
050,18,167,"Indiana","Vigo County",1,74,681,297,384
050,18,167,"Indiana","Vigo County",1,75,695,305,390
050,18,167,"Indiana","Vigo County",1,76,652,280,372
050,18,167,"Indiana","Vigo County",1,77,642,251,391
050,18,167,"Indiana","Vigo County",1,78,590,228,362
050,18,167,"Indiana","Vigo County",1,79,543,224,319
050,18,167,"Indiana","Vigo County",1,80,517,183,334
050,18,167,"Indiana","Vigo County",1,81,463,166,297
050,18,167,"Indiana","Vigo County",1,82,437,162,275
050,18,167,"Indiana","Vigo County",1,83,364,137,227
050,18,167,"Indiana","Vigo County",1,84,355,119,236
050,18,167,"Indiana","Vigo County",1,85,2116,613,1503
050,18,167,"Indiana","Vigo County",2,0,1133,602,531
050,18,167,"Indiana","Vigo County",2,1,1100,572,528
050,18,167,"Indiana","Vigo County",2,2,1172,597,575
050,18,167,"Indiana","Vigo County",2,3,1183,606,577
050,18,167,"Indiana","Vigo County",2,4,1215,632,583
050,18,167,"Indiana","Vigo County",2,5,1228,651,577
050,18,167,"Indiana","Vigo County",2,6,1245,661,584
050,18,167,"Indiana","Vigo County",2,7,1223,660,563
050,18,167,"Indiana","Vigo County",2,8,1190,636,554
050,18,167,"Indiana","Vigo County",2,9,1198,613,585
050,18,167,"Indiana","Vigo County",2,10,1196,610,586
050,18,167,"Indiana","Vigo County",2,11,1230,634,596
050,18,167,"Indiana","Vigo County",2,12,1292,674,618
050,18,167,"Indiana","Vigo County",2,13,1278,662,616
050,18,167,"Indiana","Vigo County",2,14,1262,652,610
050,18,167,"Indiana","Vigo County",2,15,1244,635,609
050,18,167,"Indiana","Vigo County",2,16,1257,639,618
050,18,167,"Indiana","Vigo County",2,17,1236,652,584
050,18,167,"Indiana","Vigo County",2,18,1506,789,717
050,18,167,"Indiana","Vigo County",2,19,2706,1440,1266
050,18,167,"Indiana","Vigo County",2,20,2741,1421,1320
050,18,167,"Indiana","Vigo County",2,21,2759,1376,1383
050,18,167,"Indiana","Vigo County",2,22,2329,1195,1134
050,18,167,"Indiana","Vigo County",2,23,2033,1062,971
050,18,167,"Indiana","Vigo County",2,24,1698,885,813
050,18,167,"Indiana","Vigo County",2,25,1505,812,693
050,18,167,"Indiana","Vigo County",2,26,1481,809,672
050,18,167,"Indiana","Vigo County",2,27,1458,775,683
050,18,167,"Indiana","Vigo County",2,28,1472,785,687
050,18,167,"Indiana","Vigo County",2,29,1421,768,653
050,18,167,"Indiana","Vigo County",2,30,1360,737,623
050,18,167,"Indiana","Vigo County",2,31,1229,661,568
050,18,167,"Indiana","Vigo County",2,32,1216,683,533
050,18,167,"Indiana","Vigo County",2,33,1238,703,535
050,18,167,"Indiana","Vigo County",2,34,1262,691,571
050,18,167,"Indiana","Vigo County",2,35,1280,689,591
050,18,167,"Indiana","Vigo County",2,36,1287,693,594
050,18,167,"Indiana","Vigo County",2,37,1320,724,596
050,18,167,"Indiana","Vigo County",2,38,1279,713,566
050,18,167,"Indiana","Vigo County",2,39,1246,658,588
050,18,167,"Indiana","Vigo County",2,40,1248,654,594
050,18,167,"Indiana","Vigo County",2,41,1207,643,564
050,18,167,"Indiana","Vigo County",2,42,1182,629,553
050,18,167,"Indiana","Vigo County",2,43,1152,605,547
050,18,167,"Indiana","Vigo County",2,44,1092,561,531
050,18,167,"Indiana","Vigo County",2,45,1122,582,540
050,18,167,"Indiana","Vigo County",2,46,1109,589,520
050,18,167,"Indiana","Vigo County",2,47,1167,610,557
050,18,167,"Indiana","Vigo County",2,48,1235,634,601
050,18,167,"Indiana","Vigo County",2,49,1307,678,629
050,18,167,"Indiana","Vigo County",2,50,1243,643,600
050,18,167,"Indiana","Vigo County",2,51,1213,643,570
050,18,167,"Indiana","Vigo County",2,52,1186,617,569
050,18,167,"Indiana","Vigo County",2,53,1211,626,585
050,18,167,"Indiana","Vigo County",2,54,1212,630,582
050,18,167,"Indiana","Vigo County",2,55,1240,633,607
050,18,167,"Indiana","Vigo County",2,56,1284,659,625
050,18,167,"Indiana","Vigo County",2,57,1275,636,639
050,18,167,"Indiana","Vigo County",2,58,1292,626,666
050,18,167,"Indiana","Vigo County",2,59,1294,632,662
050,18,167,"Indiana","Vigo County",2,60,1270,605,665
050,18,167,"Indiana","Vigo County",2,61,1271,611,660
050,18,167,"Indiana","Vigo County",2,62,1330,647,683
050,18,167,"Indiana","Vigo County",2,63,1297,630,667
050,18,167,"Indiana","Vigo County",2,64,1221,595,626
050,18,167,"Indiana","Vigo County",2,65,1233,598,635
050,18,167,"Indiana","Vigo County",2,66,1198,581,617
050,18,167,"Indiana","Vigo County",2,67,1143,526,617
050,18,167,"Indiana","Vigo County",2,68,1126,522,604
050,18,167,"Indiana","Vigo County",2,69,1066,496,570
050,18,167,"Indiana","Vigo County",2,70,1007,468,539
050,18,167,"Indiana","Vigo County",2,71,960,432,528
050,18,167,"Indiana","Vigo County",2,72,929,423,506
050,18,167,"Indiana","Vigo County",2,73,1003,473,530
050,18,167,"Indiana","Vigo County",2,74,705,316,389
050,18,167,"Indiana","Vigo County",2,75,689,299,390
050,18,167,"Indiana","Vigo County",2,76,649,279,370
050,18,167,"Indiana","Vigo County",2,77,655,263,392
050,18,167,"Indiana","Vigo County",2,78,587,226,361
050,18,167,"Indiana","Vigo County",2,79,545,218,327
050,18,167,"Indiana","Vigo County",2,80,520,188,332
050,18,167,"Indiana","Vigo County",2,81,463,169,294
050,18,167,"Indiana","Vigo County",2,82,437,160,277
050,18,167,"Indiana","Vigo County",2,83,373,139,234
050,18,167,"Indiana","Vigo County",2,84,354,121,233
050,18,167,"Indiana","Vigo County",2,85,2120,612,1508
050,18,167,"Indiana","Vigo County",3,0,1137,583,554
050,18,167,"Indiana","Vigo County",3,1,1125,582,543
050,18,167,"Indiana","Vigo County",3,2,1108,573,535
050,18,167,"Indiana","Vigo County",3,3,1179,604,575
050,18,167,"Indiana","Vigo County",3,4,1181,607,574
050,18,167,"Indiana","Vigo County",3,5,1212,629,583
050,18,167,"Indiana","Vigo County",3,6,1232,654,578
050,18,167,"Indiana","Vigo County",3,7,1245,664,581
050,18,167,"Indiana","Vigo County",3,8,1228,657,571
050,18,167,"Indiana","Vigo County",3,9,1161,610,551
050,18,167,"Indiana","Vigo County",3,10,1190,612,578
050,18,167,"Indiana","Vigo County",3,11,1204,624,580
050,18,167,"Indiana","Vigo County",3,12,1256,649,607
050,18,167,"Indiana","Vigo County",3,13,1297,673,624
050,18,167,"Indiana","Vigo County",3,14,1274,646,628
050,18,167,"Indiana","Vigo County",3,15,1271,659,612
050,18,167,"Indiana","Vigo County",3,16,1268,643,625
050,18,167,"Indiana","Vigo County",3,17,1281,651,630
050,18,167,"Indiana","Vigo County",3,18,1500,788,712
050,18,167,"Indiana","Vigo County",3,19,2713,1461,1252
050,18,167,"Indiana","Vigo County",3,20,2723,1439,1284
050,18,167,"Indiana","Vigo County",3,21,2759,1390,1369
050,18,167,"Indiana","Vigo County",3,22,2298,1179,1119
050,18,167,"Indiana","Vigo County",3,23,2028,1049,979
050,18,167,"Indiana","Vigo County",3,24,1754,894,860
050,18,167,"Indiana","Vigo County",3,25,1523,816,707
050,18,167,"Indiana","Vigo County",3,26,1416,771,645
050,18,167,"Indiana","Vigo County",3,27,1403,750,653
050,18,167,"Indiana","Vigo County",3,28,1442,782,660
050,18,167,"Indiana","Vigo County",3,29,1456,795,661
050,18,167,"Indiana","Vigo County",3,30,1468,805,663
050,18,167,"Indiana","Vigo County",3,31,1373,736,637
050,18,167,"Indiana","Vigo County",3,32,1225,667,558
050,18,167,"Indiana","Vigo County",3,33,1247,704,543
050,18,167,"Indiana","Vigo County",3,34,1230,698,532
050,18,167,"Indiana","Vigo County",3,35,1241,671,570
050,18,167,"Indiana","Vigo County",3,36,1287,686,601
050,18,167,"Indiana","Vigo County",3,37,1275,684,591
050,18,167,"Indiana","Vigo County",3,38,1332,739,593
050,18,167,"Indiana","Vigo County",3,39,1243,683,560
050,18,167,"Indiana","Vigo County",3,40,1252,664,588
050,18,167,"Indiana","Vigo County",3,41,1265,666,599
050,18,167,"Indiana","Vigo County",3,42,1181,608,573
050,18,167,"Indiana","Vigo County",3,43,1175,620,555
050,18,167,"Indiana","Vigo County",3,44,1161,617,544
050,18,167,"Indiana","Vigo County",3,45,1088,562,526
050,18,167,"Indiana","Vigo County",3,46,1120,577,543
050,18,167,"Indiana","Vigo County",3,47,1106,586,520
050,18,167,"Indiana","Vigo County",3,48,1163,605,558
050,18,167,"Indiana","Vigo County",3,49,1243,645,598
050,18,167,"Indiana","Vigo County",3,50,1292,672,620
050,18,167,"Indiana","Vigo County",3,51,1255,659,596
050,18,167,"Indiana","Vigo County",3,52,1182,613,569
050,18,167,"Indiana","Vigo County",3,53,1170,605,565
050,18,167,"Indiana","Vigo County",3,54,1183,613,570
050,18,167,"Indiana","Vigo County",3,55,1180,620,560
050,18,167,"Indiana","Vigo County",3,56,1213,603,610
050,18,167,"Indiana","Vigo County",3,57,1251,634,617
050,18,167,"Indiana","Vigo County",3,58,1245,622,623
050,18,167,"Indiana","Vigo County",3,59,1274,617,657
050,18,167,"Indiana","Vigo County",3,60,1287,631,656
050,18,167,"Indiana","Vigo County",3,61,1250,591,659
050,18,167,"Indiana","Vigo County",3,62,1265,603,662
050,18,167,"Indiana","Vigo County",3,63,1295,621,674
050,18,167,"Indiana","Vigo County",3,64,1268,615,653
050,18,167,"Indiana","Vigo County",3,65,1195,563,632
050,18,167,"Indiana","Vigo County",3,66,1209,592,617
050,18,167,"Indiana","Vigo County",3,67,1184,572,612
050,18,167,"Indiana","Vigo County",3,68,1107,510,597
050,18,167,"Indiana","Vigo County",3,69,1074,485,589
050,18,167,"Indiana","Vigo County",3,70,1042,492,550
050,18,167,"Indiana","Vigo County",3,71,979,442,537
050,18,167,"Indiana","Vigo County",3,72,930,417,513
050,18,167,"Indiana","Vigo County",3,73,895,407,488
050,18,167,"Indiana","Vigo County",3,74,966,451,515
050,18,167,"Indiana","Vigo County",3,75,660,291,369
050,18,167,"Indiana","Vigo County",3,76,659,285,374
050,18,167,"Indiana","Vigo County",3,77,614,255,359
050,18,167,"Indiana","Vigo County",3,78,621,247,374
050,18,167,"Indiana","Vigo County",3,79,553,209,344
050,18,167,"Indiana","Vigo County",3,80,505,192,313
050,18,167,"Indiana","Vigo County",3,81,479,176,303
050,18,167,"Indiana","Vigo County",3,82,430,149,281
050,18,167,"Indiana","Vigo County",3,83,413,151,262
050,18,167,"Indiana","Vigo County",3,84,351,122,229
050,18,167,"Indiana","Vigo County",3,85,2101,617,1484
050,18,167,"Indiana","Vigo County",4,0,1141,583,558
050,18,167,"Indiana","Vigo County",4,1,1156,596,560
050,18,167,"Indiana","Vigo County",4,2,1134,586,548
050,18,167,"Indiana","Vigo County",4,3,1134,588,546
050,18,167,"Indiana","Vigo County",4,4,1168,597,571
050,18,167,"Indiana","Vigo County",4,5,1196,607,589
050,18,167,"Indiana","Vigo County",4,6,1227,638,589
050,18,167,"Indiana","Vigo County",4,7,1248,649,599
050,18,167,"Indiana","Vigo County",4,8,1231,665,566
050,18,167,"Indiana","Vigo County",4,9,1217,650,567
050,18,167,"Indiana","Vigo County",4,10,1169,603,566
050,18,167,"Indiana","Vigo County",4,11,1195,623,572
050,18,167,"Indiana","Vigo County",4,12,1199,613,586
050,18,167,"Indiana","Vigo County",4,13,1260,651,609
050,18,167,"Indiana","Vigo County",4,14,1309,682,627
050,18,167,"Indiana","Vigo County",4,15,1291,668,623
050,18,167,"Indiana","Vigo County",4,16,1270,648,622
050,18,167,"Indiana","Vigo County",4,17,1274,659,615
050,18,167,"Indiana","Vigo County",4,18,1517,771,746
050,18,167,"Indiana","Vigo County",4,19,2707,1434,1273
050,18,167,"Indiana","Vigo County",4,20,2654,1416,1238
050,18,167,"Indiana","Vigo County",4,21,2736,1390,1346
050,18,167,"Indiana","Vigo County",4,22,2323,1178,1145
050,18,167,"Indiana","Vigo County",4,23,2016,1046,970
050,18,167,"Indiana","Vigo County",4,24,1707,877,830
050,18,167,"Indiana","Vigo County",4,25,1573,822,751
050,18,167,"Indiana","Vigo County",4,26,1464,784,680
050,18,167,"Indiana","Vigo County",4,27,1323,715,608
050,18,167,"Indiana","Vigo County",4,28,1364,732,632
050,18,167,"Indiana","Vigo County",4,29,1410,764,646
050,18,167,"Indiana","Vigo County",4,30,1461,799,662
050,18,167,"Indiana","Vigo County",4,31,1446,782,664
050,18,167,"Indiana","Vigo County",4,32,1378,727,651
050,18,167,"Indiana","Vigo County",4,33,1245,692,553
050,18,167,"Indiana","Vigo County",4,34,1245,695,550
050,18,167,"Indiana","Vigo County",4,35,1208,669,539
050,18,167,"Indiana","Vigo County",4,36,1222,672,550
050,18,167,"Indiana","Vigo County",4,37,1295,693,602
050,18,167,"Indiana","Vigo County",4,38,1294,689,605
050,18,167,"Indiana","Vigo County",4,39,1295,701,594
050,18,167,"Indiana","Vigo County",4,40,1243,678,565
050,18,167,"Indiana","Vigo County",4,41,1250,671,579
050,18,167,"Indiana","Vigo County",4,42,1245,656,589
050,18,167,"Indiana","Vigo County",4,43,1186,601,585
050,18,167,"Indiana","Vigo County",4,44,1176,608,568
050,18,167,"Indiana","Vigo County",4,45,1147,601,546
050,18,167,"Indiana","Vigo County",4,46,1084,557,527
050,18,167,"Indiana","Vigo County",4,47,1123,576,547
050,18,167,"Indiana","Vigo County",4,48,1104,578,526
050,18,167,"Indiana","Vigo County",4,49,1161,602,559
050,18,167,"Indiana","Vigo County",4,50,1215,628,587
050,18,167,"Indiana","Vigo County",4,51,1301,688,613
050,18,167,"Indiana","Vigo County",4,52,1239,649,590
050,18,167,"Indiana","Vigo County",4,53,1167,600,567
050,18,167,"Indiana","Vigo County",4,54,1180,612,568
050,18,167,"Indiana","Vigo County",4,55,1151,596,555
050,18,167,"Indiana","Vigo County",4,56,1144,588,556
050,18,167,"Indiana","Vigo County",4,57,1186,584,602
050,18,167,"Indiana","Vigo County",4,58,1224,623,601
050,18,167,"Indiana","Vigo County",4,59,1242,625,617
050,18,167,"Indiana","Vigo County",4,60,1258,613,645
050,18,167,"Indiana","Vigo County",4,61,1282,624,658
050,18,167,"Indiana","Vigo County",4,62,1237,587,650
050,18,167,"Indiana","Vigo County",4,63,1221,579,642
050,18,167,"Indiana","Vigo County",4,64,1260,596,664
050,18,167,"Indiana","Vigo County",4,65,1250,606,644
050,18,167,"Indiana","Vigo County",4,66,1165,547,618
050,18,167,"Indiana","Vigo County",4,67,1190,577,613
050,18,167,"Indiana","Vigo County",4,68,1141,551,590
050,18,167,"Indiana","Vigo County",4,69,1075,491,584
050,18,167,"Indiana","Vigo County",4,70,1049,478,571
050,18,167,"Indiana","Vigo County",4,71,1022,469,553
050,18,167,"Indiana","Vigo County",4,72,945,424,521
050,18,167,"Indiana","Vigo County",4,73,904,402,502
050,18,167,"Indiana","Vigo County",4,74,870,383,487
050,18,167,"Indiana","Vigo County",4,75,909,415,494
050,18,167,"Indiana","Vigo County",4,76,638,281,357
050,18,167,"Indiana","Vigo County",4,77,650,278,372
050,18,167,"Indiana","Vigo County",4,78,597,247,350
050,18,167,"Indiana","Vigo County",4,79,594,237,357
050,18,167,"Indiana","Vigo County",4,80,530,193,337
050,18,167,"Indiana","Vigo County",4,81,483,188,295
050,18,167,"Indiana","Vigo County",4,82,453,160,293
050,18,167,"Indiana","Vigo County",4,83,411,144,267
050,18,167,"Indiana","Vigo County",4,84,388,129,259
050,18,167,"Indiana","Vigo County",4,85,2090,613,1477
050,18,167,"Indiana","Vigo County",5,0,1158,589,569
050,18,167,"Indiana","Vigo County",5,1,1122,554,568
050,18,167,"Indiana","Vigo County",5,2,1154,586,568
050,18,167,"Indiana","Vigo County",5,3,1165,602,563
050,18,167,"Indiana","Vigo County",5,4,1134,589,545
050,18,167,"Indiana","Vigo County",5,5,1147,590,557
050,18,167,"Indiana","Vigo County",5,6,1196,607,589
050,18,167,"Indiana","Vigo County",5,7,1208,614,594
050,18,167,"Indiana","Vigo County",5,8,1246,650,596
050,18,167,"Indiana","Vigo County",5,9,1242,668,574
050,18,167,"Indiana","Vigo County",5,10,1224,643,581
050,18,167,"Indiana","Vigo County",5,11,1190,613,577
050,18,167,"Indiana","Vigo County",5,12,1207,624,583
050,18,167,"Indiana","Vigo County",5,13,1214,629,585
050,18,167,"Indiana","Vigo County",5,14,1269,657,612
050,18,167,"Indiana","Vigo County",5,15,1317,686,631
050,18,167,"Indiana","Vigo County",5,16,1299,673,626
050,18,167,"Indiana","Vigo County",5,17,1292,679,613
050,18,167,"Indiana","Vigo County",5,18,1525,785,740
050,18,167,"Indiana","Vigo County",5,19,2685,1406,1279
050,18,167,"Indiana","Vigo County",5,20,2696,1411,1285
050,18,167,"Indiana","Vigo County",5,21,2692,1402,1290
050,18,167,"Indiana","Vigo County",5,22,2302,1198,1104
050,18,167,"Indiana","Vigo County",5,23,2004,1022,982
050,18,167,"Indiana","Vigo County",5,24,1695,871,824
050,18,167,"Indiana","Vigo County",5,25,1520,814,706
050,18,167,"Indiana","Vigo County",5,26,1479,764,715
050,18,167,"Indiana","Vigo County",5,27,1386,723,663
050,18,167,"Indiana","Vigo County",5,28,1316,711,605
050,18,167,"Indiana","Vigo County",5,29,1357,732,625
050,18,167,"Indiana","Vigo County",5,30,1419,782,637
050,18,167,"Indiana","Vigo County",5,31,1459,792,667
050,18,167,"Indiana","Vigo County",5,32,1483,803,680
050,18,167,"Indiana","Vigo County",5,33,1367,736,631
050,18,167,"Indiana","Vigo County",5,34,1252,685,567
050,18,167,"Indiana","Vigo County",5,35,1250,686,564
050,18,167,"Indiana","Vigo County",5,36,1192,664,528
050,18,167,"Indiana","Vigo County",5,37,1238,682,556
050,18,167,"Indiana","Vigo County",5,38,1304,701,603
050,18,167,"Indiana","Vigo County",5,39,1257,648,609
050,18,167,"Indiana","Vigo County",5,40,1284,692,592
050,18,167,"Indiana","Vigo County",5,41,1236,686,550
050,18,167,"Indiana","Vigo County",5,42,1234,661,573
050,18,167,"Indiana","Vigo County",5,43,1240,646,594
050,18,167,"Indiana","Vigo County",5,44,1171,590,581
050,18,167,"Indiana","Vigo County",5,45,1190,623,567
050,18,167,"Indiana","Vigo County",5,46,1130,583,547
050,18,167,"Indiana","Vigo County",5,47,1076,550,526
050,18,167,"Indiana","Vigo County",5,48,1115,571,544
050,18,167,"Indiana","Vigo County",5,49,1103,571,532
050,18,167,"Indiana","Vigo County",5,50,1149,586,563
050,18,167,"Indiana","Vigo County",5,51,1233,642,591
050,18,167,"Indiana","Vigo County",5,52,1279,659,620
050,18,167,"Indiana","Vigo County",5,53,1208,627,581
050,18,167,"Indiana","Vigo County",5,54,1162,597,565
050,18,167,"Indiana","Vigo County",5,55,1161,601,560
050,18,167,"Indiana","Vigo County",5,56,1139,580,559
050,18,167,"Indiana","Vigo County",5,57,1125,562,563
050,18,167,"Indiana","Vigo County",5,58,1172,579,593
050,18,167,"Indiana","Vigo County",5,59,1222,631,591
050,18,167,"Indiana","Vigo County",5,60,1240,619,621
050,18,167,"Indiana","Vigo County",5,61,1244,608,636
050,18,167,"Indiana","Vigo County",5,62,1251,610,641
050,18,167,"Indiana","Vigo County",5,63,1193,558,635
050,18,167,"Indiana","Vigo County",5,64,1185,555,630
050,18,167,"Indiana","Vigo County",5,65,1248,586,662
050,18,167,"Indiana","Vigo County",5,66,1228,600,628
050,18,167,"Indiana","Vigo County",5,67,1162,539,623
050,18,167,"Indiana","Vigo County",5,68,1161,559,602
050,18,167,"Indiana","Vigo County",5,69,1105,527,578
050,18,167,"Indiana","Vigo County",5,70,1054,479,575
050,18,167,"Indiana","Vigo County",5,71,1030,458,572
050,18,167,"Indiana","Vigo County",5,72,990,455,535
050,18,167,"Indiana","Vigo County",5,73,917,413,504
050,18,167,"Indiana","Vigo County",5,74,883,382,501
050,18,167,"Indiana","Vigo County",5,75,823,357,466
050,18,167,"Indiana","Vigo County",5,76,862,392,470
050,18,167,"Indiana","Vigo County",5,77,612,265,347
050,18,167,"Indiana","Vigo County",5,78,637,270,367
050,18,167,"Indiana","Vigo County",5,79,565,233,332
050,18,167,"Indiana","Vigo County",5,80,563,213,350
050,18,167,"Indiana","Vigo County",5,81,493,182,311
050,18,167,"Indiana","Vigo County",5,82,456,169,287
050,18,167,"Indiana","Vigo County",5,83,428,154,274
050,18,167,"Indiana","Vigo County",5,84,393,126,267
050,18,167,"Indiana","Vigo County",5,85,2139,632,1507
050,18,169,"Indiana","Wabash County",1,0,308,158,150
050,18,169,"Indiana","Wabash County",1,1,319,171,148
050,18,169,"Indiana","Wabash County",1,2,328,162,166
050,18,169,"Indiana","Wabash County",1,3,332,168,164
050,18,169,"Indiana","Wabash County",1,4,369,185,184
050,18,169,"Indiana","Wabash County",1,5,328,154,174
050,18,169,"Indiana","Wabash County",1,6,339,171,168
050,18,169,"Indiana","Wabash County",1,7,345,175,170
050,18,169,"Indiana","Wabash County",1,8,342,172,170
050,18,169,"Indiana","Wabash County",1,9,352,162,190
050,18,169,"Indiana","Wabash County",1,10,358,168,190
050,18,169,"Indiana","Wabash County",1,11,401,190,211
050,18,169,"Indiana","Wabash County",1,12,407,211,196
050,18,169,"Indiana","Wabash County",1,13,410,196,214
050,18,169,"Indiana","Wabash County",1,14,408,227,181
050,18,169,"Indiana","Wabash County",1,15,405,230,175
050,18,169,"Indiana","Wabash County",1,16,414,196,218
050,18,169,"Indiana","Wabash County",1,17,430,224,206
050,18,169,"Indiana","Wabash County",1,18,352,180,172
050,18,169,"Indiana","Wabash County",1,19,368,195,173
050,18,169,"Indiana","Wabash County",1,20,367,183,184
050,18,169,"Indiana","Wabash County",1,21,342,182,160
050,18,169,"Indiana","Wabash County",1,22,349,177,172
050,18,169,"Indiana","Wabash County",1,23,345,170,175
050,18,169,"Indiana","Wabash County",1,24,372,191,181
050,18,169,"Indiana","Wabash County",1,25,351,181,170
050,18,169,"Indiana","Wabash County",1,26,337,159,178
050,18,169,"Indiana","Wabash County",1,27,339,171,168
050,18,169,"Indiana","Wabash County",1,28,364,185,179
050,18,169,"Indiana","Wabash County",1,29,348,183,165
050,18,169,"Indiana","Wabash County",1,30,339,179,160
050,18,169,"Indiana","Wabash County",1,31,341,168,173
050,18,169,"Indiana","Wabash County",1,32,328,158,170
050,18,169,"Indiana","Wabash County",1,33,331,165,166
050,18,169,"Indiana","Wabash County",1,34,317,150,167
050,18,169,"Indiana","Wabash County",1,35,310,148,162
050,18,169,"Indiana","Wabash County",1,36,313,152,161
050,18,169,"Indiana","Wabash County",1,37,365,176,189
050,18,169,"Indiana","Wabash County",1,38,362,174,188
050,18,169,"Indiana","Wabash County",1,39,354,179,175
050,18,169,"Indiana","Wabash County",1,40,382,201,181
050,18,169,"Indiana","Wabash County",1,41,350,177,173
050,18,169,"Indiana","Wabash County",1,42,357,192,165
050,18,169,"Indiana","Wabash County",1,43,348,177,171
050,18,169,"Indiana","Wabash County",1,44,343,166,177
050,18,169,"Indiana","Wabash County",1,45,360,164,196
050,18,169,"Indiana","Wabash County",1,46,336,167,169
050,18,169,"Indiana","Wabash County",1,47,366,178,188
050,18,169,"Indiana","Wabash County",1,48,408,221,187
050,18,169,"Indiana","Wabash County",1,49,401,204,197
050,18,169,"Indiana","Wabash County",1,50,382,192,190
050,18,169,"Indiana","Wabash County",1,51,374,189,185
050,18,169,"Indiana","Wabash County",1,52,367,174,193
050,18,169,"Indiana","Wabash County",1,53,372,180,192
050,18,169,"Indiana","Wabash County",1,54,393,186,207
050,18,169,"Indiana","Wabash County",1,55,444,215,229
050,18,169,"Indiana","Wabash County",1,56,427,216,211
050,18,169,"Indiana","Wabash County",1,57,417,206,211
050,18,169,"Indiana","Wabash County",1,58,480,247,233
050,18,169,"Indiana","Wabash County",1,59,491,255,236
050,18,169,"Indiana","Wabash County",1,60,468,233,235
050,18,169,"Indiana","Wabash County",1,61,464,228,236
050,18,169,"Indiana","Wabash County",1,62,462,243,219
050,18,169,"Indiana","Wabash County",1,63,448,223,225
050,18,169,"Indiana","Wabash County",1,64,443,216,227
050,18,169,"Indiana","Wabash County",1,65,459,233,226
050,18,169,"Indiana","Wabash County",1,66,397,192,205
050,18,169,"Indiana","Wabash County",1,67,408,185,223
050,18,169,"Indiana","Wabash County",1,68,389,178,211
050,18,169,"Indiana","Wabash County",1,69,344,166,178
050,18,169,"Indiana","Wabash County",1,70,339,177,162
050,18,169,"Indiana","Wabash County",1,71,337,167,170
050,18,169,"Indiana","Wabash County",1,72,360,166,194
050,18,169,"Indiana","Wabash County",1,73,374,179,195
050,18,169,"Indiana","Wabash County",1,74,236,111,125
050,18,169,"Indiana","Wabash County",1,75,251,115,136
050,18,169,"Indiana","Wabash County",1,76,260,112,148
050,18,169,"Indiana","Wabash County",1,77,246,110,136
050,18,169,"Indiana","Wabash County",1,78,219,96,123
050,18,169,"Indiana","Wabash County",1,79,190,88,102
050,18,169,"Indiana","Wabash County",1,80,196,78,118
050,18,169,"Indiana","Wabash County",1,81,185,76,109
050,18,169,"Indiana","Wabash County",1,82,175,73,102
050,18,169,"Indiana","Wabash County",1,83,166,61,105
050,18,169,"Indiana","Wabash County",1,84,163,60,103
050,18,169,"Indiana","Wabash County",1,85,1015,329,686
050,18,169,"Indiana","Wabash County",2,0,308,157,151
050,18,169,"Indiana","Wabash County",2,1,315,166,149
050,18,169,"Indiana","Wabash County",2,2,326,165,161
050,18,169,"Indiana","Wabash County",2,3,331,167,164
050,18,169,"Indiana","Wabash County",2,4,362,180,182
050,18,169,"Indiana","Wabash County",2,5,341,163,178
050,18,169,"Indiana","Wabash County",2,6,335,166,169
050,18,169,"Indiana","Wabash County",2,7,344,177,167
050,18,169,"Indiana","Wabash County",2,8,344,174,170
050,18,169,"Indiana","Wabash County",2,9,348,165,183
050,18,169,"Indiana","Wabash County",2,10,357,167,190
050,18,169,"Indiana","Wabash County",2,11,388,184,204
050,18,169,"Indiana","Wabash County",2,12,406,206,200
050,18,169,"Indiana","Wabash County",2,13,407,198,209
050,18,169,"Indiana","Wabash County",2,14,409,222,187
050,18,169,"Indiana","Wabash County",2,15,406,229,177
050,18,169,"Indiana","Wabash County",2,16,409,201,208
050,18,169,"Indiana","Wabash County",2,17,427,220,207
050,18,169,"Indiana","Wabash County",2,18,348,180,168
050,18,169,"Indiana","Wabash County",2,19,366,192,174
050,18,169,"Indiana","Wabash County",2,20,368,185,183
050,18,169,"Indiana","Wabash County",2,21,345,180,165
050,18,169,"Indiana","Wabash County",2,22,347,178,169
050,18,169,"Indiana","Wabash County",2,23,349,171,178
050,18,169,"Indiana","Wabash County",2,24,360,186,174
050,18,169,"Indiana","Wabash County",2,25,354,183,171
050,18,169,"Indiana","Wabash County",2,26,338,163,175
050,18,169,"Indiana","Wabash County",2,27,341,168,173
050,18,169,"Indiana","Wabash County",2,28,359,184,175
050,18,169,"Indiana","Wabash County",2,29,348,180,168
050,18,169,"Indiana","Wabash County",2,30,345,181,164
050,18,169,"Indiana","Wabash County",2,31,334,167,167
050,18,169,"Indiana","Wabash County",2,32,332,161,171
050,18,169,"Indiana","Wabash County",2,33,332,165,167
050,18,169,"Indiana","Wabash County",2,34,323,155,168
050,18,169,"Indiana","Wabash County",2,35,313,149,164
050,18,169,"Indiana","Wabash County",2,36,309,151,158
050,18,169,"Indiana","Wabash County",2,37,355,169,186
050,18,169,"Indiana","Wabash County",2,38,365,176,189
050,18,169,"Indiana","Wabash County",2,39,357,178,179
050,18,169,"Indiana","Wabash County",2,40,376,197,179
050,18,169,"Indiana","Wabash County",2,41,360,185,175
050,18,169,"Indiana","Wabash County",2,42,354,187,167
050,18,169,"Indiana","Wabash County",2,43,354,182,172
050,18,169,"Indiana","Wabash County",2,44,341,168,173
050,18,169,"Indiana","Wabash County",2,45,359,165,194
050,18,169,"Indiana","Wabash County",2,46,338,165,173
050,18,169,"Indiana","Wabash County",2,47,357,174,183
050,18,169,"Indiana","Wabash County",2,48,396,211,185
050,18,169,"Indiana","Wabash County",2,49,407,211,196
050,18,169,"Indiana","Wabash County",2,50,387,195,192
050,18,169,"Indiana","Wabash County",2,51,373,187,186
050,18,169,"Indiana","Wabash County",2,52,368,179,189
050,18,169,"Indiana","Wabash County",2,53,369,179,190
050,18,169,"Indiana","Wabash County",2,54,386,184,202
050,18,169,"Indiana","Wabash County",2,55,431,208,223
050,18,169,"Indiana","Wabash County",2,56,431,216,215
050,18,169,"Indiana","Wabash County",2,57,417,206,211
050,18,169,"Indiana","Wabash County",2,58,464,237,227
050,18,169,"Indiana","Wabash County",2,59,486,252,234
050,18,169,"Indiana","Wabash County",2,60,470,236,234
050,18,169,"Indiana","Wabash County",2,61,464,227,237
050,18,169,"Indiana","Wabash County",2,62,462,239,223
050,18,169,"Indiana","Wabash County",2,63,455,231,224
050,18,169,"Indiana","Wabash County",2,64,442,217,225
050,18,169,"Indiana","Wabash County",2,65,450,225,225
050,18,169,"Indiana","Wabash County",2,66,412,202,210
050,18,169,"Indiana","Wabash County",2,67,401,184,217
050,18,169,"Indiana","Wabash County",2,68,392,179,213
050,18,169,"Indiana","Wabash County",2,69,353,167,186
050,18,169,"Indiana","Wabash County",2,70,338,172,166
050,18,169,"Indiana","Wabash County",2,71,336,169,167
050,18,169,"Indiana","Wabash County",2,72,345,164,181
050,18,169,"Indiana","Wabash County",2,73,388,184,204
050,18,169,"Indiana","Wabash County",2,74,247,116,131
050,18,169,"Indiana","Wabash County",2,75,245,111,134
050,18,169,"Indiana","Wabash County",2,76,255,110,145
050,18,169,"Indiana","Wabash County",2,77,258,114,144
050,18,169,"Indiana","Wabash County",2,78,216,95,121
050,18,169,"Indiana","Wabash County",2,79,196,90,106
050,18,169,"Indiana","Wabash County",2,80,195,79,116
050,18,169,"Indiana","Wabash County",2,81,185,76,109
050,18,169,"Indiana","Wabash County",2,82,177,73,104
050,18,169,"Indiana","Wabash County",2,83,166,62,104
050,18,169,"Indiana","Wabash County",2,84,161,60,101
050,18,169,"Indiana","Wabash County",2,85,1020,329,691
050,18,169,"Indiana","Wabash County",3,0,290,139,151
050,18,169,"Indiana","Wabash County",3,1,331,162,169
050,18,169,"Indiana","Wabash County",3,2,314,163,151
050,18,169,"Indiana","Wabash County",3,3,335,171,164
050,18,169,"Indiana","Wabash County",3,4,329,160,169
050,18,169,"Indiana","Wabash County",3,5,367,186,181
050,18,169,"Indiana","Wabash County",3,6,355,168,187
050,18,169,"Indiana","Wabash County",3,7,343,176,167
050,18,169,"Indiana","Wabash County",3,8,345,177,168
050,18,169,"Indiana","Wabash County",3,9,340,165,175
050,18,169,"Indiana","Wabash County",3,10,342,158,184
050,18,169,"Indiana","Wabash County",3,11,356,168,188
050,18,169,"Indiana","Wabash County",3,12,391,185,206
050,18,169,"Indiana","Wabash County",3,13,425,215,210
050,18,169,"Indiana","Wabash County",3,14,420,207,213
050,18,169,"Indiana","Wabash County",3,15,407,228,179
050,18,169,"Indiana","Wabash County",3,16,414,223,191
050,18,169,"Indiana","Wabash County",3,17,437,223,214
050,18,169,"Indiana","Wabash County",3,18,357,178,179
050,18,169,"Indiana","Wabash County",3,19,357,193,164
050,18,169,"Indiana","Wabash County",3,20,361,180,181
050,18,169,"Indiana","Wabash County",3,21,360,185,175
050,18,169,"Indiana","Wabash County",3,22,358,189,169
050,18,169,"Indiana","Wabash County",3,23,336,173,163
050,18,169,"Indiana","Wabash County",3,24,341,170,171
050,18,169,"Indiana","Wabash County",3,25,351,186,165
050,18,169,"Indiana","Wabash County",3,26,353,185,168
050,18,169,"Indiana","Wabash County",3,27,368,176,192
050,18,169,"Indiana","Wabash County",3,28,346,160,186
050,18,169,"Indiana","Wabash County",3,29,365,185,180
050,18,169,"Indiana","Wabash County",3,30,347,184,163
050,18,169,"Indiana","Wabash County",3,31,329,183,146
050,18,169,"Indiana","Wabash County",3,32,356,179,177
050,18,169,"Indiana","Wabash County",3,33,314,154,160
050,18,169,"Indiana","Wabash County",3,34,331,164,167
050,18,169,"Indiana","Wabash County",3,35,330,156,174
050,18,169,"Indiana","Wabash County",3,36,312,150,162
050,18,169,"Indiana","Wabash County",3,37,329,156,173
050,18,169,"Indiana","Wabash County",3,38,357,174,183
050,18,169,"Indiana","Wabash County",3,39,373,179,194
050,18,169,"Indiana","Wabash County",3,40,358,180,178
050,18,169,"Indiana","Wabash County",3,41,387,200,187
050,18,169,"Indiana","Wabash County",3,42,373,190,183
050,18,169,"Indiana","Wabash County",3,43,350,188,162
050,18,169,"Indiana","Wabash County",3,44,350,183,167
050,18,169,"Indiana","Wabash County",3,45,339,164,175
050,18,169,"Indiana","Wabash County",3,46,363,167,196
050,18,169,"Indiana","Wabash County",3,47,338,161,177
050,18,169,"Indiana","Wabash County",3,48,356,177,179
050,18,169,"Indiana","Wabash County",3,49,405,216,189
050,18,169,"Indiana","Wabash County",3,50,413,215,198
050,18,169,"Indiana","Wabash County",3,51,375,183,192
050,18,169,"Indiana","Wabash County",3,52,377,184,193
050,18,169,"Indiana","Wabash County",3,53,367,180,187
050,18,169,"Indiana","Wabash County",3,54,373,175,198
050,18,169,"Indiana","Wabash County",3,55,388,184,204
050,18,169,"Indiana","Wabash County",3,56,424,205,219
050,18,169,"Indiana","Wabash County",3,57,424,212,212
050,18,169,"Indiana","Wabash County",3,58,427,210,217
050,18,169,"Indiana","Wabash County",3,59,458,233,225
050,18,169,"Indiana","Wabash County",3,60,489,252,237
050,18,169,"Indiana","Wabash County",3,61,476,240,236
050,18,169,"Indiana","Wabash County",3,62,466,231,235
050,18,169,"Indiana","Wabash County",3,63,459,238,221
050,18,169,"Indiana","Wabash County",3,64,456,230,226
050,18,169,"Indiana","Wabash County",3,65,442,217,225
050,18,169,"Indiana","Wabash County",3,66,433,218,215
050,18,169,"Indiana","Wabash County",3,67,405,200,205
050,18,169,"Indiana","Wabash County",3,68,388,177,211
050,18,169,"Indiana","Wabash County",3,69,379,178,201
050,18,169,"Indiana","Wabash County",3,70,353,163,190
050,18,169,"Indiana","Wabash County",3,71,330,171,159
050,18,169,"Indiana","Wabash County",3,72,325,162,163
050,18,169,"Indiana","Wabash County",3,73,333,154,179
050,18,169,"Indiana","Wabash County",3,74,369,178,191
050,18,169,"Indiana","Wabash County",3,75,227,103,124
050,18,169,"Indiana","Wabash County",3,76,238,108,130
050,18,169,"Indiana","Wabash County",3,77,249,111,138
050,18,169,"Indiana","Wabash County",3,78,236,97,139
050,18,169,"Indiana","Wabash County",3,79,205,93,112
050,18,169,"Indiana","Wabash County",3,80,184,80,104
050,18,169,"Indiana","Wabash County",3,81,181,70,111
050,18,169,"Indiana","Wabash County",3,82,165,65,100
050,18,169,"Indiana","Wabash County",3,83,146,57,89
050,18,169,"Indiana","Wabash County",3,84,157,59,98
050,18,169,"Indiana","Wabash County",3,85,985,322,663
050,18,169,"Indiana","Wabash County",4,0,310,157,153
050,18,169,"Indiana","Wabash County",4,1,288,132,156
050,18,169,"Indiana","Wabash County",4,2,339,168,171
050,18,169,"Indiana","Wabash County",4,3,311,163,148
050,18,169,"Indiana","Wabash County",4,4,353,183,170
050,18,169,"Indiana","Wabash County",4,5,336,167,169
050,18,169,"Indiana","Wabash County",4,6,374,186,188
050,18,169,"Indiana","Wabash County",4,7,363,170,193
050,18,169,"Indiana","Wabash County",4,8,347,181,166
050,18,169,"Indiana","Wabash County",4,9,356,178,178
050,18,169,"Indiana","Wabash County",4,10,352,172,180
050,18,169,"Indiana","Wabash County",4,11,348,167,181
050,18,169,"Indiana","Wabash County",4,12,361,176,185
050,18,169,"Indiana","Wabash County",4,13,402,193,209
050,18,169,"Indiana","Wabash County",4,14,423,224,199
050,18,169,"Indiana","Wabash County",4,15,425,214,211
050,18,169,"Indiana","Wabash County",4,16,416,222,194
050,18,169,"Indiana","Wabash County",4,17,424,228,196
050,18,169,"Indiana","Wabash County",4,18,362,185,177
050,18,169,"Indiana","Wabash County",4,19,358,184,174
050,18,169,"Indiana","Wabash County",4,20,347,181,166
050,18,169,"Indiana","Wabash County",4,21,361,180,181
050,18,169,"Indiana","Wabash County",4,22,365,190,175
050,18,169,"Indiana","Wabash County",4,23,333,165,168
050,18,169,"Indiana","Wabash County",4,24,340,175,165
050,18,169,"Indiana","Wabash County",4,25,341,175,166
050,18,169,"Indiana","Wabash County",4,26,345,181,164
050,18,169,"Indiana","Wabash County",4,27,357,181,176
050,18,169,"Indiana","Wabash County",4,28,361,175,186
050,18,169,"Indiana","Wabash County",4,29,337,160,177
050,18,169,"Indiana","Wabash County",4,30,380,191,189
050,18,169,"Indiana","Wabash County",4,31,352,175,177
050,18,169,"Indiana","Wabash County",4,32,339,188,151
050,18,169,"Indiana","Wabash County",4,33,360,183,177
050,18,169,"Indiana","Wabash County",4,34,320,159,161
050,18,169,"Indiana","Wabash County",4,35,342,168,174
050,18,169,"Indiana","Wabash County",4,36,334,157,177
050,18,169,"Indiana","Wabash County",4,37,321,155,166
050,18,169,"Indiana","Wabash County",4,38,341,162,179
050,18,169,"Indiana","Wabash County",4,39,361,172,189
050,18,169,"Indiana","Wabash County",4,40,372,180,192
050,18,169,"Indiana","Wabash County",4,41,365,189,176
050,18,169,"Indiana","Wabash County",4,42,387,201,186
050,18,169,"Indiana","Wabash County",4,43,373,184,189
050,18,169,"Indiana","Wabash County",4,44,351,189,162
050,18,169,"Indiana","Wabash County",4,45,365,185,180
050,18,169,"Indiana","Wabash County",4,46,333,161,172
050,18,169,"Indiana","Wabash County",4,47,354,159,195
050,18,169,"Indiana","Wabash County",4,48,338,171,167
050,18,169,"Indiana","Wabash County",4,49,350,174,176
050,18,169,"Indiana","Wabash County",4,50,385,205,180
050,18,169,"Indiana","Wabash County",4,51,409,212,197
050,18,169,"Indiana","Wabash County",4,52,385,179,206
050,18,169,"Indiana","Wabash County",4,53,382,186,196
050,18,169,"Indiana","Wabash County",4,54,371,185,186
050,18,169,"Indiana","Wabash County",4,55,374,176,198
050,18,169,"Indiana","Wabash County",4,56,387,182,205
050,18,169,"Indiana","Wabash County",4,57,417,200,217
050,18,169,"Indiana","Wabash County",4,58,426,212,214
050,18,169,"Indiana","Wabash County",4,59,420,207,213
050,18,169,"Indiana","Wabash County",4,60,461,234,227
050,18,169,"Indiana","Wabash County",4,61,487,252,235
050,18,169,"Indiana","Wabash County",4,62,478,237,241
050,18,169,"Indiana","Wabash County",4,63,467,232,235
050,18,169,"Indiana","Wabash County",4,64,457,231,226
050,18,169,"Indiana","Wabash County",4,65,447,226,221
050,18,169,"Indiana","Wabash County",4,66,427,209,218
050,18,169,"Indiana","Wabash County",4,67,430,215,215
050,18,169,"Indiana","Wabash County",4,68,396,192,204
050,18,169,"Indiana","Wabash County",4,69,366,167,199
050,18,169,"Indiana","Wabash County",4,70,372,169,203
050,18,169,"Indiana","Wabash County",4,71,339,163,176
050,18,169,"Indiana","Wabash County",4,72,322,168,154
050,18,169,"Indiana","Wabash County",4,73,322,157,165
050,18,169,"Indiana","Wabash County",4,74,317,145,172
050,18,169,"Indiana","Wabash County",4,75,347,163,184
050,18,169,"Indiana","Wabash County",4,76,219,100,119
050,18,169,"Indiana","Wabash County",4,77,231,105,126
050,18,169,"Indiana","Wabash County",4,78,233,101,132
050,18,169,"Indiana","Wabash County",4,79,225,95,130
050,18,169,"Indiana","Wabash County",4,80,197,85,112
050,18,169,"Indiana","Wabash County",4,81,169,69,100
050,18,169,"Indiana","Wabash County",4,82,159,58,101
050,18,169,"Indiana","Wabash County",4,83,136,53,83
050,18,169,"Indiana","Wabash County",4,84,141,54,87
050,18,169,"Indiana","Wabash County",4,85,968,323,645
050,18,169,"Indiana","Wabash County",5,0,308,156,152
050,18,169,"Indiana","Wabash County",5,1,324,155,169
050,18,169,"Indiana","Wabash County",5,2,296,140,156
050,18,169,"Indiana","Wabash County",5,3,344,179,165
050,18,169,"Indiana","Wabash County",5,4,317,165,152
050,18,169,"Indiana","Wabash County",5,5,353,177,176
050,18,169,"Indiana","Wabash County",5,6,338,172,166
050,18,169,"Indiana","Wabash County",5,7,367,185,182
050,18,169,"Indiana","Wabash County",5,8,365,172,193
050,18,169,"Indiana","Wabash County",5,9,350,179,171
050,18,169,"Indiana","Wabash County",5,10,339,166,173
050,18,169,"Indiana","Wabash County",5,11,347,171,176
050,18,169,"Indiana","Wabash County",5,12,353,171,182
050,18,169,"Indiana","Wabash County",5,13,360,172,188
050,18,169,"Indiana","Wabash County",5,14,426,214,212
050,18,169,"Indiana","Wabash County",5,15,435,229,206
050,18,169,"Indiana","Wabash County",5,16,424,205,219
050,18,169,"Indiana","Wabash County",5,17,411,225,186
050,18,169,"Indiana","Wabash County",5,18,345,192,153
050,18,169,"Indiana","Wabash County",5,19,350,185,165
050,18,169,"Indiana","Wabash County",5,20,353,175,178
050,18,169,"Indiana","Wabash County",5,21,341,184,157
050,18,169,"Indiana","Wabash County",5,22,365,185,180
050,18,169,"Indiana","Wabash County",5,23,351,191,160
050,18,169,"Indiana","Wabash County",5,24,335,163,172
050,18,169,"Indiana","Wabash County",5,25,336,175,161
050,18,169,"Indiana","Wabash County",5,26,336,178,158
050,18,169,"Indiana","Wabash County",5,27,338,178,160
050,18,169,"Indiana","Wabash County",5,28,343,172,171
050,18,169,"Indiana","Wabash County",5,29,356,172,184
050,18,169,"Indiana","Wabash County",5,30,340,166,174
050,18,169,"Indiana","Wabash County",5,31,389,189,200
050,18,169,"Indiana","Wabash County",5,32,374,192,182
050,18,169,"Indiana","Wabash County",5,33,347,192,155
050,18,169,"Indiana","Wabash County",5,34,369,187,182
050,18,169,"Indiana","Wabash County",5,35,345,168,177
050,18,169,"Indiana","Wabash County",5,36,340,167,173
050,18,169,"Indiana","Wabash County",5,37,343,157,186
050,18,169,"Indiana","Wabash County",5,38,326,159,167
050,18,169,"Indiana","Wabash County",5,39,335,159,176
050,18,169,"Indiana","Wabash County",5,40,356,169,187
050,18,169,"Indiana","Wabash County",5,41,375,186,189
050,18,169,"Indiana","Wabash County",5,42,368,187,181
050,18,169,"Indiana","Wabash County",5,43,384,197,187
050,18,169,"Indiana","Wabash County",5,44,364,182,182
050,18,169,"Indiana","Wabash County",5,45,351,188,163
050,18,169,"Indiana","Wabash County",5,46,353,180,173
050,18,169,"Indiana","Wabash County",5,47,327,157,170
050,18,169,"Indiana","Wabash County",5,48,352,158,194
050,18,169,"Indiana","Wabash County",5,49,337,161,176
050,18,169,"Indiana","Wabash County",5,50,345,169,176
050,18,169,"Indiana","Wabash County",5,51,396,211,185
050,18,169,"Indiana","Wabash County",5,52,404,209,195
050,18,169,"Indiana","Wabash County",5,53,385,182,203
050,18,169,"Indiana","Wabash County",5,54,375,186,189
050,18,169,"Indiana","Wabash County",5,55,372,182,190
050,18,169,"Indiana","Wabash County",5,56,375,176,199
050,18,169,"Indiana","Wabash County",5,57,386,183,203
050,18,169,"Indiana","Wabash County",5,58,412,196,216
050,18,169,"Indiana","Wabash County",5,59,422,210,212
050,18,169,"Indiana","Wabash County",5,60,419,205,214
050,18,169,"Indiana","Wabash County",5,61,459,236,223
050,18,169,"Indiana","Wabash County",5,62,489,256,233
050,18,169,"Indiana","Wabash County",5,63,464,227,237
050,18,169,"Indiana","Wabash County",5,64,467,226,241
050,18,169,"Indiana","Wabash County",5,65,454,229,225
050,18,169,"Indiana","Wabash County",5,66,440,222,218
050,18,169,"Indiana","Wabash County",5,67,419,208,211
050,18,169,"Indiana","Wabash County",5,68,423,207,216
050,18,169,"Indiana","Wabash County",5,69,383,185,198
050,18,169,"Indiana","Wabash County",5,70,350,154,196
050,18,169,"Indiana","Wabash County",5,71,355,163,192
050,18,169,"Indiana","Wabash County",5,72,325,156,169
050,18,169,"Indiana","Wabash County",5,73,317,161,156
050,18,169,"Indiana","Wabash County",5,74,299,142,157
050,18,169,"Indiana","Wabash County",5,75,295,134,161
050,18,169,"Indiana","Wabash County",5,76,337,155,182
050,18,169,"Indiana","Wabash County",5,77,218,101,117
050,18,169,"Indiana","Wabash County",5,78,220,98,122
050,18,169,"Indiana","Wabash County",5,79,224,106,118
050,18,169,"Indiana","Wabash County",5,80,218,87,131
050,18,169,"Indiana","Wabash County",5,81,181,76,105
050,18,169,"Indiana","Wabash County",5,82,149,58,91
050,18,169,"Indiana","Wabash County",5,83,141,49,92
050,18,169,"Indiana","Wabash County",5,84,128,49,79
050,18,169,"Indiana","Wabash County",5,85,943,320,623
050,18,171,"Indiana","Warren County",1,0,76,38,38
050,18,171,"Indiana","Warren County",1,1,83,34,49
050,18,171,"Indiana","Warren County",1,2,89,47,42
050,18,171,"Indiana","Warren County",1,3,97,50,47
050,18,171,"Indiana","Warren County",1,4,90,35,55
050,18,171,"Indiana","Warren County",1,5,109,57,52
050,18,171,"Indiana","Warren County",1,6,94,48,46
050,18,171,"Indiana","Warren County",1,7,104,50,54
050,18,171,"Indiana","Warren County",1,8,112,55,57
050,18,171,"Indiana","Warren County",1,9,98,53,45
050,18,171,"Indiana","Warren County",1,10,110,63,47
050,18,171,"Indiana","Warren County",1,11,116,58,58
050,18,171,"Indiana","Warren County",1,12,127,64,63
050,18,171,"Indiana","Warren County",1,13,110,55,55
050,18,171,"Indiana","Warren County",1,14,118,63,55
050,18,171,"Indiana","Warren County",1,15,113,50,63
050,18,171,"Indiana","Warren County",1,16,117,57,60
050,18,171,"Indiana","Warren County",1,17,107,56,51
050,18,171,"Indiana","Warren County",1,18,95,47,48
050,18,171,"Indiana","Warren County",1,19,76,40,36
050,18,171,"Indiana","Warren County",1,20,77,45,32
050,18,171,"Indiana","Warren County",1,21,83,44,39
050,18,171,"Indiana","Warren County",1,22,87,50,37
050,18,171,"Indiana","Warren County",1,23,86,47,39
050,18,171,"Indiana","Warren County",1,24,74,37,37
050,18,171,"Indiana","Warren County",1,25,72,31,41
050,18,171,"Indiana","Warren County",1,26,80,33,47
050,18,171,"Indiana","Warren County",1,27,97,46,51
050,18,171,"Indiana","Warren County",1,28,103,48,55
050,18,171,"Indiana","Warren County",1,29,105,49,56
050,18,171,"Indiana","Warren County",1,30,78,40,38
050,18,171,"Indiana","Warren County",1,31,103,51,52
050,18,171,"Indiana","Warren County",1,32,89,44,45
050,18,171,"Indiana","Warren County",1,33,91,45,46
050,18,171,"Indiana","Warren County",1,34,104,52,52
050,18,171,"Indiana","Warren County",1,35,96,53,43
050,18,171,"Indiana","Warren County",1,36,99,52,47
050,18,171,"Indiana","Warren County",1,37,87,41,46
050,18,171,"Indiana","Warren County",1,38,86,37,49
050,18,171,"Indiana","Warren County",1,39,104,50,54
050,18,171,"Indiana","Warren County",1,40,114,59,55
050,18,171,"Indiana","Warren County",1,41,92,48,44
050,18,171,"Indiana","Warren County",1,42,93,45,48
050,18,171,"Indiana","Warren County",1,43,96,48,48
050,18,171,"Indiana","Warren County",1,44,88,49,39
050,18,171,"Indiana","Warren County",1,45,93,52,41
050,18,171,"Indiana","Warren County",1,46,95,52,43
050,18,171,"Indiana","Warren County",1,47,94,46,48
050,18,171,"Indiana","Warren County",1,48,118,53,65
050,18,171,"Indiana","Warren County",1,49,130,70,60
050,18,171,"Indiana","Warren County",1,50,122,66,56
050,18,171,"Indiana","Warren County",1,51,120,61,59
050,18,171,"Indiana","Warren County",1,52,103,54,49
050,18,171,"Indiana","Warren County",1,53,105,56,49
050,18,171,"Indiana","Warren County",1,54,125,68,57
050,18,171,"Indiana","Warren County",1,55,130,73,57
050,18,171,"Indiana","Warren County",1,56,139,76,63
050,18,171,"Indiana","Warren County",1,57,139,74,65
050,18,171,"Indiana","Warren County",1,58,140,74,66
050,18,171,"Indiana","Warren County",1,59,128,70,58
050,18,171,"Indiana","Warren County",1,60,116,69,47
050,18,171,"Indiana","Warren County",1,61,125,65,60
050,18,171,"Indiana","Warren County",1,62,130,73,57
050,18,171,"Indiana","Warren County",1,63,109,55,54
050,18,171,"Indiana","Warren County",1,64,122,58,64
050,18,171,"Indiana","Warren County",1,65,109,53,56
050,18,171,"Indiana","Warren County",1,66,120,60,60
050,18,171,"Indiana","Warren County",1,67,113,51,62
050,18,171,"Indiana","Warren County",1,68,101,51,50
050,18,171,"Indiana","Warren County",1,69,94,43,51
050,18,171,"Indiana","Warren County",1,70,94,48,46
050,18,171,"Indiana","Warren County",1,71,95,48,47
050,18,171,"Indiana","Warren County",1,72,88,50,38
050,18,171,"Indiana","Warren County",1,73,83,51,32
050,18,171,"Indiana","Warren County",1,74,71,32,39
050,18,171,"Indiana","Warren County",1,75,71,30,41
050,18,171,"Indiana","Warren County",1,76,76,27,49
050,18,171,"Indiana","Warren County",1,77,78,35,43
050,18,171,"Indiana","Warren County",1,78,63,27,36
050,18,171,"Indiana","Warren County",1,79,59,29,30
050,18,171,"Indiana","Warren County",1,80,51,18,33
050,18,171,"Indiana","Warren County",1,81,49,26,23
050,18,171,"Indiana","Warren County",1,82,54,22,32
050,18,171,"Indiana","Warren County",1,83,41,15,26
050,18,171,"Indiana","Warren County",1,84,28,14,14
050,18,171,"Indiana","Warren County",1,85,188,72,116
050,18,171,"Indiana","Warren County",2,0,85,43,42
050,18,171,"Indiana","Warren County",2,1,80,34,46
050,18,171,"Indiana","Warren County",2,2,88,44,44
050,18,171,"Indiana","Warren County",2,3,94,48,46
050,18,171,"Indiana","Warren County",2,4,91,39,52
050,18,171,"Indiana","Warren County",2,5,105,51,54
050,18,171,"Indiana","Warren County",2,6,99,50,49
050,18,171,"Indiana","Warren County",2,7,100,48,52
050,18,171,"Indiana","Warren County",2,8,108,53,55
050,18,171,"Indiana","Warren County",2,9,102,55,47
050,18,171,"Indiana","Warren County",2,10,107,60,47
050,18,171,"Indiana","Warren County",2,11,114,59,55
050,18,171,"Indiana","Warren County",2,12,125,63,62
050,18,171,"Indiana","Warren County",2,13,115,57,58
050,18,171,"Indiana","Warren County",2,14,116,60,56
050,18,171,"Indiana","Warren County",2,15,114,53,61
050,18,171,"Indiana","Warren County",2,16,116,55,61
050,18,171,"Indiana","Warren County",2,17,110,56,54
050,18,171,"Indiana","Warren County",2,18,92,48,44
050,18,171,"Indiana","Warren County",2,19,76,39,37
050,18,171,"Indiana","Warren County",2,20,79,46,33
050,18,171,"Indiana","Warren County",2,21,83,45,38
050,18,171,"Indiana","Warren County",2,22,86,49,37
050,18,171,"Indiana","Warren County",2,23,87,49,38
050,18,171,"Indiana","Warren County",2,24,79,40,39
050,18,171,"Indiana","Warren County",2,25,72,32,40
050,18,171,"Indiana","Warren County",2,26,79,33,46
050,18,171,"Indiana","Warren County",2,27,93,43,50
050,18,171,"Indiana","Warren County",2,28,103,48,55
050,18,171,"Indiana","Warren County",2,29,104,49,55
050,18,171,"Indiana","Warren County",2,30,86,43,43
050,18,171,"Indiana","Warren County",2,31,96,49,47
050,18,171,"Indiana","Warren County",2,32,92,46,46
050,18,171,"Indiana","Warren County",2,33,91,45,46
050,18,171,"Indiana","Warren County",2,34,101,50,51
050,18,171,"Indiana","Warren County",2,35,100,54,46
050,18,171,"Indiana","Warren County",2,36,97,52,45
050,18,171,"Indiana","Warren County",2,37,89,43,46
050,18,171,"Indiana","Warren County",2,38,87,39,48
050,18,171,"Indiana","Warren County",2,39,101,48,53
050,18,171,"Indiana","Warren County",2,40,113,57,56
050,18,171,"Indiana","Warren County",2,41,97,51,46
050,18,171,"Indiana","Warren County",2,42,91,45,46
050,18,171,"Indiana","Warren County",2,43,96,48,48
050,18,171,"Indiana","Warren County",2,44,90,49,41
050,18,171,"Indiana","Warren County",2,45,93,52,41
050,18,171,"Indiana","Warren County",2,46,96,53,43
050,18,171,"Indiana","Warren County",2,47,92,46,46
050,18,171,"Indiana","Warren County",2,48,111,51,60
050,18,171,"Indiana","Warren County",2,49,126,65,61
050,18,171,"Indiana","Warren County",2,50,122,66,56
050,18,171,"Indiana","Warren County",2,51,120,62,58
050,18,171,"Indiana","Warren County",2,52,105,55,50
050,18,171,"Indiana","Warren County",2,53,104,55,49
050,18,171,"Indiana","Warren County",2,54,120,65,55
050,18,171,"Indiana","Warren County",2,55,128,71,57
050,18,171,"Indiana","Warren County",2,56,135,74,61
050,18,171,"Indiana","Warren County",2,57,140,75,65
050,18,171,"Indiana","Warren County",2,58,139,74,65
050,18,171,"Indiana","Warren County",2,59,131,71,60
050,18,171,"Indiana","Warren County",2,60,118,68,50
050,18,171,"Indiana","Warren County",2,61,123,66,57
050,18,171,"Indiana","Warren County",2,62,128,71,57
050,18,171,"Indiana","Warren County",2,63,114,59,55
050,18,171,"Indiana","Warren County",2,64,118,57,61
050,18,171,"Indiana","Warren County",2,65,112,54,58
050,18,171,"Indiana","Warren County",2,66,117,58,59
050,18,171,"Indiana","Warren County",2,67,114,53,61
050,18,171,"Indiana","Warren County",2,68,103,51,52
050,18,171,"Indiana","Warren County",2,69,97,45,52
050,18,171,"Indiana","Warren County",2,70,92,46,46
050,18,171,"Indiana","Warren County",2,71,95,48,47
050,18,171,"Indiana","Warren County",2,72,88,48,40
050,18,171,"Indiana","Warren County",2,73,87,53,34
050,18,171,"Indiana","Warren County",2,74,67,33,34
050,18,171,"Indiana","Warren County",2,75,70,30,40
050,18,171,"Indiana","Warren County",2,76,73,27,46
050,18,171,"Indiana","Warren County",2,77,78,32,46
050,18,171,"Indiana","Warren County",2,78,66,29,37
050,18,171,"Indiana","Warren County",2,79,59,27,32
050,18,171,"Indiana","Warren County",2,80,53,21,32
050,18,171,"Indiana","Warren County",2,81,50,25,25
050,18,171,"Indiana","Warren County",2,82,52,21,31
050,18,171,"Indiana","Warren County",2,83,44,16,28
050,18,171,"Indiana","Warren County",2,84,27,13,14
050,18,171,"Indiana","Warren County",2,85,187,72,115
050,18,171,"Indiana","Warren County",3,0,62,37,25
050,18,171,"Indiana","Warren County",3,1,72,38,34
050,18,171,"Indiana","Warren County",3,2,75,35,40
050,18,171,"Indiana","Warren County",3,3,99,49,50
050,18,171,"Indiana","Warren County",3,4,101,47,54
050,18,171,"Indiana","Warren County",3,5,92,41,51
050,18,171,"Indiana","Warren County",3,6,108,57,51
050,18,171,"Indiana","Warren County",3,7,91,45,46
050,18,171,"Indiana","Warren County",3,8,101,46,55
050,18,171,"Indiana","Warren County",3,9,119,57,62
050,18,171,"Indiana","Warren County",3,10,100,52,48
050,18,171,"Indiana","Warren County",3,11,113,64,49
050,18,171,"Indiana","Warren County",3,12,125,66,59
050,18,171,"Indiana","Warren County",3,13,122,61,61
050,18,171,"Indiana","Warren County",3,14,118,62,56
050,18,171,"Indiana","Warren County",3,15,124,72,52
050,18,171,"Indiana","Warren County",3,16,123,57,66
050,18,171,"Indiana","Warren County",3,17,120,58,62
050,18,171,"Indiana","Warren County",3,18,92,53,39
050,18,171,"Indiana","Warren County",3,19,64,33,31
050,18,171,"Indiana","Warren County",3,20,81,42,39
050,18,171,"Indiana","Warren County",3,21,79,42,37
050,18,171,"Indiana","Warren County",3,22,78,43,35
050,18,171,"Indiana","Warren County",3,23,95,54,41
050,18,171,"Indiana","Warren County",3,24,90,52,38
050,18,171,"Indiana","Warren County",3,25,87,42,45
050,18,171,"Indiana","Warren County",3,26,74,34,40
050,18,171,"Indiana","Warren County",3,27,80,38,42
050,18,171,"Indiana","Warren County",3,28,98,39,59
050,18,171,"Indiana","Warren County",3,29,102,43,59
050,18,171,"Indiana","Warren County",3,30,105,53,52
050,18,171,"Indiana","Warren County",3,31,92,51,41
050,18,171,"Indiana","Warren County",3,32,97,50,47
050,18,171,"Indiana","Warren County",3,33,103,50,53
050,18,171,"Indiana","Warren County",3,34,87,42,45
050,18,171,"Indiana","Warren County",3,35,101,51,50
050,18,171,"Indiana","Warren County",3,36,97,50,47
050,18,171,"Indiana","Warren County",3,37,94,52,42
050,18,171,"Indiana","Warren County",3,38,94,47,47
050,18,171,"Indiana","Warren County",3,39,83,37,46
050,18,171,"Indiana","Warren County",3,40,108,49,59
050,18,171,"Indiana","Warren County",3,41,114,57,57
050,18,171,"Indiana","Warren County",3,42,98,51,47
050,18,171,"Indiana","Warren County",3,43,96,48,48
050,18,171,"Indiana","Warren County",3,44,97,50,47
050,18,171,"Indiana","Warren County",3,45,83,45,38
050,18,171,"Indiana","Warren County",3,46,89,52,37
050,18,171,"Indiana","Warren County",3,47,93,49,44
050,18,171,"Indiana","Warren County",3,48,94,46,48
050,18,171,"Indiana","Warren County",3,49,121,54,67
050,18,171,"Indiana","Warren County",3,50,128,63,65
050,18,171,"Indiana","Warren County",3,51,124,68,56
050,18,171,"Indiana","Warren County",3,52,118,60,58
050,18,171,"Indiana","Warren County",3,53,110,58,52
050,18,171,"Indiana","Warren County",3,54,109,59,50
050,18,171,"Indiana","Warren County",3,55,119,64,55
050,18,171,"Indiana","Warren County",3,56,131,74,57
050,18,171,"Indiana","Warren County",3,57,131,69,62
050,18,171,"Indiana","Warren County",3,58,144,76,68
050,18,171,"Indiana","Warren County",3,59,139,75,64
050,18,171,"Indiana","Warren County",3,60,132,71,61
050,18,171,"Indiana","Warren County",3,61,118,68,50
050,18,171,"Indiana","Warren County",3,62,122,64,58
050,18,171,"Indiana","Warren County",3,63,127,70,57
050,18,171,"Indiana","Warren County",3,64,111,56,55
050,18,171,"Indiana","Warren County",3,65,119,57,62
050,18,171,"Indiana","Warren County",3,66,112,55,57
050,18,171,"Indiana","Warren County",3,67,114,58,56
050,18,171,"Indiana","Warren County",3,68,114,52,62
050,18,171,"Indiana","Warren County",3,69,101,50,51
050,18,171,"Indiana","Warren County",3,70,95,44,51
050,18,171,"Indiana","Warren County",3,71,92,47,45
050,18,171,"Indiana","Warren County",3,72,91,46,45
050,18,171,"Indiana","Warren County",3,73,86,47,39
050,18,171,"Indiana","Warren County",3,74,84,49,35
050,18,171,"Indiana","Warren County",3,75,64,32,32
050,18,171,"Indiana","Warren County",3,76,72,30,42
050,18,171,"Indiana","Warren County",3,77,64,23,41
050,18,171,"Indiana","Warren County",3,78,74,30,44
050,18,171,"Indiana","Warren County",3,79,62,29,33
050,18,171,"Indiana","Warren County",3,80,52,23,29
050,18,171,"Indiana","Warren County",3,81,49,22,27
050,18,171,"Indiana","Warren County",3,82,45,18,27
050,18,171,"Indiana","Warren County",3,83,49,19,30
050,18,171,"Indiana","Warren County",3,84,36,13,23
050,18,171,"Indiana","Warren County",3,85,180,71,109
050,18,171,"Indiana","Warren County",4,0,89,42,47
050,18,171,"Indiana","Warren County",4,1,65,41,24
050,18,171,"Indiana","Warren County",4,2,71,35,36
050,18,171,"Indiana","Warren County",4,3,84,37,47
050,18,171,"Indiana","Warren County",4,4,93,48,45
050,18,171,"Indiana","Warren County",4,5,96,47,49
050,18,171,"Indiana","Warren County",4,6,94,46,48
050,18,171,"Indiana","Warren County",4,7,112,56,56
050,18,171,"Indiana","Warren County",4,8,97,47,50
050,18,171,"Indiana","Warren County",4,9,100,49,51
050,18,171,"Indiana","Warren County",4,10,126,60,66
050,18,171,"Indiana","Warren County",4,11,109,57,52
050,18,171,"Indiana","Warren County",4,12,120,65,55
050,18,171,"Indiana","Warren County",4,13,116,62,54
050,18,171,"Indiana","Warren County",4,14,130,66,64
050,18,171,"Indiana","Warren County",4,15,119,58,61
050,18,171,"Indiana","Warren County",4,16,120,69,51
050,18,171,"Indiana","Warren County",4,17,117,58,59
050,18,171,"Indiana","Warren County",4,18,103,49,54
050,18,171,"Indiana","Warren County",4,19,70,41,29
050,18,171,"Indiana","Warren County",4,20,65,34,31
050,18,171,"Indiana","Warren County",4,21,86,45,41
050,18,171,"Indiana","Warren County",4,22,85,46,39
050,18,171,"Indiana","Warren County",4,23,84,45,39
050,18,171,"Indiana","Warren County",4,24,99,61,38
050,18,171,"Indiana","Warren County",4,25,94,49,45
050,18,171,"Indiana","Warren County",4,26,79,39,40
050,18,171,"Indiana","Warren County",4,27,80,36,44
050,18,171,"Indiana","Warren County",4,28,76,34,42
050,18,171,"Indiana","Warren County",4,29,99,41,58
050,18,171,"Indiana","Warren County",4,30,103,42,61
050,18,171,"Indiana","Warren County",4,31,105,49,56
050,18,171,"Indiana","Warren County",4,32,94,53,41
050,18,171,"Indiana","Warren County",4,33,108,57,51
050,18,171,"Indiana","Warren County",4,34,107,51,56
050,18,171,"Indiana","Warren County",4,35,91,45,46
050,18,171,"Indiana","Warren County",4,36,98,47,51
050,18,171,"Indiana","Warren County",4,37,94,48,46
050,18,171,"Indiana","Warren County",4,38,97,54,43
050,18,171,"Indiana","Warren County",4,39,94,46,48
050,18,171,"Indiana","Warren County",4,40,90,42,48
050,18,171,"Indiana","Warren County",4,41,108,48,60
050,18,171,"Indiana","Warren County",4,42,114,57,57
050,18,171,"Indiana","Warren County",4,43,97,51,46
050,18,171,"Indiana","Warren County",4,44,96,48,48
050,18,171,"Indiana","Warren County",4,45,94,47,47
050,18,171,"Indiana","Warren County",4,46,82,46,36
050,18,171,"Indiana","Warren County",4,47,93,52,41
050,18,171,"Indiana","Warren County",4,48,98,51,47
050,18,171,"Indiana","Warren County",4,49,92,44,48
050,18,171,"Indiana","Warren County",4,50,120,55,65
050,18,171,"Indiana","Warren County",4,51,130,65,65
050,18,171,"Indiana","Warren County",4,52,124,68,56
050,18,171,"Indiana","Warren County",4,53,119,60,59
050,18,171,"Indiana","Warren County",4,54,104,56,48
050,18,171,"Indiana","Warren County",4,55,115,62,53
050,18,171,"Indiana","Warren County",4,56,126,67,59
050,18,171,"Indiana","Warren County",4,57,127,73,54
050,18,171,"Indiana","Warren County",4,58,128,67,61
050,18,171,"Indiana","Warren County",4,59,140,75,65
050,18,171,"Indiana","Warren County",4,60,141,76,65
050,18,171,"Indiana","Warren County",4,61,136,75,61
050,18,171,"Indiana","Warren County",4,62,115,65,50
050,18,171,"Indiana","Warren County",4,63,118,63,55
050,18,171,"Indiana","Warren County",4,64,127,70,57
050,18,171,"Indiana","Warren County",4,65,113,60,53
050,18,171,"Indiana","Warren County",4,66,119,58,61
050,18,171,"Indiana","Warren County",4,67,108,53,55
050,18,171,"Indiana","Warren County",4,68,116,59,57
050,18,171,"Indiana","Warren County",4,69,120,53,67
050,18,171,"Indiana","Warren County",4,70,98,49,49
050,18,171,"Indiana","Warren County",4,71,90,41,49
050,18,171,"Indiana","Warren County",4,72,90,44,46
050,18,171,"Indiana","Warren County",4,73,87,43,44
050,18,171,"Indiana","Warren County",4,74,86,45,41
050,18,171,"Indiana","Warren County",4,75,83,48,35
050,18,171,"Indiana","Warren County",4,76,64,32,32
050,18,171,"Indiana","Warren County",4,77,64,28,36
050,18,171,"Indiana","Warren County",4,78,56,19,37
050,18,171,"Indiana","Warren County",4,79,71,28,43
050,18,171,"Indiana","Warren County",4,80,56,26,30
050,18,171,"Indiana","Warren County",4,81,47,22,25
050,18,171,"Indiana","Warren County",4,82,43,17,26
050,18,171,"Indiana","Warren County",4,83,42,15,27
050,18,171,"Indiana","Warren County",4,84,42,18,24
050,18,171,"Indiana","Warren County",4,85,190,73,117
050,18,171,"Indiana","Warren County",5,0,87,42,45
050,18,171,"Indiana","Warren County",5,1,91,43,48
050,18,171,"Indiana","Warren County",5,2,73,43,30
050,18,171,"Indiana","Warren County",5,3,79,39,40
050,18,171,"Indiana","Warren County",5,4,87,41,46
050,18,171,"Indiana","Warren County",5,5,91,44,47
050,18,171,"Indiana","Warren County",5,6,101,47,54
050,18,171,"Indiana","Warren County",5,7,95,44,51
050,18,171,"Indiana","Warren County",5,8,110,58,52
050,18,171,"Indiana","Warren County",5,9,100,52,48
050,18,171,"Indiana","Warren County",5,10,102,48,54
050,18,171,"Indiana","Warren County",5,11,128,61,67
050,18,171,"Indiana","Warren County",5,12,112,58,54
050,18,171,"Indiana","Warren County",5,13,125,68,57
050,18,171,"Indiana","Warren County",5,14,121,66,55
050,18,171,"Indiana","Warren County",5,15,121,60,61
050,18,171,"Indiana","Warren County",5,16,122,61,61
050,18,171,"Indiana","Warren County",5,17,128,75,53
050,18,171,"Indiana","Warren County",5,18,101,52,49
050,18,171,"Indiana","Warren County",5,19,80,40,40
050,18,171,"Indiana","Warren County",5,20,74,45,29
050,18,171,"Indiana","Warren County",5,21,71,37,34
050,18,171,"Indiana","Warren County",5,22,88,45,43
050,18,171,"Indiana","Warren County",5,23,82,49,33
050,18,171,"Indiana","Warren County",5,24,90,47,43
050,18,171,"Indiana","Warren County",5,25,97,61,36
050,18,171,"Indiana","Warren County",5,26,93,47,46
050,18,171,"Indiana","Warren County",5,27,80,45,35
050,18,171,"Indiana","Warren County",5,28,77,37,40
050,18,171,"Indiana","Warren County",5,29,78,35,43
050,18,171,"Indiana","Warren County",5,30,97,41,56
050,18,171,"Indiana","Warren County",5,31,102,41,61
050,18,171,"Indiana","Warren County",5,32,104,49,55
050,18,171,"Indiana","Warren County",5,33,105,59,46
050,18,171,"Indiana","Warren County",5,34,117,60,57
050,18,171,"Indiana","Warren County",5,35,109,52,57
050,18,171,"Indiana","Warren County",5,36,91,46,45
050,18,171,"Indiana","Warren County",5,37,96,44,52
050,18,171,"Indiana","Warren County",5,38,98,54,44
050,18,171,"Indiana","Warren County",5,39,98,52,46
050,18,171,"Indiana","Warren County",5,40,97,49,48
050,18,171,"Indiana","Warren County",5,41,92,43,49
050,18,171,"Indiana","Warren County",5,42,99,46,53
050,18,171,"Indiana","Warren County",5,43,116,58,58
050,18,171,"Indiana","Warren County",5,44,95,52,43
050,18,171,"Indiana","Warren County",5,45,92,44,48
050,18,171,"Indiana","Warren County",5,46,102,51,51
050,18,171,"Indiana","Warren County",5,47,79,43,36
050,18,171,"Indiana","Warren County",5,48,95,54,41
050,18,171,"Indiana","Warren County",5,49,98,48,50
050,18,171,"Indiana","Warren County",5,50,94,46,48
050,18,171,"Indiana","Warren County",5,51,113,56,57
050,18,171,"Indiana","Warren County",5,52,134,67,67
050,18,171,"Indiana","Warren County",5,53,123,65,58
050,18,171,"Indiana","Warren County",5,54,123,64,59
050,18,171,"Indiana","Warren County",5,55,104,54,50
050,18,171,"Indiana","Warren County",5,56,115,62,53
050,18,171,"Indiana","Warren County",5,57,122,66,56
050,18,171,"Indiana","Warren County",5,58,132,76,56
050,18,171,"Indiana","Warren County",5,59,124,66,58
050,18,171,"Indiana","Warren County",5,60,139,74,65
050,18,171,"Indiana","Warren County",5,61,141,76,65
050,18,171,"Indiana","Warren County",5,62,132,71,61
050,18,171,"Indiana","Warren County",5,63,113,64,49
050,18,171,"Indiana","Warren County",5,64,116,60,56
050,18,171,"Indiana","Warren County",5,65,125,67,58
050,18,171,"Indiana","Warren County",5,66,112,61,51
050,18,171,"Indiana","Warren County",5,67,113,55,58
050,18,171,"Indiana","Warren County",5,68,107,52,55
050,18,171,"Indiana","Warren County",5,69,115,56,59
050,18,171,"Indiana","Warren County",5,70,114,52,62
050,18,171,"Indiana","Warren County",5,71,93,47,46
050,18,171,"Indiana","Warren County",5,72,90,40,50
050,18,171,"Indiana","Warren County",5,73,85,42,43
050,18,171,"Indiana","Warren County",5,74,86,40,46
050,18,171,"Indiana","Warren County",5,75,84,45,39
050,18,171,"Indiana","Warren County",5,76,85,48,37
050,18,171,"Indiana","Warren County",5,77,56,30,26
050,18,171,"Indiana","Warren County",5,78,59,27,32
050,18,171,"Indiana","Warren County",5,79,55,18,37
050,18,171,"Indiana","Warren County",5,80,66,26,40
050,18,171,"Indiana","Warren County",5,81,52,25,27
050,18,171,"Indiana","Warren County",5,82,45,18,27
050,18,171,"Indiana","Warren County",5,83,38,13,25
050,18,171,"Indiana","Warren County",5,84,36,15,21
050,18,171,"Indiana","Warren County",5,85,211,80,131
050,18,173,"Indiana","Warrick County",1,0,602,307,295
050,18,173,"Indiana","Warrick County",1,1,626,303,323
050,18,173,"Indiana","Warrick County",1,2,661,338,323
050,18,173,"Indiana","Warrick County",1,3,701,363,338
050,18,173,"Indiana","Warrick County",1,4,807,395,412
050,18,173,"Indiana","Warrick County",1,5,802,405,397
050,18,173,"Indiana","Warrick County",1,6,756,367,389
050,18,173,"Indiana","Warrick County",1,7,797,404,393
050,18,173,"Indiana","Warrick County",1,8,818,421,397
050,18,173,"Indiana","Warrick County",1,9,859,429,430
050,18,173,"Indiana","Warrick County",1,10,903,482,421
050,18,173,"Indiana","Warrick County",1,11,980,515,465
050,18,173,"Indiana","Warrick County",1,12,979,492,487
050,18,173,"Indiana","Warrick County",1,13,978,495,483
050,18,173,"Indiana","Warrick County",1,14,926,470,456
050,18,173,"Indiana","Warrick County",1,15,955,488,467
050,18,173,"Indiana","Warrick County",1,16,979,499,480
050,18,173,"Indiana","Warrick County",1,17,927,477,450
050,18,173,"Indiana","Warrick County",1,18,796,418,378
050,18,173,"Indiana","Warrick County",1,19,631,337,294
050,18,173,"Indiana","Warrick County",1,20,622,341,281
050,18,173,"Indiana","Warrick County",1,21,644,350,294
050,18,173,"Indiana","Warrick County",1,22,677,359,318
050,18,173,"Indiana","Warrick County",1,23,655,342,313
050,18,173,"Indiana","Warrick County",1,24,674,338,336
050,18,173,"Indiana","Warrick County",1,25,684,327,357
050,18,173,"Indiana","Warrick County",1,26,704,373,331
050,18,173,"Indiana","Warrick County",1,27,729,350,379
050,18,173,"Indiana","Warrick County",1,28,731,343,388
050,18,173,"Indiana","Warrick County",1,29,727,363,364
050,18,173,"Indiana","Warrick County",1,30,739,392,347
050,18,173,"Indiana","Warrick County",1,31,691,329,362
050,18,173,"Indiana","Warrick County",1,32,707,339,368
050,18,173,"Indiana","Warrick County",1,33,730,360,370
050,18,173,"Indiana","Warrick County",1,34,750,338,412
050,18,173,"Indiana","Warrick County",1,35,773,352,421
050,18,173,"Indiana","Warrick County",1,36,827,415,412
050,18,173,"Indiana","Warrick County",1,37,848,420,428
050,18,173,"Indiana","Warrick County",1,38,865,427,438
050,18,173,"Indiana","Warrick County",1,39,869,429,440
050,18,173,"Indiana","Warrick County",1,40,889,451,438
050,18,173,"Indiana","Warrick County",1,41,875,452,423
050,18,173,"Indiana","Warrick County",1,42,831,435,396
050,18,173,"Indiana","Warrick County",1,43,818,413,405
050,18,173,"Indiana","Warrick County",1,44,825,410,415
050,18,173,"Indiana","Warrick County",1,45,793,394,399
050,18,173,"Indiana","Warrick County",1,46,792,407,385
050,18,173,"Indiana","Warrick County",1,47,825,412,413
050,18,173,"Indiana","Warrick County",1,48,902,477,425
050,18,173,"Indiana","Warrick County",1,49,939,495,444
050,18,173,"Indiana","Warrick County",1,50,864,451,413
050,18,173,"Indiana","Warrick County",1,51,824,410,414
050,18,173,"Indiana","Warrick County",1,52,764,390,374
050,18,173,"Indiana","Warrick County",1,53,766,384,382
050,18,173,"Indiana","Warrick County",1,54,805,384,421
050,18,173,"Indiana","Warrick County",1,55,896,437,459
050,18,173,"Indiana","Warrick County",1,56,880,436,444
050,18,173,"Indiana","Warrick County",1,57,854,438,416
050,18,173,"Indiana","Warrick County",1,58,903,450,453
050,18,173,"Indiana","Warrick County",1,59,938,453,485
050,18,173,"Indiana","Warrick County",1,60,931,475,456
050,18,173,"Indiana","Warrick County",1,61,893,437,456
050,18,173,"Indiana","Warrick County",1,62,897,441,456
050,18,173,"Indiana","Warrick County",1,63,853,435,418
050,18,173,"Indiana","Warrick County",1,64,809,374,435
050,18,173,"Indiana","Warrick County",1,65,758,361,397
050,18,173,"Indiana","Warrick County",1,66,761,353,408
050,18,173,"Indiana","Warrick County",1,67,749,363,386
050,18,173,"Indiana","Warrick County",1,68,740,377,363
050,18,173,"Indiana","Warrick County",1,69,678,331,347
050,18,173,"Indiana","Warrick County",1,70,691,318,373
050,18,173,"Indiana","Warrick County",1,71,678,319,359
050,18,173,"Indiana","Warrick County",1,72,627,300,327
050,18,173,"Indiana","Warrick County",1,73,658,326,332
050,18,173,"Indiana","Warrick County",1,74,465,197,268
050,18,173,"Indiana","Warrick County",1,75,433,200,233
050,18,173,"Indiana","Warrick County",1,76,422,202,220
050,18,173,"Indiana","Warrick County",1,77,444,214,230
050,18,173,"Indiana","Warrick County",1,78,386,174,212
050,18,173,"Indiana","Warrick County",1,79,337,155,182
050,18,173,"Indiana","Warrick County",1,80,294,129,165
050,18,173,"Indiana","Warrick County",1,81,272,115,157
050,18,173,"Indiana","Warrick County",1,82,264,115,149
050,18,173,"Indiana","Warrick County",1,83,205,77,128
050,18,173,"Indiana","Warrick County",1,84,202,85,117
050,18,173,"Indiana","Warrick County",1,85,1333,441,892
050,18,173,"Indiana","Warrick County",2,0,616,315,301
050,18,173,"Indiana","Warrick County",2,1,624,303,321
050,18,173,"Indiana","Warrick County",2,2,658,332,326
050,18,173,"Indiana","Warrick County",2,3,697,361,336
050,18,173,"Indiana","Warrick County",2,4,788,393,395
050,18,173,"Indiana","Warrick County",2,5,812,405,407
050,18,173,"Indiana","Warrick County",2,6,775,379,396
050,18,173,"Indiana","Warrick County",2,7,791,397,394
050,18,173,"Indiana","Warrick County",2,8,815,417,398
050,18,173,"Indiana","Warrick County",2,9,850,428,422
050,18,173,"Indiana","Warrick County",2,10,893,467,426
050,18,173,"Indiana","Warrick County",2,11,957,503,454
050,18,173,"Indiana","Warrick County",2,12,985,498,487
050,18,173,"Indiana","Warrick County",2,13,980,495,485
050,18,173,"Indiana","Warrick County",2,14,943,479,464
050,18,173,"Indiana","Warrick County",2,15,949,485,464
050,18,173,"Indiana","Warrick County",2,16,976,499,477
050,18,173,"Indiana","Warrick County",2,17,938,482,456
050,18,173,"Indiana","Warrick County",2,18,783,412,371
050,18,173,"Indiana","Warrick County",2,19,631,335,296
050,18,173,"Indiana","Warrick County",2,20,641,350,291
050,18,173,"Indiana","Warrick County",2,21,648,352,296
050,18,173,"Indiana","Warrick County",2,22,675,360,315
050,18,173,"Indiana","Warrick County",2,23,666,349,317
050,18,173,"Indiana","Warrick County",2,24,672,337,335
050,18,173,"Indiana","Warrick County",2,25,688,337,351
050,18,173,"Indiana","Warrick County",2,26,706,363,343
050,18,173,"Indiana","Warrick County",2,27,728,359,369
050,18,173,"Indiana","Warrick County",2,28,735,349,386
050,18,173,"Indiana","Warrick County",2,29,742,369,373
050,18,173,"Indiana","Warrick County",2,30,749,388,361
050,18,173,"Indiana","Warrick County",2,31,708,348,360
050,18,173,"Indiana","Warrick County",2,32,706,339,367
050,18,173,"Indiana","Warrick County",2,33,727,355,372
050,18,173,"Indiana","Warrick County",2,34,752,348,404
050,18,173,"Indiana","Warrick County",2,35,784,358,426
050,18,173,"Indiana","Warrick County",2,36,812,401,411
050,18,173,"Indiana","Warrick County",2,37,846,420,426
050,18,173,"Indiana","Warrick County",2,38,866,426,440
050,18,173,"Indiana","Warrick County",2,39,867,426,441
050,18,173,"Indiana","Warrick County",2,40,886,448,438
050,18,173,"Indiana","Warrick County",2,41,879,453,426
050,18,173,"Indiana","Warrick County",2,42,841,439,402
050,18,173,"Indiana","Warrick County",2,43,832,425,407
050,18,173,"Indiana","Warrick County",2,44,816,408,408
050,18,173,"Indiana","Warrick County",2,45,804,402,402
050,18,173,"Indiana","Warrick County",2,46,792,403,389
050,18,173,"Indiana","Warrick County",2,47,817,411,406
050,18,173,"Indiana","Warrick County",2,48,881,457,424
050,18,173,"Indiana","Warrick County",2,49,938,496,442
050,18,173,"Indiana","Warrick County",2,50,881,459,422
050,18,173,"Indiana","Warrick County",2,51,831,420,411
050,18,173,"Indiana","Warrick County",2,52,780,396,384
050,18,173,"Indiana","Warrick County",2,53,766,386,380
050,18,173,"Indiana","Warrick County",2,54,788,381,407
050,18,173,"Indiana","Warrick County",2,55,874,424,450
050,18,173,"Indiana","Warrick County",2,56,885,438,447
050,18,173,"Indiana","Warrick County",2,57,858,439,419
050,18,173,"Indiana","Warrick County",2,58,888,446,442
050,18,173,"Indiana","Warrick County",2,59,933,455,478
050,18,173,"Indiana","Warrick County",2,60,926,465,461
050,18,173,"Indiana","Warrick County",2,61,901,446,455
050,18,173,"Indiana","Warrick County",2,62,891,439,452
050,18,173,"Indiana","Warrick County",2,63,871,441,430
050,18,173,"Indiana","Warrick County",2,64,814,386,428
050,18,173,"Indiana","Warrick County",2,65,765,362,403
050,18,173,"Indiana","Warrick County",2,66,760,353,407
050,18,173,"Indiana","Warrick County",2,67,743,357,386
050,18,173,"Indiana","Warrick County",2,68,737,370,367
050,18,173,"Indiana","Warrick County",2,69,693,342,351
050,18,173,"Indiana","Warrick County",2,70,682,317,365
050,18,173,"Indiana","Warrick County",2,71,682,318,364
050,18,173,"Indiana","Warrick County",2,72,625,301,324
050,18,173,"Indiana","Warrick County",2,73,684,336,348
050,18,173,"Indiana","Warrick County",2,74,474,208,266
050,18,173,"Indiana","Warrick County",2,75,436,198,238
050,18,173,"Indiana","Warrick County",2,76,416,197,219
050,18,173,"Indiana","Warrick County",2,77,444,215,229
050,18,173,"Indiana","Warrick County",2,78,383,173,210
050,18,173,"Indiana","Warrick County",2,79,342,156,186
050,18,173,"Indiana","Warrick County",2,80,301,132,169
050,18,173,"Indiana","Warrick County",2,81,271,115,156
050,18,173,"Indiana","Warrick County",2,82,266,116,150
050,18,173,"Indiana","Warrick County",2,83,209,79,130
050,18,173,"Indiana","Warrick County",2,84,198,84,114
050,18,173,"Indiana","Warrick County",2,85,1333,444,889
050,18,173,"Indiana","Warrick County",3,0,636,334,302
050,18,173,"Indiana","Warrick County",3,1,659,334,325
050,18,173,"Indiana","Warrick County",3,2,657,337,320
050,18,173,"Indiana","Warrick County",3,3,698,351,347
050,18,173,"Indiana","Warrick County",3,4,714,356,358
050,18,173,"Indiana","Warrick County",3,5,818,398,420
050,18,173,"Indiana","Warrick County",3,6,837,429,408
050,18,173,"Indiana","Warrick County",3,7,792,397,395
050,18,173,"Indiana","Warrick County",3,8,803,400,403
050,18,173,"Indiana","Warrick County",3,9,837,435,402
050,18,173,"Indiana","Warrick County",3,10,857,438,419
050,18,173,"Indiana","Warrick County",3,11,899,467,432
050,18,173,"Indiana","Warrick County",3,12,987,523,464
050,18,173,"Indiana","Warrick County",3,13,998,503,495
050,18,173,"Indiana","Warrick County",3,14,1016,506,510
050,18,173,"Indiana","Warrick County",3,15,939,476,463
050,18,173,"Indiana","Warrick County",3,16,956,488,468
050,18,173,"Indiana","Warrick County",3,17,999,509,490
050,18,173,"Indiana","Warrick County",3,18,802,421,381
050,18,173,"Indiana","Warrick County",3,19,608,323,285
050,18,173,"Indiana","Warrick County",3,20,662,353,309
050,18,173,"Indiana","Warrick County",3,21,666,358,308
050,18,173,"Indiana","Warrick County",3,22,684,371,313
050,18,173,"Indiana","Warrick County",3,23,671,356,315
050,18,173,"Indiana","Warrick County",3,24,672,355,317
050,18,173,"Indiana","Warrick County",3,25,681,350,331
050,18,173,"Indiana","Warrick County",3,26,711,339,372
050,18,173,"Indiana","Warrick County",3,27,708,361,347
050,18,173,"Indiana","Warrick County",3,28,741,362,379
050,18,173,"Indiana","Warrick County",3,29,749,361,388
050,18,173,"Indiana","Warrick County",3,30,764,366,398
050,18,173,"Indiana","Warrick County",3,31,804,414,390
050,18,173,"Indiana","Warrick County",3,32,752,366,386
050,18,173,"Indiana","Warrick County",3,33,743,364,379
050,18,173,"Indiana","Warrick County",3,34,761,378,383
050,18,173,"Indiana","Warrick County",3,35,791,360,431
050,18,173,"Indiana","Warrick County",3,36,807,376,431
050,18,173,"Indiana","Warrick County",3,37,808,393,415
050,18,173,"Indiana","Warrick County",3,38,863,428,435
050,18,173,"Indiana","Warrick County",3,39,871,426,445
050,18,173,"Indiana","Warrick County",3,40,880,444,436
050,18,173,"Indiana","Warrick County",3,41,890,459,431
050,18,173,"Indiana","Warrick County",3,42,888,462,426
050,18,173,"Indiana","Warrick County",3,43,863,444,419
050,18,173,"Indiana","Warrick County",3,44,844,429,415
050,18,173,"Indiana","Warrick County",3,45,825,412,413
050,18,173,"Indiana","Warrick County",3,46,802,400,402
050,18,173,"Indiana","Warrick County",3,47,803,414,389
050,18,173,"Indiana","Warrick County",3,48,828,423,405
050,18,173,"Indiana","Warrick County",3,49,883,456,427
050,18,173,"Indiana","Warrick County",3,50,949,498,451
050,18,173,"Indiana","Warrick County",3,51,862,444,418
050,18,173,"Indiana","Warrick County",3,52,849,434,415
050,18,173,"Indiana","Warrick County",3,53,783,392,391
050,18,173,"Indiana","Warrick County",3,54,754,371,383
050,18,173,"Indiana","Warrick County",3,55,802,386,416
050,18,173,"Indiana","Warrick County",3,56,889,425,464
050,18,173,"Indiana","Warrick County",3,57,906,460,446
050,18,173,"Indiana","Warrick County",3,58,842,426,416
050,18,173,"Indiana","Warrick County",3,59,880,441,439
050,18,173,"Indiana","Warrick County",3,60,940,459,481
050,18,173,"Indiana","Warrick County",3,61,913,457,456
050,18,173,"Indiana","Warrick County",3,62,884,439,445
050,18,173,"Indiana","Warrick County",3,63,862,419,443
050,18,173,"Indiana","Warrick County",3,64,874,440,434
050,18,173,"Indiana","Warrick County",3,65,795,379,416
050,18,173,"Indiana","Warrick County",3,66,748,351,397
050,18,173,"Indiana","Warrick County",3,67,755,352,403
050,18,173,"Indiana","Warrick County",3,68,736,347,389
050,18,173,"Indiana","Warrick County",3,69,720,353,367
050,18,173,"Indiana","Warrick County",3,70,686,343,343
050,18,173,"Indiana","Warrick County",3,71,673,304,369
050,18,173,"Indiana","Warrick County",3,72,659,314,345
050,18,173,"Indiana","Warrick County",3,73,622,303,319
050,18,173,"Indiana","Warrick County",3,74,657,316,341
050,18,173,"Indiana","Warrick County",3,75,439,198,241
050,18,173,"Indiana","Warrick County",3,76,422,184,238
050,18,173,"Indiana","Warrick County",3,77,408,192,216
050,18,173,"Indiana","Warrick County",3,78,428,202,226
050,18,173,"Indiana","Warrick County",3,79,356,165,191
050,18,173,"Indiana","Warrick County",3,80,320,143,177
050,18,173,"Indiana","Warrick County",3,81,291,117,174
050,18,173,"Indiana","Warrick County",3,82,270,116,154
050,18,173,"Indiana","Warrick County",3,83,233,95,138
050,18,173,"Indiana","Warrick County",3,84,205,85,120
050,18,173,"Indiana","Warrick County",3,85,1318,435,883
050,18,173,"Indiana","Warrick County",4,0,587,315,272
050,18,173,"Indiana","Warrick County",4,1,686,374,312
050,18,173,"Indiana","Warrick County",4,2,661,340,321
050,18,173,"Indiana","Warrick County",4,3,700,352,348
050,18,173,"Indiana","Warrick County",4,4,755,364,391
050,18,173,"Indiana","Warrick County",4,5,735,374,361
050,18,173,"Indiana","Warrick County",4,6,851,416,435
050,18,173,"Indiana","Warrick County",4,7,846,433,413
050,18,173,"Indiana","Warrick County",4,8,818,417,401
050,18,173,"Indiana","Warrick County",4,9,819,403,416
050,18,173,"Indiana","Warrick County",4,10,858,442,416
050,18,173,"Indiana","Warrick County",4,11,862,436,426
050,18,173,"Indiana","Warrick County",4,12,910,472,438
050,18,173,"Indiana","Warrick County",4,13,988,528,460
050,18,173,"Indiana","Warrick County",4,14,997,499,498
050,18,173,"Indiana","Warrick County",4,15,1006,497,509
050,18,173,"Indiana","Warrick County",4,16,962,502,460
050,18,173,"Indiana","Warrick County",4,17,948,486,462
050,18,173,"Indiana","Warrick County",4,18,839,448,391
050,18,173,"Indiana","Warrick County",4,19,582,302,280
050,18,173,"Indiana","Warrick County",4,20,650,347,303
050,18,173,"Indiana","Warrick County",4,21,703,372,331
050,18,173,"Indiana","Warrick County",4,22,699,361,338
050,18,173,"Indiana","Warrick County",4,23,680,386,294
050,18,173,"Indiana","Warrick County",4,24,675,341,334
050,18,173,"Indiana","Warrick County",4,25,696,367,329
050,18,173,"Indiana","Warrick County",4,26,704,349,355
050,18,173,"Indiana","Warrick County",4,27,732,360,372
050,18,173,"Indiana","Warrick County",4,28,733,366,367
050,18,173,"Indiana","Warrick County",4,29,747,357,390
050,18,173,"Indiana","Warrick County",4,30,769,362,407
050,18,173,"Indiana","Warrick County",4,31,788,366,422
050,18,173,"Indiana","Warrick County",4,32,827,433,394
050,18,173,"Indiana","Warrick County",4,33,787,387,400
050,18,173,"Indiana","Warrick County",4,34,787,379,408
050,18,173,"Indiana","Warrick County",4,35,803,388,415
050,18,173,"Indiana","Warrick County",4,36,824,378,446
050,18,173,"Indiana","Warrick County",4,37,813,376,437
050,18,173,"Indiana","Warrick County",4,38,828,407,421
050,18,173,"Indiana","Warrick County",4,39,892,436,456
050,18,173,"Indiana","Warrick County",4,40,908,455,453
050,18,173,"Indiana","Warrick County",4,41,910,461,449
050,18,173,"Indiana","Warrick County",4,42,898,472,426
050,18,173,"Indiana","Warrick County",4,43,886,461,425
050,18,173,"Indiana","Warrick County",4,44,874,448,426
050,18,173,"Indiana","Warrick County",4,45,848,431,417
050,18,173,"Indiana","Warrick County",4,46,826,416,410
050,18,173,"Indiana","Warrick County",4,47,799,398,401
050,18,173,"Indiana","Warrick County",4,48,809,412,397
050,18,173,"Indiana","Warrick County",4,49,827,425,402
050,18,173,"Indiana","Warrick County",4,50,874,438,436
050,18,173,"Indiana","Warrick County",4,51,949,505,444
050,18,173,"Indiana","Warrick County",4,52,855,427,428
050,18,173,"Indiana","Warrick County",4,53,860,438,422
050,18,173,"Indiana","Warrick County",4,54,779,383,396
050,18,173,"Indiana","Warrick County",4,55,763,386,377
050,18,173,"Indiana","Warrick County",4,56,810,388,422
050,18,173,"Indiana","Warrick County",4,57,891,425,466
050,18,173,"Indiana","Warrick County",4,58,906,468,438
050,18,173,"Indiana","Warrick County",4,59,830,421,409
050,18,173,"Indiana","Warrick County",4,60,870,434,436
050,18,173,"Indiana","Warrick County",4,61,922,445,477
050,18,173,"Indiana","Warrick County",4,62,893,443,450
050,18,173,"Indiana","Warrick County",4,63,864,424,440
050,18,173,"Indiana","Warrick County",4,64,851,415,436
050,18,173,"Indiana","Warrick County",4,65,873,436,437
050,18,173,"Indiana","Warrick County",4,66,768,366,402
050,18,173,"Indiana","Warrick County",4,67,751,351,400
050,18,173,"Indiana","Warrick County",4,68,747,349,398
050,18,173,"Indiana","Warrick County",4,69,708,329,379
050,18,173,"Indiana","Warrick County",4,70,704,335,369
050,18,173,"Indiana","Warrick County",4,71,671,331,340
050,18,173,"Indiana","Warrick County",4,72,652,299,353
050,18,173,"Indiana","Warrick County",4,73,649,314,335
050,18,173,"Indiana","Warrick County",4,74,601,287,314
050,18,173,"Indiana","Warrick County",4,75,628,303,325
050,18,173,"Indiana","Warrick County",4,76,433,191,242
050,18,173,"Indiana","Warrick County",4,77,421,184,237
050,18,173,"Indiana","Warrick County",4,78,406,192,214
050,18,173,"Indiana","Warrick County",4,79,411,199,212
050,18,173,"Indiana","Warrick County",4,80,336,152,184
050,18,173,"Indiana","Warrick County",4,81,316,132,184
050,18,173,"Indiana","Warrick County",4,82,292,119,173
050,18,173,"Indiana","Warrick County",4,83,231,95,136
050,18,173,"Indiana","Warrick County",4,84,229,97,132
050,18,173,"Indiana","Warrick County",4,85,1355,441,914
050,18,173,"Indiana","Warrick County",5,0,580,313,267
050,18,173,"Indiana","Warrick County",5,1,637,321,316
050,18,173,"Indiana","Warrick County",5,2,727,407,320
050,18,173,"Indiana","Warrick County",5,3,709,363,346
050,18,173,"Indiana","Warrick County",5,4,706,356,350
050,18,173,"Indiana","Warrick County",5,5,755,366,389
050,18,173,"Indiana","Warrick County",5,6,764,394,370
050,18,173,"Indiana","Warrick County",5,7,844,408,436
050,18,173,"Indiana","Warrick County",5,8,899,475,424
050,18,173,"Indiana","Warrick County",5,9,806,409,397
050,18,173,"Indiana","Warrick County",5,10,825,410,415
050,18,173,"Indiana","Warrick County",5,11,877,446,431
050,18,173,"Indiana","Warrick County",5,12,890,450,440
050,18,173,"Indiana","Warrick County",5,13,927,489,438
050,18,173,"Indiana","Warrick County",5,14,1026,535,491
050,18,173,"Indiana","Warrick County",5,15,1013,510,503
050,18,173,"Indiana","Warrick County",5,16,1037,511,526
050,18,173,"Indiana","Warrick County",5,17,947,482,465
050,18,173,"Indiana","Warrick County",5,18,770,402,368
050,18,173,"Indiana","Warrick County",5,19,639,343,296
050,18,173,"Indiana","Warrick County",5,20,631,331,300
050,18,173,"Indiana","Warrick County",5,21,679,351,328
050,18,173,"Indiana","Warrick County",5,22,755,374,381
050,18,173,"Indiana","Warrick County",5,23,718,376,342
050,18,173,"Indiana","Warrick County",5,24,679,370,309
050,18,173,"Indiana","Warrick County",5,25,666,349,317
050,18,173,"Indiana","Warrick County",5,26,712,366,346
050,18,173,"Indiana","Warrick County",5,27,709,347,362
050,18,173,"Indiana","Warrick County",5,28,729,362,367
050,18,173,"Indiana","Warrick County",5,29,749,373,376
050,18,173,"Indiana","Warrick County",5,30,754,377,377
050,18,173,"Indiana","Warrick County",5,31,817,386,431
050,18,173,"Indiana","Warrick County",5,32,838,389,449
050,18,173,"Indiana","Warrick County",5,33,859,443,416
050,18,173,"Indiana","Warrick County",5,34,834,401,433
050,18,173,"Indiana","Warrick County",5,35,822,408,414
050,18,173,"Indiana","Warrick County",5,36,822,409,413
050,18,173,"Indiana","Warrick County",5,37,846,403,443
050,18,173,"Indiana","Warrick County",5,38,835,390,445
050,18,173,"Indiana","Warrick County",5,39,838,406,432
050,18,173,"Indiana","Warrick County",5,40,896,437,459
050,18,173,"Indiana","Warrick County",5,41,925,470,455
050,18,173,"Indiana","Warrick County",5,42,937,480,457
050,18,173,"Indiana","Warrick County",5,43,880,453,427
050,18,173,"Indiana","Warrick County",5,44,917,471,446
050,18,173,"Indiana","Warrick County",5,45,886,443,443
050,18,173,"Indiana","Warrick County",5,46,831,420,411
050,18,173,"Indiana","Warrick County",5,47,822,410,412
050,18,173,"Indiana","Warrick County",5,48,798,390,408
050,18,173,"Indiana","Warrick County",5,49,812,414,398
050,18,173,"Indiana","Warrick County",5,50,828,431,397
050,18,173,"Indiana","Warrick County",5,51,863,434,429
050,18,173,"Indiana","Warrick County",5,52,955,497,458
050,18,173,"Indiana","Warrick County",5,53,862,432,430
050,18,173,"Indiana","Warrick County",5,54,852,427,425
050,18,173,"Indiana","Warrick County",5,55,764,386,378
050,18,173,"Indiana","Warrick County",5,56,777,395,382
050,18,173,"Indiana","Warrick County",5,57,790,371,419
050,18,173,"Indiana","Warrick County",5,58,892,428,464
050,18,173,"Indiana","Warrick County",5,59,902,466,436
050,18,173,"Indiana","Warrick County",5,60,834,427,407
050,18,173,"Indiana","Warrick County",5,61,869,428,441
050,18,173,"Indiana","Warrick County",5,62,895,428,467
050,18,173,"Indiana","Warrick County",5,63,897,445,452
050,18,173,"Indiana","Warrick County",5,64,878,430,448
050,18,173,"Indiana","Warrick County",5,65,840,408,432
050,18,173,"Indiana","Warrick County",5,66,861,427,434
050,18,173,"Indiana","Warrick County",5,67,773,372,401
050,18,173,"Indiana","Warrick County",5,68,746,342,404
050,18,173,"Indiana","Warrick County",5,69,732,341,391
050,18,173,"Indiana","Warrick County",5,70,701,322,379
050,18,173,"Indiana","Warrick County",5,71,689,329,360
050,18,173,"Indiana","Warrick County",5,72,659,324,335
050,18,173,"Indiana","Warrick County",5,73,657,303,354
050,18,173,"Indiana","Warrick County",5,74,633,296,337
050,18,173,"Indiana","Warrick County",5,75,574,278,296
050,18,173,"Indiana","Warrick County",5,76,604,287,317
050,18,173,"Indiana","Warrick County",5,77,427,192,235
050,18,173,"Indiana","Warrick County",5,78,414,183,231
050,18,173,"Indiana","Warrick County",5,79,398,185,213
050,18,173,"Indiana","Warrick County",5,80,391,182,209
050,18,173,"Indiana","Warrick County",5,81,329,145,184
050,18,173,"Indiana","Warrick County",5,82,310,132,178
050,18,173,"Indiana","Warrick County",5,83,260,99,161
050,18,173,"Indiana","Warrick County",5,84,229,101,128
050,18,173,"Indiana","Warrick County",5,85,1408,472,936
050,18,175,"Indiana","Washington County",1,0,298,154,144
050,18,175,"Indiana","Washington County",1,1,298,162,136
050,18,175,"Indiana","Washington County",1,2,320,163,157
050,18,175,"Indiana","Washington County",1,3,336,167,169
050,18,175,"Indiana","Washington County",1,4,335,162,173
050,18,175,"Indiana","Washington County",1,5,353,177,176
050,18,175,"Indiana","Washington County",1,6,376,174,202
050,18,175,"Indiana","Washington County",1,7,355,170,185
050,18,175,"Indiana","Washington County",1,8,341,184,157
050,18,175,"Indiana","Washington County",1,9,354,185,169
050,18,175,"Indiana","Washington County",1,10,362,183,179
050,18,175,"Indiana","Washington County",1,11,365,183,182
050,18,175,"Indiana","Washington County",1,12,365,173,192
050,18,175,"Indiana","Washington County",1,13,373,194,179
050,18,175,"Indiana","Washington County",1,14,397,213,184
050,18,175,"Indiana","Washington County",1,15,401,200,201
050,18,175,"Indiana","Washington County",1,16,405,197,208
050,18,175,"Indiana","Washington County",1,17,414,215,199
050,18,175,"Indiana","Washington County",1,18,352,197,155
050,18,175,"Indiana","Washington County",1,19,259,137,122
050,18,175,"Indiana","Washington County",1,20,279,150,129
050,18,175,"Indiana","Washington County",1,21,283,151,132
050,18,175,"Indiana","Washington County",1,22,300,165,135
050,18,175,"Indiana","Washington County",1,23,311,150,161
050,18,175,"Indiana","Washington County",1,24,332,181,151
050,18,175,"Indiana","Washington County",1,25,349,159,190
050,18,175,"Indiana","Washington County",1,26,327,165,162
050,18,175,"Indiana","Washington County",1,27,330,171,159
050,18,175,"Indiana","Washington County",1,28,350,172,178
050,18,175,"Indiana","Washington County",1,29,376,203,173
050,18,175,"Indiana","Washington County",1,30,365,198,167
050,18,175,"Indiana","Washington County",1,31,329,169,160
050,18,175,"Indiana","Washington County",1,32,332,162,170
050,18,175,"Indiana","Washington County",1,33,330,158,172
050,18,175,"Indiana","Washington County",1,34,301,155,146
050,18,175,"Indiana","Washington County",1,35,315,158,157
050,18,175,"Indiana","Washington County",1,36,319,163,156
050,18,175,"Indiana","Washington County",1,37,321,174,147
050,18,175,"Indiana","Washington County",1,38,337,169,168
050,18,175,"Indiana","Washington County",1,39,346,174,172
050,18,175,"Indiana","Washington County",1,40,355,165,190
050,18,175,"Indiana","Washington County",1,41,372,196,176
050,18,175,"Indiana","Washington County",1,42,352,180,172
050,18,175,"Indiana","Washington County",1,43,361,187,174
050,18,175,"Indiana","Washington County",1,44,336,176,160
050,18,175,"Indiana","Washington County",1,45,332,177,155
050,18,175,"Indiana","Washington County",1,46,341,178,163
050,18,175,"Indiana","Washington County",1,47,356,182,174
050,18,175,"Indiana","Washington County",1,48,390,201,189
050,18,175,"Indiana","Washington County",1,49,397,211,186
050,18,175,"Indiana","Washington County",1,50,365,190,175
050,18,175,"Indiana","Washington County",1,51,358,180,178
050,18,175,"Indiana","Washington County",1,52,375,193,182
050,18,175,"Indiana","Washington County",1,53,391,198,193
050,18,175,"Indiana","Washington County",1,54,422,231,191
050,18,175,"Indiana","Washington County",1,55,425,213,212
050,18,175,"Indiana","Washington County",1,56,436,217,219
050,18,175,"Indiana","Washington County",1,57,419,200,219
050,18,175,"Indiana","Washington County",1,58,437,215,222
050,18,175,"Indiana","Washington County",1,59,435,211,224
050,18,175,"Indiana","Washington County",1,60,416,210,206
050,18,175,"Indiana","Washington County",1,61,411,205,206
050,18,175,"Indiana","Washington County",1,62,407,197,210
050,18,175,"Indiana","Washington County",1,63,402,198,204
050,18,175,"Indiana","Washington County",1,64,388,200,188
050,18,175,"Indiana","Washington County",1,65,371,186,185
050,18,175,"Indiana","Washington County",1,66,346,188,158
050,18,175,"Indiana","Washington County",1,67,336,172,164
050,18,175,"Indiana","Washington County",1,68,336,164,172
050,18,175,"Indiana","Washington County",1,69,301,141,160
050,18,175,"Indiana","Washington County",1,70,293,135,158
050,18,175,"Indiana","Washington County",1,71,295,129,166
050,18,175,"Indiana","Washington County",1,72,287,131,156
050,18,175,"Indiana","Washington County",1,73,295,139,156
050,18,175,"Indiana","Washington County",1,74,184,78,106
050,18,175,"Indiana","Washington County",1,75,188,94,94
050,18,175,"Indiana","Washington County",1,76,200,99,101
050,18,175,"Indiana","Washington County",1,77,171,85,86
050,18,175,"Indiana","Washington County",1,78,159,71,88
050,18,175,"Indiana","Washington County",1,79,145,66,79
050,18,175,"Indiana","Washington County",1,80,138,62,76
050,18,175,"Indiana","Washington County",1,81,117,56,61
050,18,175,"Indiana","Washington County",1,82,113,52,61
050,18,175,"Indiana","Washington County",1,83,90,41,49
050,18,175,"Indiana","Washington County",1,84,84,42,42
050,18,175,"Indiana","Washington County",1,85,449,160,289
050,18,175,"Indiana","Washington County",2,0,304,155,149
050,18,175,"Indiana","Washington County",2,1,296,158,138
050,18,175,"Indiana","Washington County",2,2,318,163,155
050,18,175,"Indiana","Washington County",2,3,331,166,165
050,18,175,"Indiana","Washington County",2,4,340,165,175
050,18,175,"Indiana","Washington County",2,5,351,176,175
050,18,175,"Indiana","Washington County",2,6,375,176,199
050,18,175,"Indiana","Washington County",2,7,359,172,187
050,18,175,"Indiana","Washington County",2,8,344,181,163
050,18,175,"Indiana","Washington County",2,9,352,186,166
050,18,175,"Indiana","Washington County",2,10,365,186,179
050,18,175,"Indiana","Washington County",2,11,365,183,182
050,18,175,"Indiana","Washington County",2,12,363,174,189
050,18,175,"Indiana","Washington County",2,13,371,189,182
050,18,175,"Indiana","Washington County",2,14,390,207,183
050,18,175,"Indiana","Washington County",2,15,398,202,196
050,18,175,"Indiana","Washington County",2,16,403,198,205
050,18,175,"Indiana","Washington County",2,17,411,212,199
050,18,175,"Indiana","Washington County",2,18,350,194,156
050,18,175,"Indiana","Washington County",2,19,268,145,123
050,18,175,"Indiana","Washington County",2,20,282,151,131
050,18,175,"Indiana","Washington County",2,21,288,156,132
050,18,175,"Indiana","Washington County",2,22,302,164,138
050,18,175,"Indiana","Washington County",2,23,311,155,156
050,18,175,"Indiana","Washington County",2,24,326,173,153
050,18,175,"Indiana","Washington County",2,25,350,166,184
050,18,175,"Indiana","Washington County",2,26,338,167,171
050,18,175,"Indiana","Washington County",2,27,332,171,161
050,18,175,"Indiana","Washington County",2,28,348,173,175
050,18,175,"Indiana","Washington County",2,29,372,197,175
050,18,175,"Indiana","Washington County",2,30,373,200,173
050,18,175,"Indiana","Washington County",2,31,337,175,162
050,18,175,"Indiana","Washington County",2,32,333,165,168
050,18,175,"Indiana","Washington County",2,33,331,160,171
050,18,175,"Indiana","Washington County",2,34,311,157,154
050,18,175,"Indiana","Washington County",2,35,316,160,156
050,18,175,"Indiana","Washington County",2,36,318,161,157
050,18,175,"Indiana","Washington County",2,37,322,172,150
050,18,175,"Indiana","Washington County",2,38,337,171,166
050,18,175,"Indiana","Washington County",2,39,346,172,174
050,18,175,"Indiana","Washington County",2,40,357,170,187
050,18,175,"Indiana","Washington County",2,41,365,187,178
050,18,175,"Indiana","Washington County",2,42,354,181,173
050,18,175,"Indiana","Washington County",2,43,363,188,175
050,18,175,"Indiana","Washington County",2,44,338,176,162
050,18,175,"Indiana","Washington County",2,45,332,177,155
050,18,175,"Indiana","Washington County",2,46,335,176,159
050,18,175,"Indiana","Washington County",2,47,348,179,169
050,18,175,"Indiana","Washington County",2,48,379,194,185
050,18,175,"Indiana","Washington County",2,49,399,210,189
050,18,175,"Indiana","Washington County",2,50,376,198,178
050,18,175,"Indiana","Washington County",2,51,358,183,175
050,18,175,"Indiana","Washington County",2,52,369,190,179
050,18,175,"Indiana","Washington County",2,53,386,197,189
050,18,175,"Indiana","Washington County",2,54,414,222,192
050,18,175,"Indiana","Washington County",2,55,425,217,208
050,18,175,"Indiana","Washington County",2,56,435,216,219
050,18,175,"Indiana","Washington County",2,57,423,204,219
050,18,175,"Indiana","Washington County",2,58,433,210,223
050,18,175,"Indiana","Washington County",2,59,443,216,227
050,18,175,"Indiana","Washington County",2,60,422,213,209
050,18,175,"Indiana","Washington County",2,61,412,207,205
050,18,175,"Indiana","Washington County",2,62,404,195,209
050,18,175,"Indiana","Washington County",2,63,405,199,206
050,18,175,"Indiana","Washington County",2,64,385,198,187
050,18,175,"Indiana","Washington County",2,65,375,190,185
050,18,175,"Indiana","Washington County",2,66,353,188,165
050,18,175,"Indiana","Washington County",2,67,338,175,163
050,18,175,"Indiana","Washington County",2,68,334,166,168
050,18,175,"Indiana","Washington County",2,69,310,146,164
050,18,175,"Indiana","Washington County",2,70,294,136,158
050,18,175,"Indiana","Washington County",2,71,295,130,165
050,18,175,"Indiana","Washington County",2,72,285,129,156
050,18,175,"Indiana","Washington County",2,73,305,142,163
050,18,175,"Indiana","Washington County",2,74,197,87,110
050,18,175,"Indiana","Washington County",2,75,185,88,97
050,18,175,"Indiana","Washington County",2,76,194,94,100
050,18,175,"Indiana","Washington County",2,77,182,91,91
050,18,175,"Indiana","Washington County",2,78,155,69,86
050,18,175,"Indiana","Washington County",2,79,145,65,80
050,18,175,"Indiana","Washington County",2,80,138,61,77
050,18,175,"Indiana","Washington County",2,81,122,57,65
050,18,175,"Indiana","Washington County",2,82,112,51,61
050,18,175,"Indiana","Washington County",2,83,95,44,51
050,18,175,"Indiana","Washington County",2,84,83,41,42
050,18,175,"Indiana","Washington County",2,85,454,167,287
050,18,175,"Indiana","Washington County",3,0,322,169,153
050,18,175,"Indiana","Washington County",3,1,309,156,153
050,18,175,"Indiana","Washington County",3,2,309,170,139
050,18,175,"Indiana","Washington County",3,3,325,166,159
050,18,175,"Indiana","Washington County",3,4,337,174,163
050,18,175,"Indiana","Washington County",3,5,342,161,181
050,18,175,"Indiana","Washington County",3,6,346,175,171
050,18,175,"Indiana","Washington County",3,7,374,170,204
050,18,175,"Indiana","Washington County",3,8,365,173,192
050,18,175,"Indiana","Washington County",3,9,348,184,164
050,18,175,"Indiana","Washington County",3,10,342,177,165
050,18,175,"Indiana","Washington County",3,11,363,182,181
050,18,175,"Indiana","Washington County",3,12,354,176,178
050,18,175,"Indiana","Washington County",3,13,357,177,180
050,18,175,"Indiana","Washington County",3,14,376,190,186
050,18,175,"Indiana","Washington County",3,15,398,211,187
050,18,175,"Indiana","Washington County",3,16,389,196,193
050,18,175,"Indiana","Washington County",3,17,397,198,199
050,18,175,"Indiana","Washington County",3,18,351,190,161
050,18,175,"Indiana","Washington County",3,19,277,157,120
050,18,175,"Indiana","Washington County",3,20,274,147,127
050,18,175,"Indiana","Washington County",3,21,286,155,131
050,18,175,"Indiana","Washington County",3,22,300,157,143
050,18,175,"Indiana","Washington County",3,23,314,167,147
050,18,175,"Indiana","Washington County",3,24,325,164,161
050,18,175,"Indiana","Washington County",3,25,335,182,153
050,18,175,"Indiana","Washington County",3,26,348,172,176
050,18,175,"Indiana","Washington County",3,27,335,162,173
050,18,175,"Indiana","Washington County",3,28,322,161,161
050,18,175,"Indiana","Washington County",3,29,326,161,165
050,18,175,"Indiana","Washington County",3,30,366,189,177
050,18,175,"Indiana","Washington County",3,31,369,196,173
050,18,175,"Indiana","Washington County",3,32,340,182,158
050,18,175,"Indiana","Washington County",3,33,339,166,173
050,18,175,"Indiana","Washington County",3,34,309,145,164
050,18,175,"Indiana","Washington County",3,35,308,154,154
050,18,175,"Indiana","Washington County",3,36,309,154,155
050,18,175,"Indiana","Washington County",3,37,324,166,158
050,18,175,"Indiana","Washington County",3,38,314,175,139
050,18,175,"Indiana","Washington County",3,39,339,174,165
050,18,175,"Indiana","Washington County",3,40,346,171,175
050,18,175,"Indiana","Washington County",3,41,355,170,185
050,18,175,"Indiana","Washington County",3,42,370,194,176
050,18,175,"Indiana","Washington County",3,43,361,186,175
050,18,175,"Indiana","Washington County",3,44,368,190,178
050,18,175,"Indiana","Washington County",3,45,341,177,164
050,18,175,"Indiana","Washington County",3,46,328,172,156
050,18,175,"Indiana","Washington County",3,47,337,175,162
050,18,175,"Indiana","Washington County",3,48,353,177,176
050,18,175,"Indiana","Washington County",3,49,370,190,180
050,18,175,"Indiana","Washington County",3,50,402,213,189
050,18,175,"Indiana","Washington County",3,51,373,198,175
050,18,175,"Indiana","Washington County",3,52,356,183,173
050,18,175,"Indiana","Washington County",3,53,360,185,175
050,18,175,"Indiana","Washington County",3,54,383,190,193
050,18,175,"Indiana","Washington County",3,55,402,215,187
050,18,175,"Indiana","Washington County",3,56,435,219,216
050,18,175,"Indiana","Washington County",3,57,433,212,221
050,18,175,"Indiana","Washington County",3,58,422,204,218
050,18,175,"Indiana","Washington County",3,59,431,208,223
050,18,175,"Indiana","Washington County",3,60,444,220,224
050,18,175,"Indiana","Washington County",3,61,414,211,203
050,18,175,"Indiana","Washington County",3,62,399,199,200
050,18,175,"Indiana","Washington County",3,63,392,186,206
050,18,175,"Indiana","Washington County",3,64,399,201,198
050,18,175,"Indiana","Washington County",3,65,373,186,187
050,18,175,"Indiana","Washington County",3,66,371,191,180
050,18,175,"Indiana","Washington County",3,67,355,183,172
050,18,175,"Indiana","Washington County",3,68,330,169,161
050,18,175,"Indiana","Washington County",3,69,321,156,165
050,18,175,"Indiana","Washington County",3,70,300,141,159
050,18,175,"Indiana","Washington County",3,71,283,133,150
050,18,175,"Indiana","Washington County",3,72,284,127,157
050,18,175,"Indiana","Washington County",3,73,282,125,157
050,18,175,"Indiana","Washington County",3,74,299,144,155
050,18,175,"Indiana","Washington County",3,75,187,83,104
050,18,175,"Indiana","Washington County",3,76,181,80,101
050,18,175,"Indiana","Washington County",3,77,182,93,89
050,18,175,"Indiana","Washington County",3,78,176,86,90
050,18,175,"Indiana","Washington County",3,79,136,59,77
050,18,175,"Indiana","Washington County",3,80,136,59,77
050,18,175,"Indiana","Washington County",3,81,129,57,72
050,18,175,"Indiana","Washington County",3,82,111,51,60
050,18,175,"Indiana","Washington County",3,83,114,49,65
050,18,175,"Indiana","Washington County",3,84,79,38,41
050,18,175,"Indiana","Washington County",3,85,472,180,292
050,18,175,"Indiana","Washington County",4,0,319,152,167
050,18,175,"Indiana","Washington County",4,1,325,169,156
050,18,175,"Indiana","Washington County",4,2,312,158,154
050,18,175,"Indiana","Washington County",4,3,319,175,144
050,18,175,"Indiana","Washington County",4,4,331,169,162
050,18,175,"Indiana","Washington County",4,5,327,163,164
050,18,175,"Indiana","Washington County",4,6,342,163,179
050,18,175,"Indiana","Washington County",4,7,353,178,175
050,18,175,"Indiana","Washington County",4,8,384,179,205
050,18,175,"Indiana","Washington County",4,9,370,179,191
050,18,175,"Indiana","Washington County",4,10,361,189,172
050,18,175,"Indiana","Washington County",4,11,346,184,162
050,18,175,"Indiana","Washington County",4,12,374,192,182
050,18,175,"Indiana","Washington County",4,13,378,183,195
050,18,175,"Indiana","Washington County",4,14,361,179,182
050,18,175,"Indiana","Washington County",4,15,384,193,191
050,18,175,"Indiana","Washington County",4,16,396,214,182
050,18,175,"Indiana","Washington County",4,17,394,197,197
050,18,175,"Indiana","Washington County",4,18,333,172,161
050,18,175,"Indiana","Washington County",4,19,266,148,118
050,18,175,"Indiana","Washington County",4,20,289,162,127
050,18,175,"Indiana","Washington County",4,21,279,144,135
050,18,175,"Indiana","Washington County",4,22,298,159,139
050,18,175,"Indiana","Washington County",4,23,319,161,158
050,18,175,"Indiana","Washington County",4,24,306,162,144
050,18,175,"Indiana","Washington County",4,25,344,166,178
050,18,175,"Indiana","Washington County",4,26,325,179,146
050,18,175,"Indiana","Washington County",4,27,352,178,174
050,18,175,"Indiana","Washington County",4,28,331,156,175
050,18,175,"Indiana","Washington County",4,29,316,161,155
050,18,175,"Indiana","Washington County",4,30,317,161,156
050,18,175,"Indiana","Washington County",4,31,374,191,183
050,18,175,"Indiana","Washington County",4,32,374,200,174
050,18,175,"Indiana","Washington County",4,33,334,184,150
050,18,175,"Indiana","Washington County",4,34,341,165,176
050,18,175,"Indiana","Washington County",4,35,316,148,168
050,18,175,"Indiana","Washington County",4,36,324,165,159
050,18,175,"Indiana","Washington County",4,37,317,158,159
050,18,175,"Indiana","Washington County",4,38,334,170,164
050,18,175,"Indiana","Washington County",4,39,317,172,145
050,18,175,"Indiana","Washington County",4,40,343,179,164
050,18,175,"Indiana","Washington County",4,41,340,164,176
050,18,175,"Indiana","Washington County",4,42,350,164,186
050,18,175,"Indiana","Washington County",4,43,376,193,183
050,18,175,"Indiana","Washington County",4,44,349,177,172
050,18,175,"Indiana","Washington County",4,45,371,196,175
050,18,175,"Indiana","Washington County",4,46,352,185,167
050,18,175,"Indiana","Washington County",4,47,333,173,160
050,18,175,"Indiana","Washington County",4,48,330,174,156
050,18,175,"Indiana","Washington County",4,49,358,178,180
050,18,175,"Indiana","Washington County",4,50,367,195,172
050,18,175,"Indiana","Washington County",4,51,412,220,192
050,18,175,"Indiana","Washington County",4,52,381,204,177
050,18,175,"Indiana","Washington County",4,53,351,181,170
050,18,175,"Indiana","Washington County",4,54,367,191,176
050,18,175,"Indiana","Washington County",4,55,380,190,190
050,18,175,"Indiana","Washington County",4,56,401,213,188
050,18,175,"Indiana","Washington County",4,57,433,211,222
050,18,175,"Indiana","Washington County",4,58,426,209,217
050,18,175,"Indiana","Washington County",4,59,412,194,218
050,18,175,"Indiana","Washington County",4,60,427,210,217
050,18,175,"Indiana","Washington County",4,61,444,215,229
050,18,175,"Indiana","Washington County",4,62,404,206,198
050,18,175,"Indiana","Washington County",4,63,393,200,193
050,18,175,"Indiana","Washington County",4,64,386,183,203
050,18,175,"Indiana","Washington County",4,65,395,194,201
050,18,175,"Indiana","Washington County",4,66,360,183,177
050,18,175,"Indiana","Washington County",4,67,362,182,180
050,18,175,"Indiana","Washington County",4,68,344,179,165
050,18,175,"Indiana","Washington County",4,69,314,159,155
050,18,175,"Indiana","Washington County",4,70,309,152,157
050,18,175,"Indiana","Washington County",4,71,289,134,155
050,18,175,"Indiana","Washington County",4,72,282,135,147
050,18,175,"Indiana","Washington County",4,73,276,125,151
050,18,175,"Indiana","Washington County",4,74,271,119,152
050,18,175,"Indiana","Washington County",4,75,278,132,146
050,18,175,"Indiana","Washington County",4,76,178,75,103
050,18,175,"Indiana","Washington County",4,77,170,76,94
050,18,175,"Indiana","Washington County",4,78,175,89,86
050,18,175,"Indiana","Washington County",4,79,167,80,87
050,18,175,"Indiana","Washington County",4,80,125,53,72
050,18,175,"Indiana","Washington County",4,81,120,47,73
050,18,175,"Indiana","Washington County",4,82,123,54,69
050,18,175,"Indiana","Washington County",4,83,105,47,58
050,18,175,"Indiana","Washington County",4,84,100,44,56
050,18,175,"Indiana","Washington County",4,85,460,177,283
050,18,175,"Indiana","Washington County",5,0,300,144,156
050,18,175,"Indiana","Washington County",5,1,322,149,173
050,18,175,"Indiana","Washington County",5,2,334,169,165
050,18,175,"Indiana","Washington County",5,3,308,156,152
050,18,175,"Indiana","Washington County",5,4,324,181,143
050,18,175,"Indiana","Washington County",5,5,339,177,162
050,18,175,"Indiana","Washington County",5,6,337,171,166
050,18,175,"Indiana","Washington County",5,7,342,168,174
050,18,175,"Indiana","Washington County",5,8,350,181,169
050,18,175,"Indiana","Washington County",5,9,374,169,205
050,18,175,"Indiana","Washington County",5,10,374,185,189
050,18,175,"Indiana","Washington County",5,11,355,189,166
050,18,175,"Indiana","Washington County",5,12,337,175,162
050,18,175,"Indiana","Washington County",5,13,376,191,185
050,18,175,"Indiana","Washington County",5,14,376,181,195
050,18,175,"Indiana","Washington County",5,15,369,186,183
050,18,175,"Indiana","Washington County",5,16,377,190,187
050,18,175,"Indiana","Washington County",5,17,405,208,197
050,18,175,"Indiana","Washington County",5,18,309,157,152
050,18,175,"Indiana","Washington County",5,19,253,134,119
050,18,175,"Indiana","Washington County",5,20,281,151,130
050,18,175,"Indiana","Washington County",5,21,289,163,126
050,18,175,"Indiana","Washington County",5,22,308,161,147
050,18,175,"Indiana","Washington County",5,23,313,163,150
050,18,175,"Indiana","Washington County",5,24,317,161,156
050,18,175,"Indiana","Washington County",5,25,327,176,151
050,18,175,"Indiana","Washington County",5,26,354,174,180
050,18,175,"Indiana","Washington County",5,27,322,177,145
050,18,175,"Indiana","Washington County",5,28,350,173,177
050,18,175,"Indiana","Washington County",5,29,340,170,170
050,18,175,"Indiana","Washington County",5,30,310,151,159
050,18,175,"Indiana","Washington County",5,31,311,153,158
050,18,175,"Indiana","Washington County",5,32,384,206,178
050,18,175,"Indiana","Washington County",5,33,383,207,176
050,18,175,"Indiana","Washington County",5,34,337,185,152
050,18,175,"Indiana","Washington County",5,35,339,165,174
050,18,175,"Indiana","Washington County",5,36,316,156,160
050,18,175,"Indiana","Washington County",5,37,327,167,160
050,18,175,"Indiana","Washington County",5,38,333,159,174
050,18,175,"Indiana","Washington County",5,39,339,170,169
050,18,175,"Indiana","Washington County",5,40,321,182,139
050,18,175,"Indiana","Washington County",5,41,344,176,168
050,18,175,"Indiana","Washington County",5,42,332,156,176
050,18,175,"Indiana","Washington County",5,43,357,176,181
050,18,175,"Indiana","Washington County",5,44,374,189,185
050,18,175,"Indiana","Washington County",5,45,346,176,170
050,18,175,"Indiana","Washington County",5,46,374,197,177
050,18,175,"Indiana","Washington County",5,47,342,182,160
050,18,175,"Indiana","Washington County",5,48,343,175,168
050,18,175,"Indiana","Washington County",5,49,331,175,156
050,18,175,"Indiana","Washington County",5,50,360,179,181
050,18,175,"Indiana","Washington County",5,51,363,193,170
050,18,175,"Indiana","Washington County",5,52,415,222,193
050,18,175,"Indiana","Washington County",5,53,383,209,174
050,18,175,"Indiana","Washington County",5,54,352,181,171
050,18,175,"Indiana","Washington County",5,55,359,187,172
050,18,175,"Indiana","Washington County",5,56,383,189,194
050,18,175,"Indiana","Washington County",5,57,392,210,182
050,18,175,"Indiana","Washington County",5,58,425,205,220
050,18,175,"Indiana","Washington County",5,59,424,207,217
050,18,175,"Indiana","Washington County",5,60,421,197,224
050,18,175,"Indiana","Washington County",5,61,420,213,207
050,18,175,"Indiana","Washington County",5,62,437,210,227
050,18,175,"Indiana","Washington County",5,63,402,205,197
050,18,175,"Indiana","Washington County",5,64,386,197,189
050,18,175,"Indiana","Washington County",5,65,382,178,204
050,18,175,"Indiana","Washington County",5,66,394,194,200
050,18,175,"Indiana","Washington County",5,67,353,176,177
050,18,175,"Indiana","Washington County",5,68,356,181,175
050,18,175,"Indiana","Washington County",5,69,331,172,159
050,18,175,"Indiana","Washington County",5,70,307,154,153
050,18,175,"Indiana","Washington County",5,71,307,147,160
050,18,175,"Indiana","Washington County",5,72,286,135,151
050,18,175,"Indiana","Washington County",5,73,277,131,146
050,18,175,"Indiana","Washington County",5,74,269,122,147
050,18,175,"Indiana","Washington County",5,75,264,116,148
050,18,175,"Indiana","Washington County",5,76,268,118,150
050,18,175,"Indiana","Washington County",5,77,171,72,99
050,18,175,"Indiana","Washington County",5,78,165,71,94
050,18,175,"Indiana","Washington County",5,79,165,82,83
050,18,175,"Indiana","Washington County",5,80,156,75,81
050,18,175,"Indiana","Washington County",5,81,112,44,68
050,18,175,"Indiana","Washington County",5,82,113,44,69
050,18,175,"Indiana","Washington County",5,83,121,51,70
050,18,175,"Indiana","Washington County",5,84,94,43,51
050,18,175,"Indiana","Washington County",5,85,487,188,299
050,18,177,"Indiana","Wayne County",1,0,772,390,382
050,18,177,"Indiana","Wayne County",1,1,820,412,408
050,18,177,"Indiana","Wayne County",1,2,828,403,425
050,18,177,"Indiana","Wayne County",1,3,770,373,397
050,18,177,"Indiana","Wayne County",1,4,772,375,397
050,18,177,"Indiana","Wayne County",1,5,804,396,408
050,18,177,"Indiana","Wayne County",1,6,743,372,371
050,18,177,"Indiana","Wayne County",1,7,799,406,393
050,18,177,"Indiana","Wayne County",1,8,820,423,397
050,18,177,"Indiana","Wayne County",1,9,846,433,413
050,18,177,"Indiana","Wayne County",1,10,876,443,433
050,18,177,"Indiana","Wayne County",1,11,906,453,453
050,18,177,"Indiana","Wayne County",1,12,920,467,453
050,18,177,"Indiana","Wayne County",1,13,878,449,429
050,18,177,"Indiana","Wayne County",1,14,905,457,448
050,18,177,"Indiana","Wayne County",1,15,886,466,420
050,18,177,"Indiana","Wayne County",1,16,849,442,407
050,18,177,"Indiana","Wayne County",1,17,891,474,417
050,18,177,"Indiana","Wayne County",1,18,835,410,425
050,18,177,"Indiana","Wayne County",1,19,821,395,426
050,18,177,"Indiana","Wayne County",1,20,872,436,436
050,18,177,"Indiana","Wayne County",1,21,923,455,468
050,18,177,"Indiana","Wayne County",1,22,873,454,419
050,18,177,"Indiana","Wayne County",1,23,796,398,398
050,18,177,"Indiana","Wayne County",1,24,810,423,387
050,18,177,"Indiana","Wayne County",1,25,750,372,378
050,18,177,"Indiana","Wayne County",1,26,781,404,377
050,18,177,"Indiana","Wayne County",1,27,790,407,383
050,18,177,"Indiana","Wayne County",1,28,814,396,418
050,18,177,"Indiana","Wayne County",1,29,816,406,410
050,18,177,"Indiana","Wayne County",1,30,731,375,356
050,18,177,"Indiana","Wayne County",1,31,758,379,379
050,18,177,"Indiana","Wayne County",1,32,743,369,374
050,18,177,"Indiana","Wayne County",1,33,760,389,371
050,18,177,"Indiana","Wayne County",1,34,771,369,402
050,18,177,"Indiana","Wayne County",1,35,774,351,423
050,18,177,"Indiana","Wayne County",1,36,721,344,377
050,18,177,"Indiana","Wayne County",1,37,727,362,365
050,18,177,"Indiana","Wayne County",1,38,729,354,375
050,18,177,"Indiana","Wayne County",1,39,770,364,406
050,18,177,"Indiana","Wayne County",1,40,812,397,415
050,18,177,"Indiana","Wayne County",1,41,777,406,371
050,18,177,"Indiana","Wayne County",1,42,747,378,369
050,18,177,"Indiana","Wayne County",1,43,750,390,360
050,18,177,"Indiana","Wayne County",1,44,740,384,356
050,18,177,"Indiana","Wayne County",1,45,772,393,379
050,18,177,"Indiana","Wayne County",1,46,760,383,377
050,18,177,"Indiana","Wayne County",1,47,803,403,400
050,18,177,"Indiana","Wayne County",1,48,830,413,417
050,18,177,"Indiana","Wayne County",1,49,876,425,451
050,18,177,"Indiana","Wayne County",1,50,885,427,458
050,18,177,"Indiana","Wayne County",1,51,840,412,428
050,18,177,"Indiana","Wayne County",1,52,806,400,406
050,18,177,"Indiana","Wayne County",1,53,865,433,432
050,18,177,"Indiana","Wayne County",1,54,840,418,422
050,18,177,"Indiana","Wayne County",1,55,933,460,473
050,18,177,"Indiana","Wayne County",1,56,939,464,475
050,18,177,"Indiana","Wayne County",1,57,954,460,494
050,18,177,"Indiana","Wayne County",1,58,980,476,504
050,18,177,"Indiana","Wayne County",1,59,947,456,491
050,18,177,"Indiana","Wayne County",1,60,893,432,461
050,18,177,"Indiana","Wayne County",1,61,927,469,458
050,18,177,"Indiana","Wayne County",1,62,924,482,442
050,18,177,"Indiana","Wayne County",1,63,898,436,462
050,18,177,"Indiana","Wayne County",1,64,906,428,478
050,18,177,"Indiana","Wayne County",1,65,871,421,450
050,18,177,"Indiana","Wayne County",1,66,898,422,476
050,18,177,"Indiana","Wayne County",1,67,825,379,446
050,18,177,"Indiana","Wayne County",1,68,778,367,411
050,18,177,"Indiana","Wayne County",1,69,745,354,391
050,18,177,"Indiana","Wayne County",1,70,704,336,368
050,18,177,"Indiana","Wayne County",1,71,708,334,374
050,18,177,"Indiana","Wayne County",1,72,658,291,367
050,18,177,"Indiana","Wayne County",1,73,689,289,400
050,18,177,"Indiana","Wayne County",1,74,445,195,250
050,18,177,"Indiana","Wayne County",1,75,480,213,267
050,18,177,"Indiana","Wayne County",1,76,465,204,261
050,18,177,"Indiana","Wayne County",1,77,481,199,282
050,18,177,"Indiana","Wayne County",1,78,426,183,243
050,18,177,"Indiana","Wayne County",1,79,388,170,218
050,18,177,"Indiana","Wayne County",1,80,346,148,198
050,18,177,"Indiana","Wayne County",1,81,357,150,207
050,18,177,"Indiana","Wayne County",1,82,326,148,178
050,18,177,"Indiana","Wayne County",1,83,294,115,179
050,18,177,"Indiana","Wayne County",1,84,287,110,177
050,18,177,"Indiana","Wayne County",1,85,1516,477,1039
050,18,177,"Indiana","Wayne County",2,0,794,390,404
050,18,177,"Indiana","Wayne County",2,1,807,406,401
050,18,177,"Indiana","Wayne County",2,2,826,406,420
050,18,177,"Indiana","Wayne County",2,3,782,377,405
050,18,177,"Indiana","Wayne County",2,4,777,378,399
050,18,177,"Indiana","Wayne County",2,5,793,391,402
050,18,177,"Indiana","Wayne County",2,6,758,380,378
050,18,177,"Indiana","Wayne County",2,7,785,397,388
050,18,177,"Indiana","Wayne County",2,8,815,421,394
050,18,177,"Indiana","Wayne County",2,9,841,434,407
050,18,177,"Indiana","Wayne County",2,10,870,442,428
050,18,177,"Indiana","Wayne County",2,11,897,450,447
050,18,177,"Indiana","Wayne County",2,12,920,466,454
050,18,177,"Indiana","Wayne County",2,13,886,453,433
050,18,177,"Indiana","Wayne County",2,14,899,457,442
050,18,177,"Indiana","Wayne County",2,15,890,463,427
050,18,177,"Indiana","Wayne County",2,16,859,451,408
050,18,177,"Indiana","Wayne County",2,17,889,472,417
050,18,177,"Indiana","Wayne County",2,18,825,408,417
050,18,177,"Indiana","Wayne County",2,19,820,400,420
050,18,177,"Indiana","Wayne County",2,20,879,436,443
050,18,177,"Indiana","Wayne County",2,21,916,452,464
050,18,177,"Indiana","Wayne County",2,22,893,458,435
050,18,177,"Indiana","Wayne County",2,23,801,404,397
050,18,177,"Indiana","Wayne County",2,24,804,416,388
050,18,177,"Indiana","Wayne County",2,25,766,386,380
050,18,177,"Indiana","Wayne County",2,26,775,398,377
050,18,177,"Indiana","Wayne County",2,27,787,407,380
050,18,177,"Indiana","Wayne County",2,28,804,398,406
050,18,177,"Indiana","Wayne County",2,29,816,404,412
050,18,177,"Indiana","Wayne County",2,30,754,384,370
050,18,177,"Indiana","Wayne County",2,31,743,373,370
050,18,177,"Indiana","Wayne County",2,32,744,370,374
050,18,177,"Indiana","Wayne County",2,33,756,385,371
050,18,177,"Indiana","Wayne County",2,34,769,374,395
050,18,177,"Indiana","Wayne County",2,35,775,357,418
050,18,177,"Indiana","Wayne County",2,36,730,344,386
050,18,177,"Indiana","Wayne County",2,37,725,355,370
050,18,177,"Indiana","Wayne County",2,38,727,353,374
050,18,177,"Indiana","Wayne County",2,39,759,361,398
050,18,177,"Indiana","Wayne County",2,40,805,392,413
050,18,177,"Indiana","Wayne County",2,41,786,404,382
050,18,177,"Indiana","Wayne County",2,42,752,384,368
050,18,177,"Indiana","Wayne County",2,43,753,389,364
050,18,177,"Indiana","Wayne County",2,44,729,378,351
050,18,177,"Indiana","Wayne County",2,45,763,391,372
050,18,177,"Indiana","Wayne County",2,46,761,383,378
050,18,177,"Indiana","Wayne County",2,47,794,398,396
050,18,177,"Indiana","Wayne County",2,48,821,410,411
050,18,177,"Indiana","Wayne County",2,49,874,427,447
050,18,177,"Indiana","Wayne County",2,50,884,425,459
050,18,177,"Indiana","Wayne County",2,51,845,412,433
050,18,177,"Indiana","Wayne County",2,52,815,404,411
050,18,177,"Indiana","Wayne County",2,53,847,423,424
050,18,177,"Indiana","Wayne County",2,54,842,420,422
050,18,177,"Indiana","Wayne County",2,55,908,448,460
050,18,177,"Indiana","Wayne County",2,56,937,465,472
050,18,177,"Indiana","Wayne County",2,57,955,465,490
050,18,177,"Indiana","Wayne County",2,58,967,468,499
050,18,177,"Indiana","Wayne County",2,59,962,465,497
050,18,177,"Indiana","Wayne County",2,60,900,435,465
050,18,177,"Indiana","Wayne County",2,61,912,455,457
050,18,177,"Indiana","Wayne County",2,62,923,478,445
050,18,177,"Indiana","Wayne County",2,63,906,445,461
050,18,177,"Indiana","Wayne County",2,64,889,421,468
050,18,177,"Indiana","Wayne County",2,65,875,419,456
050,18,177,"Indiana","Wayne County",2,66,889,418,471
050,18,177,"Indiana","Wayne County",2,67,837,388,449
050,18,177,"Indiana","Wayne County",2,68,780,365,415
050,18,177,"Indiana","Wayne County",2,69,753,358,395
050,18,177,"Indiana","Wayne County",2,70,702,336,366
050,18,177,"Indiana","Wayne County",2,71,700,334,366
050,18,177,"Indiana","Wayne County",2,72,653,295,358
050,18,177,"Indiana","Wayne County",2,73,708,300,408
050,18,177,"Indiana","Wayne County",2,74,470,204,266
050,18,177,"Indiana","Wayne County",2,75,470,207,263
050,18,177,"Indiana","Wayne County",2,76,458,199,259
050,18,177,"Indiana","Wayne County",2,77,476,197,279
050,18,177,"Indiana","Wayne County",2,78,429,179,250
050,18,177,"Indiana","Wayne County",2,79,391,170,221
050,18,177,"Indiana","Wayne County",2,80,353,151,202
050,18,177,"Indiana","Wayne County",2,81,348,147,201
050,18,177,"Indiana","Wayne County",2,82,321,143,178
050,18,177,"Indiana","Wayne County",2,83,297,118,179
050,18,177,"Indiana","Wayne County",2,84,286,109,177
050,18,177,"Indiana","Wayne County",2,85,1525,484,1041
050,18,177,"Indiana","Wayne County",3,0,736,387,349
050,18,177,"Indiana","Wayne County",3,1,823,405,418
050,18,177,"Indiana","Wayne County",3,2,807,413,394
050,18,177,"Indiana","Wayne County",3,3,834,412,422
050,18,177,"Indiana","Wayne County",3,4,770,368,402
050,18,177,"Indiana","Wayne County",3,5,779,391,388
050,18,177,"Indiana","Wayne County",3,6,785,387,398
050,18,177,"Indiana","Wayne County",3,7,784,383,401
050,18,177,"Indiana","Wayne County",3,8,789,401,388
050,18,177,"Indiana","Wayne County",3,9,834,433,401
050,18,177,"Indiana","Wayne County",3,10,835,424,411
050,18,177,"Indiana","Wayne County",3,11,869,439,430
050,18,177,"Indiana","Wayne County",3,12,894,444,450
050,18,177,"Indiana","Wayne County",3,13,929,461,468
050,18,177,"Indiana","Wayne County",3,14,895,466,429
050,18,177,"Indiana","Wayne County",3,15,907,457,450
050,18,177,"Indiana","Wayne County",3,16,888,469,419
050,18,177,"Indiana","Wayne County",3,17,896,480,416
050,18,177,"Indiana","Wayne County",3,18,819,410,409
050,18,177,"Indiana","Wayne County",3,19,802,414,388
050,18,177,"Indiana","Wayne County",3,20,891,433,458
050,18,177,"Indiana","Wayne County",3,21,905,441,464
050,18,177,"Indiana","Wayne County",3,22,929,467,462
050,18,177,"Indiana","Wayne County",3,23,799,416,383
050,18,177,"Indiana","Wayne County",3,24,808,417,391
050,18,177,"Indiana","Wayne County",3,25,810,418,392
050,18,177,"Indiana","Wayne County",3,26,780,394,386
050,18,177,"Indiana","Wayne County",3,27,779,406,373
050,18,177,"Indiana","Wayne County",3,28,776,395,381
050,18,177,"Indiana","Wayne County",3,29,776,390,386
050,18,177,"Indiana","Wayne County",3,30,813,409,404
050,18,177,"Indiana","Wayne County",3,31,770,393,377
050,18,177,"Indiana","Wayne County",3,32,756,379,377
050,18,177,"Indiana","Wayne County",3,33,749,374,375
050,18,177,"Indiana","Wayne County",3,34,745,367,378
050,18,177,"Indiana","Wayne County",3,35,775,383,392
050,18,177,"Indiana","Wayne County",3,36,775,361,414
050,18,177,"Indiana","Wayne County",3,37,744,351,393
050,18,177,"Indiana","Wayne County",3,38,727,352,375
050,18,177,"Indiana","Wayne County",3,39,741,364,377
050,18,177,"Indiana","Wayne County",3,40,767,368,399
050,18,177,"Indiana","Wayne County",3,41,803,382,421
050,18,177,"Indiana","Wayne County",3,42,780,403,377
050,18,177,"Indiana","Wayne County",3,43,757,386,371
050,18,177,"Indiana","Wayne County",3,44,745,377,368
050,18,177,"Indiana","Wayne County",3,45,719,377,342
050,18,177,"Indiana","Wayne County",3,46,777,392,385
050,18,177,"Indiana","Wayne County",3,47,759,379,380
050,18,177,"Indiana","Wayne County",3,48,775,379,396
050,18,177,"Indiana","Wayne County",3,49,842,428,414
050,18,177,"Indiana","Wayne County",3,50,873,431,442
050,18,177,"Indiana","Wayne County",3,51,874,419,455
050,18,177,"Indiana","Wayne County",3,52,850,420,430
050,18,177,"Indiana","Wayne County",3,53,827,408,419
050,18,177,"Indiana","Wayne County",3,54,845,422,423
050,18,177,"Indiana","Wayne County",3,55,825,405,420
050,18,177,"Indiana","Wayne County",3,56,905,448,457
050,18,177,"Indiana","Wayne County",3,57,940,469,471
050,18,177,"Indiana","Wayne County",3,58,943,464,479
050,18,177,"Indiana","Wayne County",3,59,959,468,491
050,18,177,"Indiana","Wayne County",3,60,946,447,499
050,18,177,"Indiana","Wayne County",3,61,894,432,462
050,18,177,"Indiana","Wayne County",3,62,904,457,447
050,18,177,"Indiana","Wayne County",3,63,907,468,439
050,18,177,"Indiana","Wayne County",3,64,883,434,449
050,18,177,"Indiana","Wayne County",3,65,863,407,456
050,18,177,"Indiana","Wayne County",3,66,861,407,454
050,18,177,"Indiana","Wayne County",3,67,865,403,462
050,18,177,"Indiana","Wayne County",3,68,813,373,440
050,18,177,"Indiana","Wayne County",3,69,750,351,399
050,18,177,"Indiana","Wayne County",3,70,725,339,386
050,18,177,"Indiana","Wayne County",3,71,680,321,359
050,18,177,"Indiana","Wayne County",3,72,685,325,360
050,18,177,"Indiana","Wayne County",3,73,648,285,363
050,18,177,"Indiana","Wayne County",3,74,681,290,391
050,18,177,"Indiana","Wayne County",3,75,454,192,262
050,18,177,"Indiana","Wayne County",3,76,436,187,249
050,18,177,"Indiana","Wayne County",3,77,428,186,242
050,18,177,"Indiana","Wayne County",3,78,456,183,273
050,18,177,"Indiana","Wayne County",3,79,405,167,238
050,18,177,"Indiana","Wayne County",3,80,354,147,207
050,18,177,"Indiana","Wayne County",3,81,333,142,191
050,18,177,"Indiana","Wayne County",3,82,305,131,174
050,18,177,"Indiana","Wayne County",3,83,311,123,188
050,18,177,"Indiana","Wayne County",3,84,277,113,164
050,18,177,"Indiana","Wayne County",3,85,1483,490,993
050,18,177,"Indiana","Wayne County",4,0,764,378,386
050,18,177,"Indiana","Wayne County",4,1,761,398,363
050,18,177,"Indiana","Wayne County",4,2,824,407,417
050,18,177,"Indiana","Wayne County",4,3,815,416,399
050,18,177,"Indiana","Wayne County",4,4,823,406,417
050,18,177,"Indiana","Wayne County",4,5,770,376,394
050,18,177,"Indiana","Wayne County",4,6,774,389,385
050,18,177,"Indiana","Wayne County",4,7,784,384,400
050,18,177,"Indiana","Wayne County",4,8,762,379,383
050,18,177,"Indiana","Wayne County",4,9,783,389,394
050,18,177,"Indiana","Wayne County",4,10,841,432,409
050,18,177,"Indiana","Wayne County",4,11,831,420,411
050,18,177,"Indiana","Wayne County",4,12,876,453,423
050,18,177,"Indiana","Wayne County",4,13,902,442,460
050,18,177,"Indiana","Wayne County",4,14,925,467,458
050,18,177,"Indiana","Wayne County",4,15,920,473,447
050,18,177,"Indiana","Wayne County",4,16,924,471,453
050,18,177,"Indiana","Wayne County",4,17,920,494,426
050,18,177,"Indiana","Wayne County",4,18,828,427,401
050,18,177,"Indiana","Wayne County",4,19,773,396,377
050,18,177,"Indiana","Wayne County",4,20,829,416,413
050,18,177,"Indiana","Wayne County",4,21,893,421,472
050,18,177,"Indiana","Wayne County",4,22,906,443,463
050,18,177,"Indiana","Wayne County",4,23,851,424,427
050,18,177,"Indiana","Wayne County",4,24,801,420,381
050,18,177,"Indiana","Wayne County",4,25,786,398,388
050,18,177,"Indiana","Wayne County",4,26,805,409,396
050,18,177,"Indiana","Wayne County",4,27,785,402,383
050,18,177,"Indiana","Wayne County",4,28,774,410,364
050,18,177,"Indiana","Wayne County",4,29,805,414,391
050,18,177,"Indiana","Wayne County",4,30,783,398,385
050,18,177,"Indiana","Wayne County",4,31,823,417,406
050,18,177,"Indiana","Wayne County",4,32,762,391,371
050,18,177,"Indiana","Wayne County",4,33,764,387,377
050,18,177,"Indiana","Wayne County",4,34,767,376,391
050,18,177,"Indiana","Wayne County",4,35,733,358,375
050,18,177,"Indiana","Wayne County",4,36,780,381,399
050,18,177,"Indiana","Wayne County",4,37,766,362,404
050,18,177,"Indiana","Wayne County",4,38,745,352,393
050,18,177,"Indiana","Wayne County",4,39,716,355,361
050,18,177,"Indiana","Wayne County",4,40,734,356,378
050,18,177,"Indiana","Wayne County",4,41,783,370,413
050,18,177,"Indiana","Wayne County",4,42,803,390,413
050,18,177,"Indiana","Wayne County",4,43,793,409,384
050,18,177,"Indiana","Wayne County",4,44,754,377,377
050,18,177,"Indiana","Wayne County",4,45,730,371,359
050,18,177,"Indiana","Wayne County",4,46,733,385,348
050,18,177,"Indiana","Wayne County",4,47,776,390,386
050,18,177,"Indiana","Wayne County",4,48,752,366,386
050,18,177,"Indiana","Wayne County",4,49,768,389,379
050,18,177,"Indiana","Wayne County",4,50,834,421,413
050,18,177,"Indiana","Wayne County",4,51,877,430,447
050,18,177,"Indiana","Wayne County",4,52,875,422,453
050,18,177,"Indiana","Wayne County",4,53,844,422,422
050,18,177,"Indiana","Wayne County",4,54,813,396,417
050,18,177,"Indiana","Wayne County",4,55,836,414,422
050,18,177,"Indiana","Wayne County",4,56,818,391,427
050,18,177,"Indiana","Wayne County",4,57,905,442,463
050,18,177,"Indiana","Wayne County",4,58,927,457,470
050,18,177,"Indiana","Wayne County",4,59,929,456,473
050,18,177,"Indiana","Wayne County",4,60,936,450,486
050,18,177,"Indiana","Wayne County",4,61,928,438,490
050,18,177,"Indiana","Wayne County",4,62,878,425,453
050,18,177,"Indiana","Wayne County",4,63,879,442,437
050,18,177,"Indiana","Wayne County",4,64,888,457,431
050,18,177,"Indiana","Wayne County",4,65,865,422,443
050,18,177,"Indiana","Wayne County",4,66,845,389,456
050,18,177,"Indiana","Wayne County",4,67,842,402,440
050,18,177,"Indiana","Wayne County",4,68,843,391,452
050,18,177,"Indiana","Wayne County",4,69,783,358,425
050,18,177,"Indiana","Wayne County",4,70,723,337,386
050,18,177,"Indiana","Wayne County",4,71,703,328,375
050,18,177,"Indiana","Wayne County",4,72,658,306,352
050,18,177,"Indiana","Wayne County",4,73,667,310,357
050,18,177,"Indiana","Wayne County",4,74,629,281,348
050,18,177,"Indiana","Wayne County",4,75,667,278,389
050,18,177,"Indiana","Wayne County",4,76,420,177,243
050,18,177,"Indiana","Wayne County",4,77,408,170,238
050,18,177,"Indiana","Wayne County",4,78,405,175,230
050,18,177,"Indiana","Wayne County",4,79,438,181,257
050,18,177,"Indiana","Wayne County",4,80,370,146,224
050,18,177,"Indiana","Wayne County",4,81,328,142,186
050,18,177,"Indiana","Wayne County",4,82,292,131,161
050,18,177,"Indiana","Wayne County",4,83,294,112,182
050,18,177,"Indiana","Wayne County",4,84,297,123,174
050,18,177,"Indiana","Wayne County",4,85,1472,505,967
050,18,177,"Indiana","Wayne County",5,0,741,371,370
050,18,177,"Indiana","Wayne County",5,1,767,379,388
050,18,177,"Indiana","Wayne County",5,2,778,405,373
050,18,177,"Indiana","Wayne County",5,3,800,390,410
050,18,177,"Indiana","Wayne County",5,4,838,418,420
050,18,177,"Indiana","Wayne County",5,5,833,407,426
050,18,177,"Indiana","Wayne County",5,6,773,373,400
050,18,177,"Indiana","Wayne County",5,7,781,393,388
050,18,177,"Indiana","Wayne County",5,8,773,382,391
050,18,177,"Indiana","Wayne County",5,9,773,382,391
050,18,177,"Indiana","Wayne County",5,10,798,398,400
050,18,177,"Indiana","Wayne County",5,11,843,427,416
050,18,177,"Indiana","Wayne County",5,12,828,424,404
050,18,177,"Indiana","Wayne County",5,13,883,456,427
050,18,177,"Indiana","Wayne County",5,14,916,458,458
050,18,177,"Indiana","Wayne County",5,15,919,466,453
050,18,177,"Indiana","Wayne County",5,16,927,486,441
050,18,177,"Indiana","Wayne County",5,17,957,496,461
050,18,177,"Indiana","Wayne County",5,18,828,427,401
050,18,177,"Indiana","Wayne County",5,19,789,417,372
050,18,177,"Indiana","Wayne County",5,20,829,407,422
050,18,177,"Indiana","Wayne County",5,21,859,429,430
050,18,177,"Indiana","Wayne County",5,22,911,437,474
050,18,177,"Indiana","Wayne County",5,23,817,398,419
050,18,177,"Indiana","Wayne County",5,24,835,416,419
050,18,177,"Indiana","Wayne County",5,25,773,411,362
050,18,177,"Indiana","Wayne County",5,26,770,380,390
050,18,177,"Indiana","Wayne County",5,27,804,410,394
050,18,177,"Indiana","Wayne County",5,28,776,399,377
050,18,177,"Indiana","Wayne County",5,29,754,402,352
050,18,177,"Indiana","Wayne County",5,30,778,399,379
050,18,177,"Indiana","Wayne County",5,31,791,399,392
050,18,177,"Indiana","Wayne County",5,32,827,418,409
050,18,177,"Indiana","Wayne County",5,33,768,388,380
050,18,177,"Indiana","Wayne County",5,34,797,405,392
050,18,177,"Indiana","Wayne County",5,35,776,379,397
050,18,177,"Indiana","Wayne County",5,36,758,373,385
050,18,177,"Indiana","Wayne County",5,37,766,375,391
050,18,177,"Indiana","Wayne County",5,38,753,357,396
050,18,177,"Indiana","Wayne County",5,39,756,349,407
050,18,177,"Indiana","Wayne County",5,40,716,355,361
050,18,177,"Indiana","Wayne County",5,41,746,356,390
050,18,177,"Indiana","Wayne County",5,42,784,371,413
050,18,177,"Indiana","Wayne County",5,43,815,397,418
050,18,177,"Indiana","Wayne County",5,44,790,403,387
050,18,177,"Indiana","Wayne County",5,45,754,373,381
050,18,177,"Indiana","Wayne County",5,46,734,370,364
050,18,177,"Indiana","Wayne County",5,47,736,389,347
050,18,177,"Indiana","Wayne County",5,48,758,379,379
050,18,177,"Indiana","Wayne County",5,49,750,370,380
050,18,177,"Indiana","Wayne County",5,50,750,384,366
050,18,177,"Indiana","Wayne County",5,51,842,429,413
050,18,177,"Indiana","Wayne County",5,52,888,442,446
050,18,177,"Indiana","Wayne County",5,53,868,419,449
050,18,177,"Indiana","Wayne County",5,54,835,409,426
050,18,177,"Indiana","Wayne County",5,55,821,399,422
050,18,177,"Indiana","Wayne County",5,56,840,412,428
050,18,177,"Indiana","Wayne County",5,57,804,388,416
050,18,177,"Indiana","Wayne County",5,58,917,450,467
050,18,177,"Indiana","Wayne County",5,59,927,455,472
050,18,177,"Indiana","Wayne County",5,60,911,439,472
050,18,177,"Indiana","Wayne County",5,61,928,446,482
050,18,177,"Indiana","Wayne County",5,62,910,437,473
050,18,177,"Indiana","Wayne County",5,63,862,422,440
050,18,177,"Indiana","Wayne County",5,64,875,436,439
050,18,177,"Indiana","Wayne County",5,65,862,444,418
050,18,177,"Indiana","Wayne County",5,66,853,412,441
050,18,177,"Indiana","Wayne County",5,67,817,381,436
050,18,177,"Indiana","Wayne County",5,68,820,392,428
050,18,177,"Indiana","Wayne County",5,69,807,371,436
050,18,177,"Indiana","Wayne County",5,70,753,344,409
050,18,177,"Indiana","Wayne County",5,71,697,317,380
050,18,177,"Indiana","Wayne County",5,72,679,317,362
050,18,177,"Indiana","Wayne County",5,73,636,289,347
050,18,177,"Indiana","Wayne County",5,74,646,301,345
050,18,177,"Indiana","Wayne County",5,75,621,272,349
050,18,177,"Indiana","Wayne County",5,76,631,261,370
050,18,177,"Indiana","Wayne County",5,77,389,163,226
050,18,177,"Indiana","Wayne County",5,78,398,164,234
050,18,177,"Indiana","Wayne County",5,79,387,175,212
050,18,177,"Indiana","Wayne County",5,80,408,162,246
050,18,177,"Indiana","Wayne County",5,81,349,143,206
050,18,177,"Indiana","Wayne County",5,82,290,130,160
050,18,177,"Indiana","Wayne County",5,83,289,116,173
050,18,177,"Indiana","Wayne County",5,84,282,110,172
050,18,177,"Indiana","Wayne County",5,85,1509,546,963
050,18,179,"Indiana","Wells County",1,0,333,170,163
050,18,179,"Indiana","Wells County",1,1,346,166,180
050,18,179,"Indiana","Wells County",1,2,330,168,162
050,18,179,"Indiana","Wells County",1,3,379,200,179
050,18,179,"Indiana","Wells County",1,4,394,196,198
050,18,179,"Indiana","Wells County",1,5,364,177,187
050,18,179,"Indiana","Wells County",1,6,385,208,177
050,18,179,"Indiana","Wells County",1,7,394,220,174
050,18,179,"Indiana","Wells County",1,8,417,224,193
050,18,179,"Indiana","Wells County",1,9,393,179,214
050,18,179,"Indiana","Wells County",1,10,398,191,207
050,18,179,"Indiana","Wells County",1,11,446,225,221
050,18,179,"Indiana","Wells County",1,12,422,217,205
050,18,179,"Indiana","Wells County",1,13,399,208,191
050,18,179,"Indiana","Wells County",1,14,419,215,204
050,18,179,"Indiana","Wells County",1,15,401,201,200
050,18,179,"Indiana","Wells County",1,16,413,214,199
050,18,179,"Indiana","Wells County",1,17,396,205,191
050,18,179,"Indiana","Wells County",1,18,333,187,146
050,18,179,"Indiana","Wells County",1,19,260,141,119
050,18,179,"Indiana","Wells County",1,20,261,146,115
050,18,179,"Indiana","Wells County",1,21,287,152,135
050,18,179,"Indiana","Wells County",1,22,307,157,150
050,18,179,"Indiana","Wells County",1,23,308,166,142
050,18,179,"Indiana","Wells County",1,24,319,165,154
050,18,179,"Indiana","Wells County",1,25,322,162,160
050,18,179,"Indiana","Wells County",1,26,344,169,175
050,18,179,"Indiana","Wells County",1,27,344,167,177
050,18,179,"Indiana","Wells County",1,28,359,170,189
050,18,179,"Indiana","Wells County",1,29,323,167,156
050,18,179,"Indiana","Wells County",1,30,322,155,167
050,18,179,"Indiana","Wells County",1,31,313,151,162
050,18,179,"Indiana","Wells County",1,32,310,166,144
050,18,179,"Indiana","Wells County",1,33,311,151,160
050,18,179,"Indiana","Wells County",1,34,320,156,164
050,18,179,"Indiana","Wells County",1,35,329,154,175
050,18,179,"Indiana","Wells County",1,36,339,170,169
050,18,179,"Indiana","Wells County",1,37,356,175,181
050,18,179,"Indiana","Wells County",1,38,344,190,154
050,18,179,"Indiana","Wells County",1,39,346,188,158
050,18,179,"Indiana","Wells County",1,40,376,191,185
050,18,179,"Indiana","Wells County",1,41,341,179,162
050,18,179,"Indiana","Wells County",1,42,319,155,164
050,18,179,"Indiana","Wells County",1,43,303,144,159
050,18,179,"Indiana","Wells County",1,44,311,160,151
050,18,179,"Indiana","Wells County",1,45,306,167,139
050,18,179,"Indiana","Wells County",1,46,304,163,141
050,18,179,"Indiana","Wells County",1,47,291,153,138
050,18,179,"Indiana","Wells County",1,48,331,165,166
050,18,179,"Indiana","Wells County",1,49,371,182,189
050,18,179,"Indiana","Wells County",1,50,349,180,169
050,18,179,"Indiana","Wells County",1,51,323,163,160
050,18,179,"Indiana","Wells County",1,52,320,164,156
050,18,179,"Indiana","Wells County",1,53,338,180,158
050,18,179,"Indiana","Wells County",1,54,346,176,170
050,18,179,"Indiana","Wells County",1,55,386,194,192
050,18,179,"Indiana","Wells County",1,56,397,196,201
050,18,179,"Indiana","Wells County",1,57,395,195,200
050,18,179,"Indiana","Wells County",1,58,407,203,204
050,18,179,"Indiana","Wells County",1,59,403,198,205
050,18,179,"Indiana","Wells County",1,60,413,209,204
050,18,179,"Indiana","Wells County",1,61,432,209,223
050,18,179,"Indiana","Wells County",1,62,432,222,210
050,18,179,"Indiana","Wells County",1,63,383,197,186
050,18,179,"Indiana","Wells County",1,64,387,195,192
050,18,179,"Indiana","Wells County",1,65,368,188,180
050,18,179,"Indiana","Wells County",1,66,348,166,182
050,18,179,"Indiana","Wells County",1,67,339,164,175
050,18,179,"Indiana","Wells County",1,68,315,146,169
050,18,179,"Indiana","Wells County",1,69,280,134,146
050,18,179,"Indiana","Wells County",1,70,293,137,156
050,18,179,"Indiana","Wells County",1,71,286,137,149
050,18,179,"Indiana","Wells County",1,72,256,123,133
050,18,179,"Indiana","Wells County",1,73,254,120,134
050,18,179,"Indiana","Wells County",1,74,196,98,98
050,18,179,"Indiana","Wells County",1,75,199,97,102
050,18,179,"Indiana","Wells County",1,76,196,90,106
050,18,179,"Indiana","Wells County",1,77,179,81,98
050,18,179,"Indiana","Wells County",1,78,162,58,104
050,18,179,"Indiana","Wells County",1,79,164,67,97
050,18,179,"Indiana","Wells County",1,80,138,59,79
050,18,179,"Indiana","Wells County",1,81,127,57,70
050,18,179,"Indiana","Wells County",1,82,118,49,69
050,18,179,"Indiana","Wells County",1,83,121,49,72
050,18,179,"Indiana","Wells County",1,84,101,38,63
050,18,179,"Indiana","Wells County",1,85,679,218,461
050,18,179,"Indiana","Wells County",2,0,321,163,158
050,18,179,"Indiana","Wells County",2,1,343,167,176
050,18,179,"Indiana","Wells County",2,2,337,170,167
050,18,179,"Indiana","Wells County",2,3,366,191,175
050,18,179,"Indiana","Wells County",2,4,392,199,193
050,18,179,"Indiana","Wells County",2,5,374,185,189
050,18,179,"Indiana","Wells County",2,6,385,205,180
050,18,179,"Indiana","Wells County",2,7,395,221,174
050,18,179,"Indiana","Wells County",2,8,411,222,189
050,18,179,"Indiana","Wells County",2,9,397,190,207
050,18,179,"Indiana","Wells County",2,10,398,189,209
050,18,179,"Indiana","Wells County",2,11,433,215,218
050,18,179,"Indiana","Wells County",2,12,433,221,212
050,18,179,"Indiana","Wells County",2,13,405,211,194
050,18,179,"Indiana","Wells County",2,14,414,214,200
050,18,179,"Indiana","Wells County",2,15,405,206,199
050,18,179,"Indiana","Wells County",2,16,408,211,197
050,18,179,"Indiana","Wells County",2,17,398,206,192
050,18,179,"Indiana","Wells County",2,18,332,185,147
050,18,179,"Indiana","Wells County",2,19,261,143,118
050,18,179,"Indiana","Wells County",2,20,271,150,121
050,18,179,"Indiana","Wells County",2,21,282,151,131
050,18,179,"Indiana","Wells County",2,22,302,156,146
050,18,179,"Indiana","Wells County",2,23,305,164,141
050,18,179,"Indiana","Wells County",2,24,313,163,150
050,18,179,"Indiana","Wells County",2,25,320,161,159
050,18,179,"Indiana","Wells County",2,26,341,168,173
050,18,179,"Indiana","Wells County",2,27,349,170,179
050,18,179,"Indiana","Wells County",2,28,357,171,186
050,18,179,"Indiana","Wells County",2,29,331,168,163
050,18,179,"Indiana","Wells County",2,30,324,156,168
050,18,179,"Indiana","Wells County",2,31,315,151,164
050,18,179,"Indiana","Wells County",2,32,311,162,149
050,18,179,"Indiana","Wells County",2,33,313,156,157
050,18,179,"Indiana","Wells County",2,34,317,154,163
050,18,179,"Indiana","Wells County",2,35,328,156,172
050,18,179,"Indiana","Wells County",2,36,334,164,170
050,18,179,"Indiana","Wells County",2,37,354,177,177
050,18,179,"Indiana","Wells County",2,38,348,187,161
050,18,179,"Indiana","Wells County",2,39,346,189,157
050,18,179,"Indiana","Wells County",2,40,371,191,180
050,18,179,"Indiana","Wells County",2,41,348,181,167
050,18,179,"Indiana","Wells County",2,42,322,158,164
050,18,179,"Indiana","Wells County",2,43,309,147,162
050,18,179,"Indiana","Wells County",2,44,304,154,150
050,18,179,"Indiana","Wells County",2,45,312,168,144
050,18,179,"Indiana","Wells County",2,46,303,164,139
050,18,179,"Indiana","Wells County",2,47,292,155,137
050,18,179,"Indiana","Wells County",2,48,321,163,158
050,18,179,"Indiana","Wells County",2,49,363,179,184
050,18,179,"Indiana","Wells County",2,50,353,181,172
050,18,179,"Indiana","Wells County",2,51,327,166,161
050,18,179,"Indiana","Wells County",2,52,318,160,158
050,18,179,"Indiana","Wells County",2,53,332,175,157
050,18,179,"Indiana","Wells County",2,54,344,178,166
050,18,179,"Indiana","Wells County",2,55,376,190,186
050,18,179,"Indiana","Wells County",2,56,395,196,199
050,18,179,"Indiana","Wells County",2,57,397,197,200
050,18,179,"Indiana","Wells County",2,58,400,198,202
050,18,179,"Indiana","Wells County",2,59,405,200,205
050,18,179,"Indiana","Wells County",2,60,409,205,204
050,18,179,"Indiana","Wells County",2,61,425,208,217
050,18,179,"Indiana","Wells County",2,62,433,219,214
050,18,179,"Indiana","Wells County",2,63,397,203,194
050,18,179,"Indiana","Wells County",2,64,384,194,190
050,18,179,"Indiana","Wells County",2,65,372,190,182
050,18,179,"Indiana","Wells County",2,66,355,172,183
050,18,179,"Indiana","Wells County",2,67,337,162,175
050,18,179,"Indiana","Wells County",2,68,316,148,168
050,18,179,"Indiana","Wells County",2,69,290,138,152
050,18,179,"Indiana","Wells County",2,70,286,136,150
050,18,179,"Indiana","Wells County",2,71,290,137,153
050,18,179,"Indiana","Wells County",2,72,256,122,134
050,18,179,"Indiana","Wells County",2,73,267,127,140
050,18,179,"Indiana","Wells County",2,74,196,96,100
050,18,179,"Indiana","Wells County",2,75,193,94,99
050,18,179,"Indiana","Wells County",2,76,192,90,102
050,18,179,"Indiana","Wells County",2,77,183,83,100
050,18,179,"Indiana","Wells County",2,78,166,63,103
050,18,179,"Indiana","Wells County",2,79,159,64,95
050,18,179,"Indiana","Wells County",2,80,144,60,84
050,18,179,"Indiana","Wells County",2,81,125,55,70
050,18,179,"Indiana","Wells County",2,82,120,51,69
050,18,179,"Indiana","Wells County",2,83,121,49,72
050,18,179,"Indiana","Wells County",2,84,103,38,65
050,18,179,"Indiana","Wells County",2,85,675,216,459
050,18,179,"Indiana","Wells County",3,0,335,178,157
050,18,179,"Indiana","Wells County",3,1,344,167,177
050,18,179,"Indiana","Wells County",3,2,361,176,185
050,18,179,"Indiana","Wells County",3,3,346,175,171
050,18,179,"Indiana","Wells County",3,4,363,187,176
050,18,179,"Indiana","Wells County",3,5,397,204,193
050,18,179,"Indiana","Wells County",3,6,390,187,203
050,18,179,"Indiana","Wells County",3,7,393,203,190
050,18,179,"Indiana","Wells County",3,8,402,231,171
050,18,179,"Indiana","Wells County",3,9,423,228,195
050,18,179,"Indiana","Wells County",3,10,400,192,208
050,18,179,"Indiana","Wells County",3,11,395,182,213
050,18,179,"Indiana","Wells County",3,12,424,209,215
050,18,179,"Indiana","Wells County",3,13,426,218,208
050,18,179,"Indiana","Wells County",3,14,396,213,183
050,18,179,"Indiana","Wells County",3,15,415,222,193
050,18,179,"Indiana","Wells County",3,16,399,200,199
050,18,179,"Indiana","Wells County",3,17,406,203,203
050,18,179,"Indiana","Wells County",3,18,351,193,158
050,18,179,"Indiana","Wells County",3,19,273,154,119
050,18,179,"Indiana","Wells County",3,20,278,156,122
050,18,179,"Indiana","Wells County",3,21,286,153,133
050,18,179,"Indiana","Wells County",3,22,298,155,143
050,18,179,"Indiana","Wells County",3,23,312,156,156
050,18,179,"Indiana","Wells County",3,24,312,173,139
050,18,179,"Indiana","Wells County",3,25,307,159,148
050,18,179,"Indiana","Wells County",3,26,329,163,166
050,18,179,"Indiana","Wells County",3,27,335,170,165
050,18,179,"Indiana","Wells County",3,28,371,188,183
050,18,179,"Indiana","Wells County",3,29,346,166,180
050,18,179,"Indiana","Wells County",3,30,324,164,160
050,18,179,"Indiana","Wells County",3,31,330,164,166
050,18,179,"Indiana","Wells County",3,32,327,157,170
050,18,179,"Indiana","Wells County",3,33,317,165,152
050,18,179,"Indiana","Wells County",3,34,311,160,151
050,18,179,"Indiana","Wells County",3,35,326,163,163
050,18,179,"Indiana","Wells County",3,36,336,156,180
050,18,179,"Indiana","Wells County",3,37,344,172,172
050,18,179,"Indiana","Wells County",3,38,352,177,175
050,18,179,"Indiana","Wells County",3,39,346,191,155
050,18,179,"Indiana","Wells County",3,40,344,187,157
050,18,179,"Indiana","Wells County",3,41,373,193,180
050,18,179,"Indiana","Wells County",3,42,346,182,164
050,18,179,"Indiana","Wells County",3,43,315,158,157
050,18,179,"Indiana","Wells County",3,44,317,153,164
050,18,179,"Indiana","Wells County",3,45,304,153,151
050,18,179,"Indiana","Wells County",3,46,309,164,145
050,18,179,"Indiana","Wells County",3,47,292,157,135
050,18,179,"Indiana","Wells County",3,48,292,149,143
050,18,179,"Indiana","Wells County",3,49,318,164,154
050,18,179,"Indiana","Wells County",3,50,358,176,182
050,18,179,"Indiana","Wells County",3,51,358,181,177
050,18,179,"Indiana","Wells County",3,52,321,161,160
050,18,179,"Indiana","Wells County",3,53,326,166,160
050,18,179,"Indiana","Wells County",3,54,320,172,148
050,18,179,"Indiana","Wells County",3,55,346,177,169
050,18,179,"Indiana","Wells County",3,56,366,186,180
050,18,179,"Indiana","Wells County",3,57,394,196,198
050,18,179,"Indiana","Wells County",3,58,397,194,203
050,18,179,"Indiana","Wells County",3,59,391,194,197
050,18,179,"Indiana","Wells County",3,60,397,196,201
050,18,179,"Indiana","Wells County",3,61,395,196,199
050,18,179,"Indiana","Wells County",3,62,422,201,221
050,18,179,"Indiana","Wells County",3,63,427,215,212
050,18,179,"Indiana","Wells County",3,64,391,198,193
050,18,179,"Indiana","Wells County",3,65,379,191,188
050,18,179,"Indiana","Wells County",3,66,371,191,180
050,18,179,"Indiana","Wells County",3,67,349,167,182
050,18,179,"Indiana","Wells County",3,68,325,155,170
050,18,179,"Indiana","Wells County",3,69,306,143,163
050,18,179,"Indiana","Wells County",3,70,278,134,144
050,18,179,"Indiana","Wells County",3,71,283,131,152
050,18,179,"Indiana","Wells County",3,72,269,131,138
050,18,179,"Indiana","Wells County",3,73,252,120,132
050,18,179,"Indiana","Wells County",3,74,252,117,135
050,18,179,"Indiana","Wells County",3,75,190,90,100
050,18,179,"Indiana","Wells County",3,76,180,88,92
050,18,179,"Indiana","Wells County",3,77,182,86,96
050,18,179,"Indiana","Wells County",3,78,179,76,103
050,18,179,"Indiana","Wells County",3,79,152,58,94
050,18,179,"Indiana","Wells County",3,80,156,60,96
050,18,179,"Indiana","Wells County",3,81,121,49,72
050,18,179,"Indiana","Wells County",3,82,111,47,64
050,18,179,"Indiana","Wells County",3,83,119,46,73
050,18,179,"Indiana","Wells County",3,84,108,42,66
050,18,179,"Indiana","Wells County",3,85,647,203,444
050,18,179,"Indiana","Wells County",4,0,324,164,160
050,18,179,"Indiana","Wells County",4,1,367,194,173
050,18,179,"Indiana","Wells County",4,2,346,166,180
050,18,179,"Indiana","Wells County",4,3,359,177,182
050,18,179,"Indiana","Wells County",4,4,364,174,190
050,18,179,"Indiana","Wells County",4,5,380,198,182
050,18,179,"Indiana","Wells County",4,6,390,199,191
050,18,179,"Indiana","Wells County",4,7,385,181,204
050,18,179,"Indiana","Wells County",4,8,402,211,191
050,18,179,"Indiana","Wells County",4,9,410,243,167
050,18,179,"Indiana","Wells County",4,10,422,231,191
050,18,179,"Indiana","Wells County",4,11,400,190,210
050,18,179,"Indiana","Wells County",4,12,406,194,212
050,18,179,"Indiana","Wells County",4,13,424,209,215
050,18,179,"Indiana","Wells County",4,14,442,231,211
050,18,179,"Indiana","Wells County",4,15,395,208,187
050,18,179,"Indiana","Wells County",4,16,408,218,190
050,18,179,"Indiana","Wells County",4,17,390,195,195
050,18,179,"Indiana","Wells County",4,18,344,180,164
050,18,179,"Indiana","Wells County",4,19,276,153,123
050,18,179,"Indiana","Wells County",4,20,291,161,130
050,18,179,"Indiana","Wells County",4,21,288,158,130
050,18,179,"Indiana","Wells County",4,22,299,162,137
050,18,179,"Indiana","Wells County",4,23,316,166,150
050,18,179,"Indiana","Wells County",4,24,322,157,165
050,18,179,"Indiana","Wells County",4,25,323,169,154
050,18,179,"Indiana","Wells County",4,26,318,164,154
050,18,179,"Indiana","Wells County",4,27,333,169,164
050,18,179,"Indiana","Wells County",4,28,323,157,166
050,18,179,"Indiana","Wells County",4,29,392,194,198
050,18,179,"Indiana","Wells County",4,30,350,163,187
050,18,179,"Indiana","Wells County",4,31,341,173,168
050,18,179,"Indiana","Wells County",4,32,333,162,171
050,18,179,"Indiana","Wells County",4,33,317,157,160
050,18,179,"Indiana","Wells County",4,34,316,166,150
050,18,179,"Indiana","Wells County",4,35,320,164,156
050,18,179,"Indiana","Wells County",4,36,327,165,162
050,18,179,"Indiana","Wells County",4,37,354,168,186
050,18,179,"Indiana","Wells County",4,38,354,177,177
050,18,179,"Indiana","Wells County",4,39,342,168,174
050,18,179,"Indiana","Wells County",4,40,353,194,159
050,18,179,"Indiana","Wells County",4,41,346,191,155
050,18,179,"Indiana","Wells County",4,42,374,194,180
050,18,179,"Indiana","Wells County",4,43,345,175,170
050,18,179,"Indiana","Wells County",4,44,319,156,163
050,18,179,"Indiana","Wells County",4,45,316,149,167
050,18,179,"Indiana","Wells County",4,46,296,150,146
050,18,179,"Indiana","Wells County",4,47,309,167,142
050,18,179,"Indiana","Wells County",4,48,293,156,137
050,18,179,"Indiana","Wells County",4,49,302,153,149
050,18,179,"Indiana","Wells County",4,50,324,169,155
050,18,179,"Indiana","Wells County",4,51,367,182,185
050,18,179,"Indiana","Wells County",4,52,347,176,171
050,18,179,"Indiana","Wells County",4,53,322,163,159
050,18,179,"Indiana","Wells County",4,54,329,164,165
050,18,179,"Indiana","Wells County",4,55,320,174,146
050,18,179,"Indiana","Wells County",4,56,344,172,172
050,18,179,"Indiana","Wells County",4,57,370,195,175
050,18,179,"Indiana","Wells County",4,58,392,194,198
050,18,179,"Indiana","Wells County",4,59,397,192,205
050,18,179,"Indiana","Wells County",4,60,389,195,194
050,18,179,"Indiana","Wells County",4,61,385,188,197
050,18,179,"Indiana","Wells County",4,62,399,191,208
050,18,179,"Indiana","Wells County",4,63,422,202,220
050,18,179,"Indiana","Wells County",4,64,416,210,206
050,18,179,"Indiana","Wells County",4,65,375,192,183
050,18,179,"Indiana","Wells County",4,66,371,190,181
050,18,179,"Indiana","Wells County",4,67,359,181,178
050,18,179,"Indiana","Wells County",4,68,348,166,182
050,18,179,"Indiana","Wells County",4,69,326,156,170
050,18,179,"Indiana","Wells County",4,70,303,143,160
050,18,179,"Indiana","Wells County",4,71,277,131,146
050,18,179,"Indiana","Wells County",4,72,264,125,139
050,18,179,"Indiana","Wells County",4,73,264,125,139
050,18,179,"Indiana","Wells County",4,74,237,108,129
050,18,179,"Indiana","Wells County",4,75,248,114,134
050,18,179,"Indiana","Wells County",4,76,181,87,94
050,18,179,"Indiana","Wells County",4,77,170,81,89
050,18,179,"Indiana","Wells County",4,78,186,83,103
050,18,179,"Indiana","Wells County",4,79,174,75,99
050,18,179,"Indiana","Wells County",4,80,149,58,91
050,18,179,"Indiana","Wells County",4,81,134,51,83
050,18,179,"Indiana","Wells County",4,82,107,43,64
050,18,179,"Indiana","Wells County",4,83,120,48,72
050,18,179,"Indiana","Wells County",4,84,106,36,70
050,18,179,"Indiana","Wells County",4,85,630,198,432
050,18,179,"Indiana","Wells County",5,0,321,165,156
050,18,179,"Indiana","Wells County",5,1,340,168,172
050,18,179,"Indiana","Wells County",5,2,365,199,166
050,18,179,"Indiana","Wells County",5,3,368,183,185
050,18,179,"Indiana","Wells County",5,4,382,192,190
050,18,179,"Indiana","Wells County",5,5,358,173,185
050,18,179,"Indiana","Wells County",5,6,384,199,185
050,18,179,"Indiana","Wells County",5,7,392,203,189
050,18,179,"Indiana","Wells County",5,8,399,188,211
050,18,179,"Indiana","Wells County",5,9,403,215,188
050,18,179,"Indiana","Wells County",5,10,414,239,175
050,18,179,"Indiana","Wells County",5,11,429,235,194
050,18,179,"Indiana","Wells County",5,12,415,202,213
050,18,179,"Indiana","Wells County",5,13,399,187,212
050,18,179,"Indiana","Wells County",5,14,438,220,218
050,18,179,"Indiana","Wells County",5,15,432,219,213
050,18,179,"Indiana","Wells County",5,16,397,212,185
050,18,179,"Indiana","Wells County",5,17,407,221,186
050,18,179,"Indiana","Wells County",5,18,327,172,155
050,18,179,"Indiana","Wells County",5,19,275,148,127
050,18,179,"Indiana","Wells County",5,20,294,154,140
050,18,179,"Indiana","Wells County",5,21,310,162,148
050,18,179,"Indiana","Wells County",5,22,316,164,152
050,18,179,"Indiana","Wells County",5,23,317,171,146
050,18,179,"Indiana","Wells County",5,24,326,166,160
050,18,179,"Indiana","Wells County",5,25,315,156,159
050,18,179,"Indiana","Wells County",5,26,345,181,164
050,18,179,"Indiana","Wells County",5,27,335,174,161
050,18,179,"Indiana","Wells County",5,28,339,183,156
050,18,179,"Indiana","Wells County",5,29,337,164,173
050,18,179,"Indiana","Wells County",5,30,393,194,199
050,18,179,"Indiana","Wells County",5,31,355,164,191
050,18,179,"Indiana","Wells County",5,32,360,183,177
050,18,179,"Indiana","Wells County",5,33,339,166,173
050,18,179,"Indiana","Wells County",5,34,331,162,169
050,18,179,"Indiana","Wells County",5,35,327,175,152
050,18,179,"Indiana","Wells County",5,36,334,171,163
050,18,179,"Indiana","Wells County",5,37,334,167,167
050,18,179,"Indiana","Wells County",5,38,373,184,189
050,18,179,"Indiana","Wells County",5,39,358,182,176
050,18,179,"Indiana","Wells County",5,40,346,166,180
050,18,179,"Indiana","Wells County",5,41,357,199,158
050,18,179,"Indiana","Wells County",5,42,354,192,162
050,18,179,"Indiana","Wells County",5,43,371,194,177
050,18,179,"Indiana","Wells County",5,44,348,179,169
050,18,179,"Indiana","Wells County",5,45,328,162,166
050,18,179,"Indiana","Wells County",5,46,321,150,171
050,18,179,"Indiana","Wells County",5,47,292,147,145
050,18,179,"Indiana","Wells County",5,48,318,169,149
050,18,179,"Indiana","Wells County",5,49,290,150,140
050,18,179,"Indiana","Wells County",5,50,296,147,149
050,18,179,"Indiana","Wells County",5,51,319,170,149
050,18,179,"Indiana","Wells County",5,52,380,189,191
050,18,179,"Indiana","Wells County",5,53,348,173,175
050,18,179,"Indiana","Wells County",5,54,318,161,157
050,18,179,"Indiana","Wells County",5,55,324,164,160
050,18,179,"Indiana","Wells County",5,56,316,175,141
050,18,179,"Indiana","Wells County",5,57,344,173,171
050,18,179,"Indiana","Wells County",5,58,368,193,175
050,18,179,"Indiana","Wells County",5,59,385,192,193
050,18,179,"Indiana","Wells County",5,60,393,188,205
050,18,179,"Indiana","Wells County",5,61,383,189,194
050,18,179,"Indiana","Wells County",5,62,378,182,196
050,18,179,"Indiana","Wells County",5,63,394,190,204
050,18,179,"Indiana","Wells County",5,64,411,196,215
050,18,179,"Indiana","Wells County",5,65,410,213,197
050,18,179,"Indiana","Wells County",5,66,377,196,181
050,18,179,"Indiana","Wells County",5,67,363,181,182
050,18,179,"Indiana","Wells County",5,68,357,179,178
050,18,179,"Indiana","Wells County",5,69,351,165,186
050,18,179,"Indiana","Wells County",5,70,308,149,159
050,18,179,"Indiana","Wells County",5,71,305,143,162
050,18,179,"Indiana","Wells County",5,72,248,119,129
050,18,179,"Indiana","Wells County",5,73,256,122,134
050,18,179,"Indiana","Wells County",5,74,255,119,136
050,18,179,"Indiana","Wells County",5,75,234,105,129
050,18,179,"Indiana","Wells County",5,76,240,114,126
050,18,179,"Indiana","Wells County",5,77,167,80,87
050,18,179,"Indiana","Wells County",5,78,178,81,97
050,18,179,"Indiana","Wells County",5,79,173,78,95
050,18,179,"Indiana","Wells County",5,80,167,73,94
050,18,179,"Indiana","Wells County",5,81,126,47,79
050,18,179,"Indiana","Wells County",5,82,122,46,76
050,18,179,"Indiana","Wells County",5,83,111,43,68
050,18,179,"Indiana","Wells County",5,84,106,40,66
050,18,179,"Indiana","Wells County",5,85,636,198,438
050,18,181,"Indiana","White County",1,0,285,144,141
050,18,181,"Indiana","White County",1,1,296,147,149
050,18,181,"Indiana","White County",1,2,303,138,165
050,18,181,"Indiana","White County",1,3,315,153,162
050,18,181,"Indiana","White County",1,4,335,176,159
050,18,181,"Indiana","White County",1,5,287,149,138
050,18,181,"Indiana","White County",1,6,325,157,168
050,18,181,"Indiana","White County",1,7,336,175,161
050,18,181,"Indiana","White County",1,8,331,173,158
050,18,181,"Indiana","White County",1,9,332,173,159
050,18,181,"Indiana","White County",1,10,326,170,156
050,18,181,"Indiana","White County",1,11,340,173,167
050,18,181,"Indiana","White County",1,12,317,166,151
050,18,181,"Indiana","White County",1,13,325,164,161
050,18,181,"Indiana","White County",1,14,363,195,168
050,18,181,"Indiana","White County",1,15,335,180,155
050,18,181,"Indiana","White County",1,16,337,185,152
050,18,181,"Indiana","White County",1,17,372,205,167
050,18,181,"Indiana","White County",1,18,329,179,150
050,18,181,"Indiana","White County",1,19,252,139,113
050,18,181,"Indiana","White County",1,20,259,138,121
050,18,181,"Indiana","White County",1,21,256,133,123
050,18,181,"Indiana","White County",1,22,261,142,119
050,18,181,"Indiana","White County",1,23,240,126,114
050,18,181,"Indiana","White County",1,24,260,125,135
050,18,181,"Indiana","White County",1,25,285,142,143
050,18,181,"Indiana","White County",1,26,294,161,133
050,18,181,"Indiana","White County",1,27,260,139,121
050,18,181,"Indiana","White County",1,28,288,144,144
050,18,181,"Indiana","White County",1,29,298,153,145
050,18,181,"Indiana","White County",1,30,281,143,138
050,18,181,"Indiana","White County",1,31,261,125,136
050,18,181,"Indiana","White County",1,32,249,128,121
050,18,181,"Indiana","White County",1,33,250,117,133
050,18,181,"Indiana","White County",1,34,246,121,125
050,18,181,"Indiana","White County",1,35,256,129,127
050,18,181,"Indiana","White County",1,36,257,133,124
050,18,181,"Indiana","White County",1,37,265,143,122
050,18,181,"Indiana","White County",1,38,248,120,128
050,18,181,"Indiana","White County",1,39,274,141,133
050,18,181,"Indiana","White County",1,40,276,132,144
050,18,181,"Indiana","White County",1,41,269,130,139
050,18,181,"Indiana","White County",1,42,293,150,143
050,18,181,"Indiana","White County",1,43,274,129,145
050,18,181,"Indiana","White County",1,44,264,131,133
050,18,181,"Indiana","White County",1,45,260,137,123
050,18,181,"Indiana","White County",1,46,275,145,130
050,18,181,"Indiana","White County",1,47,300,149,151
050,18,181,"Indiana","White County",1,48,299,156,143
050,18,181,"Indiana","White County",1,49,343,190,153
050,18,181,"Indiana","White County",1,50,348,190,158
050,18,181,"Indiana","White County",1,51,322,157,165
050,18,181,"Indiana","White County",1,52,292,146,146
050,18,181,"Indiana","White County",1,53,284,140,144
050,18,181,"Indiana","White County",1,54,287,135,152
050,18,181,"Indiana","White County",1,55,321,161,160
050,18,181,"Indiana","White County",1,56,351,166,185
050,18,181,"Indiana","White County",1,57,338,172,166
050,18,181,"Indiana","White County",1,58,371,189,182
050,18,181,"Indiana","White County",1,59,360,188,172
050,18,181,"Indiana","White County",1,60,372,189,183
050,18,181,"Indiana","White County",1,61,357,177,180
050,18,181,"Indiana","White County",1,62,381,182,199
050,18,181,"Indiana","White County",1,63,383,192,191
050,18,181,"Indiana","White County",1,64,369,174,195
050,18,181,"Indiana","White County",1,65,352,173,179
050,18,181,"Indiana","White County",1,66,335,160,175
050,18,181,"Indiana","White County",1,67,328,164,164
050,18,181,"Indiana","White County",1,68,340,172,168
050,18,181,"Indiana","White County",1,69,316,151,165
050,18,181,"Indiana","White County",1,70,292,147,145
050,18,181,"Indiana","White County",1,71,271,138,133
050,18,181,"Indiana","White County",1,72,270,131,139
050,18,181,"Indiana","White County",1,73,291,147,144
050,18,181,"Indiana","White County",1,74,205,91,114
050,18,181,"Indiana","White County",1,75,212,106,106
050,18,181,"Indiana","White County",1,76,188,93,95
050,18,181,"Indiana","White County",1,77,177,79,98
050,18,181,"Indiana","White County",1,78,150,67,83
050,18,181,"Indiana","White County",1,79,118,57,61
050,18,181,"Indiana","White County",1,80,139,63,76
050,18,181,"Indiana","White County",1,81,129,60,69
050,18,181,"Indiana","White County",1,82,104,43,61
050,18,181,"Indiana","White County",1,83,100,40,60
050,18,181,"Indiana","White County",1,84,105,47,58
050,18,181,"Indiana","White County",1,85,558,214,344
050,18,181,"Indiana","White County",2,0,286,150,136
050,18,181,"Indiana","White County",2,1,294,146,148
050,18,181,"Indiana","White County",2,2,301,140,161
050,18,181,"Indiana","White County",2,3,310,149,161
050,18,181,"Indiana","White County",2,4,331,172,159
050,18,181,"Indiana","White County",2,5,300,156,144
050,18,181,"Indiana","White County",2,6,316,154,162
050,18,181,"Indiana","White County",2,7,332,171,161
050,18,181,"Indiana","White County",2,8,332,174,158
050,18,181,"Indiana","White County",2,9,331,174,157
050,18,181,"Indiana","White County",2,10,328,172,156
050,18,181,"Indiana","White County",2,11,335,171,164
050,18,181,"Indiana","White County",2,12,326,170,156
050,18,181,"Indiana","White County",2,13,328,167,161
050,18,181,"Indiana","White County",2,14,355,189,166
050,18,181,"Indiana","White County",2,15,341,183,158
050,18,181,"Indiana","White County",2,16,341,186,155
050,18,181,"Indiana","White County",2,17,365,201,164
050,18,181,"Indiana","White County",2,18,322,176,146
050,18,181,"Indiana","White County",2,19,254,140,114
050,18,181,"Indiana","White County",2,20,263,140,123
050,18,181,"Indiana","White County",2,21,259,135,124
050,18,181,"Indiana","White County",2,22,259,140,119
050,18,181,"Indiana","White County",2,23,245,129,116
050,18,181,"Indiana","White County",2,24,255,125,130
050,18,181,"Indiana","White County",2,25,283,140,143
050,18,181,"Indiana","White County",2,26,290,156,134
050,18,181,"Indiana","White County",2,27,271,145,126
050,18,181,"Indiana","White County",2,28,285,145,140
050,18,181,"Indiana","White County",2,29,297,152,145
050,18,181,"Indiana","White County",2,30,289,146,143
050,18,181,"Indiana","White County",2,31,267,131,136
050,18,181,"Indiana","White County",2,32,252,128,124
050,18,181,"Indiana","White County",2,33,248,120,128
050,18,181,"Indiana","White County",2,34,248,122,126
050,18,181,"Indiana","White County",2,35,254,128,126
050,18,181,"Indiana","White County",2,36,255,132,123
050,18,181,"Indiana","White County",2,37,261,139,122
050,18,181,"Indiana","White County",2,38,255,128,127
050,18,181,"Indiana","White County",2,39,267,135,132
050,18,181,"Indiana","White County",2,40,275,133,142
050,18,181,"Indiana","White County",2,41,269,129,140
050,18,181,"Indiana","White County",2,42,287,144,143
050,18,181,"Indiana","White County",2,43,281,135,146
050,18,181,"Indiana","White County",2,44,263,128,135
050,18,181,"Indiana","White County",2,45,261,136,125
050,18,181,"Indiana","White County",2,46,271,143,128
050,18,181,"Indiana","White County",2,47,293,148,145
050,18,181,"Indiana","White County",2,48,297,156,141
050,18,181,"Indiana","White County",2,49,335,184,151
050,18,181,"Indiana","White County",2,50,349,192,157
050,18,181,"Indiana","White County",2,51,328,167,161
050,18,181,"Indiana","White County",2,52,300,148,152
050,18,181,"Indiana","White County",2,53,283,141,142
050,18,181,"Indiana","White County",2,54,284,134,150
050,18,181,"Indiana","White County",2,55,312,154,158
050,18,181,"Indiana","White County",2,56,344,165,179
050,18,181,"Indiana","White County",2,57,346,173,173
050,18,181,"Indiana","White County",2,58,362,184,178
050,18,181,"Indiana","White County",2,59,366,189,177
050,18,181,"Indiana","White County",2,60,364,188,176
050,18,181,"Indiana","White County",2,61,359,179,180
050,18,181,"Indiana","White County",2,62,373,180,193
050,18,181,"Indiana","White County",2,63,386,190,196
050,18,181,"Indiana","White County",2,64,366,173,193
050,18,181,"Indiana","White County",2,65,355,175,180
050,18,181,"Indiana","White County",2,66,339,163,176
050,18,181,"Indiana","White County",2,67,325,160,165
050,18,181,"Indiana","White County",2,68,332,167,165
050,18,181,"Indiana","White County",2,69,322,156,166
050,18,181,"Indiana","White County",2,70,296,147,149
050,18,181,"Indiana","White County",2,71,274,138,136
050,18,181,"Indiana","White County",2,72,265,131,134
050,18,181,"Indiana","White County",2,73,300,149,151
050,18,181,"Indiana","White County",2,74,209,97,112
050,18,181,"Indiana","White County",2,75,211,104,107
050,18,181,"Indiana","White County",2,76,189,94,95
050,18,181,"Indiana","White County",2,77,180,82,98
050,18,181,"Indiana","White County",2,78,146,64,82
050,18,181,"Indiana","White County",2,79,123,58,65
050,18,181,"Indiana","White County",2,80,131,58,73
050,18,181,"Indiana","White County",2,81,127,59,68
050,18,181,"Indiana","White County",2,82,108,46,62
050,18,181,"Indiana","White County",2,83,101,41,60
050,18,181,"Indiana","White County",2,84,99,43,56
050,18,181,"Indiana","White County",2,85,556,216,340
050,18,181,"Indiana","White County",3,0,252,129,123
050,18,181,"Indiana","White County",3,1,292,164,128
050,18,181,"Indiana","White County",3,2,286,148,138
050,18,181,"Indiana","White County",3,3,288,130,158
050,18,181,"Indiana","White County",3,4,301,141,160
050,18,181,"Indiana","White County",3,5,327,168,159
050,18,181,"Indiana","White County",3,6,304,158,146
050,18,181,"Indiana","White County",3,7,316,152,164
050,18,181,"Indiana","White County",3,8,328,172,156
050,18,181,"Indiana","White County",3,9,341,173,168
050,18,181,"Indiana","White County",3,10,337,170,167
050,18,181,"Indiana","White County",3,11,318,171,147
050,18,181,"Indiana","White County",3,12,333,163,170
050,18,181,"Indiana","White County",3,13,322,173,149
050,18,181,"Indiana","White County",3,14,324,165,159
050,18,181,"Indiana","White County",3,15,348,180,168
050,18,181,"Indiana","White County",3,16,338,184,154
050,18,181,"Indiana","White County",3,17,339,186,153
050,18,181,"Indiana","White County",3,18,308,180,128
050,18,181,"Indiana","White County",3,19,260,147,113
050,18,181,"Indiana","White County",3,20,269,151,118
050,18,181,"Indiana","White County",3,21,273,135,138
050,18,181,"Indiana","White County",3,22,281,142,139
050,18,181,"Indiana","White County",3,23,248,143,105
050,18,181,"Indiana","White County",3,24,232,129,103
050,18,181,"Indiana","White County",3,25,258,120,138
050,18,181,"Indiana","White County",3,26,278,134,144
050,18,181,"Indiana","White County",3,27,295,156,139
050,18,181,"Indiana","White County",3,28,276,152,124
050,18,181,"Indiana","White County",3,29,279,142,137
050,18,181,"Indiana","White County",3,30,284,144,140
050,18,181,"Indiana","White County",3,31,274,139,135
050,18,181,"Indiana","White County",3,32,283,139,144
050,18,181,"Indiana","White County",3,33,268,141,127
050,18,181,"Indiana","White County",3,34,249,115,134
050,18,181,"Indiana","White County",3,35,241,115,126
050,18,181,"Indiana","White County",3,36,257,127,130
050,18,181,"Indiana","White County",3,37,269,138,131
050,18,181,"Indiana","White County",3,38,269,142,127
050,18,181,"Indiana","White County",3,39,250,124,126
050,18,181,"Indiana","White County",3,40,277,141,136
050,18,181,"Indiana","White County",3,41,281,143,138
050,18,181,"Indiana","White County",3,42,265,128,137
050,18,181,"Indiana","White County",3,43,294,149,145
050,18,181,"Indiana","White County",3,44,263,125,138
050,18,181,"Indiana","White County",3,45,272,135,137
050,18,181,"Indiana","White County",3,46,276,145,131
050,18,181,"Indiana","White County",3,47,275,145,130
050,18,181,"Indiana","White County",3,48,292,149,143
050,18,181,"Indiana","White County",3,49,305,159,146
050,18,181,"Indiana","White County",3,50,332,176,156
050,18,181,"Indiana","White County",3,51,347,186,161
050,18,181,"Indiana","White County",3,52,336,176,160
050,18,181,"Indiana","White County",3,53,296,143,153
050,18,181,"Indiana","White County",3,54,278,143,135
050,18,181,"Indiana","White County",3,55,288,137,151
050,18,181,"Indiana","White County",3,56,310,154,156
050,18,181,"Indiana","White County",3,57,354,171,183
050,18,181,"Indiana","White County",3,58,350,169,181
050,18,181,"Indiana","White County",3,59,363,180,183
050,18,181,"Indiana","White County",3,60,368,187,181
050,18,181,"Indiana","White County",3,61,368,185,183
050,18,181,"Indiana","White County",3,62,357,179,178
050,18,181,"Indiana","White County",3,63,374,178,196
050,18,181,"Indiana","White County",3,64,378,185,193
050,18,181,"Indiana","White County",3,65,359,177,182
050,18,181,"Indiana","White County",3,66,357,174,183
050,18,181,"Indiana","White County",3,67,332,159,173
050,18,181,"Indiana","White County",3,68,329,164,165
050,18,181,"Indiana","White County",3,69,339,163,176
050,18,181,"Indiana","White County",3,70,317,154,163
050,18,181,"Indiana","White County",3,71,284,140,144
050,18,181,"Indiana","White County",3,72,274,137,137
050,18,181,"Indiana","White County",3,73,255,125,130
050,18,181,"Indiana","White County",3,74,297,150,147
050,18,181,"Indiana","White County",3,75,198,92,106
050,18,181,"Indiana","White County",3,76,199,92,107
050,18,181,"Indiana","White County",3,77,186,90,96
050,18,181,"Indiana","White County",3,78,174,83,91
050,18,181,"Indiana","White County",3,79,134,54,80
050,18,181,"Indiana","White County",3,80,118,54,64
050,18,181,"Indiana","White County",3,81,125,60,65
050,18,181,"Indiana","White County",3,82,119,54,65
050,18,181,"Indiana","White County",3,83,103,42,61
050,18,181,"Indiana","White County",3,84,95,41,54
050,18,181,"Indiana","White County",3,85,555,200,355
050,18,181,"Indiana","White County",4,0,330,166,164
050,18,181,"Indiana","White County",4,1,252,128,124
050,18,181,"Indiana","White County",4,2,287,160,127
050,18,181,"Indiana","White County",4,3,292,150,142
050,18,181,"Indiana","White County",4,4,296,139,157
050,18,181,"Indiana","White County",4,5,308,145,163
050,18,181,"Indiana","White County",4,6,328,164,164
050,18,181,"Indiana","White County",4,7,288,154,134
050,18,181,"Indiana","White County",4,8,312,138,174
050,18,181,"Indiana","White County",4,9,322,171,151
050,18,181,"Indiana","White County",4,10,354,184,170
050,18,181,"Indiana","White County",4,11,330,160,170
050,18,181,"Indiana","White County",4,12,325,171,154
050,18,181,"Indiana","White County",4,13,342,173,169
050,18,181,"Indiana","White County",4,14,323,171,152
050,18,181,"Indiana","White County",4,15,331,167,164
050,18,181,"Indiana","White County",4,16,366,198,168
050,18,181,"Indiana","White County",4,17,359,196,163
050,18,181,"Indiana","White County",4,18,296,173,123
050,18,181,"Indiana","White County",4,19,256,158,98
050,18,181,"Indiana","White County",4,20,270,149,121
050,18,181,"Indiana","White County",4,21,263,146,117
050,18,181,"Indiana","White County",4,22,268,133,135
050,18,181,"Indiana","White County",4,23,283,146,137
050,18,181,"Indiana","White County",4,24,241,138,103
050,18,181,"Indiana","White County",4,25,228,112,116
050,18,181,"Indiana","White County",4,26,263,124,139
050,18,181,"Indiana","White County",4,27,266,125,141
050,18,181,"Indiana","White County",4,28,271,143,128
050,18,181,"Indiana","White County",4,29,274,160,114
050,18,181,"Indiana","White County",4,30,275,137,138
050,18,181,"Indiana","White County",4,31,277,138,139
050,18,181,"Indiana","White County",4,32,278,143,135
050,18,181,"Indiana","White County",4,33,288,147,141
050,18,181,"Indiana","White County",4,34,267,139,128
050,18,181,"Indiana","White County",4,35,242,112,130
050,18,181,"Indiana","White County",4,36,252,121,131
050,18,181,"Indiana","White County",4,37,257,128,129
050,18,181,"Indiana","White County",4,38,271,142,129
050,18,181,"Indiana","White County",4,39,258,130,128
050,18,181,"Indiana","White County",4,40,262,127,135
050,18,181,"Indiana","White County",4,41,283,139,144
050,18,181,"Indiana","White County",4,42,301,153,148
050,18,181,"Indiana","White County",4,43,280,143,137
050,18,181,"Indiana","White County",4,44,281,135,146
050,18,181,"Indiana","White County",4,45,267,128,139
050,18,181,"Indiana","White County",4,46,270,132,138
050,18,181,"Indiana","White County",4,47,279,147,132
050,18,181,"Indiana","White County",4,48,281,150,131
050,18,181,"Indiana","White County",4,49,293,151,142
050,18,181,"Indiana","White County",4,50,306,162,144
050,18,181,"Indiana","White County",4,51,331,176,155
050,18,181,"Indiana","White County",4,52,343,185,158
050,18,181,"Indiana","White County",4,53,321,168,153
050,18,181,"Indiana","White County",4,54,294,143,151
050,18,181,"Indiana","White County",4,55,281,144,137
050,18,181,"Indiana","White County",4,56,275,131,144
050,18,181,"Indiana","White County",4,57,309,154,155
050,18,181,"Indiana","White County",4,58,347,166,181
050,18,181,"Indiana","White County",4,59,347,172,175
050,18,181,"Indiana","White County",4,60,367,187,180
050,18,181,"Indiana","White County",4,61,356,177,179
050,18,181,"Indiana","White County",4,62,365,186,179
050,18,181,"Indiana","White County",4,63,353,173,180
050,18,181,"Indiana","White County",4,64,369,175,194
050,18,181,"Indiana","White County",4,65,372,183,189
050,18,181,"Indiana","White County",4,66,345,168,177
050,18,181,"Indiana","White County",4,67,360,174,186
050,18,181,"Indiana","White County",4,68,327,156,171
050,18,181,"Indiana","White County",4,69,330,162,168
050,18,181,"Indiana","White County",4,70,325,152,173
050,18,181,"Indiana","White County",4,71,319,158,161
050,18,181,"Indiana","White County",4,72,284,138,146
050,18,181,"Indiana","White County",4,73,272,136,136
050,18,181,"Indiana","White County",4,74,240,120,120
050,18,181,"Indiana","White County",4,75,283,142,141
050,18,181,"Indiana","White County",4,76,189,84,105
050,18,181,"Indiana","White County",4,77,195,89,106
050,18,181,"Indiana","White County",4,78,178,89,89
050,18,181,"Indiana","White County",4,79,158,73,85
050,18,181,"Indiana","White County",4,80,131,50,81
050,18,181,"Indiana","White County",4,81,111,54,57
050,18,181,"Indiana","White County",4,82,115,52,63
050,18,181,"Indiana","White County",4,83,115,48,67
050,18,181,"Indiana","White County",4,84,101,43,58
050,18,181,"Indiana","White County",4,85,560,206,354
050,18,181,"Indiana","White County",5,0,425,216,209
050,18,181,"Indiana","White County",5,1,319,164,155
050,18,181,"Indiana","White County",5,2,289,154,135
050,18,181,"Indiana","White County",5,3,302,166,136
050,18,181,"Indiana","White County",5,4,309,160,149
050,18,181,"Indiana","White County",5,5,310,140,170
050,18,181,"Indiana","White County",5,6,311,139,172
050,18,181,"Indiana","White County",5,7,330,173,157
050,18,181,"Indiana","White County",5,8,304,152,152
050,18,181,"Indiana","White County",5,9,317,145,172
050,18,181,"Indiana","White County",5,10,335,171,164
050,18,181,"Indiana","White County",5,11,348,174,174
050,18,181,"Indiana","White County",5,12,331,164,167
050,18,181,"Indiana","White County",5,13,314,167,147
050,18,181,"Indiana","White County",5,14,337,168,169
050,18,181,"Indiana","White County",5,15,335,173,162
050,18,181,"Indiana","White County",5,16,325,158,167
050,18,181,"Indiana","White County",5,17,348,186,162
050,18,181,"Indiana","White County",5,18,315,178,137
050,18,181,"Indiana","White County",5,19,243,144,99
050,18,181,"Indiana","White County",5,20,281,173,108
050,18,181,"Indiana","White County",5,21,266,139,127
050,18,181,"Indiana","White County",5,22,273,148,125
050,18,181,"Indiana","White County",5,23,264,140,124
050,18,181,"Indiana","White County",5,24,284,143,141
050,18,181,"Indiana","White County",5,25,244,138,106
050,18,181,"Indiana","White County",5,26,233,114,119
050,18,181,"Indiana","White County",5,27,262,128,134
050,18,181,"Indiana","White County",5,28,271,128,143
050,18,181,"Indiana","White County",5,29,283,149,134
050,18,181,"Indiana","White County",5,30,274,162,112
050,18,181,"Indiana","White County",5,31,281,138,143
050,18,181,"Indiana","White County",5,32,281,131,150
050,18,181,"Indiana","White County",5,33,286,144,142
050,18,181,"Indiana","White County",5,34,283,141,142
050,18,181,"Indiana","White County",5,35,274,146,128
050,18,181,"Indiana","White County",5,36,252,126,126
050,18,181,"Indiana","White County",5,37,258,127,131
050,18,181,"Indiana","White County",5,38,258,128,130
050,18,181,"Indiana","White County",5,39,260,137,123
050,18,181,"Indiana","White County",5,40,260,138,122
050,18,181,"Indiana","White County",5,41,265,124,141
050,18,181,"Indiana","White County",5,42,288,142,146
050,18,181,"Indiana","White County",5,43,305,159,146
050,18,181,"Indiana","White County",5,44,273,137,136
050,18,181,"Indiana","White County",5,45,274,133,141
050,18,181,"Indiana","White County",5,46,269,125,144
050,18,181,"Indiana","White County",5,47,276,132,144
050,18,181,"Indiana","White County",5,48,281,150,131
050,18,181,"Indiana","White County",5,49,274,142,132
050,18,181,"Indiana","White County",5,50,285,148,137
050,18,181,"Indiana","White County",5,51,291,149,142
050,18,181,"Indiana","White County",5,52,340,183,157
050,18,181,"Indiana","White County",5,53,336,179,157
050,18,181,"Indiana","White County",5,54,316,168,148
050,18,181,"Indiana","White County",5,55,298,147,151
050,18,181,"Indiana","White County",5,56,282,142,140
050,18,181,"Indiana","White County",5,57,297,146,151
050,18,181,"Indiana","White County",5,58,310,150,160
050,18,181,"Indiana","White County",5,59,350,167,183
050,18,181,"Indiana","White County",5,60,354,172,182
050,18,181,"Indiana","White County",5,61,356,184,172
050,18,181,"Indiana","White County",5,62,342,170,172
050,18,181,"Indiana","White County",5,63,362,181,181
050,18,181,"Indiana","White County",5,64,349,172,177
050,18,181,"Indiana","White County",5,65,366,175,191
050,18,181,"Indiana","White County",5,66,360,173,187
050,18,181,"Indiana","White County",5,67,347,172,175
050,18,181,"Indiana","White County",5,68,361,173,188
050,18,181,"Indiana","White County",5,69,322,152,170
050,18,181,"Indiana","White County",5,70,325,156,169
050,18,181,"Indiana","White County",5,71,314,146,168
050,18,181,"Indiana","White County",5,72,318,156,162
050,18,181,"Indiana","White County",5,73,273,128,145
050,18,181,"Indiana","White County",5,74,265,131,134
050,18,181,"Indiana","White County",5,75,229,115,114
050,18,181,"Indiana","White County",5,76,277,136,141
050,18,181,"Indiana","White County",5,77,185,79,106
050,18,181,"Indiana","White County",5,78,191,90,101
050,18,181,"Indiana","White County",5,79,166,79,87
050,18,181,"Indiana","White County",5,80,153,67,86
050,18,181,"Indiana","White County",5,81,125,50,75
050,18,181,"Indiana","White County",5,82,102,48,54
050,18,181,"Indiana","White County",5,83,112,47,65
050,18,181,"Indiana","White County",5,84,102,46,56
050,18,181,"Indiana","White County",5,85,576,210,366
050,18,183,"Indiana","Whitley County",1,0,350,183,167
050,18,183,"Indiana","Whitley County",1,1,374,187,187
050,18,183,"Indiana","Whitley County",1,2,412,210,202
050,18,183,"Indiana","Whitley County",1,3,415,221,194
050,18,183,"Indiana","Whitley County",1,4,425,225,200
050,18,183,"Indiana","Whitley County",1,5,412,208,204
050,18,183,"Indiana","Whitley County",1,6,427,211,216
050,18,183,"Indiana","Whitley County",1,7,405,205,200
050,18,183,"Indiana","Whitley County",1,8,413,197,216
050,18,183,"Indiana","Whitley County",1,9,427,214,213
050,18,183,"Indiana","Whitley County",1,10,462,245,217
050,18,183,"Indiana","Whitley County",1,11,479,252,227
050,18,183,"Indiana","Whitley County",1,12,498,256,242
050,18,183,"Indiana","Whitley County",1,13,484,252,232
050,18,183,"Indiana","Whitley County",1,14,460,249,211
050,18,183,"Indiana","Whitley County",1,15,483,257,226
050,18,183,"Indiana","Whitley County",1,16,498,261,237
050,18,183,"Indiana","Whitley County",1,17,500,269,231
050,18,183,"Indiana","Whitley County",1,18,417,231,186
050,18,183,"Indiana","Whitley County",1,19,304,175,129
050,18,183,"Indiana","Whitley County",1,20,328,181,147
050,18,183,"Indiana","Whitley County",1,21,359,190,169
050,18,183,"Indiana","Whitley County",1,22,371,187,184
050,18,183,"Indiana","Whitley County",1,23,364,184,180
050,18,183,"Indiana","Whitley County",1,24,396,198,198
050,18,183,"Indiana","Whitley County",1,25,396,196,200
050,18,183,"Indiana","Whitley County",1,26,410,201,209
050,18,183,"Indiana","Whitley County",1,27,423,233,190
050,18,183,"Indiana","Whitley County",1,28,411,209,202
050,18,183,"Indiana","Whitley County",1,29,410,204,206
050,18,183,"Indiana","Whitley County",1,30,400,203,197
050,18,183,"Indiana","Whitley County",1,31,402,197,205
050,18,183,"Indiana","Whitley County",1,32,415,204,211
050,18,183,"Indiana","Whitley County",1,33,418,213,205
050,18,183,"Indiana","Whitley County",1,34,415,204,211
050,18,183,"Indiana","Whitley County",1,35,408,224,184
050,18,183,"Indiana","Whitley County",1,36,398,214,184
050,18,183,"Indiana","Whitley County",1,37,407,199,208
050,18,183,"Indiana","Whitley County",1,38,379,190,189
050,18,183,"Indiana","Whitley County",1,39,425,206,219
050,18,183,"Indiana","Whitley County",1,40,395,188,207
050,18,183,"Indiana","Whitley County",1,41,384,205,179
050,18,183,"Indiana","Whitley County",1,42,428,222,206
050,18,183,"Indiana","Whitley County",1,43,414,211,203
050,18,183,"Indiana","Whitley County",1,44,389,201,188
050,18,183,"Indiana","Whitley County",1,45,429,224,205
050,18,183,"Indiana","Whitley County",1,46,418,213,205
050,18,183,"Indiana","Whitley County",1,47,409,218,191
050,18,183,"Indiana","Whitley County",1,48,440,233,207
050,18,183,"Indiana","Whitley County",1,49,460,234,226
050,18,183,"Indiana","Whitley County",1,50,454,221,233
050,18,183,"Indiana","Whitley County",1,51,452,222,230
050,18,183,"Indiana","Whitley County",1,52,421,211,210
050,18,183,"Indiana","Whitley County",1,53,439,220,219
050,18,183,"Indiana","Whitley County",1,54,449,230,219
050,18,183,"Indiana","Whitley County",1,55,449,217,232
050,18,183,"Indiana","Whitley County",1,56,451,217,234
050,18,183,"Indiana","Whitley County",1,57,490,246,244
050,18,183,"Indiana","Whitley County",1,58,496,247,249
050,18,183,"Indiana","Whitley County",1,59,551,270,281
050,18,183,"Indiana","Whitley County",1,60,552,272,280
050,18,183,"Indiana","Whitley County",1,61,558,284,274
050,18,183,"Indiana","Whitley County",1,62,529,271,258
050,18,183,"Indiana","Whitley County",1,63,514,258,256
050,18,183,"Indiana","Whitley County",1,64,492,265,227
050,18,183,"Indiana","Whitley County",1,65,481,259,222
050,18,183,"Indiana","Whitley County",1,66,436,206,230
050,18,183,"Indiana","Whitley County",1,67,452,216,236
050,18,183,"Indiana","Whitley County",1,68,404,199,205
050,18,183,"Indiana","Whitley County",1,69,367,179,188
050,18,183,"Indiana","Whitley County",1,70,372,180,192
050,18,183,"Indiana","Whitley County",1,71,365,182,183
050,18,183,"Indiana","Whitley County",1,72,349,176,173
050,18,183,"Indiana","Whitley County",1,73,349,182,167
050,18,183,"Indiana","Whitley County",1,74,241,115,126
050,18,183,"Indiana","Whitley County",1,75,235,115,120
050,18,183,"Indiana","Whitley County",1,76,229,104,125
050,18,183,"Indiana","Whitley County",1,77,226,99,127
050,18,183,"Indiana","Whitley County",1,78,176,83,93
050,18,183,"Indiana","Whitley County",1,79,171,76,95
050,18,183,"Indiana","Whitley County",1,80,147,63,84
050,18,183,"Indiana","Whitley County",1,81,140,60,80
050,18,183,"Indiana","Whitley County",1,82,130,52,78
050,18,183,"Indiana","Whitley County",1,83,126,59,67
050,18,183,"Indiana","Whitley County",1,84,116,51,65
050,18,183,"Indiana","Whitley County",1,85,626,210,416
050,18,183,"Indiana","Whitley County",2,0,357,183,174
050,18,183,"Indiana","Whitley County",2,1,372,187,185
050,18,183,"Indiana","Whitley County",2,2,406,207,199
050,18,183,"Indiana","Whitley County",2,3,415,219,196
050,18,183,"Indiana","Whitley County",2,4,430,227,203
050,18,183,"Indiana","Whitley County",2,5,423,215,208
050,18,183,"Indiana","Whitley County",2,6,422,210,212
050,18,183,"Indiana","Whitley County",2,7,412,209,203
050,18,183,"Indiana","Whitley County",2,8,415,201,214
050,18,183,"Indiana","Whitley County",2,9,428,213,215
050,18,183,"Indiana","Whitley County",2,10,457,240,217
050,18,183,"Indiana","Whitley County",2,11,476,251,225
050,18,183,"Indiana","Whitley County",2,12,502,260,242
050,18,183,"Indiana","Whitley County",2,13,488,255,233
050,18,183,"Indiana","Whitley County",2,14,466,250,216
050,18,183,"Indiana","Whitley County",2,15,478,256,222
050,18,183,"Indiana","Whitley County",2,16,497,261,236
050,18,183,"Indiana","Whitley County",2,17,500,266,234
050,18,183,"Indiana","Whitley County",2,18,416,232,184
050,18,183,"Indiana","Whitley County",2,19,315,179,136
050,18,183,"Indiana","Whitley County",2,20,335,186,149
050,18,183,"Indiana","Whitley County",2,21,357,191,166
050,18,183,"Indiana","Whitley County",2,22,372,190,182
050,18,183,"Indiana","Whitley County",2,23,379,192,187
050,18,183,"Indiana","Whitley County",2,24,395,198,197
050,18,183,"Indiana","Whitley County",2,25,403,199,204
050,18,183,"Indiana","Whitley County",2,26,415,206,209
050,18,183,"Indiana","Whitley County",2,27,427,229,198
050,18,183,"Indiana","Whitley County",2,28,417,216,201
050,18,183,"Indiana","Whitley County",2,29,410,204,206
050,18,183,"Indiana","Whitley County",2,30,405,205,200
050,18,183,"Indiana","Whitley County",2,31,405,200,205
050,18,183,"Indiana","Whitley County",2,32,411,203,208
050,18,183,"Indiana","Whitley County",2,33,419,212,207
050,18,183,"Indiana","Whitley County",2,34,420,206,214
050,18,183,"Indiana","Whitley County",2,35,416,224,192
050,18,183,"Indiana","Whitley County",2,36,397,213,184
050,18,183,"Indiana","Whitley County",2,37,407,204,203
050,18,183,"Indiana","Whitley County",2,38,387,194,193
050,18,183,"Indiana","Whitley County",2,39,418,204,214
050,18,183,"Indiana","Whitley County",2,40,402,192,210
050,18,183,"Indiana","Whitley County",2,41,390,202,188
050,18,183,"Indiana","Whitley County",2,42,416,217,199
050,18,183,"Indiana","Whitley County",2,43,419,215,204
050,18,183,"Indiana","Whitley County",2,44,391,201,190
050,18,183,"Indiana","Whitley County",2,45,423,219,204
050,18,183,"Indiana","Whitley County",2,46,417,213,204
050,18,183,"Indiana","Whitley County",2,47,414,218,196
050,18,183,"Indiana","Whitley County",2,48,434,229,205
050,18,183,"Indiana","Whitley County",2,49,459,235,224
050,18,183,"Indiana","Whitley County",2,50,455,223,232
050,18,183,"Indiana","Whitley County",2,51,455,223,232
050,18,183,"Indiana","Whitley County",2,52,427,212,215
050,18,183,"Indiana","Whitley County",2,53,437,218,219
050,18,183,"Indiana","Whitley County",2,54,448,230,218
050,18,183,"Indiana","Whitley County",2,55,451,220,231
050,18,183,"Indiana","Whitley County",2,56,452,218,234
050,18,183,"Indiana","Whitley County",2,57,484,241,243
050,18,183,"Indiana","Whitley County",2,58,492,245,247
050,18,183,"Indiana","Whitley County",2,59,543,269,274
050,18,183,"Indiana","Whitley County",2,60,549,269,280
050,18,183,"Indiana","Whitley County",2,61,555,280,275
050,18,183,"Indiana","Whitley County",2,62,532,270,262
050,18,183,"Indiana","Whitley County",2,63,520,263,257
050,18,183,"Indiana","Whitley County",2,64,493,261,232
050,18,183,"Indiana","Whitley County",2,65,482,259,223
050,18,183,"Indiana","Whitley County",2,66,449,219,230
050,18,183,"Indiana","Whitley County",2,67,446,213,233
050,18,183,"Indiana","Whitley County",2,68,413,202,211
050,18,183,"Indiana","Whitley County",2,69,380,186,194
050,18,183,"Indiana","Whitley County",2,70,368,178,190
050,18,183,"Indiana","Whitley County",2,71,369,184,185
050,18,183,"Indiana","Whitley County",2,72,344,173,171
050,18,183,"Indiana","Whitley County",2,73,368,190,178
050,18,183,"Indiana","Whitley County",2,74,246,121,125
050,18,183,"Indiana","Whitley County",2,75,236,115,121
050,18,183,"Indiana","Whitley County",2,76,228,106,122
050,18,183,"Indiana","Whitley County",2,77,231,102,129
050,18,183,"Indiana","Whitley County",2,78,183,84,99
050,18,183,"Indiana","Whitley County",2,79,171,77,94
050,18,183,"Indiana","Whitley County",2,80,150,65,85
050,18,183,"Indiana","Whitley County",2,81,138,60,78
050,18,183,"Indiana","Whitley County",2,82,136,55,81
050,18,183,"Indiana","Whitley County",2,83,120,54,66
050,18,183,"Indiana","Whitley County",2,84,119,54,65
050,18,183,"Indiana","Whitley County",2,85,624,210,414
050,18,183,"Indiana","Whitley County",3,0,351,173,178
050,18,183,"Indiana","Whitley County",3,1,375,194,181
050,18,183,"Indiana","Whitley County",3,2,381,193,188
050,18,183,"Indiana","Whitley County",3,3,418,209,209
050,18,183,"Indiana","Whitley County",3,4,429,226,203
050,18,183,"Indiana","Whitley County",3,5,446,238,208
050,18,183,"Indiana","Whitley County",3,6,432,218,214
050,18,183,"Indiana","Whitley County",3,7,431,215,216
050,18,183,"Indiana","Whitley County",3,8,426,215,211
050,18,183,"Indiana","Whitley County",3,9,428,204,224
050,18,183,"Indiana","Whitley County",3,10,425,218,207
050,18,183,"Indiana","Whitley County",3,11,459,239,220
050,18,183,"Indiana","Whitley County",3,12,488,249,239
050,18,183,"Indiana","Whitley County",3,13,496,254,242
050,18,183,"Indiana","Whitley County",3,14,494,255,239
050,18,183,"Indiana","Whitley County",3,15,466,251,215
050,18,183,"Indiana","Whitley County",3,16,478,255,223
050,18,183,"Indiana","Whitley County",3,17,491,256,235
050,18,183,"Indiana","Whitley County",3,18,429,234,195
050,18,183,"Indiana","Whitley County",3,19,324,177,147
050,18,183,"Indiana","Whitley County",3,20,335,182,153
050,18,183,"Indiana","Whitley County",3,21,355,194,161
050,18,183,"Indiana","Whitley County",3,22,367,203,164
050,18,183,"Indiana","Whitley County",3,23,399,212,187
050,18,183,"Indiana","Whitley County",3,24,373,177,196
050,18,183,"Indiana","Whitley County",3,25,391,196,195
050,18,183,"Indiana","Whitley County",3,26,420,203,217
050,18,183,"Indiana","Whitley County",3,27,418,207,211
050,18,183,"Indiana","Whitley County",3,28,437,238,199
050,18,183,"Indiana","Whitley County",3,29,424,214,210
050,18,183,"Indiana","Whitley County",3,30,413,204,209
050,18,183,"Indiana","Whitley County",3,31,421,216,205
050,18,183,"Indiana","Whitley County",3,32,402,194,208
050,18,183,"Indiana","Whitley County",3,33,415,208,207
050,18,183,"Indiana","Whitley County",3,34,425,212,213
050,18,183,"Indiana","Whitley County",3,35,427,217,210
050,18,183,"Indiana","Whitley County",3,36,410,216,194
050,18,183,"Indiana","Whitley County",3,37,396,213,183
050,18,183,"Indiana","Whitley County",3,38,413,205,208
050,18,183,"Indiana","Whitley County",3,39,393,197,196
050,18,183,"Indiana","Whitley County",3,40,414,208,206
050,18,183,"Indiana","Whitley County",3,41,399,187,212
050,18,183,"Indiana","Whitley County",3,42,397,202,195
050,18,183,"Indiana","Whitley County",3,43,402,210,192
050,18,183,"Indiana","Whitley County",3,44,416,217,199
050,18,183,"Indiana","Whitley County",3,45,403,207,196
050,18,183,"Indiana","Whitley County",3,46,418,223,195
050,18,183,"Indiana","Whitley County",3,47,424,216,208
050,18,183,"Indiana","Whitley County",3,48,404,215,189
050,18,183,"Indiana","Whitley County",3,49,443,232,211
050,18,183,"Indiana","Whitley County",3,50,458,232,226
050,18,183,"Indiana","Whitley County",3,51,462,229,233
050,18,183,"Indiana","Whitley County",3,52,454,223,231
050,18,183,"Indiana","Whitley County",3,53,428,215,213
050,18,183,"Indiana","Whitley County",3,54,436,215,221
050,18,183,"Indiana","Whitley County",3,55,454,231,223
050,18,183,"Indiana","Whitley County",3,56,439,214,225
050,18,183,"Indiana","Whitley County",3,57,453,221,232
050,18,183,"Indiana","Whitley County",3,58,474,232,242
050,18,183,"Indiana","Whitley County",3,59,494,249,245
050,18,183,"Indiana","Whitley County",3,60,530,265,265
050,18,183,"Indiana","Whitley County",3,61,532,265,267
050,18,183,"Indiana","Whitley County",3,62,556,272,284
050,18,183,"Indiana","Whitley County",3,63,530,267,263
050,18,183,"Indiana","Whitley County",3,64,503,250,253
050,18,183,"Indiana","Whitley County",3,65,501,264,237
050,18,183,"Indiana","Whitley County",3,66,486,262,224
050,18,183,"Indiana","Whitley County",3,67,451,217,234
050,18,183,"Indiana","Whitley County",3,68,432,205,227
050,18,183,"Indiana","Whitley County",3,69,400,195,205
050,18,183,"Indiana","Whitley County",3,70,372,178,194
050,18,183,"Indiana","Whitley County",3,71,358,173,185
050,18,183,"Indiana","Whitley County",3,72,359,176,183
050,18,183,"Indiana","Whitley County",3,73,327,162,165
050,18,183,"Indiana","Whitley County",3,74,364,185,179
050,18,183,"Indiana","Whitley County",3,75,240,118,122
050,18,183,"Indiana","Whitley County",3,76,233,116,117
050,18,183,"Indiana","Whitley County",3,77,216,96,120
050,18,183,"Indiana","Whitley County",3,78,216,96,120
050,18,183,"Indiana","Whitley County",3,79,171,79,92
050,18,183,"Indiana","Whitley County",3,80,160,70,90
050,18,183,"Indiana","Whitley County",3,81,141,62,79
050,18,183,"Indiana","Whitley County",3,82,131,56,75
050,18,183,"Indiana","Whitley County",3,83,126,51,75
050,18,183,"Indiana","Whitley County",3,84,115,53,62
050,18,183,"Indiana","Whitley County",3,85,647,227,420
050,18,183,"Indiana","Whitley County",4,0,367,198,169
050,18,183,"Indiana","Whitley County",4,1,363,181,182
050,18,183,"Indiana","Whitley County",4,2,387,202,185
050,18,183,"Indiana","Whitley County",4,3,381,191,190
050,18,183,"Indiana","Whitley County",4,4,414,207,207
050,18,183,"Indiana","Whitley County",4,5,442,237,205
050,18,183,"Indiana","Whitley County",4,6,459,243,216
050,18,183,"Indiana","Whitley County",4,7,439,220,219
050,18,183,"Indiana","Whitley County",4,8,448,225,223
050,18,183,"Indiana","Whitley County",4,9,427,222,205
050,18,183,"Indiana","Whitley County",4,10,445,211,234
050,18,183,"Indiana","Whitley County",4,11,441,221,220
050,18,183,"Indiana","Whitley County",4,12,462,239,223
050,18,183,"Indiana","Whitley County",4,13,492,249,243
050,18,183,"Indiana","Whitley County",4,14,499,256,243
050,18,183,"Indiana","Whitley County",4,15,496,263,233
050,18,183,"Indiana","Whitley County",4,16,465,249,216
050,18,183,"Indiana","Whitley County",4,17,483,258,225
050,18,183,"Indiana","Whitley County",4,18,405,215,190
050,18,183,"Indiana","Whitley County",4,19,336,183,153
050,18,183,"Indiana","Whitley County",4,20,332,186,146
050,18,183,"Indiana","Whitley County",4,21,337,184,153
050,18,183,"Indiana","Whitley County",4,22,384,205,179
050,18,183,"Indiana","Whitley County",4,23,368,206,162
050,18,183,"Indiana","Whitley County",4,24,405,227,178
050,18,183,"Indiana","Whitley County",4,25,378,184,194
050,18,183,"Indiana","Whitley County",4,26,386,195,191
050,18,183,"Indiana","Whitley County",4,27,406,189,217
050,18,183,"Indiana","Whitley County",4,28,425,211,214
050,18,183,"Indiana","Whitley County",4,29,424,235,189
050,18,183,"Indiana","Whitley County",4,30,422,216,206
050,18,183,"Indiana","Whitley County",4,31,440,216,224
050,18,183,"Indiana","Whitley County",4,32,419,211,208
050,18,183,"Indiana","Whitley County",4,33,397,189,208
050,18,183,"Indiana","Whitley County",4,34,426,212,214
050,18,183,"Indiana","Whitley County",4,35,427,214,213
050,18,183,"Indiana","Whitley County",4,36,424,212,212
050,18,183,"Indiana","Whitley County",4,37,426,226,200
050,18,183,"Indiana","Whitley County",4,38,388,207,181
050,18,183,"Indiana","Whitley County",4,39,427,213,214
050,18,183,"Indiana","Whitley County",4,40,382,197,185
050,18,183,"Indiana","Whitley County",4,41,417,209,208
050,18,183,"Indiana","Whitley County",4,42,405,188,217
050,18,183,"Indiana","Whitley County",4,43,408,216,192
050,18,183,"Indiana","Whitley County",4,44,403,210,193
050,18,183,"Indiana","Whitley County",4,45,414,219,195
050,18,183,"Indiana","Whitley County",4,46,402,211,191
050,18,183,"Indiana","Whitley County",4,47,436,231,205
050,18,183,"Indiana","Whitley County",4,48,418,217,201
050,18,183,"Indiana","Whitley County",4,49,403,219,184
050,18,183,"Indiana","Whitley County",4,50,434,223,211
050,18,183,"Indiana","Whitley County",4,51,460,231,229
050,18,183,"Indiana","Whitley County",4,52,471,228,243
050,18,183,"Indiana","Whitley County",4,53,447,215,232
050,18,183,"Indiana","Whitley County",4,54,418,208,210
050,18,183,"Indiana","Whitley County",4,55,435,214,221
050,18,183,"Indiana","Whitley County",4,56,445,226,219
050,18,183,"Indiana","Whitley County",4,57,444,221,223
050,18,183,"Indiana","Whitley County",4,58,462,232,230
050,18,183,"Indiana","Whitley County",4,59,485,237,248
050,18,183,"Indiana","Whitley County",4,60,488,246,242
050,18,183,"Indiana","Whitley County",4,61,526,266,260
050,18,183,"Indiana","Whitley County",4,62,526,262,264
050,18,183,"Indiana","Whitley County",4,63,561,277,284
050,18,183,"Indiana","Whitley County",4,64,533,267,266
050,18,183,"Indiana","Whitley County",4,65,498,245,253
050,18,183,"Indiana","Whitley County",4,66,496,263,233
050,18,183,"Indiana","Whitley County",4,67,478,254,224
050,18,183,"Indiana","Whitley County",4,68,443,212,231
050,18,183,"Indiana","Whitley County",4,69,424,201,223
050,18,183,"Indiana","Whitley County",4,70,397,193,204
050,18,183,"Indiana","Whitley County",4,71,356,168,188
050,18,183,"Indiana","Whitley County",4,72,349,168,181
050,18,183,"Indiana","Whitley County",4,73,339,162,177
050,18,183,"Indiana","Whitley County",4,74,317,153,164
050,18,183,"Indiana","Whitley County",4,75,350,179,171
050,18,183,"Indiana","Whitley County",4,76,236,110,126
050,18,183,"Indiana","Whitley County",4,77,225,107,118
050,18,183,"Indiana","Whitley County",4,78,212,99,113
050,18,183,"Indiana","Whitley County",4,79,203,88,115
050,18,183,"Indiana","Whitley County",4,80,167,74,93
050,18,183,"Indiana","Whitley County",4,81,147,69,78
050,18,183,"Indiana","Whitley County",4,82,137,60,77
050,18,183,"Indiana","Whitley County",4,83,117,51,66
050,18,183,"Indiana","Whitley County",4,84,117,50,67
050,18,183,"Indiana","Whitley County",4,85,654,233,421
050,18,183,"Indiana","Whitley County",5,0,374,201,173
050,18,183,"Indiana","Whitley County",5,1,387,198,189
050,18,183,"Indiana","Whitley County",5,2,366,189,177
050,18,183,"Indiana","Whitley County",5,3,377,184,193
050,18,183,"Indiana","Whitley County",5,4,400,205,195
050,18,183,"Indiana","Whitley County",5,5,421,211,210
050,18,183,"Indiana","Whitley County",5,6,450,240,210
050,18,183,"Indiana","Whitley County",5,7,462,244,218
050,18,183,"Indiana","Whitley County",5,8,433,222,211
050,18,183,"Indiana","Whitley County",5,9,462,237,225
050,18,183,"Indiana","Whitley County",5,10,430,222,208
050,18,183,"Indiana","Whitley County",5,11,448,203,245
050,18,183,"Indiana","Whitley County",5,12,436,218,218
050,18,183,"Indiana","Whitley County",5,13,471,243,228
050,18,183,"Indiana","Whitley County",5,14,495,257,238
050,18,183,"Indiana","Whitley County",5,15,497,259,238
050,18,183,"Indiana","Whitley County",5,16,500,255,245
050,18,183,"Indiana","Whitley County",5,17,468,256,212
050,18,183,"Indiana","Whitley County",5,18,407,222,185
050,18,183,"Indiana","Whitley County",5,19,315,169,146
050,18,183,"Indiana","Whitley County",5,20,379,210,169
050,18,183,"Indiana","Whitley County",5,21,364,197,167
050,18,183,"Indiana","Whitley County",5,22,365,194,171
050,18,183,"Indiana","Whitley County",5,23,423,230,193
050,18,183,"Indiana","Whitley County",5,24,392,212,180
050,18,183,"Indiana","Whitley County",5,25,397,217,180
050,18,183,"Indiana","Whitley County",5,26,369,185,184
050,18,183,"Indiana","Whitley County",5,27,391,188,203
050,18,183,"Indiana","Whitley County",5,28,412,188,224
050,18,183,"Indiana","Whitley County",5,29,443,216,227
050,18,183,"Indiana","Whitley County",5,30,435,250,185
050,18,183,"Indiana","Whitley County",5,31,423,216,207
050,18,183,"Indiana","Whitley County",5,32,443,214,229
050,18,183,"Indiana","Whitley County",5,33,414,211,203
050,18,183,"Indiana","Whitley County",5,34,401,187,214
050,18,183,"Indiana","Whitley County",5,35,447,229,218
050,18,183,"Indiana","Whitley County",5,36,428,214,214
050,18,183,"Indiana","Whitley County",5,37,451,229,222
050,18,183,"Indiana","Whitley County",5,38,421,225,196
050,18,183,"Indiana","Whitley County",5,39,397,210,187
050,18,183,"Indiana","Whitley County",5,40,424,218,206
050,18,183,"Indiana","Whitley County",5,41,373,189,184
050,18,183,"Indiana","Whitley County",5,42,420,201,219
050,18,183,"Indiana","Whitley County",5,43,410,190,220
050,18,183,"Indiana","Whitley County",5,44,415,222,193
050,18,183,"Indiana","Whitley County",5,45,399,208,191
050,18,183,"Indiana","Whitley County",5,46,417,221,196
050,18,183,"Indiana","Whitley County",5,47,402,212,190
050,18,183,"Indiana","Whitley County",5,48,427,224,203
050,18,183,"Indiana","Whitley County",5,49,422,218,204
050,18,183,"Indiana","Whitley County",5,50,402,213,189
050,18,183,"Indiana","Whitley County",5,51,432,228,204
050,18,183,"Indiana","Whitley County",5,52,449,224,225
050,18,183,"Indiana","Whitley County",5,53,471,224,247
050,18,183,"Indiana","Whitley County",5,54,442,218,224
050,18,183,"Indiana","Whitley County",5,55,418,203,215
050,18,183,"Indiana","Whitley County",5,56,437,216,221
050,18,183,"Indiana","Whitley County",5,57,458,234,224
050,18,183,"Indiana","Whitley County",5,58,441,222,219
050,18,183,"Indiana","Whitley County",5,59,455,224,231
050,18,183,"Indiana","Whitley County",5,60,466,230,236
050,18,183,"Indiana","Whitley County",5,61,470,244,226
050,18,183,"Indiana","Whitley County",5,62,505,257,248
050,18,183,"Indiana","Whitley County",5,63,523,266,257
050,18,183,"Indiana","Whitley County",5,64,550,269,281
050,18,183,"Indiana","Whitley County",5,65,530,267,263
050,18,183,"Indiana","Whitley County",5,66,501,249,252
050,18,183,"Indiana","Whitley County",5,67,486,258,228
050,18,183,"Indiana","Whitley County",5,68,469,251,218
050,18,183,"Indiana","Whitley County",5,69,439,210,229
050,18,183,"Indiana","Whitley County",5,70,416,194,222
050,18,183,"Indiana","Whitley County",5,71,389,184,205
050,18,183,"Indiana","Whitley County",5,72,336,156,180
050,18,183,"Indiana","Whitley County",5,73,332,157,175
050,18,183,"Indiana","Whitley County",5,74,329,155,174
050,18,183,"Indiana","Whitley County",5,75,305,147,158
050,18,183,"Indiana","Whitley County",5,76,342,173,169
050,18,183,"Indiana","Whitley County",5,77,222,101,121
050,18,183,"Indiana","Whitley County",5,78,220,106,114
050,18,183,"Indiana","Whitley County",5,79,197,90,107
050,18,183,"Indiana","Whitley County",5,80,193,79,114
050,18,183,"Indiana","Whitley County",5,81,153,71,82
050,18,183,"Indiana","Whitley County",5,82,143,66,77
050,18,183,"Indiana","Whitley County",5,83,126,54,72
050,18,183,"Indiana","Whitley County",5,84,109,49,60
050,18,183,"Indiana","Whitley County",5,85,683,248,435

