"SUMLEV","STATE","COUNTY","STNAME","CTYNAME","YEAR","AGE","TOT_POP","TOT_MALE","TOT_FEMALE"
050,32,001,"Nevada","Churchill County",1,0,343,175,168
050,32,001,"Nevada","Churchill County",1,1,339,167,172
050,32,001,"Nevada","Churchill County",1,2,329,147,182
050,32,001,"Nevada","Churchill County",1,3,328,176,152
050,32,001,"Nevada","Churchill County",1,4,333,182,151
050,32,001,"Nevada","Churchill County",1,5,312,159,153
050,32,001,"Nevada","Churchill County",1,6,339,158,181
050,32,001,"Nevada","Churchill County",1,7,324,159,165
050,32,001,"Nevada","Churchill County",1,8,336,174,162
050,32,001,"Nevada","Churchill County",1,9,312,157,155
050,32,001,"Nevada","Churchill County",1,10,311,168,143
050,32,001,"Nevada","Churchill County",1,11,343,186,157
050,32,001,"Nevada","Churchill County",1,12,351,185,166
050,32,001,"Nevada","Churchill County",1,13,310,169,141
050,32,001,"Nevada","Churchill County",1,14,315,163,152
050,32,001,"Nevada","Churchill County",1,15,291,154,137
050,32,001,"Nevada","Churchill County",1,16,312,157,155
050,32,001,"Nevada","Churchill County",1,17,323,162,161
050,32,001,"Nevada","Churchill County",1,18,276,145,131
050,32,001,"Nevada","Churchill County",1,19,248,131,117
050,32,001,"Nevada","Churchill County",1,20,283,147,136
050,32,001,"Nevada","Churchill County",1,21,277,154,123
050,32,001,"Nevada","Churchill County",1,22,282,154,128
050,32,001,"Nevada","Churchill County",1,23,284,155,129
050,32,001,"Nevada","Churchill County",1,24,327,166,161
050,32,001,"Nevada","Churchill County",1,25,325,167,158
050,32,001,"Nevada","Churchill County",1,26,361,190,171
050,32,001,"Nevada","Churchill County",1,27,341,184,157
050,32,001,"Nevada","Churchill County",1,28,338,175,163
050,32,001,"Nevada","Churchill County",1,29,402,208,194
050,32,001,"Nevada","Churchill County",1,30,396,204,192
050,32,001,"Nevada","Churchill County",1,31,375,178,197
050,32,001,"Nevada","Churchill County",1,32,388,211,177
050,32,001,"Nevada","Churchill County",1,33,361,197,164
050,32,001,"Nevada","Churchill County",1,34,343,183,160
050,32,001,"Nevada","Churchill County",1,35,302,163,139
050,32,001,"Nevada","Churchill County",1,36,310,160,150
050,32,001,"Nevada","Churchill County",1,37,317,175,142
050,32,001,"Nevada","Churchill County",1,38,307,157,150
050,32,001,"Nevada","Churchill County",1,39,304,173,131
050,32,001,"Nevada","Churchill County",1,40,305,176,129
050,32,001,"Nevada","Churchill County",1,41,279,151,128
050,32,001,"Nevada","Churchill County",1,42,277,142,135
050,32,001,"Nevada","Churchill County",1,43,274,134,140
050,32,001,"Nevada","Churchill County",1,44,249,133,116
050,32,001,"Nevada","Churchill County",1,45,220,124,96
050,32,001,"Nevada","Churchill County",1,46,215,104,111
050,32,001,"Nevada","Churchill County",1,47,270,140,130
050,32,001,"Nevada","Churchill County",1,48,297,157,140
050,32,001,"Nevada","Churchill County",1,49,288,137,151
050,32,001,"Nevada","Churchill County",1,50,268,124,144
050,32,001,"Nevada","Churchill County",1,51,303,150,153
050,32,001,"Nevada","Churchill County",1,52,276,132,144
050,32,001,"Nevada","Churchill County",1,53,289,134,155
050,32,001,"Nevada","Churchill County",1,54,292,148,144
050,32,001,"Nevada","Churchill County",1,55,327,183,144
050,32,001,"Nevada","Churchill County",1,56,357,190,167
050,32,001,"Nevada","Churchill County",1,57,358,191,167
050,32,001,"Nevada","Churchill County",1,58,372,186,186
050,32,001,"Nevada","Churchill County",1,59,386,200,186
050,32,001,"Nevada","Churchill County",1,60,348,163,185
050,32,001,"Nevada","Churchill County",1,61,344,176,168
050,32,001,"Nevada","Churchill County",1,62,357,188,169
050,32,001,"Nevada","Churchill County",1,63,347,157,190
050,32,001,"Nevada","Churchill County",1,64,330,153,177
050,32,001,"Nevada","Churchill County",1,65,326,159,167
050,32,001,"Nevada","Churchill County",1,66,324,157,167
050,32,001,"Nevada","Churchill County",1,67,314,150,164
050,32,001,"Nevada","Churchill County",1,68,288,128,160
050,32,001,"Nevada","Churchill County",1,69,281,136,145
050,32,001,"Nevada","Churchill County",1,70,305,154,151
050,32,001,"Nevada","Churchill County",1,71,286,147,139
050,32,001,"Nevada","Churchill County",1,72,286,132,154
050,32,001,"Nevada","Churchill County",1,73,290,138,152
050,32,001,"Nevada","Churchill County",1,74,206,100,106
050,32,001,"Nevada","Churchill County",1,75,218,108,110
050,32,001,"Nevada","Churchill County",1,76,228,116,112
050,32,001,"Nevada","Churchill County",1,77,236,130,106
050,32,001,"Nevada","Churchill County",1,78,168,88,80
050,32,001,"Nevada","Churchill County",1,79,138,66,72
050,32,001,"Nevada","Churchill County",1,80,134,62,72
050,32,001,"Nevada","Churchill County",1,81,132,59,73
050,32,001,"Nevada","Churchill County",1,82,121,57,64
050,32,001,"Nevada","Churchill County",1,83,106,48,58
050,32,001,"Nevada","Churchill County",1,84,75,43,32
050,32,001,"Nevada","Churchill County",1,85,430,188,242
050,32,001,"Nevada","Churchill County",2,0,320,160,160
050,32,001,"Nevada","Churchill County",2,1,334,162,172
050,32,001,"Nevada","Churchill County",2,2,330,152,178
050,32,001,"Nevada","Churchill County",2,3,328,171,157
050,32,001,"Nevada","Churchill County",2,4,333,180,153
050,32,001,"Nevada","Churchill County",2,5,316,164,152
050,32,001,"Nevada","Churchill County",2,6,340,162,178
050,32,001,"Nevada","Churchill County",2,7,329,159,170
050,32,001,"Nevada","Churchill County",2,8,332,168,164
050,32,001,"Nevada","Churchill County",2,9,321,163,158
050,32,001,"Nevada","Churchill County",2,10,314,167,147
050,32,001,"Nevada","Churchill County",2,11,330,178,152
050,32,001,"Nevada","Churchill County",2,12,350,185,165
050,32,001,"Nevada","Churchill County",2,13,319,171,148
050,32,001,"Nevada","Churchill County",2,14,316,166,150
050,32,001,"Nevada","Churchill County",2,15,296,156,140
050,32,001,"Nevada","Churchill County",2,16,310,159,151
050,32,001,"Nevada","Churchill County",2,17,318,160,158
050,32,001,"Nevada","Churchill County",2,18,272,142,130
050,32,001,"Nevada","Churchill County",2,19,251,131,120
050,32,001,"Nevada","Churchill County",2,20,285,149,136
050,32,001,"Nevada","Churchill County",2,21,277,151,126
050,32,001,"Nevada","Churchill County",2,22,286,156,130
050,32,001,"Nevada","Churchill County",2,23,290,159,131
050,32,001,"Nevada","Churchill County",2,24,320,166,154
050,32,001,"Nevada","Churchill County",2,25,338,175,163
050,32,001,"Nevada","Churchill County",2,26,354,186,168
050,32,001,"Nevada","Churchill County",2,27,346,186,160
050,32,001,"Nevada","Churchill County",2,28,343,180,163
050,32,001,"Nevada","Churchill County",2,29,393,206,187
050,32,001,"Nevada","Churchill County",2,30,399,203,196
050,32,001,"Nevada","Churchill County",2,31,377,181,196
050,32,001,"Nevada","Churchill County",2,32,385,208,177
050,32,001,"Nevada","Churchill County",2,33,364,199,165
050,32,001,"Nevada","Churchill County",2,34,346,186,160
050,32,001,"Nevada","Churchill County",2,35,314,167,147
050,32,001,"Nevada","Churchill County",2,36,306,160,146
050,32,001,"Nevada","Churchill County",2,37,315,171,144
050,32,001,"Nevada","Churchill County",2,38,314,167,147
050,32,001,"Nevada","Churchill County",2,39,299,168,131
050,32,001,"Nevada","Churchill County",2,40,308,177,131
050,32,001,"Nevada","Churchill County",2,41,285,157,128
050,32,001,"Nevada","Churchill County",2,42,274,142,132
050,32,001,"Nevada","Churchill County",2,43,278,139,139
050,32,001,"Nevada","Churchill County",2,44,252,132,120
050,32,001,"Nevada","Churchill County",2,45,230,128,102
050,32,001,"Nevada","Churchill County",2,46,218,109,109
050,32,001,"Nevada","Churchill County",2,47,259,132,127
050,32,001,"Nevada","Churchill County",2,48,292,155,137
050,32,001,"Nevada","Churchill County",2,49,289,140,149
050,32,001,"Nevada","Churchill County",2,50,277,129,148
050,32,001,"Nevada","Churchill County",2,51,296,144,152
050,32,001,"Nevada","Churchill County",2,52,282,135,147
050,32,001,"Nevada","Churchill County",2,53,285,131,154
050,32,001,"Nevada","Churchill County",2,54,289,144,145
050,32,001,"Nevada","Churchill County",2,55,314,170,144
050,32,001,"Nevada","Churchill County",2,56,352,191,161
050,32,001,"Nevada","Churchill County",2,57,357,191,166
050,32,001,"Nevada","Churchill County",2,58,371,189,182
050,32,001,"Nevada","Churchill County",2,59,385,199,186
050,32,001,"Nevada","Churchill County",2,60,357,171,186
050,32,001,"Nevada","Churchill County",2,61,347,173,174
050,32,001,"Nevada","Churchill County",2,62,355,186,169
050,32,001,"Nevada","Churchill County",2,63,353,165,188
050,32,001,"Nevada","Churchill County",2,64,329,152,177
050,32,001,"Nevada","Churchill County",2,65,328,158,170
050,32,001,"Nevada","Churchill County",2,66,327,158,169
050,32,001,"Nevada","Churchill County",2,67,317,152,165
050,32,001,"Nevada","Churchill County",2,68,292,132,160
050,32,001,"Nevada","Churchill County",2,69,284,134,150
050,32,001,"Nevada","Churchill County",2,70,296,145,151
050,32,001,"Nevada","Churchill County",2,71,287,147,140
050,32,001,"Nevada","Churchill County",2,72,283,134,149
050,32,001,"Nevada","Churchill County",2,73,303,145,158
050,32,001,"Nevada","Churchill County",2,74,210,102,108
050,32,001,"Nevada","Churchill County",2,75,215,104,111
050,32,001,"Nevada","Churchill County",2,76,221,111,110
050,32,001,"Nevada","Churchill County",2,77,242,131,111
050,32,001,"Nevada","Churchill County",2,78,174,91,83
050,32,001,"Nevada","Churchill County",2,79,143,71,72
050,32,001,"Nevada","Churchill County",2,80,134,62,72
050,32,001,"Nevada","Churchill County",2,81,130,60,70
050,32,001,"Nevada","Churchill County",2,82,119,55,64
050,32,001,"Nevada","Churchill County",2,83,109,51,58
050,32,001,"Nevada","Churchill County",2,84,76,43,33
050,32,001,"Nevada","Churchill County",2,85,438,196,242
050,32,001,"Nevada","Churchill County",3,0,261,133,128
050,32,001,"Nevada","Churchill County",3,1,326,170,156
050,32,001,"Nevada","Churchill County",3,2,345,176,169
050,32,001,"Nevada","Churchill County",3,3,331,157,174
050,32,001,"Nevada","Churchill County",3,4,325,166,159
050,32,001,"Nevada","Churchill County",3,5,325,173,152
050,32,001,"Nevada","Churchill County",3,6,322,170,152
050,32,001,"Nevada","Churchill County",3,7,334,155,179
050,32,001,"Nevada","Churchill County",3,8,329,167,162
050,32,001,"Nevada","Churchill County",3,9,339,170,169
050,32,001,"Nevada","Churchill County",3,10,340,172,168
050,32,001,"Nevada","Churchill County",3,11,312,170,142
050,32,001,"Nevada","Churchill County",3,12,334,177,157
050,32,001,"Nevada","Churchill County",3,13,347,191,156
050,32,001,"Nevada","Churchill County",3,14,324,172,152
050,32,001,"Nevada","Churchill County",3,15,310,165,145
050,32,001,"Nevada","Churchill County",3,16,293,156,137
050,32,001,"Nevada","Churchill County",3,17,311,162,149
050,32,001,"Nevada","Churchill County",3,18,276,143,133
050,32,001,"Nevada","Churchill County",3,19,242,129,113
050,32,001,"Nevada","Churchill County",3,20,279,154,125
050,32,001,"Nevada","Churchill County",3,21,283,153,130
050,32,001,"Nevada","Churchill County",3,22,291,144,147
050,32,001,"Nevada","Churchill County",3,23,285,149,136
050,32,001,"Nevada","Churchill County",3,24,316,174,142
050,32,001,"Nevada","Churchill County",3,25,357,184,173
050,32,001,"Nevada","Churchill County",3,26,350,177,173
050,32,001,"Nevada","Churchill County",3,27,361,211,150
050,32,001,"Nevada","Churchill County",3,28,349,185,164
050,32,001,"Nevada","Churchill County",3,29,365,189,176
050,32,001,"Nevada","Churchill County",3,30,370,194,176
050,32,001,"Nevada","Churchill County",3,31,397,203,194
050,32,001,"Nevada","Churchill County",3,32,374,188,186
050,32,001,"Nevada","Churchill County",3,33,391,208,183
050,32,001,"Nevada","Churchill County",3,34,365,194,171
050,32,001,"Nevada","Churchill County",3,35,342,175,167
050,32,001,"Nevada","Churchill County",3,36,313,175,138
050,32,001,"Nevada","Churchill County",3,37,313,151,162
050,32,001,"Nevada","Churchill County",3,38,327,187,140
050,32,001,"Nevada","Churchill County",3,39,314,165,149
050,32,001,"Nevada","Churchill County",3,40,298,166,132
050,32,001,"Nevada","Churchill County",3,41,307,180,127
050,32,001,"Nevada","Churchill County",3,42,288,164,124
050,32,001,"Nevada","Churchill County",3,43,283,142,141
050,32,001,"Nevada","Churchill County",3,44,267,129,138
050,32,001,"Nevada","Churchill County",3,45,261,131,130
050,32,001,"Nevada","Churchill County",3,46,240,135,105
050,32,001,"Nevada","Churchill County",3,47,227,119,108
050,32,001,"Nevada","Churchill County",3,48,265,137,128
050,32,001,"Nevada","Churchill County",3,49,280,139,141
050,32,001,"Nevada","Churchill County",3,50,280,139,141
050,32,001,"Nevada","Churchill County",3,51,272,128,144
050,32,001,"Nevada","Churchill County",3,52,291,139,152
050,32,001,"Nevada","Churchill County",3,53,284,133,151
050,32,001,"Nevada","Churchill County",3,54,292,139,153
050,32,001,"Nevada","Churchill County",3,55,288,142,146
050,32,001,"Nevada","Churchill County",3,56,321,171,150
050,32,001,"Nevada","Churchill County",3,57,365,198,167
050,32,001,"Nevada","Churchill County",3,58,363,196,167
050,32,001,"Nevada","Churchill County",3,59,375,195,180
050,32,001,"Nevada","Churchill County",3,60,375,193,182
050,32,001,"Nevada","Churchill County",3,61,364,168,196
050,32,001,"Nevada","Churchill County",3,62,353,173,180
050,32,001,"Nevada","Churchill County",3,63,354,178,176
050,32,001,"Nevada","Churchill County",3,64,336,159,177
050,32,001,"Nevada","Churchill County",3,65,334,157,177
050,32,001,"Nevada","Churchill County",3,66,320,154,166
050,32,001,"Nevada","Churchill County",3,67,315,147,168
050,32,001,"Nevada","Churchill County",3,68,301,137,164
050,32,001,"Nevada","Churchill County",3,69,284,130,154
050,32,001,"Nevada","Churchill County",3,70,274,127,147
050,32,001,"Nevada","Churchill County",3,71,292,146,146
050,32,001,"Nevada","Churchill County",3,72,273,138,135
050,32,001,"Nevada","Churchill County",3,73,269,122,147
050,32,001,"Nevada","Churchill County",3,74,291,143,148
050,32,001,"Nevada","Churchill County",3,75,203,94,109
050,32,001,"Nevada","Churchill County",3,76,203,101,102
050,32,001,"Nevada","Churchill County",3,77,221,113,108
050,32,001,"Nevada","Churchill County",3,78,222,112,110
050,32,001,"Nevada","Churchill County",3,79,160,89,71
050,32,001,"Nevada","Churchill County",3,80,142,71,71
050,32,001,"Nevada","Churchill County",3,81,127,60,67
050,32,001,"Nevada","Churchill County",3,82,115,52,63
050,32,001,"Nevada","Churchill County",3,83,119,56,63
050,32,001,"Nevada","Churchill County",3,84,90,42,48
050,32,001,"Nevada","Churchill County",3,85,412,192,220
050,32,001,"Nevada","Churchill County",4,0,285,151,134
050,32,001,"Nevada","Churchill County",4,1,274,141,133
050,32,001,"Nevada","Churchill County",4,2,319,171,148
050,32,001,"Nevada","Churchill County",4,3,356,177,179
050,32,001,"Nevada","Churchill County",4,4,320,146,174
050,32,001,"Nevada","Churchill County",4,5,325,171,154
050,32,001,"Nevada","Churchill County",4,6,325,174,151
050,32,001,"Nevada","Churchill County",4,7,326,174,152
050,32,001,"Nevada","Churchill County",4,8,337,164,173
050,32,001,"Nevada","Churchill County",4,9,340,175,165
050,32,001,"Nevada","Churchill County",4,10,354,180,174
050,32,001,"Nevada","Churchill County",4,11,341,168,173
050,32,001,"Nevada","Churchill County",4,12,319,171,148
050,32,001,"Nevada","Churchill County",4,13,338,180,158
050,32,001,"Nevada","Churchill County",4,14,350,183,167
050,32,001,"Nevada","Churchill County",4,15,326,178,148
050,32,001,"Nevada","Churchill County",4,16,322,177,145
050,32,001,"Nevada","Churchill County",4,17,300,158,142
050,32,001,"Nevada","Churchill County",4,18,273,145,128
050,32,001,"Nevada","Churchill County",4,19,224,118,106
050,32,001,"Nevada","Churchill County",4,20,260,152,108
050,32,001,"Nevada","Churchill County",4,21,263,142,121
050,32,001,"Nevada","Churchill County",4,22,287,145,142
050,32,001,"Nevada","Churchill County",4,23,272,139,133
050,32,001,"Nevada","Churchill County",4,24,315,169,146
050,32,001,"Nevada","Churchill County",4,25,345,181,164
050,32,001,"Nevada","Churchill County",4,26,373,200,173
050,32,001,"Nevada","Churchill County",4,27,341,172,169
050,32,001,"Nevada","Churchill County",4,28,372,216,156
050,32,001,"Nevada","Churchill County",4,29,386,208,178
050,32,001,"Nevada","Churchill County",4,30,380,199,181
050,32,001,"Nevada","Churchill County",4,31,396,204,192
050,32,001,"Nevada","Churchill County",4,32,377,195,182
050,32,001,"Nevada","Churchill County",4,33,363,179,184
050,32,001,"Nevada","Churchill County",4,34,398,216,182
050,32,001,"Nevada","Churchill County",4,35,374,195,179
050,32,001,"Nevada","Churchill County",4,36,346,179,167
050,32,001,"Nevada","Churchill County",4,37,317,175,142
050,32,001,"Nevada","Churchill County",4,38,322,168,154
050,32,001,"Nevada","Churchill County",4,39,327,192,135
050,32,001,"Nevada","Churchill County",4,40,317,162,155
050,32,001,"Nevada","Churchill County",4,41,298,166,132
050,32,001,"Nevada","Churchill County",4,42,311,180,131
050,32,001,"Nevada","Churchill County",4,43,301,165,136
050,32,001,"Nevada","Churchill County",4,44,295,148,147
050,32,001,"Nevada","Churchill County",4,45,269,136,133
050,32,001,"Nevada","Churchill County",4,46,269,136,133
050,32,001,"Nevada","Churchill County",4,47,235,131,104
050,32,001,"Nevada","Churchill County",4,48,239,129,110
050,32,001,"Nevada","Churchill County",4,49,252,126,126
050,32,001,"Nevada","Churchill County",4,50,279,133,146
050,32,001,"Nevada","Churchill County",4,51,296,150,146
050,32,001,"Nevada","Churchill County",4,52,272,130,142
050,32,001,"Nevada","Churchill County",4,53,302,146,156
050,32,001,"Nevada","Churchill County",4,54,302,148,154
050,32,001,"Nevada","Churchill County",4,55,286,133,153
050,32,001,"Nevada","Churchill County",4,56,298,153,145
050,32,001,"Nevada","Churchill County",4,57,323,162,161
050,32,001,"Nevada","Churchill County",4,58,352,188,164
050,32,001,"Nevada","Churchill County",4,59,345,185,160
050,32,001,"Nevada","Churchill County",4,60,383,198,185
050,32,001,"Nevada","Churchill County",4,61,368,189,179
050,32,001,"Nevada","Churchill County",4,62,363,163,200
050,32,001,"Nevada","Churchill County",4,63,347,160,187
050,32,001,"Nevada","Churchill County",4,64,359,180,179
050,32,001,"Nevada","Churchill County",4,65,337,160,177
050,32,001,"Nevada","Churchill County",4,66,328,157,171
050,32,001,"Nevada","Churchill County",4,67,305,144,161
050,32,001,"Nevada","Churchill County",4,68,312,150,162
050,32,001,"Nevada","Churchill County",4,69,291,135,156
050,32,001,"Nevada","Churchill County",4,70,277,132,145
050,32,001,"Nevada","Churchill County",4,71,265,126,139
050,32,001,"Nevada","Churchill County",4,72,282,141,141
050,32,001,"Nevada","Churchill County",4,73,258,126,132
050,32,001,"Nevada","Churchill County",4,74,255,119,136
050,32,001,"Nevada","Churchill County",4,75,272,132,140
050,32,001,"Nevada","Churchill County",4,76,192,89,103
050,32,001,"Nevada","Churchill County",4,77,202,101,101
050,32,001,"Nevada","Churchill County",4,78,197,96,101
050,32,001,"Nevada","Churchill County",4,79,195,99,96
050,32,001,"Nevada","Churchill County",4,80,147,77,70
050,32,001,"Nevada","Churchill County",4,81,134,69,65
050,32,001,"Nevada","Churchill County",4,82,111,51,60
050,32,001,"Nevada","Churchill County",4,83,115,55,60
050,32,001,"Nevada","Churchill County",4,84,99,47,52
050,32,001,"Nevada","Churchill County",4,85,395,189,206
050,32,001,"Nevada","Churchill County",5,0,282,149,133
050,32,001,"Nevada","Churchill County",5,1,288,139,149
050,32,001,"Nevada","Churchill County",5,2,281,146,135
050,32,001,"Nevada","Churchill County",5,3,330,181,149
050,32,001,"Nevada","Churchill County",5,4,354,176,178
050,32,001,"Nevada","Churchill County",5,5,342,159,183
050,32,001,"Nevada","Churchill County",5,6,339,182,157
050,32,001,"Nevada","Churchill County",5,7,320,177,143
050,32,001,"Nevada","Churchill County",5,8,317,166,151
050,32,001,"Nevada","Churchill County",5,9,346,168,178
050,32,001,"Nevada","Churchill County",5,10,332,168,164
050,32,001,"Nevada","Churchill County",5,11,357,175,182
050,32,001,"Nevada","Churchill County",5,12,342,175,167
050,32,001,"Nevada","Churchill County",5,13,310,176,134
050,32,001,"Nevada","Churchill County",5,14,340,188,152
050,32,001,"Nevada","Churchill County",5,15,351,189,162
050,32,001,"Nevada","Churchill County",5,16,331,178,153
050,32,001,"Nevada","Churchill County",5,17,324,180,144
050,32,001,"Nevada","Churchill County",5,18,260,136,124
050,32,001,"Nevada","Churchill County",5,19,226,116,110
050,32,001,"Nevada","Churchill County",5,20,258,140,118
050,32,001,"Nevada","Churchill County",5,21,254,151,103
050,32,001,"Nevada","Churchill County",5,22,277,150,127
050,32,001,"Nevada","Churchill County",5,23,284,142,142
050,32,001,"Nevada","Churchill County",5,24,297,154,143
050,32,001,"Nevada","Churchill County",5,25,326,177,149
050,32,001,"Nevada","Churchill County",5,26,357,201,156
050,32,001,"Nevada","Churchill County",5,27,383,199,184
050,32,001,"Nevada","Churchill County",5,28,341,157,184
050,32,001,"Nevada","Churchill County",5,29,355,203,152
050,32,001,"Nevada","Churchill County",5,30,380,202,178
050,32,001,"Nevada","Churchill County",5,31,385,198,187
050,32,001,"Nevada","Churchill County",5,32,396,212,184
050,32,001,"Nevada","Churchill County",5,33,382,204,178
050,32,001,"Nevada","Churchill County",5,34,373,192,181
050,32,001,"Nevada","Churchill County",5,35,383,197,186
050,32,001,"Nevada","Churchill County",5,36,394,201,193
050,32,001,"Nevada","Churchill County",5,37,341,176,165
050,32,001,"Nevada","Churchill County",5,38,314,175,139
050,32,001,"Nevada","Churchill County",5,39,298,157,141
050,32,001,"Nevada","Churchill County",5,40,317,189,128
050,32,001,"Nevada","Churchill County",5,41,314,167,147
050,32,001,"Nevada","Churchill County",5,42,300,163,137
050,32,001,"Nevada","Churchill County",5,43,310,178,132
050,32,001,"Nevada","Churchill County",5,44,294,157,137
050,32,001,"Nevada","Churchill County",5,45,292,148,144
050,32,001,"Nevada","Churchill County",5,46,247,122,125
050,32,001,"Nevada","Churchill County",5,47,275,141,134
050,32,001,"Nevada","Churchill County",5,48,249,144,105
050,32,001,"Nevada","Churchill County",5,49,244,125,119
050,32,001,"Nevada","Churchill County",5,50,256,129,127
050,32,001,"Nevada","Churchill County",5,51,279,128,151
050,32,001,"Nevada","Churchill County",5,52,297,147,150
050,32,001,"Nevada","Churchill County",5,53,268,126,142
050,32,001,"Nevada","Churchill County",5,54,310,150,160
050,32,001,"Nevada","Churchill County",5,55,284,139,145
050,32,001,"Nevada","Churchill County",5,56,291,144,147
050,32,001,"Nevada","Churchill County",5,57,293,151,142
050,32,001,"Nevada","Churchill County",5,58,321,157,164
050,32,001,"Nevada","Churchill County",5,59,360,196,164
050,32,001,"Nevada","Churchill County",5,60,348,179,169
050,32,001,"Nevada","Churchill County",5,61,378,198,180
050,32,001,"Nevada","Churchill County",5,62,366,189,177
050,32,001,"Nevada","Churchill County",5,63,360,161,199
050,32,001,"Nevada","Churchill County",5,64,338,157,181
050,32,001,"Nevada","Churchill County",5,65,354,183,171
050,32,001,"Nevada","Churchill County",5,66,325,154,171
050,32,001,"Nevada","Churchill County",5,67,317,142,175
050,32,001,"Nevada","Churchill County",5,68,305,145,160
050,32,001,"Nevada","Churchill County",5,69,306,151,155
050,32,001,"Nevada","Churchill County",5,70,294,142,152
050,32,001,"Nevada","Churchill County",5,71,271,133,138
050,32,001,"Nevada","Churchill County",5,72,258,118,140
050,32,001,"Nevada","Churchill County",5,73,272,132,140
050,32,001,"Nevada","Churchill County",5,74,248,123,125
050,32,001,"Nevada","Churchill County",5,75,239,110,129
050,32,001,"Nevada","Churchill County",5,76,255,127,128
050,32,001,"Nevada","Churchill County",5,77,188,90,98
050,32,001,"Nevada","Churchill County",5,78,180,80,100
050,32,001,"Nevada","Churchill County",5,79,178,88,90
050,32,001,"Nevada","Churchill County",5,80,187,92,95
050,32,001,"Nevada","Churchill County",5,81,140,73,67
050,32,001,"Nevada","Churchill County",5,82,123,60,63
050,32,001,"Nevada","Churchill County",5,83,113,56,57
050,32,001,"Nevada","Churchill County",5,84,93,45,48
050,32,001,"Nevada","Churchill County",5,85,416,201,215
050,32,003,"Nevada","Clark County",1,0,25894,13230,12664
050,32,003,"Nevada","Clark County",1,1,26215,13367,12848
050,32,003,"Nevada","Clark County",1,2,26796,13752,13044
050,32,003,"Nevada","Clark County",1,3,27834,14208,13626
050,32,003,"Nevada","Clark County",1,4,28428,14469,13959
050,32,003,"Nevada","Clark County",1,5,28650,14690,13960
050,32,003,"Nevada","Clark County",1,6,28175,14420,13755
050,32,003,"Nevada","Clark County",1,7,28610,14565,14045
050,32,003,"Nevada","Clark County",1,8,28653,14870,13783
050,32,003,"Nevada","Clark County",1,9,29421,15049,14372
050,32,003,"Nevada","Clark County",1,10,29755,15275,14480
050,32,003,"Nevada","Clark County",1,11,30635,15636,14999
050,32,003,"Nevada","Clark County",1,12,31709,16265,15444
050,32,003,"Nevada","Clark County",1,13,31315,15957,15358
050,32,003,"Nevada","Clark County",1,14,30175,15339,14836
050,32,003,"Nevada","Clark County",1,15,29576,14996,14580
050,32,003,"Nevada","Clark County",1,16,29312,14945,14367
050,32,003,"Nevada","Clark County",1,17,28908,14767,14141
050,32,003,"Nevada","Clark County",1,18,25780,13347,12433
050,32,003,"Nevada","Clark County",1,19,23545,12299,11246
050,32,003,"Nevada","Clark County",1,20,24220,12529,11691
050,32,003,"Nevada","Clark County",1,21,25109,12886,12223
050,32,003,"Nevada","Clark County",1,22,26023,13086,12937
050,32,003,"Nevada","Clark County",1,23,27576,13774,13802
050,32,003,"Nevada","Clark County",1,24,29150,14666,14484
050,32,003,"Nevada","Clark County",1,25,30404,15226,15178
050,32,003,"Nevada","Clark County",1,26,31541,15840,15701
050,32,003,"Nevada","Clark County",1,27,32747,16539,16208
050,32,003,"Nevada","Clark County",1,28,34362,17156,17206
050,32,003,"Nevada","Clark County",1,29,35396,17679,17717
050,32,003,"Nevada","Clark County",1,30,35112,17701,17411
050,32,003,"Nevada","Clark County",1,31,33883,17013,16870
050,32,003,"Nevada","Clark County",1,32,33411,16932,16479
050,32,003,"Nevada","Clark County",1,33,33103,16858,16245
050,32,003,"Nevada","Clark County",1,34,33201,16833,16368
050,32,003,"Nevada","Clark County",1,35,33038,16762,16276
050,32,003,"Nevada","Clark County",1,36,32884,16679,16205
050,32,003,"Nevada","Clark County",1,37,33466,16861,16605
050,32,003,"Nevada","Clark County",1,38,33017,16681,16336
050,32,003,"Nevada","Clark County",1,39,32688,16605,16083
050,32,003,"Nevada","Clark County",1,40,32090,16439,15651
050,32,003,"Nevada","Clark County",1,41,30662,15526,15136
050,32,003,"Nevada","Clark County",1,42,30287,15301,14986
050,32,003,"Nevada","Clark County",1,43,29411,14723,14688
050,32,003,"Nevada","Clark County",1,44,29041,14501,14540
050,32,003,"Nevada","Clark County",1,45,29426,14819,14607
050,32,003,"Nevada","Clark County",1,46,29048,14522,14526
050,32,003,"Nevada","Clark County",1,47,29643,14939,14704
050,32,003,"Nevada","Clark County",1,48,30781,15409,15372
050,32,003,"Nevada","Clark County",1,49,32489,16627,15862
050,32,003,"Nevada","Clark County",1,50,31258,16011,15247
050,32,003,"Nevada","Clark County",1,51,29691,15144,14547
050,32,003,"Nevada","Clark County",1,52,28634,14555,14079
050,32,003,"Nevada","Clark County",1,53,28336,14522,13814
050,32,003,"Nevada","Clark County",1,54,28404,14616,13788
050,32,003,"Nevada","Clark County",1,55,29291,14943,14348
050,32,003,"Nevada","Clark County",1,56,28784,14565,14219
050,32,003,"Nevada","Clark County",1,57,28404,14331,14073
050,32,003,"Nevada","Clark County",1,58,28558,14456,14102
050,32,003,"Nevada","Clark County",1,59,27938,14029,13909
050,32,003,"Nevada","Clark County",1,60,27348,13735,13613
050,32,003,"Nevada","Clark County",1,61,26322,13027,13295
050,32,003,"Nevada","Clark County",1,62,26228,12926,13302
050,32,003,"Nevada","Clark County",1,63,25377,12316,13061
050,32,003,"Nevada","Clark County",1,64,25248,12183,13065
050,32,003,"Nevada","Clark County",1,65,24959,11970,12989
050,32,003,"Nevada","Clark County",1,66,23602,11285,12317
050,32,003,"Nevada","Clark County",1,67,22865,10920,11945
050,32,003,"Nevada","Clark County",1,68,22300,10557,11743
050,32,003,"Nevada","Clark County",1,69,21222,10024,11198
050,32,003,"Nevada","Clark County",1,70,21148,9973,11175
050,32,003,"Nevada","Clark County",1,71,20558,9679,10879
050,32,003,"Nevada","Clark County",1,72,20686,9896,10790
050,32,003,"Nevada","Clark County",1,73,20672,9999,10673
050,32,003,"Nevada","Clark County",1,74,14915,7105,7810
050,32,003,"Nevada","Clark County",1,75,14618,6897,7721
050,32,003,"Nevada","Clark County",1,76,14219,6660,7559
050,32,003,"Nevada","Clark County",1,77,13635,6443,7192
050,32,003,"Nevada","Clark County",1,78,11524,5413,6111
050,32,003,"Nevada","Clark County",1,79,10222,4731,5491
050,32,003,"Nevada","Clark County",1,80,9306,4336,4970
050,32,003,"Nevada","Clark County",1,81,8299,3927,4372
050,32,003,"Nevada","Clark County",1,82,7417,3532,3885
050,32,003,"Nevada","Clark County",1,83,6472,3018,3454
050,32,003,"Nevada","Clark County",1,84,5721,2630,3091
050,32,003,"Nevada","Clark County",1,85,28699,12001,16698
050,32,003,"Nevada","Clark County",2,0,25603,13038,12565
050,32,003,"Nevada","Clark County",2,1,26251,13392,12859
050,32,003,"Nevada","Clark County",2,2,26760,13711,13049
050,32,003,"Nevada","Clark County",2,3,27610,14105,13505
050,32,003,"Nevada","Clark County",2,4,28424,14477,13947
050,32,003,"Nevada","Clark County",2,5,28683,14691,13992
050,32,003,"Nevada","Clark County",2,6,28392,14544,13848
050,32,003,"Nevada","Clark County",2,7,28528,14548,13980
050,32,003,"Nevada","Clark County",2,8,28615,14773,13842
050,32,003,"Nevada","Clark County",2,9,29273,15040,14233
050,32,003,"Nevada","Clark County",2,10,29725,15243,14482
050,32,003,"Nevada","Clark County",2,11,30312,15484,14828
050,32,003,"Nevada","Clark County",2,12,31639,16195,15444
050,32,003,"Nevada","Clark County",2,13,31424,16035,15389
050,32,003,"Nevada","Clark County",2,14,30492,15505,14987
050,32,003,"Nevada","Clark County",2,15,29783,15116,14667
050,32,003,"Nevada","Clark County",2,16,29418,14983,14435
050,32,003,"Nevada","Clark County",2,17,29001,14802,14199
050,32,003,"Nevada","Clark County",2,18,25849,13393,12456
050,32,003,"Nevada","Clark County",2,19,23688,12352,11336
050,32,003,"Nevada","Clark County",2,20,24667,12772,11895
050,32,003,"Nevada","Clark County",2,21,25231,12956,12275
050,32,003,"Nevada","Clark County",2,22,26300,13244,13056
050,32,003,"Nevada","Clark County",2,23,27718,13858,13860
050,32,003,"Nevada","Clark County",2,24,29079,14619,14460
050,32,003,"Nevada","Clark County",2,25,30437,15274,15163
050,32,003,"Nevada","Clark County",2,26,31644,15902,15742
050,32,003,"Nevada","Clark County",2,27,32654,16485,16169
050,32,003,"Nevada","Clark County",2,28,34230,17156,17074
050,32,003,"Nevada","Clark County",2,29,35317,17660,17657
050,32,003,"Nevada","Clark County",2,30,35477,17863,17614
050,32,003,"Nevada","Clark County",2,31,34199,17192,17007
050,32,003,"Nevada","Clark County",2,32,33621,17014,16607
050,32,003,"Nevada","Clark County",2,33,33263,16917,16346
050,32,003,"Nevada","Clark County",2,34,33255,16885,16370
050,32,003,"Nevada","Clark County",2,35,33362,16949,16413
050,32,003,"Nevada","Clark County",2,36,32869,16673,16196
050,32,003,"Nevada","Clark County",2,37,33459,16892,16567
050,32,003,"Nevada","Clark County",2,38,33373,16853,16520
050,32,003,"Nevada","Clark County",2,39,32719,16600,16119
050,32,003,"Nevada","Clark County",2,40,32565,16659,15906
050,32,003,"Nevada","Clark County",2,41,30972,15714,15258
050,32,003,"Nevada","Clark County",2,42,30298,15320,14978
050,32,003,"Nevada","Clark County",2,43,29823,14935,14888
050,32,003,"Nevada","Clark County",2,44,29004,14494,14510
050,32,003,"Nevada","Clark County",2,45,29539,14849,14690
050,32,003,"Nevada","Clark County",2,46,29090,14563,14527
050,32,003,"Nevada","Clark County",2,47,29544,14864,14680
050,32,003,"Nevada","Clark County",2,48,30589,15329,15260
050,32,003,"Nevada","Clark County",2,49,32236,16412,15824
050,32,003,"Nevada","Clark County",2,50,31664,16212,15452
050,32,003,"Nevada","Clark County",2,51,29989,15294,14695
050,32,003,"Nevada","Clark County",2,52,28989,14750,14239
050,32,003,"Nevada","Clark County",2,53,28388,14509,13879
050,32,003,"Nevada","Clark County",2,54,28386,14583,13803
050,32,003,"Nevada","Clark County",2,55,29151,14898,14253
050,32,003,"Nevada","Clark County",2,56,29052,14723,14329
050,32,003,"Nevada","Clark County",2,57,28596,14422,14174
050,32,003,"Nevada","Clark County",2,58,28564,14430,14134
050,32,003,"Nevada","Clark County",2,59,28145,14167,13978
050,32,003,"Nevada","Clark County",2,60,27619,13864,13755
050,32,003,"Nevada","Clark County",2,61,26562,13190,13372
050,32,003,"Nevada","Clark County",2,62,26237,12929,13308
050,32,003,"Nevada","Clark County",2,63,25787,12566,13221
050,32,003,"Nevada","Clark County",2,64,25222,12175,13047
050,32,003,"Nevada","Clark County",2,65,25046,12018,13028
050,32,003,"Nevada","Clark County",2,66,23976,11462,12514
050,32,003,"Nevada","Clark County",2,67,22976,10972,12004
050,32,003,"Nevada","Clark County",2,68,22347,10600,11747
050,32,003,"Nevada","Clark County",2,69,21559,10169,11390
050,32,003,"Nevada","Clark County",2,70,21136,9947,11189
050,32,003,"Nevada","Clark County",2,71,20646,9712,10934
050,32,003,"Nevada","Clark County",2,72,20372,9707,10665
050,32,003,"Nevada","Clark County",2,73,21398,10335,11063
050,32,003,"Nevada","Clark County",2,74,15433,7365,8068
050,32,003,"Nevada","Clark County",2,75,14671,6935,7736
050,32,003,"Nevada","Clark County",2,76,14107,6598,7509
050,32,003,"Nevada","Clark County",2,77,13935,6575,7360
050,32,003,"Nevada","Clark County",2,78,11772,5528,6244
050,32,003,"Nevada","Clark County",2,79,10414,4823,5591
050,32,003,"Nevada","Clark County",2,80,9416,4373,5043
050,32,003,"Nevada","Clark County",2,81,8408,3955,4453
050,32,003,"Nevada","Clark County",2,82,7549,3574,3975
050,32,003,"Nevada","Clark County",2,83,6546,3059,3487
050,32,003,"Nevada","Clark County",2,84,5805,2690,3115
050,32,003,"Nevada","Clark County",2,85,29020,12159,16861
050,32,003,"Nevada","Clark County",3,0,24930,12803,12127
050,32,003,"Nevada","Clark County",3,1,25711,13120,12591
050,32,003,"Nevada","Clark County",3,2,26475,13497,12978
050,32,003,"Nevada","Clark County",3,3,26868,13802,13066
050,32,003,"Nevada","Clark County",3,4,27640,14035,13605
050,32,003,"Nevada","Clark County",3,5,28624,14581,14043
050,32,003,"Nevada","Clark County",3,6,28747,14650,14097
050,32,003,"Nevada","Clark County",3,7,28586,14665,13921
050,32,003,"Nevada","Clark County",3,8,28647,14621,14026
050,32,003,"Nevada","Clark County",3,9,28707,14796,13911
050,32,003,"Nevada","Clark County",3,10,29392,15102,14290
050,32,003,"Nevada","Clark County",3,11,29789,15262,14527
050,32,003,"Nevada","Clark County",3,12,30417,15500,14917
050,32,003,"Nevada","Clark County",3,13,31797,16294,15503
050,32,003,"Nevada","Clark County",3,14,31548,16083,15465
050,32,003,"Nevada","Clark County",3,15,30536,15602,14934
050,32,003,"Nevada","Clark County",3,16,29791,15100,14691
050,32,003,"Nevada","Clark County",3,17,29423,14981,14442
050,32,003,"Nevada","Clark County",3,18,26262,13683,12579
050,32,003,"Nevada","Clark County",3,19,23500,12183,11317
050,32,003,"Nevada","Clark County",3,20,24995,12921,12074
050,32,003,"Nevada","Clark County",3,21,26009,13402,12607
050,32,003,"Nevada","Clark County",3,22,26647,13496,13151
050,32,003,"Nevada","Clark County",3,23,28002,14064,13938
050,32,003,"Nevada","Clark County",3,24,28972,14544,14428
050,32,003,"Nevada","Clark County",3,25,30095,15146,14949
050,32,003,"Nevada","Clark County",3,26,31428,15829,15599
050,32,003,"Nevada","Clark County",3,27,32443,16368,16075
050,32,003,"Nevada","Clark County",3,28,33355,16819,16536
050,32,003,"Nevada","Clark County",3,29,34812,17436,17376
050,32,003,"Nevada","Clark County",3,30,35655,17930,17725
050,32,003,"Nevada","Clark County",3,31,35772,18024,17748
050,32,003,"Nevada","Clark County",3,32,34505,17318,17187
050,32,003,"Nevada","Clark County",3,33,33823,17136,16687
050,32,003,"Nevada","Clark County",3,34,33561,17058,16503
050,32,003,"Nevada","Clark County",3,35,33398,16981,16417
050,32,003,"Nevada","Clark County",3,36,33596,17111,16485
050,32,003,"Nevada","Clark County",3,37,32983,16677,16306
050,32,003,"Nevada","Clark County",3,38,33572,17029,16543
050,32,003,"Nevada","Clark County",3,39,33445,16901,16544
050,32,003,"Nevada","Clark County",3,40,32939,16770,16169
050,32,003,"Nevada","Clark County",3,41,32515,16588,15927
050,32,003,"Nevada","Clark County",3,42,30998,15729,15269
050,32,003,"Nevada","Clark County",3,43,30355,15331,15024
050,32,003,"Nevada","Clark County",3,44,29893,14908,14985
050,32,003,"Nevada","Clark County",3,45,29003,14512,14491
050,32,003,"Nevada","Clark County",3,46,29337,14624,14713
050,32,003,"Nevada","Clark County",3,47,29180,14619,14561
050,32,003,"Nevada","Clark County",3,48,29398,14750,14648
050,32,003,"Nevada","Clark County",3,49,30452,15239,15213
050,32,003,"Nevada","Clark County",3,50,32166,16342,15824
050,32,003,"Nevada","Clark County",3,51,31552,16073,15479
050,32,003,"Nevada","Clark County",3,52,30030,15372,14658
050,32,003,"Nevada","Clark County",3,53,28951,14708,14243
050,32,003,"Nevada","Clark County",3,54,28377,14471,13906
050,32,003,"Nevada","Clark County",3,55,28343,14536,13807
050,32,003,"Nevada","Clark County",3,56,29149,14867,14282
050,32,003,"Nevada","Clark County",3,57,29063,14672,14391
050,32,003,"Nevada","Clark County",3,58,28591,14363,14228
050,32,003,"Nevada","Clark County",3,59,28537,14382,14155
050,32,003,"Nevada","Clark County",3,60,28003,14066,13937
050,32,003,"Nevada","Clark County",3,61,27499,13767,13732
050,32,003,"Nevada","Clark County",3,62,26390,13056,13334
050,32,003,"Nevada","Clark County",3,63,26207,12865,13342
050,32,003,"Nevada","Clark County",3,64,25730,12446,13284
050,32,003,"Nevada","Clark County",3,65,25123,12093,13030
050,32,003,"Nevada","Clark County",3,66,24920,11952,12968
050,32,003,"Nevada","Clark County",3,67,23844,11371,12473
050,32,003,"Nevada","Clark County",3,68,22738,10828,11910
050,32,003,"Nevada","Clark County",3,69,22090,10391,11699
050,32,003,"Nevada","Clark County",3,70,21287,9937,11350
050,32,003,"Nevada","Clark County",3,71,20706,9694,11012
050,32,003,"Nevada","Clark County",3,72,20294,9505,10789
050,32,003,"Nevada","Clark County",3,73,19880,9388,10492
050,32,003,"Nevada","Clark County",3,74,20816,9982,10834
050,32,003,"Nevada","Clark County",3,75,15016,7104,7912
050,32,003,"Nevada","Clark County",3,76,14140,6648,7492
050,32,003,"Nevada","Clark County",3,77,13566,6316,7250
050,32,003,"Nevada","Clark County",3,78,13300,6242,7058
050,32,003,"Nevada","Clark County",3,79,11201,5239,5962
050,32,003,"Nevada","Clark County",3,80,9846,4545,5301
050,32,003,"Nevada","Clark County",3,81,8814,4076,4738
050,32,003,"Nevada","Clark County",3,82,7815,3642,4173
050,32,003,"Nevada","Clark County",3,83,6927,3235,3692
050,32,003,"Nevada","Clark County",3,84,6008,2788,3220
050,32,003,"Nevada","Clark County",3,85,29863,12580,17283
050,32,003,"Nevada","Clark County",4,0,25071,12796,12275
050,32,003,"Nevada","Clark County",4,1,25496,13101,12395
050,32,003,"Nevada","Clark County",4,2,26065,13311,12754
050,32,003,"Nevada","Clark County",4,3,26796,13620,13176
050,32,003,"Nevada","Clark County",4,4,27198,13913,13285
050,32,003,"Nevada","Clark County",4,5,27945,14202,13743
050,32,003,"Nevada","Clark County",4,6,28940,14791,14149
050,32,003,"Nevada","Clark County",4,7,29082,14832,14250
050,32,003,"Nevada","Clark County",4,8,28789,14696,14093
050,32,003,"Nevada","Clark County",4,9,28786,14677,14109
050,32,003,"Nevada","Clark County",4,10,29038,14957,14081
050,32,003,"Nevada","Clark County",4,11,29702,15303,14399
050,32,003,"Nevada","Clark County",4,12,29967,15365,14602
050,32,003,"Nevada","Clark County",4,13,30657,15676,14981
050,32,003,"Nevada","Clark County",4,14,31907,16348,15559
050,32,003,"Nevada","Clark County",4,15,31714,16138,15576
050,32,003,"Nevada","Clark County",4,16,30713,15663,15050
050,32,003,"Nevada","Clark County",4,17,29928,15195,14733
050,32,003,"Nevada","Clark County",4,18,26653,13844,12809
050,32,003,"Nevada","Clark County",4,19,23522,12268,11254
050,32,003,"Nevada","Clark County",4,20,24688,12679,12009
050,32,003,"Nevada","Clark County",4,21,26087,13418,12669
050,32,003,"Nevada","Clark County",4,22,27261,13855,13406
050,32,003,"Nevada","Clark County",4,23,28397,14320,14077
050,32,003,"Nevada","Clark County",4,24,29536,14900,14636
050,32,003,"Nevada","Clark County",4,25,30385,15254,15131
050,32,003,"Nevada","Clark County",4,26,31409,15837,15572
050,32,003,"Nevada","Clark County",4,27,32589,16443,16146
050,32,003,"Nevada","Clark County",4,28,33443,16902,16541
050,32,003,"Nevada","Clark County",4,29,34200,17298,16902
050,32,003,"Nevada","Clark County",4,30,35624,17873,17751
050,32,003,"Nevada","Clark County",4,31,36278,18247,18031
050,32,003,"Nevada","Clark County",4,32,36488,18392,18096
050,32,003,"Nevada","Clark County",4,33,35194,17599,17595
050,32,003,"Nevada","Clark County",4,34,34260,17409,16851
050,32,003,"Nevada","Clark County",4,35,33998,17377,16621
050,32,003,"Nevada","Clark County",4,36,33825,17167,16658
050,32,003,"Nevada","Clark County",4,37,33842,17216,16626
050,32,003,"Nevada","Clark County",4,38,33431,16944,16487
050,32,003,"Nevada","Clark County",4,39,33769,17073,16696
050,32,003,"Nevada","Clark County",4,40,33668,17017,16651
050,32,003,"Nevada","Clark County",4,41,32963,16793,16170
050,32,003,"Nevada","Clark County",4,42,32730,16626,16104
050,32,003,"Nevada","Clark County",4,43,31150,15765,15385
050,32,003,"Nevada","Clark County",4,44,30489,15425,15064
050,32,003,"Nevada","Clark County",4,45,30088,15020,15068
050,32,003,"Nevada","Clark County",4,46,28931,14368,14563
050,32,003,"Nevada","Clark County",4,47,29413,14602,14811
050,32,003,"Nevada","Clark County",4,48,29169,14496,14673
050,32,003,"Nevada","Clark County",4,49,29486,14769,14717
050,32,003,"Nevada","Clark County",4,50,30531,15320,15211
050,32,003,"Nevada","Clark County",4,51,32111,16248,15863
050,32,003,"Nevada","Clark County",4,52,31543,16035,15508
050,32,003,"Nevada","Clark County",4,53,30056,15374,14682
050,32,003,"Nevada","Clark County",4,54,28848,14670,14178
050,32,003,"Nevada","Clark County",4,55,28461,14472,13989
050,32,003,"Nevada","Clark County",4,56,28452,14563,13889
050,32,003,"Nevada","Clark County",4,57,29225,14826,14399
050,32,003,"Nevada","Clark County",4,58,29141,14672,14469
050,32,003,"Nevada","Clark County",4,59,28610,14280,14330
050,32,003,"Nevada","Clark County",4,60,28417,14247,14170
050,32,003,"Nevada","Clark County",4,61,27858,13964,13894
050,32,003,"Nevada","Clark County",4,62,27412,13630,13782
050,32,003,"Nevada","Clark County",4,63,26409,13038,13371
050,32,003,"Nevada","Clark County",4,64,26178,12799,13379
050,32,003,"Nevada","Clark County",4,65,25636,12366,13270
050,32,003,"Nevada","Clark County",4,66,24970,12002,12968
050,32,003,"Nevada","Clark County",4,67,24631,11766,12865
050,32,003,"Nevada","Clark County",4,68,23470,11122,12348
050,32,003,"Nevada","Clark County",4,69,22409,10586,11823
050,32,003,"Nevada","Clark County",4,70,21627,10074,11553
050,32,003,"Nevada","Clark County",4,71,20810,9649,11161
050,32,003,"Nevada","Clark County",4,72,20233,9371,10862
050,32,003,"Nevada","Clark County",4,73,19832,9235,10597
050,32,003,"Nevada","Clark County",4,74,19333,9106,10227
050,32,003,"Nevada","Clark County",4,75,19955,9498,10457
050,32,003,"Nevada","Clark County",4,76,14487,6804,7683
050,32,003,"Nevada","Clark County",4,77,13537,6307,7230
050,32,003,"Nevada","Clark County",4,78,12924,5997,6927
050,32,003,"Nevada","Clark County",4,79,12644,5886,6758
050,32,003,"Nevada","Clark County",4,80,10539,4888,5651
050,32,003,"Nevada","Clark County",4,81,9135,4185,4950
050,32,003,"Nevada","Clark County",4,82,8168,3733,4435
050,32,003,"Nevada","Clark County",4,83,7148,3287,3861
050,32,003,"Nevada","Clark County",4,84,6357,2956,3401
050,32,003,"Nevada","Clark County",4,85,30678,12988,17690
050,32,003,"Nevada","Clark County",5,0,24608,12532,12076
050,32,003,"Nevada","Clark County",5,1,25192,12899,12293
050,32,003,"Nevada","Clark County",5,2,25560,13105,12455
050,32,003,"Nevada","Clark County",5,3,26063,13304,12759
050,32,003,"Nevada","Clark County",5,4,26750,13581,13169
050,32,003,"Nevada","Clark County",5,5,27136,13892,13244
050,32,003,"Nevada","Clark County",5,6,27994,14260,13734
050,32,003,"Nevada","Clark County",5,7,28934,14793,14141
050,32,003,"Nevada","Clark County",5,8,28957,14802,14155
050,32,003,"Nevada","Clark County",5,9,28805,14661,14144
050,32,003,"Nevada","Clark County",5,10,28827,14693,14134
050,32,003,"Nevada","Clark County",5,11,28912,14847,14065
050,32,003,"Nevada","Clark County",5,12,29721,15277,14444
050,32,003,"Nevada","Clark County",5,13,29894,15349,14545
050,32,003,"Nevada","Clark County",5,14,30546,15681,14865
050,32,003,"Nevada","Clark County",5,15,31909,16347,15562
050,32,003,"Nevada","Clark County",5,16,31529,15937,15592
050,32,003,"Nevada","Clark County",5,17,30575,15620,14955
050,32,003,"Nevada","Clark County",5,18,26818,13876,12942
050,32,003,"Nevada","Clark County",5,19,23916,12478,11438
050,32,003,"Nevada","Clark County",5,20,24867,12908,11959
050,32,003,"Nevada","Clark County",5,21,25862,13196,12666
050,32,003,"Nevada","Clark County",5,22,27430,13914,13516
050,32,003,"Nevada","Clark County",5,23,28644,14561,14083
050,32,003,"Nevada","Clark County",5,24,29379,14869,14510
050,32,003,"Nevada","Clark County",5,25,30502,15367,15135
050,32,003,"Nevada","Clark County",5,26,31274,15799,15475
050,32,003,"Nevada","Clark County",5,27,32014,16196,15818
050,32,003,"Nevada","Clark County",5,28,33016,16681,16335
050,32,003,"Nevada","Clark County",5,29,33916,17185,16731
050,32,003,"Nevada","Clark County",5,30,34626,17628,16998
050,32,003,"Nevada","Clark County",5,31,35876,17981,17895
050,32,003,"Nevada","Clark County",5,32,36518,18470,18048
050,32,003,"Nevada","Clark County",5,33,36852,18563,18289
050,32,003,"Nevada","Clark County",5,34,35427,17725,17702
050,32,003,"Nevada","Clark County",5,35,34394,17543,16851
050,32,003,"Nevada","Clark County",5,36,34056,17459,16597
050,32,003,"Nevada","Clark County",5,37,33815,17129,16686
050,32,003,"Nevada","Clark County",5,38,33935,17250,16685
050,32,003,"Nevada","Clark County",5,39,33540,16982,16558
050,32,003,"Nevada","Clark County",5,40,33856,17133,16723
050,32,003,"Nevada","Clark County",5,41,33536,16923,16613
050,32,003,"Nevada","Clark County",5,42,32991,16827,16164
050,32,003,"Nevada","Clark County",5,43,32690,16637,16053
050,32,003,"Nevada","Clark County",5,44,31226,15802,15424
050,32,003,"Nevada","Clark County",5,45,30617,15508,15109
050,32,003,"Nevada","Clark County",5,46,29920,14806,15114
050,32,003,"Nevada","Clark County",5,47,28971,14439,14532
050,32,003,"Nevada","Clark County",5,48,29422,14580,14842
050,32,003,"Nevada","Clark County",5,49,29144,14463,14681
050,32,003,"Nevada","Clark County",5,50,29436,14724,14712
050,32,003,"Nevada","Clark County",5,51,30409,15226,15183
050,32,003,"Nevada","Clark County",5,52,32045,16200,15845
050,32,003,"Nevada","Clark County",5,53,31459,15922,15537
050,32,003,"Nevada","Clark County",5,54,30029,15355,14674
050,32,003,"Nevada","Clark County",5,55,28879,14635,14244
050,32,003,"Nevada","Clark County",5,56,28435,14447,13988
050,32,003,"Nevada","Clark County",5,57,28453,14489,13964
050,32,003,"Nevada","Clark County",5,58,29110,14781,14329
050,32,003,"Nevada","Clark County",5,59,29044,14560,14484
050,32,003,"Nevada","Clark County",5,60,28496,14189,14307
050,32,003,"Nevada","Clark County",5,61,28312,14135,14177
050,32,003,"Nevada","Clark County",5,62,27722,13851,13871
050,32,003,"Nevada","Clark County",5,63,27251,13485,13766
050,32,003,"Nevada","Clark County",5,64,26069,12807,13262
050,32,003,"Nevada","Clark County",5,65,26007,12711,13296
050,32,003,"Nevada","Clark County",5,66,25470,12257,13213
050,32,003,"Nevada","Clark County",5,67,24654,11787,12867
050,32,003,"Nevada","Clark County",5,68,24269,11545,12724
050,32,003,"Nevada","Clark County",5,69,23136,10895,12241
050,32,003,"Nevada","Clark County",5,70,22051,10324,11727
050,32,003,"Nevada","Clark County",5,71,21152,9817,11335
050,32,003,"Nevada","Clark County",5,72,20358,9384,10974
050,32,003,"Nevada","Clark County",5,73,19789,9105,10684
050,32,003,"Nevada","Clark County",5,74,19246,8959,10287
050,32,003,"Nevada","Clark County",5,75,18646,8715,9931
050,32,003,"Nevada","Clark County",5,76,19326,9140,10186
050,32,003,"Nevada","Clark County",5,77,13880,6475,7405
050,32,003,"Nevada","Clark County",5,78,12901,5997,6904
050,32,003,"Nevada","Clark County",5,79,12422,5747,6675
050,32,003,"Nevada","Clark County",5,80,11979,5541,6438
050,32,003,"Nevada","Clark County",5,81,9913,4554,5359
050,32,003,"Nevada","Clark County",5,82,8594,3909,4685
050,32,003,"Nevada","Clark County",5,83,7594,3430,4164
050,32,003,"Nevada","Clark County",5,84,6638,3034,3604
050,32,003,"Nevada","Clark County",5,85,32437,13840,18597
050,32,005,"Nevada","Douglas County",1,0,323,166,157
050,32,005,"Nevada","Douglas County",1,1,324,166,158
050,32,005,"Nevada","Douglas County",1,2,300,154,146
050,32,005,"Nevada","Douglas County",1,3,341,177,164
050,32,005,"Nevada","Douglas County",1,4,359,198,161
050,32,005,"Nevada","Douglas County",1,5,401,220,181
050,32,005,"Nevada","Douglas County",1,6,401,201,200
050,32,005,"Nevada","Douglas County",1,7,421,217,204
050,32,005,"Nevada","Douglas County",1,8,421,239,182
050,32,005,"Nevada","Douglas County",1,9,444,229,215
050,32,005,"Nevada","Douglas County",1,10,506,258,248
050,32,005,"Nevada","Douglas County",1,11,485,257,228
050,32,005,"Nevada","Douglas County",1,12,526,268,258
050,32,005,"Nevada","Douglas County",1,13,497,267,230
050,32,005,"Nevada","Douglas County",1,14,520,282,238
050,32,005,"Nevada","Douglas County",1,15,535,272,263
050,32,005,"Nevada","Douglas County",1,16,529,277,252
050,32,005,"Nevada","Douglas County",1,17,517,265,252
050,32,005,"Nevada","Douglas County",1,18,455,238,217
050,32,005,"Nevada","Douglas County",1,19,374,194,180
050,32,005,"Nevada","Douglas County",1,20,363,188,175
050,32,005,"Nevada","Douglas County",1,21,359,197,162
050,32,005,"Nevada","Douglas County",1,22,362,193,169
050,32,005,"Nevada","Douglas County",1,23,357,192,165
050,32,005,"Nevada","Douglas County",1,24,387,214,173
050,32,005,"Nevada","Douglas County",1,25,396,217,179
050,32,005,"Nevada","Douglas County",1,26,403,205,198
050,32,005,"Nevada","Douglas County",1,27,408,204,204
050,32,005,"Nevada","Douglas County",1,28,487,245,242
050,32,005,"Nevada","Douglas County",1,29,489,263,226
050,32,005,"Nevada","Douglas County",1,30,482,242,240
050,32,005,"Nevada","Douglas County",1,31,469,226,243
050,32,005,"Nevada","Douglas County",1,32,486,257,229
050,32,005,"Nevada","Douglas County",1,33,526,287,239
050,32,005,"Nevada","Douglas County",1,34,505,252,253
050,32,005,"Nevada","Douglas County",1,35,481,268,213
050,32,005,"Nevada","Douglas County",1,36,481,254,227
050,32,005,"Nevada","Douglas County",1,37,515,265,250
050,32,005,"Nevada","Douglas County",1,38,541,289,252
050,32,005,"Nevada","Douglas County",1,39,547,282,265
050,32,005,"Nevada","Douglas County",1,40,535,273,262
050,32,005,"Nevada","Douglas County",1,41,482,250,232
050,32,005,"Nevada","Douglas County",1,42,470,236,234
050,32,005,"Nevada","Douglas County",1,43,485,254,231
050,32,005,"Nevada","Douglas County",1,44,472,238,234
050,32,005,"Nevada","Douglas County",1,45,468,246,222
050,32,005,"Nevada","Douglas County",1,46,456,238,218
050,32,005,"Nevada","Douglas County",1,47,492,246,246
050,32,005,"Nevada","Douglas County",1,48,522,258,264
050,32,005,"Nevada","Douglas County",1,49,558,258,300
050,32,005,"Nevada","Douglas County",1,50,577,293,284
050,32,005,"Nevada","Douglas County",1,51,564,291,273
050,32,005,"Nevada","Douglas County",1,52,550,269,281
050,32,005,"Nevada","Douglas County",1,53,557,264,293
050,32,005,"Nevada","Douglas County",1,54,627,287,340
050,32,005,"Nevada","Douglas County",1,55,694,340,354
050,32,005,"Nevada","Douglas County",1,56,777,380,397
050,32,005,"Nevada","Douglas County",1,57,814,399,415
050,32,005,"Nevada","Douglas County",1,58,890,441,449
050,32,005,"Nevada","Douglas County",1,59,920,423,497
050,32,005,"Nevada","Douglas County",1,60,896,437,459
050,32,005,"Nevada","Douglas County",1,61,997,469,528
050,32,005,"Nevada","Douglas County",1,62,1021,501,520
050,32,005,"Nevada","Douglas County",1,63,967,466,501
050,32,005,"Nevada","Douglas County",1,64,996,500,496
050,32,005,"Nevada","Douglas County",1,65,1035,521,514
050,32,005,"Nevada","Douglas County",1,66,1043,503,540
050,32,005,"Nevada","Douglas County",1,67,1004,501,503
050,32,005,"Nevada","Douglas County",1,68,968,468,500
050,32,005,"Nevada","Douglas County",1,69,863,431,432
050,32,005,"Nevada","Douglas County",1,70,826,410,416
050,32,005,"Nevada","Douglas County",1,71,849,425,424
050,32,005,"Nevada","Douglas County",1,72,934,479,455
050,32,005,"Nevada","Douglas County",1,73,916,484,432
050,32,005,"Nevada","Douglas County",1,74,666,342,324
050,32,005,"Nevada","Douglas County",1,75,643,335,308
050,32,005,"Nevada","Douglas County",1,76,643,320,323
050,32,005,"Nevada","Douglas County",1,77,634,305,329
050,32,005,"Nevada","Douglas County",1,78,514,247,267
050,32,005,"Nevada","Douglas County",1,79,434,227,207
050,32,005,"Nevada","Douglas County",1,80,400,213,187
050,32,005,"Nevada","Douglas County",1,81,384,207,177
050,32,005,"Nevada","Douglas County",1,82,343,184,159
050,32,005,"Nevada","Douglas County",1,83,288,148,140
050,32,005,"Nevada","Douglas County",1,84,224,108,116
050,32,005,"Nevada","Douglas County",1,85,1361,600,761
050,32,005,"Nevada","Douglas County",2,0,333,171,162
050,32,005,"Nevada","Douglas County",2,1,324,167,157
050,32,005,"Nevada","Douglas County",2,2,305,158,147
050,32,005,"Nevada","Douglas County",2,3,330,172,158
050,32,005,"Nevada","Douglas County",2,4,360,198,162
050,32,005,"Nevada","Douglas County",2,5,392,217,175
050,32,005,"Nevada","Douglas County",2,6,404,208,196
050,32,005,"Nevada","Douglas County",2,7,414,212,202
050,32,005,"Nevada","Douglas County",2,8,422,232,190
050,32,005,"Nevada","Douglas County",2,9,440,230,210
050,32,005,"Nevada","Douglas County",2,10,489,250,239
050,32,005,"Nevada","Douglas County",2,11,490,255,235
050,32,005,"Nevada","Douglas County",2,12,517,268,249
050,32,005,"Nevada","Douglas County",2,13,500,266,234
050,32,005,"Nevada","Douglas County",2,14,518,279,239
050,32,005,"Nevada","Douglas County",2,15,527,274,253
050,32,005,"Nevada","Douglas County",2,16,527,274,253
050,32,005,"Nevada","Douglas County",2,17,516,267,249
050,32,005,"Nevada","Douglas County",2,18,444,236,208
050,32,005,"Nevada","Douglas County",2,19,370,189,181
050,32,005,"Nevada","Douglas County",2,20,367,192,175
050,32,005,"Nevada","Douglas County",2,21,364,199,165
050,32,005,"Nevada","Douglas County",2,22,362,196,166
050,32,005,"Nevada","Douglas County",2,23,367,197,170
050,32,005,"Nevada","Douglas County",2,24,383,213,170
050,32,005,"Nevada","Douglas County",2,25,395,215,180
050,32,005,"Nevada","Douglas County",2,26,406,210,196
050,32,005,"Nevada","Douglas County",2,27,408,204,204
050,32,005,"Nevada","Douglas County",2,28,467,238,229
050,32,005,"Nevada","Douglas County",2,29,485,256,229
050,32,005,"Nevada","Douglas County",2,30,483,245,238
050,32,005,"Nevada","Douglas County",2,31,464,226,238
050,32,005,"Nevada","Douglas County",2,32,483,251,232
050,32,005,"Nevada","Douglas County",2,33,519,282,237
050,32,005,"Nevada","Douglas County",2,34,512,264,248
050,32,005,"Nevada","Douglas County",2,35,492,270,222
050,32,005,"Nevada","Douglas County",2,36,482,257,225
050,32,005,"Nevada","Douglas County",2,37,511,264,247
050,32,005,"Nevada","Douglas County",2,38,540,287,253
050,32,005,"Nevada","Douglas County",2,39,548,287,261
050,32,005,"Nevada","Douglas County",2,40,538,275,263
050,32,005,"Nevada","Douglas County",2,41,490,251,239
050,32,005,"Nevada","Douglas County",2,42,470,238,232
050,32,005,"Nevada","Douglas County",2,43,489,255,234
050,32,005,"Nevada","Douglas County",2,44,469,238,231
050,32,005,"Nevada","Douglas County",2,45,469,243,226
050,32,005,"Nevada","Douglas County",2,46,457,238,219
050,32,005,"Nevada","Douglas County",2,47,484,246,238
050,32,005,"Nevada","Douglas County",2,48,512,251,261
050,32,005,"Nevada","Douglas County",2,49,553,260,293
050,32,005,"Nevada","Douglas County",2,50,573,285,288
050,32,005,"Nevada","Douglas County",2,51,568,290,278
050,32,005,"Nevada","Douglas County",2,52,553,273,280
050,32,005,"Nevada","Douglas County",2,53,562,268,294
050,32,005,"Nevada","Douglas County",2,54,611,286,325
050,32,005,"Nevada","Douglas County",2,55,678,327,351
050,32,005,"Nevada","Douglas County",2,56,759,372,387
050,32,005,"Nevada","Douglas County",2,57,810,399,411
050,32,005,"Nevada","Douglas County",2,58,874,430,444
050,32,005,"Nevada","Douglas County",2,59,921,433,488
050,32,005,"Nevada","Douglas County",2,60,908,435,473
050,32,005,"Nevada","Douglas County",2,61,974,464,510
050,32,005,"Nevada","Douglas County",2,62,1019,494,525
050,32,005,"Nevada","Douglas County",2,63,989,480,509
050,32,005,"Nevada","Douglas County",2,64,984,490,494
050,32,005,"Nevada","Douglas County",2,65,1031,521,510
050,32,005,"Nevada","Douglas County",2,66,1046,512,534
050,32,005,"Nevada","Douglas County",2,67,1020,505,515
050,32,005,"Nevada","Douglas County",2,68,973,473,500
050,32,005,"Nevada","Douglas County",2,69,899,444,455
050,32,005,"Nevada","Douglas County",2,70,834,415,419
050,32,005,"Nevada","Douglas County",2,71,850,426,424
050,32,005,"Nevada","Douglas County",2,72,899,457,442
050,32,005,"Nevada","Douglas County",2,73,965,507,458
050,32,005,"Nevada","Douglas County",2,74,680,352,328
050,32,005,"Nevada","Douglas County",2,75,647,336,311
050,32,005,"Nevada","Douglas County",2,76,632,316,316
050,32,005,"Nevada","Douglas County",2,77,650,316,334
050,32,005,"Nevada","Douglas County",2,78,529,254,275
050,32,005,"Nevada","Douglas County",2,79,446,229,217
050,32,005,"Nevada","Douglas County",2,80,405,216,189
050,32,005,"Nevada","Douglas County",2,81,382,205,177
050,32,005,"Nevada","Douglas County",2,82,349,188,161
050,32,005,"Nevada","Douglas County",2,83,290,150,140
050,32,005,"Nevada","Douglas County",2,84,239,117,122
050,32,005,"Nevada","Douglas County",2,85,1385,611,774
050,32,005,"Nevada","Douglas County",3,0,345,183,162
050,32,005,"Nevada","Douglas County",3,1,333,170,163
050,32,005,"Nevada","Douglas County",3,2,349,187,162
050,32,005,"Nevada","Douglas County",3,3,330,165,165
050,32,005,"Nevada","Douglas County",3,4,359,185,174
050,32,005,"Nevada","Douglas County",3,5,383,217,166
050,32,005,"Nevada","Douglas County",3,6,392,209,183
050,32,005,"Nevada","Douglas County",3,7,412,215,197
050,32,005,"Nevada","Douglas County",3,8,412,209,203
050,32,005,"Nevada","Douglas County",3,9,415,225,190
050,32,005,"Nevada","Douglas County",3,10,450,242,208
050,32,005,"Nevada","Douglas County",3,11,482,246,236
050,32,005,"Nevada","Douglas County",3,12,483,254,229
050,32,005,"Nevada","Douglas County",3,13,515,264,251
050,32,005,"Nevada","Douglas County",3,14,509,272,237
050,32,005,"Nevada","Douglas County",3,15,521,279,242
050,32,005,"Nevada","Douglas County",3,16,524,274,250
050,32,005,"Nevada","Douglas County",3,17,513,267,246
050,32,005,"Nevada","Douglas County",3,18,443,239,204
050,32,005,"Nevada","Douglas County",3,19,347,176,171
050,32,005,"Nevada","Douglas County",3,20,378,196,182
050,32,005,"Nevada","Douglas County",3,21,364,187,177
050,32,005,"Nevada","Douglas County",3,22,373,207,166
050,32,005,"Nevada","Douglas County",3,23,384,215,169
050,32,005,"Nevada","Douglas County",3,24,360,200,160
050,32,005,"Nevada","Douglas County",3,25,398,217,181
050,32,005,"Nevada","Douglas County",3,26,390,220,170
050,32,005,"Nevada","Douglas County",3,27,417,219,198
050,32,005,"Nevada","Douglas County",3,28,413,225,188
050,32,005,"Nevada","Douglas County",3,29,481,244,237
050,32,005,"Nevada","Douglas County",3,30,511,258,253
050,32,005,"Nevada","Douglas County",3,31,499,265,234
050,32,005,"Nevada","Douglas County",3,32,458,230,228
050,32,005,"Nevada","Douglas County",3,33,506,264,242
050,32,005,"Nevada","Douglas County",3,34,538,288,250
050,32,005,"Nevada","Douglas County",3,35,519,277,242
050,32,005,"Nevada","Douglas County",3,36,524,282,242
050,32,005,"Nevada","Douglas County",3,37,501,257,244
050,32,005,"Nevada","Douglas County",3,38,538,282,256
050,32,005,"Nevada","Douglas County",3,39,549,290,259
050,32,005,"Nevada","Douglas County",3,40,550,282,268
050,32,005,"Nevada","Douglas County",3,41,542,279,263
050,32,005,"Nevada","Douglas County",3,42,487,248,239
050,32,005,"Nevada","Douglas County",3,43,464,236,228
050,32,005,"Nevada","Douglas County",3,44,486,247,239
050,32,005,"Nevada","Douglas County",3,45,486,255,231
050,32,005,"Nevada","Douglas County",3,46,463,246,217
050,32,005,"Nevada","Douglas County",3,47,467,249,218
050,32,005,"Nevada","Douglas County",3,48,471,230,241
050,32,005,"Nevada","Douglas County",3,49,522,249,273
050,32,005,"Nevada","Douglas County",3,50,556,267,289
050,32,005,"Nevada","Douglas County",3,51,583,290,293
050,32,005,"Nevada","Douglas County",3,52,590,304,286
050,32,005,"Nevada","Douglas County",3,53,583,290,293
050,32,005,"Nevada","Douglas County",3,54,581,279,302
050,32,005,"Nevada","Douglas County",3,55,610,274,336
050,32,005,"Nevada","Douglas County",3,56,696,332,364
050,32,005,"Nevada","Douglas County",3,57,784,382,402
050,32,005,"Nevada","Douglas County",3,58,838,416,422
050,32,005,"Nevada","Douglas County",3,59,898,444,454
050,32,005,"Nevada","Douglas County",3,60,928,440,488
050,32,005,"Nevada","Douglas County",3,61,945,459,486
050,32,005,"Nevada","Douglas County",3,62,995,472,523
050,32,005,"Nevada","Douglas County",3,63,1061,515,546
050,32,005,"Nevada","Douglas County",3,64,1025,500,525
050,32,005,"Nevada","Douglas County",3,65,1011,502,509
050,32,005,"Nevada","Douglas County",3,66,1059,533,526
050,32,005,"Nevada","Douglas County",3,67,1066,513,553
050,32,005,"Nevada","Douglas County",3,68,1017,505,512
050,32,005,"Nevada","Douglas County",3,69,971,467,504
050,32,005,"Nevada","Douglas County",3,70,911,449,462
050,32,005,"Nevada","Douglas County",3,71,824,410,414
050,32,005,"Nevada","Douglas County",3,72,846,424,422
050,32,005,"Nevada","Douglas County",3,73,874,446,428
050,32,005,"Nevada","Douglas County",3,74,958,500,458
050,32,005,"Nevada","Douglas County",3,75,664,343,321
050,32,005,"Nevada","Douglas County",3,76,634,326,308
050,32,005,"Nevada","Douglas County",3,77,609,294,315
050,32,005,"Nevada","Douglas County",3,78,637,304,333
050,32,005,"Nevada","Douglas County",3,79,503,240,263
050,32,005,"Nevada","Douglas County",3,80,439,227,212
050,32,005,"Nevada","Douglas County",3,81,381,202,179
050,32,005,"Nevada","Douglas County",3,82,368,194,174
050,32,005,"Nevada","Douglas County",3,83,334,177,157
050,32,005,"Nevada","Douglas County",3,84,271,139,132
050,32,005,"Nevada","Douglas County",3,85,1393,620,773
050,32,005,"Nevada","Douglas County",4,0,319,171,148
050,32,005,"Nevada","Douglas County",4,1,348,183,165
050,32,005,"Nevada","Douglas County",4,2,339,179,160
050,32,005,"Nevada","Douglas County",4,3,350,184,166
050,32,005,"Nevada","Douglas County",4,4,304,156,148
050,32,005,"Nevada","Douglas County",4,5,351,182,169
050,32,005,"Nevada","Douglas County",4,6,382,211,171
050,32,005,"Nevada","Douglas County",4,7,376,204,172
050,32,005,"Nevada","Douglas County",4,8,416,223,193
050,32,005,"Nevada","Douglas County",4,9,416,213,203
050,32,005,"Nevada","Douglas County",4,10,411,216,195
050,32,005,"Nevada","Douglas County",4,11,445,239,206
050,32,005,"Nevada","Douglas County",4,12,463,231,232
050,32,005,"Nevada","Douglas County",4,13,469,246,223
050,32,005,"Nevada","Douglas County",4,14,514,266,248
050,32,005,"Nevada","Douglas County",4,15,506,275,231
050,32,005,"Nevada","Douglas County",4,16,514,280,234
050,32,005,"Nevada","Douglas County",4,17,518,274,244
050,32,005,"Nevada","Douglas County",4,18,422,228,194
050,32,005,"Nevada","Douglas County",4,19,343,187,156
050,32,005,"Nevada","Douglas County",4,20,329,175,154
050,32,005,"Nevada","Douglas County",4,21,379,202,177
050,32,005,"Nevada","Douglas County",4,22,381,194,187
050,32,005,"Nevada","Douglas County",4,23,367,207,160
050,32,005,"Nevada","Douglas County",4,24,360,199,161
050,32,005,"Nevada","Douglas County",4,25,356,187,169
050,32,005,"Nevada","Douglas County",4,26,406,217,189
050,32,005,"Nevada","Douglas County",4,27,365,203,162
050,32,005,"Nevada","Douglas County",4,28,429,219,210
050,32,005,"Nevada","Douglas County",4,29,429,231,198
050,32,005,"Nevada","Douglas County",4,30,481,244,237
050,32,005,"Nevada","Douglas County",4,31,530,270,260
050,32,005,"Nevada","Douglas County",4,32,518,282,236
050,32,005,"Nevada","Douglas County",4,33,467,247,220
050,32,005,"Nevada","Douglas County",4,34,495,252,243
050,32,005,"Nevada","Douglas County",4,35,517,269,248
050,32,005,"Nevada","Douglas County",4,36,517,272,245
050,32,005,"Nevada","Douglas County",4,37,533,283,250
050,32,005,"Nevada","Douglas County",4,38,513,265,248
050,32,005,"Nevada","Douglas County",4,39,542,277,265
050,32,005,"Nevada","Douglas County",4,40,565,295,270
050,32,005,"Nevada","Douglas County",4,41,554,283,271
050,32,005,"Nevada","Douglas County",4,42,542,275,267
050,32,005,"Nevada","Douglas County",4,43,485,254,231
050,32,005,"Nevada","Douglas County",4,44,452,223,229
050,32,005,"Nevada","Douglas County",4,45,476,247,229
050,32,005,"Nevada","Douglas County",4,46,472,246,226
050,32,005,"Nevada","Douglas County",4,47,457,245,212
050,32,005,"Nevada","Douglas County",4,48,445,240,205
050,32,005,"Nevada","Douglas County",4,49,474,222,252
050,32,005,"Nevada","Douglas County",4,50,513,255,258
050,32,005,"Nevada","Douglas County",4,51,557,256,301
050,32,005,"Nevada","Douglas County",4,52,587,294,293
050,32,005,"Nevada","Douglas County",4,53,606,315,291
050,32,005,"Nevada","Douglas County",4,54,604,299,305
050,32,005,"Nevada","Douglas County",4,55,588,280,308
050,32,005,"Nevada","Douglas County",4,56,629,287,342
050,32,005,"Nevada","Douglas County",4,57,724,348,376
050,32,005,"Nevada","Douglas County",4,58,791,386,405
050,32,005,"Nevada","Douglas County",4,59,879,440,439
050,32,005,"Nevada","Douglas County",4,60,902,445,457
050,32,005,"Nevada","Douglas County",4,61,926,443,483
050,32,005,"Nevada","Douglas County",4,62,954,467,487
050,32,005,"Nevada","Douglas County",4,63,1005,488,517
050,32,005,"Nevada","Douglas County",4,64,1066,529,537
050,32,005,"Nevada","Douglas County",4,65,1041,505,536
050,32,005,"Nevada","Douglas County",4,66,1020,513,507
050,32,005,"Nevada","Douglas County",4,67,1076,540,536
050,32,005,"Nevada","Douglas County",4,68,1058,498,560
050,32,005,"Nevada","Douglas County",4,69,1005,508,497
050,32,005,"Nevada","Douglas County",4,70,965,464,501
050,32,005,"Nevada","Douglas County",4,71,916,448,468
050,32,005,"Nevada","Douglas County",4,72,797,394,403
050,32,005,"Nevada","Douglas County",4,73,831,418,413
050,32,005,"Nevada","Douglas County",4,74,864,428,436
050,32,005,"Nevada","Douglas County",4,75,947,493,454
050,32,005,"Nevada","Douglas County",4,76,624,318,306
050,32,005,"Nevada","Douglas County",4,77,625,323,302
050,32,005,"Nevada","Douglas County",4,78,583,285,298
050,32,005,"Nevada","Douglas County",4,79,588,281,307
050,32,005,"Nevada","Douglas County",4,80,479,231,248
050,32,005,"Nevada","Douglas County",4,81,410,203,207
050,32,005,"Nevada","Douglas County",4,82,352,180,172
050,32,005,"Nevada","Douglas County",4,83,352,180,172
050,32,005,"Nevada","Douglas County",4,84,318,166,152
050,32,005,"Nevada","Douglas County",4,85,1438,646,792
050,32,005,"Nevada","Douglas County",5,0,315,166,149
050,32,005,"Nevada","Douglas County",5,1,309,158,151
050,32,005,"Nevada","Douglas County",5,2,343,168,175
050,32,005,"Nevada","Douglas County",5,3,330,174,156
050,32,005,"Nevada","Douglas County",5,4,350,182,168
050,32,005,"Nevada","Douglas County",5,5,302,162,140
050,32,005,"Nevada","Douglas County",5,6,354,176,178
050,32,005,"Nevada","Douglas County",5,7,374,213,161
050,32,005,"Nevada","Douglas County",5,8,375,197,178
050,32,005,"Nevada","Douglas County",5,9,418,224,194
050,32,005,"Nevada","Douglas County",5,10,412,214,198
050,32,005,"Nevada","Douglas County",5,11,420,214,206
050,32,005,"Nevada","Douglas County",5,12,421,239,182
050,32,005,"Nevada","Douglas County",5,13,444,226,218
050,32,005,"Nevada","Douglas County",5,14,474,245,229
050,32,005,"Nevada","Douglas County",5,15,506,261,245
050,32,005,"Nevada","Douglas County",5,16,513,276,237
050,32,005,"Nevada","Douglas County",5,17,510,274,236
050,32,005,"Nevada","Douglas County",5,18,427,238,189
050,32,005,"Nevada","Douglas County",5,19,338,182,156
050,32,005,"Nevada","Douglas County",5,20,351,195,156
050,32,005,"Nevada","Douglas County",5,21,348,184,164
050,32,005,"Nevada","Douglas County",5,22,370,188,182
050,32,005,"Nevada","Douglas County",5,23,369,197,172
050,32,005,"Nevada","Douglas County",5,24,382,219,163
050,32,005,"Nevada","Douglas County",5,25,368,198,170
050,32,005,"Nevada","Douglas County",5,26,383,207,176
050,32,005,"Nevada","Douglas County",5,27,427,220,207
050,32,005,"Nevada","Douglas County",5,28,394,220,174
050,32,005,"Nevada","Douglas County",5,29,426,219,207
050,32,005,"Nevada","Douglas County",5,30,420,221,199
050,32,005,"Nevada","Douglas County",5,31,510,256,254
050,32,005,"Nevada","Douglas County",5,32,514,264,250
050,32,005,"Nevada","Douglas County",5,33,544,298,246
050,32,005,"Nevada","Douglas County",5,34,462,239,223
050,32,005,"Nevada","Douglas County",5,35,498,262,236
050,32,005,"Nevada","Douglas County",5,36,512,280,232
050,32,005,"Nevada","Douglas County",5,37,519,278,241
050,32,005,"Nevada","Douglas County",5,38,537,292,245
050,32,005,"Nevada","Douglas County",5,39,517,262,255
050,32,005,"Nevada","Douglas County",5,40,533,273,260
050,32,005,"Nevada","Douglas County",5,41,573,300,273
050,32,005,"Nevada","Douglas County",5,42,539,280,259
050,32,005,"Nevada","Douglas County",5,43,548,277,271
050,32,005,"Nevada","Douglas County",5,44,478,249,229
050,32,005,"Nevada","Douglas County",5,45,448,224,224
050,32,005,"Nevada","Douglas County",5,46,468,242,226
050,32,005,"Nevada","Douglas County",5,47,486,263,223
050,32,005,"Nevada","Douglas County",5,48,447,234,213
050,32,005,"Nevada","Douglas County",5,49,461,242,219
050,32,005,"Nevada","Douglas County",5,50,465,221,244
050,32,005,"Nevada","Douglas County",5,51,530,261,269
050,32,005,"Nevada","Douglas County",5,52,566,264,302
050,32,005,"Nevada","Douglas County",5,53,595,300,295
050,32,005,"Nevada","Douglas County",5,54,613,318,295
050,32,005,"Nevada","Douglas County",5,55,630,308,322
050,32,005,"Nevada","Douglas County",5,56,593,283,310
050,32,005,"Nevada","Douglas County",5,57,650,302,348
050,32,005,"Nevada","Douglas County",5,58,739,356,383
050,32,005,"Nevada","Douglas County",5,59,830,409,421
050,32,005,"Nevada","Douglas County",5,60,889,438,451
050,32,005,"Nevada","Douglas County",5,61,913,448,465
050,32,005,"Nevada","Douglas County",5,62,958,459,499
050,32,005,"Nevada","Douglas County",5,63,981,469,512
050,32,005,"Nevada","Douglas County",5,64,1022,492,530
050,32,005,"Nevada","Douglas County",5,65,1078,540,538
050,32,005,"Nevada","Douglas County",5,66,1038,506,532
050,32,005,"Nevada","Douglas County",5,67,1024,514,510
050,32,005,"Nevada","Douglas County",5,68,1058,525,533
050,32,005,"Nevada","Douglas County",5,69,1051,494,557
050,32,005,"Nevada","Douglas County",5,70,1002,507,495
050,32,005,"Nevada","Douglas County",5,71,953,472,481
050,32,005,"Nevada","Douglas County",5,72,885,433,452
050,32,005,"Nevada","Douglas County",5,73,778,383,395
050,32,005,"Nevada","Douglas County",5,74,813,400,413
050,32,005,"Nevada","Douglas County",5,75,841,415,426
050,32,005,"Nevada","Douglas County",5,76,912,474,438
050,32,005,"Nevada","Douglas County",5,77,615,312,303
050,32,005,"Nevada","Douglas County",5,78,605,309,296
050,32,005,"Nevada","Douglas County",5,79,546,270,276
050,32,005,"Nevada","Douglas County",5,80,552,267,285
050,32,005,"Nevada","Douglas County",5,81,453,211,242
050,32,005,"Nevada","Douglas County",5,82,394,198,196
050,32,005,"Nevada","Douglas County",5,83,322,162,160
050,32,005,"Nevada","Douglas County",5,84,332,166,166
050,32,005,"Nevada","Douglas County",5,85,1552,716,836
050,32,007,"Nevada","Elko County",1,0,721,369,352
050,32,007,"Nevada","Elko County",1,1,743,390,353
050,32,007,"Nevada","Elko County",1,2,803,429,374
050,32,007,"Nevada","Elko County",1,3,750,388,362
050,32,007,"Nevada","Elko County",1,4,751,403,348
050,32,007,"Nevada","Elko County",1,5,807,403,404
050,32,007,"Nevada","Elko County",1,6,804,409,395
050,32,007,"Nevada","Elko County",1,7,756,405,351
050,32,007,"Nevada","Elko County",1,8,737,391,346
050,32,007,"Nevada","Elko County",1,9,826,406,420
050,32,007,"Nevada","Elko County",1,10,888,432,456
050,32,007,"Nevada","Elko County",1,11,915,472,443
050,32,007,"Nevada","Elko County",1,12,929,481,448
050,32,007,"Nevada","Elko County",1,13,884,435,449
050,32,007,"Nevada","Elko County",1,14,822,420,402
050,32,007,"Nevada","Elko County",1,15,853,449,404
050,32,007,"Nevada","Elko County",1,16,784,409,375
050,32,007,"Nevada","Elko County",1,17,773,411,362
050,32,007,"Nevada","Elko County",1,18,680,386,294
050,32,007,"Nevada","Elko County",1,19,562,317,245
050,32,007,"Nevada","Elko County",1,20,560,301,259
050,32,007,"Nevada","Elko County",1,21,577,293,284
050,32,007,"Nevada","Elko County",1,22,619,324,295
050,32,007,"Nevada","Elko County",1,23,668,356,312
050,32,007,"Nevada","Elko County",1,24,687,369,318
050,32,007,"Nevada","Elko County",1,25,734,384,350
050,32,007,"Nevada","Elko County",1,26,768,388,380
050,32,007,"Nevada","Elko County",1,27,760,383,377
050,32,007,"Nevada","Elko County",1,28,775,402,373
050,32,007,"Nevada","Elko County",1,29,848,450,398
050,32,007,"Nevada","Elko County",1,30,848,448,400
050,32,007,"Nevada","Elko County",1,31,833,425,408
050,32,007,"Nevada","Elko County",1,32,811,425,386
050,32,007,"Nevada","Elko County",1,33,825,441,384
050,32,007,"Nevada","Elko County",1,34,811,433,378
050,32,007,"Nevada","Elko County",1,35,807,435,372
050,32,007,"Nevada","Elko County",1,36,762,403,359
050,32,007,"Nevada","Elko County",1,37,776,421,355
050,32,007,"Nevada","Elko County",1,38,777,413,364
050,32,007,"Nevada","Elko County",1,39,754,408,346
050,32,007,"Nevada","Elko County",1,40,742,413,329
050,32,007,"Nevada","Elko County",1,41,678,367,311
050,32,007,"Nevada","Elko County",1,42,683,355,328
050,32,007,"Nevada","Elko County",1,43,641,334,307
050,32,007,"Nevada","Elko County",1,44,614,323,291
050,32,007,"Nevada","Elko County",1,45,617,331,286
050,32,007,"Nevada","Elko County",1,46,591,313,278
050,32,007,"Nevada","Elko County",1,47,594,291,303
050,32,007,"Nevada","Elko County",1,48,657,332,325
050,32,007,"Nevada","Elko County",1,49,716,363,353
050,32,007,"Nevada","Elko County",1,50,676,351,325
050,32,007,"Nevada","Elko County",1,51,650,331,319
050,32,007,"Nevada","Elko County",1,52,636,344,292
050,32,007,"Nevada","Elko County",1,53,621,319,302
050,32,007,"Nevada","Elko County",1,54,642,343,299
050,32,007,"Nevada","Elko County",1,55,711,366,345
050,32,007,"Nevada","Elko County",1,56,740,388,352
050,32,007,"Nevada","Elko County",1,57,684,368,316
050,32,007,"Nevada","Elko County",1,58,676,363,313
050,32,007,"Nevada","Elko County",1,59,701,378,323
050,32,007,"Nevada","Elko County",1,60,714,376,338
050,32,007,"Nevada","Elko County",1,61,620,332,288
050,32,007,"Nevada","Elko County",1,62,625,330,295
050,32,007,"Nevada","Elko County",1,63,641,348,293
050,32,007,"Nevada","Elko County",1,64,592,312,280
050,32,007,"Nevada","Elko County",1,65,572,300,272
050,32,007,"Nevada","Elko County",1,66,517,271,246
050,32,007,"Nevada","Elko County",1,67,471,257,214
050,32,007,"Nevada","Elko County",1,68,443,237,206
050,32,007,"Nevada","Elko County",1,69,411,219,192
050,32,007,"Nevada","Elko County",1,70,362,184,178
050,32,007,"Nevada","Elko County",1,71,377,190,187
050,32,007,"Nevada","Elko County",1,72,363,181,182
050,32,007,"Nevada","Elko County",1,73,359,185,174
050,32,007,"Nevada","Elko County",1,74,245,131,114
050,32,007,"Nevada","Elko County",1,75,237,121,116
050,32,007,"Nevada","Elko County",1,76,249,123,126
050,32,007,"Nevada","Elko County",1,77,243,127,116
050,32,007,"Nevada","Elko County",1,78,210,102,108
050,32,007,"Nevada","Elko County",1,79,174,92,82
050,32,007,"Nevada","Elko County",1,80,168,91,77
050,32,007,"Nevada","Elko County",1,81,146,68,78
050,32,007,"Nevada","Elko County",1,82,128,61,67
050,32,007,"Nevada","Elko County",1,83,101,52,49
050,32,007,"Nevada","Elko County",1,84,109,53,56
050,32,007,"Nevada","Elko County",1,85,565,232,333
050,32,007,"Nevada","Elko County",2,0,699,369,330
050,32,007,"Nevada","Elko County",2,1,742,389,353
050,32,007,"Nevada","Elko County",2,2,788,419,369
050,32,007,"Nevada","Elko County",2,3,765,398,367
050,32,007,"Nevada","Elko County",2,4,756,401,355
050,32,007,"Nevada","Elko County",2,5,801,407,394
050,32,007,"Nevada","Elko County",2,6,813,411,402
050,32,007,"Nevada","Elko County",2,7,774,409,365
050,32,007,"Nevada","Elko County",2,8,741,394,347
050,32,007,"Nevada","Elko County",2,9,797,398,399
050,32,007,"Nevada","Elko County",2,10,868,425,443
050,32,007,"Nevada","Elko County",2,11,902,458,444
050,32,007,"Nevada","Elko County",2,12,932,482,450
050,32,007,"Nevada","Elko County",2,13,891,443,448
050,32,007,"Nevada","Elko County",2,14,838,425,413
050,32,007,"Nevada","Elko County",2,15,849,445,404
050,32,007,"Nevada","Elko County",2,16,799,417,382
050,32,007,"Nevada","Elko County",2,17,775,411,364
050,32,007,"Nevada","Elko County",2,18,670,376,294
050,32,007,"Nevada","Elko County",2,19,562,316,246
050,32,007,"Nevada","Elko County",2,20,561,302,259
050,32,007,"Nevada","Elko County",2,21,572,290,282
050,32,007,"Nevada","Elko County",2,22,613,314,299
050,32,007,"Nevada","Elko County",2,23,660,349,311
050,32,007,"Nevada","Elko County",2,24,682,362,320
050,32,007,"Nevada","Elko County",2,25,730,383,347
050,32,007,"Nevada","Elko County",2,26,763,388,375
050,32,007,"Nevada","Elko County",2,27,754,378,376
050,32,007,"Nevada","Elko County",2,28,769,393,376
050,32,007,"Nevada","Elko County",2,29,828,435,393
050,32,007,"Nevada","Elko County",2,30,855,450,405
050,32,007,"Nevada","Elko County",2,31,838,431,407
050,32,007,"Nevada","Elko County",2,32,813,424,389
050,32,007,"Nevada","Elko County",2,33,814,434,380
050,32,007,"Nevada","Elko County",2,34,814,435,379
050,32,007,"Nevada","Elko County",2,35,812,437,375
050,32,007,"Nevada","Elko County",2,36,770,410,360
050,32,007,"Nevada","Elko County",2,37,776,418,358
050,32,007,"Nevada","Elko County",2,38,778,416,362
050,32,007,"Nevada","Elko County",2,39,756,409,347
050,32,007,"Nevada","Elko County",2,40,746,411,335
050,32,007,"Nevada","Elko County",2,41,690,374,316
050,32,007,"Nevada","Elko County",2,42,677,356,321
050,32,007,"Nevada","Elko County",2,43,651,340,311
050,32,007,"Nevada","Elko County",2,44,612,321,291
050,32,007,"Nevada","Elko County",2,45,612,325,287
050,32,007,"Nevada","Elko County",2,46,592,313,279
050,32,007,"Nevada","Elko County",2,47,589,294,295
050,32,007,"Nevada","Elko County",2,48,638,320,318
050,32,007,"Nevada","Elko County",2,49,699,353,346
050,32,007,"Nevada","Elko County",2,50,683,350,333
050,32,007,"Nevada","Elko County",2,51,650,332,318
050,32,007,"Nevada","Elko County",2,52,635,337,298
050,32,007,"Nevada","Elko County",2,53,620,323,297
050,32,007,"Nevada","Elko County",2,54,632,336,296
050,32,007,"Nevada","Elko County",2,55,692,358,334
050,32,007,"Nevada","Elko County",2,56,734,383,351
050,32,007,"Nevada","Elko County",2,57,696,373,323
050,32,007,"Nevada","Elko County",2,58,671,358,313
050,32,007,"Nevada","Elko County",2,59,694,373,321
050,32,007,"Nevada","Elko County",2,60,702,372,330
050,32,007,"Nevada","Elko County",2,61,639,340,299
050,32,007,"Nevada","Elko County",2,62,620,329,291
050,32,007,"Nevada","Elko County",2,63,633,340,293
050,32,007,"Nevada","Elko County",2,64,598,315,283
050,32,007,"Nevada","Elko County",2,65,575,301,274
050,32,007,"Nevada","Elko County",2,66,530,278,252
050,32,007,"Nevada","Elko County",2,67,479,261,218
050,32,007,"Nevada","Elko County",2,68,446,241,205
050,32,007,"Nevada","Elko County",2,69,418,223,195
050,32,007,"Nevada","Elko County",2,70,369,190,179
050,32,007,"Nevada","Elko County",2,71,369,183,186
050,32,007,"Nevada","Elko County",2,72,361,180,181
050,32,007,"Nevada","Elko County",2,73,372,190,182
050,32,007,"Nevada","Elko County",2,74,253,135,118
050,32,007,"Nevada","Elko County",2,75,239,123,116
050,32,007,"Nevada","Elko County",2,76,241,119,122
050,32,007,"Nevada","Elko County",2,77,249,128,121
050,32,007,"Nevada","Elko County",2,78,213,103,110
050,32,007,"Nevada","Elko County",2,79,185,96,89
050,32,007,"Nevada","Elko County",2,80,161,86,75
050,32,007,"Nevada","Elko County",2,81,151,73,78
050,32,007,"Nevada","Elko County",2,82,136,63,73
050,32,007,"Nevada","Elko County",2,83,108,52,56
050,32,007,"Nevada","Elko County",2,84,107,52,55
050,32,007,"Nevada","Elko County",2,85,577,233,344
050,32,007,"Nevada","Elko County",3,0,683,359,324
050,32,007,"Nevada","Elko County",3,1,729,378,351
050,32,007,"Nevada","Elko County",3,2,761,401,360
050,32,007,"Nevada","Elko County",3,3,798,430,368
050,32,007,"Nevada","Elko County",3,4,785,403,382
050,32,007,"Nevada","Elko County",3,5,757,397,360
050,32,007,"Nevada","Elko County",3,6,811,413,398
050,32,007,"Nevada","Elko County",3,7,796,403,393
050,32,007,"Nevada","Elko County",3,8,775,411,364
050,32,007,"Nevada","Elko County",3,9,742,394,348
050,32,007,"Nevada","Elko County",3,10,784,384,400
050,32,007,"Nevada","Elko County",3,11,872,413,459
050,32,007,"Nevada","Elko County",3,12,892,446,446
050,32,007,"Nevada","Elko County",3,13,913,479,434
050,32,007,"Nevada","Elko County",3,14,880,437,443
050,32,007,"Nevada","Elko County",3,15,848,441,407
050,32,007,"Nevada","Elko County",3,16,845,442,403
050,32,007,"Nevada","Elko County",3,17,786,405,381
050,32,007,"Nevada","Elko County",3,18,685,366,319
050,32,007,"Nevada","Elko County",3,19,554,318,236
050,32,007,"Nevada","Elko County",3,20,575,322,253
050,32,007,"Nevada","Elko County",3,21,574,301,273
050,32,007,"Nevada","Elko County",3,22,587,298,289
050,32,007,"Nevada","Elko County",3,23,651,332,319
050,32,007,"Nevada","Elko County",3,24,688,363,325
050,32,007,"Nevada","Elko County",3,25,702,380,322
050,32,007,"Nevada","Elko County",3,26,750,395,355
050,32,007,"Nevada","Elko County",3,27,776,399,377
050,32,007,"Nevada","Elko County",3,28,752,376,376
050,32,007,"Nevada","Elko County",3,29,771,396,375
050,32,007,"Nevada","Elko County",3,30,846,442,404
050,32,007,"Nevada","Elko County",3,31,864,446,418
050,32,007,"Nevada","Elko County",3,32,872,453,419
050,32,007,"Nevada","Elko County",3,33,829,436,393
050,32,007,"Nevada","Elko County",3,34,833,438,395
050,32,007,"Nevada","Elko County",3,35,811,440,371
050,32,007,"Nevada","Elko County",3,36,809,439,370
050,32,007,"Nevada","Elko County",3,37,778,409,369
050,32,007,"Nevada","Elko County",3,38,769,416,353
050,32,007,"Nevada","Elko County",3,39,784,427,357
050,32,007,"Nevada","Elko County",3,40,762,405,357
050,32,007,"Nevada","Elko County",3,41,721,396,325
050,32,007,"Nevada","Elko County",3,42,674,367,307
050,32,007,"Nevada","Elko County",3,43,657,347,310
050,32,007,"Nevada","Elko County",3,44,657,345,312
050,32,007,"Nevada","Elko County",3,45,603,308,295
050,32,007,"Nevada","Elko County",3,46,622,339,283
050,32,007,"Nevada","Elko County",3,47,586,317,269
050,32,007,"Nevada","Elko County",3,48,590,294,296
050,32,007,"Nevada","Elko County",3,49,652,319,333
050,32,007,"Nevada","Elko County",3,50,685,346,339
050,32,007,"Nevada","Elko County",3,51,659,341,318
050,32,007,"Nevada","Elko County",3,52,648,335,313
050,32,007,"Nevada","Elko County",3,53,619,319,300
050,32,007,"Nevada","Elko County",3,54,610,323,287
050,32,007,"Nevada","Elko County",3,55,627,329,298
050,32,007,"Nevada","Elko County",3,56,702,378,324
050,32,007,"Nevada","Elko County",3,57,723,381,342
050,32,007,"Nevada","Elko County",3,58,689,361,328
050,32,007,"Nevada","Elko County",3,59,655,350,305
050,32,007,"Nevada","Elko County",3,60,697,372,325
050,32,007,"Nevada","Elko County",3,61,677,356,321
050,32,007,"Nevada","Elko County",3,62,629,342,287
050,32,007,"Nevada","Elko County",3,63,600,321,279
050,32,007,"Nevada","Elko County",3,64,604,325,279
050,32,007,"Nevada","Elko County",3,65,578,293,285
050,32,007,"Nevada","Elko County",3,66,541,288,253
050,32,007,"Nevada","Elko County",3,67,516,270,246
050,32,007,"Nevada","Elko County",3,68,471,254,217
050,32,007,"Nevada","Elko County",3,69,438,238,200
050,32,007,"Nevada","Elko County",3,70,412,216,196
050,32,007,"Nevada","Elko County",3,71,370,189,181
050,32,007,"Nevada","Elko County",3,72,353,173,180
050,32,007,"Nevada","Elko County",3,73,348,170,178
050,32,007,"Nevada","Elko County",3,74,353,177,176
050,32,007,"Nevada","Elko County",3,75,243,131,112
050,32,007,"Nevada","Elko County",3,76,230,116,114
050,32,007,"Nevada","Elko County",3,77,233,110,123
050,32,007,"Nevada","Elko County",3,78,242,119,123
050,32,007,"Nevada","Elko County",3,79,203,98,105
050,32,007,"Nevada","Elko County",3,80,160,84,76
050,32,007,"Nevada","Elko County",3,81,148,76,72
050,32,007,"Nevada","Elko County",3,82,142,70,72
050,32,007,"Nevada","Elko County",3,83,127,56,71
050,32,007,"Nevada","Elko County",3,84,102,46,56
050,32,007,"Nevada","Elko County",3,85,577,241,336
050,32,007,"Nevada","Elko County",4,0,640,332,308
050,32,007,"Nevada","Elko County",4,1,647,354,293
050,32,007,"Nevada","Elko County",4,2,744,381,363
050,32,007,"Nevada","Elko County",4,3,772,399,373
050,32,007,"Nevada","Elko County",4,4,808,446,362
050,32,007,"Nevada","Elko County",4,5,782,386,396
050,32,007,"Nevada","Elko County",4,6,774,413,361
050,32,007,"Nevada","Elko County",4,7,836,419,417
050,32,007,"Nevada","Elko County",4,8,814,409,405
050,32,007,"Nevada","Elko County",4,9,807,432,375
050,32,007,"Nevada","Elko County",4,10,744,390,354
050,32,007,"Nevada","Elko County",4,11,792,396,396
050,32,007,"Nevada","Elko County",4,12,875,423,452
050,32,007,"Nevada","Elko County",4,13,897,445,452
050,32,007,"Nevada","Elko County",4,14,905,478,427
050,32,007,"Nevada","Elko County",4,15,884,442,442
050,32,007,"Nevada","Elko County",4,16,860,446,414
050,32,007,"Nevada","Elko County",4,17,839,444,395
050,32,007,"Nevada","Elko County",4,18,680,359,321
050,32,007,"Nevada","Elko County",4,19,550,298,252
050,32,007,"Nevada","Elko County",4,20,527,295,232
050,32,007,"Nevada","Elko County",4,21,573,316,257
050,32,007,"Nevada","Elko County",4,22,602,318,284
050,32,007,"Nevada","Elko County",4,23,630,326,304
050,32,007,"Nevada","Elko County",4,24,656,335,321
050,32,007,"Nevada","Elko County",4,25,681,357,324
050,32,007,"Nevada","Elko County",4,26,730,404,326
050,32,007,"Nevada","Elko County",4,27,773,406,367
050,32,007,"Nevada","Elko County",4,28,767,388,379
050,32,007,"Nevada","Elko County",4,29,757,379,378
050,32,007,"Nevada","Elko County",4,30,784,402,382
050,32,007,"Nevada","Elko County",4,31,846,433,413
050,32,007,"Nevada","Elko County",4,32,884,455,429
050,32,007,"Nevada","Elko County",4,33,867,445,422
050,32,007,"Nevada","Elko County",4,34,821,437,384
050,32,007,"Nevada","Elko County",4,35,838,436,402
050,32,007,"Nevada","Elko County",4,36,819,442,377
050,32,007,"Nevada","Elko County",4,37,808,429,379
050,32,007,"Nevada","Elko County",4,38,779,406,373
050,32,007,"Nevada","Elko County",4,39,779,414,365
050,32,007,"Nevada","Elko County",4,40,770,419,351
050,32,007,"Nevada","Elko County",4,41,736,392,344
050,32,007,"Nevada","Elko County",4,42,730,406,324
050,32,007,"Nevada","Elko County",4,43,666,350,316
050,32,007,"Nevada","Elko County",4,44,670,352,318
050,32,007,"Nevada","Elko County",4,45,674,358,316
050,32,007,"Nevada","Elko County",4,46,605,311,294
050,32,007,"Nevada","Elko County",4,47,577,309,268
050,32,007,"Nevada","Elko County",4,48,582,316,266
050,32,007,"Nevada","Elko County",4,49,567,272,295
050,32,007,"Nevada","Elko County",4,50,649,320,329
050,32,007,"Nevada","Elko County",4,51,676,350,326
050,32,007,"Nevada","Elko County",4,52,650,339,311
050,32,007,"Nevada","Elko County",4,53,635,331,304
050,32,007,"Nevada","Elko County",4,54,625,323,302
050,32,007,"Nevada","Elko County",4,55,602,301,301
050,32,007,"Nevada","Elko County",4,56,634,336,298
050,32,007,"Nevada","Elko County",4,57,672,365,307
050,32,007,"Nevada","Elko County",4,58,719,377,342
050,32,007,"Nevada","Elko County",4,59,676,353,323
050,32,007,"Nevada","Elko County",4,60,665,357,308
050,32,007,"Nevada","Elko County",4,61,688,365,323
050,32,007,"Nevada","Elko County",4,62,650,341,309
050,32,007,"Nevada","Elko County",4,63,599,327,272
050,32,007,"Nevada","Elko County",4,64,578,311,267
050,32,007,"Nevada","Elko County",4,65,592,312,280
050,32,007,"Nevada","Elko County",4,66,575,278,297
050,32,007,"Nevada","Elko County",4,67,549,298,251
050,32,007,"Nevada","Elko County",4,68,517,268,249
050,32,007,"Nevada","Elko County",4,69,459,253,206
050,32,007,"Nevada","Elko County",4,70,419,226,193
050,32,007,"Nevada","Elko County",4,71,399,209,190
050,32,007,"Nevada","Elko County",4,72,354,181,173
050,32,007,"Nevada","Elko County",4,73,344,168,176
050,32,007,"Nevada","Elko County",4,74,339,161,178
050,32,007,"Nevada","Elko County",4,75,348,176,172
050,32,007,"Nevada","Elko County",4,76,229,121,108
050,32,007,"Nevada","Elko County",4,77,218,107,111
050,32,007,"Nevada","Elko County",4,78,223,110,113
050,32,007,"Nevada","Elko County",4,79,227,116,111
050,32,007,"Nevada","Elko County",4,80,182,88,94
050,32,007,"Nevada","Elko County",4,81,151,77,74
050,32,007,"Nevada","Elko County",4,82,141,74,67
050,32,007,"Nevada","Elko County",4,83,134,65,69
050,32,007,"Nevada","Elko County",4,84,119,47,72
050,32,007,"Nevada","Elko County",4,85,594,251,343
050,32,007,"Nevada","Elko County",5,0,574,299,275
050,32,007,"Nevada","Elko County",5,1,655,338,317
050,32,007,"Nevada","Elko County",5,2,677,369,308
050,32,007,"Nevada","Elko County",5,3,738,379,359
050,32,007,"Nevada","Elko County",5,4,773,400,373
050,32,007,"Nevada","Elko County",5,5,796,432,364
050,32,007,"Nevada","Elko County",5,6,766,390,376
050,32,007,"Nevada","Elko County",5,7,791,431,360
050,32,007,"Nevada","Elko County",5,8,839,423,416
050,32,007,"Nevada","Elko County",5,9,808,420,388
050,32,007,"Nevada","Elko County",5,10,799,418,381
050,32,007,"Nevada","Elko County",5,11,760,397,363
050,32,007,"Nevada","Elko County",5,12,800,398,402
050,32,007,"Nevada","Elko County",5,13,895,425,470
050,32,007,"Nevada","Elko County",5,14,886,442,444
050,32,007,"Nevada","Elko County",5,15,911,476,435
050,32,007,"Nevada","Elko County",5,16,874,442,432
050,32,007,"Nevada","Elko County",5,17,858,445,413
050,32,007,"Nevada","Elko County",5,18,720,395,325
050,32,007,"Nevada","Elko County",5,19,577,306,271
050,32,007,"Nevada","Elko County",5,20,568,306,262
050,32,007,"Nevada","Elko County",5,21,550,307,243
050,32,007,"Nevada","Elko County",5,22,606,327,279
050,32,007,"Nevada","Elko County",5,23,653,340,313
050,32,007,"Nevada","Elko County",5,24,653,339,314
050,32,007,"Nevada","Elko County",5,25,703,363,340
050,32,007,"Nevada","Elko County",5,26,721,385,336
050,32,007,"Nevada","Elko County",5,27,750,430,320
050,32,007,"Nevada","Elko County",5,28,768,408,360
050,32,007,"Nevada","Elko County",5,29,774,387,387
050,32,007,"Nevada","Elko County",5,30,774,391,383
050,32,007,"Nevada","Elko County",5,31,782,390,392
050,32,007,"Nevada","Elko County",5,32,864,451,413
050,32,007,"Nevada","Elko County",5,33,893,470,423
050,32,007,"Nevada","Elko County",5,34,877,452,425
050,32,007,"Nevada","Elko County",5,35,829,448,381
050,32,007,"Nevada","Elko County",5,36,839,442,397
050,32,007,"Nevada","Elko County",5,37,813,427,386
050,32,007,"Nevada","Elko County",5,38,806,426,380
050,32,007,"Nevada","Elko County",5,39,792,413,379
050,32,007,"Nevada","Elko County",5,40,773,415,358
050,32,007,"Nevada","Elko County",5,41,776,417,359
050,32,007,"Nevada","Elko County",5,42,740,394,346
050,32,007,"Nevada","Elko County",5,43,732,406,326
050,32,007,"Nevada","Elko County",5,44,681,369,312
050,32,007,"Nevada","Elko County",5,45,663,343,320
050,32,007,"Nevada","Elko County",5,46,670,347,323
050,32,007,"Nevada","Elko County",5,47,601,305,296
050,32,007,"Nevada","Elko County",5,48,595,319,276
050,32,007,"Nevada","Elko County",5,49,600,325,275
050,32,007,"Nevada","Elko County",5,50,563,275,288
050,32,007,"Nevada","Elko County",5,51,637,315,322
050,32,007,"Nevada","Elko County",5,52,664,357,307
050,32,007,"Nevada","Elko County",5,53,646,336,310
050,32,007,"Nevada","Elko County",5,54,631,335,296
050,32,007,"Nevada","Elko County",5,55,640,333,307
050,32,007,"Nevada","Elko County",5,56,591,303,288
050,32,007,"Nevada","Elko County",5,57,618,323,295
050,32,007,"Nevada","Elko County",5,58,655,356,299
050,32,007,"Nevada","Elko County",5,59,715,378,337
050,32,007,"Nevada","Elko County",5,60,689,368,321
050,32,007,"Nevada","Elko County",5,61,659,355,304
050,32,007,"Nevada","Elko County",5,62,681,357,324
050,32,007,"Nevada","Elko County",5,63,639,345,294
050,32,007,"Nevada","Elko County",5,64,576,323,253
050,32,007,"Nevada","Elko County",5,65,558,298,260
050,32,007,"Nevada","Elko County",5,66,576,299,277
050,32,007,"Nevada","Elko County",5,67,575,275,300
050,32,007,"Nevada","Elko County",5,68,548,296,252
050,32,007,"Nevada","Elko County",5,69,499,265,234
050,32,007,"Nevada","Elko County",5,70,441,242,199
050,32,007,"Nevada","Elko County",5,71,406,220,186
050,32,007,"Nevada","Elko County",5,72,386,199,187
050,32,007,"Nevada","Elko County",5,73,339,172,167
050,32,007,"Nevada","Elko County",5,74,331,165,166
050,32,007,"Nevada","Elko County",5,75,323,154,169
050,32,007,"Nevada","Elko County",5,76,327,167,160
050,32,007,"Nevada","Elko County",5,77,216,112,104
050,32,007,"Nevada","Elko County",5,78,211,101,110
050,32,007,"Nevada","Elko County",5,79,211,108,103
050,32,007,"Nevada","Elko County",5,80,203,106,97
050,32,007,"Nevada","Elko County",5,81,167,81,86
050,32,007,"Nevada","Elko County",5,82,139,74,65
050,32,007,"Nevada","Elko County",5,83,128,68,60
050,32,007,"Nevada","Elko County",5,84,122,58,64
050,32,007,"Nevada","Elko County",5,85,640,259,381
050,32,009,"Nevada","Esmeralda County",1,0,4,2,2
050,32,009,"Nevada","Esmeralda County",1,1,5,2,3
050,32,009,"Nevada","Esmeralda County",1,2,5,2,3
050,32,009,"Nevada","Esmeralda County",1,3,5,3,2
050,32,009,"Nevada","Esmeralda County",1,4,3,2,1
050,32,009,"Nevada","Esmeralda County",1,5,6,2,4
050,32,009,"Nevada","Esmeralda County",1,6,5,3,2
050,32,009,"Nevada","Esmeralda County",1,7,6,3,3
050,32,009,"Nevada","Esmeralda County",1,8,4,2,2
050,32,009,"Nevada","Esmeralda County",1,9,5,4,1
050,32,009,"Nevada","Esmeralda County",1,10,8,4,4
050,32,009,"Nevada","Esmeralda County",1,11,9,7,2
050,32,009,"Nevada","Esmeralda County",1,12,12,6,6
050,32,009,"Nevada","Esmeralda County",1,13,11,5,6
050,32,009,"Nevada","Esmeralda County",1,14,6,3,3
050,32,009,"Nevada","Esmeralda County",1,15,6,4,2
050,32,009,"Nevada","Esmeralda County",1,16,5,4,1
050,32,009,"Nevada","Esmeralda County",1,17,8,4,4
050,32,009,"Nevada","Esmeralda County",1,18,5,2,3
050,32,009,"Nevada","Esmeralda County",1,19,5,3,2
050,32,009,"Nevada","Esmeralda County",1,20,5,4,1
050,32,009,"Nevada","Esmeralda County",1,21,3,1,2
050,32,009,"Nevada","Esmeralda County",1,22,4,2,2
050,32,009,"Nevada","Esmeralda County",1,23,4,4,0
050,32,009,"Nevada","Esmeralda County",1,24,3,1,2
050,32,009,"Nevada","Esmeralda County",1,25,5,2,3
050,32,009,"Nevada","Esmeralda County",1,26,6,4,2
050,32,009,"Nevada","Esmeralda County",1,27,6,3,3
050,32,009,"Nevada","Esmeralda County",1,28,4,3,1
050,32,009,"Nevada","Esmeralda County",1,29,5,5,0
050,32,009,"Nevada","Esmeralda County",1,30,5,4,1
050,32,009,"Nevada","Esmeralda County",1,31,7,4,3
050,32,009,"Nevada","Esmeralda County",1,32,8,4,4
050,32,009,"Nevada","Esmeralda County",1,33,9,2,7
050,32,009,"Nevada","Esmeralda County",1,34,7,4,3
050,32,009,"Nevada","Esmeralda County",1,35,7,4,3
050,32,009,"Nevada","Esmeralda County",1,36,11,6,5
050,32,009,"Nevada","Esmeralda County",1,37,11,4,7
050,32,009,"Nevada","Esmeralda County",1,38,9,5,4
050,32,009,"Nevada","Esmeralda County",1,39,8,3,5
050,32,009,"Nevada","Esmeralda County",1,40,8,3,5
050,32,009,"Nevada","Esmeralda County",1,41,8,6,2
050,32,009,"Nevada","Esmeralda County",1,42,7,4,3
050,32,009,"Nevada","Esmeralda County",1,43,8,4,4
050,32,009,"Nevada","Esmeralda County",1,44,7,5,2
050,32,009,"Nevada","Esmeralda County",1,45,9,5,4
050,32,009,"Nevada","Esmeralda County",1,46,6,4,2
050,32,009,"Nevada","Esmeralda County",1,47,9,4,5
050,32,009,"Nevada","Esmeralda County",1,48,7,5,2
050,32,009,"Nevada","Esmeralda County",1,49,11,6,5
050,32,009,"Nevada","Esmeralda County",1,50,12,8,4
050,32,009,"Nevada","Esmeralda County",1,51,7,4,3
050,32,009,"Nevada","Esmeralda County",1,52,6,3,3
050,32,009,"Nevada","Esmeralda County",1,53,8,5,3
050,32,009,"Nevada","Esmeralda County",1,54,9,6,3
050,32,009,"Nevada","Esmeralda County",1,55,9,5,4
050,32,009,"Nevada","Esmeralda County",1,56,12,6,6
050,32,009,"Nevada","Esmeralda County",1,57,14,6,8
050,32,009,"Nevada","Esmeralda County",1,58,13,6,7
050,32,009,"Nevada","Esmeralda County",1,59,13,9,4
050,32,009,"Nevada","Esmeralda County",1,60,10,6,4
050,32,009,"Nevada","Esmeralda County",1,61,14,9,5
050,32,009,"Nevada","Esmeralda County",1,62,8,6,2
050,32,009,"Nevada","Esmeralda County",1,63,12,7,5
050,32,009,"Nevada","Esmeralda County",1,64,10,4,6
050,32,009,"Nevada","Esmeralda County",1,65,5,3,2
050,32,009,"Nevada","Esmeralda County",1,66,9,4,5
050,32,009,"Nevada","Esmeralda County",1,67,15,8,7
050,32,009,"Nevada","Esmeralda County",1,68,15,9,6
050,32,009,"Nevada","Esmeralda County",1,69,13,9,4
050,32,009,"Nevada","Esmeralda County",1,70,11,6,5
050,32,009,"Nevada","Esmeralda County",1,71,20,10,10
050,32,009,"Nevada","Esmeralda County",1,72,20,12,8
050,32,009,"Nevada","Esmeralda County",1,73,14,9,5
050,32,009,"Nevada","Esmeralda County",1,74,13,7,6
050,32,009,"Nevada","Esmeralda County",1,75,9,2,7
050,32,009,"Nevada","Esmeralda County",1,76,11,5,6
050,32,009,"Nevada","Esmeralda County",1,77,10,6,4
050,32,009,"Nevada","Esmeralda County",1,78,2,1,1
050,32,009,"Nevada","Esmeralda County",1,79,9,5,4
050,32,009,"Nevada","Esmeralda County",1,80,6,5,1
050,32,009,"Nevada","Esmeralda County",1,81,9,4,5
050,32,009,"Nevada","Esmeralda County",1,82,6,4,2
050,32,009,"Nevada","Esmeralda County",1,83,7,5,2
050,32,009,"Nevada","Esmeralda County",1,84,6,6,0
050,32,009,"Nevada","Esmeralda County",1,85,33,19,14
050,32,009,"Nevada","Esmeralda County",2,0,4,2,2
050,32,009,"Nevada","Esmeralda County",2,1,5,2,3
050,32,009,"Nevada","Esmeralda County",2,2,5,2,3
050,32,009,"Nevada","Esmeralda County",2,3,5,3,2
050,32,009,"Nevada","Esmeralda County",2,4,3,2,1
050,32,009,"Nevada","Esmeralda County",2,5,6,2,4
050,32,009,"Nevada","Esmeralda County",2,6,5,3,2
050,32,009,"Nevada","Esmeralda County",2,7,6,3,3
050,32,009,"Nevada","Esmeralda County",2,8,4,2,2
050,32,009,"Nevada","Esmeralda County",2,9,5,4,1
050,32,009,"Nevada","Esmeralda County",2,10,7,4,3
050,32,009,"Nevada","Esmeralda County",2,11,8,6,2
050,32,009,"Nevada","Esmeralda County",2,12,13,7,6
050,32,009,"Nevada","Esmeralda County",2,13,11,5,6
050,32,009,"Nevada","Esmeralda County",2,14,6,3,3
050,32,009,"Nevada","Esmeralda County",2,15,6,4,2
050,32,009,"Nevada","Esmeralda County",2,16,5,4,1
050,32,009,"Nevada","Esmeralda County",2,17,8,4,4
050,32,009,"Nevada","Esmeralda County",2,18,5,2,3
050,32,009,"Nevada","Esmeralda County",2,19,5,3,2
050,32,009,"Nevada","Esmeralda County",2,20,5,4,1
050,32,009,"Nevada","Esmeralda County",2,21,3,1,2
050,32,009,"Nevada","Esmeralda County",2,22,4,2,2
050,32,009,"Nevada","Esmeralda County",2,23,5,4,1
050,32,009,"Nevada","Esmeralda County",2,24,3,1,2
050,32,009,"Nevada","Esmeralda County",2,25,5,2,3
050,32,009,"Nevada","Esmeralda County",2,26,6,4,2
050,32,009,"Nevada","Esmeralda County",2,27,5,3,2
050,32,009,"Nevada","Esmeralda County",2,28,4,3,1
050,32,009,"Nevada","Esmeralda County",2,29,4,4,0
050,32,009,"Nevada","Esmeralda County",2,30,6,5,1
050,32,009,"Nevada","Esmeralda County",2,31,8,5,3
050,32,009,"Nevada","Esmeralda County",2,32,9,5,4
050,32,009,"Nevada","Esmeralda County",2,33,8,2,6
050,32,009,"Nevada","Esmeralda County",2,34,7,4,3
050,32,009,"Nevada","Esmeralda County",2,35,7,4,3
050,32,009,"Nevada","Esmeralda County",2,36,10,5,5
050,32,009,"Nevada","Esmeralda County",2,37,11,4,7
050,32,009,"Nevada","Esmeralda County",2,38,10,5,5
050,32,009,"Nevada","Esmeralda County",2,39,8,3,5
050,32,009,"Nevada","Esmeralda County",2,40,9,4,5
050,32,009,"Nevada","Esmeralda County",2,41,7,5,2
050,32,009,"Nevada","Esmeralda County",2,42,7,4,3
050,32,009,"Nevada","Esmeralda County",2,43,8,4,4
050,32,009,"Nevada","Esmeralda County",2,44,7,5,2
050,32,009,"Nevada","Esmeralda County",2,45,9,5,4
050,32,009,"Nevada","Esmeralda County",2,46,6,4,2
050,32,009,"Nevada","Esmeralda County",2,47,9,4,5
050,32,009,"Nevada","Esmeralda County",2,48,7,5,2
050,32,009,"Nevada","Esmeralda County",2,49,10,6,4
050,32,009,"Nevada","Esmeralda County",2,50,11,7,4
050,32,009,"Nevada","Esmeralda County",2,51,8,5,3
050,32,009,"Nevada","Esmeralda County",2,52,6,3,3
050,32,009,"Nevada","Esmeralda County",2,53,8,5,3
050,32,009,"Nevada","Esmeralda County",2,54,8,5,3
050,32,009,"Nevada","Esmeralda County",2,55,9,5,4
050,32,009,"Nevada","Esmeralda County",2,56,12,6,6
050,32,009,"Nevada","Esmeralda County",2,57,14,6,8
050,32,009,"Nevada","Esmeralda County",2,58,14,7,7
050,32,009,"Nevada","Esmeralda County",2,59,14,9,5
050,32,009,"Nevada","Esmeralda County",2,60,11,7,4
050,32,009,"Nevada","Esmeralda County",2,61,13,8,5
050,32,009,"Nevada","Esmeralda County",2,62,9,6,3
050,32,009,"Nevada","Esmeralda County",2,63,12,7,5
050,32,009,"Nevada","Esmeralda County",2,64,10,5,5
050,32,009,"Nevada","Esmeralda County",2,65,5,3,2
050,32,009,"Nevada","Esmeralda County",2,66,8,4,4
050,32,009,"Nevada","Esmeralda County",2,67,14,7,7
050,32,009,"Nevada","Esmeralda County",2,68,15,8,7
050,32,009,"Nevada","Esmeralda County",2,69,15,10,5
050,32,009,"Nevada","Esmeralda County",2,70,12,7,5
050,32,009,"Nevada","Esmeralda County",2,71,18,9,9
050,32,009,"Nevada","Esmeralda County",2,72,18,10,8
050,32,009,"Nevada","Esmeralda County",2,73,16,10,6
050,32,009,"Nevada","Esmeralda County",2,74,13,7,6
050,32,009,"Nevada","Esmeralda County",2,75,10,3,7
050,32,009,"Nevada","Esmeralda County",2,76,11,5,6
050,32,009,"Nevada","Esmeralda County",2,77,10,6,4
050,32,009,"Nevada","Esmeralda County",2,78,4,2,2
050,32,009,"Nevada","Esmeralda County",2,79,9,5,4
050,32,009,"Nevada","Esmeralda County",2,80,6,5,1
050,32,009,"Nevada","Esmeralda County",2,81,8,4,4
050,32,009,"Nevada","Esmeralda County",2,82,8,5,3
050,32,009,"Nevada","Esmeralda County",2,83,6,4,2
050,32,009,"Nevada","Esmeralda County",2,84,6,6,0
050,32,009,"Nevada","Esmeralda County",2,85,34,20,14
050,32,009,"Nevada","Esmeralda County",3,0,4,0,4
050,32,009,"Nevada","Esmeralda County",3,1,3,1,2
050,32,009,"Nevada","Esmeralda County",3,2,4,3,1
050,32,009,"Nevada","Esmeralda County",3,3,5,2,3
050,32,009,"Nevada","Esmeralda County",3,4,4,2,2
050,32,009,"Nevada","Esmeralda County",3,5,4,2,2
050,32,009,"Nevada","Esmeralda County",3,6,8,3,5
050,32,009,"Nevada","Esmeralda County",3,7,4,2,2
050,32,009,"Nevada","Esmeralda County",3,8,7,3,4
050,32,009,"Nevada","Esmeralda County",3,9,6,3,3
050,32,009,"Nevada","Esmeralda County",3,10,5,4,1
050,32,009,"Nevada","Esmeralda County",3,11,6,3,3
050,32,009,"Nevada","Esmeralda County",3,12,7,5,2
050,32,009,"Nevada","Esmeralda County",3,13,14,7,7
050,32,009,"Nevada","Esmeralda County",3,14,10,5,5
050,32,009,"Nevada","Esmeralda County",3,15,6,2,4
050,32,009,"Nevada","Esmeralda County",3,16,4,3,1
050,32,009,"Nevada","Esmeralda County",3,17,7,4,3
050,32,009,"Nevada","Esmeralda County",3,18,8,4,4
050,32,009,"Nevada","Esmeralda County",3,19,7,3,4
050,32,009,"Nevada","Esmeralda County",3,20,6,4,2
050,32,009,"Nevada","Esmeralda County",3,21,6,4,2
050,32,009,"Nevada","Esmeralda County",3,22,3,1,2
050,32,009,"Nevada","Esmeralda County",3,23,6,2,4
050,32,009,"Nevada","Esmeralda County",3,24,6,4,2
050,32,009,"Nevada","Esmeralda County",3,25,3,1,2
050,32,009,"Nevada","Esmeralda County",3,26,5,2,3
050,32,009,"Nevada","Esmeralda County",3,27,6,4,2
050,32,009,"Nevada","Esmeralda County",3,28,5,3,2
050,32,009,"Nevada","Esmeralda County",3,29,5,4,1
050,32,009,"Nevada","Esmeralda County",3,30,1,1,0
050,32,009,"Nevada","Esmeralda County",3,31,8,5,3
050,32,009,"Nevada","Esmeralda County",3,32,7,5,2
050,32,009,"Nevada","Esmeralda County",3,33,8,5,3
050,32,009,"Nevada","Esmeralda County",3,34,7,1,6
050,32,009,"Nevada","Esmeralda County",3,35,5,3,2
050,32,009,"Nevada","Esmeralda County",3,36,9,5,4
050,32,009,"Nevada","Esmeralda County",3,37,10,5,5
050,32,009,"Nevada","Esmeralda County",3,38,12,5,7
050,32,009,"Nevada","Esmeralda County",3,39,12,6,6
050,32,009,"Nevada","Esmeralda County",3,40,8,3,5
050,32,009,"Nevada","Esmeralda County",3,41,11,4,7
050,32,009,"Nevada","Esmeralda County",3,42,8,6,2
050,32,009,"Nevada","Esmeralda County",3,43,5,4,1
050,32,009,"Nevada","Esmeralda County",3,44,9,5,4
050,32,009,"Nevada","Esmeralda County",3,45,6,4,2
050,32,009,"Nevada","Esmeralda County",3,46,9,6,3
050,32,009,"Nevada","Esmeralda County",3,47,5,3,2
050,32,009,"Nevada","Esmeralda County",3,48,9,4,5
050,32,009,"Nevada","Esmeralda County",3,49,7,5,2
050,32,009,"Nevada","Esmeralda County",3,50,12,8,4
050,32,009,"Nevada","Esmeralda County",3,51,11,7,4
050,32,009,"Nevada","Esmeralda County",3,52,9,5,4
050,32,009,"Nevada","Esmeralda County",3,53,4,1,3
050,32,009,"Nevada","Esmeralda County",3,54,8,5,3
050,32,009,"Nevada","Esmeralda County",3,55,8,5,3
050,32,009,"Nevada","Esmeralda County",3,56,10,5,5
050,32,009,"Nevada","Esmeralda County",3,57,13,6,7
050,32,009,"Nevada","Esmeralda County",3,58,14,6,8
050,32,009,"Nevada","Esmeralda County",3,59,15,8,7
050,32,009,"Nevada","Esmeralda County",3,60,14,9,5
050,32,009,"Nevada","Esmeralda County",3,61,14,8,6
050,32,009,"Nevada","Esmeralda County",3,62,13,8,5
050,32,009,"Nevada","Esmeralda County",3,63,11,8,3
050,32,009,"Nevada","Esmeralda County",3,64,13,7,6
050,32,009,"Nevada","Esmeralda County",3,65,10,5,5
050,32,009,"Nevada","Esmeralda County",3,66,4,3,1
050,32,009,"Nevada","Esmeralda County",3,67,8,5,3
050,32,009,"Nevada","Esmeralda County",3,68,15,7,8
050,32,009,"Nevada","Esmeralda County",3,69,12,6,6
050,32,009,"Nevada","Esmeralda County",3,70,13,9,4
050,32,009,"Nevada","Esmeralda County",3,71,14,8,6
050,32,009,"Nevada","Esmeralda County",3,72,17,9,8
050,32,009,"Nevada","Esmeralda County",3,73,18,10,8
050,32,009,"Nevada","Esmeralda County",3,74,15,8,7
050,32,009,"Nevada","Esmeralda County",3,75,13,7,6
050,32,009,"Nevada","Esmeralda County",3,76,11,4,7
050,32,009,"Nevada","Esmeralda County",3,77,9,4,5
050,32,009,"Nevada","Esmeralda County",3,78,8,4,4
050,32,009,"Nevada","Esmeralda County",3,79,4,2,2
050,32,009,"Nevada","Esmeralda County",3,80,7,4,3
050,32,009,"Nevada","Esmeralda County",3,81,5,5,0
050,32,009,"Nevada","Esmeralda County",3,82,8,4,4
050,32,009,"Nevada","Esmeralda County",3,83,7,5,2
050,32,009,"Nevada","Esmeralda County",3,84,5,3,2
050,32,009,"Nevada","Esmeralda County",3,85,33,20,13
050,32,009,"Nevada","Esmeralda County",4,0,4,2,2
050,32,009,"Nevada","Esmeralda County",4,1,3,0,3
050,32,009,"Nevada","Esmeralda County",4,2,3,1,2
050,32,009,"Nevada","Esmeralda County",4,3,4,3,1
050,32,009,"Nevada","Esmeralda County",4,4,5,2,3
050,32,009,"Nevada","Esmeralda County",4,5,5,3,2
050,32,009,"Nevada","Esmeralda County",4,6,4,2,2
050,32,009,"Nevada","Esmeralda County",4,7,10,4,6
050,32,009,"Nevada","Esmeralda County",4,8,4,2,2
050,32,009,"Nevada","Esmeralda County",4,9,6,3,3
050,32,009,"Nevada","Esmeralda County",4,10,7,4,3
050,32,009,"Nevada","Esmeralda County",4,11,4,3,1
050,32,009,"Nevada","Esmeralda County",4,12,6,2,4
050,32,009,"Nevada","Esmeralda County",4,13,8,6,2
050,32,009,"Nevada","Esmeralda County",4,14,14,8,6
050,32,009,"Nevada","Esmeralda County",4,15,8,3,5
050,32,009,"Nevada","Esmeralda County",4,16,7,3,4
050,32,009,"Nevada","Esmeralda County",4,17,4,3,1
050,32,009,"Nevada","Esmeralda County",4,18,7,4,3
050,32,009,"Nevada","Esmeralda County",4,19,4,3,1
050,32,009,"Nevada","Esmeralda County",4,20,5,2,3
050,32,009,"Nevada","Esmeralda County",4,21,6,4,2
050,32,009,"Nevada","Esmeralda County",4,22,5,4,1
050,32,009,"Nevada","Esmeralda County",4,23,4,1,3
050,32,009,"Nevada","Esmeralda County",4,24,6,2,4
050,32,009,"Nevada","Esmeralda County",4,25,7,5,2
050,32,009,"Nevada","Esmeralda County",4,26,4,1,3
050,32,009,"Nevada","Esmeralda County",4,27,5,2,3
050,32,009,"Nevada","Esmeralda County",4,28,9,7,2
050,32,009,"Nevada","Esmeralda County",4,29,6,4,2
050,32,009,"Nevada","Esmeralda County",4,30,6,5,1
050,32,009,"Nevada","Esmeralda County",4,31,1,1,0
050,32,009,"Nevada","Esmeralda County",4,32,8,5,3
050,32,009,"Nevada","Esmeralda County",4,33,7,5,2
050,32,009,"Nevada","Esmeralda County",4,34,8,5,3
050,32,009,"Nevada","Esmeralda County",4,35,8,1,7
050,32,009,"Nevada","Esmeralda County",4,36,5,3,2
050,32,009,"Nevada","Esmeralda County",4,37,11,6,5
050,32,009,"Nevada","Esmeralda County",4,38,11,5,6
050,32,009,"Nevada","Esmeralda County",4,39,13,6,7
050,32,009,"Nevada","Esmeralda County",4,40,12,6,6
050,32,009,"Nevada","Esmeralda County",4,41,7,3,4
050,32,009,"Nevada","Esmeralda County",4,42,11,4,7
050,32,009,"Nevada","Esmeralda County",4,43,6,4,2
050,32,009,"Nevada","Esmeralda County",4,44,7,5,2
050,32,009,"Nevada","Esmeralda County",4,45,11,7,4
050,32,009,"Nevada","Esmeralda County",4,46,6,4,2
050,32,009,"Nevada","Esmeralda County",4,47,10,7,3
050,32,009,"Nevada","Esmeralda County",4,48,8,5,3
050,32,009,"Nevada","Esmeralda County",4,49,8,2,6
050,32,009,"Nevada","Esmeralda County",4,50,5,4,1
050,32,009,"Nevada","Esmeralda County",4,51,12,8,4
050,32,009,"Nevada","Esmeralda County",4,52,14,10,4
050,32,009,"Nevada","Esmeralda County",4,53,9,5,4
050,32,009,"Nevada","Esmeralda County",4,54,4,1,3
050,32,009,"Nevada","Esmeralda County",4,55,10,7,3
050,32,009,"Nevada","Esmeralda County",4,56,7,5,2
050,32,009,"Nevada","Esmeralda County",4,57,11,5,6
050,32,009,"Nevada","Esmeralda County",4,58,12,5,7
050,32,009,"Nevada","Esmeralda County",4,59,15,6,9
050,32,009,"Nevada","Esmeralda County",4,60,17,8,9
050,32,009,"Nevada","Esmeralda County",4,61,15,10,5
050,32,009,"Nevada","Esmeralda County",4,62,12,8,4
050,32,009,"Nevada","Esmeralda County",4,63,14,8,6
050,32,009,"Nevada","Esmeralda County",4,64,11,8,3
050,32,009,"Nevada","Esmeralda County",4,65,14,7,7
050,32,009,"Nevada","Esmeralda County",4,66,11,6,5
050,32,009,"Nevada","Esmeralda County",4,67,7,6,1
050,32,009,"Nevada","Esmeralda County",4,68,8,6,2
050,32,009,"Nevada","Esmeralda County",4,69,14,7,7
050,32,009,"Nevada","Esmeralda County",4,70,11,5,6
050,32,009,"Nevada","Esmeralda County",4,71,12,8,4
050,32,009,"Nevada","Esmeralda County",4,72,14,8,6
050,32,009,"Nevada","Esmeralda County",4,73,16,9,7
050,32,009,"Nevada","Esmeralda County",4,74,18,11,7
050,32,009,"Nevada","Esmeralda County",4,75,15,8,7
050,32,009,"Nevada","Esmeralda County",4,76,11,4,7
050,32,009,"Nevada","Esmeralda County",4,77,11,4,7
050,32,009,"Nevada","Esmeralda County",4,78,8,4,4
050,32,009,"Nevada","Esmeralda County",4,79,7,3,4
050,32,009,"Nevada","Esmeralda County",4,80,4,2,2
050,32,009,"Nevada","Esmeralda County",4,81,6,4,2
050,32,009,"Nevada","Esmeralda County",4,82,5,5,0
050,32,009,"Nevada","Esmeralda County",4,83,7,4,3
050,32,009,"Nevada","Esmeralda County",4,84,7,5,2
050,32,009,"Nevada","Esmeralda County",4,85,35,22,13
050,32,009,"Nevada","Esmeralda County",5,0,3,1,2
050,32,009,"Nevada","Esmeralda County",5,1,3,2,1
050,32,009,"Nevada","Esmeralda County",5,2,6,0,6
050,32,009,"Nevada","Esmeralda County",5,3,3,1,2
050,32,009,"Nevada","Esmeralda County",5,4,6,3,3
050,32,009,"Nevada","Esmeralda County",5,5,6,3,3
050,32,009,"Nevada","Esmeralda County",5,6,5,2,3
050,32,009,"Nevada","Esmeralda County",5,7,5,2,3
050,32,009,"Nevada","Esmeralda County",5,8,7,3,4
050,32,009,"Nevada","Esmeralda County",5,9,5,3,2
050,32,009,"Nevada","Esmeralda County",5,10,5,3,2
050,32,009,"Nevada","Esmeralda County",5,11,4,2,2
050,32,009,"Nevada","Esmeralda County",5,12,4,4,0
050,32,009,"Nevada","Esmeralda County",5,13,6,3,3
050,32,009,"Nevada","Esmeralda County",5,14,7,4,3
050,32,009,"Nevada","Esmeralda County",5,15,12,6,6
050,32,009,"Nevada","Esmeralda County",5,16,8,2,6
050,32,009,"Nevada","Esmeralda County",5,17,5,2,3
050,32,009,"Nevada","Esmeralda County",5,18,3,3,0
050,32,009,"Nevada","Esmeralda County",5,19,5,4,1
050,32,009,"Nevada","Esmeralda County",5,20,4,3,1
050,32,009,"Nevada","Esmeralda County",5,21,6,2,4
050,32,009,"Nevada","Esmeralda County",5,22,8,5,3
050,32,009,"Nevada","Esmeralda County",5,23,4,4,0
050,32,009,"Nevada","Esmeralda County",5,24,4,2,2
050,32,009,"Nevada","Esmeralda County",5,25,5,3,2
050,32,009,"Nevada","Esmeralda County",5,26,7,3,4
050,32,009,"Nevada","Esmeralda County",5,27,7,2,5
050,32,009,"Nevada","Esmeralda County",5,28,5,2,3
050,32,009,"Nevada","Esmeralda County",5,29,8,4,4
050,32,009,"Nevada","Esmeralda County",5,30,6,4,2
050,32,009,"Nevada","Esmeralda County",5,31,6,5,1
050,32,009,"Nevada","Esmeralda County",5,32,4,3,1
050,32,009,"Nevada","Esmeralda County",5,33,7,5,2
050,32,009,"Nevada","Esmeralda County",5,34,8,6,2
050,32,009,"Nevada","Esmeralda County",5,35,9,5,4
050,32,009,"Nevada","Esmeralda County",5,36,6,1,5
050,32,009,"Nevada","Esmeralda County",5,37,5,3,2
050,32,009,"Nevada","Esmeralda County",5,38,11,6,5
050,32,009,"Nevada","Esmeralda County",5,39,9,4,5
050,32,009,"Nevada","Esmeralda County",5,40,13,5,8
050,32,009,"Nevada","Esmeralda County",5,41,11,5,6
050,32,009,"Nevada","Esmeralda County",5,42,6,2,4
050,32,009,"Nevada","Esmeralda County",5,43,12,5,7
050,32,009,"Nevada","Esmeralda County",5,44,5,5,0
050,32,009,"Nevada","Esmeralda County",5,45,6,4,2
050,32,009,"Nevada","Esmeralda County",5,46,9,5,4
050,32,009,"Nevada","Esmeralda County",5,47,6,4,2
050,32,009,"Nevada","Esmeralda County",5,48,11,7,4
050,32,009,"Nevada","Esmeralda County",5,49,6,4,2
050,32,009,"Nevada","Esmeralda County",5,50,7,1,6
050,32,009,"Nevada","Esmeralda County",5,51,6,4,2
050,32,009,"Nevada","Esmeralda County",5,52,14,8,6
050,32,009,"Nevada","Esmeralda County",5,53,17,13,4
050,32,009,"Nevada","Esmeralda County",5,54,9,5,4
050,32,009,"Nevada","Esmeralda County",5,55,5,1,4
050,32,009,"Nevada","Esmeralda County",5,56,10,7,3
050,32,009,"Nevada","Esmeralda County",5,57,9,6,3
050,32,009,"Nevada","Esmeralda County",5,58,10,4,6
050,32,009,"Nevada","Esmeralda County",5,59,14,8,6
050,32,009,"Nevada","Esmeralda County",5,60,15,5,10
050,32,009,"Nevada","Esmeralda County",5,61,21,9,12
050,32,009,"Nevada","Esmeralda County",5,62,15,10,5
050,32,009,"Nevada","Esmeralda County",5,63,14,10,4
050,32,009,"Nevada","Esmeralda County",5,64,10,6,4
050,32,009,"Nevada","Esmeralda County",5,65,12,9,3
050,32,009,"Nevada","Esmeralda County",5,66,14,7,7
050,32,009,"Nevada","Esmeralda County",5,67,11,6,5
050,32,009,"Nevada","Esmeralda County",5,68,7,6,1
050,32,009,"Nevada","Esmeralda County",5,69,8,6,2
050,32,009,"Nevada","Esmeralda County",5,70,13,7,6
050,32,009,"Nevada","Esmeralda County",5,71,10,4,6
050,32,009,"Nevada","Esmeralda County",5,72,12,8,4
050,32,009,"Nevada","Esmeralda County",5,73,14,8,6
050,32,009,"Nevada","Esmeralda County",5,74,14,9,5
050,32,009,"Nevada","Esmeralda County",5,75,17,10,7
050,32,009,"Nevada","Esmeralda County",5,76,12,4,8
050,32,009,"Nevada","Esmeralda County",5,77,10,3,7
050,32,009,"Nevada","Esmeralda County",5,78,10,4,6
050,32,009,"Nevada","Esmeralda County",5,79,8,4,4
050,32,009,"Nevada","Esmeralda County",5,80,7,3,4
050,32,009,"Nevada","Esmeralda County",5,81,5,2,3
050,32,009,"Nevada","Esmeralda County",5,82,6,4,2
050,32,009,"Nevada","Esmeralda County",5,83,5,5,0
050,32,009,"Nevada","Esmeralda County",5,84,5,3,2
050,32,009,"Nevada","Esmeralda County",5,85,38,26,12
050,32,011,"Nevada","Eureka County",1,0,14,7,7
050,32,011,"Nevada","Eureka County",1,1,13,6,7
050,32,011,"Nevada","Eureka County",1,2,9,3,6
050,32,011,"Nevada","Eureka County",1,3,13,6,7
050,32,011,"Nevada","Eureka County",1,4,16,7,9
050,32,011,"Nevada","Eureka County",1,5,29,13,16
050,32,011,"Nevada","Eureka County",1,6,25,8,17
050,32,011,"Nevada","Eureka County",1,7,25,12,13
050,32,011,"Nevada","Eureka County",1,8,16,8,8
050,32,011,"Nevada","Eureka County",1,9,24,17,7
050,32,011,"Nevada","Eureka County",1,10,38,22,16
050,32,011,"Nevada","Eureka County",1,11,35,20,15
050,32,011,"Nevada","Eureka County",1,12,33,22,11
050,32,011,"Nevada","Eureka County",1,13,38,20,18
050,32,011,"Nevada","Eureka County",1,14,37,19,18
050,32,011,"Nevada","Eureka County",1,15,25,12,13
050,32,011,"Nevada","Eureka County",1,16,26,14,12
050,32,011,"Nevada","Eureka County",1,17,23,13,10
050,32,011,"Nevada","Eureka County",1,18,16,8,8
050,32,011,"Nevada","Eureka County",1,19,14,7,7
050,32,011,"Nevada","Eureka County",1,20,9,4,5
050,32,011,"Nevada","Eureka County",1,21,14,8,6
050,32,011,"Nevada","Eureka County",1,22,15,7,8
050,32,011,"Nevada","Eureka County",1,23,12,6,6
050,32,011,"Nevada","Eureka County",1,24,16,10,6
050,32,011,"Nevada","Eureka County",1,25,16,8,8
050,32,011,"Nevada","Eureka County",1,26,20,11,9
050,32,011,"Nevada","Eureka County",1,27,14,6,8
050,32,011,"Nevada","Eureka County",1,28,15,10,5
050,32,011,"Nevada","Eureka County",1,29,17,12,5
050,32,011,"Nevada","Eureka County",1,30,15,6,9
050,32,011,"Nevada","Eureka County",1,31,23,12,11
050,32,011,"Nevada","Eureka County",1,32,26,11,15
050,32,011,"Nevada","Eureka County",1,33,27,13,14
050,32,011,"Nevada","Eureka County",1,34,24,14,10
050,32,011,"Nevada","Eureka County",1,35,22,10,12
050,32,011,"Nevada","Eureka County",1,36,22,10,12
050,32,011,"Nevada","Eureka County",1,37,19,9,10
050,32,011,"Nevada","Eureka County",1,38,20,15,5
050,32,011,"Nevada","Eureka County",1,39,20,12,8
050,32,011,"Nevada","Eureka County",1,40,32,19,13
050,32,011,"Nevada","Eureka County",1,41,16,10,6
050,32,011,"Nevada","Eureka County",1,42,19,11,8
050,32,011,"Nevada","Eureka County",1,43,21,11,10
050,32,011,"Nevada","Eureka County",1,44,27,15,12
050,32,011,"Nevada","Eureka County",1,45,23,12,11
050,32,011,"Nevada","Eureka County",1,46,21,13,8
050,32,011,"Nevada","Eureka County",1,47,17,11,6
050,32,011,"Nevada","Eureka County",1,48,21,14,7
050,32,011,"Nevada","Eureka County",1,49,29,17,12
050,32,011,"Nevada","Eureka County",1,50,31,19,12
050,32,011,"Nevada","Eureka County",1,51,22,12,10
050,32,011,"Nevada","Eureka County",1,52,20,12,8
050,32,011,"Nevada","Eureka County",1,53,31,15,16
050,32,011,"Nevada","Eureka County",1,54,25,14,11
050,32,011,"Nevada","Eureka County",1,55,31,20,11
050,32,011,"Nevada","Eureka County",1,56,34,17,17
050,32,011,"Nevada","Eureka County",1,57,44,21,23
050,32,011,"Nevada","Eureka County",1,58,31,17,14
050,32,011,"Nevada","Eureka County",1,59,28,17,11
050,32,011,"Nevada","Eureka County",1,60,34,22,12
050,32,011,"Nevada","Eureka County",1,61,39,21,18
050,32,011,"Nevada","Eureka County",1,62,30,14,16
050,32,011,"Nevada","Eureka County",1,63,28,14,14
050,32,011,"Nevada","Eureka County",1,64,27,15,12
050,32,011,"Nevada","Eureka County",1,65,25,17,8
050,32,011,"Nevada","Eureka County",1,66,23,17,6
050,32,011,"Nevada","Eureka County",1,67,20,11,9
050,32,011,"Nevada","Eureka County",1,68,27,13,14
050,32,011,"Nevada","Eureka County",1,69,26,18,8
050,32,011,"Nevada","Eureka County",1,70,17,13,4
050,32,011,"Nevada","Eureka County",1,71,19,8,11
050,32,011,"Nevada","Eureka County",1,72,12,5,7
050,32,011,"Nevada","Eureka County",1,73,21,11,10
050,32,011,"Nevada","Eureka County",1,74,17,8,9
050,32,011,"Nevada","Eureka County",1,75,14,7,7
050,32,011,"Nevada","Eureka County",1,76,11,5,6
050,32,011,"Nevada","Eureka County",1,77,15,10,5
050,32,011,"Nevada","Eureka County",1,78,12,9,3
050,32,011,"Nevada","Eureka County",1,79,12,10,2
050,32,011,"Nevada","Eureka County",1,80,8,4,4
050,32,011,"Nevada","Eureka County",1,81,4,2,2
050,32,011,"Nevada","Eureka County",1,82,8,3,5
050,32,011,"Nevada","Eureka County",1,83,5,4,1
050,32,011,"Nevada","Eureka County",1,84,5,2,3
050,32,011,"Nevada","Eureka County",1,85,35,14,21
050,32,011,"Nevada","Eureka County",2,0,15,9,6
050,32,011,"Nevada","Eureka County",2,1,13,6,7
050,32,011,"Nevada","Eureka County",2,2,10,3,7
050,32,011,"Nevada","Eureka County",2,3,13,6,7
050,32,011,"Nevada","Eureka County",2,4,16,7,9
050,32,011,"Nevada","Eureka County",2,5,26,12,14
050,32,011,"Nevada","Eureka County",2,6,25,9,16
050,32,011,"Nevada","Eureka County",2,7,23,10,13
050,32,011,"Nevada","Eureka County",2,8,18,9,9
050,32,011,"Nevada","Eureka County",2,9,22,15,7
050,32,011,"Nevada","Eureka County",2,10,34,20,14
050,32,011,"Nevada","Eureka County",2,11,34,19,15
050,32,011,"Nevada","Eureka County",2,12,34,22,12
050,32,011,"Nevada","Eureka County",2,13,37,21,16
050,32,011,"Nevada","Eureka County",2,14,37,19,18
050,32,011,"Nevada","Eureka County",2,15,27,13,14
050,32,011,"Nevada","Eureka County",2,16,27,14,13
050,32,011,"Nevada","Eureka County",2,17,22,13,9
050,32,011,"Nevada","Eureka County",2,18,17,9,8
050,32,011,"Nevada","Eureka County",2,19,12,6,6
050,32,011,"Nevada","Eureka County",2,20,10,5,5
050,32,011,"Nevada","Eureka County",2,21,14,8,6
050,32,011,"Nevada","Eureka County",2,22,14,7,7
050,32,011,"Nevada","Eureka County",2,23,12,6,6
050,32,011,"Nevada","Eureka County",2,24,16,10,6
050,32,011,"Nevada","Eureka County",2,25,17,10,7
050,32,011,"Nevada","Eureka County",2,26,19,10,9
050,32,011,"Nevada","Eureka County",2,27,15,7,8
050,32,011,"Nevada","Eureka County",2,28,16,10,6
050,32,011,"Nevada","Eureka County",2,29,16,11,5
050,32,011,"Nevada","Eureka County",2,30,17,8,9
050,32,011,"Nevada","Eureka County",2,31,21,11,10
050,32,011,"Nevada","Eureka County",2,32,25,11,14
050,32,011,"Nevada","Eureka County",2,33,28,14,14
050,32,011,"Nevada","Eureka County",2,34,24,14,10
050,32,011,"Nevada","Eureka County",2,35,22,11,11
050,32,011,"Nevada","Eureka County",2,36,23,10,13
050,32,011,"Nevada","Eureka County",2,37,20,10,10
050,32,011,"Nevada","Eureka County",2,38,19,13,6
050,32,011,"Nevada","Eureka County",2,39,19,12,7
050,32,011,"Nevada","Eureka County",2,40,30,18,12
050,32,011,"Nevada","Eureka County",2,41,18,11,7
050,32,011,"Nevada","Eureka County",2,42,18,11,7
050,32,011,"Nevada","Eureka County",2,43,22,12,10
050,32,011,"Nevada","Eureka County",2,44,25,14,11
050,32,011,"Nevada","Eureka County",2,45,24,13,11
050,32,011,"Nevada","Eureka County",2,46,22,13,9
050,32,011,"Nevada","Eureka County",2,47,17,11,6
050,32,011,"Nevada","Eureka County",2,48,21,14,7
050,32,011,"Nevada","Eureka County",2,49,27,16,11
050,32,011,"Nevada","Eureka County",2,50,30,19,11
050,32,011,"Nevada","Eureka County",2,51,23,13,10
050,32,011,"Nevada","Eureka County",2,52,20,12,8
050,32,011,"Nevada","Eureka County",2,53,29,14,15
050,32,011,"Nevada","Eureka County",2,54,27,15,12
050,32,011,"Nevada","Eureka County",2,55,30,19,11
050,32,011,"Nevada","Eureka County",2,56,33,18,15
050,32,011,"Nevada","Eureka County",2,57,41,20,21
050,32,011,"Nevada","Eureka County",2,58,36,18,18
050,32,011,"Nevada","Eureka County",2,59,29,17,12
050,32,011,"Nevada","Eureka County",2,60,34,22,12
050,32,011,"Nevada","Eureka County",2,61,38,21,17
050,32,011,"Nevada","Eureka County",2,62,31,15,16
050,32,011,"Nevada","Eureka County",2,63,29,14,15
050,32,011,"Nevada","Eureka County",2,64,28,16,12
050,32,011,"Nevada","Eureka County",2,65,25,16,9
050,32,011,"Nevada","Eureka County",2,66,24,17,7
050,32,011,"Nevada","Eureka County",2,67,22,13,9
050,32,011,"Nevada","Eureka County",2,68,24,12,12
050,32,011,"Nevada","Eureka County",2,69,27,17,10
050,32,011,"Nevada","Eureka County",2,70,19,14,5
050,32,011,"Nevada","Eureka County",2,71,18,9,9
050,32,011,"Nevada","Eureka County",2,72,13,6,7
050,32,011,"Nevada","Eureka County",2,73,20,10,10
050,32,011,"Nevada","Eureka County",2,74,17,8,9
050,32,011,"Nevada","Eureka County",2,75,14,7,7
050,32,011,"Nevada","Eureka County",2,76,11,5,6
050,32,011,"Nevada","Eureka County",2,77,14,9,5
050,32,011,"Nevada","Eureka County",2,78,13,10,3
050,32,011,"Nevada","Eureka County",2,79,12,10,2
050,32,011,"Nevada","Eureka County",2,80,9,5,4
050,32,011,"Nevada","Eureka County",2,81,5,3,2
050,32,011,"Nevada","Eureka County",2,82,8,3,5
050,32,011,"Nevada","Eureka County",2,83,6,4,2
050,32,011,"Nevada","Eureka County",2,84,5,2,3
050,32,011,"Nevada","Eureka County",2,85,35,13,22
050,32,011,"Nevada","Eureka County",3,0,18,11,7
050,32,011,"Nevada","Eureka County",3,1,13,5,8
050,32,011,"Nevada","Eureka County",3,2,16,6,10
050,32,011,"Nevada","Eureka County",3,3,13,7,6
050,32,011,"Nevada","Eureka County",3,4,13,4,9
050,32,011,"Nevada","Eureka County",3,5,20,10,10
050,32,011,"Nevada","Eureka County",3,6,25,11,14
050,32,011,"Nevada","Eureka County",3,7,23,7,16
050,32,011,"Nevada","Eureka County",3,8,24,8,16
050,32,011,"Nevada","Eureka County",3,9,21,11,10
050,32,011,"Nevada","Eureka County",3,10,25,18,7
050,32,011,"Nevada","Eureka County",3,11,33,20,13
050,32,011,"Nevada","Eureka County",3,12,43,23,20
050,32,011,"Nevada","Eureka County",3,13,35,20,15
050,32,011,"Nevada","Eureka County",3,14,32,18,14
050,32,011,"Nevada","Eureka County",3,15,34,19,15
050,32,011,"Nevada","Eureka County",3,16,21,10,11
050,32,011,"Nevada","Eureka County",3,17,29,15,14
050,32,011,"Nevada","Eureka County",3,18,15,9,6
050,32,011,"Nevada","Eureka County",3,19,13,8,5
050,32,011,"Nevada","Eureka County",3,20,13,7,6
050,32,011,"Nevada","Eureka County",3,21,10,5,5
050,32,011,"Nevada","Eureka County",3,22,10,6,4
050,32,011,"Nevada","Eureka County",3,23,21,9,12
050,32,011,"Nevada","Eureka County",3,24,13,6,7
050,32,011,"Nevada","Eureka County",3,25,17,9,8
050,32,011,"Nevada","Eureka County",3,26,18,11,7
050,32,011,"Nevada","Eureka County",3,27,18,10,8
050,32,011,"Nevada","Eureka County",3,28,17,8,9
050,32,011,"Nevada","Eureka County",3,29,17,13,4
050,32,011,"Nevada","Eureka County",3,30,22,14,8
050,32,011,"Nevada","Eureka County",3,31,24,11,13
050,32,011,"Nevada","Eureka County",3,32,25,9,16
050,32,011,"Nevada","Eureka County",3,33,29,13,16
050,32,011,"Nevada","Eureka County",3,34,26,13,13
050,32,011,"Nevada","Eureka County",3,35,25,18,7
050,32,011,"Nevada","Eureka County",3,36,22,9,13
050,32,011,"Nevada","Eureka County",3,37,23,8,15
050,32,011,"Nevada","Eureka County",3,38,21,10,11
050,32,011,"Nevada","Eureka County",3,39,19,12,7
050,32,011,"Nevada","Eureka County",3,40,19,10,9
050,32,011,"Nevada","Eureka County",3,41,33,20,13
050,32,011,"Nevada","Eureka County",3,42,19,12,7
050,32,011,"Nevada","Eureka County",3,43,18,10,8
050,32,011,"Nevada","Eureka County",3,44,25,14,11
050,32,011,"Nevada","Eureka County",3,45,22,12,10
050,32,011,"Nevada","Eureka County",3,46,26,15,11
050,32,011,"Nevada","Eureka County",3,47,21,10,11
050,32,011,"Nevada","Eureka County",3,48,16,10,6
050,32,011,"Nevada","Eureka County",3,49,30,20,10
050,32,011,"Nevada","Eureka County",3,50,31,19,12
050,32,011,"Nevada","Eureka County",3,51,35,24,11
050,32,011,"Nevada","Eureka County",3,52,25,15,10
050,32,011,"Nevada","Eureka County",3,53,23,12,11
050,32,011,"Nevada","Eureka County",3,54,34,16,18
050,32,011,"Nevada","Eureka County",3,55,22,13,9
050,32,011,"Nevada","Eureka County",3,56,30,19,11
050,32,011,"Nevada","Eureka County",3,57,31,16,15
050,32,011,"Nevada","Eureka County",3,58,38,19,19
050,32,011,"Nevada","Eureka County",3,59,33,15,18
050,32,011,"Nevada","Eureka County",3,60,28,15,13
050,32,011,"Nevada","Eureka County",3,61,35,23,12
050,32,011,"Nevada","Eureka County",3,62,42,24,18
050,32,011,"Nevada","Eureka County",3,63,34,16,18
050,32,011,"Nevada","Eureka County",3,64,30,15,15
050,32,011,"Nevada","Eureka County",3,65,29,17,12
050,32,011,"Nevada","Eureka County",3,66,26,16,10
050,32,011,"Nevada","Eureka County",3,67,24,17,7
050,32,011,"Nevada","Eureka County",3,68,23,14,9
050,32,011,"Nevada","Eureka County",3,69,25,13,12
050,32,011,"Nevada","Eureka County",3,70,27,17,10
050,32,011,"Nevada","Eureka County",3,71,19,14,5
050,32,011,"Nevada","Eureka County",3,72,13,6,7
050,32,011,"Nevada","Eureka County",3,73,11,4,7
050,32,011,"Nevada","Eureka County",3,74,19,10,9
050,32,011,"Nevada","Eureka County",3,75,17,8,9
050,32,011,"Nevada","Eureka County",3,76,14,7,7
050,32,011,"Nevada","Eureka County",3,77,10,5,5
050,32,011,"Nevada","Eureka County",3,78,13,9,4
050,32,011,"Nevada","Eureka County",3,79,13,10,3
050,32,011,"Nevada","Eureka County",3,80,11,9,2
050,32,011,"Nevada","Eureka County",3,81,6,4,2
050,32,011,"Nevada","Eureka County",3,82,5,3,2
050,32,011,"Nevada","Eureka County",3,83,8,3,5
050,32,011,"Nevada","Eureka County",3,84,4,2,2
050,32,011,"Nevada","Eureka County",3,85,35,13,22
050,32,011,"Nevada","Eureka County",4,0,18,7,11
050,32,011,"Nevada","Eureka County",4,1,20,13,7
050,32,011,"Nevada","Eureka County",4,2,12,6,6
050,32,011,"Nevada","Eureka County",4,3,12,5,7
050,32,011,"Nevada","Eureka County",4,4,7,3,4
050,32,011,"Nevada","Eureka County",4,5,12,4,8
050,32,011,"Nevada","Eureka County",4,6,20,11,9
050,32,011,"Nevada","Eureka County",4,7,22,10,12
050,32,011,"Nevada","Eureka County",4,8,21,8,13
050,32,011,"Nevada","Eureka County",4,9,21,10,11
050,32,011,"Nevada","Eureka County",4,10,21,10,11
050,32,011,"Nevada","Eureka County",4,11,27,17,10
050,32,011,"Nevada","Eureka County",4,12,40,19,21
050,32,011,"Nevada","Eureka County",4,13,46,23,23
050,32,011,"Nevada","Eureka County",4,14,34,19,15
050,32,011,"Nevada","Eureka County",4,15,31,20,11
050,32,011,"Nevada","Eureka County",4,16,29,17,12
050,32,011,"Nevada","Eureka County",4,17,22,11,11
050,32,011,"Nevada","Eureka County",4,18,23,12,11
050,32,011,"Nevada","Eureka County",4,19,9,6,3
050,32,011,"Nevada","Eureka County",4,20,12,7,5
050,32,011,"Nevada","Eureka County",4,21,12,6,6
050,32,011,"Nevada","Eureka County",4,22,12,7,5
050,32,011,"Nevada","Eureka County",4,23,9,6,3
050,32,011,"Nevada","Eureka County",4,24,15,7,8
050,32,011,"Nevada","Eureka County",4,25,11,5,6
050,32,011,"Nevada","Eureka County",4,26,15,9,6
050,32,011,"Nevada","Eureka County",4,27,20,12,8
050,32,011,"Nevada","Eureka County",4,28,23,10,13
050,32,011,"Nevada","Eureka County",4,29,15,7,8
050,32,011,"Nevada","Eureka County",4,30,19,13,6
050,32,011,"Nevada","Eureka County",4,31,19,13,6
050,32,011,"Nevada","Eureka County",4,32,27,11,16
050,32,011,"Nevada","Eureka County",4,33,27,12,15
050,32,011,"Nevada","Eureka County",4,34,26,10,16
050,32,011,"Nevada","Eureka County",4,35,28,13,15
050,32,011,"Nevada","Eureka County",4,36,20,14,6
050,32,011,"Nevada","Eureka County",4,37,21,12,9
050,32,011,"Nevada","Eureka County",4,38,25,8,17
050,32,011,"Nevada","Eureka County",4,39,19,10,9
050,32,011,"Nevada","Eureka County",4,40,22,15,7
050,32,011,"Nevada","Eureka County",4,41,15,10,5
050,32,011,"Nevada","Eureka County",4,42,32,19,13
050,32,011,"Nevada","Eureka County",4,43,16,8,8
050,32,011,"Nevada","Eureka County",4,44,19,11,8
050,32,011,"Nevada","Eureka County",4,45,29,15,14
050,32,011,"Nevada","Eureka County",4,46,23,12,11
050,32,011,"Nevada","Eureka County",4,47,27,16,11
050,32,011,"Nevada","Eureka County",4,48,23,11,12
050,32,011,"Nevada","Eureka County",4,49,16,10,6
050,32,011,"Nevada","Eureka County",4,50,32,22,10
050,32,011,"Nevada","Eureka County",4,51,25,14,11
050,32,011,"Nevada","Eureka County",4,52,32,22,10
050,32,011,"Nevada","Eureka County",4,53,25,17,8
050,32,011,"Nevada","Eureka County",4,54,26,13,13
050,32,011,"Nevada","Eureka County",4,55,39,20,19
050,32,011,"Nevada","Eureka County",4,56,23,14,9
050,32,011,"Nevada","Eureka County",4,57,32,17,15
050,32,011,"Nevada","Eureka County",4,58,33,18,15
050,32,011,"Nevada","Eureka County",4,59,37,17,20
050,32,011,"Nevada","Eureka County",4,60,32,14,18
050,32,011,"Nevada","Eureka County",4,61,29,16,13
050,32,011,"Nevada","Eureka County",4,62,35,23,12
050,32,011,"Nevada","Eureka County",4,63,39,24,15
050,32,011,"Nevada","Eureka County",4,64,28,12,16
050,32,011,"Nevada","Eureka County",4,65,30,15,15
050,32,011,"Nevada","Eureka County",4,66,28,17,11
050,32,011,"Nevada","Eureka County",4,67,25,15,10
050,32,011,"Nevada","Eureka County",4,68,23,16,7
050,32,011,"Nevada","Eureka County",4,69,25,15,10
050,32,011,"Nevada","Eureka County",4,70,24,12,12
050,32,011,"Nevada","Eureka County",4,71,27,17,10
050,32,011,"Nevada","Eureka County",4,72,15,12,3
050,32,011,"Nevada","Eureka County",4,73,7,4,3
050,32,011,"Nevada","Eureka County",4,74,12,5,7
050,32,011,"Nevada","Eureka County",4,75,18,10,8
050,32,011,"Nevada","Eureka County",4,76,17,8,9
050,32,011,"Nevada","Eureka County",4,77,12,7,5
050,32,011,"Nevada","Eureka County",4,78,9,4,5
050,32,011,"Nevada","Eureka County",4,79,12,8,4
050,32,011,"Nevada","Eureka County",4,80,10,7,3
050,32,011,"Nevada","Eureka County",4,81,10,8,2
050,32,011,"Nevada","Eureka County",4,82,5,4,1
050,32,011,"Nevada","Eureka County",4,83,5,3,2
050,32,011,"Nevada","Eureka County",4,84,7,2,5
050,32,011,"Nevada","Eureka County",4,85,31,10,21
050,32,011,"Nevada","Eureka County",5,0,17,9,8
050,32,011,"Nevada","Eureka County",5,1,18,7,11
050,32,011,"Nevada","Eureka County",5,2,19,10,9
050,32,011,"Nevada","Eureka County",5,3,11,4,7
050,32,011,"Nevada","Eureka County",5,4,13,5,8
050,32,011,"Nevada","Eureka County",5,5,12,5,7
050,32,011,"Nevada","Eureka County",5,6,11,5,6
050,32,011,"Nevada","Eureka County",5,7,22,12,10
050,32,011,"Nevada","Eureka County",5,8,29,11,18
050,32,011,"Nevada","Eureka County",5,9,24,11,13
050,32,011,"Nevada","Eureka County",5,10,24,12,12
050,32,011,"Nevada","Eureka County",5,11,23,11,12
050,32,011,"Nevada","Eureka County",5,12,39,20,19
050,32,011,"Nevada","Eureka County",5,13,43,19,24
050,32,011,"Nevada","Eureka County",5,14,41,22,19
050,32,011,"Nevada","Eureka County",5,15,35,21,14
050,32,011,"Nevada","Eureka County",5,16,28,18,10
050,32,011,"Nevada","Eureka County",5,17,28,17,11
050,32,011,"Nevada","Eureka County",5,18,22,11,11
050,32,011,"Nevada","Eureka County",5,19,18,9,9
050,32,011,"Nevada","Eureka County",5,20,8,3,5
050,32,011,"Nevada","Eureka County",5,21,14,9,5
050,32,011,"Nevada","Eureka County",5,22,16,8,8
050,32,011,"Nevada","Eureka County",5,23,15,9,6
050,32,011,"Nevada","Eureka County",5,24,11,7,4
050,32,011,"Nevada","Eureka County",5,25,18,9,9
050,32,011,"Nevada","Eureka County",5,26,11,4,7
050,32,011,"Nevada","Eureka County",5,27,15,8,7
050,32,011,"Nevada","Eureka County",5,28,13,8,5
050,32,011,"Nevada","Eureka County",5,29,21,11,10
050,32,011,"Nevada","Eureka County",5,30,16,7,9
050,32,011,"Nevada","Eureka County",5,31,21,15,6
050,32,011,"Nevada","Eureka County",5,32,17,13,4
050,32,011,"Nevada","Eureka County",5,33,26,10,16
050,32,011,"Nevada","Eureka County",5,34,26,13,13
050,32,011,"Nevada","Eureka County",5,35,28,11,17
050,32,011,"Nevada","Eureka County",5,36,30,15,15
050,32,011,"Nevada","Eureka County",5,37,19,13,6
050,32,011,"Nevada","Eureka County",5,38,25,13,12
050,32,011,"Nevada","Eureka County",5,39,31,13,18
050,32,011,"Nevada","Eureka County",5,40,19,10,9
050,32,011,"Nevada","Eureka County",5,41,21,13,8
050,32,011,"Nevada","Eureka County",5,42,15,10,5
050,32,011,"Nevada","Eureka County",5,43,36,21,15
050,32,011,"Nevada","Eureka County",5,44,20,9,11
050,32,011,"Nevada","Eureka County",5,45,22,11,11
050,32,011,"Nevada","Eureka County",5,46,33,21,12
050,32,011,"Nevada","Eureka County",5,47,26,13,13
050,32,011,"Nevada","Eureka County",5,48,23,13,10
050,32,011,"Nevada","Eureka County",5,49,19,9,10
050,32,011,"Nevada","Eureka County",5,50,16,9,7
050,32,011,"Nevada","Eureka County",5,51,30,20,10
050,32,011,"Nevada","Eureka County",5,52,30,15,15
050,32,011,"Nevada","Eureka County",5,53,35,24,11
050,32,011,"Nevada","Eureka County",5,54,25,16,9
050,32,011,"Nevada","Eureka County",5,55,25,13,12
050,32,011,"Nevada","Eureka County",5,56,39,22,17
050,32,011,"Nevada","Eureka County",5,57,26,16,10
050,32,011,"Nevada","Eureka County",5,58,31,16,15
050,32,011,"Nevada","Eureka County",5,59,34,18,16
050,32,011,"Nevada","Eureka County",5,60,36,18,18
050,32,011,"Nevada","Eureka County",5,61,31,14,17
050,32,011,"Nevada","Eureka County",5,62,31,18,13
050,32,011,"Nevada","Eureka County",5,63,34,22,12
050,32,011,"Nevada","Eureka County",5,64,38,20,18
050,32,011,"Nevada","Eureka County",5,65,26,10,16
050,32,011,"Nevada","Eureka County",5,66,30,15,15
050,32,011,"Nevada","Eureka County",5,67,28,17,11
050,32,011,"Nevada","Eureka County",5,68,24,14,10
050,32,011,"Nevada","Eureka County",5,69,22,16,6
050,32,011,"Nevada","Eureka County",5,70,24,13,11
050,32,011,"Nevada","Eureka County",5,71,25,12,13
050,32,011,"Nevada","Eureka County",5,72,24,17,7
050,32,011,"Nevada","Eureka County",5,73,13,10,3
050,32,011,"Nevada","Eureka County",5,74,8,5,3
050,32,011,"Nevada","Eureka County",5,75,11,5,6
050,32,011,"Nevada","Eureka County",5,76,19,11,8
050,32,011,"Nevada","Eureka County",5,77,16,8,8
050,32,011,"Nevada","Eureka County",5,78,11,6,5
050,32,011,"Nevada","Eureka County",5,79,10,4,6
050,32,011,"Nevada","Eureka County",5,80,12,7,5
050,32,011,"Nevada","Eureka County",5,81,9,6,3
050,32,011,"Nevada","Eureka County",5,82,9,8,1
050,32,011,"Nevada","Eureka County",5,83,6,5,1
050,32,011,"Nevada","Eureka County",5,84,3,2,1
050,32,011,"Nevada","Eureka County",5,85,34,10,24
050,32,013,"Nevada","Humboldt County",1,0,249,127,122
050,32,013,"Nevada","Humboldt County",1,1,243,118,125
050,32,013,"Nevada","Humboldt County",1,2,232,119,113
050,32,013,"Nevada","Humboldt County",1,3,248,136,112
050,32,013,"Nevada","Humboldt County",1,4,242,114,128
050,32,013,"Nevada","Humboldt County",1,5,265,129,136
050,32,013,"Nevada","Humboldt County",1,6,260,135,125
050,32,013,"Nevada","Humboldt County",1,7,262,141,121
050,32,013,"Nevada","Humboldt County",1,8,271,141,130
050,32,013,"Nevada","Humboldt County",1,9,294,142,152
050,32,013,"Nevada","Humboldt County",1,10,280,139,141
050,32,013,"Nevada","Humboldt County",1,11,276,140,136
050,32,013,"Nevada","Humboldt County",1,12,307,160,147
050,32,013,"Nevada","Humboldt County",1,13,274,137,137
050,32,013,"Nevada","Humboldt County",1,14,260,134,126
050,32,013,"Nevada","Humboldt County",1,15,233,121,112
050,32,013,"Nevada","Humboldt County",1,16,233,120,113
050,32,013,"Nevada","Humboldt County",1,17,224,116,108
050,32,013,"Nevada","Humboldt County",1,18,233,139,94
050,32,013,"Nevada","Humboldt County",1,19,167,85,82
050,32,013,"Nevada","Humboldt County",1,20,181,85,96
050,32,013,"Nevada","Humboldt County",1,21,171,92,79
050,32,013,"Nevada","Humboldt County",1,22,187,98,89
050,32,013,"Nevada","Humboldt County",1,23,195,111,84
050,32,013,"Nevada","Humboldt County",1,24,204,108,96
050,32,013,"Nevada","Humboldt County",1,25,201,95,106
050,32,013,"Nevada","Humboldt County",1,26,213,114,99
050,32,013,"Nevada","Humboldt County",1,27,233,123,110
050,32,013,"Nevada","Humboldt County",1,28,246,125,121
050,32,013,"Nevada","Humboldt County",1,29,221,112,109
050,32,013,"Nevada","Humboldt County",1,30,237,128,109
050,32,013,"Nevada","Humboldt County",1,31,243,127,116
050,32,013,"Nevada","Humboldt County",1,32,245,128,117
050,32,013,"Nevada","Humboldt County",1,33,229,109,120
050,32,013,"Nevada","Humboldt County",1,34,265,145,120
050,32,013,"Nevada","Humboldt County",1,35,249,137,112
050,32,013,"Nevada","Humboldt County",1,36,233,128,105
050,32,013,"Nevada","Humboldt County",1,37,233,123,110
050,32,013,"Nevada","Humboldt County",1,38,225,130,95
050,32,013,"Nevada","Humboldt County",1,39,225,121,104
050,32,013,"Nevada","Humboldt County",1,40,200,103,97
050,32,013,"Nevada","Humboldt County",1,41,207,113,94
050,32,013,"Nevada","Humboldt County",1,42,212,117,95
050,32,013,"Nevada","Humboldt County",1,43,202,107,95
050,32,013,"Nevada","Humboldt County",1,44,191,99,92
050,32,013,"Nevada","Humboldt County",1,45,192,116,76
050,32,013,"Nevada","Humboldt County",1,46,178,98,80
050,32,013,"Nevada","Humboldt County",1,47,177,92,85
050,32,013,"Nevada","Humboldt County",1,48,215,115,100
050,32,013,"Nevada","Humboldt County",1,49,222,121,101
050,32,013,"Nevada","Humboldt County",1,50,195,108,87
050,32,013,"Nevada","Humboldt County",1,51,196,106,90
050,32,013,"Nevada","Humboldt County",1,52,217,111,106
050,32,013,"Nevada","Humboldt County",1,53,199,112,87
050,32,013,"Nevada","Humboldt County",1,54,171,93,78
050,32,013,"Nevada","Humboldt County",1,55,209,108,101
050,32,013,"Nevada","Humboldt County",1,56,213,106,107
050,32,013,"Nevada","Humboldt County",1,57,214,103,111
050,32,013,"Nevada","Humboldt County",1,58,248,128,120
050,32,013,"Nevada","Humboldt County",1,59,249,142,107
050,32,013,"Nevada","Humboldt County",1,60,231,121,110
050,32,013,"Nevada","Humboldt County",1,61,225,121,104
050,32,013,"Nevada","Humboldt County",1,62,232,121,111
050,32,013,"Nevada","Humboldt County",1,63,229,119,110
050,32,013,"Nevada","Humboldt County",1,64,204,111,93
050,32,013,"Nevada","Humboldt County",1,65,215,108,107
050,32,013,"Nevada","Humboldt County",1,66,215,112,103
050,32,013,"Nevada","Humboldt County",1,67,202,116,86
050,32,013,"Nevada","Humboldt County",1,68,172,95,77
050,32,013,"Nevada","Humboldt County",1,69,173,88,85
050,32,013,"Nevada","Humboldt County",1,70,164,88,76
050,32,013,"Nevada","Humboldt County",1,71,149,79,70
050,32,013,"Nevada","Humboldt County",1,72,156,84,72
050,32,013,"Nevada","Humboldt County",1,73,153,84,69
050,32,013,"Nevada","Humboldt County",1,74,92,51,41
050,32,013,"Nevada","Humboldt County",1,75,83,38,45
050,32,013,"Nevada","Humboldt County",1,76,91,48,43
050,32,013,"Nevada","Humboldt County",1,77,93,45,48
050,32,013,"Nevada","Humboldt County",1,78,82,37,45
050,32,013,"Nevada","Humboldt County",1,79,70,33,37
050,32,013,"Nevada","Humboldt County",1,80,68,31,37
050,32,013,"Nevada","Humboldt County",1,81,62,28,34
050,32,013,"Nevada","Humboldt County",1,82,49,26,23
050,32,013,"Nevada","Humboldt County",1,83,37,17,20
050,32,013,"Nevada","Humboldt County",1,84,38,16,22
050,32,013,"Nevada","Humboldt County",1,85,203,87,116
050,32,013,"Nevada","Humboldt County",2,0,246,126,120
050,32,013,"Nevada","Humboldt County",2,1,244,120,124
050,32,013,"Nevada","Humboldt County",2,2,236,120,116
050,32,013,"Nevada","Humboldt County",2,3,242,131,111
050,32,013,"Nevada","Humboldt County",2,4,243,118,125
050,32,013,"Nevada","Humboldt County",2,5,260,126,134
050,32,013,"Nevada","Humboldt County",2,6,264,136,128
050,32,013,"Nevada","Humboldt County",2,7,259,138,121
050,32,013,"Nevada","Humboldt County",2,8,266,139,127
050,32,013,"Nevada","Humboldt County",2,9,289,143,146
050,32,013,"Nevada","Humboldt County",2,10,285,140,145
050,32,013,"Nevada","Humboldt County",2,11,276,139,137
050,32,013,"Nevada","Humboldt County",2,12,302,155,147
050,32,013,"Nevada","Humboldt County",2,13,279,141,138
050,32,013,"Nevada","Humboldt County",2,14,258,133,125
050,32,013,"Nevada","Humboldt County",2,15,239,125,114
050,32,013,"Nevada","Humboldt County",2,16,232,120,112
050,32,013,"Nevada","Humboldt County",2,17,226,117,109
050,32,013,"Nevada","Humboldt County",2,18,221,129,92
050,32,013,"Nevada","Humboldt County",2,19,174,92,82
050,32,013,"Nevada","Humboldt County",2,20,181,86,95
050,32,013,"Nevada","Humboldt County",2,21,173,89,84
050,32,013,"Nevada","Humboldt County",2,22,186,99,87
050,32,013,"Nevada","Humboldt County",2,23,197,109,88
050,32,013,"Nevada","Humboldt County",2,24,206,110,96
050,32,013,"Nevada","Humboldt County",2,25,202,99,103
050,32,013,"Nevada","Humboldt County",2,26,208,109,99
050,32,013,"Nevada","Humboldt County",2,27,226,120,106
050,32,013,"Nevada","Humboldt County",2,28,243,125,118
050,32,013,"Nevada","Humboldt County",2,29,226,114,112
050,32,013,"Nevada","Humboldt County",2,30,235,123,112
050,32,013,"Nevada","Humboldt County",2,31,242,128,114
050,32,013,"Nevada","Humboldt County",2,32,242,125,117
050,32,013,"Nevada","Humboldt County",2,33,232,113,119
050,32,013,"Nevada","Humboldt County",2,34,257,137,120
050,32,013,"Nevada","Humboldt County",2,35,252,139,113
050,32,013,"Nevada","Humboldt County",2,36,236,131,105
050,32,013,"Nevada","Humboldt County",2,37,231,124,107
050,32,013,"Nevada","Humboldt County",2,38,225,128,97
050,32,013,"Nevada","Humboldt County",2,39,221,121,100
050,32,013,"Nevada","Humboldt County",2,40,207,109,98
050,32,013,"Nevada","Humboldt County",2,41,200,108,92
050,32,013,"Nevada","Humboldt County",2,42,206,114,92
050,32,013,"Nevada","Humboldt County",2,43,204,109,95
050,32,013,"Nevada","Humboldt County",2,44,192,100,92
050,32,013,"Nevada","Humboldt County",2,45,190,111,79
050,32,013,"Nevada","Humboldt County",2,46,178,100,78
050,32,013,"Nevada","Humboldt County",2,47,175,92,83
050,32,013,"Nevada","Humboldt County",2,48,207,110,97
050,32,013,"Nevada","Humboldt County",2,49,221,118,103
050,32,013,"Nevada","Humboldt County",2,50,205,114,91
050,32,013,"Nevada","Humboldt County",2,51,194,104,90
050,32,013,"Nevada","Humboldt County",2,52,211,109,102
050,32,013,"Nevada","Humboldt County",2,53,200,110,90
050,32,013,"Nevada","Humboldt County",2,54,177,98,79
050,32,013,"Nevada","Humboldt County",2,55,201,107,94
050,32,013,"Nevada","Humboldt County",2,56,212,106,106
050,32,013,"Nevada","Humboldt County",2,57,217,106,111
050,32,013,"Nevada","Humboldt County",2,58,239,122,117
050,32,013,"Nevada","Humboldt County",2,59,250,138,112
050,32,013,"Nevada","Humboldt County",2,60,235,126,109
050,32,013,"Nevada","Humboldt County",2,61,221,119,102
050,32,013,"Nevada","Humboldt County",2,62,227,119,108
050,32,013,"Nevada","Humboldt County",2,63,231,120,111
050,32,013,"Nevada","Humboldt County",2,64,210,113,97
050,32,013,"Nevada","Humboldt County",2,65,214,109,105
050,32,013,"Nevada","Humboldt County",2,66,216,111,105
050,32,013,"Nevada","Humboldt County",2,67,202,115,87
050,32,013,"Nevada","Humboldt County",2,68,179,99,80
050,32,013,"Nevada","Humboldt County",2,69,171,88,83
050,32,013,"Nevada","Humboldt County",2,70,168,89,79
050,32,013,"Nevada","Humboldt County",2,71,153,82,71
050,32,013,"Nevada","Humboldt County",2,72,152,81,71
050,32,013,"Nevada","Humboldt County",2,73,161,87,74
050,32,013,"Nevada","Humboldt County",2,74,100,55,45
050,32,013,"Nevada","Humboldt County",2,75,85,41,44
050,32,013,"Nevada","Humboldt County",2,76,88,45,43
050,32,013,"Nevada","Humboldt County",2,77,94,46,48
050,32,013,"Nevada","Humboldt County",2,78,80,36,44
050,32,013,"Nevada","Humboldt County",2,79,71,33,38
050,32,013,"Nevada","Humboldt County",2,80,69,32,37
050,32,013,"Nevada","Humboldt County",2,81,62,27,35
050,32,013,"Nevada","Humboldt County",2,82,51,25,26
050,32,013,"Nevada","Humboldt County",2,83,40,19,21
050,32,013,"Nevada","Humboldt County",2,84,36,14,22
050,32,013,"Nevada","Humboldt County",2,85,207,87,120
050,32,013,"Nevada","Humboldt County",3,0,209,101,108
050,32,013,"Nevada","Humboldt County",3,1,265,139,126
050,32,013,"Nevada","Humboldt County",3,2,255,122,133
050,32,013,"Nevada","Humboldt County",3,3,250,122,128
050,32,013,"Nevada","Humboldt County",3,4,258,138,120
050,32,013,"Nevada","Humboldt County",3,5,252,123,129
050,32,013,"Nevada","Humboldt County",3,6,264,129,135
050,32,013,"Nevada","Humboldt County",3,7,261,134,127
050,32,013,"Nevada","Humboldt County",3,8,258,143,115
050,32,013,"Nevada","Humboldt County",3,9,279,144,135
050,32,013,"Nevada","Humboldt County",3,10,299,147,152
050,32,013,"Nevada","Humboldt County",3,11,277,132,145
050,32,013,"Nevada","Humboldt County",3,12,278,141,137
050,32,013,"Nevada","Humboldt County",3,13,299,147,152
050,32,013,"Nevada","Humboldt County",3,14,281,139,142
050,32,013,"Nevada","Humboldt County",3,15,254,127,127
050,32,013,"Nevada","Humboldt County",3,16,250,134,116
050,32,013,"Nevada","Humboldt County",3,17,236,120,116
050,32,013,"Nevada","Humboldt County",3,18,201,108,93
050,32,013,"Nevada","Humboldt County",3,19,193,108,85
050,32,013,"Nevada","Humboldt County",3,20,177,94,83
050,32,013,"Nevada","Humboldt County",3,21,184,88,96
050,32,013,"Nevada","Humboldt County",3,22,193,101,92
050,32,013,"Nevada","Humboldt County",3,23,195,101,94
050,32,013,"Nevada","Humboldt County",3,24,204,103,101
050,32,013,"Nevada","Humboldt County",3,25,220,118,102
050,32,013,"Nevada","Humboldt County",3,26,203,100,103
050,32,013,"Nevada","Humboldt County",3,27,202,104,98
050,32,013,"Nevada","Humboldt County",3,28,239,127,112
050,32,013,"Nevada","Humboldt County",3,29,255,129,126
050,32,013,"Nevada","Humboldt County",3,30,244,125,119
050,32,013,"Nevada","Humboldt County",3,31,247,124,123
050,32,013,"Nevada","Humboldt County",3,32,246,127,119
050,32,013,"Nevada","Humboldt County",3,33,256,131,125
050,32,013,"Nevada","Humboldt County",3,34,254,127,127
050,32,013,"Nevada","Humboldt County",3,35,253,136,117
050,32,013,"Nevada","Humboldt County",3,36,265,150,115
050,32,013,"Nevada","Humboldt County",3,37,242,138,104
050,32,013,"Nevada","Humboldt County",3,38,233,128,105
050,32,013,"Nevada","Humboldt County",3,39,229,129,100
050,32,013,"Nevada","Humboldt County",3,40,228,125,103
050,32,013,"Nevada","Humboldt County",3,41,215,121,94
050,32,013,"Nevada","Humboldt County",3,42,194,105,89
050,32,013,"Nevada","Humboldt County",3,43,196,110,86
050,32,013,"Nevada","Humboldt County",3,44,208,114,94
050,32,013,"Nevada","Humboldt County",3,45,198,99,99
050,32,013,"Nevada","Humboldt County",3,46,188,113,75
050,32,013,"Nevada","Humboldt County",3,47,184,104,80
050,32,013,"Nevada","Humboldt County",3,48,191,99,92
050,32,013,"Nevada","Humboldt County",3,49,208,108,100
050,32,013,"Nevada","Humboldt County",3,50,227,117,110
050,32,013,"Nevada","Humboldt County",3,51,202,115,87
050,32,013,"Nevada","Humboldt County",3,52,193,96,97
050,32,013,"Nevada","Humboldt County",3,53,207,114,93
050,32,013,"Nevada","Humboldt County",3,54,206,112,94
050,32,013,"Nevada","Humboldt County",3,55,188,105,83
050,32,013,"Nevada","Humboldt County",3,56,207,107,100
050,32,013,"Nevada","Humboldt County",3,57,210,108,102
050,32,013,"Nevada","Humboldt County",3,58,216,100,116
050,32,013,"Nevada","Humboldt County",3,59,232,122,110
050,32,013,"Nevada","Humboldt County",3,60,255,141,114
050,32,013,"Nevada","Humboldt County",3,61,226,124,102
050,32,013,"Nevada","Humboldt County",3,62,220,113,107
050,32,013,"Nevada","Humboldt County",3,63,223,112,111
050,32,013,"Nevada","Humboldt County",3,64,224,116,108
050,32,013,"Nevada","Humboldt County",3,65,205,113,92
050,32,013,"Nevada","Humboldt County",3,66,213,110,103
050,32,013,"Nevada","Humboldt County",3,67,206,107,99
050,32,013,"Nevada","Humboldt County",3,68,191,108,83
050,32,013,"Nevada","Humboldt County",3,69,178,103,75
050,32,013,"Nevada","Humboldt County",3,70,173,87,86
050,32,013,"Nevada","Humboldt County",3,71,168,87,81
050,32,013,"Nevada","Humboldt County",3,72,150,81,69
050,32,013,"Nevada","Humboldt County",3,73,152,79,73
050,32,013,"Nevada","Humboldt County",3,74,157,80,77
050,32,013,"Nevada","Humboldt County",3,75,100,51,49
050,32,013,"Nevada","Humboldt County",3,76,77,39,38
050,32,013,"Nevada","Humboldt County",3,77,91,49,42
050,32,013,"Nevada","Humboldt County",3,78,91,44,47
050,32,013,"Nevada","Humboldt County",3,79,76,34,42
050,32,013,"Nevada","Humboldt County",3,80,63,28,35
050,32,013,"Nevada","Humboldt County",3,81,64,29,35
050,32,013,"Nevada","Humboldt County",3,82,59,28,31
050,32,013,"Nevada","Humboldt County",3,83,46,21,25
050,32,013,"Nevada","Humboldt County",3,84,39,19,20
050,32,013,"Nevada","Humboldt County",3,85,227,90,137
050,32,013,"Nevada","Humboldt County",4,0,208,103,105
050,32,013,"Nevada","Humboldt County",4,1,220,112,108
050,32,013,"Nevada","Humboldt County",4,2,267,142,125
050,32,013,"Nevada","Humboldt County",4,3,258,123,135
050,32,013,"Nevada","Humboldt County",4,4,234,115,119
050,32,013,"Nevada","Humboldt County",4,5,254,138,116
050,32,013,"Nevada","Humboldt County",4,6,242,111,131
050,32,013,"Nevada","Humboldt County",4,7,266,135,131
050,32,013,"Nevada","Humboldt County",4,8,255,130,125
050,32,013,"Nevada","Humboldt County",4,9,245,138,107
050,32,013,"Nevada","Humboldt County",4,10,277,143,134
050,32,013,"Nevada","Humboldt County",4,11,281,140,141
050,32,013,"Nevada","Humboldt County",4,12,275,138,137
050,32,013,"Nevada","Humboldt County",4,13,265,134,131
050,32,013,"Nevada","Humboldt County",4,14,289,147,142
050,32,013,"Nevada","Humboldt County",4,15,276,132,144
050,32,013,"Nevada","Humboldt County",4,16,249,126,123
050,32,013,"Nevada","Humboldt County",4,17,241,130,111
050,32,013,"Nevada","Humboldt County",4,18,196,107,89
050,32,013,"Nevada","Humboldt County",4,19,172,93,79
050,32,013,"Nevada","Humboldt County",4,20,188,106,82
050,32,013,"Nevada","Humboldt County",4,21,182,94,88
050,32,013,"Nevada","Humboldt County",4,22,188,97,91
050,32,013,"Nevada","Humboldt County",4,23,194,104,90
050,32,013,"Nevada","Humboldt County",4,24,192,93,99
050,32,013,"Nevada","Humboldt County",4,25,206,100,106
050,32,013,"Nevada","Humboldt County",4,26,216,114,102
050,32,013,"Nevada","Humboldt County",4,27,206,97,109
050,32,013,"Nevada","Humboldt County",4,28,200,103,97
050,32,013,"Nevada","Humboldt County",4,29,243,128,115
050,32,013,"Nevada","Humboldt County",4,30,235,124,111
050,32,013,"Nevada","Humboldt County",4,31,257,126,131
050,32,013,"Nevada","Humboldt County",4,32,241,127,114
050,32,013,"Nevada","Humboldt County",4,33,216,106,110
050,32,013,"Nevada","Humboldt County",4,34,250,135,115
050,32,013,"Nevada","Humboldt County",4,35,251,124,127
050,32,013,"Nevada","Humboldt County",4,36,240,133,107
050,32,013,"Nevada","Humboldt County",4,37,266,149,117
050,32,013,"Nevada","Humboldt County",4,38,244,136,108
050,32,013,"Nevada","Humboldt County",4,39,235,125,110
050,32,013,"Nevada","Humboldt County",4,40,237,128,109
050,32,013,"Nevada","Humboldt County",4,41,218,120,98
050,32,013,"Nevada","Humboldt County",4,42,206,117,89
050,32,013,"Nevada","Humboldt County",4,43,181,97,84
050,32,013,"Nevada","Humboldt County",4,44,187,101,86
050,32,013,"Nevada","Humboldt County",4,45,203,111,92
050,32,013,"Nevada","Humboldt County",4,46,189,96,93
050,32,013,"Nevada","Humboldt County",4,47,183,109,74
050,32,013,"Nevada","Humboldt County",4,48,175,100,75
050,32,013,"Nevada","Humboldt County",4,49,192,99,93
050,32,013,"Nevada","Humboldt County",4,50,195,99,96
050,32,013,"Nevada","Humboldt County",4,51,221,114,107
050,32,013,"Nevada","Humboldt County",4,52,208,120,88
050,32,013,"Nevada","Humboldt County",4,53,192,89,103
050,32,013,"Nevada","Humboldt County",4,54,194,103,91
050,32,013,"Nevada","Humboldt County",4,55,198,108,90
050,32,013,"Nevada","Humboldt County",4,56,179,99,80
050,32,013,"Nevada","Humboldt County",4,57,196,103,93
050,32,013,"Nevada","Humboldt County",4,58,200,101,99
050,32,013,"Nevada","Humboldt County",4,59,204,99,105
050,32,013,"Nevada","Humboldt County",4,60,226,114,112
050,32,013,"Nevada","Humboldt County",4,61,243,137,106
050,32,013,"Nevada","Humboldt County",4,62,223,118,105
050,32,013,"Nevada","Humboldt County",4,63,210,114,96
050,32,013,"Nevada","Humboldt County",4,64,225,113,112
050,32,013,"Nevada","Humboldt County",4,65,209,107,102
050,32,013,"Nevada","Humboldt County",4,66,201,111,90
050,32,013,"Nevada","Humboldt County",4,67,198,97,101
050,32,013,"Nevada","Humboldt County",4,68,201,99,102
050,32,013,"Nevada","Humboldt County",4,69,186,106,80
050,32,013,"Nevada","Humboldt County",4,70,178,100,78
050,32,013,"Nevada","Humboldt County",4,71,168,79,89
050,32,013,"Nevada","Humboldt County",4,72,168,87,81
050,32,013,"Nevada","Humboldt County",4,73,144,80,64
050,32,013,"Nevada","Humboldt County",4,74,146,74,72
050,32,013,"Nevada","Humboldt County",4,75,153,77,76
050,32,013,"Nevada","Humboldt County",4,76,96,49,47
050,32,013,"Nevada","Humboldt County",4,77,77,39,38
050,32,013,"Nevada","Humboldt County",4,78,84,44,40
050,32,013,"Nevada","Humboldt County",4,79,82,41,41
050,32,013,"Nevada","Humboldt County",4,80,70,31,39
050,32,013,"Nevada","Humboldt County",4,81,51,26,25
050,32,013,"Nevada","Humboldt County",4,82,62,29,33
050,32,013,"Nevada","Humboldt County",4,83,51,23,28
050,32,013,"Nevada","Humboldt County",4,84,47,20,27
050,32,013,"Nevada","Humboldt County",4,85,219,91,128
050,32,013,"Nevada","Humboldt County",5,0,198,97,101
050,32,013,"Nevada","Humboldt County",5,1,214,113,101
050,32,013,"Nevada","Humboldt County",5,2,221,116,105
050,32,013,"Nevada","Humboldt County",5,3,258,134,124
050,32,013,"Nevada","Humboldt County",5,4,259,125,134
050,32,013,"Nevada","Humboldt County",5,5,228,112,116
050,32,013,"Nevada","Humboldt County",5,6,258,139,119
050,32,013,"Nevada","Humboldt County",5,7,228,110,118
050,32,013,"Nevada","Humboldt County",5,8,267,142,125
050,32,013,"Nevada","Humboldt County",5,9,244,127,117
050,32,013,"Nevada","Humboldt County",5,10,247,133,114
050,32,013,"Nevada","Humboldt County",5,11,271,138,133
050,32,013,"Nevada","Humboldt County",5,12,274,140,134
050,32,013,"Nevada","Humboldt County",5,13,253,126,127
050,32,013,"Nevada","Humboldt County",5,14,261,135,126
050,32,013,"Nevada","Humboldt County",5,15,277,140,137
050,32,013,"Nevada","Humboldt County",5,16,272,130,142
050,32,013,"Nevada","Humboldt County",5,17,254,129,125
050,32,013,"Nevada","Humboldt County",5,18,220,113,107
050,32,013,"Nevada","Humboldt County",5,19,159,89,70
050,32,013,"Nevada","Humboldt County",5,20,187,106,81
050,32,013,"Nevada","Humboldt County",5,21,198,111,87
050,32,013,"Nevada","Humboldt County",5,22,194,94,100
050,32,013,"Nevada","Humboldt County",5,23,192,97,95
050,32,013,"Nevada","Humboldt County",5,24,202,104,98
050,32,013,"Nevada","Humboldt County",5,25,215,106,109
050,32,013,"Nevada","Humboldt County",5,26,202,86,116
050,32,013,"Nevada","Humboldt County",5,27,219,119,100
050,32,013,"Nevada","Humboldt County",5,28,206,98,108
050,32,013,"Nevada","Humboldt County",5,29,213,109,104
050,32,013,"Nevada","Humboldt County",5,30,247,133,114
050,32,013,"Nevada","Humboldt County",5,31,230,120,110
050,32,013,"Nevada","Humboldt County",5,32,251,124,127
050,32,013,"Nevada","Humboldt County",5,33,237,128,109
050,32,013,"Nevada","Humboldt County",5,34,214,107,107
050,32,013,"Nevada","Humboldt County",5,35,230,118,112
050,32,013,"Nevada","Humboldt County",5,36,240,114,126
050,32,013,"Nevada","Humboldt County",5,37,227,124,103
050,32,013,"Nevada","Humboldt County",5,38,255,137,118
050,32,013,"Nevada","Humboldt County",5,39,227,121,106
050,32,013,"Nevada","Humboldt County",5,40,235,127,108
050,32,013,"Nevada","Humboldt County",5,41,232,125,107
050,32,013,"Nevada","Humboldt County",5,42,221,124,97
050,32,013,"Nevada","Humboldt County",5,43,209,116,93
050,32,013,"Nevada","Humboldt County",5,44,178,89,89
050,32,013,"Nevada","Humboldt County",5,45,188,97,91
050,32,013,"Nevada","Humboldt County",5,46,199,109,90
050,32,013,"Nevada","Humboldt County",5,47,186,98,88
050,32,013,"Nevada","Humboldt County",5,48,189,113,76
050,32,013,"Nevada","Humboldt County",5,49,169,95,74
050,32,013,"Nevada","Humboldt County",5,50,195,99,96
050,32,013,"Nevada","Humboldt County",5,51,193,96,97
050,32,013,"Nevada","Humboldt County",5,52,227,117,110
050,32,013,"Nevada","Humboldt County",5,53,204,120,84
050,32,013,"Nevada","Humboldt County",5,54,187,87,100
050,32,013,"Nevada","Humboldt County",5,55,183,98,85
050,32,013,"Nevada","Humboldt County",5,56,200,107,93
050,32,013,"Nevada","Humboldt County",5,57,169,95,74
050,32,013,"Nevada","Humboldt County",5,58,196,102,94
050,32,013,"Nevada","Humboldt County",5,59,192,93,99
050,32,013,"Nevada","Humboldt County",5,60,198,93,105
050,32,013,"Nevada","Humboldt County",5,61,226,114,112
050,32,013,"Nevada","Humboldt County",5,62,246,140,106
050,32,013,"Nevada","Humboldt County",5,63,227,120,107
050,32,013,"Nevada","Humboldt County",5,64,204,112,92
050,32,013,"Nevada","Humboldt County",5,65,223,114,109
050,32,013,"Nevada","Humboldt County",5,66,200,102,98
050,32,013,"Nevada","Humboldt County",5,67,184,99,85
050,32,013,"Nevada","Humboldt County",5,68,188,88,100
050,32,013,"Nevada","Humboldt County",5,69,199,101,98
050,32,013,"Nevada","Humboldt County",5,70,178,102,76
050,32,013,"Nevada","Humboldt County",5,71,169,93,76
050,32,013,"Nevada","Humboldt County",5,72,164,79,85
050,32,013,"Nevada","Humboldt County",5,73,166,87,79
050,32,013,"Nevada","Humboldt County",5,74,134,71,63
050,32,013,"Nevada","Humboldt County",5,75,138,67,71
050,32,013,"Nevada","Humboldt County",5,76,142,71,71
050,32,013,"Nevada","Humboldt County",5,77,94,48,46
050,32,013,"Nevada","Humboldt County",5,78,69,35,34
050,32,013,"Nevada","Humboldt County",5,79,76,41,35
050,32,013,"Nevada","Humboldt County",5,80,73,35,38
050,32,013,"Nevada","Humboldt County",5,81,63,30,33
050,32,013,"Nevada","Humboldt County",5,82,47,25,22
050,32,013,"Nevada","Humboldt County",5,83,57,25,32
050,32,013,"Nevada","Humboldt County",5,84,48,23,25
050,32,013,"Nevada","Humboldt County",5,85,222,89,133
050,32,015,"Nevada","Lander County",1,0,77,39,38
050,32,015,"Nevada","Lander County",1,1,76,41,35
050,32,015,"Nevada","Lander County",1,2,68,34,34
050,32,015,"Nevada","Lander County",1,3,94,42,52
050,32,015,"Nevada","Lander County",1,4,95,53,42
050,32,015,"Nevada","Lander County",1,5,83,43,40
050,32,015,"Nevada","Lander County",1,6,84,42,42
050,32,015,"Nevada","Lander County",1,7,93,53,40
050,32,015,"Nevada","Lander County",1,8,85,49,36
050,32,015,"Nevada","Lander County",1,9,83,39,44
050,32,015,"Nevada","Lander County",1,10,80,34,46
050,32,015,"Nevada","Lander County",1,11,85,38,47
050,32,015,"Nevada","Lander County",1,12,91,36,55
050,32,015,"Nevada","Lander County",1,13,81,32,49
050,32,015,"Nevada","Lander County",1,14,80,38,42
050,32,015,"Nevada","Lander County",1,15,92,56,36
050,32,015,"Nevada","Lander County",1,16,90,53,37
050,32,015,"Nevada","Lander County",1,17,75,34,41
050,32,015,"Nevada","Lander County",1,18,60,32,28
050,32,015,"Nevada","Lander County",1,19,56,30,26
050,32,015,"Nevada","Lander County",1,20,50,30,20
050,32,015,"Nevada","Lander County",1,21,42,20,22
050,32,015,"Nevada","Lander County",1,22,60,30,30
050,32,015,"Nevada","Lander County",1,23,62,29,33
050,32,015,"Nevada","Lander County",1,24,54,29,25
050,32,015,"Nevada","Lander County",1,25,50,35,15
050,32,015,"Nevada","Lander County",1,26,65,38,27
050,32,015,"Nevada","Lander County",1,27,80,36,44
050,32,015,"Nevada","Lander County",1,28,76,41,35
050,32,015,"Nevada","Lander County",1,29,79,41,38
050,32,015,"Nevada","Lander County",1,30,75,34,41
050,32,015,"Nevada","Lander County",1,31,83,39,44
050,32,015,"Nevada","Lander County",1,32,78,36,42
050,32,015,"Nevada","Lander County",1,33,76,40,36
050,32,015,"Nevada","Lander County",1,34,71,38,33
050,32,015,"Nevada","Lander County",1,35,83,42,41
050,32,015,"Nevada","Lander County",1,36,72,32,40
050,32,015,"Nevada","Lander County",1,37,88,46,42
050,32,015,"Nevada","Lander County",1,38,84,44,40
050,32,015,"Nevada","Lander County",1,39,77,38,39
050,32,015,"Nevada","Lander County",1,40,72,40,32
050,32,015,"Nevada","Lander County",1,41,57,36,21
050,32,015,"Nevada","Lander County",1,42,56,37,19
050,32,015,"Nevada","Lander County",1,43,67,37,30
050,32,015,"Nevada","Lander County",1,44,62,36,26
050,32,015,"Nevada","Lander County",1,45,59,37,22
050,32,015,"Nevada","Lander County",1,46,60,32,28
050,32,015,"Nevada","Lander County",1,47,60,29,31
050,32,015,"Nevada","Lander County",1,48,56,31,25
050,32,015,"Nevada","Lander County",1,49,75,41,34
050,32,015,"Nevada","Lander County",1,50,83,49,34
050,32,015,"Nevada","Lander County",1,51,74,41,33
050,32,015,"Nevada","Lander County",1,52,67,40,27
050,32,015,"Nevada","Lander County",1,53,74,33,41
050,32,015,"Nevada","Lander County",1,54,82,41,41
050,32,015,"Nevada","Lander County",1,55,85,44,41
050,32,015,"Nevada","Lander County",1,56,73,35,38
050,32,015,"Nevada","Lander County",1,57,75,37,38
050,32,015,"Nevada","Lander County",1,58,75,44,31
050,32,015,"Nevada","Lander County",1,59,64,38,26
050,32,015,"Nevada","Lander County",1,60,92,50,42
050,32,015,"Nevada","Lander County",1,61,84,42,42
050,32,015,"Nevada","Lander County",1,62,76,43,33
050,32,015,"Nevada","Lander County",1,63,70,41,29
050,32,015,"Nevada","Lander County",1,64,68,39,29
050,32,015,"Nevada","Lander County",1,65,67,36,31
050,32,015,"Nevada","Lander County",1,66,55,30,25
050,32,015,"Nevada","Lander County",1,67,67,34,33
050,32,015,"Nevada","Lander County",1,68,61,30,31
050,32,015,"Nevada","Lander County",1,69,63,33,30
050,32,015,"Nevada","Lander County",1,70,42,21,21
050,32,015,"Nevada","Lander County",1,71,41,16,25
050,32,015,"Nevada","Lander County",1,72,51,25,26
050,32,015,"Nevada","Lander County",1,73,54,29,25
050,32,015,"Nevada","Lander County",1,74,40,23,17
050,32,015,"Nevada","Lander County",1,75,43,24,19
050,32,015,"Nevada","Lander County",1,76,46,24,22
050,32,015,"Nevada","Lander County",1,77,37,19,18
050,32,015,"Nevada","Lander County",1,78,28,13,15
050,32,015,"Nevada","Lander County",1,79,29,15,14
050,32,015,"Nevada","Lander County",1,80,28,13,15
050,32,015,"Nevada","Lander County",1,81,19,8,11
050,32,015,"Nevada","Lander County",1,82,18,9,9
050,32,015,"Nevada","Lander County",1,83,24,10,14
050,32,015,"Nevada","Lander County",1,84,26,14,12
050,32,015,"Nevada","Lander County",1,85,95,31,64
050,32,015,"Nevada","Lander County",2,0,78,38,40
050,32,015,"Nevada","Lander County",2,1,74,39,35
050,32,015,"Nevada","Lander County",2,2,69,34,35
050,32,015,"Nevada","Lander County",2,3,87,40,47
050,32,015,"Nevada","Lander County",2,4,94,51,43
050,32,015,"Nevada","Lander County",2,5,87,46,41
050,32,015,"Nevada","Lander County",2,6,85,42,43
050,32,015,"Nevada","Lander County",2,7,87,49,38
050,32,015,"Nevada","Lander County",2,8,86,49,37
050,32,015,"Nevada","Lander County",2,9,83,41,42
050,32,015,"Nevada","Lander County",2,10,82,36,46
050,32,015,"Nevada","Lander County",2,11,84,38,46
050,32,015,"Nevada","Lander County",2,12,91,38,53
050,32,015,"Nevada","Lander County",2,13,84,33,51
050,32,015,"Nevada","Lander County",2,14,83,38,45
050,32,015,"Nevada","Lander County",2,15,89,52,37
050,32,015,"Nevada","Lander County",2,16,91,53,38
050,32,015,"Nevada","Lander County",2,17,80,39,41
050,32,015,"Nevada","Lander County",2,18,59,31,28
050,32,015,"Nevada","Lander County",2,19,54,29,25
050,32,015,"Nevada","Lander County",2,20,50,29,21
050,32,015,"Nevada","Lander County",2,21,45,23,22
050,32,015,"Nevada","Lander County",2,22,58,28,30
050,32,015,"Nevada","Lander County",2,23,61,29,32
050,32,015,"Nevada","Lander County",2,24,54,29,25
050,32,015,"Nevada","Lander County",2,25,50,33,17
050,32,015,"Nevada","Lander County",2,26,65,39,26
050,32,015,"Nevada","Lander County",2,27,77,37,40
050,32,015,"Nevada","Lander County",2,28,76,39,37
050,32,015,"Nevada","Lander County",2,29,78,41,37
050,32,015,"Nevada","Lander County",2,30,77,36,41
050,32,015,"Nevada","Lander County",2,31,81,37,44
050,32,015,"Nevada","Lander County",2,32,81,38,43
050,32,015,"Nevada","Lander County",2,33,74,38,36
050,32,015,"Nevada","Lander County",2,34,71,38,33
050,32,015,"Nevada","Lander County",2,35,81,41,40
050,32,015,"Nevada","Lander County",2,36,74,34,40
050,32,015,"Nevada","Lander County",2,37,82,42,40
050,32,015,"Nevada","Lander County",2,38,86,45,41
050,32,015,"Nevada","Lander County",2,39,80,41,39
050,32,015,"Nevada","Lander County",2,40,74,40,34
050,32,015,"Nevada","Lander County",2,41,60,37,23
050,32,015,"Nevada","Lander County",2,42,55,36,19
050,32,015,"Nevada","Lander County",2,43,66,38,28
050,32,015,"Nevada","Lander County",2,44,65,37,28
050,32,015,"Nevada","Lander County",2,45,60,38,22
050,32,015,"Nevada","Lander County",2,46,58,32,26
050,32,015,"Nevada","Lander County",2,47,60,30,30
050,32,015,"Nevada","Lander County",2,48,57,31,26
050,32,015,"Nevada","Lander County",2,49,71,38,33
050,32,015,"Nevada","Lander County",2,50,81,48,33
050,32,015,"Nevada","Lander County",2,51,73,41,32
050,32,015,"Nevada","Lander County",2,52,69,40,29
050,32,015,"Nevada","Lander County",2,53,71,34,37
050,32,015,"Nevada","Lander County",2,54,79,39,40
050,32,015,"Nevada","Lander County",2,55,85,43,42
050,32,015,"Nevada","Lander County",2,56,77,37,40
050,32,015,"Nevada","Lander County",2,57,77,37,40
050,32,015,"Nevada","Lander County",2,58,73,41,32
050,32,015,"Nevada","Lander County",2,59,66,40,26
050,32,015,"Nevada","Lander County",2,60,87,48,39
050,32,015,"Nevada","Lander County",2,61,86,43,43
050,32,015,"Nevada","Lander County",2,62,77,42,35
050,32,015,"Nevada","Lander County",2,63,74,43,31
050,32,015,"Nevada","Lander County",2,64,67,39,28
050,32,015,"Nevada","Lander County",2,65,66,36,30
050,32,015,"Nevada","Lander County",2,66,59,33,26
050,32,015,"Nevada","Lander County",2,67,65,34,31
050,32,015,"Nevada","Lander County",2,68,60,31,29
050,32,015,"Nevada","Lander County",2,69,65,34,31
050,32,015,"Nevada","Lander County",2,70,45,22,23
050,32,015,"Nevada","Lander County",2,71,39,17,22
050,32,015,"Nevada","Lander County",2,72,48,22,26
050,32,015,"Nevada","Lander County",2,73,56,30,26
050,32,015,"Nevada","Lander County",2,74,40,23,17
050,32,015,"Nevada","Lander County",2,75,42,23,19
050,32,015,"Nevada","Lander County",2,76,43,23,20
050,32,015,"Nevada","Lander County",2,77,40,21,19
050,32,015,"Nevada","Lander County",2,78,28,14,14
050,32,015,"Nevada","Lander County",2,79,29,14,15
050,32,015,"Nevada","Lander County",2,80,27,13,14
050,32,015,"Nevada","Lander County",2,81,20,9,11
050,32,015,"Nevada","Lander County",2,82,19,9,10
050,32,015,"Nevada","Lander County",2,83,23,10,13
050,32,015,"Nevada","Lander County",2,84,24,13,11
050,32,015,"Nevada","Lander County",2,85,94,30,64
050,32,015,"Nevada","Lander County",3,0,58,21,37
050,32,015,"Nevada","Lander County",3,1,78,42,36
050,32,015,"Nevada","Lander County",3,2,76,37,39
050,32,015,"Nevada","Lander County",3,3,72,39,33
050,32,015,"Nevada","Lander County",3,4,88,44,44
050,32,015,"Nevada","Lander County",3,5,91,48,43
050,32,015,"Nevada","Lander County",3,6,92,44,48
050,32,015,"Nevada","Lander County",3,7,87,49,38
050,32,015,"Nevada","Lander County",3,8,84,49,35
050,32,015,"Nevada","Lander County",3,9,95,53,42
050,32,015,"Nevada","Lander County",3,10,86,42,44
050,32,015,"Nevada","Lander County",3,11,90,41,49
050,32,015,"Nevada","Lander County",3,12,88,41,47
050,32,015,"Nevada","Lander County",3,13,89,40,49
050,32,015,"Nevada","Lander County",3,14,89,35,54
050,32,015,"Nevada","Lander County",3,15,84,35,49
050,32,015,"Nevada","Lander County",3,16,88,50,38
050,32,015,"Nevada","Lander County",3,17,98,50,48
050,32,015,"Nevada","Lander County",3,18,70,35,35
050,32,015,"Nevada","Lander County",3,19,49,24,25
050,32,015,"Nevada","Lander County",3,20,53,25,28
050,32,015,"Nevada","Lander County",3,21,52,31,21
050,32,015,"Nevada","Lander County",3,22,48,26,22
050,32,015,"Nevada","Lander County",3,23,58,26,32
050,32,015,"Nevada","Lander County",3,24,59,27,32
050,32,015,"Nevada","Lander County",3,25,49,25,24
050,32,015,"Nevada","Lander County",3,26,48,30,18
050,32,015,"Nevada","Lander County",3,27,65,38,27
050,32,015,"Nevada","Lander County",3,28,81,42,39
050,32,015,"Nevada","Lander County",3,29,83,42,41
050,32,015,"Nevada","Lander County",3,30,76,38,38
050,32,015,"Nevada","Lander County",3,31,78,34,44
050,32,015,"Nevada","Lander County",3,32,80,38,42
050,32,015,"Nevada","Lander County",3,33,80,41,39
050,32,015,"Nevada","Lander County",3,34,79,40,39
050,32,015,"Nevada","Lander County",3,35,70,36,34
050,32,015,"Nevada","Lander County",3,36,75,39,36
050,32,015,"Nevada","Lander County",3,37,74,32,42
050,32,015,"Nevada","Lander County",3,38,84,44,40
050,32,015,"Nevada","Lander County",3,39,83,41,42
050,32,015,"Nevada","Lander County",3,40,87,47,40
050,32,015,"Nevada","Lander County",3,41,75,35,40
050,32,015,"Nevada","Lander County",3,42,58,37,21
050,32,015,"Nevada","Lander County",3,43,61,40,21
050,32,015,"Nevada","Lander County",3,44,69,37,32
050,32,015,"Nevada","Lander County",3,45,64,39,25
050,32,015,"Nevada","Lander County",3,46,56,35,21
050,32,015,"Nevada","Lander County",3,47,58,32,26
050,32,015,"Nevada","Lander County",3,48,61,30,31
050,32,015,"Nevada","Lander County",3,49,58,31,27
050,32,015,"Nevada","Lander County",3,50,71,36,35
050,32,015,"Nevada","Lander County",3,51,79,47,32
050,32,015,"Nevada","Lander County",3,52,76,42,34
050,32,015,"Nevada","Lander County",3,53,72,41,31
050,32,015,"Nevada","Lander County",3,54,71,36,35
050,32,015,"Nevada","Lander County",3,55,80,40,40
050,32,015,"Nevada","Lander County",3,56,84,42,42
050,32,015,"Nevada","Lander County",3,57,78,40,38
050,32,015,"Nevada","Lander County",3,58,80,39,41
050,32,015,"Nevada","Lander County",3,59,71,42,29
050,32,015,"Nevada","Lander County",3,60,66,42,24
050,32,015,"Nevada","Lander County",3,61,82,45,37
050,32,015,"Nevada","Lander County",3,62,84,43,41
050,32,015,"Nevada","Lander County",3,63,71,39,32
050,32,015,"Nevada","Lander County",3,64,73,40,33
050,32,015,"Nevada","Lander County",3,65,64,37,27
050,32,015,"Nevada","Lander County",3,66,64,35,29
050,32,015,"Nevada","Lander County",3,67,53,30,23
050,32,015,"Nevada","Lander County",3,68,65,34,31
050,32,015,"Nevada","Lander County",3,69,54,27,27
050,32,015,"Nevada","Lander County",3,70,63,31,32
050,32,015,"Nevada","Lander County",3,71,48,24,24
050,32,015,"Nevada","Lander County",3,72,38,17,21
050,32,015,"Nevada","Lander County",3,73,44,19,25
050,32,015,"Nevada","Lander County",3,74,54,28,26
050,32,015,"Nevada","Lander County",3,75,41,24,17
050,32,015,"Nevada","Lander County",3,76,43,23,20
050,32,015,"Nevada","Lander County",3,77,41,22,19
050,32,015,"Nevada","Lander County",3,78,37,20,17
050,32,015,"Nevada","Lander County",3,79,30,15,15
050,32,015,"Nevada","Lander County",3,80,26,12,14
050,32,015,"Nevada","Lander County",3,81,24,11,13
050,32,015,"Nevada","Lander County",3,82,20,10,10
050,32,015,"Nevada","Lander County",3,83,17,8,9
050,32,015,"Nevada","Lander County",3,84,22,10,12
050,32,015,"Nevada","Lander County",3,85,101,38,63
050,32,015,"Nevada","Lander County",4,0,63,23,40
050,32,015,"Nevada","Lander County",4,1,66,26,40
050,32,015,"Nevada","Lander County",4,2,74,36,38
050,32,015,"Nevada","Lander County",4,3,75,33,42
050,32,015,"Nevada","Lander County",4,4,79,44,35
050,32,015,"Nevada","Lander County",4,5,91,43,48
050,32,015,"Nevada","Lander County",4,6,93,51,42
050,32,015,"Nevada","Lander County",4,7,85,44,41
050,32,015,"Nevada","Lander County",4,8,82,48,34
050,32,015,"Nevada","Lander County",4,9,86,48,38
050,32,015,"Nevada","Lander County",4,10,93,53,40
050,32,015,"Nevada","Lander County",4,11,89,45,44
050,32,015,"Nevada","Lander County",4,12,90,40,50
050,32,015,"Nevada","Lander County",4,13,89,43,46
050,32,015,"Nevada","Lander County",4,14,94,43,51
050,32,015,"Nevada","Lander County",4,15,87,36,51
050,32,015,"Nevada","Lander County",4,16,83,31,52
050,32,015,"Nevada","Lander County",4,17,87,51,36
050,32,015,"Nevada","Lander County",4,18,89,48,41
050,32,015,"Nevada","Lander County",4,19,54,27,27
050,32,015,"Nevada","Lander County",4,20,46,21,25
050,32,015,"Nevada","Lander County",4,21,50,26,24
050,32,015,"Nevada","Lander County",4,22,57,31,26
050,32,015,"Nevada","Lander County",4,23,53,28,25
050,32,015,"Nevada","Lander County",4,24,66,30,36
050,32,015,"Nevada","Lander County",4,25,69,31,38
050,32,015,"Nevada","Lander County",4,26,53,28,25
050,32,015,"Nevada","Lander County",4,27,47,29,18
050,32,015,"Nevada","Lander County",4,28,69,40,29
050,32,015,"Nevada","Lander County",4,29,84,42,42
050,32,015,"Nevada","Lander County",4,30,72,33,39
050,32,015,"Nevada","Lander County",4,31,78,41,37
050,32,015,"Nevada","Lander County",4,32,81,37,44
050,32,015,"Nevada","Lander County",4,33,85,43,42
050,32,015,"Nevada","Lander County",4,34,88,45,43
050,32,015,"Nevada","Lander County",4,35,74,41,33
050,32,015,"Nevada","Lander County",4,36,73,35,38
050,32,015,"Nevada","Lander County",4,37,72,39,33
050,32,015,"Nevada","Lander County",4,38,73,33,40
050,32,015,"Nevada","Lander County",4,39,80,40,40
050,32,015,"Nevada","Lander County",4,40,87,44,43
050,32,015,"Nevada","Lander County",4,41,85,42,43
050,32,015,"Nevada","Lander County",4,42,76,35,41
050,32,015,"Nevada","Lander County",4,43,57,37,20
050,32,015,"Nevada","Lander County",4,44,63,40,23
050,32,015,"Nevada","Lander County",4,45,72,38,34
050,32,015,"Nevada","Lander County",4,46,63,37,26
050,32,015,"Nevada","Lander County",4,47,59,39,20
050,32,015,"Nevada","Lander County",4,48,60,33,27
050,32,015,"Nevada","Lander County",4,49,61,29,32
050,32,015,"Nevada","Lander County",4,50,60,31,29
050,32,015,"Nevada","Lander County",4,51,69,36,33
050,32,015,"Nevada","Lander County",4,52,79,48,31
050,32,015,"Nevada","Lander County",4,53,74,44,30
050,32,015,"Nevada","Lander County",4,54,70,41,29
050,32,015,"Nevada","Lander County",4,55,64,31,33
050,32,015,"Nevada","Lander County",4,56,74,36,38
050,32,015,"Nevada","Lander County",4,57,80,43,37
050,32,015,"Nevada","Lander County",4,58,77,39,38
050,32,015,"Nevada","Lander County",4,59,73,31,42
050,32,015,"Nevada","Lander County",4,60,72,43,29
050,32,015,"Nevada","Lander County",4,61,62,38,24
050,32,015,"Nevada","Lander County",4,62,82,44,38
050,32,015,"Nevada","Lander County",4,63,84,42,42
050,32,015,"Nevada","Lander County",4,64,70,40,30
050,32,015,"Nevada","Lander County",4,65,70,42,28
050,32,015,"Nevada","Lander County",4,66,66,39,27
050,32,015,"Nevada","Lander County",4,67,60,32,28
050,32,015,"Nevada","Lander County",4,68,49,25,24
050,32,015,"Nevada","Lander County",4,69,68,36,32
050,32,015,"Nevada","Lander County",4,70,53,26,27
050,32,015,"Nevada","Lander County",4,71,60,29,31
050,32,015,"Nevada","Lander County",4,72,45,22,23
050,32,015,"Nevada","Lander County",4,73,37,15,22
050,32,015,"Nevada","Lander County",4,74,41,16,25
050,32,015,"Nevada","Lander County",4,75,55,26,29
050,32,015,"Nevada","Lander County",4,76,38,21,17
050,32,015,"Nevada","Lander County",4,77,37,19,18
050,32,015,"Nevada","Lander County",4,78,39,21,18
050,32,015,"Nevada","Lander County",4,79,33,16,17
050,32,015,"Nevada","Lander County",4,80,25,11,14
050,32,015,"Nevada","Lander County",4,81,21,9,12
050,32,015,"Nevada","Lander County",4,82,25,13,12
050,32,015,"Nevada","Lander County",4,83,19,10,9
050,32,015,"Nevada","Lander County",4,84,16,8,8
050,32,015,"Nevada","Lander County",4,85,112,45,67
050,32,015,"Nevada","Lander County",5,0,60,21,39
050,32,015,"Nevada","Lander County",5,1,73,27,46
050,32,015,"Nevada","Lander County",5,2,69,26,43
050,32,015,"Nevada","Lander County",5,3,86,44,42
050,32,015,"Nevada","Lander County",5,4,72,32,40
050,32,015,"Nevada","Lander County",5,5,78,46,32
050,32,015,"Nevada","Lander County",5,6,89,43,46
050,32,015,"Nevada","Lander County",5,7,99,54,45
050,32,015,"Nevada","Lander County",5,8,90,47,43
050,32,015,"Nevada","Lander County",5,9,83,46,37
050,32,015,"Nevada","Lander County",5,10,86,48,38
050,32,015,"Nevada","Lander County",5,11,95,56,39
050,32,015,"Nevada","Lander County",5,12,86,45,41
050,32,015,"Nevada","Lander County",5,13,86,36,50
050,32,015,"Nevada","Lander County",5,14,93,42,51
050,32,015,"Nevada","Lander County",5,15,87,41,46
050,32,015,"Nevada","Lander County",5,16,86,34,52
050,32,015,"Nevada","Lander County",5,17,81,32,49
050,32,015,"Nevada","Lander County",5,18,74,45,29
050,32,015,"Nevada","Lander County",5,19,71,40,31
050,32,015,"Nevada","Lander County",5,20,53,28,25
050,32,015,"Nevada","Lander County",5,21,45,20,25
050,32,015,"Nevada","Lander County",5,22,54,28,26
050,32,015,"Nevada","Lander County",5,23,55,28,27
050,32,015,"Nevada","Lander County",5,24,63,33,30
050,32,015,"Nevada","Lander County",5,25,62,28,34
050,32,015,"Nevada","Lander County",5,26,70,36,34
050,32,015,"Nevada","Lander County",5,27,61,33,28
050,32,015,"Nevada","Lander County",5,28,50,31,19
050,32,015,"Nevada","Lander County",5,29,68,42,26
050,32,015,"Nevada","Lander County",5,30,83,39,44
050,32,015,"Nevada","Lander County",5,31,77,38,39
050,32,015,"Nevada","Lander County",5,32,86,44,42
050,32,015,"Nevada","Lander County",5,33,82,40,42
050,32,015,"Nevada","Lander County",5,34,87,42,45
050,32,015,"Nevada","Lander County",5,35,96,48,48
050,32,015,"Nevada","Lander County",5,36,72,38,34
050,32,015,"Nevada","Lander County",5,37,71,36,35
050,32,015,"Nevada","Lander County",5,38,70,39,31
050,32,015,"Nevada","Lander County",5,39,73,36,37
050,32,015,"Nevada","Lander County",5,40,85,41,44
050,32,015,"Nevada","Lander County",5,41,91,45,46
050,32,015,"Nevada","Lander County",5,42,84,40,44
050,32,015,"Nevada","Lander County",5,43,79,39,40
050,32,015,"Nevada","Lander County",5,44,53,33,20
050,32,015,"Nevada","Lander County",5,45,63,40,23
050,32,015,"Nevada","Lander County",5,46,70,37,33
050,32,015,"Nevada","Lander County",5,47,67,38,29
050,32,015,"Nevada","Lander County",5,48,58,38,20
050,32,015,"Nevada","Lander County",5,49,56,31,25
050,32,015,"Nevada","Lander County",5,50,53,25,28
050,32,015,"Nevada","Lander County",5,51,60,32,28
050,32,015,"Nevada","Lander County",5,52,67,37,30
050,32,015,"Nevada","Lander County",5,53,79,48,31
050,32,015,"Nevada","Lander County",5,54,70,42,28
050,32,015,"Nevada","Lander County",5,55,66,38,28
050,32,015,"Nevada","Lander County",5,56,64,30,34
050,32,015,"Nevada","Lander County",5,57,77,39,38
050,32,015,"Nevada","Lander County",5,58,79,43,36
050,32,015,"Nevada","Lander County",5,59,75,39,36
050,32,015,"Nevada","Lander County",5,60,74,32,42
050,32,015,"Nevada","Lander County",5,61,71,43,28
050,32,015,"Nevada","Lander County",5,62,63,39,24
050,32,015,"Nevada","Lander County",5,63,76,40,36
050,32,015,"Nevada","Lander County",5,64,80,43,37
050,32,015,"Nevada","Lander County",5,65,70,40,30
050,32,015,"Nevada","Lander County",5,66,71,44,27
050,32,015,"Nevada","Lander County",5,67,62,36,26
050,32,015,"Nevada","Lander County",5,68,59,31,28
050,32,015,"Nevada","Lander County",5,69,51,27,24
050,32,015,"Nevada","Lander County",5,70,67,35,32
050,32,015,"Nevada","Lander County",5,71,50,23,27
050,32,015,"Nevada","Lander County",5,72,58,28,30
050,32,015,"Nevada","Lander County",5,73,42,19,23
050,32,015,"Nevada","Lander County",5,74,32,12,20
050,32,015,"Nevada","Lander County",5,75,38,13,25
050,32,015,"Nevada","Lander County",5,76,54,26,28
050,32,015,"Nevada","Lander County",5,77,35,18,17
050,32,015,"Nevada","Lander County",5,78,33,18,15
050,32,015,"Nevada","Lander County",5,79,39,21,18
050,32,015,"Nevada","Lander County",5,80,26,11,15
050,32,015,"Nevada","Lander County",5,81,22,8,14
050,32,015,"Nevada","Lander County",5,82,22,10,12
050,32,015,"Nevada","Lander County",5,83,24,12,12
050,32,015,"Nevada","Lander County",5,84,18,10,8
050,32,015,"Nevada","Lander County",5,85,114,49,65
050,32,017,"Nevada","Lincoln County",1,0,50,27,23
050,32,017,"Nevada","Lincoln County",1,1,48,28,20
050,32,017,"Nevada","Lincoln County",1,2,41,22,19
050,32,017,"Nevada","Lincoln County",1,3,46,22,24
050,32,017,"Nevada","Lincoln County",1,4,35,20,15
050,32,017,"Nevada","Lincoln County",1,5,41,25,16
050,32,017,"Nevada","Lincoln County",1,6,33,17,16
050,32,017,"Nevada","Lincoln County",1,7,36,21,15
050,32,017,"Nevada","Lincoln County",1,8,35,20,15
050,32,017,"Nevada","Lincoln County",1,9,47,25,22
050,32,017,"Nevada","Lincoln County",1,10,63,37,26
050,32,017,"Nevada","Lincoln County",1,11,54,27,27
050,32,017,"Nevada","Lincoln County",1,12,61,26,35
050,32,017,"Nevada","Lincoln County",1,13,56,27,29
050,32,017,"Nevada","Lincoln County",1,14,64,36,28
050,32,017,"Nevada","Lincoln County",1,15,70,44,26
050,32,017,"Nevada","Lincoln County",1,16,79,52,27
050,32,017,"Nevada","Lincoln County",1,17,80,48,32
050,32,017,"Nevada","Lincoln County",1,18,48,33,15
050,32,017,"Nevada","Lincoln County",1,19,55,41,14
050,32,017,"Nevada","Lincoln County",1,20,48,28,20
050,32,017,"Nevada","Lincoln County",1,21,53,35,18
050,32,017,"Nevada","Lincoln County",1,22,40,25,15
050,32,017,"Nevada","Lincoln County",1,23,47,25,22
050,32,017,"Nevada","Lincoln County",1,24,49,27,22
050,32,017,"Nevada","Lincoln County",1,25,61,39,22
050,32,017,"Nevada","Lincoln County",1,26,59,33,26
050,32,017,"Nevada","Lincoln County",1,27,53,24,29
050,32,017,"Nevada","Lincoln County",1,28,48,29,19
050,32,017,"Nevada","Lincoln County",1,29,42,25,17
050,32,017,"Nevada","Lincoln County",1,30,52,30,22
050,32,017,"Nevada","Lincoln County",1,31,49,30,19
050,32,017,"Nevada","Lincoln County",1,32,43,21,22
050,32,017,"Nevada","Lincoln County",1,33,42,26,16
050,32,017,"Nevada","Lincoln County",1,34,48,26,22
050,32,017,"Nevada","Lincoln County",1,35,52,27,25
050,32,017,"Nevada","Lincoln County",1,36,47,26,21
050,32,017,"Nevada","Lincoln County",1,37,52,31,21
050,32,017,"Nevada","Lincoln County",1,38,53,32,21
050,32,017,"Nevada","Lincoln County",1,39,62,38,24
050,32,017,"Nevada","Lincoln County",1,40,68,44,24
050,32,017,"Nevada","Lincoln County",1,41,53,33,20
050,32,017,"Nevada","Lincoln County",1,42,49,27,22
050,32,017,"Nevada","Lincoln County",1,43,43,19,24
050,32,017,"Nevada","Lincoln County",1,44,51,25,26
050,32,017,"Nevada","Lincoln County",1,45,47,23,24
050,32,017,"Nevada","Lincoln County",1,46,46,22,24
050,32,017,"Nevada","Lincoln County",1,47,50,26,24
050,32,017,"Nevada","Lincoln County",1,48,45,26,19
050,32,017,"Nevada","Lincoln County",1,49,49,28,21
050,32,017,"Nevada","Lincoln County",1,50,70,36,34
050,32,017,"Nevada","Lincoln County",1,51,58,33,25
050,32,017,"Nevada","Lincoln County",1,52,39,24,15
050,32,017,"Nevada","Lincoln County",1,53,48,28,20
050,32,017,"Nevada","Lincoln County",1,54,41,23,18
050,32,017,"Nevada","Lincoln County",1,55,59,31,28
050,32,017,"Nevada","Lincoln County",1,56,49,26,23
050,32,017,"Nevada","Lincoln County",1,57,69,36,33
050,32,017,"Nevada","Lincoln County",1,58,65,35,30
050,32,017,"Nevada","Lincoln County",1,59,62,31,31
050,32,017,"Nevada","Lincoln County",1,60,67,36,31
050,32,017,"Nevada","Lincoln County",1,61,63,28,35
050,32,017,"Nevada","Lincoln County",1,62,60,29,31
050,32,017,"Nevada","Lincoln County",1,63,66,36,30
050,32,017,"Nevada","Lincoln County",1,64,57,24,33
050,32,017,"Nevada","Lincoln County",1,65,49,25,24
050,32,017,"Nevada","Lincoln County",1,66,55,31,24
050,32,017,"Nevada","Lincoln County",1,67,75,40,35
050,32,017,"Nevada","Lincoln County",1,68,68,35,33
050,32,017,"Nevada","Lincoln County",1,69,83,44,39
050,32,017,"Nevada","Lincoln County",1,70,77,48,29
050,32,017,"Nevada","Lincoln County",1,71,62,35,27
050,32,017,"Nevada","Lincoln County",1,72,73,43,30
050,32,017,"Nevada","Lincoln County",1,73,61,28,33
050,32,017,"Nevada","Lincoln County",1,74,37,18,19
050,32,017,"Nevada","Lincoln County",1,75,47,27,20
050,32,017,"Nevada","Lincoln County",1,76,39,20,19
050,32,017,"Nevada","Lincoln County",1,77,49,23,26
050,32,017,"Nevada","Lincoln County",1,78,41,18,23
050,32,017,"Nevada","Lincoln County",1,79,41,21,20
050,32,017,"Nevada","Lincoln County",1,80,38,18,20
050,32,017,"Nevada","Lincoln County",1,81,26,14,12
050,32,017,"Nevada","Lincoln County",1,82,21,10,11
050,32,017,"Nevada","Lincoln County",1,83,24,8,16
050,32,017,"Nevada","Lincoln County",1,84,20,10,10
050,32,017,"Nevada","Lincoln County",1,85,103,53,50
050,32,017,"Nevada","Lincoln County",2,0,55,28,27
050,32,017,"Nevada","Lincoln County",2,1,48,27,21
050,32,017,"Nevada","Lincoln County",2,2,42,23,19
050,32,017,"Nevada","Lincoln County",2,3,44,22,22
050,32,017,"Nevada","Lincoln County",2,4,38,21,17
050,32,017,"Nevada","Lincoln County",2,5,41,25,16
050,32,017,"Nevada","Lincoln County",2,6,33,18,15
050,32,017,"Nevada","Lincoln County",2,7,36,21,15
050,32,017,"Nevada","Lincoln County",2,8,35,20,15
050,32,017,"Nevada","Lincoln County",2,9,44,24,20
050,32,017,"Nevada","Lincoln County",2,10,57,34,23
050,32,017,"Nevada","Lincoln County",2,11,56,29,27
050,32,017,"Nevada","Lincoln County",2,12,60,27,33
050,32,017,"Nevada","Lincoln County",2,13,58,27,31
050,32,017,"Nevada","Lincoln County",2,14,63,35,28
050,32,017,"Nevada","Lincoln County",2,15,69,43,26
050,32,017,"Nevada","Lincoln County",2,16,77,49,28
050,32,017,"Nevada","Lincoln County",2,17,75,45,30
050,32,017,"Nevada","Lincoln County",2,18,47,31,16
050,32,017,"Nevada","Lincoln County",2,19,49,35,14
050,32,017,"Nevada","Lincoln County",2,20,47,28,19
050,32,017,"Nevada","Lincoln County",2,21,50,32,18
050,32,017,"Nevada","Lincoln County",2,22,38,22,16
050,32,017,"Nevada","Lincoln County",2,23,46,24,22
050,32,017,"Nevada","Lincoln County",2,24,44,22,22
050,32,017,"Nevada","Lincoln County",2,25,56,34,22
050,32,017,"Nevada","Lincoln County",2,26,57,31,26
050,32,017,"Nevada","Lincoln County",2,27,51,23,28
050,32,017,"Nevada","Lincoln County",2,28,47,26,21
050,32,017,"Nevada","Lincoln County",2,29,41,24,17
050,32,017,"Nevada","Lincoln County",2,30,49,27,22
050,32,017,"Nevada","Lincoln County",2,31,48,28,20
050,32,017,"Nevada","Lincoln County",2,32,42,21,21
050,32,017,"Nevada","Lincoln County",2,33,42,24,18
050,32,017,"Nevada","Lincoln County",2,34,45,24,21
050,32,017,"Nevada","Lincoln County",2,35,50,26,24
050,32,017,"Nevada","Lincoln County",2,36,46,25,21
050,32,017,"Nevada","Lincoln County",2,37,52,30,22
050,32,017,"Nevada","Lincoln County",2,38,52,31,21
050,32,017,"Nevada","Lincoln County",2,39,58,35,23
050,32,017,"Nevada","Lincoln County",2,40,65,41,24
050,32,017,"Nevada","Lincoln County",2,41,56,34,22
050,32,017,"Nevada","Lincoln County",2,42,47,26,21
050,32,017,"Nevada","Lincoln County",2,43,45,20,25
050,32,017,"Nevada","Lincoln County",2,44,49,24,25
050,32,017,"Nevada","Lincoln County",2,45,46,22,24
050,32,017,"Nevada","Lincoln County",2,46,46,22,24
050,32,017,"Nevada","Lincoln County",2,47,49,25,24
050,32,017,"Nevada","Lincoln County",2,48,44,24,20
050,32,017,"Nevada","Lincoln County",2,49,49,28,21
050,32,017,"Nevada","Lincoln County",2,50,67,35,32
050,32,017,"Nevada","Lincoln County",2,51,59,33,26
050,32,017,"Nevada","Lincoln County",2,52,42,25,17
050,32,017,"Nevada","Lincoln County",2,53,47,28,19
050,32,017,"Nevada","Lincoln County",2,54,43,24,19
050,32,017,"Nevada","Lincoln County",2,55,53,28,25
050,32,017,"Nevada","Lincoln County",2,56,50,26,24
050,32,017,"Nevada","Lincoln County",2,57,66,34,32
050,32,017,"Nevada","Lincoln County",2,58,66,35,31
050,32,017,"Nevada","Lincoln County",2,59,64,33,31
050,32,017,"Nevada","Lincoln County",2,60,66,35,31
050,32,017,"Nevada","Lincoln County",2,61,64,29,35
050,32,017,"Nevada","Lincoln County",2,62,62,29,33
050,32,017,"Nevada","Lincoln County",2,63,67,36,31
050,32,017,"Nevada","Lincoln County",2,64,59,26,33
050,32,017,"Nevada","Lincoln County",2,65,50,25,25
050,32,017,"Nevada","Lincoln County",2,66,53,29,24
050,32,017,"Nevada","Lincoln County",2,67,71,38,33
050,32,017,"Nevada","Lincoln County",2,68,69,36,33
050,32,017,"Nevada","Lincoln County",2,69,79,41,38
050,32,017,"Nevada","Lincoln County",2,70,79,47,32
050,32,017,"Nevada","Lincoln County",2,71,66,39,27
050,32,017,"Nevada","Lincoln County",2,72,69,40,29
050,32,017,"Nevada","Lincoln County",2,73,68,33,35
050,32,017,"Nevada","Lincoln County",2,74,39,19,20
050,32,017,"Nevada","Lincoln County",2,75,45,25,20
050,32,017,"Nevada","Lincoln County",2,76,41,22,19
050,32,017,"Nevada","Lincoln County",2,77,45,23,22
050,32,017,"Nevada","Lincoln County",2,78,40,18,22
050,32,017,"Nevada","Lincoln County",2,79,41,20,21
050,32,017,"Nevada","Lincoln County",2,80,38,19,19
050,32,017,"Nevada","Lincoln County",2,81,27,14,13
050,32,017,"Nevada","Lincoln County",2,82,22,11,11
050,32,017,"Nevada","Lincoln County",2,83,22,8,14
050,32,017,"Nevada","Lincoln County",2,84,21,10,11
050,32,017,"Nevada","Lincoln County",2,85,101,52,49
050,32,017,"Nevada","Lincoln County",3,0,45,19,26
050,32,017,"Nevada","Lincoln County",3,1,57,27,30
050,32,017,"Nevada","Lincoln County",3,2,52,30,22
050,32,017,"Nevada","Lincoln County",3,3,44,24,20
050,32,017,"Nevada","Lincoln County",3,4,39,18,21
050,32,017,"Nevada","Lincoln County",3,5,52,27,25
050,32,017,"Nevada","Lincoln County",3,6,46,29,17
050,32,017,"Nevada","Lincoln County",3,7,37,19,18
050,32,017,"Nevada","Lincoln County",3,8,35,19,16
050,32,017,"Nevada","Lincoln County",3,9,34,18,16
050,32,017,"Nevada","Lincoln County",3,10,42,24,18
050,32,017,"Nevada","Lincoln County",3,11,50,26,24
050,32,017,"Nevada","Lincoln County",3,12,60,34,26
050,32,017,"Nevada","Lincoln County",3,13,58,27,31
050,32,017,"Nevada","Lincoln County",3,14,63,31,32
050,32,017,"Nevada","Lincoln County",3,15,67,39,28
050,32,017,"Nevada","Lincoln County",3,16,68,41,27
050,32,017,"Nevada","Lincoln County",3,17,73,44,29
050,32,017,"Nevada","Lincoln County",3,18,47,25,22
050,32,017,"Nevada","Lincoln County",3,19,35,26,9
050,32,017,"Nevada","Lincoln County",3,20,42,28,14
050,32,017,"Nevada","Lincoln County",3,21,41,28,13
050,32,017,"Nevada","Lincoln County",3,22,43,27,16
050,32,017,"Nevada","Lincoln County",3,23,38,21,17
050,32,017,"Nevada","Lincoln County",3,24,38,19,19
050,32,017,"Nevada","Lincoln County",3,25,41,23,18
050,32,017,"Nevada","Lincoln County",3,26,49,26,23
050,32,017,"Nevada","Lincoln County",3,27,55,27,28
050,32,017,"Nevada","Lincoln County",3,28,51,25,26
050,32,017,"Nevada","Lincoln County",3,29,50,27,23
050,32,017,"Nevada","Lincoln County",3,30,45,23,22
050,32,017,"Nevada","Lincoln County",3,31,49,26,23
050,32,017,"Nevada","Lincoln County",3,32,56,30,26
050,32,017,"Nevada","Lincoln County",3,33,48,28,20
050,32,017,"Nevada","Lincoln County",3,34,38,20,18
050,32,017,"Nevada","Lincoln County",3,35,46,25,21
050,32,017,"Nevada","Lincoln County",3,36,47,22,25
050,32,017,"Nevada","Lincoln County",3,37,50,28,22
050,32,017,"Nevada","Lincoln County",3,38,56,35,21
050,32,017,"Nevada","Lincoln County",3,39,55,32,23
050,32,017,"Nevada","Lincoln County",3,40,61,33,28
050,32,017,"Nevada","Lincoln County",3,41,64,40,24
050,32,017,"Nevada","Lincoln County",3,42,55,30,25
050,32,017,"Nevada","Lincoln County",3,43,55,31,24
050,32,017,"Nevada","Lincoln County",3,44,44,19,25
050,32,017,"Nevada","Lincoln County",3,45,46,22,24
050,32,017,"Nevada","Lincoln County",3,46,40,16,24
050,32,017,"Nevada","Lincoln County",3,47,50,25,25
050,32,017,"Nevada","Lincoln County",3,48,41,21,20
050,32,017,"Nevada","Lincoln County",3,49,39,23,16
050,32,017,"Nevada","Lincoln County",3,50,52,28,24
050,32,017,"Nevada","Lincoln County",3,51,73,36,37
050,32,017,"Nevada","Lincoln County",3,52,56,30,26
050,32,017,"Nevada","Lincoln County",3,53,39,22,17
050,32,017,"Nevada","Lincoln County",3,54,52,30,22
050,32,017,"Nevada","Lincoln County",3,55,45,24,21
050,32,017,"Nevada","Lincoln County",3,56,51,27,24
050,32,017,"Nevada","Lincoln County",3,57,51,26,25
050,32,017,"Nevada","Lincoln County",3,58,67,34,33
050,32,017,"Nevada","Lincoln County",3,59,67,35,32
050,32,017,"Nevada","Lincoln County",3,60,69,36,33
050,32,017,"Nevada","Lincoln County",3,61,62,35,27
050,32,017,"Nevada","Lincoln County",3,62,62,28,34
050,32,017,"Nevada","Lincoln County",3,63,66,33,33
050,32,017,"Nevada","Lincoln County",3,64,68,38,30
050,32,017,"Nevada","Lincoln County",3,65,59,26,33
050,32,017,"Nevada","Lincoln County",3,66,47,24,23
050,32,017,"Nevada","Lincoln County",3,67,49,25,24
050,32,017,"Nevada","Lincoln County",3,68,70,41,29
050,32,017,"Nevada","Lincoln County",3,69,68,33,35
050,32,017,"Nevada","Lincoln County",3,70,73,39,34
050,32,017,"Nevada","Lincoln County",3,71,73,44,29
050,32,017,"Nevada","Lincoln County",3,72,62,35,27
050,32,017,"Nevada","Lincoln County",3,73,66,38,28
050,32,017,"Nevada","Lincoln County",3,74,60,27,33
050,32,017,"Nevada","Lincoln County",3,75,40,17,23
050,32,017,"Nevada","Lincoln County",3,76,42,23,19
050,32,017,"Nevada","Lincoln County",3,77,42,21,21
050,32,017,"Nevada","Lincoln County",3,78,39,21,18
050,32,017,"Nevada","Lincoln County",3,79,42,20,22
050,32,017,"Nevada","Lincoln County",3,80,40,20,20
050,32,017,"Nevada","Lincoln County",3,81,34,16,18
050,32,017,"Nevada","Lincoln County",3,82,25,13,12
050,32,017,"Nevada","Lincoln County",3,83,21,11,10
050,32,017,"Nevada","Lincoln County",3,84,19,7,12
050,32,017,"Nevada","Lincoln County",3,85,104,52,52
050,32,017,"Nevada","Lincoln County",4,0,47,25,22
050,32,017,"Nevada","Lincoln County",4,1,50,23,27
050,32,017,"Nevada","Lincoln County",4,2,60,31,29
050,32,017,"Nevada","Lincoln County",4,3,52,31,21
050,32,017,"Nevada","Lincoln County",4,4,48,26,22
050,32,017,"Nevada","Lincoln County",4,5,40,18,22
050,32,017,"Nevada","Lincoln County",4,6,56,31,25
050,32,017,"Nevada","Lincoln County",4,7,55,34,21
050,32,017,"Nevada","Lincoln County",4,8,44,21,23
050,32,017,"Nevada","Lincoln County",4,9,38,19,19
050,32,017,"Nevada","Lincoln County",4,10,43,20,23
050,32,017,"Nevada","Lincoln County",4,11,47,28,19
050,32,017,"Nevada","Lincoln County",4,12,52,25,27
050,32,017,"Nevada","Lincoln County",4,13,62,32,30
050,32,017,"Nevada","Lincoln County",4,14,62,31,31
050,32,017,"Nevada","Lincoln County",4,15,65,34,31
050,32,017,"Nevada","Lincoln County",4,16,68,39,29
050,32,017,"Nevada","Lincoln County",4,17,67,40,27
050,32,017,"Nevada","Lincoln County",4,18,50,31,19
050,32,017,"Nevada","Lincoln County",4,19,34,21,13
050,32,017,"Nevada","Lincoln County",4,20,31,21,10
050,32,017,"Nevada","Lincoln County",4,21,46,31,15
050,32,017,"Nevada","Lincoln County",4,22,42,28,14
050,32,017,"Nevada","Lincoln County",4,23,42,27,15
050,32,017,"Nevada","Lincoln County",4,24,33,16,17
050,32,017,"Nevada","Lincoln County",4,25,43,21,22
050,32,017,"Nevada","Lincoln County",4,26,43,21,22
050,32,017,"Nevada","Lincoln County",4,27,44,21,23
050,32,017,"Nevada","Lincoln County",4,28,57,31,26
050,32,017,"Nevada","Lincoln County",4,29,52,23,29
050,32,017,"Nevada","Lincoln County",4,30,51,25,26
050,32,017,"Nevada","Lincoln County",4,31,45,27,18
050,32,017,"Nevada","Lincoln County",4,32,47,23,24
050,32,017,"Nevada","Lincoln County",4,33,59,35,24
050,32,017,"Nevada","Lincoln County",4,34,47,25,22
050,32,017,"Nevada","Lincoln County",4,35,42,26,16
050,32,017,"Nevada","Lincoln County",4,36,51,25,26
050,32,017,"Nevada","Lincoln County",4,37,48,24,24
050,32,017,"Nevada","Lincoln County",4,38,53,29,24
050,32,017,"Nevada","Lincoln County",4,39,53,31,22
050,32,017,"Nevada","Lincoln County",4,40,55,32,23
050,32,017,"Nevada","Lincoln County",4,41,58,31,27
050,32,017,"Nevada","Lincoln County",4,42,61,37,24
050,32,017,"Nevada","Lincoln County",4,43,54,28,26
050,32,017,"Nevada","Lincoln County",4,44,63,37,26
050,32,017,"Nevada","Lincoln County",4,45,45,19,26
050,32,017,"Nevada","Lincoln County",4,46,45,21,24
050,32,017,"Nevada","Lincoln County",4,47,45,21,24
050,32,017,"Nevada","Lincoln County",4,48,46,23,23
050,32,017,"Nevada","Lincoln County",4,49,41,22,19
050,32,017,"Nevada","Lincoln County",4,50,38,22,16
050,32,017,"Nevada","Lincoln County",4,51,53,29,24
050,32,017,"Nevada","Lincoln County",4,52,73,38,35
050,32,017,"Nevada","Lincoln County",4,53,60,33,27
050,32,017,"Nevada","Lincoln County",4,54,43,23,20
050,32,017,"Nevada","Lincoln County",4,55,57,34,23
050,32,017,"Nevada","Lincoln County",4,56,49,27,22
050,32,017,"Nevada","Lincoln County",4,57,53,28,25
050,32,017,"Nevada","Lincoln County",4,58,52,29,23
050,32,017,"Nevada","Lincoln County",4,59,66,34,32
050,32,017,"Nevada","Lincoln County",4,60,73,39,34
050,32,017,"Nevada","Lincoln County",4,61,69,36,33
050,32,017,"Nevada","Lincoln County",4,62,60,32,28
050,32,017,"Nevada","Lincoln County",4,63,60,27,33
050,32,017,"Nevada","Lincoln County",4,64,63,31,32
050,32,017,"Nevada","Lincoln County",4,65,67,38,29
050,32,017,"Nevada","Lincoln County",4,66,57,27,30
050,32,017,"Nevada","Lincoln County",4,67,45,24,21
050,32,017,"Nevada","Lincoln County",4,68,53,27,26
050,32,017,"Nevada","Lincoln County",4,69,71,42,29
050,32,017,"Nevada","Lincoln County",4,70,67,33,34
050,32,017,"Nevada","Lincoln County",4,71,66,34,32
050,32,017,"Nevada","Lincoln County",4,72,73,45,28
050,32,017,"Nevada","Lincoln County",4,73,57,31,26
050,32,017,"Nevada","Lincoln County",4,74,63,37,26
050,32,017,"Nevada","Lincoln County",4,75,60,26,34
050,32,017,"Nevada","Lincoln County",4,76,38,16,22
050,32,017,"Nevada","Lincoln County",4,77,41,22,19
050,32,017,"Nevada","Lincoln County",4,78,42,19,23
050,32,017,"Nevada","Lincoln County",4,79,38,20,18
050,32,017,"Nevada","Lincoln County",4,80,40,20,20
050,32,017,"Nevada","Lincoln County",4,81,39,19,20
050,32,017,"Nevada","Lincoln County",4,82,28,13,15
050,32,017,"Nevada","Lincoln County",4,83,25,13,12
050,32,017,"Nevada","Lincoln County",4,84,14,7,7
050,32,017,"Nevada","Lincoln County",4,85,105,48,57
050,32,017,"Nevada","Lincoln County",5,0,29,15,14
050,32,017,"Nevada","Lincoln County",5,1,41,20,21
050,32,017,"Nevada","Lincoln County",5,2,48,22,26
050,32,017,"Nevada","Lincoln County",5,3,62,31,31
050,32,017,"Nevada","Lincoln County",5,4,53,32,21
050,32,017,"Nevada","Lincoln County",5,5,46,26,20
050,32,017,"Nevada","Lincoln County",5,6,41,20,21
050,32,017,"Nevada","Lincoln County",5,7,55,30,25
050,32,017,"Nevada","Lincoln County",5,8,58,36,22
050,32,017,"Nevada","Lincoln County",5,9,45,23,22
050,32,017,"Nevada","Lincoln County",5,10,38,20,18
050,32,017,"Nevada","Lincoln County",5,11,46,17,29
050,32,017,"Nevada","Lincoln County",5,12,47,26,21
050,32,017,"Nevada","Lincoln County",5,13,53,27,26
050,32,017,"Nevada","Lincoln County",5,14,66,36,30
050,32,017,"Nevada","Lincoln County",5,15,73,41,32
050,32,017,"Nevada","Lincoln County",5,16,65,36,29
050,32,017,"Nevada","Lincoln County",5,17,67,37,30
050,32,017,"Nevada","Lincoln County",5,18,47,27,20
050,32,017,"Nevada","Lincoln County",5,19,38,28,10
050,32,017,"Nevada","Lincoln County",5,20,33,19,14
050,32,017,"Nevada","Lincoln County",5,21,33,25,8
050,32,017,"Nevada","Lincoln County",5,22,44,29,15
050,32,017,"Nevada","Lincoln County",5,23,44,30,14
050,32,017,"Nevada","Lincoln County",5,24,44,28,16
050,32,017,"Nevada","Lincoln County",5,25,41,22,19
050,32,017,"Nevada","Lincoln County",5,26,44,21,23
050,32,017,"Nevada","Lincoln County",5,27,38,15,23
050,32,017,"Nevada","Lincoln County",5,28,47,24,23
050,32,017,"Nevada","Lincoln County",5,29,55,30,25
050,32,017,"Nevada","Lincoln County",5,30,48,22,26
050,32,017,"Nevada","Lincoln County",5,31,56,27,29
050,32,017,"Nevada","Lincoln County",5,32,41,22,19
050,32,017,"Nevada","Lincoln County",5,33,52,25,27
050,32,017,"Nevada","Lincoln County",5,34,49,29,20
050,32,017,"Nevada","Lincoln County",5,35,46,24,22
050,32,017,"Nevada","Lincoln County",5,36,36,20,16
050,32,017,"Nevada","Lincoln County",5,37,48,24,24
050,32,017,"Nevada","Lincoln County",5,38,52,29,23
050,32,017,"Nevada","Lincoln County",5,39,55,33,22
050,32,017,"Nevada","Lincoln County",5,40,63,35,28
050,32,017,"Nevada","Lincoln County",5,41,60,37,23
050,32,017,"Nevada","Lincoln County",5,42,58,31,27
050,32,017,"Nevada","Lincoln County",5,43,60,36,24
050,32,017,"Nevada","Lincoln County",5,44,60,30,30
050,32,017,"Nevada","Lincoln County",5,45,63,37,26
050,32,017,"Nevada","Lincoln County",5,46,48,21,27
050,32,017,"Nevada","Lincoln County",5,47,49,24,25
050,32,017,"Nevada","Lincoln County",5,48,42,19,23
050,32,017,"Nevada","Lincoln County",5,49,50,24,26
050,32,017,"Nevada","Lincoln County",5,50,40,22,18
050,32,017,"Nevada","Lincoln County",5,51,39,22,17
050,32,017,"Nevada","Lincoln County",5,52,55,28,27
050,32,017,"Nevada","Lincoln County",5,53,74,41,33
050,32,017,"Nevada","Lincoln County",5,54,63,36,27
050,32,017,"Nevada","Lincoln County",5,55,42,24,18
050,32,017,"Nevada","Lincoln County",5,56,58,32,26
050,32,017,"Nevada","Lincoln County",5,57,51,31,20
050,32,017,"Nevada","Lincoln County",5,58,60,32,28
050,32,017,"Nevada","Lincoln County",5,59,50,29,21
050,32,017,"Nevada","Lincoln County",5,60,66,34,32
050,32,017,"Nevada","Lincoln County",5,61,77,42,35
050,32,017,"Nevada","Lincoln County",5,62,70,35,35
050,32,017,"Nevada","Lincoln County",5,63,66,37,29
050,32,017,"Nevada","Lincoln County",5,64,61,26,35
050,32,017,"Nevada","Lincoln County",5,65,65,34,31
050,32,017,"Nevada","Lincoln County",5,66,66,38,28
050,32,017,"Nevada","Lincoln County",5,67,53,25,28
050,32,017,"Nevada","Lincoln County",5,68,45,24,21
050,32,017,"Nevada","Lincoln County",5,69,54,29,25
050,32,017,"Nevada","Lincoln County",5,70,74,43,31
050,32,017,"Nevada","Lincoln County",5,71,62,31,31
050,32,017,"Nevada","Lincoln County",5,72,66,34,32
050,32,017,"Nevada","Lincoln County",5,73,69,41,28
050,32,017,"Nevada","Lincoln County",5,74,53,29,24
050,32,017,"Nevada","Lincoln County",5,75,65,37,28
050,32,017,"Nevada","Lincoln County",5,76,57,26,31
050,32,017,"Nevada","Lincoln County",5,77,40,17,23
050,32,017,"Nevada","Lincoln County",5,78,38,20,18
050,32,017,"Nevada","Lincoln County",5,79,38,19,19
050,32,017,"Nevada","Lincoln County",5,80,37,20,17
050,32,017,"Nevada","Lincoln County",5,81,39,19,20
050,32,017,"Nevada","Lincoln County",5,82,32,15,17
050,32,017,"Nevada","Lincoln County",5,83,26,11,15
050,32,017,"Nevada","Lincoln County",5,84,19,11,8
050,32,017,"Nevada","Lincoln County",5,85,105,48,57
050,32,019,"Nevada","Lyon County",1,0,599,310,289
050,32,019,"Nevada","Lyon County",1,1,583,307,276
050,32,019,"Nevada","Lyon County",1,2,616,312,304
050,32,019,"Nevada","Lyon County",1,3,676,335,341
050,32,019,"Nevada","Lyon County",1,4,680,336,344
050,32,019,"Nevada","Lyon County",1,5,697,358,339
050,32,019,"Nevada","Lyon County",1,6,684,353,331
050,32,019,"Nevada","Lyon County",1,7,693,366,327
050,32,019,"Nevada","Lyon County",1,8,657,345,312
050,32,019,"Nevada","Lyon County",1,9,727,369,358
050,32,019,"Nevada","Lyon County",1,10,716,389,327
050,32,019,"Nevada","Lyon County",1,11,707,342,365
050,32,019,"Nevada","Lyon County",1,12,776,391,385
050,32,019,"Nevada","Lyon County",1,13,770,402,368
050,32,019,"Nevada","Lyon County",1,14,716,378,338
050,32,019,"Nevada","Lyon County",1,15,700,357,343
050,32,019,"Nevada","Lyon County",1,16,736,376,360
050,32,019,"Nevada","Lyon County",1,17,734,384,350
050,32,019,"Nevada","Lyon County",1,18,593,300,293
050,32,019,"Nevada","Lyon County",1,19,456,235,221
050,32,019,"Nevada","Lyon County",1,20,508,271,237
050,32,019,"Nevada","Lyon County",1,21,533,273,260
050,32,019,"Nevada","Lyon County",1,22,519,274,245
050,32,019,"Nevada","Lyon County",1,23,566,271,295
050,32,019,"Nevada","Lyon County",1,24,619,297,322
050,32,019,"Nevada","Lyon County",1,25,658,335,323
050,32,019,"Nevada","Lyon County",1,26,723,387,336
050,32,019,"Nevada","Lyon County",1,27,732,393,339
050,32,019,"Nevada","Lyon County",1,28,758,390,368
050,32,019,"Nevada","Lyon County",1,29,873,466,407
050,32,019,"Nevada","Lyon County",1,30,875,475,400
050,32,019,"Nevada","Lyon County",1,31,777,420,357
050,32,019,"Nevada","Lyon County",1,32,737,402,335
050,32,019,"Nevada","Lyon County",1,33,752,408,344
050,32,019,"Nevada","Lyon County",1,34,817,430,387
050,32,019,"Nevada","Lyon County",1,35,776,411,365
050,32,019,"Nevada","Lyon County",1,36,768,405,363
050,32,019,"Nevada","Lyon County",1,37,735,374,361
050,32,019,"Nevada","Lyon County",1,38,757,399,358
050,32,019,"Nevada","Lyon County",1,39,729,399,330
050,32,019,"Nevada","Lyon County",1,40,678,342,336
050,32,019,"Nevada","Lyon County",1,41,669,336,333
050,32,019,"Nevada","Lyon County",1,42,659,332,327
050,32,019,"Nevada","Lyon County",1,43,619,327,292
050,32,019,"Nevada","Lyon County",1,44,618,322,296
050,32,019,"Nevada","Lyon County",1,45,605,307,298
050,32,019,"Nevada","Lyon County",1,46,623,324,299
050,32,019,"Nevada","Lyon County",1,47,637,328,309
050,32,019,"Nevada","Lyon County",1,48,680,346,334
050,32,019,"Nevada","Lyon County",1,49,728,384,344
050,32,019,"Nevada","Lyon County",1,50,730,376,354
050,32,019,"Nevada","Lyon County",1,51,696,366,330
050,32,019,"Nevada","Lyon County",1,52,648,344,304
050,32,019,"Nevada","Lyon County",1,53,689,365,324
050,32,019,"Nevada","Lyon County",1,54,784,410,374
050,32,019,"Nevada","Lyon County",1,55,830,408,422
050,32,019,"Nevada","Lyon County",1,56,822,409,413
050,32,019,"Nevada","Lyon County",1,57,837,429,408
050,32,019,"Nevada","Lyon County",1,58,872,442,430
050,32,019,"Nevada","Lyon County",1,59,913,469,444
050,32,019,"Nevada","Lyon County",1,60,891,468,423
050,32,019,"Nevada","Lyon County",1,61,882,465,417
050,32,019,"Nevada","Lyon County",1,62,892,457,435
050,32,019,"Nevada","Lyon County",1,63,914,470,444
050,32,019,"Nevada","Lyon County",1,64,909,470,439
050,32,019,"Nevada","Lyon County",1,65,894,444,450
050,32,019,"Nevada","Lyon County",1,66,864,426,438
050,32,019,"Nevada","Lyon County",1,67,846,405,441
050,32,019,"Nevada","Lyon County",1,68,826,391,435
050,32,019,"Nevada","Lyon County",1,69,794,377,417
050,32,019,"Nevada","Lyon County",1,70,847,418,429
050,32,019,"Nevada","Lyon County",1,71,830,429,401
050,32,019,"Nevada","Lyon County",1,72,820,427,393
050,32,019,"Nevada","Lyon County",1,73,818,431,387
050,32,019,"Nevada","Lyon County",1,74,564,299,265
050,32,019,"Nevada","Lyon County",1,75,550,282,268
050,32,019,"Nevada","Lyon County",1,76,542,282,260
050,32,019,"Nevada","Lyon County",1,77,546,291,255
050,32,019,"Nevada","Lyon County",1,78,436,234,202
050,32,019,"Nevada","Lyon County",1,79,361,188,173
050,32,019,"Nevada","Lyon County",1,80,330,160,170
050,32,019,"Nevada","Lyon County",1,81,324,163,161
050,32,019,"Nevada","Lyon County",1,82,248,121,127
050,32,019,"Nevada","Lyon County",1,83,218,108,110
050,32,019,"Nevada","Lyon County",1,84,200,103,97
050,32,019,"Nevada","Lyon County",1,85,825,355,470
050,32,019,"Nevada","Lyon County",2,0,602,312,290
050,32,019,"Nevada","Lyon County",2,1,587,307,280
050,32,019,"Nevada","Lyon County",2,2,613,312,301
050,32,019,"Nevada","Lyon County",2,3,660,329,331
050,32,019,"Nevada","Lyon County",2,4,684,338,346
050,32,019,"Nevada","Lyon County",2,5,691,349,342
050,32,019,"Nevada","Lyon County",2,6,690,354,336
050,32,019,"Nevada","Lyon County",2,7,684,360,324
050,32,019,"Nevada","Lyon County",2,8,668,350,318
050,32,019,"Nevada","Lyon County",2,9,711,364,347
050,32,019,"Nevada","Lyon County",2,10,718,382,336
050,32,019,"Nevada","Lyon County",2,11,710,356,354
050,32,019,"Nevada","Lyon County",2,12,764,384,380
050,32,019,"Nevada","Lyon County",2,13,773,400,373
050,32,019,"Nevada","Lyon County",2,14,729,383,346
050,32,019,"Nevada","Lyon County",2,15,706,364,342
050,32,019,"Nevada","Lyon County",2,16,732,375,357
050,32,019,"Nevada","Lyon County",2,17,733,384,349
050,32,019,"Nevada","Lyon County",2,18,592,307,285
050,32,019,"Nevada","Lyon County",2,19,469,240,229
050,32,019,"Nevada","Lyon County",2,20,506,269,237
050,32,019,"Nevada","Lyon County",2,21,535,278,257
050,32,019,"Nevada","Lyon County",2,22,534,277,257
050,32,019,"Nevada","Lyon County",2,23,570,282,288
050,32,019,"Nevada","Lyon County",2,24,617,298,319
050,32,019,"Nevada","Lyon County",2,25,658,333,325
050,32,019,"Nevada","Lyon County",2,26,719,383,336
050,32,019,"Nevada","Lyon County",2,27,741,397,344
050,32,019,"Nevada","Lyon County",2,28,764,397,367
050,32,019,"Nevada","Lyon County",2,29,856,455,401
050,32,019,"Nevada","Lyon County",2,30,885,478,407
050,32,019,"Nevada","Lyon County",2,31,802,434,368
050,32,019,"Nevada","Lyon County",2,32,747,406,341
050,32,019,"Nevada","Lyon County",2,33,751,408,343
050,32,019,"Nevada","Lyon County",2,34,802,427,375
050,32,019,"Nevada","Lyon County",2,35,791,421,370
050,32,019,"Nevada","Lyon County",2,36,767,404,363
050,32,019,"Nevada","Lyon County",2,37,743,384,359
050,32,019,"Nevada","Lyon County",2,38,759,401,358
050,32,019,"Nevada","Lyon County",2,39,736,400,336
050,32,019,"Nevada","Lyon County",2,40,701,364,337
050,32,019,"Nevada","Lyon County",2,41,679,343,336
050,32,019,"Nevada","Lyon County",2,42,664,336,328
050,32,019,"Nevada","Lyon County",2,43,630,329,301
050,32,019,"Nevada","Lyon County",2,44,615,319,296
050,32,019,"Nevada","Lyon County",2,45,610,312,298
050,32,019,"Nevada","Lyon County",2,46,620,321,299
050,32,019,"Nevada","Lyon County",2,47,634,325,309
050,32,019,"Nevada","Lyon County",2,48,669,344,325
050,32,019,"Nevada","Lyon County",2,49,720,379,341
050,32,019,"Nevada","Lyon County",2,50,735,378,357
050,32,019,"Nevada","Lyon County",2,51,704,367,337
050,32,019,"Nevada","Lyon County",2,52,659,348,311
050,32,019,"Nevada","Lyon County",2,53,685,364,321
050,32,019,"Nevada","Lyon County",2,54,766,399,367
050,32,019,"Nevada","Lyon County",2,55,823,411,412
050,32,019,"Nevada","Lyon County",2,56,831,413,418
050,32,019,"Nevada","Lyon County",2,57,838,423,415
050,32,019,"Nevada","Lyon County",2,58,869,441,428
050,32,019,"Nevada","Lyon County",2,59,912,467,445
050,32,019,"Nevada","Lyon County",2,60,898,469,429
050,32,019,"Nevada","Lyon County",2,61,884,464,420
050,32,019,"Nevada","Lyon County",2,62,896,462,434
050,32,019,"Nevada","Lyon County",2,63,920,476,444
050,32,019,"Nevada","Lyon County",2,64,905,468,437
050,32,019,"Nevada","Lyon County",2,65,907,456,451
050,32,019,"Nevada","Lyon County",2,66,870,431,439
050,32,019,"Nevada","Lyon County",2,67,854,411,443
050,32,019,"Nevada","Lyon County",2,68,830,394,436
050,32,019,"Nevada","Lyon County",2,69,810,384,426
050,32,019,"Nevada","Lyon County",2,70,832,407,425
050,32,019,"Nevada","Lyon County",2,71,835,424,411
050,32,019,"Nevada","Lyon County",2,72,812,423,389
050,32,019,"Nevada","Lyon County",2,73,857,451,406
050,32,019,"Nevada","Lyon County",2,74,578,307,271
050,32,019,"Nevada","Lyon County",2,75,547,282,265
050,32,019,"Nevada","Lyon County",2,76,535,277,258
050,32,019,"Nevada","Lyon County",2,77,550,294,256
050,32,019,"Nevada","Lyon County",2,78,453,242,211
050,32,019,"Nevada","Lyon County",2,79,369,195,174
050,32,019,"Nevada","Lyon County",2,80,335,164,171
050,32,019,"Nevada","Lyon County",2,81,318,160,158
050,32,019,"Nevada","Lyon County",2,82,262,128,134
050,32,019,"Nevada","Lyon County",2,83,220,109,111
050,32,019,"Nevada","Lyon County",2,84,197,100,97
050,32,019,"Nevada","Lyon County",2,85,828,355,473
050,32,019,"Nevada","Lyon County",3,0,602,305,297
050,32,019,"Nevada","Lyon County",3,1,654,328,326
050,32,019,"Nevada","Lyon County",3,2,636,344,292
050,32,019,"Nevada","Lyon County",3,3,659,343,316
050,32,019,"Nevada","Lyon County",3,4,693,345,348
050,32,019,"Nevada","Lyon County",3,5,700,348,352
050,32,019,"Nevada","Lyon County",3,6,718,374,344
050,32,019,"Nevada","Lyon County",3,7,707,372,335
050,32,019,"Nevada","Lyon County",3,8,716,389,327
050,32,019,"Nevada","Lyon County",3,9,677,355,322
050,32,019,"Nevada","Lyon County",3,10,725,364,361
050,32,019,"Nevada","Lyon County",3,11,729,387,342
050,32,019,"Nevada","Lyon County",3,12,716,363,353
050,32,019,"Nevada","Lyon County",3,13,775,384,391
050,32,019,"Nevada","Lyon County",3,14,782,409,373
050,32,019,"Nevada","Lyon County",3,15,741,401,340
050,32,019,"Nevada","Lyon County",3,16,728,378,350
050,32,019,"Nevada","Lyon County",3,17,724,375,349
050,32,019,"Nevada","Lyon County",3,18,640,349,291
050,32,019,"Nevada","Lyon County",3,19,481,243,238
050,32,019,"Nevada","Lyon County",3,20,499,262,237
050,32,019,"Nevada","Lyon County",3,21,525,267,258
050,32,019,"Nevada","Lyon County",3,22,571,286,285
050,32,019,"Nevada","Lyon County",3,23,592,327,265
050,32,019,"Nevada","Lyon County",3,24,619,305,314
050,32,019,"Nevada","Lyon County",3,25,685,353,332
050,32,019,"Nevada","Lyon County",3,26,710,361,349
050,32,019,"Nevada","Lyon County",3,27,775,410,365
050,32,019,"Nevada","Lyon County",3,28,780,417,363
050,32,019,"Nevada","Lyon County",3,29,874,470,404
050,32,019,"Nevada","Lyon County",3,30,911,508,403
050,32,019,"Nevada","Lyon County",3,31,940,509,431
050,32,019,"Nevada","Lyon County",3,32,829,442,387
050,32,019,"Nevada","Lyon County",3,33,796,436,360
050,32,019,"Nevada","Lyon County",3,34,816,442,374
050,32,019,"Nevada","Lyon County",3,35,850,469,381
050,32,019,"Nevada","Lyon County",3,36,810,431,379
050,32,019,"Nevada","Lyon County",3,37,782,417,365
050,32,019,"Nevada","Lyon County",3,38,784,417,367
050,32,019,"Nevada","Lyon County",3,39,740,386,354
050,32,019,"Nevada","Lyon County",3,40,773,426,347
050,32,019,"Nevada","Lyon County",3,41,731,379,352
050,32,019,"Nevada","Lyon County",3,42,701,362,339
050,32,019,"Nevada","Lyon County",3,43,657,340,317
050,32,019,"Nevada","Lyon County",3,44,682,359,323
050,32,019,"Nevada","Lyon County",3,45,614,318,296
050,32,019,"Nevada","Lyon County",3,46,611,306,305
050,32,019,"Nevada","Lyon County",3,47,642,326,316
050,32,019,"Nevada","Lyon County",3,48,643,339,304
050,32,019,"Nevada","Lyon County",3,49,687,352,335
050,32,019,"Nevada","Lyon County",3,50,746,394,352
050,32,019,"Nevada","Lyon County",3,51,747,392,355
050,32,019,"Nevada","Lyon County",3,52,694,357,337
050,32,019,"Nevada","Lyon County",3,53,689,357,332
050,32,019,"Nevada","Lyon County",3,54,708,371,337
050,32,019,"Nevada","Lyon County",3,55,774,398,376
050,32,019,"Nevada","Lyon County",3,56,842,426,416
050,32,019,"Nevada","Lyon County",3,57,865,428,437
050,32,019,"Nevada","Lyon County",3,58,850,431,419
050,32,019,"Nevada","Lyon County",3,59,896,456,440
050,32,019,"Nevada","Lyon County",3,60,927,483,444
050,32,019,"Nevada","Lyon County",3,61,916,472,444
050,32,019,"Nevada","Lyon County",3,62,879,468,411
050,32,019,"Nevada","Lyon County",3,63,935,479,456
050,32,019,"Nevada","Lyon County",3,64,918,478,440
050,32,019,"Nevada","Lyon County",3,65,917,463,454
050,32,019,"Nevada","Lyon County",3,66,923,465,458
050,32,019,"Nevada","Lyon County",3,67,873,426,447
050,32,019,"Nevada","Lyon County",3,68,861,410,451
050,32,019,"Nevada","Lyon County",3,69,817,394,423
050,32,019,"Nevada","Lyon County",3,70,809,391,418
050,32,019,"Nevada","Lyon County",3,71,813,386,427
050,32,019,"Nevada","Lyon County",3,72,811,410,401
050,32,019,"Nevada","Lyon County",3,73,777,405,372
050,32,019,"Nevada","Lyon County",3,74,828,436,392
050,32,019,"Nevada","Lyon County",3,75,537,282,255
050,32,019,"Nevada","Lyon County",3,76,519,268,251
050,32,019,"Nevada","Lyon County",3,77,521,269,252
050,32,019,"Nevada","Lyon County",3,78,521,279,242
050,32,019,"Nevada","Lyon County",3,79,421,220,201
050,32,019,"Nevada","Lyon County",3,80,335,173,162
050,32,019,"Nevada","Lyon County",3,81,301,144,157
050,32,019,"Nevada","Lyon County",3,82,295,153,142
050,32,019,"Nevada","Lyon County",3,83,225,105,120
050,32,019,"Nevada","Lyon County",3,84,196,97,99
050,32,019,"Nevada","Lyon County",3,85,843,365,478
050,32,019,"Nevada","Lyon County",4,0,625,311,314
050,32,019,"Nevada","Lyon County",4,1,607,297,310
050,32,019,"Nevada","Lyon County",4,2,701,337,364
050,32,019,"Nevada","Lyon County",4,3,619,329,290
050,32,019,"Nevada","Lyon County",4,4,669,339,330
050,32,019,"Nevada","Lyon County",4,5,664,327,337
050,32,019,"Nevada","Lyon County",4,6,734,362,372
050,32,019,"Nevada","Lyon County",4,7,721,382,339
050,32,019,"Nevada","Lyon County",4,8,740,397,343
050,32,019,"Nevada","Lyon County",4,9,710,387,323
050,32,019,"Nevada","Lyon County",4,10,681,339,342
050,32,019,"Nevada","Lyon County",4,11,740,367,373
050,32,019,"Nevada","Lyon County",4,12,713,376,337
050,32,019,"Nevada","Lyon County",4,13,725,356,369
050,32,019,"Nevada","Lyon County",4,14,771,383,388
050,32,019,"Nevada","Lyon County",4,15,800,424,376
050,32,019,"Nevada","Lyon County",4,16,750,399,351
050,32,019,"Nevada","Lyon County",4,17,734,380,354
050,32,019,"Nevada","Lyon County",4,18,635,346,289
050,32,019,"Nevada","Lyon County",4,19,497,270,227
050,32,019,"Nevada","Lyon County",4,20,495,265,230
050,32,019,"Nevada","Lyon County",4,21,525,266,259
050,32,019,"Nevada","Lyon County",4,22,574,297,277
050,32,019,"Nevada","Lyon County",4,23,606,304,302
050,32,019,"Nevada","Lyon County",4,24,606,328,278
050,32,019,"Nevada","Lyon County",4,25,669,336,333
050,32,019,"Nevada","Lyon County",4,26,733,373,360
050,32,019,"Nevada","Lyon County",4,27,741,398,343
050,32,019,"Nevada","Lyon County",4,28,808,432,376
050,32,019,"Nevada","Lyon County",4,29,832,450,382
050,32,019,"Nevada","Lyon County",4,30,922,488,434
050,32,019,"Nevada","Lyon County",4,31,898,496,402
050,32,019,"Nevada","Lyon County",4,32,948,499,449
050,32,019,"Nevada","Lyon County",4,33,812,443,369
050,32,019,"Nevada","Lyon County",4,34,853,475,378
050,32,019,"Nevada","Lyon County",4,35,825,445,380
050,32,019,"Nevada","Lyon County",4,36,878,491,387
050,32,019,"Nevada","Lyon County",4,37,786,412,374
050,32,019,"Nevada","Lyon County",4,38,827,444,383
050,32,019,"Nevada","Lyon County",4,39,806,438,368
050,32,019,"Nevada","Lyon County",4,40,752,395,357
050,32,019,"Nevada","Lyon County",4,41,774,424,350
050,32,019,"Nevada","Lyon County",4,42,737,387,350
050,32,019,"Nevada","Lyon County",4,43,702,362,340
050,32,019,"Nevada","Lyon County",4,44,666,334,332
050,32,019,"Nevada","Lyon County",4,45,689,365,324
050,32,019,"Nevada","Lyon County",4,46,628,335,293
050,32,019,"Nevada","Lyon County",4,47,618,302,316
050,32,019,"Nevada","Lyon County",4,48,668,339,329
050,32,019,"Nevada","Lyon County",4,49,657,340,317
050,32,019,"Nevada","Lyon County",4,50,711,357,354
050,32,019,"Nevada","Lyon County",4,51,774,405,369
050,32,019,"Nevada","Lyon County",4,52,712,376,336
050,32,019,"Nevada","Lyon County",4,53,687,352,335
050,32,019,"Nevada","Lyon County",4,54,717,377,340
050,32,019,"Nevada","Lyon County",4,55,731,381,350
050,32,019,"Nevada","Lyon County",4,56,791,399,392
050,32,019,"Nevada","Lyon County",4,57,842,421,421
050,32,019,"Nevada","Lyon County",4,58,884,441,443
050,32,019,"Nevada","Lyon County",4,59,859,414,445
050,32,019,"Nevada","Lyon County",4,60,894,462,432
050,32,019,"Nevada","Lyon County",4,61,946,480,466
050,32,019,"Nevada","Lyon County",4,62,925,471,454
050,32,019,"Nevada","Lyon County",4,63,902,486,416
050,32,019,"Nevada","Lyon County",4,64,939,494,445
050,32,019,"Nevada","Lyon County",4,65,933,491,442
050,32,019,"Nevada","Lyon County",4,66,922,460,462
050,32,019,"Nevada","Lyon County",4,67,918,463,455
050,32,019,"Nevada","Lyon County",4,68,860,414,446
050,32,019,"Nevada","Lyon County",4,69,841,409,432
050,32,019,"Nevada","Lyon County",4,70,808,400,408
050,32,019,"Nevada","Lyon County",4,71,792,377,415
050,32,019,"Nevada","Lyon County",4,72,798,389,409
050,32,019,"Nevada","Lyon County",4,73,778,396,382
050,32,019,"Nevada","Lyon County",4,74,768,393,375
050,32,019,"Nevada","Lyon County",4,75,790,406,384
050,32,019,"Nevada","Lyon County",4,76,515,270,245
050,32,019,"Nevada","Lyon County",4,77,487,251,236
050,32,019,"Nevada","Lyon County",4,78,496,252,244
050,32,019,"Nevada","Lyon County",4,79,481,256,225
050,32,019,"Nevada","Lyon County",4,80,388,199,189
050,32,019,"Nevada","Lyon County",4,81,308,154,154
050,32,019,"Nevada","Lyon County",4,82,271,126,145
050,32,019,"Nevada","Lyon County",4,83,259,128,131
050,32,019,"Nevada","Lyon County",4,84,194,88,106
050,32,019,"Nevada","Lyon County",4,85,836,374,462
050,32,019,"Nevada","Lyon County",5,0,620,306,314
050,32,019,"Nevada","Lyon County",5,1,643,316,327
050,32,019,"Nevada","Lyon County",5,2,634,318,316
050,32,019,"Nevada","Lyon County",5,3,709,363,346
050,32,019,"Nevada","Lyon County",5,4,646,356,290
050,32,019,"Nevada","Lyon County",5,5,703,359,344
050,32,019,"Nevada","Lyon County",5,6,696,341,355
050,32,019,"Nevada","Lyon County",5,7,752,371,381
050,32,019,"Nevada","Lyon County",5,8,759,412,347
050,32,019,"Nevada","Lyon County",5,9,755,404,351
050,32,019,"Nevada","Lyon County",5,10,755,408,347
050,32,019,"Nevada","Lyon County",5,11,683,346,337
050,32,019,"Nevada","Lyon County",5,12,740,370,370
050,32,019,"Nevada","Lyon County",5,13,740,384,356
050,32,019,"Nevada","Lyon County",5,14,740,369,371
050,32,019,"Nevada","Lyon County",5,15,770,392,378
050,32,019,"Nevada","Lyon County",5,16,796,427,369
050,32,019,"Nevada","Lyon County",5,17,744,404,340
050,32,019,"Nevada","Lyon County",5,18,631,351,280
050,32,019,"Nevada","Lyon County",5,19,514,281,233
050,32,019,"Nevada","Lyon County",5,20,509,274,235
050,32,019,"Nevada","Lyon County",5,21,524,276,248
050,32,019,"Nevada","Lyon County",5,22,567,298,269
050,32,019,"Nevada","Lyon County",5,23,630,320,310
050,32,019,"Nevada","Lyon County",5,24,630,335,295
050,32,019,"Nevada","Lyon County",5,25,626,333,293
050,32,019,"Nevada","Lyon County",5,26,717,372,345
050,32,019,"Nevada","Lyon County",5,27,756,395,361
050,32,019,"Nevada","Lyon County",5,28,769,421,348
050,32,019,"Nevada","Lyon County",5,29,856,440,416
050,32,019,"Nevada","Lyon County",5,30,887,485,402
050,32,019,"Nevada","Lyon County",5,31,973,518,455
050,32,019,"Nevada","Lyon County",5,32,935,516,419
050,32,019,"Nevada","Lyon County",5,33,961,516,445
050,32,019,"Nevada","Lyon County",5,34,836,447,389
050,32,019,"Nevada","Lyon County",5,35,867,484,383
050,32,019,"Nevada","Lyon County",5,36,846,474,372
050,32,019,"Nevada","Lyon County",5,37,880,481,399
050,32,019,"Nevada","Lyon County",5,38,804,425,379
050,32,019,"Nevada","Lyon County",5,39,844,454,390
050,32,019,"Nevada","Lyon County",5,40,821,448,373
050,32,019,"Nevada","Lyon County",5,41,774,421,353
050,32,019,"Nevada","Lyon County",5,42,783,432,351
050,32,019,"Nevada","Lyon County",5,43,742,397,345
050,32,019,"Nevada","Lyon County",5,44,712,364,348
050,32,019,"Nevada","Lyon County",5,45,651,327,324
050,32,019,"Nevada","Lyon County",5,46,731,380,351
050,32,019,"Nevada","Lyon County",5,47,623,320,303
050,32,019,"Nevada","Lyon County",5,48,614,296,318
050,32,019,"Nevada","Lyon County",5,49,675,348,327
050,32,019,"Nevada","Lyon County",5,50,655,336,319
050,32,019,"Nevada","Lyon County",5,51,706,352,354
050,32,019,"Nevada","Lyon County",5,52,791,417,374
050,32,019,"Nevada","Lyon County",5,53,735,390,345
050,32,019,"Nevada","Lyon County",5,54,705,361,344
050,32,019,"Nevada","Lyon County",5,55,703,370,333
050,32,019,"Nevada","Lyon County",5,56,769,396,373
050,32,019,"Nevada","Lyon County",5,57,812,414,398
050,32,019,"Nevada","Lyon County",5,58,845,428,417
050,32,019,"Nevada","Lyon County",5,59,876,433,443
050,32,019,"Nevada","Lyon County",5,60,861,417,444
050,32,019,"Nevada","Lyon County",5,61,883,453,430
050,32,019,"Nevada","Lyon County",5,62,973,496,477
050,32,019,"Nevada","Lyon County",5,63,943,471,472
050,32,019,"Nevada","Lyon County",5,64,930,508,422
050,32,019,"Nevada","Lyon County",5,65,950,489,461
050,32,019,"Nevada","Lyon County",5,66,947,495,452
050,32,019,"Nevada","Lyon County",5,67,918,467,451
050,32,019,"Nevada","Lyon County",5,68,914,461,453
050,32,019,"Nevada","Lyon County",5,69,830,399,431
050,32,019,"Nevada","Lyon County",5,70,832,395,437
050,32,019,"Nevada","Lyon County",5,71,792,385,407
050,32,019,"Nevada","Lyon County",5,72,785,385,400
050,32,019,"Nevada","Lyon County",5,73,778,380,398
050,32,019,"Nevada","Lyon County",5,74,755,375,380
050,32,019,"Nevada","Lyon County",5,75,731,372,359
050,32,019,"Nevada","Lyon County",5,76,752,389,363
050,32,019,"Nevada","Lyon County",5,77,486,255,231
050,32,019,"Nevada","Lyon County",5,78,469,240,229
050,32,019,"Nevada","Lyon County",5,79,468,235,233
050,32,019,"Nevada","Lyon County",5,80,451,238,213
050,32,019,"Nevada","Lyon County",5,81,355,184,171
050,32,019,"Nevada","Lyon County",5,82,274,144,130
050,32,019,"Nevada","Lyon County",5,83,244,106,138
050,32,019,"Nevada","Lyon County",5,84,227,109,118
050,32,019,"Nevada","Lyon County",5,85,865,389,476
050,32,021,"Nevada","Mineral County",1,0,40,21,19
050,32,021,"Nevada","Mineral County",1,1,40,19,21
050,32,021,"Nevada","Mineral County",1,2,58,29,29
050,32,021,"Nevada","Mineral County",1,3,51,24,27
050,32,021,"Nevada","Mineral County",1,4,50,33,17
050,32,021,"Nevada","Mineral County",1,5,47,25,22
050,32,021,"Nevada","Mineral County",1,6,48,22,26
050,32,021,"Nevada","Mineral County",1,7,48,21,27
050,32,021,"Nevada","Mineral County",1,8,68,31,37
050,32,021,"Nevada","Mineral County",1,9,50,22,28
050,32,021,"Nevada","Mineral County",1,10,46,22,24
050,32,021,"Nevada","Mineral County",1,11,41,21,20
050,32,021,"Nevada","Mineral County",1,12,47,26,21
050,32,021,"Nevada","Mineral County",1,13,43,23,20
050,32,021,"Nevada","Mineral County",1,14,48,27,21
050,32,021,"Nevada","Mineral County",1,15,60,33,27
050,32,021,"Nevada","Mineral County",1,16,54,31,23
050,32,021,"Nevada","Mineral County",1,17,46,27,19
050,32,021,"Nevada","Mineral County",1,18,34,19,15
050,32,021,"Nevada","Mineral County",1,19,26,13,13
050,32,021,"Nevada","Mineral County",1,20,31,14,17
050,32,021,"Nevada","Mineral County",1,21,44,17,27
050,32,021,"Nevada","Mineral County",1,22,45,19,26
050,32,021,"Nevada","Mineral County",1,23,42,23,19
050,32,021,"Nevada","Mineral County",1,24,51,28,23
050,32,021,"Nevada","Mineral County",1,25,48,22,26
050,32,021,"Nevada","Mineral County",1,26,46,22,24
050,32,021,"Nevada","Mineral County",1,27,47,22,25
050,32,021,"Nevada","Mineral County",1,28,43,26,17
050,32,021,"Nevada","Mineral County",1,29,47,22,25
050,32,021,"Nevada","Mineral County",1,30,53,26,27
050,32,021,"Nevada","Mineral County",1,31,49,24,25
050,32,021,"Nevada","Mineral County",1,32,52,27,25
050,32,021,"Nevada","Mineral County",1,33,67,35,32
050,32,021,"Nevada","Mineral County",1,34,58,30,28
050,32,021,"Nevada","Mineral County",1,35,61,34,27
050,32,021,"Nevada","Mineral County",1,36,56,33,23
050,32,021,"Nevada","Mineral County",1,37,54,33,21
050,32,021,"Nevada","Mineral County",1,38,48,23,25
050,32,021,"Nevada","Mineral County",1,39,57,31,26
050,32,021,"Nevada","Mineral County",1,40,60,30,30
050,32,021,"Nevada","Mineral County",1,41,45,28,17
050,32,021,"Nevada","Mineral County",1,42,46,27,19
050,32,021,"Nevada","Mineral County",1,43,38,25,13
050,32,021,"Nevada","Mineral County",1,44,34,19,15
050,32,021,"Nevada","Mineral County",1,45,40,21,19
050,32,021,"Nevada","Mineral County",1,46,29,11,18
050,32,021,"Nevada","Mineral County",1,47,37,15,22
050,32,021,"Nevada","Mineral County",1,48,48,19,29
050,32,021,"Nevada","Mineral County",1,49,53,25,28
050,32,021,"Nevada","Mineral County",1,50,60,29,31
050,32,021,"Nevada","Mineral County",1,51,39,17,22
050,32,021,"Nevada","Mineral County",1,52,43,16,27
050,32,021,"Nevada","Mineral County",1,53,61,31,30
050,32,021,"Nevada","Mineral County",1,54,53,25,28
050,32,021,"Nevada","Mineral County",1,55,62,32,30
050,32,021,"Nevada","Mineral County",1,56,69,34,35
050,32,021,"Nevada","Mineral County",1,57,79,39,40
050,32,021,"Nevada","Mineral County",1,58,83,40,43
050,32,021,"Nevada","Mineral County",1,59,64,32,32
050,32,021,"Nevada","Mineral County",1,60,82,41,41
050,32,021,"Nevada","Mineral County",1,61,81,44,37
050,32,021,"Nevada","Mineral County",1,62,81,41,40
050,32,021,"Nevada","Mineral County",1,63,71,33,38
050,32,021,"Nevada","Mineral County",1,64,73,34,39
050,32,021,"Nevada","Mineral County",1,65,89,43,46
050,32,021,"Nevada","Mineral County",1,66,87,47,40
050,32,021,"Nevada","Mineral County",1,67,76,46,30
050,32,021,"Nevada","Mineral County",1,68,63,42,21
050,32,021,"Nevada","Mineral County",1,69,62,31,31
050,32,021,"Nevada","Mineral County",1,70,65,30,35
050,32,021,"Nevada","Mineral County",1,71,57,23,34
050,32,021,"Nevada","Mineral County",1,72,63,30,33
050,32,021,"Nevada","Mineral County",1,73,70,38,32
050,32,021,"Nevada","Mineral County",1,74,47,21,26
050,32,021,"Nevada","Mineral County",1,75,46,22,24
050,32,021,"Nevada","Mineral County",1,76,42,22,20
050,32,021,"Nevada","Mineral County",1,77,47,23,24
050,32,021,"Nevada","Mineral County",1,78,44,24,20
050,32,021,"Nevada","Mineral County",1,79,34,10,24
050,32,021,"Nevada","Mineral County",1,80,38,16,22
050,32,021,"Nevada","Mineral County",1,81,35,14,21
050,32,021,"Nevada","Mineral County",1,82,38,23,15
050,32,021,"Nevada","Mineral County",1,83,31,20,11
050,32,021,"Nevada","Mineral County",1,84,30,10,20
050,32,021,"Nevada","Mineral County",1,85,114,48,66
050,32,021,"Nevada","Mineral County",2,0,40,21,19
050,32,021,"Nevada","Mineral County",2,1,40,20,20
050,32,021,"Nevada","Mineral County",2,2,56,27,29
050,32,021,"Nevada","Mineral County",2,3,52,24,28
050,32,021,"Nevada","Mineral County",2,4,50,31,19
050,32,021,"Nevada","Mineral County",2,5,48,27,21
050,32,021,"Nevada","Mineral County",2,6,49,23,26
050,32,021,"Nevada","Mineral County",2,7,48,21,27
050,32,021,"Nevada","Mineral County",2,8,63,29,34
050,32,021,"Nevada","Mineral County",2,9,53,24,29
050,32,021,"Nevada","Mineral County",2,10,45,21,24
050,32,021,"Nevada","Mineral County",2,11,43,21,22
050,32,021,"Nevada","Mineral County",2,12,47,25,22
050,32,021,"Nevada","Mineral County",2,13,44,24,20
050,32,021,"Nevada","Mineral County",2,14,45,25,20
050,32,021,"Nevada","Mineral County",2,15,61,34,27
050,32,021,"Nevada","Mineral County",2,16,55,31,24
050,32,021,"Nevada","Mineral County",2,17,45,25,20
050,32,021,"Nevada","Mineral County",2,18,34,20,14
050,32,021,"Nevada","Mineral County",2,19,25,14,11
050,32,021,"Nevada","Mineral County",2,20,31,14,17
050,32,021,"Nevada","Mineral County",2,21,43,17,26
050,32,021,"Nevada","Mineral County",2,22,46,20,26
050,32,021,"Nevada","Mineral County",2,23,45,23,22
050,32,021,"Nevada","Mineral County",2,24,50,27,23
050,32,021,"Nevada","Mineral County",2,25,50,24,26
050,32,021,"Nevada","Mineral County",2,26,45,21,24
050,32,021,"Nevada","Mineral County",2,27,47,22,25
050,32,021,"Nevada","Mineral County",2,28,44,25,19
050,32,021,"Nevada","Mineral County",2,29,46,22,24
050,32,021,"Nevada","Mineral County",2,30,53,26,27
050,32,021,"Nevada","Mineral County",2,31,49,24,25
050,32,021,"Nevada","Mineral County",2,32,54,28,26
050,32,021,"Nevada","Mineral County",2,33,63,33,30
050,32,021,"Nevada","Mineral County",2,34,59,30,29
050,32,021,"Nevada","Mineral County",2,35,61,33,28
050,32,021,"Nevada","Mineral County",2,36,57,33,24
050,32,021,"Nevada","Mineral County",2,37,57,34,23
050,32,021,"Nevada","Mineral County",2,38,49,25,24
050,32,021,"Nevada","Mineral County",2,39,55,29,26
050,32,021,"Nevada","Mineral County",2,40,61,31,30
050,32,021,"Nevada","Mineral County",2,41,49,29,20
050,32,021,"Nevada","Mineral County",2,42,47,29,18
050,32,021,"Nevada","Mineral County",2,43,42,27,15
050,32,021,"Nevada","Mineral County",2,44,34,20,14
050,32,021,"Nevada","Mineral County",2,45,38,20,18
050,32,021,"Nevada","Mineral County",2,46,31,13,18
050,32,021,"Nevada","Mineral County",2,47,36,14,22
050,32,021,"Nevada","Mineral County",2,48,45,18,27
050,32,021,"Nevada","Mineral County",2,49,54,24,30
050,32,021,"Nevada","Mineral County",2,50,60,28,32
050,32,021,"Nevada","Mineral County",2,51,44,20,24
050,32,021,"Nevada","Mineral County",2,52,41,16,25
050,32,021,"Nevada","Mineral County",2,53,58,28,30
050,32,021,"Nevada","Mineral County",2,54,54,26,28
050,32,021,"Nevada","Mineral County",2,55,59,31,28
050,32,021,"Nevada","Mineral County",2,56,68,34,34
050,32,021,"Nevada","Mineral County",2,57,77,39,38
050,32,021,"Nevada","Mineral County",2,58,79,38,41
050,32,021,"Nevada","Mineral County",2,59,68,34,34
050,32,021,"Nevada","Mineral County",2,60,77,38,39
050,32,021,"Nevada","Mineral County",2,61,81,44,37
050,32,021,"Nevada","Mineral County",2,62,80,41,39
050,32,021,"Nevada","Mineral County",2,63,74,36,38
050,32,021,"Nevada","Mineral County",2,64,71,32,39
050,32,021,"Nevada","Mineral County",2,65,85,40,45
050,32,021,"Nevada","Mineral County",2,66,89,47,42
050,32,021,"Nevada","Mineral County",2,67,79,47,32
050,32,021,"Nevada","Mineral County",2,68,66,44,22
050,32,021,"Nevada","Mineral County",2,69,64,34,30
050,32,021,"Nevada","Mineral County",2,70,63,30,33
050,32,021,"Nevada","Mineral County",2,71,58,25,33
050,32,021,"Nevada","Mineral County",2,72,61,28,33
050,32,021,"Nevada","Mineral County",2,73,70,36,34
050,32,021,"Nevada","Mineral County",2,74,50,24,26
050,32,021,"Nevada","Mineral County",2,75,47,22,25
050,32,021,"Nevada","Mineral County",2,76,43,21,22
050,32,021,"Nevada","Mineral County",2,77,47,24,23
050,32,021,"Nevada","Mineral County",2,78,43,23,20
050,32,021,"Nevada","Mineral County",2,79,31,11,20
050,32,021,"Nevada","Mineral County",2,80,36,14,22
050,32,021,"Nevada","Mineral County",2,81,32,13,19
050,32,021,"Nevada","Mineral County",2,82,38,21,17
050,32,021,"Nevada","Mineral County",2,83,32,21,11
050,32,021,"Nevada","Mineral County",2,84,30,12,18
050,32,021,"Nevada","Mineral County",2,85,115,48,67
050,32,021,"Nevada","Mineral County",3,0,28,15,13
050,32,021,"Nevada","Mineral County",3,1,44,24,20
050,32,021,"Nevada","Mineral County",3,2,45,23,22
050,32,021,"Nevada","Mineral County",3,3,55,27,28
050,32,021,"Nevada","Mineral County",3,4,52,25,27
050,32,021,"Nevada","Mineral County",3,5,49,29,20
050,32,021,"Nevada","Mineral County",3,6,53,25,28
050,32,021,"Nevada","Mineral County",3,7,50,24,26
050,32,021,"Nevada","Mineral County",3,8,53,23,30
050,32,021,"Nevada","Mineral County",3,9,62,30,32
050,32,021,"Nevada","Mineral County",3,10,58,27,31
050,32,021,"Nevada","Mineral County",3,11,48,23,25
050,32,021,"Nevada","Mineral County",3,12,42,21,21
050,32,021,"Nevada","Mineral County",3,13,50,27,23
050,32,021,"Nevada","Mineral County",3,14,44,22,22
050,32,021,"Nevada","Mineral County",3,15,48,26,22
050,32,021,"Nevada","Mineral County",3,16,57,33,24
050,32,021,"Nevada","Mineral County",3,17,50,29,21
050,32,021,"Nevada","Mineral County",3,18,38,17,21
050,32,021,"Nevada","Mineral County",3,19,34,17,17
050,32,021,"Nevada","Mineral County",3,20,25,13,12
050,32,021,"Nevada","Mineral County",3,21,31,13,18
050,32,021,"Nevada","Mineral County",3,22,46,20,26
050,32,021,"Nevada","Mineral County",3,23,49,21,28
050,32,021,"Nevada","Mineral County",3,24,41,21,20
050,32,021,"Nevada","Mineral County",3,25,45,26,19
050,32,021,"Nevada","Mineral County",3,26,60,27,33
050,32,021,"Nevada","Mineral County",3,27,44,19,25
050,32,021,"Nevada","Mineral County",3,28,46,21,25
050,32,021,"Nevada","Mineral County",3,29,50,26,24
050,32,021,"Nevada","Mineral County",3,30,47,24,23
050,32,021,"Nevada","Mineral County",3,31,63,31,32
050,32,021,"Nevada","Mineral County",3,32,58,29,29
050,32,021,"Nevada","Mineral County",3,33,67,36,31
050,32,021,"Nevada","Mineral County",3,34,62,34,28
050,32,021,"Nevada","Mineral County",3,35,54,27,27
050,32,021,"Nevada","Mineral County",3,36,63,37,26
050,32,021,"Nevada","Mineral County",3,37,57,35,22
050,32,021,"Nevada","Mineral County",3,38,58,35,23
050,32,021,"Nevada","Mineral County",3,39,52,28,24
050,32,021,"Nevada","Mineral County",3,40,52,27,25
050,32,021,"Nevada","Mineral County",3,41,63,32,31
050,32,021,"Nevada","Mineral County",3,42,50,27,23
050,32,021,"Nevada","Mineral County",3,43,49,29,20
050,32,021,"Nevada","Mineral County",3,44,41,26,15
050,32,021,"Nevada","Mineral County",3,45,36,21,15
050,32,021,"Nevada","Mineral County",3,46,40,21,19
050,32,021,"Nevada","Mineral County",3,47,28,13,15
050,32,021,"Nevada","Mineral County",3,48,37,14,23
050,32,021,"Nevada","Mineral County",3,49,49,19,30
050,32,021,"Nevada","Mineral County",3,50,60,27,33
050,32,021,"Nevada","Mineral County",3,51,64,31,33
050,32,021,"Nevada","Mineral County",3,52,47,22,25
050,32,021,"Nevada","Mineral County",3,53,45,20,25
050,32,021,"Nevada","Mineral County",3,54,60,31,29
050,32,021,"Nevada","Mineral County",3,55,57,27,30
050,32,021,"Nevada","Mineral County",3,56,58,29,29
050,32,021,"Nevada","Mineral County",3,57,63,31,32
050,32,021,"Nevada","Mineral County",3,58,79,41,38
050,32,021,"Nevada","Mineral County",3,59,80,38,42
050,32,021,"Nevada","Mineral County",3,60,73,33,40
050,32,021,"Nevada","Mineral County",3,61,83,41,42
050,32,021,"Nevada","Mineral County",3,62,81,44,37
050,32,021,"Nevada","Mineral County",3,63,77,39,38
050,32,021,"Nevada","Mineral County",3,64,70,37,33
050,32,021,"Nevada","Mineral County",3,65,77,35,42
050,32,021,"Nevada","Mineral County",3,66,85,41,44
050,32,021,"Nevada","Mineral County",3,67,87,46,41
050,32,021,"Nevada","Mineral County",3,68,78,44,34
050,32,021,"Nevada","Mineral County",3,69,66,45,21
050,32,021,"Nevada","Mineral County",3,70,63,33,30
050,32,021,"Nevada","Mineral County",3,71,60,27,33
050,32,021,"Nevada","Mineral County",3,72,55,23,32
050,32,021,"Nevada","Mineral County",3,73,58,28,30
050,32,021,"Nevada","Mineral County",3,74,75,39,36
050,32,021,"Nevada","Mineral County",3,75,49,25,24
050,32,021,"Nevada","Mineral County",3,76,49,22,27
050,32,021,"Nevada","Mineral County",3,77,38,19,19
050,32,021,"Nevada","Mineral County",3,78,42,24,18
050,32,021,"Nevada","Mineral County",3,79,35,19,16
050,32,021,"Nevada","Mineral County",3,80,30,11,19
050,32,021,"Nevada","Mineral County",3,81,34,14,20
050,32,021,"Nevada","Mineral County",3,82,28,12,16
050,32,021,"Nevada","Mineral County",3,83,32,17,15
050,32,021,"Nevada","Mineral County",3,84,33,21,12
050,32,021,"Nevada","Mineral County",3,85,123,49,74
050,32,021,"Nevada","Mineral County",4,0,35,20,15
050,32,021,"Nevada","Mineral County",4,1,33,20,13
050,32,021,"Nevada","Mineral County",4,2,41,23,18
050,32,021,"Nevada","Mineral County",4,3,42,20,22
050,32,021,"Nevada","Mineral County",4,4,55,25,30
050,32,021,"Nevada","Mineral County",4,5,48,22,26
050,32,021,"Nevada","Mineral County",4,6,46,28,18
050,32,021,"Nevada","Mineral County",4,7,44,20,24
050,32,021,"Nevada","Mineral County",4,8,54,28,26
050,32,021,"Nevada","Mineral County",4,9,49,19,30
050,32,021,"Nevada","Mineral County",4,10,57,29,28
050,32,021,"Nevada","Mineral County",4,11,62,30,32
050,32,021,"Nevada","Mineral County",4,12,50,25,25
050,32,021,"Nevada","Mineral County",4,13,41,20,21
050,32,021,"Nevada","Mineral County",4,14,52,27,25
050,32,021,"Nevada","Mineral County",4,15,49,24,25
050,32,021,"Nevada","Mineral County",4,16,51,29,22
050,32,021,"Nevada","Mineral County",4,17,54,31,23
050,32,021,"Nevada","Mineral County",4,18,42,24,18
050,32,021,"Nevada","Mineral County",4,19,26,16,10
050,32,021,"Nevada","Mineral County",4,20,34,17,17
050,32,021,"Nevada","Mineral County",4,21,29,16,13
050,32,021,"Nevada","Mineral County",4,22,33,16,17
050,32,021,"Nevada","Mineral County",4,23,52,21,31
050,32,021,"Nevada","Mineral County",4,24,46,21,25
050,32,021,"Nevada","Mineral County",4,25,41,21,20
050,32,021,"Nevada","Mineral County",4,26,42,24,18
050,32,021,"Nevada","Mineral County",4,27,57,25,32
050,32,021,"Nevada","Mineral County",4,28,50,23,27
050,32,021,"Nevada","Mineral County",4,29,39,19,20
050,32,021,"Nevada","Mineral County",4,30,46,28,18
050,32,021,"Nevada","Mineral County",4,31,44,22,22
050,32,021,"Nevada","Mineral County",4,32,58,32,26
050,32,021,"Nevada","Mineral County",4,33,51,22,29
050,32,021,"Nevada","Mineral County",4,34,64,35,29
050,32,021,"Nevada","Mineral County",4,35,66,36,30
050,32,021,"Nevada","Mineral County",4,36,53,27,26
050,32,021,"Nevada","Mineral County",4,37,59,35,24
050,32,021,"Nevada","Mineral County",4,38,57,35,22
050,32,021,"Nevada","Mineral County",4,39,57,33,24
050,32,021,"Nevada","Mineral County",4,40,54,28,26
050,32,021,"Nevada","Mineral County",4,41,51,27,24
050,32,021,"Nevada","Mineral County",4,42,56,28,28
050,32,021,"Nevada","Mineral County",4,43,46,24,22
050,32,021,"Nevada","Mineral County",4,44,46,27,19
050,32,021,"Nevada","Mineral County",4,45,42,27,15
050,32,021,"Nevada","Mineral County",4,46,35,19,16
050,32,021,"Nevada","Mineral County",4,47,42,22,20
050,32,021,"Nevada","Mineral County",4,48,28,12,16
050,32,021,"Nevada","Mineral County",4,49,34,12,22
050,32,021,"Nevada","Mineral County",4,50,46,18,28
050,32,021,"Nevada","Mineral County",4,51,57,24,33
050,32,021,"Nevada","Mineral County",4,52,65,33,32
050,32,021,"Nevada","Mineral County",4,53,49,23,26
050,32,021,"Nevada","Mineral County",4,54,40,19,21
050,32,021,"Nevada","Mineral County",4,55,62,31,31
050,32,021,"Nevada","Mineral County",4,56,54,25,29
050,32,021,"Nevada","Mineral County",4,57,59,29,30
050,32,021,"Nevada","Mineral County",4,58,60,29,31
050,32,021,"Nevada","Mineral County",4,59,81,42,39
050,32,021,"Nevada","Mineral County",4,60,84,38,46
050,32,021,"Nevada","Mineral County",4,61,71,33,38
050,32,021,"Nevada","Mineral County",4,62,80,40,40
050,32,021,"Nevada","Mineral County",4,63,80,44,36
050,32,021,"Nevada","Mineral County",4,64,77,37,40
050,32,021,"Nevada","Mineral County",4,65,65,35,30
050,32,021,"Nevada","Mineral County",4,66,84,39,45
050,32,021,"Nevada","Mineral County",4,67,90,45,45
050,32,021,"Nevada","Mineral County",4,68,87,48,39
050,32,021,"Nevada","Mineral County",4,69,79,41,38
050,32,021,"Nevada","Mineral County",4,70,66,43,23
050,32,021,"Nevada","Mineral County",4,71,62,32,30
050,32,021,"Nevada","Mineral County",4,72,55,24,31
050,32,021,"Nevada","Mineral County",4,73,52,22,30
050,32,021,"Nevada","Mineral County",4,74,55,28,27
050,32,021,"Nevada","Mineral County",4,75,75,40,35
050,32,021,"Nevada","Mineral County",4,76,46,25,21
050,32,021,"Nevada","Mineral County",4,77,46,19,27
050,32,021,"Nevada","Mineral County",4,78,38,19,19
050,32,021,"Nevada","Mineral County",4,79,40,23,17
050,32,021,"Nevada","Mineral County",4,80,29,15,14
050,32,021,"Nevada","Mineral County",4,81,28,11,17
050,32,021,"Nevada","Mineral County",4,82,29,12,17
050,32,021,"Nevada","Mineral County",4,83,25,12,13
050,32,021,"Nevada","Mineral County",4,84,32,17,15
050,32,021,"Nevada","Mineral County",4,85,146,68,78
050,32,021,"Nevada","Mineral County",5,0,34,19,15
050,32,021,"Nevada","Mineral County",5,1,42,27,15
050,32,021,"Nevada","Mineral County",5,2,30,19,11
050,32,021,"Nevada","Mineral County",5,3,41,23,18
050,32,021,"Nevada","Mineral County",5,4,48,24,24
050,32,021,"Nevada","Mineral County",5,5,52,24,28
050,32,021,"Nevada","Mineral County",5,6,49,20,29
050,32,021,"Nevada","Mineral County",5,7,46,28,18
050,32,021,"Nevada","Mineral County",5,8,48,20,28
050,32,021,"Nevada","Mineral County",5,9,49,22,27
050,32,021,"Nevada","Mineral County",5,10,50,19,31
050,32,021,"Nevada","Mineral County",5,11,61,35,26
050,32,021,"Nevada","Mineral County",5,12,65,31,34
050,32,021,"Nevada","Mineral County",5,13,51,27,24
050,32,021,"Nevada","Mineral County",5,14,48,25,23
050,32,021,"Nevada","Mineral County",5,15,59,32,27
050,32,021,"Nevada","Mineral County",5,16,47,24,23
050,32,021,"Nevada","Mineral County",5,17,52,29,23
050,32,021,"Nevada","Mineral County",5,18,41,22,19
050,32,021,"Nevada","Mineral County",5,19,37,19,18
050,32,021,"Nevada","Mineral County",5,20,27,15,12
050,32,021,"Nevada","Mineral County",5,21,38,19,19
050,32,021,"Nevada","Mineral County",5,22,28,18,10
050,32,021,"Nevada","Mineral County",5,23,33,15,18
050,32,021,"Nevada","Mineral County",5,24,51,21,30
050,32,021,"Nevada","Mineral County",5,25,45,21,24
050,32,021,"Nevada","Mineral County",5,26,36,16,20
050,32,021,"Nevada","Mineral County",5,27,42,24,18
050,32,021,"Nevada","Mineral County",5,28,55,28,27
050,32,021,"Nevada","Mineral County",5,29,51,25,26
050,32,021,"Nevada","Mineral County",5,30,40,22,18
050,32,021,"Nevada","Mineral County",5,31,46,30,16
050,32,021,"Nevada","Mineral County",5,32,46,24,22
050,32,021,"Nevada","Mineral County",5,33,60,30,30
050,32,021,"Nevada","Mineral County",5,34,61,25,36
050,32,021,"Nevada","Mineral County",5,35,67,38,29
050,32,021,"Nevada","Mineral County",5,36,65,36,29
050,32,021,"Nevada","Mineral County",5,37,53,29,24
050,32,021,"Nevada","Mineral County",5,38,48,24,24
050,32,021,"Nevada","Mineral County",5,39,53,32,21
050,32,021,"Nevada","Mineral County",5,40,62,33,29
050,32,021,"Nevada","Mineral County",5,41,53,27,26
050,32,021,"Nevada","Mineral County",5,42,43,22,21
050,32,021,"Nevada","Mineral County",5,43,60,30,30
050,32,021,"Nevada","Mineral County",5,44,48,26,22
050,32,021,"Nevada","Mineral County",5,45,41,24,17
050,32,021,"Nevada","Mineral County",5,46,38,25,13
050,32,021,"Nevada","Mineral County",5,47,38,24,14
050,32,021,"Nevada","Mineral County",5,48,46,23,23
050,32,021,"Nevada","Mineral County",5,49,30,15,15
050,32,021,"Nevada","Mineral County",5,50,38,16,22
050,32,021,"Nevada","Mineral County",5,51,40,16,24
050,32,021,"Nevada","Mineral County",5,52,52,20,32
050,32,021,"Nevada","Mineral County",5,53,65,33,32
050,32,021,"Nevada","Mineral County",5,54,50,25,25
050,32,021,"Nevada","Mineral County",5,55,43,20,23
050,32,021,"Nevada","Mineral County",5,56,58,27,31
050,32,021,"Nevada","Mineral County",5,57,54,23,31
050,32,021,"Nevada","Mineral County",5,58,54,27,27
050,32,021,"Nevada","Mineral County",5,59,62,29,33
050,32,021,"Nevada","Mineral County",5,60,83,44,39
050,32,021,"Nevada","Mineral County",5,61,86,43,43
050,32,021,"Nevada","Mineral County",5,62,74,34,40
050,32,021,"Nevada","Mineral County",5,63,84,44,40
050,32,021,"Nevada","Mineral County",5,64,79,42,37
050,32,021,"Nevada","Mineral County",5,65,79,36,43
050,32,021,"Nevada","Mineral County",5,66,66,34,32
050,32,021,"Nevada","Mineral County",5,67,84,40,44
050,32,021,"Nevada","Mineral County",5,68,91,45,46
050,32,021,"Nevada","Mineral County",5,69,85,47,38
050,32,021,"Nevada","Mineral County",5,70,77,40,37
050,32,021,"Nevada","Mineral County",5,71,71,47,24
050,32,021,"Nevada","Mineral County",5,72,58,31,27
050,32,021,"Nevada","Mineral County",5,73,51,22,29
050,32,021,"Nevada","Mineral County",5,74,51,22,29
050,32,021,"Nevada","Mineral County",5,75,52,27,25
050,32,021,"Nevada","Mineral County",5,76,73,40,33
050,32,021,"Nevada","Mineral County",5,77,41,23,18
050,32,021,"Nevada","Mineral County",5,78,41,19,22
050,32,021,"Nevada","Mineral County",5,79,31,17,14
050,32,021,"Nevada","Mineral County",5,80,35,19,16
050,32,021,"Nevada","Mineral County",5,81,27,14,13
050,32,021,"Nevada","Mineral County",5,82,22,11,11
050,32,021,"Nevada","Mineral County",5,83,27,12,15
050,32,021,"Nevada","Mineral County",5,84,25,12,13
050,32,021,"Nevada","Mineral County",5,85,165,79,86
050,32,023,"Nevada","Nye County",1,0,437,226,211
050,32,023,"Nevada","Nye County",1,1,434,228,206
050,32,023,"Nevada","Nye County",1,2,413,228,185
050,32,023,"Nevada","Nye County",1,3,471,254,217
050,32,023,"Nevada","Nye County",1,4,464,235,229
050,32,023,"Nevada","Nye County",1,5,461,237,224
050,32,023,"Nevada","Nye County",1,6,478,256,222
050,32,023,"Nevada","Nye County",1,7,429,224,205
050,32,023,"Nevada","Nye County",1,8,472,226,246
050,32,023,"Nevada","Nye County",1,9,482,229,253
050,32,023,"Nevada","Nye County",1,10,497,249,248
050,32,023,"Nevada","Nye County",1,11,481,229,252
050,32,023,"Nevada","Nye County",1,12,502,249,253
050,32,023,"Nevada","Nye County",1,13,509,255,254
050,32,023,"Nevada","Nye County",1,14,547,283,264
050,32,023,"Nevada","Nye County",1,15,524,276,248
050,32,023,"Nevada","Nye County",1,16,533,277,256
050,32,023,"Nevada","Nye County",1,17,513,256,257
050,32,023,"Nevada","Nye County",1,18,450,244,206
050,32,023,"Nevada","Nye County",1,19,384,217,167
050,32,023,"Nevada","Nye County",1,20,410,232,178
050,32,023,"Nevada","Nye County",1,21,407,223,184
050,32,023,"Nevada","Nye County",1,22,503,322,181
050,32,023,"Nevada","Nye County",1,23,503,285,218
050,32,023,"Nevada","Nye County",1,24,474,261,213
050,32,023,"Nevada","Nye County",1,25,456,244,212
050,32,023,"Nevada","Nye County",1,26,577,349,228
050,32,023,"Nevada","Nye County",1,27,510,284,226
050,32,023,"Nevada","Nye County",1,28,532,291,241
050,32,023,"Nevada","Nye County",1,29,528,283,245
050,32,023,"Nevada","Nye County",1,30,525,287,238
050,32,023,"Nevada","Nye County",1,31,486,285,201
050,32,023,"Nevada","Nye County",1,32,471,253,218
050,32,023,"Nevada","Nye County",1,33,452,234,218
050,32,023,"Nevada","Nye County",1,34,452,220,232
050,32,023,"Nevada","Nye County",1,35,475,245,230
050,32,023,"Nevada","Nye County",1,36,452,234,218
050,32,023,"Nevada","Nye County",1,37,476,235,241
050,32,023,"Nevada","Nye County",1,38,483,230,253
050,32,023,"Nevada","Nye County",1,39,511,257,254
050,32,023,"Nevada","Nye County",1,40,446,223,223
050,32,023,"Nevada","Nye County",1,41,454,233,221
050,32,023,"Nevada","Nye County",1,42,462,244,218
050,32,023,"Nevada","Nye County",1,43,460,252,208
050,32,023,"Nevada","Nye County",1,44,495,252,243
050,32,023,"Nevada","Nye County",1,45,476,242,234
050,32,023,"Nevada","Nye County",1,46,460,242,218
050,32,023,"Nevada","Nye County",1,47,455,231,224
050,32,023,"Nevada","Nye County",1,48,524,260,264
050,32,023,"Nevada","Nye County",1,49,578,284,294
050,32,023,"Nevada","Nye County",1,50,597,318,279
050,32,023,"Nevada","Nye County",1,51,561,249,312
050,32,023,"Nevada","Nye County",1,52,555,256,299
050,32,023,"Nevada","Nye County",1,53,631,329,302
050,32,023,"Nevada","Nye County",1,54,653,338,315
050,32,023,"Nevada","Nye County",1,55,762,386,376
050,32,023,"Nevada","Nye County",1,56,817,406,411
050,32,023,"Nevada","Nye County",1,57,838,435,403
050,32,023,"Nevada","Nye County",1,58,845,397,448
050,32,023,"Nevada","Nye County",1,59,838,389,449
050,32,023,"Nevada","Nye County",1,60,877,442,435
050,32,023,"Nevada","Nye County",1,61,907,469,438
050,32,023,"Nevada","Nye County",1,62,950,464,486
050,32,023,"Nevada","Nye County",1,63,1024,512,512
050,32,023,"Nevada","Nye County",1,64,1046,511,535
050,32,023,"Nevada","Nye County",1,65,1023,474,549
050,32,023,"Nevada","Nye County",1,66,968,492,476
050,32,023,"Nevada","Nye County",1,67,1008,513,495
050,32,023,"Nevada","Nye County",1,68,1018,510,508
050,32,023,"Nevada","Nye County",1,69,976,480,496
050,32,023,"Nevada","Nye County",1,70,901,448,453
050,32,023,"Nevada","Nye County",1,71,895,458,437
050,32,023,"Nevada","Nye County",1,72,954,474,480
050,32,023,"Nevada","Nye County",1,73,1018,542,476
050,32,023,"Nevada","Nye County",1,74,702,359,343
050,32,023,"Nevada","Nye County",1,75,715,352,363
050,32,023,"Nevada","Nye County",1,76,747,398,349
050,32,023,"Nevada","Nye County",1,77,704,362,342
050,32,023,"Nevada","Nye County",1,78,618,331,287
050,32,023,"Nevada","Nye County",1,79,478,250,228
050,32,023,"Nevada","Nye County",1,80,437,250,187
050,32,023,"Nevada","Nye County",1,81,413,229,184
050,32,023,"Nevada","Nye County",1,82,382,201,181
050,32,023,"Nevada","Nye County",1,83,312,167,145
050,32,023,"Nevada","Nye County",1,84,280,147,133
050,32,023,"Nevada","Nye County",1,85,1164,559,605
050,32,023,"Nevada","Nye County",2,0,427,224,203
050,32,023,"Nevada","Nye County",2,1,437,228,209
050,32,023,"Nevada","Nye County",2,2,422,230,192
050,32,023,"Nevada","Nye County",2,3,463,250,213
050,32,023,"Nevada","Nye County",2,4,470,242,228
050,32,023,"Nevada","Nye County",2,5,468,241,227
050,32,023,"Nevada","Nye County",2,6,476,254,222
050,32,023,"Nevada","Nye County",2,7,446,234,212
050,32,023,"Nevada","Nye County",2,8,462,226,236
050,32,023,"Nevada","Nye County",2,9,480,227,253
050,32,023,"Nevada","Nye County",2,10,492,242,250
050,32,023,"Nevada","Nye County",2,11,486,236,250
050,32,023,"Nevada","Nye County",2,12,501,246,255
050,32,023,"Nevada","Nye County",2,13,513,254,259
050,32,023,"Nevada","Nye County",2,14,537,276,261
050,32,023,"Nevada","Nye County",2,15,536,282,254
050,32,023,"Nevada","Nye County",2,16,537,278,259
050,32,023,"Nevada","Nye County",2,17,517,263,254
050,32,023,"Nevada","Nye County",2,18,441,237,204
050,32,023,"Nevada","Nye County",2,19,388,221,167
050,32,023,"Nevada","Nye County",2,20,419,235,184
050,32,023,"Nevada","Nye County",2,21,404,222,182
050,32,023,"Nevada","Nye County",2,22,504,318,186
050,32,023,"Nevada","Nye County",2,23,503,288,215
050,32,023,"Nevada","Nye County",2,24,478,264,214
050,32,023,"Nevada","Nye County",2,25,460,245,215
050,32,023,"Nevada","Nye County",2,26,567,344,223
050,32,023,"Nevada","Nye County",2,27,511,284,227
050,32,023,"Nevada","Nye County",2,28,536,293,243
050,32,023,"Nevada","Nye County",2,29,531,282,249
050,32,023,"Nevada","Nye County",2,30,530,288,242
050,32,023,"Nevada","Nye County",2,31,505,293,212
050,32,023,"Nevada","Nye County",2,32,473,254,219
050,32,023,"Nevada","Nye County",2,33,457,236,221
050,32,023,"Nevada","Nye County",2,34,457,222,235
050,32,023,"Nevada","Nye County",2,35,479,245,234
050,32,023,"Nevada","Nye County",2,36,461,239,222
050,32,023,"Nevada","Nye County",2,37,484,239,245
050,32,023,"Nevada","Nye County",2,38,487,232,255
050,32,023,"Nevada","Nye County",2,39,507,254,253
050,32,023,"Nevada","Nye County",2,40,463,234,229
050,32,023,"Nevada","Nye County",2,41,456,233,223
050,32,023,"Nevada","Nye County",2,42,464,245,219
050,32,023,"Nevada","Nye County",2,43,474,256,218
050,32,023,"Nevada","Nye County",2,44,493,254,239
050,32,023,"Nevada","Nye County",2,45,479,238,241
050,32,023,"Nevada","Nye County",2,46,470,247,223
050,32,023,"Nevada","Nye County",2,47,460,231,229
050,32,023,"Nevada","Nye County",2,48,510,253,257
050,32,023,"Nevada","Nye County",2,49,580,289,291
050,32,023,"Nevada","Nye County",2,50,606,321,285
050,32,023,"Nevada","Nye County",2,51,571,263,308
050,32,023,"Nevada","Nye County",2,52,562,258,304
050,32,023,"Nevada","Nye County",2,53,625,323,302
050,32,023,"Nevada","Nye County",2,54,644,331,313
050,32,023,"Nevada","Nye County",2,55,745,380,365
050,32,023,"Nevada","Nye County",2,56,812,406,406
050,32,023,"Nevada","Nye County",2,57,842,436,406
050,32,023,"Nevada","Nye County",2,58,855,408,447
050,32,023,"Nevada","Nye County",2,59,846,394,452
050,32,023,"Nevada","Nye County",2,60,872,431,441
050,32,023,"Nevada","Nye County",2,61,909,465,444
050,32,023,"Nevada","Nye County",2,62,959,478,481
050,32,023,"Nevada","Nye County",2,63,1031,512,519
050,32,023,"Nevada","Nye County",2,64,1052,515,537
050,32,023,"Nevada","Nye County",2,65,1047,492,555
050,32,023,"Nevada","Nye County",2,66,1004,499,505
050,32,023,"Nevada","Nye County",2,67,1006,514,492
050,32,023,"Nevada","Nye County",2,68,1010,505,505
050,32,023,"Nevada","Nye County",2,69,1000,493,507
050,32,023,"Nevada","Nye County",2,70,926,461,465
050,32,023,"Nevada","Nye County",2,71,906,463,443
050,32,023,"Nevada","Nye County",2,72,927,463,464
050,32,023,"Nevada","Nye County",2,73,1051,549,502
050,32,023,"Nevada","Nye County",2,74,728,378,350
050,32,023,"Nevada","Nye County",2,75,715,357,358
050,32,023,"Nevada","Nye County",2,76,721,373,348
050,32,023,"Nevada","Nye County",2,77,731,381,350
050,32,023,"Nevada","Nye County",2,78,624,328,296
050,32,023,"Nevada","Nye County",2,79,504,266,238
050,32,023,"Nevada","Nye County",2,80,434,240,194
050,32,023,"Nevada","Nye County",2,81,410,231,179
050,32,023,"Nevada","Nye County",2,82,388,205,183
050,32,023,"Nevada","Nye County",2,83,319,175,144
050,32,023,"Nevada","Nye County",2,84,284,151,133
050,32,023,"Nevada","Nye County",2,85,1196,578,618
050,32,023,"Nevada","Nye County",3,0,372,175,197
050,32,023,"Nevada","Nye County",3,1,447,249,198
050,32,023,"Nevada","Nye County",3,2,468,249,219
050,32,023,"Nevada","Nye County",3,3,454,249,205
050,32,023,"Nevada","Nye County",3,4,466,250,216
050,32,023,"Nevada","Nye County",3,5,503,262,241
050,32,023,"Nevada","Nye County",3,6,502,245,257
050,32,023,"Nevada","Nye County",3,7,490,272,218
050,32,023,"Nevada","Nye County",3,8,459,240,219
050,32,023,"Nevada","Nye County",3,9,482,242,240
050,32,023,"Nevada","Nye County",3,10,496,239,257
050,32,023,"Nevada","Nye County",3,11,497,242,255
050,32,023,"Nevada","Nye County",3,12,497,251,246
050,32,023,"Nevada","Nye County",3,13,525,252,273
050,32,023,"Nevada","Nye County",3,14,507,246,261
050,32,023,"Nevada","Nye County",3,15,575,309,266
050,32,023,"Nevada","Nye County",3,16,548,278,270
050,32,023,"Nevada","Nye County",3,17,565,285,280
050,32,023,"Nevada","Nye County",3,18,462,240,222
050,32,023,"Nevada","Nye County",3,19,369,208,161
050,32,023,"Nevada","Nye County",3,20,440,241,199
050,32,023,"Nevada","Nye County",3,21,434,246,188
050,32,023,"Nevada","Nye County",3,22,474,286,188
050,32,023,"Nevada","Nye County",3,23,502,283,219
050,32,023,"Nevada","Nye County",3,24,485,271,214
050,32,023,"Nevada","Nye County",3,25,458,229,229
050,32,023,"Nevada","Nye County",3,26,554,323,231
050,32,023,"Nevada","Nye County",3,27,505,287,218
050,32,023,"Nevada","Nye County",3,28,543,303,240
050,32,023,"Nevada","Nye County",3,29,549,295,254
050,32,023,"Nevada","Nye County",3,30,558,304,254
050,32,023,"Nevada","Nye County",3,31,542,301,241
050,32,023,"Nevada","Nye County",3,32,497,275,222
050,32,023,"Nevada","Nye County",3,33,499,267,232
050,32,023,"Nevada","Nye County",3,34,462,228,234
050,32,023,"Nevada","Nye County",3,35,466,242,224
050,32,023,"Nevada","Nye County",3,36,503,257,246
050,32,023,"Nevada","Nye County",3,37,478,244,234
050,32,023,"Nevada","Nye County",3,38,502,244,258
050,32,023,"Nevada","Nye County",3,39,524,264,260
050,32,023,"Nevada","Nye County",3,40,506,246,260
050,32,023,"Nevada","Nye County",3,41,486,256,230
050,32,023,"Nevada","Nye County",3,42,508,269,239
050,32,023,"Nevada","Nye County",3,43,507,277,230
050,32,023,"Nevada","Nye County",3,44,500,272,228
050,32,023,"Nevada","Nye County",3,45,470,232,238
050,32,023,"Nevada","Nye County",3,46,517,262,255
050,32,023,"Nevada","Nye County",3,47,480,234,246
050,32,023,"Nevada","Nye County",3,48,474,243,231
050,32,023,"Nevada","Nye County",3,49,554,284,270
050,32,023,"Nevada","Nye County",3,50,636,327,309
050,32,023,"Nevada","Nye County",3,51,632,322,310
050,32,023,"Nevada","Nye County",3,52,606,280,326
050,32,023,"Nevada","Nye County",3,53,628,302,326
050,32,023,"Nevada","Nye County",3,54,643,320,323
050,32,023,"Nevada","Nye County",3,55,693,364,329
050,32,023,"Nevada","Nye County",3,56,797,394,403
050,32,023,"Nevada","Nye County",3,57,876,446,430
050,32,023,"Nevada","Nye County",3,58,888,444,444
050,32,023,"Nevada","Nye County",3,59,922,453,469
050,32,023,"Nevada","Nye County",3,60,899,432,467
050,32,023,"Nevada","Nye County",3,61,919,463,456
050,32,023,"Nevada","Nye County",3,62,942,488,454
050,32,023,"Nevada","Nye County",3,63,1017,506,511
050,32,023,"Nevada","Nye County",3,64,1059,529,530
050,32,023,"Nevada","Nye County",3,65,1102,539,563
050,32,023,"Nevada","Nye County",3,66,1060,507,553
050,32,023,"Nevada","Nye County",3,67,1039,522,517
050,32,023,"Nevada","Nye County",3,68,1008,500,508
050,32,023,"Nevada","Nye County",3,69,1013,506,507
050,32,023,"Nevada","Nye County",3,70,995,492,503
050,32,023,"Nevada","Nye County",3,71,943,472,471
050,32,023,"Nevada","Nye County",3,72,902,457,445
050,32,023,"Nevada","Nye County",3,73,934,459,475
050,32,023,"Nevada","Nye County",3,74,1035,543,492
050,32,023,"Nevada","Nye County",3,75,700,359,341
050,32,023,"Nevada","Nye County",3,76,653,324,329
050,32,023,"Nevada","Nye County",3,77,679,356,323
050,32,023,"Nevada","Nye County",3,78,719,368,351
050,32,023,"Nevada","Nye County",3,79,578,310,268
050,32,023,"Nevada","Nye County",3,80,474,256,218
050,32,023,"Nevada","Nye County",3,81,394,218,176
050,32,023,"Nevada","Nye County",3,82,391,212,179
050,32,023,"Nevada","Nye County",3,83,345,182,163
050,32,023,"Nevada","Nye County",3,84,288,157,131
050,32,023,"Nevada","Nye County",3,85,1254,612,642
050,32,023,"Nevada","Nye County",4,0,367,177,190
050,32,023,"Nevada","Nye County",4,1,409,202,207
050,32,023,"Nevada","Nye County",4,2,486,264,222
050,32,023,"Nevada","Nye County",4,3,471,244,227
050,32,023,"Nevada","Nye County",4,4,483,264,219
050,32,023,"Nevada","Nye County",4,5,483,265,218
050,32,023,"Nevada","Nye County",4,6,556,289,267
050,32,023,"Nevada","Nye County",4,7,512,255,257
050,32,023,"Nevada","Nye County",4,8,538,298,240
050,32,023,"Nevada","Nye County",4,9,492,259,233
050,32,023,"Nevada","Nye County",4,10,511,254,257
050,32,023,"Nevada","Nye County",4,11,533,267,266
050,32,023,"Nevada","Nye County",4,12,512,248,264
050,32,023,"Nevada","Nye County",4,13,536,272,264
050,32,023,"Nevada","Nye County",4,14,543,274,269
050,32,023,"Nevada","Nye County",4,15,564,285,279
050,32,023,"Nevada","Nye County",4,16,590,316,274
050,32,023,"Nevada","Nye County",4,17,574,294,280
050,32,023,"Nevada","Nye County",4,18,493,256,237
050,32,023,"Nevada","Nye County",4,19,379,203,176
050,32,023,"Nevada","Nye County",4,20,406,223,183
050,32,023,"Nevada","Nye County",4,21,429,241,188
050,32,023,"Nevada","Nye County",4,22,531,328,203
050,32,023,"Nevada","Nye County",4,23,490,282,208
050,32,023,"Nevada","Nye County",4,24,489,281,208
050,32,023,"Nevada","Nye County",4,25,485,256,229
050,32,023,"Nevada","Nye County",4,26,539,318,221
050,32,023,"Nevada","Nye County",4,27,497,266,231
050,32,023,"Nevada","Nye County",4,28,536,301,235
050,32,023,"Nevada","Nye County",4,29,558,287,271
050,32,023,"Nevada","Nye County",4,30,588,322,266
050,32,023,"Nevada","Nye County",4,31,592,343,249
050,32,023,"Nevada","Nye County",4,32,561,289,272
050,32,023,"Nevada","Nye County",4,33,529,283,246
050,32,023,"Nevada","Nye County",4,34,530,277,253
050,32,023,"Nevada","Nye County",4,35,513,266,247
050,32,023,"Nevada","Nye County",4,36,494,254,240
050,32,023,"Nevada","Nye County",4,37,543,271,272
050,32,023,"Nevada","Nye County",4,38,477,247,230
050,32,023,"Nevada","Nye County",4,39,555,273,282
050,32,023,"Nevada","Nye County",4,40,536,261,275
050,32,023,"Nevada","Nye County",4,41,560,271,289
050,32,023,"Nevada","Nye County",4,42,517,275,242
050,32,023,"Nevada","Nye County",4,43,556,304,252
050,32,023,"Nevada","Nye County",4,44,552,305,247
050,32,023,"Nevada","Nye County",4,45,491,259,232
050,32,023,"Nevada","Nye County",4,46,483,253,230
050,32,023,"Nevada","Nye County",4,47,515,250,265
050,32,023,"Nevada","Nye County",4,48,512,260,252
050,32,023,"Nevada","Nye County",4,49,494,252,242
050,32,023,"Nevada","Nye County",4,50,617,330,287
050,32,023,"Nevada","Nye County",4,51,652,324,328
050,32,023,"Nevada","Nye County",4,52,659,337,322
050,32,023,"Nevada","Nye County",4,53,654,311,343
050,32,023,"Nevada","Nye County",4,54,625,292,333
050,32,023,"Nevada","Nye County",4,55,669,345,324
050,32,023,"Nevada","Nye County",4,56,734,379,355
050,32,023,"Nevada","Nye County",4,57,839,412,427
050,32,023,"Nevada","Nye County",4,58,876,430,446
050,32,023,"Nevada","Nye County",4,59,911,468,443
050,32,023,"Nevada","Nye County",4,60,994,491,503
050,32,023,"Nevada","Nye County",4,61,961,454,507
050,32,023,"Nevada","Nye County",4,62,919,457,462
050,32,023,"Nevada","Nye County",4,63,970,499,471
050,32,023,"Nevada","Nye County",4,64,1035,522,513
050,32,023,"Nevada","Nye County",4,65,1086,541,545
050,32,023,"Nevada","Nye County",4,66,1129,564,565
050,32,023,"Nevada","Nye County",4,67,1080,508,572
050,32,023,"Nevada","Nye County",4,68,1050,511,539
050,32,023,"Nevada","Nye County",4,69,1033,511,522
050,32,023,"Nevada","Nye County",4,70,996,492,504
050,32,023,"Nevada","Nye County",4,71,1018,507,511
050,32,023,"Nevada","Nye County",4,72,948,470,478
050,32,023,"Nevada","Nye County",4,73,908,449,459
050,32,023,"Nevada","Nye County",4,74,906,446,460
050,32,023,"Nevada","Nye County",4,75,1019,531,488
050,32,023,"Nevada","Nye County",4,76,658,339,319
050,32,023,"Nevada","Nye County",4,77,621,303,318
050,32,023,"Nevada","Nye County",4,78,660,328,332
050,32,023,"Nevada","Nye County",4,79,663,351,312
050,32,023,"Nevada","Nye County",4,80,539,291,248
050,32,023,"Nevada","Nye County",4,81,438,236,202
050,32,023,"Nevada","Nye County",4,82,377,200,177
050,32,023,"Nevada","Nye County",4,83,327,180,147
050,32,023,"Nevada","Nye County",4,84,318,163,155
050,32,023,"Nevada","Nye County",4,85,1290,632,658
050,32,023,"Nevada","Nye County",5,0,366,178,188
050,32,023,"Nevada","Nye County",5,1,396,197,199
050,32,023,"Nevada","Nye County",5,2,433,216,217
050,32,023,"Nevada","Nye County",5,3,495,275,220
050,32,023,"Nevada","Nye County",5,4,499,267,232
050,32,023,"Nevada","Nye County",5,5,520,283,237
050,32,023,"Nevada","Nye County",5,6,492,258,234
050,32,023,"Nevada","Nye County",5,7,568,293,275
050,32,023,"Nevada","Nye County",5,8,549,264,285
050,32,023,"Nevada","Nye County",5,9,527,304,223
050,32,023,"Nevada","Nye County",5,10,490,262,228
050,32,023,"Nevada","Nye County",5,11,529,251,278
050,32,023,"Nevada","Nye County",5,12,554,273,281
050,32,023,"Nevada","Nye County",5,13,550,263,287
050,32,023,"Nevada","Nye County",5,14,554,280,274
050,32,023,"Nevada","Nye County",5,15,551,285,266
050,32,023,"Nevada","Nye County",5,16,553,287,266
050,32,023,"Nevada","Nye County",5,17,588,314,274
050,32,023,"Nevada","Nye County",5,18,496,262,234
050,32,023,"Nevada","Nye County",5,19,425,226,199
050,32,023,"Nevada","Nye County",5,20,440,236,204
050,32,023,"Nevada","Nye County",5,21,425,232,193
050,32,023,"Nevada","Nye County",5,22,552,342,210
050,32,023,"Nevada","Nye County",5,23,539,318,221
050,32,023,"Nevada","Nye County",5,24,491,267,224
050,32,023,"Nevada","Nye County",5,25,489,283,206
050,32,023,"Nevada","Nye County",5,26,575,354,221
050,32,023,"Nevada","Nye County",5,27,490,252,238
050,32,023,"Nevada","Nye County",5,28,530,287,243
050,32,023,"Nevada","Nye County",5,29,540,290,250
050,32,023,"Nevada","Nye County",5,30,556,287,269
050,32,023,"Nevada","Nye County",5,31,651,373,278
050,32,023,"Nevada","Nye County",5,32,598,329,269
050,32,023,"Nevada","Nye County",5,33,596,300,296
050,32,023,"Nevada","Nye County",5,34,548,274,274
050,32,023,"Nevada","Nye County",5,35,572,307,265
050,32,023,"Nevada","Nye County",5,36,534,274,260
050,32,023,"Nevada","Nye County",5,37,542,268,274
050,32,023,"Nevada","Nye County",5,38,568,283,285
050,32,023,"Nevada","Nye County",5,39,534,275,259
050,32,023,"Nevada","Nye County",5,40,582,280,302
050,32,023,"Nevada","Nye County",5,41,583,297,286
050,32,023,"Nevada","Nye County",5,42,575,287,288
050,32,023,"Nevada","Nye County",5,43,569,313,256
050,32,023,"Nevada","Nye County",5,44,604,333,271
050,32,023,"Nevada","Nye County",5,45,519,280,239
050,32,023,"Nevada","Nye County",5,46,550,295,255
050,32,023,"Nevada","Nye County",5,47,477,239,238
050,32,023,"Nevada","Nye County",5,48,536,254,282
050,32,023,"Nevada","Nye County",5,49,531,269,262
050,32,023,"Nevada","Nye County",5,50,553,302,251
050,32,023,"Nevada","Nye County",5,51,646,342,304
050,32,023,"Nevada","Nye County",5,52,664,318,346
050,32,023,"Nevada","Nye County",5,53,694,370,324
050,32,023,"Nevada","Nye County",5,54,647,299,348
050,32,023,"Nevada","Nye County",5,55,639,322,317
050,32,023,"Nevada","Nye County",5,56,668,338,330
050,32,023,"Nevada","Nye County",5,57,769,391,378
050,32,023,"Nevada","Nye County",5,58,849,406,443
050,32,023,"Nevada","Nye County",5,59,890,446,444
050,32,023,"Nevada","Nye County",5,60,947,484,463
050,32,023,"Nevada","Nye County",5,61,1018,507,511
050,32,023,"Nevada","Nye County",5,62,973,452,521
050,32,023,"Nevada","Nye County",5,63,940,470,470
050,32,023,"Nevada","Nye County",5,64,1012,529,483
050,32,023,"Nevada","Nye County",5,65,1065,550,515
050,32,023,"Nevada","Nye County",5,66,1077,535,542
050,32,023,"Nevada","Nye County",5,67,1148,575,573
050,32,023,"Nevada","Nye County",5,68,1061,498,563
050,32,023,"Nevada","Nye County",5,69,1062,519,543
050,32,023,"Nevada","Nye County",5,70,1001,484,517
050,32,023,"Nevada","Nye County",5,71,981,488,493
050,32,023,"Nevada","Nye County",5,72,990,495,495
050,32,023,"Nevada","Nye County",5,73,935,466,469
050,32,023,"Nevada","Nye County",5,74,859,423,436
050,32,023,"Nevada","Nye County",5,75,876,423,453
050,32,023,"Nevada","Nye County",5,76,953,496,457
050,32,023,"Nevada","Nye County",5,77,626,323,303
050,32,023,"Nevada","Nye County",5,78,606,290,316
050,32,023,"Nevada","Nye County",5,79,612,305,307
050,32,023,"Nevada","Nye County",5,80,614,324,290
050,32,023,"Nevada","Nye County",5,81,499,270,229
050,32,023,"Nevada","Nye County",5,82,412,216,196
050,32,023,"Nevada","Nye County",5,83,319,168,151
050,32,023,"Nevada","Nye County",5,84,301,159,142
050,32,023,"Nevada","Nye County",5,85,1383,671,712
050,32,027,"Nevada","Pershing County",1,0,46,24,22
050,32,027,"Nevada","Pershing County",1,1,63,31,32
050,32,027,"Nevada","Pershing County",1,2,67,30,37
050,32,027,"Nevada","Pershing County",1,3,50,22,28
050,32,027,"Nevada","Pershing County",1,4,66,32,34
050,32,027,"Nevada","Pershing County",1,5,59,28,31
050,32,027,"Nevada","Pershing County",1,6,67,34,33
050,32,027,"Nevada","Pershing County",1,7,62,37,25
050,32,027,"Nevada","Pershing County",1,8,76,40,36
050,32,027,"Nevada","Pershing County",1,9,69,33,36
050,32,027,"Nevada","Pershing County",1,10,61,30,31
050,32,027,"Nevada","Pershing County",1,11,53,28,25
050,32,027,"Nevada","Pershing County",1,12,63,35,28
050,32,027,"Nevada","Pershing County",1,13,65,35,30
050,32,027,"Nevada","Pershing County",1,14,68,37,31
050,32,027,"Nevada","Pershing County",1,15,55,25,30
050,32,027,"Nevada","Pershing County",1,16,54,28,26
050,32,027,"Nevada","Pershing County",1,17,52,29,23
050,32,027,"Nevada","Pershing County",1,18,61,35,26
050,32,027,"Nevada","Pershing County",1,19,59,37,22
050,32,027,"Nevada","Pershing County",1,20,76,55,21
050,32,027,"Nevada","Pershing County",1,21,82,60,22
050,32,027,"Nevada","Pershing County",1,22,63,43,20
050,32,027,"Nevada","Pershing County",1,23,79,57,22
050,32,027,"Nevada","Pershing County",1,24,84,60,24
050,32,027,"Nevada","Pershing County",1,25,83,55,28
050,32,027,"Nevada","Pershing County",1,26,100,71,29
050,32,027,"Nevada","Pershing County",1,27,106,75,31
050,32,027,"Nevada","Pershing County",1,28,102,74,28
050,32,027,"Nevada","Pershing County",1,29,109,80,29
050,32,027,"Nevada","Pershing County",1,30,102,76,26
050,32,027,"Nevada","Pershing County",1,31,109,77,32
050,32,027,"Nevada","Pershing County",1,32,103,75,28
050,32,027,"Nevada","Pershing County",1,33,98,69,29
050,32,027,"Nevada","Pershing County",1,34,92,65,27
050,32,027,"Nevada","Pershing County",1,35,84,58,26
050,32,027,"Nevada","Pershing County",1,36,91,64,27
050,32,027,"Nevada","Pershing County",1,37,110,86,24
050,32,027,"Nevada","Pershing County",1,38,96,69,27
050,32,027,"Nevada","Pershing County",1,39,97,79,18
050,32,027,"Nevada","Pershing County",1,40,89,70,19
050,32,027,"Nevada","Pershing County",1,41,73,56,17
050,32,027,"Nevada","Pershing County",1,42,111,82,29
050,32,027,"Nevada","Pershing County",1,43,103,77,26
050,32,027,"Nevada","Pershing County",1,44,111,93,18
050,32,027,"Nevada","Pershing County",1,45,102,79,23
050,32,027,"Nevada","Pershing County",1,46,92,76,16
050,32,027,"Nevada","Pershing County",1,47,107,78,29
050,32,027,"Nevada","Pershing County",1,48,110,77,33
050,32,027,"Nevada","Pershing County",1,49,105,76,29
050,32,027,"Nevada","Pershing County",1,50,99,72,27
050,32,027,"Nevada","Pershing County",1,51,115,82,33
050,32,027,"Nevada","Pershing County",1,52,98,65,33
050,32,027,"Nevada","Pershing County",1,53,108,74,34
050,32,027,"Nevada","Pershing County",1,54,107,69,38
050,32,027,"Nevada","Pershing County",1,55,102,64,38
050,32,027,"Nevada","Pershing County",1,56,85,62,23
050,32,027,"Nevada","Pershing County",1,57,99,67,32
050,32,027,"Nevada","Pershing County",1,58,77,45,32
050,32,027,"Nevada","Pershing County",1,59,85,52,33
050,32,027,"Nevada","Pershing County",1,60,118,75,43
050,32,027,"Nevada","Pershing County",1,61,99,59,40
050,32,027,"Nevada","Pershing County",1,62,92,52,40
050,32,027,"Nevada","Pershing County",1,63,81,47,34
050,32,027,"Nevada","Pershing County",1,64,75,40,35
050,32,027,"Nevada","Pershing County",1,65,74,42,32
050,32,027,"Nevada","Pershing County",1,66,81,59,22
050,32,027,"Nevada","Pershing County",1,67,82,47,35
050,32,027,"Nevada","Pershing County",1,68,60,31,29
050,32,027,"Nevada","Pershing County",1,69,50,24,26
050,32,027,"Nevada","Pershing County",1,70,56,33,23
050,32,027,"Nevada","Pershing County",1,71,57,32,25
050,32,027,"Nevada","Pershing County",1,72,64,37,27
050,32,027,"Nevada","Pershing County",1,73,68,38,30
050,32,027,"Nevada","Pershing County",1,74,42,25,17
050,32,027,"Nevada","Pershing County",1,75,54,24,30
050,32,027,"Nevada","Pershing County",1,76,52,24,28
050,32,027,"Nevada","Pershing County",1,77,47,33,14
050,32,027,"Nevada","Pershing County",1,78,56,36,20
050,32,027,"Nevada","Pershing County",1,79,45,23,22
050,32,027,"Nevada","Pershing County",1,80,43,27,16
050,32,027,"Nevada","Pershing County",1,81,36,21,15
050,32,027,"Nevada","Pershing County",1,82,28,14,14
050,32,027,"Nevada","Pershing County",1,83,19,10,9
050,32,027,"Nevada","Pershing County",1,84,23,11,12
050,32,027,"Nevada","Pershing County",1,85,84,31,53
050,32,027,"Nevada","Pershing County",2,0,52,27,25
050,32,027,"Nevada","Pershing County",2,1,61,31,30
050,32,027,"Nevada","Pershing County",2,2,66,31,35
050,32,027,"Nevada","Pershing County",2,3,55,25,30
050,32,027,"Nevada","Pershing County",2,4,64,31,33
050,32,027,"Nevada","Pershing County",2,5,62,29,33
050,32,027,"Nevada","Pershing County",2,6,64,32,32
050,32,027,"Nevada","Pershing County",2,7,66,38,28
050,32,027,"Nevada","Pershing County",2,8,72,39,33
050,32,027,"Nevada","Pershing County",2,9,72,36,36
050,32,027,"Nevada","Pershing County",2,10,61,30,31
050,32,027,"Nevada","Pershing County",2,11,53,28,25
050,32,027,"Nevada","Pershing County",2,12,60,34,26
050,32,027,"Nevada","Pershing County",2,13,64,36,28
050,32,027,"Nevada","Pershing County",2,14,67,36,31
050,32,027,"Nevada","Pershing County",2,15,57,27,30
050,32,027,"Nevada","Pershing County",2,16,53,27,26
050,32,027,"Nevada","Pershing County",2,17,52,29,23
050,32,027,"Nevada","Pershing County",2,18,57,33,24
050,32,027,"Nevada","Pershing County",2,19,57,36,21
050,32,027,"Nevada","Pershing County",2,20,78,55,23
050,32,027,"Nevada","Pershing County",2,21,81,60,21
050,32,027,"Nevada","Pershing County",2,22,64,44,20
050,32,027,"Nevada","Pershing County",2,23,77,57,20
050,32,027,"Nevada","Pershing County",2,24,83,59,24
050,32,027,"Nevada","Pershing County",2,25,82,55,27
050,32,027,"Nevada","Pershing County",2,26,100,70,30
050,32,027,"Nevada","Pershing County",2,27,106,75,31
050,32,027,"Nevada","Pershing County",2,28,100,71,29
050,32,027,"Nevada","Pershing County",2,29,110,81,29
050,32,027,"Nevada","Pershing County",2,30,106,78,28
050,32,027,"Nevada","Pershing County",2,31,105,75,30
050,32,027,"Nevada","Pershing County",2,32,101,73,28
050,32,027,"Nevada","Pershing County",2,33,98,69,29
050,32,027,"Nevada","Pershing County",2,34,90,62,28
050,32,027,"Nevada","Pershing County",2,35,85,59,26
050,32,027,"Nevada","Pershing County",2,36,90,65,25
050,32,027,"Nevada","Pershing County",2,37,106,82,24
050,32,027,"Nevada","Pershing County",2,38,96,69,27
050,32,027,"Nevada","Pershing County",2,39,99,81,18
050,32,027,"Nevada","Pershing County",2,40,88,68,20
050,32,027,"Nevada","Pershing County",2,41,72,54,18
050,32,027,"Nevada","Pershing County",2,42,106,80,26
050,32,027,"Nevada","Pershing County",2,43,104,77,27
050,32,027,"Nevada","Pershing County",2,44,110,91,19
050,32,027,"Nevada","Pershing County",2,45,102,80,22
050,32,027,"Nevada","Pershing County",2,46,89,72,17
050,32,027,"Nevada","Pershing County",2,47,102,76,26
050,32,027,"Nevada","Pershing County",2,48,109,77,32
050,32,027,"Nevada","Pershing County",2,49,104,74,30
050,32,027,"Nevada","Pershing County",2,50,98,70,28
050,32,027,"Nevada","Pershing County",2,51,110,79,31
050,32,027,"Nevada","Pershing County",2,52,99,67,32
050,32,027,"Nevada","Pershing County",2,53,104,70,34
050,32,027,"Nevada","Pershing County",2,54,106,68,38
050,32,027,"Nevada","Pershing County",2,55,102,64,38
050,32,027,"Nevada","Pershing County",2,56,88,62,26
050,32,027,"Nevada","Pershing County",2,57,95,65,30
050,32,027,"Nevada","Pershing County",2,58,80,49,31
050,32,027,"Nevada","Pershing County",2,59,81,48,33
050,32,027,"Nevada","Pershing County",2,60,111,71,40
050,32,027,"Nevada","Pershing County",2,61,101,60,41
050,32,027,"Nevada","Pershing County",2,62,92,52,40
050,32,027,"Nevada","Pershing County",2,63,82,47,35
050,32,027,"Nevada","Pershing County",2,64,77,42,35
050,32,027,"Nevada","Pershing County",2,65,73,41,32
050,32,027,"Nevada","Pershing County",2,66,80,55,25
050,32,027,"Nevada","Pershing County",2,67,82,50,32
050,32,027,"Nevada","Pershing County",2,68,65,34,31
050,32,027,"Nevada","Pershing County",2,69,53,27,26
050,32,027,"Nevada","Pershing County",2,70,56,32,24
050,32,027,"Nevada","Pershing County",2,71,56,32,24
050,32,027,"Nevada","Pershing County",2,72,62,36,26
050,32,027,"Nevada","Pershing County",2,73,70,39,31
050,32,027,"Nevada","Pershing County",2,74,45,26,19
050,32,027,"Nevada","Pershing County",2,75,54,25,29
050,32,027,"Nevada","Pershing County",2,76,52,24,28
050,32,027,"Nevada","Pershing County",2,77,50,32,18
050,32,027,"Nevada","Pershing County",2,78,52,34,18
050,32,027,"Nevada","Pershing County",2,79,47,25,22
050,32,027,"Nevada","Pershing County",2,80,42,25,17
050,32,027,"Nevada","Pershing County",2,81,37,21,16
050,32,027,"Nevada","Pershing County",2,82,29,16,13
050,32,027,"Nevada","Pershing County",2,83,20,10,10
050,32,027,"Nevada","Pershing County",2,84,22,10,12
050,32,027,"Nevada","Pershing County",2,85,86,33,53
050,32,027,"Nevada","Pershing County",3,0,57,25,32
050,32,027,"Nevada","Pershing County",3,1,52,25,27
050,32,027,"Nevada","Pershing County",3,2,61,33,28
050,32,027,"Nevada","Pershing County",3,3,65,31,34
050,32,027,"Nevada","Pershing County",3,4,58,24,34
050,32,027,"Nevada","Pershing County",3,5,65,32,33
050,32,027,"Nevada","Pershing County",3,6,59,27,32
050,32,027,"Nevada","Pershing County",3,7,66,34,32
050,32,027,"Nevada","Pershing County",3,8,62,37,25
050,32,027,"Nevada","Pershing County",3,9,67,34,33
050,32,027,"Nevada","Pershing County",3,10,71,36,35
050,32,027,"Nevada","Pershing County",3,11,65,30,35
050,32,027,"Nevada","Pershing County",3,12,54,28,26
050,32,027,"Nevada","Pershing County",3,13,65,38,27
050,32,027,"Nevada","Pershing County",3,14,62,36,26
050,32,027,"Nevada","Pershing County",3,15,64,35,29
050,32,027,"Nevada","Pershing County",3,16,56,27,29
050,32,027,"Nevada","Pershing County",3,17,55,30,25
050,32,027,"Nevada","Pershing County",3,18,53,29,24
050,32,027,"Nevada","Pershing County",3,19,45,27,18
050,32,027,"Nevada","Pershing County",3,20,62,41,21
050,32,027,"Nevada","Pershing County",3,21,82,58,24
050,32,027,"Nevada","Pershing County",3,22,66,48,18
050,32,027,"Nevada","Pershing County",3,23,76,54,22
050,32,027,"Nevada","Pershing County",3,24,76,52,24
050,32,027,"Nevada","Pershing County",3,25,73,50,23
050,32,027,"Nevada","Pershing County",3,26,93,64,29
050,32,027,"Nevada","Pershing County",3,27,104,73,31
050,32,027,"Nevada","Pershing County",3,28,90,59,31
050,32,027,"Nevada","Pershing County",3,29,102,75,27
050,32,027,"Nevada","Pershing County",3,30,105,76,29
050,32,027,"Nevada","Pershing County",3,31,94,67,27
050,32,027,"Nevada","Pershing County",3,32,99,66,33
050,32,027,"Nevada","Pershing County",3,33,97,66,31
050,32,027,"Nevada","Pershing County",3,34,94,62,32
050,32,027,"Nevada","Pershing County",3,35,89,60,29
050,32,027,"Nevada","Pershing County",3,36,88,65,23
050,32,027,"Nevada","Pershing County",3,37,104,76,28
050,32,027,"Nevada","Pershing County",3,38,90,65,25
050,32,027,"Nevada","Pershing County",3,39,106,82,24
050,32,027,"Nevada","Pershing County",3,40,76,57,19
050,32,027,"Nevada","Pershing County",3,41,78,55,23
050,32,027,"Nevada","Pershing County",3,42,98,78,20
050,32,027,"Nevada","Pershing County",3,43,95,68,27
050,32,027,"Nevada","Pershing County",3,44,104,78,26
050,32,027,"Nevada","Pershing County",3,45,96,76,20
050,32,027,"Nevada","Pershing County",3,46,76,54,22
050,32,027,"Nevada","Pershing County",3,47,84,64,20
050,32,027,"Nevada","Pershing County",3,48,103,75,28
050,32,027,"Nevada","Pershing County",3,49,98,67,31
050,32,027,"Nevada","Pershing County",3,50,98,68,30
050,32,027,"Nevada","Pershing County",3,51,99,68,31
050,32,027,"Nevada","Pershing County",3,52,101,69,32
050,32,027,"Nevada","Pershing County",3,53,97,62,35
050,32,027,"Nevada","Pershing County",3,54,95,59,36
050,32,027,"Nevada","Pershing County",3,55,101,65,36
050,32,027,"Nevada","Pershing County",3,56,90,53,37
050,32,027,"Nevada","Pershing County",3,57,89,61,28
050,32,027,"Nevada","Pershing County",3,58,89,57,32
050,32,027,"Nevada","Pershing County",3,59,81,50,31
050,32,027,"Nevada","Pershing County",3,60,86,55,31
050,32,027,"Nevada","Pershing County",3,61,100,60,40
050,32,027,"Nevada","Pershing County",3,62,96,53,43
050,32,027,"Nevada","Pershing County",3,63,81,43,38
050,32,027,"Nevada","Pershing County",3,64,78,47,31
050,32,027,"Nevada","Pershing County",3,65,74,40,34
050,32,027,"Nevada","Pershing County",3,66,76,41,35
050,32,027,"Nevada","Pershing County",3,67,77,51,26
050,32,027,"Nevada","Pershing County",3,68,79,47,32
050,32,027,"Nevada","Pershing County",3,69,62,34,28
050,32,027,"Nevada","Pershing County",3,70,51,25,26
050,32,027,"Nevada","Pershing County",3,71,53,27,26
050,32,027,"Nevada","Pershing County",3,72,53,31,22
050,32,027,"Nevada","Pershing County",3,73,53,28,25
050,32,027,"Nevada","Pershing County",3,74,63,36,27
050,32,027,"Nevada","Pershing County",3,75,46,25,21
050,32,027,"Nevada","Pershing County",3,76,54,25,29
050,32,027,"Nevada","Pershing County",3,77,49,23,26
050,32,027,"Nevada","Pershing County",3,78,45,27,18
050,32,027,"Nevada","Pershing County",3,79,49,32,17
050,32,027,"Nevada","Pershing County",3,80,44,24,20
050,32,027,"Nevada","Pershing County",3,81,40,24,16
050,32,027,"Nevada","Pershing County",3,82,36,21,15
050,32,027,"Nevada","Pershing County",3,83,27,16,11
050,32,027,"Nevada","Pershing County",3,84,19,9,10
050,32,027,"Nevada","Pershing County",3,85,96,38,58
050,32,027,"Nevada","Pershing County",4,0,50,17,33
050,32,027,"Nevada","Pershing County",4,1,56,22,34
050,32,027,"Nevada","Pershing County",4,2,51,27,24
050,32,027,"Nevada","Pershing County",4,3,64,34,30
050,32,027,"Nevada","Pershing County",4,4,64,31,33
050,32,027,"Nevada","Pershing County",4,5,57,24,33
050,32,027,"Nevada","Pershing County",4,6,65,30,35
050,32,027,"Nevada","Pershing County",4,7,58,25,33
050,32,027,"Nevada","Pershing County",4,8,64,34,30
050,32,027,"Nevada","Pershing County",4,9,58,34,24
050,32,027,"Nevada","Pershing County",4,10,74,40,34
050,32,027,"Nevada","Pershing County",4,11,79,37,42
050,32,027,"Nevada","Pershing County",4,12,69,32,37
050,32,027,"Nevada","Pershing County",4,13,55,28,27
050,32,027,"Nevada","Pershing County",4,14,66,39,27
050,32,027,"Nevada","Pershing County",4,15,60,35,25
050,32,027,"Nevada","Pershing County",4,16,68,37,31
050,32,027,"Nevada","Pershing County",4,17,56,29,27
050,32,027,"Nevada","Pershing County",4,18,56,34,22
050,32,027,"Nevada","Pershing County",4,19,40,23,17
050,32,027,"Nevada","Pershing County",4,20,52,37,15
050,32,027,"Nevada","Pershing County",4,21,65,45,20
050,32,027,"Nevada","Pershing County",4,22,67,43,24
050,32,027,"Nevada","Pershing County",4,23,89,66,23
050,32,027,"Nevada","Pershing County",4,24,73,52,21
050,32,027,"Nevada","Pershing County",4,25,67,47,20
050,32,027,"Nevada","Pershing County",4,26,91,65,26
050,32,027,"Nevada","Pershing County",4,27,88,61,27
050,32,027,"Nevada","Pershing County",4,28,92,62,30
050,32,027,"Nevada","Pershing County",4,29,97,67,30
050,32,027,"Nevada","Pershing County",4,30,102,77,25
050,32,027,"Nevada","Pershing County",4,31,107,80,27
050,32,027,"Nevada","Pershing County",4,32,103,71,32
050,32,027,"Nevada","Pershing County",4,33,103,65,38
050,32,027,"Nevada","Pershing County",4,34,96,69,27
050,32,027,"Nevada","Pershing County",4,35,91,60,31
050,32,027,"Nevada","Pershing County",4,36,105,74,31
050,32,027,"Nevada","Pershing County",4,37,96,73,23
050,32,027,"Nevada","Pershing County",4,38,94,63,31
050,32,027,"Nevada","Pershing County",4,39,104,82,22
050,32,027,"Nevada","Pershing County",4,40,102,77,25
050,32,027,"Nevada","Pershing County",4,41,64,47,17
050,32,027,"Nevada","Pershing County",4,42,103,78,25
050,32,027,"Nevada","Pershing County",4,43,94,73,21
050,32,027,"Nevada","Pershing County",4,44,107,81,26
050,32,027,"Nevada","Pershing County",4,45,101,73,28
050,32,027,"Nevada","Pershing County",4,46,85,64,21
050,32,027,"Nevada","Pershing County",4,47,78,56,22
050,32,027,"Nevada","Pershing County",4,48,89,69,20
050,32,027,"Nevada","Pershing County",4,49,94,68,26
050,32,027,"Nevada","Pershing County",4,50,89,60,29
050,32,027,"Nevada","Pershing County",4,51,101,69,32
050,32,027,"Nevada","Pershing County",4,52,95,63,32
050,32,027,"Nevada","Pershing County",4,53,95,61,34
050,32,027,"Nevada","Pershing County",4,54,97,62,35
050,32,027,"Nevada","Pershing County",4,55,93,57,36
050,32,027,"Nevada","Pershing County",4,56,90,56,34
050,32,027,"Nevada","Pershing County",4,57,93,59,34
050,32,027,"Nevada","Pershing County",4,58,92,62,30
050,32,027,"Nevada","Pershing County",4,59,87,54,33
050,32,027,"Nevada","Pershing County",4,60,88,58,30
050,32,027,"Nevada","Pershing County",4,61,71,41,30
050,32,027,"Nevada","Pershing County",4,62,99,58,41
050,32,027,"Nevada","Pershing County",4,63,96,50,46
050,32,027,"Nevada","Pershing County",4,64,80,47,33
050,32,027,"Nevada","Pershing County",4,65,73,42,31
050,32,027,"Nevada","Pershing County",4,66,77,43,34
050,32,027,"Nevada","Pershing County",4,67,68,35,33
050,32,027,"Nevada","Pershing County",4,68,76,50,26
050,32,027,"Nevada","Pershing County",4,69,79,50,29
050,32,027,"Nevada","Pershing County",4,70,61,35,26
050,32,027,"Nevada","Pershing County",4,71,47,21,26
050,32,027,"Nevada","Pershing County",4,72,51,24,27
050,32,027,"Nevada","Pershing County",4,73,53,31,22
050,32,027,"Nevada","Pershing County",4,74,51,27,24
050,32,027,"Nevada","Pershing County",4,75,62,38,24
050,32,027,"Nevada","Pershing County",4,76,43,23,20
050,32,027,"Nevada","Pershing County",4,77,51,25,26
050,32,027,"Nevada","Pershing County",4,78,44,20,24
050,32,027,"Nevada","Pershing County",4,79,48,27,21
050,32,027,"Nevada","Pershing County",4,80,48,30,18
050,32,027,"Nevada","Pershing County",4,81,41,21,20
050,32,027,"Nevada","Pershing County",4,82,40,23,17
050,32,027,"Nevada","Pershing County",4,83,33,20,13
050,32,027,"Nevada","Pershing County",4,84,26,15,11
050,32,027,"Nevada","Pershing County",4,85,103,42,61
050,32,027,"Nevada","Pershing County",5,0,50,17,33
050,32,027,"Nevada","Pershing County",5,1,50,19,31
050,32,027,"Nevada","Pershing County",5,2,46,19,27
050,32,027,"Nevada","Pershing County",5,3,47,25,22
050,32,027,"Nevada","Pershing County",5,4,53,33,20
050,32,027,"Nevada","Pershing County",5,5,62,31,31
050,32,027,"Nevada","Pershing County",5,6,57,25,32
050,32,027,"Nevada","Pershing County",5,7,62,30,32
050,32,027,"Nevada","Pershing County",5,8,65,31,34
050,32,027,"Nevada","Pershing County",5,9,65,36,29
050,32,027,"Nevada","Pershing County",5,10,55,33,22
050,32,027,"Nevada","Pershing County",5,11,73,40,33
050,32,027,"Nevada","Pershing County",5,12,73,34,39
050,32,027,"Nevada","Pershing County",5,13,68,31,37
050,32,027,"Nevada","Pershing County",5,14,58,31,27
050,32,027,"Nevada","Pershing County",5,15,67,36,31
050,32,027,"Nevada","Pershing County",5,16,65,37,28
050,32,027,"Nevada","Pershing County",5,17,69,38,31
050,32,027,"Nevada","Pershing County",5,18,58,31,27
050,32,027,"Nevada","Pershing County",5,19,44,29,15
050,32,027,"Nevada","Pershing County",5,20,48,32,16
050,32,027,"Nevada","Pershing County",5,21,60,46,14
050,32,027,"Nevada","Pershing County",5,22,52,34,18
050,32,027,"Nevada","Pershing County",5,23,86,60,26
050,32,027,"Nevada","Pershing County",5,24,79,60,19
050,32,027,"Nevada","Pershing County",5,25,73,47,26
050,32,027,"Nevada","Pershing County",5,26,82,64,18
050,32,027,"Nevada","Pershing County",5,27,91,70,21
050,32,027,"Nevada","Pershing County",5,28,79,54,25
050,32,027,"Nevada","Pershing County",5,29,94,68,26
050,32,027,"Nevada","Pershing County",5,30,98,71,27
050,32,027,"Nevada","Pershing County",5,31,100,75,25
050,32,027,"Nevada","Pershing County",5,32,100,74,26
050,32,027,"Nevada","Pershing County",5,33,102,68,34
050,32,027,"Nevada","Pershing County",5,34,90,55,35
050,32,027,"Nevada","Pershing County",5,35,91,66,25
050,32,027,"Nevada","Pershing County",5,36,99,66,33
050,32,027,"Nevada","Pershing County",5,37,115,85,30
050,32,027,"Nevada","Pershing County",5,38,83,58,25
050,32,027,"Nevada","Pershing County",5,39,106,79,27
050,32,027,"Nevada","Pershing County",5,40,93,69,24
050,32,027,"Nevada","Pershing County",5,41,91,66,25
050,32,027,"Nevada","Pershing County",5,42,86,70,16
050,32,027,"Nevada","Pershing County",5,43,98,72,26
050,32,027,"Nevada","Pershing County",5,44,102,83,19
050,32,027,"Nevada","Pershing County",5,45,102,75,27
050,32,027,"Nevada","Pershing County",5,46,84,55,29
050,32,027,"Nevada","Pershing County",5,47,84,66,18
050,32,027,"Nevada","Pershing County",5,48,80,57,23
050,32,027,"Nevada","Pershing County",5,49,77,60,17
050,32,027,"Nevada","Pershing County",5,50,83,61,22
050,32,027,"Nevada","Pershing County",5,51,93,63,30
050,32,027,"Nevada","Pershing County",5,52,100,67,33
050,32,027,"Nevada","Pershing County",5,53,92,62,30
050,32,027,"Nevada","Pershing County",5,54,93,55,38
050,32,027,"Nevada","Pershing County",5,55,96,59,37
050,32,027,"Nevada","Pershing County",5,56,85,50,35
050,32,027,"Nevada","Pershing County",5,57,88,55,33
050,32,027,"Nevada","Pershing County",5,58,86,52,34
050,32,027,"Nevada","Pershing County",5,59,91,63,28
050,32,027,"Nevada","Pershing County",5,60,89,57,32
050,32,027,"Nevada","Pershing County",5,61,78,49,29
050,32,027,"Nevada","Pershing County",5,62,72,39,33
050,32,027,"Nevada","Pershing County",5,63,98,52,46
050,32,027,"Nevada","Pershing County",5,64,98,51,47
050,32,027,"Nevada","Pershing County",5,65,75,40,35
050,32,027,"Nevada","Pershing County",5,66,71,42,29
050,32,027,"Nevada","Pershing County",5,67,74,42,32
050,32,027,"Nevada","Pershing County",5,68,67,35,32
050,32,027,"Nevada","Pershing County",5,69,76,49,27
050,32,027,"Nevada","Pershing County",5,70,80,51,29
050,32,027,"Nevada","Pershing County",5,71,61,34,27
050,32,027,"Nevada","Pershing County",5,72,42,18,24
050,32,027,"Nevada","Pershing County",5,73,53,24,29
050,32,027,"Nevada","Pershing County",5,74,53,30,23
050,32,027,"Nevada","Pershing County",5,75,49,27,22
050,32,027,"Nevada","Pershing County",5,76,59,36,23
050,32,027,"Nevada","Pershing County",5,77,39,21,18
050,32,027,"Nevada","Pershing County",5,78,48,24,24
050,32,027,"Nevada","Pershing County",5,79,44,20,24
050,32,027,"Nevada","Pershing County",5,80,48,27,21
050,32,027,"Nevada","Pershing County",5,81,45,30,15
050,32,027,"Nevada","Pershing County",5,82,42,22,20
050,32,027,"Nevada","Pershing County",5,83,37,22,15
050,32,027,"Nevada","Pershing County",5,84,32,19,13
050,32,027,"Nevada","Pershing County",5,85,115,49,66
050,32,029,"Nevada","Storey County",1,0,20,10,10
050,32,029,"Nevada","Storey County",1,1,21,13,8
050,32,029,"Nevada","Storey County",1,2,14,9,5
050,32,029,"Nevada","Storey County",1,3,24,12,12
050,32,029,"Nevada","Storey County",1,4,21,10,11
050,32,029,"Nevada","Storey County",1,5,21,14,7
050,32,029,"Nevada","Storey County",1,6,24,11,13
050,32,029,"Nevada","Storey County",1,7,26,11,15
050,32,029,"Nevada","Storey County",1,8,22,12,10
050,32,029,"Nevada","Storey County",1,9,24,14,10
050,32,029,"Nevada","Storey County",1,10,26,14,12
050,32,029,"Nevada","Storey County",1,11,37,19,18
050,32,029,"Nevada","Storey County",1,12,35,15,20
050,32,029,"Nevada","Storey County",1,13,44,20,24
050,32,029,"Nevada","Storey County",1,14,37,21,16
050,32,029,"Nevada","Storey County",1,15,42,22,20
050,32,029,"Nevada","Storey County",1,16,37,12,25
050,32,029,"Nevada","Storey County",1,17,35,13,22
050,32,029,"Nevada","Storey County",1,18,24,14,10
050,32,029,"Nevada","Storey County",1,19,26,11,15
050,32,029,"Nevada","Storey County",1,20,28,12,16
050,32,029,"Nevada","Storey County",1,21,26,16,10
050,32,029,"Nevada","Storey County",1,22,31,17,14
050,32,029,"Nevada","Storey County",1,23,26,14,12
050,32,029,"Nevada","Storey County",1,24,35,21,14
050,32,029,"Nevada","Storey County",1,25,37,18,19
050,32,029,"Nevada","Storey County",1,26,38,18,20
050,32,029,"Nevada","Storey County",1,27,40,21,19
050,32,029,"Nevada","Storey County",1,28,29,20,9
050,32,029,"Nevada","Storey County",1,29,35,20,15
050,32,029,"Nevada","Storey County",1,30,43,22,21
050,32,029,"Nevada","Storey County",1,31,29,18,11
050,32,029,"Nevada","Storey County",1,32,34,18,16
050,32,029,"Nevada","Storey County",1,33,40,26,14
050,32,029,"Nevada","Storey County",1,34,34,18,16
050,32,029,"Nevada","Storey County",1,35,31,12,19
050,32,029,"Nevada","Storey County",1,36,38,17,21
050,32,029,"Nevada","Storey County",1,37,38,24,14
050,32,029,"Nevada","Storey County",1,38,34,19,15
050,32,029,"Nevada","Storey County",1,39,35,18,17
050,32,029,"Nevada","Storey County",1,40,34,16,18
050,32,029,"Nevada","Storey County",1,41,38,19,19
050,32,029,"Nevada","Storey County",1,42,36,22,14
050,32,029,"Nevada","Storey County",1,43,52,27,25
050,32,029,"Nevada","Storey County",1,44,47,21,26
050,32,029,"Nevada","Storey County",1,45,45,22,23
050,32,029,"Nevada","Storey County",1,46,41,22,19
050,32,029,"Nevada","Storey County",1,47,40,18,22
050,32,029,"Nevada","Storey County",1,48,48,27,21
050,32,029,"Nevada","Storey County",1,49,56,34,22
050,32,029,"Nevada","Storey County",1,50,48,25,23
050,32,029,"Nevada","Storey County",1,51,56,25,31
050,32,029,"Nevada","Storey County",1,52,54,31,23
050,32,029,"Nevada","Storey County",1,53,51,18,33
050,32,029,"Nevada","Storey County",1,54,48,23,25
050,32,029,"Nevada","Storey County",1,55,60,29,31
050,32,029,"Nevada","Storey County",1,56,64,30,34
050,32,029,"Nevada","Storey County",1,57,77,42,35
050,32,029,"Nevada","Storey County",1,58,91,48,43
050,32,029,"Nevada","Storey County",1,59,83,42,41
050,32,029,"Nevada","Storey County",1,60,78,39,39
050,32,029,"Nevada","Storey County",1,61,95,51,44
050,32,029,"Nevada","Storey County",1,62,95,48,47
050,32,029,"Nevada","Storey County",1,63,98,50,48
050,32,029,"Nevada","Storey County",1,64,83,37,46
050,32,029,"Nevada","Storey County",1,65,80,43,37
050,32,029,"Nevada","Storey County",1,66,96,44,52
050,32,029,"Nevada","Storey County",1,67,84,36,48
050,32,029,"Nevada","Storey County",1,68,102,46,56
050,32,029,"Nevada","Storey County",1,69,88,51,37
050,32,029,"Nevada","Storey County",1,70,88,48,40
050,32,029,"Nevada","Storey County",1,71,85,44,41
050,32,029,"Nevada","Storey County",1,72,105,54,51
050,32,029,"Nevada","Storey County",1,73,93,51,42
050,32,029,"Nevada","Storey County",1,74,50,27,23
050,32,029,"Nevada","Storey County",1,75,62,36,26
050,32,029,"Nevada","Storey County",1,76,59,34,25
050,32,029,"Nevada","Storey County",1,77,57,34,23
050,32,029,"Nevada","Storey County",1,78,53,30,23
050,32,029,"Nevada","Storey County",1,79,34,18,16
050,32,029,"Nevada","Storey County",1,80,26,13,13
050,32,029,"Nevada","Storey County",1,81,31,16,15
050,32,029,"Nevada","Storey County",1,82,26,17,9
050,32,029,"Nevada","Storey County",1,83,14,9,5
050,32,029,"Nevada","Storey County",1,84,14,6,8
050,32,029,"Nevada","Storey County",1,85,94,36,58
050,32,029,"Nevada","Storey County",2,0,20,10,10
050,32,029,"Nevada","Storey County",2,1,20,11,9
050,32,029,"Nevada","Storey County",2,2,16,10,6
050,32,029,"Nevada","Storey County",2,3,22,11,11
050,32,029,"Nevada","Storey County",2,4,20,10,10
050,32,029,"Nevada","Storey County",2,5,22,14,8
050,32,029,"Nevada","Storey County",2,6,23,11,12
050,32,029,"Nevada","Storey County",2,7,25,11,14
050,32,029,"Nevada","Storey County",2,8,22,12,10
050,32,029,"Nevada","Storey County",2,9,23,13,10
050,32,029,"Nevada","Storey County",2,10,28,15,13
050,32,029,"Nevada","Storey County",2,11,35,19,16
050,32,029,"Nevada","Storey County",2,12,37,17,20
050,32,029,"Nevada","Storey County",2,13,43,19,24
050,32,029,"Nevada","Storey County",2,14,39,21,18
050,32,029,"Nevada","Storey County",2,15,43,23,20
050,32,029,"Nevada","Storey County",2,16,36,13,23
050,32,029,"Nevada","Storey County",2,17,35,13,22
050,32,029,"Nevada","Storey County",2,18,26,14,12
050,32,029,"Nevada","Storey County",2,19,24,11,13
050,32,029,"Nevada","Storey County",2,20,29,13,16
050,32,029,"Nevada","Storey County",2,21,28,15,13
050,32,029,"Nevada","Storey County",2,22,31,16,15
050,32,029,"Nevada","Storey County",2,23,29,16,13
050,32,029,"Nevada","Storey County",2,24,34,20,14
050,32,029,"Nevada","Storey County",2,25,37,18,19
050,32,029,"Nevada","Storey County",2,26,37,18,19
050,32,029,"Nevada","Storey County",2,27,39,21,18
050,32,029,"Nevada","Storey County",2,28,32,20,12
050,32,029,"Nevada","Storey County",2,29,35,21,14
050,32,029,"Nevada","Storey County",2,30,41,22,19
050,32,029,"Nevada","Storey County",2,31,32,18,14
050,32,029,"Nevada","Storey County",2,32,34,19,15
050,32,029,"Nevada","Storey County",2,33,37,22,15
050,32,029,"Nevada","Storey County",2,34,34,18,16
050,32,029,"Nevada","Storey County",2,35,33,13,20
050,32,029,"Nevada","Storey County",2,36,36,16,20
050,32,029,"Nevada","Storey County",2,37,39,23,16
050,32,029,"Nevada","Storey County",2,38,35,20,15
050,32,029,"Nevada","Storey County",2,39,34,18,16
050,32,029,"Nevada","Storey County",2,40,33,16,17
050,32,029,"Nevada","Storey County",2,41,36,18,18
050,32,029,"Nevada","Storey County",2,42,38,23,15
050,32,029,"Nevada","Storey County",2,43,48,26,22
050,32,029,"Nevada","Storey County",2,44,49,24,25
050,32,029,"Nevada","Storey County",2,45,46,22,24
050,32,029,"Nevada","Storey County",2,46,40,21,19
050,32,029,"Nevada","Storey County",2,47,41,20,21
050,32,029,"Nevada","Storey County",2,48,48,25,23
050,32,029,"Nevada","Storey County",2,49,54,32,22
050,32,029,"Nevada","Storey County",2,50,50,28,22
050,32,029,"Nevada","Storey County",2,51,57,27,30
050,32,029,"Nevada","Storey County",2,52,53,28,25
050,32,029,"Nevada","Storey County",2,53,52,21,31
050,32,029,"Nevada","Storey County",2,54,49,22,27
050,32,029,"Nevada","Storey County",2,55,58,28,30
050,32,029,"Nevada","Storey County",2,56,62,29,33
050,32,029,"Nevada","Storey County",2,57,75,40,35
050,32,029,"Nevada","Storey County",2,58,87,46,41
050,32,029,"Nevada","Storey County",2,59,85,44,41
050,32,029,"Nevada","Storey County",2,60,80,40,40
050,32,029,"Nevada","Storey County",2,61,92,48,44
050,32,029,"Nevada","Storey County",2,62,96,49,47
050,32,029,"Nevada","Storey County",2,63,97,50,47
050,32,029,"Nevada","Storey County",2,64,85,39,46
050,32,029,"Nevada","Storey County",2,65,80,41,39
050,32,029,"Nevada","Storey County",2,66,93,44,49
050,32,029,"Nevada","Storey County",2,67,85,37,48
050,32,029,"Nevada","Storey County",2,68,98,45,53
050,32,029,"Nevada","Storey County",2,69,92,51,41
050,32,029,"Nevada","Storey County",2,70,85,47,38
050,32,029,"Nevada","Storey County",2,71,86,46,40
050,32,029,"Nevada","Storey County",2,72,99,52,47
050,32,029,"Nevada","Storey County",2,73,103,55,48
050,32,029,"Nevada","Storey County",2,74,57,30,27
050,32,029,"Nevada","Storey County",2,75,60,34,26
050,32,029,"Nevada","Storey County",2,76,59,35,24
050,32,029,"Nevada","Storey County",2,77,59,34,25
050,32,029,"Nevada","Storey County",2,78,51,28,23
050,32,029,"Nevada","Storey County",2,79,37,20,17
050,32,029,"Nevada","Storey County",2,80,27,14,13
050,32,029,"Nevada","Storey County",2,81,29,15,14
050,32,029,"Nevada","Storey County",2,82,27,17,10
050,32,029,"Nevada","Storey County",2,83,17,11,6
050,32,029,"Nevada","Storey County",2,84,14,7,7
050,32,029,"Nevada","Storey County",2,85,94,36,58
050,32,029,"Nevada","Storey County",3,0,25,13,12
050,32,029,"Nevada","Storey County",3,1,19,14,5
050,32,029,"Nevada","Storey County",3,2,20,11,9
050,32,029,"Nevada","Storey County",3,3,20,14,6
050,32,029,"Nevada","Storey County",3,4,32,18,14
050,32,029,"Nevada","Storey County",3,5,20,10,10
050,32,029,"Nevada","Storey County",3,6,24,14,10
050,32,029,"Nevada","Storey County",3,7,32,15,17
050,32,029,"Nevada","Storey County",3,8,30,14,16
050,32,029,"Nevada","Storey County",3,9,28,15,13
050,32,029,"Nevada","Storey County",3,10,24,14,10
050,32,029,"Nevada","Storey County",3,11,30,14,16
050,32,029,"Nevada","Storey County",3,12,36,18,18
050,32,029,"Nevada","Storey County",3,13,35,14,21
050,32,029,"Nevada","Storey County",3,14,41,18,23
050,32,029,"Nevada","Storey County",3,15,38,23,15
050,32,029,"Nevada","Storey County",3,16,39,23,16
050,32,029,"Nevada","Storey County",3,17,34,13,21
050,32,029,"Nevada","Storey County",3,18,33,11,22
050,32,029,"Nevada","Storey County",3,19,23,13,10
050,32,029,"Nevada","Storey County",3,20,29,13,16
050,32,029,"Nevada","Storey County",3,21,25,11,14
050,32,029,"Nevada","Storey County",3,22,29,14,15
050,32,029,"Nevada","Storey County",3,23,29,15,14
050,32,029,"Nevada","Storey County",3,24,35,22,13
050,32,029,"Nevada","Storey County",3,25,39,21,18
050,32,029,"Nevada","Storey County",3,26,37,16,21
050,32,029,"Nevada","Storey County",3,27,42,19,23
050,32,029,"Nevada","Storey County",3,28,41,22,19
050,32,029,"Nevada","Storey County",3,29,35,23,12
050,32,029,"Nevada","Storey County",3,30,43,23,20
050,32,029,"Nevada","Storey County",3,31,40,21,19
050,32,029,"Nevada","Storey County",3,32,34,20,14
050,32,029,"Nevada","Storey County",3,33,33,18,15
050,32,029,"Nevada","Storey County",3,34,48,28,20
050,32,029,"Nevada","Storey County",3,35,35,19,16
050,32,029,"Nevada","Storey County",3,36,37,17,20
050,32,029,"Nevada","Storey County",3,37,39,19,20
050,32,029,"Nevada","Storey County",3,38,41,24,17
050,32,029,"Nevada","Storey County",3,39,37,19,18
050,32,029,"Nevada","Storey County",3,40,37,18,19
050,32,029,"Nevada","Storey County",3,41,31,17,14
050,32,029,"Nevada","Storey County",3,42,37,17,20
050,32,029,"Nevada","Storey County",3,43,42,26,16
050,32,029,"Nevada","Storey County",3,44,46,25,21
050,32,029,"Nevada","Storey County",3,45,49,25,24
050,32,029,"Nevada","Storey County",3,46,50,25,25
050,32,029,"Nevada","Storey County",3,47,39,21,18
050,32,029,"Nevada","Storey County",3,48,45,20,25
050,32,029,"Nevada","Storey County",3,49,49,24,25
050,32,029,"Nevada","Storey County",3,50,58,38,20
050,32,029,"Nevada","Storey County",3,51,54,29,25
050,32,029,"Nevada","Storey County",3,52,50,25,25
050,32,029,"Nevada","Storey County",3,53,50,26,24
050,32,029,"Nevada","Storey County",3,54,50,16,34
050,32,029,"Nevada","Storey County",3,55,45,20,25
050,32,029,"Nevada","Storey County",3,56,59,29,30
050,32,029,"Nevada","Storey County",3,57,60,28,32
050,32,029,"Nevada","Storey County",3,58,71,38,33
050,32,029,"Nevada","Storey County",3,59,93,51,42
050,32,029,"Nevada","Storey County",3,60,85,46,39
050,32,029,"Nevada","Storey County",3,61,75,37,38
050,32,029,"Nevada","Storey County",3,62,92,47,45
050,32,029,"Nevada","Storey County",3,63,92,48,44
050,32,029,"Nevada","Storey County",3,64,94,47,47
050,32,029,"Nevada","Storey County",3,65,84,35,49
050,32,029,"Nevada","Storey County",3,66,83,41,42
050,32,029,"Nevada","Storey County",3,67,89,40,49
050,32,029,"Nevada","Storey County",3,68,82,36,46
050,32,029,"Nevada","Storey County",3,69,94,42,52
050,32,029,"Nevada","Storey County",3,70,95,51,44
050,32,029,"Nevada","Storey County",3,71,82,47,35
050,32,029,"Nevada","Storey County",3,72,84,44,40
050,32,029,"Nevada","Storey County",3,73,94,50,44
050,32,029,"Nevada","Storey County",3,74,98,55,43
050,32,029,"Nevada","Storey County",3,75,54,29,25
050,32,029,"Nevada","Storey County",3,76,57,32,25
050,32,029,"Nevada","Storey County",3,77,55,31,24
050,32,029,"Nevada","Storey County",3,78,58,34,24
050,32,029,"Nevada","Storey County",3,79,46,25,21
050,32,029,"Nevada","Storey County",3,80,36,19,17
050,32,029,"Nevada","Storey County",3,81,22,13,9
050,32,029,"Nevada","Storey County",3,82,26,14,12
050,32,029,"Nevada","Storey County",3,83,27,18,9
050,32,029,"Nevada","Storey County",3,84,15,11,4
050,32,029,"Nevada","Storey County",3,85,97,38,59
050,32,029,"Nevada","Storey County",4,0,20,13,7
050,32,029,"Nevada","Storey County",4,1,24,10,14
050,32,029,"Nevada","Storey County",4,2,17,12,5
050,32,029,"Nevada","Storey County",4,3,17,7,10
050,32,029,"Nevada","Storey County",4,4,17,11,6
050,32,029,"Nevada","Storey County",4,5,30,17,13
050,32,029,"Nevada","Storey County",4,6,25,13,12
050,32,029,"Nevada","Storey County",4,7,26,17,9
050,32,029,"Nevada","Storey County",4,8,24,9,15
050,32,029,"Nevada","Storey County",4,9,25,12,13
050,32,029,"Nevada","Storey County",4,10,29,14,15
050,32,029,"Nevada","Storey County",4,11,32,21,11
050,32,029,"Nevada","Storey County",4,12,30,14,16
050,32,029,"Nevada","Storey County",4,13,35,17,18
050,32,029,"Nevada","Storey County",4,14,40,15,25
050,32,029,"Nevada","Storey County",4,15,43,20,23
050,32,029,"Nevada","Storey County",4,16,40,25,15
050,32,029,"Nevada","Storey County",4,17,44,27,17
050,32,029,"Nevada","Storey County",4,18,33,15,18
050,32,029,"Nevada","Storey County",4,19,29,11,18
050,32,029,"Nevada","Storey County",4,20,25,14,11
050,32,029,"Nevada","Storey County",4,21,29,15,14
050,32,029,"Nevada","Storey County",4,22,21,11,10
050,32,029,"Nevada","Storey County",4,23,35,17,18
050,32,029,"Nevada","Storey County",4,24,25,12,13
050,32,029,"Nevada","Storey County",4,25,39,23,16
050,32,029,"Nevada","Storey County",4,26,39,19,20
050,32,029,"Nevada","Storey County",4,27,33,16,17
050,32,029,"Nevada","Storey County",4,28,47,24,23
050,32,029,"Nevada","Storey County",4,29,39,21,18
050,32,029,"Nevada","Storey County",4,30,38,23,15
050,32,029,"Nevada","Storey County",4,31,42,26,16
050,32,029,"Nevada","Storey County",4,32,44,21,23
050,32,029,"Nevada","Storey County",4,33,38,26,12
050,32,029,"Nevada","Storey County",4,34,43,27,16
050,32,029,"Nevada","Storey County",4,35,55,31,24
050,32,029,"Nevada","Storey County",4,36,42,23,19
050,32,029,"Nevada","Storey County",4,37,35,16,19
050,32,029,"Nevada","Storey County",4,38,43,20,23
050,32,029,"Nevada","Storey County",4,39,45,26,19
050,32,029,"Nevada","Storey County",4,40,40,24,16
050,32,029,"Nevada","Storey County",4,41,33,19,14
050,32,029,"Nevada","Storey County",4,42,37,16,21
050,32,029,"Nevada","Storey County",4,43,39,16,23
050,32,029,"Nevada","Storey County",4,44,39,23,16
050,32,029,"Nevada","Storey County",4,45,47,25,22
050,32,029,"Nevada","Storey County",4,46,47,24,23
050,32,029,"Nevada","Storey County",4,47,56,27,29
050,32,029,"Nevada","Storey County",4,48,40,19,21
050,32,029,"Nevada","Storey County",4,49,43,21,22
050,32,029,"Nevada","Storey County",4,50,54,25,29
050,32,029,"Nevada","Storey County",4,51,59,36,23
050,32,029,"Nevada","Storey County",4,52,60,30,30
050,32,029,"Nevada","Storey County",4,53,46,22,24
050,32,029,"Nevada","Storey County",4,54,52,27,25
050,32,029,"Nevada","Storey County",4,55,53,20,33
050,32,029,"Nevada","Storey County",4,56,51,24,27
050,32,029,"Nevada","Storey County",4,57,62,34,28
050,32,029,"Nevada","Storey County",4,58,58,25,33
050,32,029,"Nevada","Storey County",4,59,69,37,32
050,32,029,"Nevada","Storey County",4,60,83,43,40
050,32,029,"Nevada","Storey County",4,61,82,46,36
050,32,029,"Nevada","Storey County",4,62,77,37,40
050,32,029,"Nevada","Storey County",4,63,90,44,46
050,32,029,"Nevada","Storey County",4,64,91,49,42
050,32,029,"Nevada","Storey County",4,65,95,49,46
050,32,029,"Nevada","Storey County",4,66,81,37,44
050,32,029,"Nevada","Storey County",4,67,80,42,38
050,32,029,"Nevada","Storey County",4,68,82,35,47
050,32,029,"Nevada","Storey County",4,69,81,36,45
050,32,029,"Nevada","Storey County",4,70,88,42,46
050,32,029,"Nevada","Storey County",4,71,98,51,47
050,32,029,"Nevada","Storey County",4,72,82,47,35
050,32,029,"Nevada","Storey County",4,73,83,44,39
050,32,029,"Nevada","Storey County",4,74,93,51,42
050,32,029,"Nevada","Storey County",4,75,87,48,39
050,32,029,"Nevada","Storey County",4,76,56,30,26
050,32,029,"Nevada","Storey County",4,77,54,29,25
050,32,029,"Nevada","Storey County",4,78,54,31,23
050,32,029,"Nevada","Storey County",4,79,52,28,24
050,32,029,"Nevada","Storey County",4,80,44,23,21
050,32,029,"Nevada","Storey County",4,81,34,17,17
050,32,029,"Nevada","Storey County",4,82,21,12,9
050,32,029,"Nevada","Storey County",4,83,22,10,12
050,32,029,"Nevada","Storey County",4,84,29,18,11
050,32,029,"Nevada","Storey County",4,85,104,46,58
050,32,029,"Nevada","Storey County",5,0,17,12,5
050,32,029,"Nevada","Storey County",5,1,21,14,7
050,32,029,"Nevada","Storey County",5,2,22,8,14
050,32,029,"Nevada","Storey County",5,3,18,12,6
050,32,029,"Nevada","Storey County",5,4,21,10,11
050,32,029,"Nevada","Storey County",5,5,21,12,9
050,32,029,"Nevada","Storey County",5,6,33,17,16
050,32,029,"Nevada","Storey County",5,7,29,15,14
050,32,029,"Nevada","Storey County",5,8,35,19,16
050,32,029,"Nevada","Storey County",5,9,22,10,12
050,32,029,"Nevada","Storey County",5,10,26,11,15
050,32,029,"Nevada","Storey County",5,11,32,18,14
050,32,029,"Nevada","Storey County",5,12,32,22,10
050,32,029,"Nevada","Storey County",5,13,27,14,13
050,32,029,"Nevada","Storey County",5,14,35,17,18
050,32,029,"Nevada","Storey County",5,15,39,13,26
050,32,029,"Nevada","Storey County",5,16,46,18,28
050,32,029,"Nevada","Storey County",5,17,39,26,13
050,32,029,"Nevada","Storey County",5,18,39,22,17
050,32,029,"Nevada","Storey County",5,19,25,9,16
050,32,029,"Nevada","Storey County",5,20,27,10,17
050,32,029,"Nevada","Storey County",5,21,25,13,12
050,32,029,"Nevada","Storey County",5,22,29,14,15
050,32,029,"Nevada","Storey County",5,23,28,14,14
050,32,029,"Nevada","Storey County",5,24,42,21,21
050,32,029,"Nevada","Storey County",5,25,31,17,14
050,32,029,"Nevada","Storey County",5,26,45,27,18
050,32,029,"Nevada","Storey County",5,27,40,23,17
050,32,029,"Nevada","Storey County",5,28,30,15,15
050,32,029,"Nevada","Storey County",5,29,44,23,21
050,32,029,"Nevada","Storey County",5,30,43,23,20
050,32,029,"Nevada","Storey County",5,31,36,20,16
050,32,029,"Nevada","Storey County",5,32,50,29,21
050,32,029,"Nevada","Storey County",5,33,46,21,25
050,32,029,"Nevada","Storey County",5,34,35,22,13
050,32,029,"Nevada","Storey County",5,35,47,27,20
050,32,029,"Nevada","Storey County",5,36,61,34,27
050,32,029,"Nevada","Storey County",5,37,44,23,21
050,32,029,"Nevada","Storey County",5,38,35,17,18
050,32,029,"Nevada","Storey County",5,39,47,21,26
050,32,029,"Nevada","Storey County",5,40,43,25,18
050,32,029,"Nevada","Storey County",5,41,41,27,14
050,32,029,"Nevada","Storey County",5,42,36,22,14
050,32,029,"Nevada","Storey County",5,43,40,19,21
050,32,029,"Nevada","Storey County",5,44,41,18,23
050,32,029,"Nevada","Storey County",5,45,38,19,19
050,32,029,"Nevada","Storey County",5,46,41,23,18
050,32,029,"Nevada","Storey County",5,47,51,27,24
050,32,029,"Nevada","Storey County",5,48,57,24,33
050,32,029,"Nevada","Storey County",5,49,37,18,19
050,32,029,"Nevada","Storey County",5,50,53,29,24
050,32,029,"Nevada","Storey County",5,51,50,24,26
050,32,029,"Nevada","Storey County",5,52,62,37,25
050,32,029,"Nevada","Storey County",5,53,54,28,26
050,32,029,"Nevada","Storey County",5,54,48,23,25
050,32,029,"Nevada","Storey County",5,55,51,28,23
050,32,029,"Nevada","Storey County",5,56,48,21,27
050,32,029,"Nevada","Storey County",5,57,52,26,26
050,32,029,"Nevada","Storey County",5,58,56,30,26
050,32,029,"Nevada","Storey County",5,59,46,19,27
050,32,029,"Nevada","Storey County",5,60,63,33,30
050,32,029,"Nevada","Storey County",5,61,88,44,44
050,32,029,"Nevada","Storey County",5,62,82,44,38
050,32,029,"Nevada","Storey County",5,63,75,37,38
050,32,029,"Nevada","Storey County",5,64,91,47,44
050,32,029,"Nevada","Storey County",5,65,83,44,39
050,32,029,"Nevada","Storey County",5,66,100,52,48
050,32,029,"Nevada","Storey County",5,67,82,36,46
050,32,029,"Nevada","Storey County",5,68,86,46,40
050,32,029,"Nevada","Storey County",5,69,81,33,48
050,32,029,"Nevada","Storey County",5,70,83,36,47
050,32,029,"Nevada","Storey County",5,71,88,43,45
050,32,029,"Nevada","Storey County",5,72,95,49,46
050,32,029,"Nevada","Storey County",5,73,81,45,36
050,32,029,"Nevada","Storey County",5,74,79,43,36
050,32,029,"Nevada","Storey County",5,75,86,45,41
050,32,029,"Nevada","Storey County",5,76,87,50,37
050,32,029,"Nevada","Storey County",5,77,51,26,25
050,32,029,"Nevada","Storey County",5,78,55,30,25
050,32,029,"Nevada","Storey County",5,79,51,27,24
050,32,029,"Nevada","Storey County",5,80,49,26,23
050,32,029,"Nevada","Storey County",5,81,40,20,20
050,32,029,"Nevada","Storey County",5,82,33,16,17
050,32,029,"Nevada","Storey County",5,83,19,11,8
050,32,029,"Nevada","Storey County",5,84,22,10,12
050,32,029,"Nevada","Storey County",5,85,118,56,62
050,32,031,"Nevada","Washoe County",1,0,5370,2742,2628
050,32,031,"Nevada","Washoe County",1,1,5358,2752,2606
050,32,031,"Nevada","Washoe County",1,2,5375,2766,2609
050,32,031,"Nevada","Washoe County",1,3,5527,2839,2688
050,32,031,"Nevada","Washoe County",1,4,5834,2931,2903
050,32,031,"Nevada","Washoe County",1,5,5837,2988,2849
050,32,031,"Nevada","Washoe County",1,6,5755,2997,2758
050,32,031,"Nevada","Washoe County",1,7,5759,2968,2791
050,32,031,"Nevada","Washoe County",1,8,5611,2920,2691
050,32,031,"Nevada","Washoe County",1,9,5703,2956,2747
050,32,031,"Nevada","Washoe County",1,10,5850,2972,2878
050,32,031,"Nevada","Washoe County",1,11,5987,3045,2942
050,32,031,"Nevada","Washoe County",1,12,6287,3250,3037
050,32,031,"Nevada","Washoe County",1,13,6272,3216,3056
050,32,031,"Nevada","Washoe County",1,14,6062,3114,2948
050,32,031,"Nevada","Washoe County",1,15,5910,3016,2894
050,32,031,"Nevada","Washoe County",1,16,5938,3065,2873
050,32,031,"Nevada","Washoe County",1,17,5785,3006,2779
050,32,031,"Nevada","Washoe County",1,18,5859,3054,2805
050,32,031,"Nevada","Washoe County",1,19,5949,3120,2829
050,32,031,"Nevada","Washoe County",1,20,5660,2945,2715
050,32,031,"Nevada","Washoe County",1,21,5929,3003,2926
050,32,031,"Nevada","Washoe County",1,22,6270,3157,3113
050,32,031,"Nevada","Washoe County",1,23,6619,3376,3243
050,32,031,"Nevada","Washoe County",1,24,6923,3606,3317
050,32,031,"Nevada","Washoe County",1,25,6964,3559,3405
050,32,031,"Nevada","Washoe County",1,26,6960,3583,3377
050,32,031,"Nevada","Washoe County",1,27,7259,3800,3459
050,32,031,"Nevada","Washoe County",1,28,7477,3866,3611
050,32,031,"Nevada","Washoe County",1,29,7633,3910,3723
050,32,031,"Nevada","Washoe County",1,30,7736,3970,3766
050,32,031,"Nevada","Washoe County",1,31,7551,3958,3593
050,32,031,"Nevada","Washoe County",1,32,7395,3888,3507
050,32,031,"Nevada","Washoe County",1,33,7015,3661,3354
050,32,031,"Nevada","Washoe County",1,34,7006,3719,3287
050,32,031,"Nevada","Washoe County",1,35,6911,3621,3290
050,32,031,"Nevada","Washoe County",1,36,6712,3496,3216
050,32,031,"Nevada","Washoe County",1,37,6584,3360,3224
050,32,031,"Nevada","Washoe County",1,38,6480,3342,3138
050,32,031,"Nevada","Washoe County",1,39,6368,3227,3141
050,32,031,"Nevada","Washoe County",1,40,6169,3154,3015
050,32,031,"Nevada","Washoe County",1,41,5838,3025,2813
050,32,031,"Nevada","Washoe County",1,42,5721,2917,2804
050,32,031,"Nevada","Washoe County",1,43,5692,2854,2838
050,32,031,"Nevada","Washoe County",1,44,5554,2822,2732
050,32,031,"Nevada","Washoe County",1,45,5499,2829,2670
050,32,031,"Nevada","Washoe County",1,46,5280,2722,2558
050,32,031,"Nevada","Washoe County",1,47,5573,2871,2702
050,32,031,"Nevada","Washoe County",1,48,5878,3004,2874
050,32,031,"Nevada","Washoe County",1,49,6301,3261,3040
050,32,031,"Nevada","Washoe County",1,50,6222,3288,2934
050,32,031,"Nevada","Washoe County",1,51,6113,3193,2920
050,32,031,"Nevada","Washoe County",1,52,5965,3042,2923
050,32,031,"Nevada","Washoe County",1,53,5987,3051,2936
050,32,031,"Nevada","Washoe County",1,54,6053,3129,2924
050,32,031,"Nevada","Washoe County",1,55,6210,3132,3078
050,32,031,"Nevada","Washoe County",1,56,6392,3195,3197
050,32,031,"Nevada","Washoe County",1,57,6474,3203,3271
050,32,031,"Nevada","Washoe County",1,58,6507,3270,3237
050,32,031,"Nevada","Washoe County",1,59,6563,3351,3212
050,32,031,"Nevada","Washoe County",1,60,6482,3247,3235
050,32,031,"Nevada","Washoe County",1,61,6325,3181,3144
050,32,031,"Nevada","Washoe County",1,62,6449,3222,3227
050,32,031,"Nevada","Washoe County",1,63,6290,3172,3118
050,32,031,"Nevada","Washoe County",1,64,6158,3042,3116
050,32,031,"Nevada","Washoe County",1,65,6069,2981,3088
050,32,031,"Nevada","Washoe County",1,66,5888,2805,3083
050,32,031,"Nevada","Washoe County",1,67,5771,2756,3015
050,32,031,"Nevada","Washoe County",1,68,5419,2644,2775
050,32,031,"Nevada","Washoe County",1,69,5096,2487,2609
050,32,031,"Nevada","Washoe County",1,70,5000,2419,2581
050,32,031,"Nevada","Washoe County",1,71,4908,2424,2484
050,32,031,"Nevada","Washoe County",1,72,5030,2503,2527
050,32,031,"Nevada","Washoe County",1,73,5052,2526,2526
050,32,031,"Nevada","Washoe County",1,74,3560,1738,1822
050,32,031,"Nevada","Washoe County",1,75,3430,1683,1747
050,32,031,"Nevada","Washoe County",1,76,3302,1618,1684
050,32,031,"Nevada","Washoe County",1,77,3112,1523,1589
050,32,031,"Nevada","Washoe County",1,78,2592,1259,1333
050,32,031,"Nevada","Washoe County",1,79,2285,1117,1168
050,32,031,"Nevada","Washoe County",1,80,2037,1018,1019
050,32,031,"Nevada","Washoe County",1,81,1896,875,1021
050,32,031,"Nevada","Washoe County",1,82,1690,788,902
050,32,031,"Nevada","Washoe County",1,83,1445,666,779
050,32,031,"Nevada","Washoe County",1,84,1263,541,722
050,32,031,"Nevada","Washoe County",1,85,6473,2631,3842
050,32,031,"Nevada","Washoe County",2,0,5275,2723,2552
050,32,031,"Nevada","Washoe County",2,1,5361,2755,2606
050,32,031,"Nevada","Washoe County",2,2,5379,2773,2606
050,32,031,"Nevada","Washoe County",2,3,5469,2807,2662
050,32,031,"Nevada","Washoe County",2,4,5771,2920,2851
050,32,031,"Nevada","Washoe County",2,5,5835,2974,2861
050,32,031,"Nevada","Washoe County",2,6,5781,3002,2779
050,32,031,"Nevada","Washoe County",2,7,5756,2972,2784
050,32,031,"Nevada","Washoe County",2,8,5627,2920,2707
050,32,031,"Nevada","Washoe County",2,9,5676,2948,2728
050,32,031,"Nevada","Washoe County",2,10,5814,2965,2849
050,32,031,"Nevada","Washoe County",2,11,5931,3018,2913
050,32,031,"Nevada","Washoe County",2,12,6240,3213,3027
050,32,031,"Nevada","Washoe County",2,13,6268,3222,3046
050,32,031,"Nevada","Washoe County",2,14,6117,3139,2978
050,32,031,"Nevada","Washoe County",2,15,5953,3044,2909
050,32,031,"Nevada","Washoe County",2,16,5935,3060,2875
050,32,031,"Nevada","Washoe County",2,17,5838,3022,2816
050,32,031,"Nevada","Washoe County",2,18,5888,3058,2830
050,32,031,"Nevada","Washoe County",2,19,5959,3120,2839
050,32,031,"Nevada","Washoe County",2,20,5743,2998,2745
050,32,031,"Nevada","Washoe County",2,21,5927,3016,2911
050,32,031,"Nevada","Washoe County",2,22,6243,3147,3096
050,32,031,"Nevada","Washoe County",2,23,6607,3368,3239
050,32,031,"Nevada","Washoe County",2,24,6877,3558,3319
050,32,031,"Nevada","Washoe County",2,25,6989,3592,3397
050,32,031,"Nevada","Washoe County",2,26,7011,3613,3398
050,32,031,"Nevada","Washoe County",2,27,7198,3759,3439
050,32,031,"Nevada","Washoe County",2,28,7450,3858,3592
050,32,031,"Nevada","Washoe County",2,29,7588,3893,3695
050,32,031,"Nevada","Washoe County",2,30,7749,3981,3768
050,32,031,"Nevada","Washoe County",2,31,7569,3941,3628
050,32,031,"Nevada","Washoe County",2,32,7432,3901,3531
050,32,031,"Nevada","Washoe County",2,33,7122,3724,3398
050,32,031,"Nevada","Washoe County",2,34,7014,3714,3300
050,32,031,"Nevada","Washoe County",2,35,6988,3673,3315
050,32,031,"Nevada","Washoe County",2,36,6727,3504,3223
050,32,031,"Nevada","Washoe County",2,37,6641,3411,3230
050,32,031,"Nevada","Washoe County",2,38,6542,3363,3179
050,32,031,"Nevada","Washoe County",2,39,6379,3245,3134
050,32,031,"Nevada","Washoe County",2,40,6256,3191,3065
050,32,031,"Nevada","Washoe County",2,41,5924,3052,2872
050,32,031,"Nevada","Washoe County",2,42,5728,2932,2796
050,32,031,"Nevada","Washoe County",2,43,5732,2885,2847
050,32,031,"Nevada","Washoe County",2,44,5541,2806,2735
050,32,031,"Nevada","Washoe County",2,45,5534,2835,2699
050,32,031,"Nevada","Washoe County",2,46,5322,2739,2583
050,32,031,"Nevada","Washoe County",2,47,5491,2833,2658
050,32,031,"Nevada","Washoe County",2,48,5811,2970,2841
050,32,031,"Nevada","Washoe County",2,49,6242,3221,3021
050,32,031,"Nevada","Washoe County",2,50,6273,3302,2971
050,32,031,"Nevada","Washoe County",2,51,6131,3215,2916
050,32,031,"Nevada","Washoe County",2,52,6008,3082,2926
050,32,031,"Nevada","Washoe County",2,53,5984,3052,2932
050,32,031,"Nevada","Washoe County",2,54,6038,3115,2923
050,32,031,"Nevada","Washoe County",2,55,6180,3135,3045
050,32,031,"Nevada","Washoe County",2,56,6381,3195,3186
050,32,031,"Nevada","Washoe County",2,57,6458,3203,3255
050,32,031,"Nevada","Washoe County",2,58,6502,3255,3247
050,32,031,"Nevada","Washoe County",2,59,6575,3344,3231
050,32,031,"Nevada","Washoe County",2,60,6509,3266,3243
050,32,031,"Nevada","Washoe County",2,61,6336,3178,3158
050,32,031,"Nevada","Washoe County",2,62,6399,3201,3198
050,32,031,"Nevada","Washoe County",2,63,6399,3222,3177
050,32,031,"Nevada","Washoe County",2,64,6160,3062,3098
050,32,031,"Nevada","Washoe County",2,65,6081,2985,3096
050,32,031,"Nevada","Washoe County",2,66,5938,2854,3084
050,32,031,"Nevada","Washoe County",2,67,5774,2756,3018
050,32,031,"Nevada","Washoe County",2,68,5466,2651,2815
050,32,031,"Nevada","Washoe County",2,69,5181,2524,2657
050,32,031,"Nevada","Washoe County",2,70,4988,2413,2575
050,32,031,"Nevada","Washoe County",2,71,4910,2406,2504
050,32,031,"Nevada","Washoe County",2,72,4914,2441,2473
050,32,031,"Nevada","Washoe County",2,73,5264,2633,2631
050,32,031,"Nevada","Washoe County",2,74,3689,1814,1875
050,32,031,"Nevada","Washoe County",2,75,3453,1687,1766
050,32,031,"Nevada","Washoe County",2,76,3276,1604,1672
050,32,031,"Nevada","Washoe County",2,77,3209,1573,1636
050,32,031,"Nevada","Washoe County",2,78,2655,1294,1361
050,32,031,"Nevada","Washoe County",2,79,2323,1131,1192
050,32,031,"Nevada","Washoe County",2,80,2077,1032,1045
050,32,031,"Nevada","Washoe County",2,81,1916,900,1016
050,32,031,"Nevada","Washoe County",2,82,1727,805,922
050,32,031,"Nevada","Washoe County",2,83,1487,688,799
050,32,031,"Nevada","Washoe County",2,84,1273,548,725
050,32,031,"Nevada","Washoe County",2,85,6526,2658,3868
050,32,031,"Nevada","Washoe County",3,0,4885,2476,2409
050,32,031,"Nevada","Washoe County",3,1,5334,2681,2653
050,32,031,"Nevada","Washoe County",3,2,5446,2799,2647
050,32,031,"Nevada","Washoe County",3,3,5415,2791,2624
050,32,031,"Nevada","Washoe County",3,4,5543,2859,2684
050,32,031,"Nevada","Washoe County",3,5,5813,2958,2855
050,32,031,"Nevada","Washoe County",3,6,5870,2987,2883
050,32,031,"Nevada","Washoe County",3,7,5839,3045,2794
050,32,031,"Nevada","Washoe County",3,8,5795,2991,2804
050,32,031,"Nevada","Washoe County",3,9,5681,2944,2737
050,32,031,"Nevada","Washoe County",3,10,5768,2984,2784
050,32,031,"Nevada","Washoe County",3,11,5864,3012,2852
050,32,031,"Nevada","Washoe County",3,12,6004,3071,2933
050,32,031,"Nevada","Washoe County",3,13,6261,3235,3026
050,32,031,"Nevada","Washoe County",3,14,6326,3233,3093
050,32,031,"Nevada","Washoe County",3,15,6140,3143,2997
050,32,031,"Nevada","Washoe County",3,16,6011,3092,2919
050,32,031,"Nevada","Washoe County",3,17,5981,3060,2921
050,32,031,"Nevada","Washoe County",3,18,6026,3107,2919
050,32,031,"Nevada","Washoe County",3,19,5936,3087,2849
050,32,031,"Nevada","Washoe County",3,20,5848,3049,2799
050,32,031,"Nevada","Washoe County",3,21,6037,3093,2944
050,32,031,"Nevada","Washoe County",3,22,6185,3143,3042
050,32,031,"Nevada","Washoe County",3,23,6605,3353,3252
050,32,031,"Nevada","Washoe County",3,24,6848,3527,3321
050,32,031,"Nevada","Washoe County",3,25,7050,3650,3400
050,32,031,"Nevada","Washoe County",3,26,7181,3683,3498
050,32,031,"Nevada","Washoe County",3,27,7182,3736,3446
050,32,031,"Nevada","Washoe County",3,28,7347,3824,3523
050,32,031,"Nevada","Washoe County",3,29,7604,3928,3676
050,32,031,"Nevada","Washoe County",3,30,7740,3997,3743
050,32,031,"Nevada","Washoe County",3,31,7878,4053,3825
050,32,031,"Nevada","Washoe County",3,32,7679,4003,3676
050,32,031,"Nevada","Washoe County",3,33,7528,3949,3579
050,32,031,"Nevada","Washoe County",3,34,7258,3837,3421
050,32,031,"Nevada","Washoe County",3,35,7139,3767,3372
050,32,031,"Nevada","Washoe County",3,36,7055,3693,3362
050,32,031,"Nevada","Washoe County",3,37,6770,3532,3238
050,32,031,"Nevada","Washoe County",3,38,6733,3454,3279
050,32,031,"Nevada","Washoe County",3,39,6653,3433,3220
050,32,031,"Nevada","Washoe County",3,40,6401,3271,3130
050,32,031,"Nevada","Washoe County",3,41,6344,3236,3108
050,32,031,"Nevada","Washoe County",3,42,5961,3059,2902
050,32,031,"Nevada","Washoe County",3,43,5805,2958,2847
050,32,031,"Nevada","Washoe County",3,44,5715,2880,2835
050,32,031,"Nevada","Washoe County",3,45,5610,2852,2758
050,32,031,"Nevada","Washoe County",3,46,5611,2862,2749
050,32,031,"Nevada","Washoe County",3,47,5343,2758,2585
050,32,031,"Nevada","Washoe County",3,48,5503,2828,2675
050,32,031,"Nevada","Washoe County",3,49,5845,3001,2844
050,32,031,"Nevada","Washoe County",3,50,6329,3290,3039
050,32,031,"Nevada","Washoe County",3,51,6278,3306,2972
050,32,031,"Nevada","Washoe County",3,52,6144,3233,2911
050,32,031,"Nevada","Washoe County",3,53,6029,3078,2951
050,32,031,"Nevada","Washoe County",3,54,6006,3058,2948
050,32,031,"Nevada","Washoe County",3,55,6061,3128,2933
050,32,031,"Nevada","Washoe County",3,56,6231,3148,3083
050,32,031,"Nevada","Washoe County",3,57,6367,3168,3199
050,32,031,"Nevada","Washoe County",3,58,6465,3190,3275
050,32,031,"Nevada","Washoe County",3,59,6519,3262,3257
050,32,031,"Nevada","Washoe County",3,60,6647,3359,3288
050,32,031,"Nevada","Washoe County",3,61,6533,3290,3243
050,32,031,"Nevada","Washoe County",3,62,6339,3168,3171
050,32,031,"Nevada","Washoe County",3,63,6372,3166,3206
050,32,031,"Nevada","Washoe County",3,64,6409,3226,3183
050,32,031,"Nevada","Washoe County",3,65,6124,3004,3120
050,32,031,"Nevada","Washoe County",3,66,6046,2958,3088
050,32,031,"Nevada","Washoe County",3,67,5871,2812,3059
050,32,031,"Nevada","Washoe County",3,68,5700,2708,2992
050,32,031,"Nevada","Washoe County",3,69,5411,2604,2807
050,32,031,"Nevada","Washoe County",3,70,5081,2476,2605
050,32,031,"Nevada","Washoe County",3,71,4883,2346,2537
050,32,031,"Nevada","Washoe County",3,72,4827,2355,2472
050,32,031,"Nevada","Washoe County",3,73,4808,2352,2456
050,32,031,"Nevada","Washoe County",3,74,5125,2553,2572
050,32,031,"Nevada","Washoe County",3,75,3558,1760,1798
050,32,031,"Nevada","Washoe County",3,76,3354,1633,1721
050,32,031,"Nevada","Washoe County",3,77,3168,1523,1645
050,32,031,"Nevada","Washoe County",3,78,3100,1502,1598
050,32,031,"Nevada","Washoe County",3,79,2529,1219,1310
050,32,031,"Nevada","Washoe County",3,80,2207,1073,1134
050,32,031,"Nevada","Washoe County",3,81,1953,944,1009
050,32,031,"Nevada","Washoe County",3,82,1781,836,945
050,32,031,"Nevada","Washoe County",3,83,1609,759,850
050,32,031,"Nevada","Washoe County",3,84,1373,625,748
050,32,031,"Nevada","Washoe County",3,85,6667,2740,3927
050,32,031,"Nevada","Washoe County",4,0,4988,2574,2414
050,32,031,"Nevada","Washoe County",4,1,4924,2525,2399
050,32,031,"Nevada","Washoe County",4,2,5264,2659,2605
050,32,031,"Nevada","Washoe County",4,3,5446,2810,2636
050,32,031,"Nevada","Washoe County",4,4,5402,2774,2628
050,32,031,"Nevada","Washoe County",4,5,5497,2823,2674
050,32,031,"Nevada","Washoe County",4,6,5803,2982,2821
050,32,031,"Nevada","Washoe County",4,7,5850,2977,2873
050,32,031,"Nevada","Washoe County",4,8,5808,3011,2797
050,32,031,"Nevada","Washoe County",4,9,5810,3016,2794
050,32,031,"Nevada","Washoe County",4,10,5708,2920,2788
050,32,031,"Nevada","Washoe County",4,11,5765,2984,2781
050,32,031,"Nevada","Washoe County",4,12,5829,2998,2831
050,32,031,"Nevada","Washoe County",4,13,5971,3057,2914
050,32,031,"Nevada","Washoe County",4,14,6295,3219,3076
050,32,031,"Nevada","Washoe County",4,15,6369,3266,3103
050,32,031,"Nevada","Washoe County",4,16,6175,3188,2987
050,32,031,"Nevada","Washoe County",4,17,6005,3086,2919
050,32,031,"Nevada","Washoe County",4,18,6048,3080,2968
050,32,031,"Nevada","Washoe County",4,19,5903,3066,2837
050,32,031,"Nevada","Washoe County",4,20,5724,2944,2780
050,32,031,"Nevada","Washoe County",4,21,6075,3129,2946
050,32,031,"Nevada","Washoe County",4,22,6308,3246,3062
050,32,031,"Nevada","Washoe County",4,23,6603,3405,3198
050,32,031,"Nevada","Washoe County",4,24,6896,3519,3377
050,32,031,"Nevada","Washoe County",4,25,6921,3585,3336
050,32,031,"Nevada","Washoe County",4,26,7114,3728,3386
050,32,031,"Nevada","Washoe County",4,27,7298,3756,3542
050,32,031,"Nevada","Washoe County",4,28,7219,3753,3466
050,32,031,"Nevada","Washoe County",4,29,7348,3829,3519
050,32,031,"Nevada","Washoe County",4,30,7625,3986,3639
050,32,031,"Nevada","Washoe County",4,31,7725,4011,3714
050,32,031,"Nevada","Washoe County",4,32,7860,4057,3803
050,32,031,"Nevada","Washoe County",4,33,7700,3996,3704
050,32,031,"Nevada","Washoe County",4,34,7518,3979,3539
050,32,031,"Nevada","Washoe County",4,35,7299,3826,3473
050,32,031,"Nevada","Washoe County",4,36,7096,3727,3369
050,32,031,"Nevada","Washoe County",4,37,7171,3747,3424
050,32,031,"Nevada","Washoe County",4,38,6776,3540,3236
050,32,031,"Nevada","Washoe County",4,39,6711,3431,3280
050,32,031,"Nevada","Washoe County",4,40,6604,3394,3210
050,32,031,"Nevada","Washoe County",4,41,6418,3280,3138
050,32,031,"Nevada","Washoe County",4,42,6396,3297,3099
050,32,031,"Nevada","Washoe County",4,43,5969,3077,2892
050,32,031,"Nevada","Washoe County",4,44,5730,2901,2829
050,32,031,"Nevada","Washoe County",4,45,5675,2860,2815
050,32,031,"Nevada","Washoe County",4,46,5596,2836,2760
050,32,031,"Nevada","Washoe County",4,47,5605,2862,2743
050,32,031,"Nevada","Washoe County",4,48,5325,2740,2585
050,32,031,"Nevada","Washoe County",4,49,5528,2874,2654
050,32,031,"Nevada","Washoe County",4,50,5898,3045,2853
050,32,031,"Nevada","Washoe County",4,51,6344,3303,3041
050,32,031,"Nevada","Washoe County",4,52,6310,3313,2997
050,32,031,"Nevada","Washoe County",4,53,6162,3226,2936
050,32,031,"Nevada","Washoe County",4,54,5974,3039,2935
050,32,031,"Nevada","Washoe County",4,55,6051,3081,2970
050,32,031,"Nevada","Washoe County",4,56,6108,3149,2959
050,32,031,"Nevada","Washoe County",4,57,6231,3131,3100
050,32,031,"Nevada","Washoe County",4,58,6381,3182,3199
050,32,031,"Nevada","Washoe County",4,59,6489,3217,3272
050,32,031,"Nevada","Washoe County",4,60,6550,3279,3271
050,32,031,"Nevada","Washoe County",4,61,6615,3395,3220
050,32,031,"Nevada","Washoe County",4,62,6437,3181,3256
050,32,031,"Nevada","Washoe County",4,63,6338,3154,3184
050,32,031,"Nevada","Washoe County",4,64,6302,3144,3158
050,32,031,"Nevada","Washoe County",4,65,6352,3172,3180
050,32,031,"Nevada","Washoe County",4,66,6102,2967,3135
050,32,031,"Nevada","Washoe County",4,67,5970,2913,3057
050,32,031,"Nevada","Washoe County",4,68,5769,2771,2998
050,32,031,"Nevada","Washoe County",4,69,5579,2646,2933
050,32,031,"Nevada","Washoe County",4,70,5342,2566,2776
050,32,031,"Nevada","Washoe County",4,71,4964,2405,2559
050,32,031,"Nevada","Washoe County",4,72,4758,2272,2486
050,32,031,"Nevada","Washoe County",4,73,4679,2280,2399
050,32,031,"Nevada","Washoe County",4,74,4663,2270,2393
050,32,031,"Nevada","Washoe County",4,75,4957,2449,2508
050,32,031,"Nevada","Washoe County",4,76,3457,1705,1752
050,32,031,"Nevada","Washoe County",4,77,3184,1549,1635
050,32,031,"Nevada","Washoe County",4,78,3042,1443,1599
050,32,031,"Nevada","Washoe County",4,79,2980,1425,1555
050,32,031,"Nevada","Washoe County",4,80,2388,1142,1246
050,32,031,"Nevada","Washoe County",4,81,2099,1001,1098
050,32,031,"Nevada","Washoe County",4,82,1814,883,931
050,32,031,"Nevada","Washoe County",4,83,1640,780,860
050,32,031,"Nevada","Washoe County",4,84,1464,689,775
050,32,031,"Nevada","Washoe County",4,85,6894,2900,3994
050,32,031,"Nevada","Washoe County",5,0,4961,2557,2404
050,32,031,"Nevada","Washoe County",5,1,5014,2553,2461
050,32,031,"Nevada","Washoe County",5,2,4961,2540,2421
050,32,031,"Nevada","Washoe County",5,3,5287,2687,2600
050,32,031,"Nevada","Washoe County",5,4,5440,2825,2615
050,32,031,"Nevada","Washoe County",5,5,5388,2756,2632
050,32,031,"Nevada","Washoe County",5,6,5452,2800,2652
050,32,031,"Nevada","Washoe County",5,7,5766,2975,2791
050,32,031,"Nevada","Washoe County",5,8,5820,2971,2849
050,32,031,"Nevada","Washoe County",5,9,5758,2968,2790
050,32,031,"Nevada","Washoe County",5,10,5741,2954,2787
050,32,031,"Nevada","Washoe County",5,11,5746,2943,2803
050,32,031,"Nevada","Washoe County",5,12,5765,3005,2760
050,32,031,"Nevada","Washoe County",5,13,5830,2991,2839
050,32,031,"Nevada","Washoe County",5,14,5951,3046,2905
050,32,031,"Nevada","Washoe County",5,15,6241,3197,3044
050,32,031,"Nevada","Washoe County",5,16,6329,3263,3066
050,32,031,"Nevada","Washoe County",5,17,6134,3158,2976
050,32,031,"Nevada","Washoe County",5,18,6038,3068,2970
050,32,031,"Nevada","Washoe County",5,19,5900,3024,2876
050,32,031,"Nevada","Washoe County",5,20,5700,2962,2738
050,32,031,"Nevada","Washoe County",5,21,5873,3011,2862
050,32,031,"Nevada","Washoe County",5,22,6297,3229,3068
050,32,031,"Nevada","Washoe County",5,23,6630,3461,3169
050,32,031,"Nevada","Washoe County",5,24,6753,3520,3233
050,32,031,"Nevada","Washoe County",5,25,6945,3575,3370
050,32,031,"Nevada","Washoe County",5,26,6923,3618,3305
050,32,031,"Nevada","Washoe County",5,27,7157,3759,3398
050,32,031,"Nevada","Washoe County",5,28,7350,3754,3596
050,32,031,"Nevada","Washoe County",5,29,7207,3762,3445
050,32,031,"Nevada","Washoe County",5,30,7343,3834,3509
050,32,031,"Nevada","Washoe County",5,31,7653,4016,3637
050,32,031,"Nevada","Washoe County",5,32,7714,4026,3688
050,32,031,"Nevada","Washoe County",5,33,7852,4069,3783
050,32,031,"Nevada","Washoe County",5,34,7706,4011,3695
050,32,031,"Nevada","Washoe County",5,35,7526,3954,3572
050,32,031,"Nevada","Washoe County",5,36,7284,3791,3493
050,32,031,"Nevada","Washoe County",5,37,7121,3756,3365
050,32,031,"Nevada","Washoe County",5,38,7194,3805,3389
050,32,031,"Nevada","Washoe County",5,39,6706,3504,3202
050,32,031,"Nevada","Washoe County",5,40,6645,3399,3246
050,32,031,"Nevada","Washoe County",5,41,6639,3391,3248
050,32,031,"Nevada","Washoe County",5,42,6398,3256,3142
050,32,031,"Nevada","Washoe County",5,43,6353,3283,3070
050,32,031,"Nevada","Washoe County",5,44,5898,3025,2873
050,32,031,"Nevada","Washoe County",5,45,5667,2871,2796
050,32,031,"Nevada","Washoe County",5,46,5683,2869,2814
050,32,031,"Nevada","Washoe County",5,47,5539,2794,2745
050,32,031,"Nevada","Washoe County",5,48,5540,2831,2709
050,32,031,"Nevada","Washoe County",5,49,5322,2721,2601
050,32,031,"Nevada","Washoe County",5,50,5489,2864,2625
050,32,031,"Nevada","Washoe County",5,51,5841,3000,2841
050,32,031,"Nevada","Washoe County",5,52,6284,3276,3008
050,32,031,"Nevada","Washoe County",5,53,6278,3276,3002
050,32,031,"Nevada","Washoe County",5,54,6126,3201,2925
050,32,031,"Nevada","Washoe County",5,55,5930,2992,2938
050,32,031,"Nevada","Washoe County",5,56,6021,3037,2984
050,32,031,"Nevada","Washoe County",5,57,6101,3190,2911
050,32,031,"Nevada","Washoe County",5,58,6193,3120,3073
050,32,031,"Nevada","Washoe County",5,59,6342,3156,3186
050,32,031,"Nevada","Washoe County",5,60,6481,3200,3281
050,32,031,"Nevada","Washoe County",5,61,6517,3277,3240
050,32,031,"Nevada","Washoe County",5,62,6496,3303,3193
050,32,031,"Nevada","Washoe County",5,63,6401,3159,3242
050,32,031,"Nevada","Washoe County",5,64,6243,3101,3142
050,32,031,"Nevada","Washoe County",5,65,6256,3109,3147
050,32,031,"Nevada","Washoe County",5,66,6303,3155,3148
050,32,031,"Nevada","Washoe County",5,67,6027,2904,3123
050,32,031,"Nevada","Washoe County",5,68,5860,2846,3014
050,32,031,"Nevada","Washoe County",5,69,5649,2706,2943
050,32,031,"Nevada","Washoe County",5,70,5473,2590,2883
050,32,031,"Nevada","Washoe County",5,71,5236,2502,2734
050,32,031,"Nevada","Washoe County",5,72,4866,2355,2511
050,32,031,"Nevada","Washoe County",5,73,4652,2208,2444
050,32,031,"Nevada","Washoe County",5,74,4557,2219,2338
050,32,031,"Nevada","Washoe County",5,75,4558,2197,2361
050,32,031,"Nevada","Washoe County",5,76,4829,2364,2465
050,32,031,"Nevada","Washoe County",5,77,3343,1642,1701
050,32,031,"Nevada","Washoe County",5,78,3081,1496,1585
050,32,031,"Nevada","Washoe County",5,79,2898,1351,1547
050,32,031,"Nevada","Washoe County",5,80,2830,1366,1464
050,32,031,"Nevada","Washoe County",5,81,2276,1067,1209
050,32,031,"Nevada","Washoe County",5,82,1960,936,1024
050,32,031,"Nevada","Washoe County",5,83,1697,829,868
050,32,031,"Nevada","Washoe County",5,84,1498,710,788
050,32,031,"Nevada","Washoe County",5,85,7290,3156,4134
050,32,033,"Nevada","White Pine County",1,0,86,43,43
050,32,033,"Nevada","White Pine County",1,1,92,46,46
050,32,033,"Nevada","White Pine County",1,2,104,57,47
050,32,033,"Nevada","White Pine County",1,3,109,53,56
050,32,033,"Nevada","White Pine County",1,4,96,51,45
050,32,033,"Nevada","White Pine County",1,5,81,33,48
050,32,033,"Nevada","White Pine County",1,6,94,40,54
050,32,033,"Nevada","White Pine County",1,7,90,46,44
050,32,033,"Nevada","White Pine County",1,8,99,57,42
050,32,033,"Nevada","White Pine County",1,9,106,58,48
050,32,033,"Nevada","White Pine County",1,10,113,60,53
050,32,033,"Nevada","White Pine County",1,11,116,58,58
050,32,033,"Nevada","White Pine County",1,12,108,54,54
050,32,033,"Nevada","White Pine County",1,13,109,59,50
050,32,033,"Nevada","White Pine County",1,14,103,52,51
050,32,033,"Nevada","White Pine County",1,15,90,46,44
050,32,033,"Nevada","White Pine County",1,16,102,50,52
050,32,033,"Nevada","White Pine County",1,17,105,54,51
050,32,033,"Nevada","White Pine County",1,18,95,50,45
050,32,033,"Nevada","White Pine County",1,19,77,39,38
050,32,033,"Nevada","White Pine County",1,20,82,46,36
050,32,033,"Nevada","White Pine County",1,21,102,66,36
050,32,033,"Nevada","White Pine County",1,22,102,72,30
050,32,033,"Nevada","White Pine County",1,23,107,72,35
050,32,033,"Nevada","White Pine County",1,24,119,74,45
050,32,033,"Nevada","White Pine County",1,25,117,76,41
050,32,033,"Nevada","White Pine County",1,26,128,84,44
050,32,033,"Nevada","White Pine County",1,27,122,79,43
050,32,033,"Nevada","White Pine County",1,28,132,94,38
050,32,033,"Nevada","White Pine County",1,29,140,90,50
050,32,033,"Nevada","White Pine County",1,30,143,96,47
050,32,033,"Nevada","White Pine County",1,31,141,102,39
050,32,033,"Nevada","White Pine County",1,32,133,96,37
050,32,033,"Nevada","White Pine County",1,33,147,93,54
050,32,033,"Nevada","White Pine County",1,34,126,75,51
050,32,033,"Nevada","White Pine County",1,35,110,62,48
050,32,033,"Nevada","White Pine County",1,36,129,84,45
050,32,033,"Nevada","White Pine County",1,37,120,72,48
050,32,033,"Nevada","White Pine County",1,38,127,88,39
050,32,033,"Nevada","White Pine County",1,39,130,86,44
050,32,033,"Nevada","White Pine County",1,40,128,87,41
050,32,033,"Nevada","White Pine County",1,41,133,88,45
050,32,033,"Nevada","White Pine County",1,42,112,75,37
050,32,033,"Nevada","White Pine County",1,43,113,65,48
050,32,033,"Nevada","White Pine County",1,44,109,72,37
050,32,033,"Nevada","White Pine County",1,45,100,66,34
050,32,033,"Nevada","White Pine County",1,46,106,62,44
050,32,033,"Nevada","White Pine County",1,47,100,64,36
050,32,033,"Nevada","White Pine County",1,48,122,76,46
050,32,033,"Nevada","White Pine County",1,49,116,72,44
050,32,033,"Nevada","White Pine County",1,50,95,53,42
050,32,033,"Nevada","White Pine County",1,51,103,63,40
050,32,033,"Nevada","White Pine County",1,52,106,63,43
050,32,033,"Nevada","White Pine County",1,53,110,69,41
050,32,033,"Nevada","White Pine County",1,54,106,62,44
050,32,033,"Nevada","White Pine County",1,55,124,70,54
050,32,033,"Nevada","White Pine County",1,56,126,76,50
050,32,033,"Nevada","White Pine County",1,57,137,78,59
050,32,033,"Nevada","White Pine County",1,58,130,70,60
050,32,033,"Nevada","White Pine County",1,59,142,81,61
050,32,033,"Nevada","White Pine County",1,60,138,83,55
050,32,033,"Nevada","White Pine County",1,61,139,81,58
050,32,033,"Nevada","White Pine County",1,62,116,68,48
050,32,033,"Nevada","White Pine County",1,63,117,60,57
050,32,033,"Nevada","White Pine County",1,64,111,62,49
050,32,033,"Nevada","White Pine County",1,65,117,65,52
050,32,033,"Nevada","White Pine County",1,66,118,71,47
050,32,033,"Nevada","White Pine County",1,67,113,68,45
050,32,033,"Nevada","White Pine County",1,68,106,61,45
050,32,033,"Nevada","White Pine County",1,69,106,59,47
050,32,033,"Nevada","White Pine County",1,70,87,48,39
050,32,033,"Nevada","White Pine County",1,71,89,49,40
050,32,033,"Nevada","White Pine County",1,72,86,47,39
050,32,033,"Nevada","White Pine County",1,73,83,39,44
050,32,033,"Nevada","White Pine County",1,74,72,36,36
050,32,033,"Nevada","White Pine County",1,75,71,31,40
050,32,033,"Nevada","White Pine County",1,76,70,37,33
050,32,033,"Nevada","White Pine County",1,77,63,31,32
050,32,033,"Nevada","White Pine County",1,78,66,34,32
050,32,033,"Nevada","White Pine County",1,79,47,18,29
050,32,033,"Nevada","White Pine County",1,80,54,25,29
050,32,033,"Nevada","White Pine County",1,81,52,29,23
050,32,033,"Nevada","White Pine County",1,82,50,33,17
050,32,033,"Nevada","White Pine County",1,83,34,17,17
050,32,033,"Nevada","White Pine County",1,84,28,13,15
050,32,033,"Nevada","White Pine County",1,85,193,83,110
050,32,033,"Nevada","White Pine County",2,0,92,48,44
050,32,033,"Nevada","White Pine County",2,1,93,48,45
050,32,033,"Nevada","White Pine County",2,2,101,54,47
050,32,033,"Nevada","White Pine County",2,3,108,54,54
050,32,033,"Nevada","White Pine County",2,4,102,53,49
050,32,033,"Nevada","White Pine County",2,5,83,37,46
050,32,033,"Nevada","White Pine County",2,6,90,37,53
050,32,033,"Nevada","White Pine County",2,7,90,45,45
050,32,033,"Nevada","White Pine County",2,8,96,53,43
050,32,033,"Nevada","White Pine County",2,9,104,59,45
050,32,033,"Nevada","White Pine County",2,10,115,61,54
050,32,033,"Nevada","White Pine County",2,11,116,60,56
050,32,033,"Nevada","White Pine County",2,12,112,56,56
050,32,033,"Nevada","White Pine County",2,13,109,57,52
050,32,033,"Nevada","White Pine County",2,14,104,53,51
050,32,033,"Nevada","White Pine County",2,15,95,48,47
050,32,033,"Nevada","White Pine County",2,16,98,49,49
050,32,033,"Nevada","White Pine County",2,17,104,54,50
050,32,033,"Nevada","White Pine County",2,18,94,51,43
050,32,033,"Nevada","White Pine County",2,19,77,39,38
050,32,033,"Nevada","White Pine County",2,20,85,47,38
050,32,033,"Nevada","White Pine County",2,21,102,66,36
050,32,033,"Nevada","White Pine County",2,22,104,71,33
050,32,033,"Nevada","White Pine County",2,23,108,72,36
050,32,033,"Nevada","White Pine County",2,24,117,73,44
050,32,033,"Nevada","White Pine County",2,25,118,74,44
050,32,033,"Nevada","White Pine County",2,26,125,82,43
050,32,033,"Nevada","White Pine County",2,27,119,78,41
050,32,033,"Nevada","White Pine County",2,28,129,90,39
050,32,033,"Nevada","White Pine County",2,29,134,87,47
050,32,033,"Nevada","White Pine County",2,30,146,98,48
050,32,033,"Nevada","White Pine County",2,31,141,101,40
050,32,033,"Nevada","White Pine County",2,32,129,92,37
050,32,033,"Nevada","White Pine County",2,33,145,94,51
050,32,033,"Nevada","White Pine County",2,34,127,76,51
050,32,033,"Nevada","White Pine County",2,35,111,63,48
050,32,033,"Nevada","White Pine County",2,36,126,79,47
050,32,033,"Nevada","White Pine County",2,37,117,70,47
050,32,033,"Nevada","White Pine County",2,38,127,86,41
050,32,033,"Nevada","White Pine County",2,39,128,85,43
050,32,033,"Nevada","White Pine County",2,40,129,87,42
050,32,033,"Nevada","White Pine County",2,41,129,85,44
050,32,033,"Nevada","White Pine County",2,42,116,77,39
050,32,033,"Nevada","White Pine County",2,43,112,66,46
050,32,033,"Nevada","White Pine County",2,44,109,70,39
050,32,033,"Nevada","White Pine County",2,45,102,67,35
050,32,033,"Nevada","White Pine County",2,46,104,63,41
050,32,033,"Nevada","White Pine County",2,47,103,65,38
050,32,033,"Nevada","White Pine County",2,48,115,72,43
050,32,033,"Nevada","White Pine County",2,49,118,73,45
050,32,033,"Nevada","White Pine County",2,50,97,55,42
050,32,033,"Nevada","White Pine County",2,51,102,62,40
050,32,033,"Nevada","White Pine County",2,52,103,61,42
050,32,033,"Nevada","White Pine County",2,53,107,67,40
050,32,033,"Nevada","White Pine County",2,54,105,62,43
050,32,033,"Nevada","White Pine County",2,55,120,67,53
050,32,033,"Nevada","White Pine County",2,56,129,77,52
050,32,033,"Nevada","White Pine County",2,57,130,74,56
050,32,033,"Nevada","White Pine County",2,58,133,73,60
050,32,033,"Nevada","White Pine County",2,59,139,78,61
050,32,033,"Nevada","White Pine County",2,60,140,83,57
050,32,033,"Nevada","White Pine County",2,61,139,82,57
050,32,033,"Nevada","White Pine County",2,62,120,70,50
050,32,033,"Nevada","White Pine County",2,63,118,63,55
050,32,033,"Nevada","White Pine County",2,64,113,62,51
050,32,033,"Nevada","White Pine County",2,65,114,64,50
050,32,033,"Nevada","White Pine County",2,66,119,70,49
050,32,033,"Nevada","White Pine County",2,67,113,67,46
050,32,033,"Nevada","White Pine County",2,68,104,61,43
050,32,033,"Nevada","White Pine County",2,69,107,60,47
050,32,033,"Nevada","White Pine County",2,70,92,51,41
050,32,033,"Nevada","White Pine County",2,71,89,48,41
050,32,033,"Nevada","White Pine County",2,72,86,47,39
050,32,033,"Nevada","White Pine County",2,73,89,43,46
050,32,033,"Nevada","White Pine County",2,74,71,35,36
050,32,033,"Nevada","White Pine County",2,75,71,32,39
050,32,033,"Nevada","White Pine County",2,76,69,35,34
050,32,033,"Nevada","White Pine County",2,77,63,31,32
050,32,033,"Nevada","White Pine County",2,78,64,32,32
050,32,033,"Nevada","White Pine County",2,79,51,21,30
050,32,033,"Nevada","White Pine County",2,80,51,23,28
050,32,033,"Nevada","White Pine County",2,81,52,28,24
050,32,033,"Nevada","White Pine County",2,82,51,32,19
050,32,033,"Nevada","White Pine County",2,83,36,19,17
050,32,033,"Nevada","White Pine County",2,84,27,13,14
050,32,033,"Nevada","White Pine County",2,85,187,82,105
050,32,033,"Nevada","White Pine County",3,0,80,41,39
050,32,033,"Nevada","White Pine County",3,1,92,46,46
050,32,033,"Nevada","White Pine County",3,2,90,48,42
050,32,033,"Nevada","White Pine County",3,3,100,53,47
050,32,033,"Nevada","White Pine County",3,4,111,58,53
050,32,033,"Nevada","White Pine County",3,5,103,50,53
050,32,033,"Nevada","White Pine County",3,6,79,38,41
050,32,033,"Nevada","White Pine County",3,7,97,41,56
050,32,033,"Nevada","White Pine County",3,8,92,49,43
050,32,033,"Nevada","White Pine County",3,9,104,59,45
050,32,033,"Nevada","White Pine County",3,10,108,60,48
050,32,033,"Nevada","White Pine County",3,11,120,62,58
050,32,033,"Nevada","White Pine County",3,12,111,58,53
050,32,033,"Nevada","White Pine County",3,13,113,55,58
050,32,033,"Nevada","White Pine County",3,14,114,62,52
050,32,033,"Nevada","White Pine County",3,15,104,53,51
050,32,033,"Nevada","White Pine County",3,16,100,48,52
050,32,033,"Nevada","White Pine County",3,17,100,48,52
050,32,033,"Nevada","White Pine County",3,18,89,48,41
050,32,033,"Nevada","White Pine County",3,19,82,45,37
050,32,033,"Nevada","White Pine County",3,20,83,41,42
050,32,033,"Nevada","White Pine County",3,21,91,56,35
050,32,033,"Nevada","White Pine County",3,22,94,57,37
050,32,033,"Nevada","White Pine County",3,23,97,64,33
050,32,033,"Nevada","White Pine County",3,24,105,67,38
050,32,033,"Nevada","White Pine County",3,25,109,69,40
050,32,033,"Nevada","White Pine County",3,26,114,70,44
050,32,033,"Nevada","White Pine County",3,27,121,73,48
050,32,033,"Nevada","White Pine County",3,28,128,80,48
050,32,033,"Nevada","White Pine County",3,29,119,78,41
050,32,033,"Nevada","White Pine County",3,30,136,84,52
050,32,033,"Nevada","White Pine County",3,31,143,92,51
050,32,033,"Nevada","White Pine County",3,32,108,71,37
050,32,033,"Nevada","White Pine County",3,33,118,83,35
050,32,033,"Nevada","White Pine County",3,34,125,78,47
050,32,033,"Nevada","White Pine County",3,35,112,60,52
050,32,033,"Nevada","White Pine County",3,36,110,67,43
050,32,033,"Nevada","White Pine County",3,37,109,62,47
050,32,033,"Nevada","White Pine County",3,38,121,71,50
050,32,033,"Nevada","White Pine County",3,39,128,82,46
050,32,033,"Nevada","White Pine County",3,40,122,81,41
050,32,033,"Nevada","White Pine County",3,41,128,78,50
050,32,033,"Nevada","White Pine County",3,42,130,86,44
050,32,033,"Nevada","White Pine County",3,43,109,67,42
050,32,033,"Nevada","White Pine County",3,44,112,65,47
050,32,033,"Nevada","White Pine County",3,45,100,58,42
050,32,033,"Nevada","White Pine County",3,46,92,60,32
050,32,033,"Nevada","White Pine County",3,47,105,63,42
050,32,033,"Nevada","White Pine County",3,48,94,56,38
050,32,033,"Nevada","White Pine County",3,49,109,66,43
050,32,033,"Nevada","White Pine County",3,50,107,60,47
050,32,033,"Nevada","White Pine County",3,51,107,59,48
050,32,033,"Nevada","White Pine County",3,52,93,53,40
050,32,033,"Nevada","White Pine County",3,53,107,67,40
050,32,033,"Nevada","White Pine County",3,54,95,53,42
050,32,033,"Nevada","White Pine County",3,55,91,49,42
050,32,033,"Nevada","White Pine County",3,56,120,67,53
050,32,033,"Nevada","White Pine County",3,57,113,65,48
050,32,033,"Nevada","White Pine County",3,58,136,77,59
050,32,033,"Nevada","White Pine County",3,59,143,81,62
050,32,033,"Nevada","White Pine County",3,60,133,71,62
050,32,033,"Nevada","White Pine County",3,61,143,86,57
050,32,033,"Nevada","White Pine County",3,62,126,73,53
050,32,033,"Nevada","White Pine County",3,63,110,62,48
050,32,033,"Nevada","White Pine County",3,64,111,57,54
050,32,033,"Nevada","White Pine County",3,65,115,60,55
050,32,033,"Nevada","White Pine County",3,66,111,59,52
050,32,033,"Nevada","White Pine County",3,67,118,67,51
050,32,033,"Nevada","White Pine County",3,68,111,69,42
050,32,033,"Nevada","White Pine County",3,69,105,59,46
050,32,033,"Nevada","White Pine County",3,70,107,61,46
050,32,033,"Nevada","White Pine County",3,71,88,49,39
050,32,033,"Nevada","White Pine County",3,72,89,47,42
050,32,033,"Nevada","White Pine County",3,73,85,48,37
050,32,033,"Nevada","White Pine County",3,74,85,39,46
050,32,033,"Nevada","White Pine County",3,75,65,31,34
050,32,033,"Nevada","White Pine County",3,76,70,31,39
050,32,033,"Nevada","White Pine County",3,77,65,34,31
050,32,033,"Nevada","White Pine County",3,78,56,28,28
050,32,033,"Nevada","White Pine County",3,79,61,30,31
050,32,033,"Nevada","White Pine County",3,80,49,21,28
050,32,033,"Nevada","White Pine County",3,81,47,21,26
050,32,033,"Nevada","White Pine County",3,82,51,26,25
050,32,033,"Nevada","White Pine County",3,83,48,31,17
050,32,033,"Nevada","White Pine County",3,84,32,18,14
050,32,033,"Nevada","White Pine County",3,85,190,85,105
050,32,033,"Nevada","White Pine County",4,0,75,42,33
050,32,033,"Nevada","White Pine County",4,1,75,39,36
050,32,033,"Nevada","White Pine County",4,2,87,46,41
050,32,033,"Nevada","White Pine County",4,3,91,46,45
050,32,033,"Nevada","White Pine County",4,4,103,58,45
050,32,033,"Nevada","White Pine County",4,5,110,55,55
050,32,033,"Nevada","White Pine County",4,6,101,47,54
050,32,033,"Nevada","White Pine County",4,7,79,39,40
050,32,033,"Nevada","White Pine County",4,8,97,42,55
050,32,033,"Nevada","White Pine County",4,9,90,47,43
050,32,033,"Nevada","White Pine County",4,10,109,57,52
050,32,033,"Nevada","White Pine County",4,11,109,63,46
050,32,033,"Nevada","White Pine County",4,12,115,64,51
050,32,033,"Nevada","White Pine County",4,13,102,52,50
050,32,033,"Nevada","White Pine County",4,14,113,51,62
050,32,033,"Nevada","White Pine County",4,15,110,58,52
050,32,033,"Nevada","White Pine County",4,16,101,53,48
050,32,033,"Nevada","White Pine County",4,17,105,49,56
050,32,033,"Nevada","White Pine County",4,18,83,45,38
050,32,033,"Nevada","White Pine County",4,19,73,37,36
050,32,033,"Nevada","White Pine County",4,20,96,57,39
050,32,033,"Nevada","White Pine County",4,21,87,49,38
050,32,033,"Nevada","White Pine County",4,22,95,55,40
050,32,033,"Nevada","White Pine County",4,23,91,55,36
050,32,033,"Nevada","White Pine County",4,24,96,60,36
050,32,033,"Nevada","White Pine County",4,25,114,70,44
050,32,033,"Nevada","White Pine County",4,26,111,68,43
050,32,033,"Nevada","White Pine County",4,27,107,64,43
050,32,033,"Nevada","White Pine County",4,28,123,77,46
050,32,033,"Nevada","White Pine County",4,29,114,70,44
050,32,033,"Nevada","White Pine County",4,30,126,85,41
050,32,033,"Nevada","White Pine County",4,31,146,90,56
050,32,033,"Nevada","White Pine County",4,32,131,82,49
050,32,033,"Nevada","White Pine County",4,33,116,78,38
050,32,033,"Nevada","White Pine County",4,34,120,80,40
050,32,033,"Nevada","White Pine County",4,35,114,66,48
050,32,033,"Nevada","White Pine County",4,36,114,63,51
050,32,033,"Nevada","White Pine County",4,37,102,62,40
050,32,033,"Nevada","White Pine County",4,38,110,67,43
050,32,033,"Nevada","White Pine County",4,39,121,72,49
050,32,033,"Nevada","White Pine County",4,40,126,80,46
050,32,033,"Nevada","White Pine County",4,41,122,77,45
050,32,033,"Nevada","White Pine County",4,42,128,83,45
050,32,033,"Nevada","White Pine County",4,43,119,75,44
050,32,033,"Nevada","White Pine County",4,44,108,66,42
050,32,033,"Nevada","White Pine County",4,45,109,61,48
050,32,033,"Nevada","White Pine County",4,46,93,52,41
050,32,033,"Nevada","White Pine County",4,47,105,66,39
050,32,033,"Nevada","White Pine County",4,48,105,64,41
050,32,033,"Nevada","White Pine County",4,49,95,56,39
050,32,033,"Nevada","White Pine County",4,50,99,55,44
050,32,033,"Nevada","White Pine County",4,51,106,58,48
050,32,033,"Nevada","White Pine County",4,52,99,56,43
050,32,033,"Nevada","White Pine County",4,53,96,57,39
050,32,033,"Nevada","White Pine County",4,54,108,66,42
050,32,033,"Nevada","White Pine County",4,55,88,46,42
050,32,033,"Nevada","White Pine County",4,56,94,55,39
050,32,033,"Nevada","White Pine County",4,57,116,57,59
050,32,033,"Nevada","White Pine County",4,58,110,68,42
050,32,033,"Nevada","White Pine County",4,59,138,78,60
050,32,033,"Nevada","White Pine County",4,60,142,80,62
050,32,033,"Nevada","White Pine County",4,61,131,70,61
050,32,033,"Nevada","White Pine County",4,62,142,82,60
050,32,033,"Nevada","White Pine County",4,63,131,74,57
050,32,033,"Nevada","White Pine County",4,64,110,59,51
050,32,033,"Nevada","White Pine County",4,65,112,57,55
050,32,033,"Nevada","White Pine County",4,66,114,63,51
050,32,033,"Nevada","White Pine County",4,67,107,54,53
050,32,033,"Nevada","White Pine County",4,68,115,66,49
050,32,033,"Nevada","White Pine County",4,69,109,68,41
050,32,033,"Nevada","White Pine County",4,70,102,56,46
050,32,033,"Nevada","White Pine County",4,71,99,55,44
050,32,033,"Nevada","White Pine County",4,72,88,50,38
050,32,033,"Nevada","White Pine County",4,73,89,49,40
050,32,033,"Nevada","White Pine County",4,74,79,47,32
050,32,033,"Nevada","White Pine County",4,75,83,41,42
050,32,033,"Nevada","White Pine County",4,76,67,33,34
050,32,033,"Nevada","White Pine County",4,77,65,30,35
050,32,033,"Nevada","White Pine County",4,78,64,33,31
050,32,033,"Nevada","White Pine County",4,79,52,25,27
050,32,033,"Nevada","White Pine County",4,80,53,24,29
050,32,033,"Nevada","White Pine County",4,81,44,18,26
050,32,033,"Nevada","White Pine County",4,82,46,21,25
050,32,033,"Nevada","White Pine County",4,83,48,26,22
050,32,033,"Nevada","White Pine County",4,84,41,27,14
050,32,033,"Nevada","White Pine County",4,85,187,91,96
050,32,033,"Nevada","White Pine County",5,0,66,38,28
050,32,033,"Nevada","White Pine County",5,1,76,42,34
050,32,033,"Nevada","White Pine County",5,2,80,43,37
050,32,033,"Nevada","White Pine County",5,3,84,46,38
050,32,033,"Nevada","White Pine County",5,4,86,40,46
050,32,033,"Nevada","White Pine County",5,5,102,58,44
050,32,033,"Nevada","White Pine County",5,6,109,52,57
050,32,033,"Nevada","White Pine County",5,7,100,45,55
050,32,033,"Nevada","White Pine County",5,8,77,39,38
050,32,033,"Nevada","White Pine County",5,9,101,45,56
050,32,033,"Nevada","White Pine County",5,10,85,45,40
050,32,033,"Nevada","White Pine County",5,11,106,58,48
050,32,033,"Nevada","White Pine County",5,12,114,68,46
050,32,033,"Nevada","White Pine County",5,13,111,62,49
050,32,033,"Nevada","White Pine County",5,14,99,49,50
050,32,033,"Nevada","White Pine County",5,15,113,51,62
050,32,033,"Nevada","White Pine County",5,16,109,58,51
050,32,033,"Nevada","White Pine County",5,17,101,53,48
050,32,033,"Nevada","White Pine County",5,18,93,48,45
050,32,033,"Nevada","White Pine County",5,19,67,35,32
050,32,033,"Nevada","White Pine County",5,20,78,41,37
050,32,033,"Nevada","White Pine County",5,21,102,61,41
050,32,033,"Nevada","White Pine County",5,22,86,46,40
050,32,033,"Nevada","White Pine County",5,23,92,56,36
050,32,033,"Nevada","White Pine County",5,24,85,48,37
050,32,033,"Nevada","White Pine County",5,25,83,51,32
050,32,033,"Nevada","White Pine County",5,26,109,64,45
050,32,033,"Nevada","White Pine County",5,27,105,65,40
050,32,033,"Nevada","White Pine County",5,28,113,69,44
050,32,033,"Nevada","White Pine County",5,29,117,67,50
050,32,033,"Nevada","White Pine County",5,30,118,71,47
050,32,033,"Nevada","White Pine County",5,31,127,84,43
050,32,033,"Nevada","White Pine County",5,32,133,79,54
050,32,033,"Nevada","White Pine County",5,33,122,75,47
050,32,033,"Nevada","White Pine County",5,34,100,64,36
050,32,033,"Nevada","White Pine County",5,35,114,72,42
050,32,033,"Nevada","White Pine County",5,36,112,68,44
050,32,033,"Nevada","White Pine County",5,37,100,54,46
050,32,033,"Nevada","White Pine County",5,38,95,58,37
050,32,033,"Nevada","White Pine County",5,39,100,59,41
050,32,033,"Nevada","White Pine County",5,40,121,72,49
050,32,033,"Nevada","White Pine County",5,41,118,68,50
050,32,033,"Nevada","White Pine County",5,42,117,72,45
050,32,033,"Nevada","White Pine County",5,43,113,71,42
050,32,033,"Nevada","White Pine County",5,44,119,76,43
050,32,033,"Nevada","White Pine County",5,45,104,62,42
050,32,033,"Nevada","White Pine County",5,46,106,59,47
050,32,033,"Nevada","White Pine County",5,47,98,53,45
050,32,033,"Nevada","White Pine County",5,48,100,61,39
050,32,033,"Nevada","White Pine County",5,49,103,60,43
050,32,033,"Nevada","White Pine County",5,50,78,38,40
050,32,033,"Nevada","White Pine County",5,51,101,59,42
050,32,033,"Nevada","White Pine County",5,52,102,53,49
050,32,033,"Nevada","White Pine County",5,53,99,58,41
050,32,033,"Nevada","White Pine County",5,54,91,52,39
050,32,033,"Nevada","White Pine County",5,55,97,55,42
050,32,033,"Nevada","White Pine County",5,56,92,49,43
050,32,033,"Nevada","White Pine County",5,57,89,47,42
050,32,033,"Nevada","White Pine County",5,58,121,60,61
050,32,033,"Nevada","White Pine County",5,59,109,69,40
050,32,033,"Nevada","White Pine County",5,60,131,72,59
050,32,033,"Nevada","White Pine County",5,61,143,81,62
050,32,033,"Nevada","White Pine County",5,62,125,69,56
050,32,033,"Nevada","White Pine County",5,63,135,74,61
050,32,033,"Nevada","White Pine County",5,64,133,70,63
050,32,033,"Nevada","White Pine County",5,65,113,57,56
050,32,033,"Nevada","White Pine County",5,66,111,56,55
050,32,033,"Nevada","White Pine County",5,67,111,61,50
050,32,033,"Nevada","White Pine County",5,68,110,55,55
050,32,033,"Nevada","White Pine County",5,69,115,66,49
050,32,033,"Nevada","White Pine County",5,70,107,65,42
050,32,033,"Nevada","White Pine County",5,71,96,51,45
050,32,033,"Nevada","White Pine County",5,72,97,53,44
050,32,033,"Nevada","White Pine County",5,73,88,48,40
050,32,033,"Nevada","White Pine County",5,74,84,49,35
050,32,033,"Nevada","White Pine County",5,75,82,48,34
050,32,033,"Nevada","White Pine County",5,76,78,38,40
050,32,033,"Nevada","White Pine County",5,77,66,32,34
050,32,033,"Nevada","White Pine County",5,78,65,30,35
050,32,033,"Nevada","White Pine County",5,79,58,30,28
050,32,033,"Nevada","White Pine County",5,80,46,20,26
050,32,033,"Nevada","White Pine County",5,81,51,24,27
050,32,033,"Nevada","White Pine County",5,82,39,16,23
050,32,033,"Nevada","White Pine County",5,83,44,20,24
050,32,033,"Nevada","White Pine County",5,84,47,26,21
050,32,033,"Nevada","White Pine County",5,85,199,103,96
050,32,510,"Nevada","Carson City",1,0,608,312,296
050,32,510,"Nevada","Carson City",1,1,631,323,308
050,32,510,"Nevada","Carson City",1,2,650,317,333
050,32,510,"Nevada","Carson City",1,3,665,346,319
050,32,510,"Nevada","Carson City",1,4,681,344,337
050,32,510,"Nevada","Carson City",1,5,669,335,334
050,32,510,"Nevada","Carson City",1,6,633,315,318
050,32,510,"Nevada","Carson City",1,7,650,317,333
050,32,510,"Nevada","Carson City",1,8,633,321,312
050,32,510,"Nevada","Carson City",1,9,647,312,335
050,32,510,"Nevada","Carson City",1,10,632,323,309
050,32,510,"Nevada","Carson City",1,11,695,355,340
050,32,510,"Nevada","Carson City",1,12,749,373,376
050,32,510,"Nevada","Carson City",1,13,733,368,365
050,32,510,"Nevada","Carson City",1,14,714,375,339
050,32,510,"Nevada","Carson City",1,15,699,372,327
050,32,510,"Nevada","Carson City",1,16,672,348,324
050,32,510,"Nevada","Carson City",1,17,665,344,321
050,32,510,"Nevada","Carson City",1,18,602,298,304
050,32,510,"Nevada","Carson City",1,19,560,280,280
050,32,510,"Nevada","Carson City",1,20,605,326,279
050,32,510,"Nevada","Carson City",1,21,624,341,283
050,32,510,"Nevada","Carson City",1,22,621,355,266
050,32,510,"Nevada","Carson City",1,23,619,356,263
050,32,510,"Nevada","Carson City",1,24,682,363,319
050,32,510,"Nevada","Carson City",1,25,766,416,350
050,32,510,"Nevada","Carson City",1,26,765,408,357
050,32,510,"Nevada","Carson City",1,27,775,434,341
050,32,510,"Nevada","Carson City",1,28,796,445,351
050,32,510,"Nevada","Carson City",1,29,850,483,367
050,32,510,"Nevada","Carson City",1,30,801,459,342
050,32,510,"Nevada","Carson City",1,31,773,439,334
050,32,510,"Nevada","Carson City",1,32,791,440,351
050,32,510,"Nevada","Carson City",1,33,790,447,343
050,32,510,"Nevada","Carson City",1,34,754,435,319
050,32,510,"Nevada","Carson City",1,35,736,410,326
050,32,510,"Nevada","Carson City",1,36,725,409,316
050,32,510,"Nevada","Carson City",1,37,709,402,307
050,32,510,"Nevada","Carson City",1,38,708,389,319
050,32,510,"Nevada","Carson City",1,39,692,377,315
050,32,510,"Nevada","Carson City",1,40,693,370,323
050,32,510,"Nevada","Carson City",1,41,655,361,294
050,32,510,"Nevada","Carson City",1,42,666,384,282
050,32,510,"Nevada","Carson City",1,43,659,366,293
050,32,510,"Nevada","Carson City",1,44,621,355,266
050,32,510,"Nevada","Carson City",1,45,620,346,274
050,32,510,"Nevada","Carson City",1,46,638,352,286
050,32,510,"Nevada","Carson City",1,47,662,372,290
050,32,510,"Nevada","Carson City",1,48,719,382,337
050,32,510,"Nevada","Carson City",1,49,778,418,360
050,32,510,"Nevada","Carson City",1,50,737,432,305
050,32,510,"Nevada","Carson City",1,51,726,397,329
050,32,510,"Nevada","Carson City",1,52,723,392,331
050,32,510,"Nevada","Carson City",1,53,763,423,340
050,32,510,"Nevada","Carson City",1,54,801,447,354
050,32,510,"Nevada","Carson City",1,55,792,419,373
050,32,510,"Nevada","Carson City",1,56,800,400,400
050,32,510,"Nevada","Carson City",1,57,846,431,415
050,32,510,"Nevada","Carson City",1,58,847,426,421
050,32,510,"Nevada","Carson City",1,59,868,429,439
050,32,510,"Nevada","Carson City",1,60,872,448,424
050,32,510,"Nevada","Carson City",1,61,839,416,423
050,32,510,"Nevada","Carson City",1,62,896,455,441
050,32,510,"Nevada","Carson City",1,63,875,430,445
050,32,510,"Nevada","Carson City",1,64,825,410,415
050,32,510,"Nevada","Carson City",1,65,783,378,405
050,32,510,"Nevada","Carson City",1,66,767,359,408
050,32,510,"Nevada","Carson City",1,67,767,369,398
050,32,510,"Nevada","Carson City",1,68,772,373,399
050,32,510,"Nevada","Carson City",1,69,696,336,360
050,32,510,"Nevada","Carson City",1,70,700,338,362
050,32,510,"Nevada","Carson City",1,71,672,321,351
050,32,510,"Nevada","Carson City",1,72,703,334,369
050,32,510,"Nevada","Carson City",1,73,737,359,378
050,32,510,"Nevada","Carson City",1,74,490,241,249
050,32,510,"Nevada","Carson City",1,75,540,257,283
050,32,510,"Nevada","Carson City",1,76,490,237,253
050,32,510,"Nevada","Carson City",1,77,477,225,252
050,32,510,"Nevada","Carson City",1,78,424,195,229
050,32,510,"Nevada","Carson City",1,79,357,165,192
050,32,510,"Nevada","Carson City",1,80,338,166,172
050,32,510,"Nevada","Carson City",1,81,290,127,163
050,32,510,"Nevada","Carson City",1,82,293,127,166
050,32,510,"Nevada","Carson City",1,83,243,97,146
050,32,510,"Nevada","Carson City",1,84,221,94,127
050,32,510,"Nevada","Carson City",1,85,1195,438,757
050,32,510,"Nevada","Carson City",2,0,596,308,288
050,32,510,"Nevada","Carson City",2,1,627,321,306
050,32,510,"Nevada","Carson City",2,2,646,319,327
050,32,510,"Nevada","Carson City",2,3,663,340,323
050,32,510,"Nevada","Carson City",2,4,678,342,336
050,32,510,"Nevada","Carson City",2,5,669,335,334
050,32,510,"Nevada","Carson City",2,6,640,318,322
050,32,510,"Nevada","Carson City",2,7,644,315,329
050,32,510,"Nevada","Carson City",2,8,640,319,321
050,32,510,"Nevada","Carson City",2,9,643,315,328
050,32,510,"Nevada","Carson City",2,10,634,318,316
050,32,510,"Nevada","Carson City",2,11,678,344,334
050,32,510,"Nevada","Carson City",2,12,736,368,368
050,32,510,"Nevada","Carson City",2,13,739,371,368
050,32,510,"Nevada","Carson City",2,14,715,371,344
050,32,510,"Nevada","Carson City",2,15,699,369,330
050,32,510,"Nevada","Carson City",2,16,683,358,325
050,32,510,"Nevada","Carson City",2,17,671,346,325
050,32,510,"Nevada","Carson City",2,18,604,303,301
050,32,510,"Nevada","Carson City",2,19,558,280,278
050,32,510,"Nevada","Carson City",2,20,608,322,286
050,32,510,"Nevada","Carson City",2,21,622,340,282
050,32,510,"Nevada","Carson City",2,22,627,356,271
050,32,510,"Nevada","Carson City",2,23,625,357,268
050,32,510,"Nevada","Carson City",2,24,672,364,308
050,32,510,"Nevada","Carson City",2,25,750,407,343
050,32,510,"Nevada","Carson City",2,26,764,410,354
050,32,510,"Nevada","Carson City",2,27,773,428,345
050,32,510,"Nevada","Carson City",2,28,796,444,352
050,32,510,"Nevada","Carson City",2,29,839,475,364
050,32,510,"Nevada","Carson City",2,30,808,459,349
050,32,510,"Nevada","Carson City",2,31,777,441,336
050,32,510,"Nevada","Carson City",2,32,792,441,351
050,32,510,"Nevada","Carson City",2,33,791,443,348
050,32,510,"Nevada","Carson City",2,34,766,440,326
050,32,510,"Nevada","Carson City",2,35,735,410,325
050,32,510,"Nevada","Carson City",2,36,724,408,316
050,32,510,"Nevada","Carson City",2,37,710,402,308
050,32,510,"Nevada","Carson City",2,38,711,395,316
050,32,510,"Nevada","Carson City",2,39,690,375,315
050,32,510,"Nevada","Carson City",2,40,697,371,326
050,32,510,"Nevada","Carson City",2,41,668,367,301
050,32,510,"Nevada","Carson City",2,42,662,375,287
050,32,510,"Nevada","Carson City",2,43,668,379,289
050,32,510,"Nevada","Carson City",2,44,622,355,267
050,32,510,"Nevada","Carson City",2,45,625,353,272
050,32,510,"Nevada","Carson City",2,46,635,353,282
050,32,510,"Nevada","Carson City",2,47,659,367,292
050,32,510,"Nevada","Carson City",2,48,708,382,326
050,32,510,"Nevada","Carson City",2,49,766,409,357
050,32,510,"Nevada","Carson City",2,50,751,433,318
050,32,510,"Nevada","Carson City",2,51,726,404,322
050,32,510,"Nevada","Carson City",2,52,718,390,328
050,32,510,"Nevada","Carson City",2,53,747,413,334
050,32,510,"Nevada","Carson City",2,54,793,444,349
050,32,510,"Nevada","Carson City",2,55,789,420,369
050,32,510,"Nevada","Carson City",2,56,803,404,399
050,32,510,"Nevada","Carson City",2,57,836,422,414
050,32,510,"Nevada","Carson City",2,58,845,424,421
050,32,510,"Nevada","Carson City",2,59,877,436,441
050,32,510,"Nevada","Carson City",2,60,871,439,432
050,32,510,"Nevada","Carson City",2,61,849,424,425
050,32,510,"Nevada","Carson City",2,62,883,448,435
050,32,510,"Nevada","Carson City",2,63,881,436,445
050,32,510,"Nevada","Carson City",2,64,824,408,416
050,32,510,"Nevada","Carson City",2,65,789,380,409
050,32,510,"Nevada","Carson City",2,66,779,365,414
050,32,510,"Nevada","Carson City",2,67,763,363,400
050,32,510,"Nevada","Carson City",2,68,763,370,393
050,32,510,"Nevada","Carson City",2,69,719,347,372
050,32,510,"Nevada","Carson City",2,70,693,332,361
050,32,510,"Nevada","Carson City",2,71,673,321,352
050,32,510,"Nevada","Carson City",2,72,687,327,360
050,32,510,"Nevada","Carson City",2,73,764,368,396
050,32,510,"Nevada","Carson City",2,74,519,254,265
050,32,510,"Nevada","Carson City",2,75,532,255,277
050,32,510,"Nevada","Carson City",2,76,492,231,261
050,32,510,"Nevada","Carson City",2,77,489,234,255
050,32,510,"Nevada","Carson City",2,78,423,194,229
050,32,510,"Nevada","Carson City",2,79,373,173,200
050,32,510,"Nevada","Carson City",2,80,337,163,174
050,32,510,"Nevada","Carson City",2,81,295,135,160
050,32,510,"Nevada","Carson City",2,82,285,122,163
050,32,510,"Nevada","Carson City",2,83,254,104,150
050,32,510,"Nevada","Carson City",2,84,222,94,128
050,32,510,"Nevada","Carson City",2,85,1189,441,748
050,32,510,"Nevada","Carson City",3,0,503,246,257
050,32,510,"Nevada","Carson City",3,1,624,323,301
050,32,510,"Nevada","Carson City",3,2,595,299,296
050,32,510,"Nevada","Carson City",3,3,650,324,326
050,32,510,"Nevada","Carson City",3,4,656,328,328
050,32,510,"Nevada","Carson City",3,5,651,321,330
050,32,510,"Nevada","Carson City",3,6,683,348,335
050,32,510,"Nevada","Carson City",3,7,630,317,313
050,32,510,"Nevada","Carson City",3,8,632,312,320
050,32,510,"Nevada","Carson City",3,9,635,318,317
050,32,510,"Nevada","Carson City",3,10,629,312,317
050,32,510,"Nevada","Carson City",3,11,617,311,306
050,32,510,"Nevada","Carson City",3,12,695,343,352
050,32,510,"Nevada","Carson City",3,13,737,382,355
050,32,510,"Nevada","Carson City",3,14,726,364,362
050,32,510,"Nevada","Carson City",3,15,735,370,365
050,32,510,"Nevada","Carson City",3,16,696,369,327
050,32,510,"Nevada","Carson City",3,17,692,366,326
050,32,510,"Nevada","Carson City",3,18,612,318,294
050,32,510,"Nevada","Carson City",3,19,558,290,268
050,32,510,"Nevada","Carson City",3,20,590,295,295
050,32,510,"Nevada","Carson City",3,21,657,358,299
050,32,510,"Nevada","Carson City",3,22,674,378,296
050,32,510,"Nevada","Carson City",3,23,655,365,290
050,32,510,"Nevada","Carson City",3,24,657,376,281
050,32,510,"Nevada","Carson City",3,25,678,377,301
050,32,510,"Nevada","Carson City",3,26,756,404,352
050,32,510,"Nevada","Carson City",3,27,770,429,341
050,32,510,"Nevada","Carson City",3,28,790,432,358
050,32,510,"Nevada","Carson City",3,29,813,469,344
050,32,510,"Nevada","Carson City",3,30,834,470,364
050,32,510,"Nevada","Carson City",3,31,834,472,362
050,32,510,"Nevada","Carson City",3,32,777,443,334
050,32,510,"Nevada","Carson City",3,33,793,433,360
050,32,510,"Nevada","Carson City",3,34,793,436,357
050,32,510,"Nevada","Carson City",3,35,775,444,331
050,32,510,"Nevada","Carson City",3,36,765,442,323
050,32,510,"Nevada","Carson City",3,37,749,424,325
050,32,510,"Nevada","Carson City",3,38,714,405,309
050,32,510,"Nevada","Carson City",3,39,711,398,313
050,32,510,"Nevada","Carson City",3,40,681,368,313
050,32,510,"Nevada","Carson City",3,41,731,391,340
050,32,510,"Nevada","Carson City",3,42,671,365,306
050,32,510,"Nevada","Carson City",3,43,688,400,288
050,32,510,"Nevada","Carson City",3,44,642,361,281
050,32,510,"Nevada","Carson City",3,45,626,355,271
050,32,510,"Nevada","Carson City",3,46,633,356,277
050,32,510,"Nevada","Carson City",3,47,649,361,288
050,32,510,"Nevada","Carson City",3,48,662,367,295
050,32,510,"Nevada","Carson City",3,49,710,363,347
050,32,510,"Nevada","Carson City",3,50,742,402,340
050,32,510,"Nevada","Carson City",3,51,751,420,331
050,32,510,"Nevada","Carson City",3,52,724,396,328
050,32,510,"Nevada","Carson City",3,53,714,400,314
050,32,510,"Nevada","Carson City",3,54,768,427,341
050,32,510,"Nevada","Carson City",3,55,764,411,353
050,32,510,"Nevada","Carson City",3,56,793,421,372
050,32,510,"Nevada","Carson City",3,57,783,406,377
050,32,510,"Nevada","Carson City",3,58,853,428,425
050,32,510,"Nevada","Carson City",3,59,863,428,435
050,32,510,"Nevada","Carson City",3,60,861,424,437
050,32,510,"Nevada","Carson City",3,61,892,454,438
050,32,510,"Nevada","Carson City",3,62,866,428,438
050,32,510,"Nevada","Carson City",3,63,852,421,431
050,32,510,"Nevada","Carson City",3,64,866,417,449
050,32,510,"Nevada","Carson City",3,65,808,402,406
050,32,510,"Nevada","Carson City",3,66,786,377,409
050,32,510,"Nevada","Carson City",3,67,770,365,405
050,32,510,"Nevada","Carson City",3,68,748,350,398
050,32,510,"Nevada","Carson City",3,69,767,372,395
050,32,510,"Nevada","Carson City",3,70,704,331,373
050,32,510,"Nevada","Carson City",3,71,672,322,350
050,32,510,"Nevada","Carson City",3,72,666,313,353
050,32,510,"Nevada","Carson City",3,73,675,318,357
050,32,510,"Nevada","Carson City",3,74,741,351,390
050,32,510,"Nevada","Carson City",3,75,503,235,268
050,32,510,"Nevada","Carson City",3,76,502,232,270
050,32,510,"Nevada","Carson City",3,77,486,227,259
050,32,510,"Nevada","Carson City",3,78,465,214,251
050,32,510,"Nevada","Carson City",3,79,405,194,211
050,32,510,"Nevada","Carson City",3,80,343,156,187
050,32,510,"Nevada","Carson City",3,81,307,142,165
050,32,510,"Nevada","Carson City",3,82,275,124,151
050,32,510,"Nevada","Carson City",3,83,246,109,137
050,32,510,"Nevada","Carson City",3,84,229,99,130
050,32,510,"Nevada","Carson City",3,85,1140,434,706
050,32,510,"Nevada","Carson City",4,0,522,254,268
050,32,510,"Nevada","Carson City",4,1,506,245,261
050,32,510,"Nevada","Carson City",4,2,621,314,307
050,32,510,"Nevada","Carson City",4,3,620,311,309
050,32,510,"Nevada","Carson City",4,4,661,310,351
050,32,510,"Nevada","Carson City",4,5,652,324,328
050,32,510,"Nevada","Carson City",4,6,678,343,335
050,32,510,"Nevada","Carson City",4,7,679,343,336
050,32,510,"Nevada","Carson City",4,8,617,318,299
050,32,510,"Nevada","Carson City",4,9,648,326,322
050,32,510,"Nevada","Carson City",4,10,628,321,307
050,32,510,"Nevada","Carson City",4,11,633,317,316
050,32,510,"Nevada","Carson City",4,12,636,331,305
050,32,510,"Nevada","Carson City",4,13,683,334,349
050,32,510,"Nevada","Carson City",4,14,742,386,356
050,32,510,"Nevada","Carson City",4,15,718,367,351
050,32,510,"Nevada","Carson City",4,16,722,370,352
050,32,510,"Nevada","Carson City",4,17,698,372,326
050,32,510,"Nevada","Carson City",4,18,608,325,283
050,32,510,"Nevada","Carson City",4,19,537,290,247
050,32,510,"Nevada","Carson City",4,20,612,315,297
050,32,510,"Nevada","Carson City",4,21,631,312,319
050,32,510,"Nevada","Carson City",4,22,689,378,311
050,32,510,"Nevada","Carson City",4,23,723,393,330
050,32,510,"Nevada","Carson City",4,24,678,379,299
050,32,510,"Nevada","Carson City",4,25,665,373,292
050,32,510,"Nevada","Carson City",4,26,683,366,317
050,32,510,"Nevada","Carson City",4,27,774,420,354
050,32,510,"Nevada","Carson City",4,28,757,414,343
050,32,510,"Nevada","Carson City",4,29,774,426,348
050,32,510,"Nevada","Carson City",4,30,778,450,328
050,32,510,"Nevada","Carson City",4,31,855,463,392
050,32,510,"Nevada","Carson City",4,32,821,455,366
050,32,510,"Nevada","Carson City",4,33,810,451,359
050,32,510,"Nevada","Carson City",4,34,773,422,351
050,32,510,"Nevada","Carson City",4,35,745,398,347
050,32,510,"Nevada","Carson City",4,36,766,430,336
050,32,510,"Nevada","Carson City",4,37,748,437,311
050,32,510,"Nevada","Carson City",4,38,718,407,311
050,32,510,"Nevada","Carson City",4,39,704,395,309
050,32,510,"Nevada","Carson City",4,40,678,372,306
050,32,510,"Nevada","Carson City",4,41,711,384,327
050,32,510,"Nevada","Carson City",4,42,714,375,339
050,32,510,"Nevada","Carson City",4,43,682,369,313
050,32,510,"Nevada","Carson City",4,44,655,382,273
050,32,510,"Nevada","Carson City",4,45,644,352,292
050,32,510,"Nevada","Carson City",4,46,631,348,283
050,32,510,"Nevada","Carson City",4,47,630,351,279
050,32,510,"Nevada","Carson City",4,48,621,341,280
050,32,510,"Nevada","Carson City",4,49,640,330,310
050,32,510,"Nevada","Carson City",4,50,707,365,342
050,32,510,"Nevada","Carson City",4,51,728,388,340
050,32,510,"Nevada","Carson City",4,52,730,406,324
050,32,510,"Nevada","Carson City",4,53,716,381,335
050,32,510,"Nevada","Carson City",4,54,718,394,324
050,32,510,"Nevada","Carson City",4,55,718,393,325
050,32,510,"Nevada","Carson City",4,56,746,398,348
050,32,510,"Nevada","Carson City",4,57,773,409,364
050,32,510,"Nevada","Carson City",4,58,758,372,386
050,32,510,"Nevada","Carson City",4,59,836,422,414
050,32,510,"Nevada","Carson City",4,60,839,414,425
050,32,510,"Nevada","Carson City",4,61,859,424,435
050,32,510,"Nevada","Carson City",4,62,867,445,422
050,32,510,"Nevada","Carson City",4,63,832,398,434
050,32,510,"Nevada","Carson City",4,64,835,392,443
050,32,510,"Nevada","Carson City",4,65,850,393,457
050,32,510,"Nevada","Carson City",4,66,789,400,389
050,32,510,"Nevada","Carson City",4,67,754,365,389
050,32,510,"Nevada","Carson City",4,68,748,358,390
050,32,510,"Nevada","Carson City",4,69,752,353,399
050,32,510,"Nevada","Carson City",4,70,748,347,401
050,32,510,"Nevada","Carson City",4,71,658,316,342
050,32,510,"Nevada","Carson City",4,72,648,305,343
050,32,510,"Nevada","Carson City",4,73,638,300,338
050,32,510,"Nevada","Carson City",4,74,652,299,353
050,32,510,"Nevada","Carson City",4,75,701,324,377
050,32,510,"Nevada","Carson City",4,76,468,218,250
050,32,510,"Nevada","Carson City",4,77,477,225,252
050,32,510,"Nevada","Carson City",4,78,444,203,241
050,32,510,"Nevada","Carson City",4,79,441,208,233
050,32,510,"Nevada","Carson City",4,80,373,175,198
050,32,510,"Nevada","Carson City",4,81,298,134,164
050,32,510,"Nevada","Carson City",4,82,278,122,156
050,32,510,"Nevada","Carson City",4,83,239,103,136
050,32,510,"Nevada","Carson City",4,84,220,104,116
050,32,510,"Nevada","Carson City",4,85,1108,443,665
050,32,510,"Nevada","Carson City",5,0,516,251,265
050,32,510,"Nevada","Carson City",5,1,557,284,273
050,32,510,"Nevada","Carson City",5,2,487,231,256
050,32,510,"Nevada","Carson City",5,3,630,314,316
050,32,510,"Nevada","Carson City",5,4,600,295,305
050,32,510,"Nevada","Carson City",5,5,626,298,328
050,32,510,"Nevada","Carson City",5,6,645,318,327
050,32,510,"Nevada","Carson City",5,7,674,350,324
050,32,510,"Nevada","Carson City",5,8,682,342,340
050,32,510,"Nevada","Carson City",5,9,631,329,302
050,32,510,"Nevada","Carson City",5,10,653,323,330
050,32,510,"Nevada","Carson City",5,11,634,330,304
050,32,510,"Nevada","Carson City",5,12,638,315,323
050,32,510,"Nevada","Carson City",5,13,632,331,301
050,32,510,"Nevada","Carson City",5,14,673,319,354
050,32,510,"Nevada","Carson City",5,15,743,377,366
050,32,510,"Nevada","Carson City",5,16,711,371,340
050,32,510,"Nevada","Carson City",5,17,729,374,355
050,32,510,"Nevada","Carson City",5,18,615,332,283
050,32,510,"Nevada","Carson City",5,19,531,287,244
050,32,510,"Nevada","Carson City",5,20,571,314,257
050,32,510,"Nevada","Carson City",5,21,634,323,311
050,32,510,"Nevada","Carson City",5,22,652,344,308
050,32,510,"Nevada","Carson City",5,23,711,398,313
050,32,510,"Nevada","Carson City",5,24,734,396,338
050,32,510,"Nevada","Carson City",5,25,690,384,306
050,32,510,"Nevada","Carson City",5,26,687,375,312
050,32,510,"Nevada","Carson City",5,27,710,396,314
050,32,510,"Nevada","Carson City",5,28,781,427,354
050,32,510,"Nevada","Carson City",5,29,791,447,344
050,32,510,"Nevada","Carson City",5,30,780,417,363
050,32,510,"Nevada","Carson City",5,31,802,463,339
050,32,510,"Nevada","Carson City",5,32,860,474,386
050,32,510,"Nevada","Carson City",5,33,807,452,355
050,32,510,"Nevada","Carson City",5,34,832,468,364
050,32,510,"Nevada","Carson City",5,35,772,421,351
050,32,510,"Nevada","Carson City",5,36,780,421,359
050,32,510,"Nevada","Carson City",5,37,804,463,341
050,32,510,"Nevada","Carson City",5,38,752,445,307
050,32,510,"Nevada","Carson City",5,39,726,408,318
050,32,510,"Nevada","Carson City",5,40,696,388,308
050,32,510,"Nevada","Carson City",5,41,706,399,307
050,32,510,"Nevada","Carson City",5,42,697,370,327
050,32,510,"Nevada","Carson City",5,43,729,379,350
050,32,510,"Nevada","Carson City",5,44,666,358,308
050,32,510,"Nevada","Carson City",5,45,679,391,288
050,32,510,"Nevada","Carson City",5,46,643,358,285
050,32,510,"Nevada","Carson City",5,47,629,359,270
050,32,510,"Nevada","Carson City",5,48,632,353,279
050,32,510,"Nevada","Carson City",5,49,627,325,302
050,32,510,"Nevada","Carson City",5,50,622,329,293
050,32,510,"Nevada","Carson City",5,51,702,358,344
050,32,510,"Nevada","Carson City",5,52,736,398,338
050,32,510,"Nevada","Carson City",5,53,741,412,329
050,32,510,"Nevada","Carson City",5,54,715,380,335
050,32,510,"Nevada","Carson City",5,55,692,378,314
050,32,510,"Nevada","Carson City",5,56,714,388,326
050,32,510,"Nevada","Carson City",5,57,749,397,352
050,32,510,"Nevada","Carson City",5,58,773,393,380
050,32,510,"Nevada","Carson City",5,59,781,392,389
050,32,510,"Nevada","Carson City",5,60,816,410,406
050,32,510,"Nevada","Carson City",5,61,824,415,409
050,32,510,"Nevada","Carson City",5,62,873,440,433
050,32,510,"Nevada","Carson City",5,63,861,440,421
050,32,510,"Nevada","Carson City",5,64,821,392,429
050,32,510,"Nevada","Carson City",5,65,816,375,441
050,32,510,"Nevada","Carson City",5,66,841,386,455
050,32,510,"Nevada","Carson City",5,67,780,393,387
050,32,510,"Nevada","Carson City",5,68,748,362,386
050,32,510,"Nevada","Carson City",5,69,730,350,380
050,32,510,"Nevada","Carson City",5,70,750,348,402
050,32,510,"Nevada","Carson City",5,71,723,333,390
050,32,510,"Nevada","Carson City",5,72,647,300,347
050,32,510,"Nevada","Carson City",5,73,631,296,335
050,32,510,"Nevada","Carson City",5,74,614,285,329
050,32,510,"Nevada","Carson City",5,75,618,280,338
050,32,510,"Nevada","Carson City",5,76,664,296,368
050,32,510,"Nevada","Carson City",5,77,443,213,230
050,32,510,"Nevada","Carson City",5,78,452,207,245
050,32,510,"Nevada","Carson City",5,79,413,188,225
050,32,510,"Nevada","Carson City",5,80,414,191,223
050,32,510,"Nevada","Carson City",5,81,335,157,178
050,32,510,"Nevada","Carson City",5,82,265,114,151
050,32,510,"Nevada","Carson City",5,83,247,113,134
050,32,510,"Nevada","Carson City",5,84,211,97,114
050,32,510,"Nevada","Carson City",5,85,1087,463,624

