"SUMLEV","STATE","COUNTY","STNAME","CTYNAME","YEAR","AGE","TOT_POP","TOT_MALE","TOT_FEMALE"
050,31,001,"Nebraska","Adams County",1,0,387,201,186
050,31,001,"Nebraska","Adams County",1,1,395,195,200
050,31,001,"Nebraska","Adams County",1,2,411,202,209
050,31,001,"Nebraska","Adams County",1,3,394,215,179
050,31,001,"Nebraska","Adams County",1,4,412,185,227
050,31,001,"Nebraska","Adams County",1,5,426,205,221
050,31,001,"Nebraska","Adams County",1,6,438,222,216
050,31,001,"Nebraska","Adams County",1,7,407,199,208
050,31,001,"Nebraska","Adams County",1,8,383,188,195
050,31,001,"Nebraska","Adams County",1,9,409,197,212
050,31,001,"Nebraska","Adams County",1,10,423,213,210
050,31,001,"Nebraska","Adams County",1,11,419,224,195
050,31,001,"Nebraska","Adams County",1,12,402,214,188
050,31,001,"Nebraska","Adams County",1,13,439,241,198
050,31,001,"Nebraska","Adams County",1,14,440,236,204
050,31,001,"Nebraska","Adams County",1,15,419,206,213
050,31,001,"Nebraska","Adams County",1,16,439,213,226
050,31,001,"Nebraska","Adams County",1,17,432,219,213
050,31,001,"Nebraska","Adams County",1,18,465,230,235
050,31,001,"Nebraska","Adams County",1,19,537,292,245
050,31,001,"Nebraska","Adams County",1,20,530,286,244
050,31,001,"Nebraska","Adams County",1,21,454,244,210
050,31,001,"Nebraska","Adams County",1,22,412,220,192
050,31,001,"Nebraska","Adams County",1,23,376,202,174
050,31,001,"Nebraska","Adams County",1,24,384,190,194
050,31,001,"Nebraska","Adams County",1,25,376,183,193
050,31,001,"Nebraska","Adams County",1,26,420,212,208
050,31,001,"Nebraska","Adams County",1,27,427,207,220
050,31,001,"Nebraska","Adams County",1,28,417,216,201
050,31,001,"Nebraska","Adams County",1,29,400,199,201
050,31,001,"Nebraska","Adams County",1,30,379,191,188
050,31,001,"Nebraska","Adams County",1,31,335,168,167
050,31,001,"Nebraska","Adams County",1,32,331,166,165
050,31,001,"Nebraska","Adams County",1,33,351,186,165
050,31,001,"Nebraska","Adams County",1,34,365,186,179
050,31,001,"Nebraska","Adams County",1,35,367,187,180
050,31,001,"Nebraska","Adams County",1,36,374,203,171
050,31,001,"Nebraska","Adams County",1,37,354,193,161
050,31,001,"Nebraska","Adams County",1,38,342,176,166
050,31,001,"Nebraska","Adams County",1,39,353,184,169
050,31,001,"Nebraska","Adams County",1,40,345,179,166
050,31,001,"Nebraska","Adams County",1,41,317,151,166
050,31,001,"Nebraska","Adams County",1,42,357,165,192
050,31,001,"Nebraska","Adams County",1,43,367,185,182
050,31,001,"Nebraska","Adams County",1,44,326,171,155
050,31,001,"Nebraska","Adams County",1,45,343,189,154
050,31,001,"Nebraska","Adams County",1,46,316,160,156
050,31,001,"Nebraska","Adams County",1,47,321,170,151
050,31,001,"Nebraska","Adams County",1,48,330,171,159
050,31,001,"Nebraska","Adams County",1,49,361,179,182
050,31,001,"Nebraska","Adams County",1,50,340,176,164
050,31,001,"Nebraska","Adams County",1,51,324,159,165
050,31,001,"Nebraska","Adams County",1,52,333,168,165
050,31,001,"Nebraska","Adams County",1,53,363,193,170
050,31,001,"Nebraska","Adams County",1,54,371,178,193
050,31,001,"Nebraska","Adams County",1,55,360,174,186
050,31,001,"Nebraska","Adams County",1,56,384,193,191
050,31,001,"Nebraska","Adams County",1,57,377,188,189
050,31,001,"Nebraska","Adams County",1,58,431,223,208
050,31,001,"Nebraska","Adams County",1,59,462,239,223
050,31,001,"Nebraska","Adams County",1,60,437,223,214
050,31,001,"Nebraska","Adams County",1,61,438,240,198
050,31,001,"Nebraska","Adams County",1,62,421,215,206
050,31,001,"Nebraska","Adams County",1,63,412,206,206
050,31,001,"Nebraska","Adams County",1,64,392,197,195
050,31,001,"Nebraska","Adams County",1,65,396,196,200
050,31,001,"Nebraska","Adams County",1,66,377,184,193
050,31,001,"Nebraska","Adams County",1,67,380,198,182
050,31,001,"Nebraska","Adams County",1,68,374,189,185
050,31,001,"Nebraska","Adams County",1,69,333,156,177
050,31,001,"Nebraska","Adams County",1,70,332,156,176
050,31,001,"Nebraska","Adams County",1,71,320,151,169
050,31,001,"Nebraska","Adams County",1,72,315,147,168
050,31,001,"Nebraska","Adams County",1,73,295,135,160
050,31,001,"Nebraska","Adams County",1,74,209,92,117
050,31,001,"Nebraska","Adams County",1,75,214,103,111
050,31,001,"Nebraska","Adams County",1,76,233,102,131
050,31,001,"Nebraska","Adams County",1,77,226,104,122
050,31,001,"Nebraska","Adams County",1,78,182,82,100
050,31,001,"Nebraska","Adams County",1,79,176,81,95
050,31,001,"Nebraska","Adams County",1,80,148,66,82
050,31,001,"Nebraska","Adams County",1,81,140,59,81
050,31,001,"Nebraska","Adams County",1,82,127,47,80
050,31,001,"Nebraska","Adams County",1,83,116,54,62
050,31,001,"Nebraska","Adams County",1,84,115,45,70
050,31,001,"Nebraska","Adams County",1,85,739,269,470
050,31,001,"Nebraska","Adams County",2,0,391,201,190
050,31,001,"Nebraska","Adams County",2,1,394,195,199
050,31,001,"Nebraska","Adams County",2,2,406,200,206
050,31,001,"Nebraska","Adams County",2,3,394,207,187
050,31,001,"Nebraska","Adams County",2,4,409,191,218
050,31,001,"Nebraska","Adams County",2,5,426,203,223
050,31,001,"Nebraska","Adams County",2,6,435,217,218
050,31,001,"Nebraska","Adams County",2,7,416,207,209
050,31,001,"Nebraska","Adams County",2,8,389,189,200
050,31,001,"Nebraska","Adams County",2,9,405,196,209
050,31,001,"Nebraska","Adams County",2,10,422,209,213
050,31,001,"Nebraska","Adams County",2,11,417,220,197
050,31,001,"Nebraska","Adams County",2,12,411,221,190
050,31,001,"Nebraska","Adams County",2,13,429,235,194
050,31,001,"Nebraska","Adams County",2,14,437,237,200
050,31,001,"Nebraska","Adams County",2,15,425,215,210
050,31,001,"Nebraska","Adams County",2,16,434,210,224
050,31,001,"Nebraska","Adams County",2,17,435,218,217
050,31,001,"Nebraska","Adams County",2,18,462,228,234
050,31,001,"Nebraska","Adams County",2,19,542,292,250
050,31,001,"Nebraska","Adams County",2,20,530,286,244
050,31,001,"Nebraska","Adams County",2,21,460,249,211
050,31,001,"Nebraska","Adams County",2,22,403,215,188
050,31,001,"Nebraska","Adams County",2,23,378,202,176
050,31,001,"Nebraska","Adams County",2,24,375,190,185
050,31,001,"Nebraska","Adams County",2,25,375,180,195
050,31,001,"Nebraska","Adams County",2,26,412,204,208
050,31,001,"Nebraska","Adams County",2,27,422,206,216
050,31,001,"Nebraska","Adams County",2,28,419,211,208
050,31,001,"Nebraska","Adams County",2,29,401,200,201
050,31,001,"Nebraska","Adams County",2,30,389,194,195
050,31,001,"Nebraska","Adams County",2,31,340,169,171
050,31,001,"Nebraska","Adams County",2,32,335,169,166
050,31,001,"Nebraska","Adams County",2,33,344,180,164
050,31,001,"Nebraska","Adams County",2,34,361,185,176
050,31,001,"Nebraska","Adams County",2,35,370,188,182
050,31,001,"Nebraska","Adams County",2,36,369,198,171
050,31,001,"Nebraska","Adams County",2,37,357,195,162
050,31,001,"Nebraska","Adams County",2,38,347,181,166
050,31,001,"Nebraska","Adams County",2,39,350,183,167
050,31,001,"Nebraska","Adams County",2,40,350,181,169
050,31,001,"Nebraska","Adams County",2,41,324,157,167
050,31,001,"Nebraska","Adams County",2,42,344,160,184
050,31,001,"Nebraska","Adams County",2,43,370,183,187
050,31,001,"Nebraska","Adams County",2,44,331,172,159
050,31,001,"Nebraska","Adams County",2,45,342,186,156
050,31,001,"Nebraska","Adams County",2,46,323,167,156
050,31,001,"Nebraska","Adams County",2,47,316,165,151
050,31,001,"Nebraska","Adams County",2,48,327,169,158
050,31,001,"Nebraska","Adams County",2,49,358,179,179
050,31,001,"Nebraska","Adams County",2,50,345,176,169
050,31,001,"Nebraska","Adams County",2,51,326,163,163
050,31,001,"Nebraska","Adams County",2,52,330,166,164
050,31,001,"Nebraska","Adams County",2,53,357,187,170
050,31,001,"Nebraska","Adams County",2,54,365,180,185
050,31,001,"Nebraska","Adams County",2,55,362,174,188
050,31,001,"Nebraska","Adams County",2,56,377,186,191
050,31,001,"Nebraska","Adams County",2,57,374,186,188
050,31,001,"Nebraska","Adams County",2,58,416,214,202
050,31,001,"Nebraska","Adams County",2,59,455,235,220
050,31,001,"Nebraska","Adams County",2,60,439,224,215
050,31,001,"Nebraska","Adams County",2,61,436,236,200
050,31,001,"Nebraska","Adams County",2,62,424,220,204
050,31,001,"Nebraska","Adams County",2,63,413,206,207
050,31,001,"Nebraska","Adams County",2,64,390,196,194
050,31,001,"Nebraska","Adams County",2,65,389,193,196
050,31,001,"Nebraska","Adams County",2,66,379,184,195
050,31,001,"Nebraska","Adams County",2,67,378,194,184
050,31,001,"Nebraska","Adams County",2,68,372,189,183
050,31,001,"Nebraska","Adams County",2,69,342,163,179
050,31,001,"Nebraska","Adams County",2,70,332,156,176
050,31,001,"Nebraska","Adams County",2,71,322,153,169
050,31,001,"Nebraska","Adams County",2,72,309,147,162
050,31,001,"Nebraska","Adams County",2,73,310,144,166
050,31,001,"Nebraska","Adams County",2,74,213,95,118
050,31,001,"Nebraska","Adams County",2,75,213,101,112
050,31,001,"Nebraska","Adams County",2,76,226,100,126
050,31,001,"Nebraska","Adams County",2,77,233,105,128
050,31,001,"Nebraska","Adams County",2,78,188,85,103
050,31,001,"Nebraska","Adams County",2,79,174,80,94
050,31,001,"Nebraska","Adams County",2,80,153,68,85
050,31,001,"Nebraska","Adams County",2,81,140,61,79
050,31,001,"Nebraska","Adams County",2,82,131,50,81
050,31,001,"Nebraska","Adams County",2,83,114,49,65
050,31,001,"Nebraska","Adams County",2,84,112,46,66
050,31,001,"Nebraska","Adams County",2,85,738,272,466
050,31,001,"Nebraska","Adams County",3,0,356,180,176
050,31,001,"Nebraska","Adams County",3,1,403,206,197
050,31,001,"Nebraska","Adams County",3,2,386,198,188
050,31,001,"Nebraska","Adams County",3,3,397,190,207
050,31,001,"Nebraska","Adams County",3,4,398,210,188
050,31,001,"Nebraska","Adams County",3,5,392,184,208
050,31,001,"Nebraska","Adams County",3,6,417,199,218
050,31,001,"Nebraska","Adams County",3,7,436,221,215
050,31,001,"Nebraska","Adams County",3,8,406,207,199
050,31,001,"Nebraska","Adams County",3,9,382,185,197
050,31,001,"Nebraska","Adams County",3,10,407,197,210
050,31,001,"Nebraska","Adams County",3,11,421,207,214
050,31,001,"Nebraska","Adams County",3,12,419,218,201
050,31,001,"Nebraska","Adams County",3,13,413,225,188
050,31,001,"Nebraska","Adams County",3,14,417,227,190
050,31,001,"Nebraska","Adams County",3,15,436,234,202
050,31,001,"Nebraska","Adams County",3,16,434,217,217
050,31,001,"Nebraska","Adams County",3,17,431,211,220
050,31,001,"Nebraska","Adams County",3,18,451,220,231
050,31,001,"Nebraska","Adams County",3,19,541,284,257
050,31,001,"Nebraska","Adams County",3,20,500,262,238
050,31,001,"Nebraska","Adams County",3,21,456,252,204
050,31,001,"Nebraska","Adams County",3,22,395,203,192
050,31,001,"Nebraska","Adams County",3,23,361,187,174
050,31,001,"Nebraska","Adams County",3,24,386,205,181
050,31,001,"Nebraska","Adams County",3,25,365,188,177
050,31,001,"Nebraska","Adams County",3,26,399,203,196
050,31,001,"Nebraska","Adams County",3,27,385,189,196
050,31,001,"Nebraska","Adams County",3,28,392,192,200
050,31,001,"Nebraska","Adams County",3,29,424,212,212
050,31,001,"Nebraska","Adams County",3,30,394,198,196
050,31,001,"Nebraska","Adams County",3,31,364,180,184
050,31,001,"Nebraska","Adams County",3,32,334,163,171
050,31,001,"Nebraska","Adams County",3,33,354,177,177
050,31,001,"Nebraska","Adams County",3,34,336,174,162
050,31,001,"Nebraska","Adams County",3,35,361,192,169
050,31,001,"Nebraska","Adams County",3,36,384,198,186
050,31,001,"Nebraska","Adams County",3,37,374,196,178
050,31,001,"Nebraska","Adams County",3,38,360,201,159
050,31,001,"Nebraska","Adams County",3,39,352,179,173
050,31,001,"Nebraska","Adams County",3,40,349,176,173
050,31,001,"Nebraska","Adams County",3,41,345,177,168
050,31,001,"Nebraska","Adams County",3,42,330,165,165
050,31,001,"Nebraska","Adams County",3,43,354,166,188
050,31,001,"Nebraska","Adams County",3,44,367,178,189
050,31,001,"Nebraska","Adams County",3,45,328,169,159
050,31,001,"Nebraska","Adams County",3,46,340,184,156
050,31,001,"Nebraska","Adams County",3,47,322,164,158
050,31,001,"Nebraska","Adams County",3,48,313,163,150
050,31,001,"Nebraska","Adams County",3,49,320,164,156
050,31,001,"Nebraska","Adams County",3,50,358,183,175
050,31,001,"Nebraska","Adams County",3,51,343,177,166
050,31,001,"Nebraska","Adams County",3,52,331,166,165
050,31,001,"Nebraska","Adams County",3,53,319,158,161
050,31,001,"Nebraska","Adams County",3,54,348,182,166
050,31,001,"Nebraska","Adams County",3,55,358,178,180
050,31,001,"Nebraska","Adams County",3,56,353,164,189
050,31,001,"Nebraska","Adams County",3,57,373,186,187
050,31,001,"Nebraska","Adams County",3,58,370,187,183
050,31,001,"Nebraska","Adams County",3,59,415,210,205
050,31,001,"Nebraska","Adams County",3,60,446,226,220
050,31,001,"Nebraska","Adams County",3,61,441,223,218
050,31,001,"Nebraska","Adams County",3,62,435,232,203
050,31,001,"Nebraska","Adams County",3,63,420,219,201
050,31,001,"Nebraska","Adams County",3,64,403,201,202
050,31,001,"Nebraska","Adams County",3,65,394,193,201
050,31,001,"Nebraska","Adams County",3,66,390,195,195
050,31,001,"Nebraska","Adams County",3,67,378,183,195
050,31,001,"Nebraska","Adams County",3,68,375,190,185
050,31,001,"Nebraska","Adams County",3,69,363,183,180
050,31,001,"Nebraska","Adams County",3,70,336,155,181
050,31,001,"Nebraska","Adams County",3,71,324,152,172
050,31,001,"Nebraska","Adams County",3,72,313,150,163
050,31,001,"Nebraska","Adams County",3,73,294,139,155
050,31,001,"Nebraska","Adams County",3,74,295,137,158
050,31,001,"Nebraska","Adams County",3,75,209,94,115
050,31,001,"Nebraska","Adams County",3,76,213,101,112
050,31,001,"Nebraska","Adams County",3,77,216,93,123
050,31,001,"Nebraska","Adams County",3,78,223,96,127
050,31,001,"Nebraska","Adams County",3,79,173,78,95
050,31,001,"Nebraska","Adams County",3,80,163,73,90
050,31,001,"Nebraska","Adams County",3,81,146,63,83
050,31,001,"Nebraska","Adams County",3,82,131,58,73
050,31,001,"Nebraska","Adams County",3,83,127,47,80
050,31,001,"Nebraska","Adams County",3,84,102,45,57
050,31,001,"Nebraska","Adams County",3,85,702,267,435
050,31,001,"Nebraska","Adams County",4,0,377,194,183
050,31,001,"Nebraska","Adams County",4,1,390,195,195
050,31,001,"Nebraska","Adams County",4,2,393,200,193
050,31,001,"Nebraska","Adams County",4,3,378,190,188
050,31,001,"Nebraska","Adams County",4,4,388,192,196
050,31,001,"Nebraska","Adams County",4,5,398,211,187
050,31,001,"Nebraska","Adams County",4,6,418,195,223
050,31,001,"Nebraska","Adams County",4,7,428,208,220
050,31,001,"Nebraska","Adams County",4,8,442,229,213
050,31,001,"Nebraska","Adams County",4,9,412,213,199
050,31,001,"Nebraska","Adams County",4,10,373,184,189
050,31,001,"Nebraska","Adams County",4,11,415,200,215
050,31,001,"Nebraska","Adams County",4,12,415,209,206
050,31,001,"Nebraska","Adams County",4,13,409,209,200
050,31,001,"Nebraska","Adams County",4,14,410,219,191
050,31,001,"Nebraska","Adams County",4,15,424,236,188
050,31,001,"Nebraska","Adams County",4,16,440,241,199
050,31,001,"Nebraska","Adams County",4,17,446,226,220
050,31,001,"Nebraska","Adams County",4,18,456,221,235
050,31,001,"Nebraska","Adams County",4,19,517,278,239
050,31,001,"Nebraska","Adams County",4,20,514,267,247
050,31,001,"Nebraska","Adams County",4,21,443,244,199
050,31,001,"Nebraska","Adams County",4,22,410,223,187
050,31,001,"Nebraska","Adams County",4,23,368,176,192
050,31,001,"Nebraska","Adams County",4,24,349,170,179
050,31,001,"Nebraska","Adams County",4,25,353,191,162
050,31,001,"Nebraska","Adams County",4,26,345,182,163
050,31,001,"Nebraska","Adams County",4,27,387,191,196
050,31,001,"Nebraska","Adams County",4,28,379,182,197
050,31,001,"Nebraska","Adams County",4,29,395,194,201
050,31,001,"Nebraska","Adams County",4,30,432,224,208
050,31,001,"Nebraska","Adams County",4,31,375,184,191
050,31,001,"Nebraska","Adams County",4,32,370,187,183
050,31,001,"Nebraska","Adams County",4,33,357,179,178
050,31,001,"Nebraska","Adams County",4,34,341,167,174
050,31,001,"Nebraska","Adams County",4,35,331,173,158
050,31,001,"Nebraska","Adams County",4,36,365,198,167
050,31,001,"Nebraska","Adams County",4,37,379,197,182
050,31,001,"Nebraska","Adams County",4,38,377,197,180
050,31,001,"Nebraska","Adams County",4,39,378,211,167
050,31,001,"Nebraska","Adams County",4,40,364,176,188
050,31,001,"Nebraska","Adams County",4,41,356,175,181
050,31,001,"Nebraska","Adams County",4,42,347,185,162
050,31,001,"Nebraska","Adams County",4,43,328,163,165
050,31,001,"Nebraska","Adams County",4,44,351,163,188
050,31,001,"Nebraska","Adams County",4,45,367,182,185
050,31,001,"Nebraska","Adams County",4,46,328,166,162
050,31,001,"Nebraska","Adams County",4,47,325,177,148
050,31,001,"Nebraska","Adams County",4,48,309,157,152
050,31,001,"Nebraska","Adams County",4,49,303,151,152
050,31,001,"Nebraska","Adams County",4,50,321,162,159
050,31,001,"Nebraska","Adams County",4,51,358,186,172
050,31,001,"Nebraska","Adams County",4,52,347,179,168
050,31,001,"Nebraska","Adams County",4,53,329,167,162
050,31,001,"Nebraska","Adams County",4,54,318,151,167
050,31,001,"Nebraska","Adams County",4,55,343,179,164
050,31,001,"Nebraska","Adams County",4,56,377,186,191
050,31,001,"Nebraska","Adams County",4,57,346,161,185
050,31,001,"Nebraska","Adams County",4,58,367,181,186
050,31,001,"Nebraska","Adams County",4,59,373,185,188
050,31,001,"Nebraska","Adams County",4,60,407,204,203
050,31,001,"Nebraska","Adams County",4,61,442,227,215
050,31,001,"Nebraska","Adams County",4,62,421,211,210
050,31,001,"Nebraska","Adams County",4,63,422,228,194
050,31,001,"Nebraska","Adams County",4,64,411,212,199
050,31,001,"Nebraska","Adams County",4,65,403,200,203
050,31,001,"Nebraska","Adams County",4,66,383,185,198
050,31,001,"Nebraska","Adams County",4,67,398,199,199
050,31,001,"Nebraska","Adams County",4,68,378,183,195
050,31,001,"Nebraska","Adams County",4,69,374,189,185
050,31,001,"Nebraska","Adams County",4,70,356,182,174
050,31,001,"Nebraska","Adams County",4,71,329,149,180
050,31,001,"Nebraska","Adams County",4,72,319,147,172
050,31,001,"Nebraska","Adams County",4,73,299,138,161
050,31,001,"Nebraska","Adams County",4,74,297,141,156
050,31,001,"Nebraska","Adams County",4,75,280,130,150
050,31,001,"Nebraska","Adams County",4,76,205,92,113
050,31,001,"Nebraska","Adams County",4,77,205,97,108
050,31,001,"Nebraska","Adams County",4,78,213,96,117
050,31,001,"Nebraska","Adams County",4,79,206,88,118
050,31,001,"Nebraska","Adams County",4,80,170,77,93
050,31,001,"Nebraska","Adams County",4,81,158,68,90
050,31,001,"Nebraska","Adams County",4,82,128,58,70
050,31,001,"Nebraska","Adams County",4,83,131,56,75
050,31,001,"Nebraska","Adams County",4,84,114,40,74
050,31,001,"Nebraska","Adams County",4,85,664,258,406
050,31,001,"Nebraska","Adams County",5,0,384,194,190
050,31,001,"Nebraska","Adams County",5,1,388,192,196
050,31,001,"Nebraska","Adams County",5,2,373,186,187
050,31,001,"Nebraska","Adams County",5,3,411,203,208
050,31,001,"Nebraska","Adams County",5,4,369,185,184
050,31,001,"Nebraska","Adams County",5,5,382,189,193
050,31,001,"Nebraska","Adams County",5,6,384,196,188
050,31,001,"Nebraska","Adams County",5,7,431,216,215
050,31,001,"Nebraska","Adams County",5,8,424,208,216
050,31,001,"Nebraska","Adams County",5,9,431,230,201
050,31,001,"Nebraska","Adams County",5,10,406,213,193
050,31,001,"Nebraska","Adams County",5,11,379,182,197
050,31,001,"Nebraska","Adams County",5,12,418,197,221
050,31,001,"Nebraska","Adams County",5,13,424,211,213
050,31,001,"Nebraska","Adams County",5,14,414,215,199
050,31,001,"Nebraska","Adams County",5,15,420,229,191
050,31,001,"Nebraska","Adams County",5,16,422,230,192
050,31,001,"Nebraska","Adams County",5,17,461,260,201
050,31,001,"Nebraska","Adams County",5,18,463,230,233
050,31,001,"Nebraska","Adams County",5,19,529,276,253
050,31,001,"Nebraska","Adams County",5,20,516,269,247
050,31,001,"Nebraska","Adams County",5,21,475,257,218
050,31,001,"Nebraska","Adams County",5,22,391,208,183
050,31,001,"Nebraska","Adams County",5,23,373,193,180
050,31,001,"Nebraska","Adams County",5,24,364,182,182
050,31,001,"Nebraska","Adams County",5,25,335,174,161
050,31,001,"Nebraska","Adams County",5,26,346,182,164
050,31,001,"Nebraska","Adams County",5,27,332,169,163
050,31,001,"Nebraska","Adams County",5,28,379,184,195
050,31,001,"Nebraska","Adams County",5,29,379,191,188
050,31,001,"Nebraska","Adams County",5,30,383,183,200
050,31,001,"Nebraska","Adams County",5,31,423,212,211
050,31,001,"Nebraska","Adams County",5,32,386,185,201
050,31,001,"Nebraska","Adams County",5,33,365,180,185
050,31,001,"Nebraska","Adams County",5,34,357,178,179
050,31,001,"Nebraska","Adams County",5,35,344,164,180
050,31,001,"Nebraska","Adams County",5,36,351,185,166
050,31,001,"Nebraska","Adams County",5,37,364,196,168
050,31,001,"Nebraska","Adams County",5,38,390,198,192
050,31,001,"Nebraska","Adams County",5,39,371,195,176
050,31,001,"Nebraska","Adams County",5,40,369,203,166
050,31,001,"Nebraska","Adams County",5,41,353,167,186
050,31,001,"Nebraska","Adams County",5,42,341,170,171
050,31,001,"Nebraska","Adams County",5,43,354,186,168
050,31,001,"Nebraska","Adams County",5,44,322,162,160
050,31,001,"Nebraska","Adams County",5,45,360,172,188
050,31,001,"Nebraska","Adams County",5,46,368,178,190
050,31,001,"Nebraska","Adams County",5,47,336,171,165
050,31,001,"Nebraska","Adams County",5,48,327,180,147
050,31,001,"Nebraska","Adams County",5,49,296,149,147
050,31,001,"Nebraska","Adams County",5,50,296,148,148
050,31,001,"Nebraska","Adams County",5,51,319,160,159
050,31,001,"Nebraska","Adams County",5,52,357,185,172
050,31,001,"Nebraska","Adams County",5,53,340,170,170
050,31,001,"Nebraska","Adams County",5,54,324,165,159
050,31,001,"Nebraska","Adams County",5,55,311,146,165
050,31,001,"Nebraska","Adams County",5,56,332,167,165
050,31,001,"Nebraska","Adams County",5,57,363,179,184
050,31,001,"Nebraska","Adams County",5,58,342,162,180
050,31,001,"Nebraska","Adams County",5,59,363,179,184
050,31,001,"Nebraska","Adams County",5,60,369,183,186
050,31,001,"Nebraska","Adams County",5,61,405,204,201
050,31,001,"Nebraska","Adams County",5,62,434,219,215
050,31,001,"Nebraska","Adams County",5,63,422,214,208
050,31,001,"Nebraska","Adams County",5,64,423,230,193
050,31,001,"Nebraska","Adams County",5,65,412,211,201
050,31,001,"Nebraska","Adams County",5,66,394,191,203
050,31,001,"Nebraska","Adams County",5,67,374,179,195
050,31,001,"Nebraska","Adams County",5,68,396,198,198
050,31,001,"Nebraska","Adams County",5,69,376,177,199
050,31,001,"Nebraska","Adams County",5,70,365,182,183
050,31,001,"Nebraska","Adams County",5,71,351,173,178
050,31,001,"Nebraska","Adams County",5,72,321,148,173
050,31,001,"Nebraska","Adams County",5,73,307,133,174
050,31,001,"Nebraska","Adams County",5,74,293,136,157
050,31,001,"Nebraska","Adams County",5,75,284,135,149
050,31,001,"Nebraska","Adams County",5,76,268,124,144
050,31,001,"Nebraska","Adams County",5,77,198,89,109
050,31,001,"Nebraska","Adams County",5,78,199,94,105
050,31,001,"Nebraska","Adams County",5,79,195,88,107
050,31,001,"Nebraska","Adams County",5,80,200,86,114
050,31,001,"Nebraska","Adams County",5,81,161,70,91
050,31,001,"Nebraska","Adams County",5,82,145,67,78
050,31,001,"Nebraska","Adams County",5,83,125,57,68
050,31,001,"Nebraska","Adams County",5,84,120,53,67
050,31,001,"Nebraska","Adams County",5,85,652,253,399
050,31,003,"Nebraska","Antelope County",1,0,83,42,41
050,31,003,"Nebraska","Antelope County",1,1,87,43,44
050,31,003,"Nebraska","Antelope County",1,2,88,42,46
050,31,003,"Nebraska","Antelope County",1,3,90,47,43
050,31,003,"Nebraska","Antelope County",1,4,78,44,34
050,31,003,"Nebraska","Antelope County",1,5,81,40,41
050,31,003,"Nebraska","Antelope County",1,6,91,40,51
050,31,003,"Nebraska","Antelope County",1,7,84,48,36
050,31,003,"Nebraska","Antelope County",1,8,80,51,29
050,31,003,"Nebraska","Antelope County",1,9,87,49,38
050,31,003,"Nebraska","Antelope County",1,10,94,52,42
050,31,003,"Nebraska","Antelope County",1,11,87,40,47
050,31,003,"Nebraska","Antelope County",1,12,82,38,44
050,31,003,"Nebraska","Antelope County",1,13,82,44,38
050,31,003,"Nebraska","Antelope County",1,14,86,45,41
050,31,003,"Nebraska","Antelope County",1,15,76,38,38
050,31,003,"Nebraska","Antelope County",1,16,86,42,44
050,31,003,"Nebraska","Antelope County",1,17,76,43,33
050,31,003,"Nebraska","Antelope County",1,18,63,37,26
050,31,003,"Nebraska","Antelope County",1,19,53,27,26
050,31,003,"Nebraska","Antelope County",1,20,56,26,30
050,31,003,"Nebraska","Antelope County",1,21,64,29,35
050,31,003,"Nebraska","Antelope County",1,22,67,39,28
050,31,003,"Nebraska","Antelope County",1,23,63,32,31
050,31,003,"Nebraska","Antelope County",1,24,58,28,30
050,31,003,"Nebraska","Antelope County",1,25,77,41,36
050,31,003,"Nebraska","Antelope County",1,26,71,39,32
050,31,003,"Nebraska","Antelope County",1,27,64,33,31
050,31,003,"Nebraska","Antelope County",1,28,72,43,29
050,31,003,"Nebraska","Antelope County",1,29,56,30,26
050,31,003,"Nebraska","Antelope County",1,30,50,23,27
050,31,003,"Nebraska","Antelope County",1,31,49,26,23
050,31,003,"Nebraska","Antelope County",1,32,54,25,29
050,31,003,"Nebraska","Antelope County",1,33,67,30,37
050,31,003,"Nebraska","Antelope County",1,34,59,31,28
050,31,003,"Nebraska","Antelope County",1,35,71,38,33
050,31,003,"Nebraska","Antelope County",1,36,79,42,37
050,31,003,"Nebraska","Antelope County",1,37,75,44,31
050,31,003,"Nebraska","Antelope County",1,38,74,43,31
050,31,003,"Nebraska","Antelope County",1,39,66,37,29
050,31,003,"Nebraska","Antelope County",1,40,69,37,32
050,31,003,"Nebraska","Antelope County",1,41,60,31,29
050,31,003,"Nebraska","Antelope County",1,42,64,38,26
050,31,003,"Nebraska","Antelope County",1,43,57,32,25
050,31,003,"Nebraska","Antelope County",1,44,50,26,24
050,31,003,"Nebraska","Antelope County",1,45,62,30,32
050,31,003,"Nebraska","Antelope County",1,46,63,29,34
050,31,003,"Nebraska","Antelope County",1,47,54,24,30
050,31,003,"Nebraska","Antelope County",1,48,49,29,20
050,31,003,"Nebraska","Antelope County",1,49,60,39,21
050,31,003,"Nebraska","Antelope County",1,50,59,27,32
050,31,003,"Nebraska","Antelope County",1,51,57,27,30
050,31,003,"Nebraska","Antelope County",1,52,61,31,30
050,31,003,"Nebraska","Antelope County",1,53,55,27,28
050,31,003,"Nebraska","Antelope County",1,54,70,33,37
050,31,003,"Nebraska","Antelope County",1,55,84,40,44
050,31,003,"Nebraska","Antelope County",1,56,83,44,39
050,31,003,"Nebraska","Antelope County",1,57,99,50,49
050,31,003,"Nebraska","Antelope County",1,58,106,53,53
050,31,003,"Nebraska","Antelope County",1,59,107,55,52
050,31,003,"Nebraska","Antelope County",1,60,100,48,52
050,31,003,"Nebraska","Antelope County",1,61,101,54,47
050,31,003,"Nebraska","Antelope County",1,62,92,44,48
050,31,003,"Nebraska","Antelope County",1,63,102,54,48
050,31,003,"Nebraska","Antelope County",1,64,96,47,49
050,31,003,"Nebraska","Antelope County",1,65,91,52,39
050,31,003,"Nebraska","Antelope County",1,66,101,47,54
050,31,003,"Nebraska","Antelope County",1,67,97,50,47
050,31,003,"Nebraska","Antelope County",1,68,100,56,44
050,31,003,"Nebraska","Antelope County",1,69,82,43,39
050,31,003,"Nebraska","Antelope County",1,70,72,27,45
050,31,003,"Nebraska","Antelope County",1,71,68,33,35
050,31,003,"Nebraska","Antelope County",1,72,77,39,38
050,31,003,"Nebraska","Antelope County",1,73,84,44,40
050,31,003,"Nebraska","Antelope County",1,74,55,31,24
050,31,003,"Nebraska","Antelope County",1,75,48,23,25
050,31,003,"Nebraska","Antelope County",1,76,61,29,32
050,31,003,"Nebraska","Antelope County",1,77,50,24,26
050,31,003,"Nebraska","Antelope County",1,78,55,26,29
050,31,003,"Nebraska","Antelope County",1,79,45,17,28
050,31,003,"Nebraska","Antelope County",1,80,47,22,25
050,31,003,"Nebraska","Antelope County",1,81,47,22,25
050,31,003,"Nebraska","Antelope County",1,82,54,26,28
050,31,003,"Nebraska","Antelope County",1,83,42,18,24
050,31,003,"Nebraska","Antelope County",1,84,35,11,24
050,31,003,"Nebraska","Antelope County",1,85,195,75,120
050,31,003,"Nebraska","Antelope County",2,0,92,47,45
050,31,003,"Nebraska","Antelope County",2,1,85,42,43
050,31,003,"Nebraska","Antelope County",2,2,89,42,47
050,31,003,"Nebraska","Antelope County",2,3,89,45,44
050,31,003,"Nebraska","Antelope County",2,4,81,45,36
050,31,003,"Nebraska","Antelope County",2,5,81,42,39
050,31,003,"Nebraska","Antelope County",2,6,88,41,47
050,31,003,"Nebraska","Antelope County",2,7,87,47,40
050,31,003,"Nebraska","Antelope County",2,8,82,52,30
050,31,003,"Nebraska","Antelope County",2,9,87,51,36
050,31,003,"Nebraska","Antelope County",2,10,91,50,41
050,31,003,"Nebraska","Antelope County",2,11,85,40,45
050,31,003,"Nebraska","Antelope County",2,12,84,39,45
050,31,003,"Nebraska","Antelope County",2,13,82,42,40
050,31,003,"Nebraska","Antelope County",2,14,85,44,41
050,31,003,"Nebraska","Antelope County",2,15,78,40,38
050,31,003,"Nebraska","Antelope County",2,16,84,42,42
050,31,003,"Nebraska","Antelope County",2,17,76,41,35
050,31,003,"Nebraska","Antelope County",2,18,62,36,26
050,31,003,"Nebraska","Antelope County",2,19,52,27,25
050,31,003,"Nebraska","Antelope County",2,20,55,26,29
050,31,003,"Nebraska","Antelope County",2,21,62,28,34
050,31,003,"Nebraska","Antelope County",2,22,65,36,29
050,31,003,"Nebraska","Antelope County",2,23,65,35,30
050,31,003,"Nebraska","Antelope County",2,24,60,29,31
050,31,003,"Nebraska","Antelope County",2,25,73,39,34
050,31,003,"Nebraska","Antelope County",2,26,72,39,33
050,31,003,"Nebraska","Antelope County",2,27,67,35,32
050,31,003,"Nebraska","Antelope County",2,28,70,40,30
050,31,003,"Nebraska","Antelope County",2,29,60,33,27
050,31,003,"Nebraska","Antelope County",2,30,53,25,28
050,31,003,"Nebraska","Antelope County",2,31,49,25,24
050,31,003,"Nebraska","Antelope County",2,32,52,25,27
050,31,003,"Nebraska","Antelope County",2,33,63,28,35
050,31,003,"Nebraska","Antelope County",2,34,62,31,31
050,31,003,"Nebraska","Antelope County",2,35,71,38,33
050,31,003,"Nebraska","Antelope County",2,36,77,41,36
050,31,003,"Nebraska","Antelope County",2,37,77,44,33
050,31,003,"Nebraska","Antelope County",2,38,74,42,32
050,31,003,"Nebraska","Antelope County",2,39,68,39,29
050,31,003,"Nebraska","Antelope County",2,40,68,37,31
050,31,003,"Nebraska","Antelope County",2,41,60,32,28
050,31,003,"Nebraska","Antelope County",2,42,62,36,26
050,31,003,"Nebraska","Antelope County",2,43,59,34,25
050,31,003,"Nebraska","Antelope County",2,44,51,27,24
050,31,003,"Nebraska","Antelope County",2,45,58,29,29
050,31,003,"Nebraska","Antelope County",2,46,62,29,33
050,31,003,"Nebraska","Antelope County",2,47,55,24,31
050,31,003,"Nebraska","Antelope County",2,48,49,28,21
050,31,003,"Nebraska","Antelope County",2,49,58,37,21
050,31,003,"Nebraska","Antelope County",2,50,58,29,29
050,31,003,"Nebraska","Antelope County",2,51,56,26,30
050,31,003,"Nebraska","Antelope County",2,52,60,31,29
050,31,003,"Nebraska","Antelope County",2,53,55,28,27
050,31,003,"Nebraska","Antelope County",2,54,64,31,33
050,31,003,"Nebraska","Antelope County",2,55,80,38,42
050,31,003,"Nebraska","Antelope County",2,56,83,43,40
050,31,003,"Nebraska","Antelope County",2,57,95,48,47
050,31,003,"Nebraska","Antelope County",2,58,105,53,52
050,31,003,"Nebraska","Antelope County",2,59,107,54,53
050,31,003,"Nebraska","Antelope County",2,60,100,48,52
050,31,003,"Nebraska","Antelope County",2,61,101,53,48
050,31,003,"Nebraska","Antelope County",2,62,93,46,47
050,31,003,"Nebraska","Antelope County",2,63,100,52,48
050,31,003,"Nebraska","Antelope County",2,64,96,47,49
050,31,003,"Nebraska","Antelope County",2,65,92,51,41
050,31,003,"Nebraska","Antelope County",2,66,100,49,51
050,31,003,"Nebraska","Antelope County",2,67,95,48,47
050,31,003,"Nebraska","Antelope County",2,68,99,55,44
050,31,003,"Nebraska","Antelope County",2,69,87,46,41
050,31,003,"Nebraska","Antelope County",2,70,73,30,43
050,31,003,"Nebraska","Antelope County",2,71,70,32,38
050,31,003,"Nebraska","Antelope County",2,72,74,37,37
050,31,003,"Nebraska","Antelope County",2,73,87,45,42
050,31,003,"Nebraska","Antelope County",2,74,58,32,26
050,31,003,"Nebraska","Antelope County",2,75,50,25,25
050,31,003,"Nebraska","Antelope County",2,76,57,27,30
050,31,003,"Nebraska","Antelope County",2,77,51,23,28
050,31,003,"Nebraska","Antelope County",2,78,51,24,27
050,31,003,"Nebraska","Antelope County",2,79,47,19,28
050,31,003,"Nebraska","Antelope County",2,80,46,21,25
050,31,003,"Nebraska","Antelope County",2,81,45,20,25
050,31,003,"Nebraska","Antelope County",2,82,53,26,27
050,31,003,"Nebraska","Antelope County",2,83,43,19,24
050,31,003,"Nebraska","Antelope County",2,84,36,12,24
050,31,003,"Nebraska","Antelope County",2,85,195,74,121
050,31,003,"Nebraska","Antelope County",3,0,86,48,38
050,31,003,"Nebraska","Antelope County",3,1,101,48,53
050,31,003,"Nebraska","Antelope County",3,2,84,43,41
050,31,003,"Nebraska","Antelope County",3,3,92,41,51
050,31,003,"Nebraska","Antelope County",3,4,91,48,43
050,31,003,"Nebraska","Antelope County",3,5,84,43,41
050,31,003,"Nebraska","Antelope County",3,6,79,41,38
050,31,003,"Nebraska","Antelope County",3,7,91,42,49
050,31,003,"Nebraska","Antelope County",3,8,87,46,41
050,31,003,"Nebraska","Antelope County",3,9,78,51,27
050,31,003,"Nebraska","Antelope County",3,10,85,49,36
050,31,003,"Nebraska","Antelope County",3,11,93,46,47
050,31,003,"Nebraska","Antelope County",3,12,85,38,47
050,31,003,"Nebraska","Antelope County",3,13,82,38,44
050,31,003,"Nebraska","Antelope County",3,14,81,41,40
050,31,003,"Nebraska","Antelope County",3,15,85,44,41
050,31,003,"Nebraska","Antelope County",3,16,79,42,37
050,31,003,"Nebraska","Antelope County",3,17,85,43,42
050,31,003,"Nebraska","Antelope County",3,18,60,31,29
050,31,003,"Nebraska","Antelope County",3,19,50,28,22
050,31,003,"Nebraska","Antelope County",3,20,53,25,28
050,31,003,"Nebraska","Antelope County",3,21,64,29,35
050,31,003,"Nebraska","Antelope County",3,22,67,30,37
050,31,003,"Nebraska","Antelope County",3,23,68,34,34
050,31,003,"Nebraska","Antelope County",3,24,63,36,27
050,31,003,"Nebraska","Antelope County",3,25,54,28,26
050,31,003,"Nebraska","Antelope County",3,26,75,37,38
050,31,003,"Nebraska","Antelope County",3,27,73,38,35
050,31,003,"Nebraska","Antelope County",3,28,70,38,32
050,31,003,"Nebraska","Antelope County",3,29,65,36,29
050,31,003,"Nebraska","Antelope County",3,30,62,35,27
050,31,003,"Nebraska","Antelope County",3,31,58,29,29
050,31,003,"Nebraska","Antelope County",3,32,53,27,26
050,31,003,"Nebraska","Antelope County",3,33,53,27,26
050,31,003,"Nebraska","Antelope County",3,34,60,27,33
050,31,003,"Nebraska","Antelope County",3,35,64,33,31
050,31,003,"Nebraska","Antelope County",3,36,67,37,30
050,31,003,"Nebraska","Antelope County",3,37,72,36,36
050,31,003,"Nebraska","Antelope County",3,38,78,46,32
050,31,003,"Nebraska","Antelope County",3,39,77,43,34
050,31,003,"Nebraska","Antelope County",3,40,75,43,32
050,31,003,"Nebraska","Antelope County",3,41,69,39,30
050,31,003,"Nebraska","Antelope County",3,42,59,33,26
050,31,003,"Nebraska","Antelope County",3,43,61,35,26
050,31,003,"Nebraska","Antelope County",3,44,58,34,24
050,31,003,"Nebraska","Antelope County",3,45,49,25,24
050,31,003,"Nebraska","Antelope County",3,46,60,29,31
050,31,003,"Nebraska","Antelope County",3,47,64,30,34
050,31,003,"Nebraska","Antelope County",3,48,56,24,32
050,31,003,"Nebraska","Antelope County",3,49,49,28,21
050,31,003,"Nebraska","Antelope County",3,50,57,36,21
050,31,003,"Nebraska","Antelope County",3,51,58,29,29
050,31,003,"Nebraska","Antelope County",3,52,57,27,30
050,31,003,"Nebraska","Antelope County",3,53,66,37,29
050,31,003,"Nebraska","Antelope County",3,54,61,30,31
050,31,003,"Nebraska","Antelope County",3,55,62,30,32
050,31,003,"Nebraska","Antelope County",3,56,79,36,43
050,31,003,"Nebraska","Antelope County",3,57,83,42,41
050,31,003,"Nebraska","Antelope County",3,58,94,48,46
050,31,003,"Nebraska","Antelope County",3,59,105,53,52
050,31,003,"Nebraska","Antelope County",3,60,105,52,53
050,31,003,"Nebraska","Antelope County",3,61,99,47,52
050,31,003,"Nebraska","Antelope County",3,62,98,53,45
050,31,003,"Nebraska","Antelope County",3,63,96,49,47
050,31,003,"Nebraska","Antelope County",3,64,100,52,48
050,31,003,"Nebraska","Antelope County",3,65,97,48,49
050,31,003,"Nebraska","Antelope County",3,66,88,48,40
050,31,003,"Nebraska","Antelope County",3,67,98,46,52
050,31,003,"Nebraska","Antelope County",3,68,91,46,45
050,31,003,"Nebraska","Antelope County",3,69,97,54,43
050,31,003,"Nebraska","Antelope County",3,70,88,45,43
050,31,003,"Nebraska","Antelope County",3,71,72,32,40
050,31,003,"Nebraska","Antelope County",3,72,69,32,37
050,31,003,"Nebraska","Antelope County",3,73,72,36,36
050,31,003,"Nebraska","Antelope County",3,74,85,42,43
050,31,003,"Nebraska","Antelope County",3,75,57,32,25
050,31,003,"Nebraska","Antelope County",3,76,48,24,24
050,31,003,"Nebraska","Antelope County",3,77,52,24,28
050,31,003,"Nebraska","Antelope County",3,78,50,24,26
050,31,003,"Nebraska","Antelope County",3,79,47,21,26
050,31,003,"Nebraska","Antelope County",3,80,43,18,25
050,31,003,"Nebraska","Antelope County",3,81,42,18,24
050,31,003,"Nebraska","Antelope County",3,82,47,20,27
050,31,003,"Nebraska","Antelope County",3,83,48,25,23
050,31,003,"Nebraska","Antelope County",3,84,39,16,23
050,31,003,"Nebraska","Antelope County",3,85,191,69,122
050,31,003,"Nebraska","Antelope County",4,0,85,45,40
050,31,003,"Nebraska","Antelope County",4,1,87,51,36
050,31,003,"Nebraska","Antelope County",4,2,99,51,48
050,31,003,"Nebraska","Antelope County",4,3,84,45,39
050,31,003,"Nebraska","Antelope County",4,4,93,42,51
050,31,003,"Nebraska","Antelope County",4,5,92,48,44
050,31,003,"Nebraska","Antelope County",4,6,82,44,38
050,31,003,"Nebraska","Antelope County",4,7,78,41,37
050,31,003,"Nebraska","Antelope County",4,8,88,41,47
050,31,003,"Nebraska","Antelope County",4,9,89,47,42
050,31,003,"Nebraska","Antelope County",4,10,79,49,30
050,31,003,"Nebraska","Antelope County",4,11,86,51,35
050,31,003,"Nebraska","Antelope County",4,12,86,41,45
050,31,003,"Nebraska","Antelope County",4,13,89,37,52
050,31,003,"Nebraska","Antelope County",4,14,86,39,47
050,31,003,"Nebraska","Antelope County",4,15,88,46,42
050,31,003,"Nebraska","Antelope County",4,16,83,42,41
050,31,003,"Nebraska","Antelope County",4,17,82,42,40
050,31,003,"Nebraska","Antelope County",4,18,70,36,34
050,31,003,"Nebraska","Antelope County",4,19,47,24,23
050,31,003,"Nebraska","Antelope County",4,20,49,27,22
050,31,003,"Nebraska","Antelope County",4,21,56,31,25
050,31,003,"Nebraska","Antelope County",4,22,66,30,36
050,31,003,"Nebraska","Antelope County",4,23,73,36,37
050,31,003,"Nebraska","Antelope County",4,24,66,28,38
050,31,003,"Nebraska","Antelope County",4,25,62,35,27
050,31,003,"Nebraska","Antelope County",4,26,56,28,28
050,31,003,"Nebraska","Antelope County",4,27,74,37,37
050,31,003,"Nebraska","Antelope County",4,28,72,39,33
050,31,003,"Nebraska","Antelope County",4,29,74,42,32
050,31,003,"Nebraska","Antelope County",4,30,70,38,32
050,31,003,"Nebraska","Antelope County",4,31,58,32,26
050,31,003,"Nebraska","Antelope County",4,32,58,28,30
050,31,003,"Nebraska","Antelope County",4,33,52,27,25
050,31,003,"Nebraska","Antelope County",4,34,52,26,26
050,31,003,"Nebraska","Antelope County",4,35,61,28,33
050,31,003,"Nebraska","Antelope County",4,36,65,34,31
050,31,003,"Nebraska","Antelope County",4,37,71,39,32
050,31,003,"Nebraska","Antelope County",4,38,70,34,36
050,31,003,"Nebraska","Antelope County",4,39,77,46,31
050,31,003,"Nebraska","Antelope County",4,40,74,41,33
050,31,003,"Nebraska","Antelope County",4,41,74,42,32
050,31,003,"Nebraska","Antelope County",4,42,73,39,34
050,31,003,"Nebraska","Antelope County",4,43,59,35,24
050,31,003,"Nebraska","Antelope County",4,44,58,33,25
050,31,003,"Nebraska","Antelope County",4,45,61,35,26
050,31,003,"Nebraska","Antelope County",4,46,51,28,23
050,31,003,"Nebraska","Antelope County",4,47,60,28,32
050,31,003,"Nebraska","Antelope County",4,48,62,29,33
050,31,003,"Nebraska","Antelope County",4,49,58,25,33
050,31,003,"Nebraska","Antelope County",4,50,54,30,24
050,31,003,"Nebraska","Antelope County",4,51,58,37,21
050,31,003,"Nebraska","Antelope County",4,52,65,32,33
050,31,003,"Nebraska","Antelope County",4,53,58,28,30
050,31,003,"Nebraska","Antelope County",4,54,63,36,27
050,31,003,"Nebraska","Antelope County",4,55,59,27,32
050,31,003,"Nebraska","Antelope County",4,56,65,30,35
050,31,003,"Nebraska","Antelope County",4,57,80,36,44
050,31,003,"Nebraska","Antelope County",4,58,81,43,38
050,31,003,"Nebraska","Antelope County",4,59,94,48,46
050,31,003,"Nebraska","Antelope County",4,60,103,51,52
050,31,003,"Nebraska","Antelope County",4,61,104,51,53
050,31,003,"Nebraska","Antelope County",4,62,97,46,51
050,31,003,"Nebraska","Antelope County",4,63,100,54,46
050,31,003,"Nebraska","Antelope County",4,64,95,48,47
050,31,003,"Nebraska","Antelope County",4,65,101,53,48
050,31,003,"Nebraska","Antelope County",4,66,95,48,47
050,31,003,"Nebraska","Antelope County",4,67,86,45,41
050,31,003,"Nebraska","Antelope County",4,68,92,45,47
050,31,003,"Nebraska","Antelope County",4,69,91,47,44
050,31,003,"Nebraska","Antelope County",4,70,95,52,43
050,31,003,"Nebraska","Antelope County",4,71,82,41,41
050,31,003,"Nebraska","Antelope County",4,72,70,32,38
050,31,003,"Nebraska","Antelope County",4,73,66,31,35
050,31,003,"Nebraska","Antelope County",4,74,71,34,37
050,31,003,"Nebraska","Antelope County",4,75,85,43,42
050,31,003,"Nebraska","Antelope County",4,76,60,32,28
050,31,003,"Nebraska","Antelope County",4,77,45,23,22
050,31,003,"Nebraska","Antelope County",4,78,48,22,26
050,31,003,"Nebraska","Antelope County",4,79,44,20,24
050,31,003,"Nebraska","Antelope County",4,80,44,19,25
050,31,003,"Nebraska","Antelope County",4,81,39,16,23
050,31,003,"Nebraska","Antelope County",4,82,43,18,25
050,31,003,"Nebraska","Antelope County",4,83,45,17,28
050,31,003,"Nebraska","Antelope County",4,84,44,22,22
050,31,003,"Nebraska","Antelope County",4,85,198,73,125
050,31,003,"Nebraska","Antelope County",5,0,83,45,38
050,31,003,"Nebraska","Antelope County",5,1,95,57,38
050,31,003,"Nebraska","Antelope County",5,2,82,47,35
050,31,003,"Nebraska","Antelope County",5,3,98,50,48
050,31,003,"Nebraska","Antelope County",5,4,81,44,37
050,31,003,"Nebraska","Antelope County",5,5,92,40,52
050,31,003,"Nebraska","Antelope County",5,6,93,47,46
050,31,003,"Nebraska","Antelope County",5,7,85,46,39
050,31,003,"Nebraska","Antelope County",5,8,78,43,35
050,31,003,"Nebraska","Antelope County",5,9,90,42,48
050,31,003,"Nebraska","Antelope County",5,10,88,47,41
050,31,003,"Nebraska","Antelope County",5,11,74,47,27
050,31,003,"Nebraska","Antelope County",5,12,89,51,38
050,31,003,"Nebraska","Antelope County",5,13,84,41,43
050,31,003,"Nebraska","Antelope County",5,14,92,39,53
050,31,003,"Nebraska","Antelope County",5,15,85,37,48
050,31,003,"Nebraska","Antelope County",5,16,82,42,40
050,31,003,"Nebraska","Antelope County",5,17,86,45,41
050,31,003,"Nebraska","Antelope County",5,18,67,35,32
050,31,003,"Nebraska","Antelope County",5,19,57,29,28
050,31,003,"Nebraska","Antelope County",5,20,53,26,27
050,31,003,"Nebraska","Antelope County",5,21,59,33,26
050,31,003,"Nebraska","Antelope County",5,22,60,32,28
050,31,003,"Nebraska","Antelope County",5,23,60,27,33
050,31,003,"Nebraska","Antelope County",5,24,77,41,36
050,31,003,"Nebraska","Antelope County",5,25,67,31,36
050,31,003,"Nebraska","Antelope County",5,26,57,36,21
050,31,003,"Nebraska","Antelope County",5,27,51,26,25
050,31,003,"Nebraska","Antelope County",5,28,68,34,34
050,31,003,"Nebraska","Antelope County",5,29,67,38,29
050,31,003,"Nebraska","Antelope County",5,30,76,45,31
050,31,003,"Nebraska","Antelope County",5,31,76,39,37
050,31,003,"Nebraska","Antelope County",5,32,58,32,26
050,31,003,"Nebraska","Antelope County",5,33,56,28,28
050,31,003,"Nebraska","Antelope County",5,34,59,32,27
050,31,003,"Nebraska","Antelope County",5,35,56,29,27
050,31,003,"Nebraska","Antelope County",5,36,66,32,34
050,31,003,"Nebraska","Antelope County",5,37,66,34,32
050,31,003,"Nebraska","Antelope County",5,38,72,38,34
050,31,003,"Nebraska","Antelope County",5,39,69,33,36
050,31,003,"Nebraska","Antelope County",5,40,75,42,33
050,31,003,"Nebraska","Antelope County",5,41,73,41,32
050,31,003,"Nebraska","Antelope County",5,42,74,40,34
050,31,003,"Nebraska","Antelope County",5,43,71,40,31
050,31,003,"Nebraska","Antelope County",5,44,58,34,24
050,31,003,"Nebraska","Antelope County",5,45,62,37,25
050,31,003,"Nebraska","Antelope County",5,46,63,37,26
050,31,003,"Nebraska","Antelope County",5,47,52,28,24
050,31,003,"Nebraska","Antelope County",5,48,59,26,33
050,31,003,"Nebraska","Antelope County",5,49,62,29,33
050,31,003,"Nebraska","Antelope County",5,50,56,25,31
050,31,003,"Nebraska","Antelope County",5,51,52,28,24
050,31,003,"Nebraska","Antelope County",5,52,60,39,21
050,31,003,"Nebraska","Antelope County",5,53,65,32,33
050,31,003,"Nebraska","Antelope County",5,54,58,27,31
050,31,003,"Nebraska","Antelope County",5,55,62,36,26
050,31,003,"Nebraska","Antelope County",5,56,59,27,32
050,31,003,"Nebraska","Antelope County",5,57,67,30,37
050,31,003,"Nebraska","Antelope County",5,58,79,36,43
050,31,003,"Nebraska","Antelope County",5,59,81,43,38
050,31,003,"Nebraska","Antelope County",5,60,93,47,46
050,31,003,"Nebraska","Antelope County",5,61,102,50,52
050,31,003,"Nebraska","Antelope County",5,62,100,51,49
050,31,003,"Nebraska","Antelope County",5,63,95,45,50
050,31,003,"Nebraska","Antelope County",5,64,99,52,47
050,31,003,"Nebraska","Antelope County",5,65,94,48,46
050,31,003,"Nebraska","Antelope County",5,66,99,52,47
050,31,003,"Nebraska","Antelope County",5,67,93,46,47
050,31,003,"Nebraska","Antelope County",5,68,80,42,38
050,31,003,"Nebraska","Antelope County",5,69,93,46,47
050,31,003,"Nebraska","Antelope County",5,70,91,46,45
050,31,003,"Nebraska","Antelope County",5,71,93,51,42
050,31,003,"Nebraska","Antelope County",5,72,83,42,41
050,31,003,"Nebraska","Antelope County",5,73,67,31,36
050,31,003,"Nebraska","Antelope County",5,74,63,29,34
050,31,003,"Nebraska","Antelope County",5,75,70,35,35
050,31,003,"Nebraska","Antelope County",5,76,86,42,44
050,31,003,"Nebraska","Antelope County",5,77,57,31,26
050,31,003,"Nebraska","Antelope County",5,78,43,23,20
050,31,003,"Nebraska","Antelope County",5,79,42,19,23
050,31,003,"Nebraska","Antelope County",5,80,40,18,22
050,31,003,"Nebraska","Antelope County",5,81,40,17,23
050,31,003,"Nebraska","Antelope County",5,82,41,15,26
050,31,003,"Nebraska","Antelope County",5,83,41,16,25
050,31,003,"Nebraska","Antelope County",5,84,38,13,25
050,31,003,"Nebraska","Antelope County",5,85,217,87,130
050,31,005,"Nebraska","Arthur County",1,0,6,3,3
050,31,005,"Nebraska","Arthur County",1,1,4,2,2
050,31,005,"Nebraska","Arthur County",1,2,4,3,1
050,31,005,"Nebraska","Arthur County",1,3,5,5,0
050,31,005,"Nebraska","Arthur County",1,4,5,3,2
050,31,005,"Nebraska","Arthur County",1,5,5,3,2
050,31,005,"Nebraska","Arthur County",1,6,4,2,2
050,31,005,"Nebraska","Arthur County",1,7,6,2,4
050,31,005,"Nebraska","Arthur County",1,8,6,3,3
050,31,005,"Nebraska","Arthur County",1,9,6,4,2
050,31,005,"Nebraska","Arthur County",1,10,9,6,3
050,31,005,"Nebraska","Arthur County",1,11,9,3,6
050,31,005,"Nebraska","Arthur County",1,12,9,2,7
050,31,005,"Nebraska","Arthur County",1,13,6,2,4
050,31,005,"Nebraska","Arthur County",1,14,8,2,6
050,31,005,"Nebraska","Arthur County",1,15,7,4,3
050,31,005,"Nebraska","Arthur County",1,16,7,3,4
050,31,005,"Nebraska","Arthur County",1,17,9,3,6
050,31,005,"Nebraska","Arthur County",1,18,7,4,3
050,31,005,"Nebraska","Arthur County",1,19,5,2,3
050,31,005,"Nebraska","Arthur County",1,20,3,2,1
050,31,005,"Nebraska","Arthur County",1,21,5,2,3
050,31,005,"Nebraska","Arthur County",1,22,8,2,6
050,31,005,"Nebraska","Arthur County",1,23,3,0,3
050,31,005,"Nebraska","Arthur County",1,24,4,1,3
050,31,005,"Nebraska","Arthur County",1,25,5,2,3
050,31,005,"Nebraska","Arthur County",1,26,4,2,2
050,31,005,"Nebraska","Arthur County",1,27,3,2,1
050,31,005,"Nebraska","Arthur County",1,28,3,2,1
050,31,005,"Nebraska","Arthur County",1,29,3,2,1
050,31,005,"Nebraska","Arthur County",1,30,5,3,2
050,31,005,"Nebraska","Arthur County",1,31,5,3,2
050,31,005,"Nebraska","Arthur County",1,32,3,2,1
050,31,005,"Nebraska","Arthur County",1,33,6,4,2
050,31,005,"Nebraska","Arthur County",1,34,7,3,4
050,31,005,"Nebraska","Arthur County",1,35,6,3,3
050,31,005,"Nebraska","Arthur County",1,36,2,1,1
050,31,005,"Nebraska","Arthur County",1,37,1,0,1
050,31,005,"Nebraska","Arthur County",1,38,3,1,2
050,31,005,"Nebraska","Arthur County",1,39,4,1,3
050,31,005,"Nebraska","Arthur County",1,40,6,2,4
050,31,005,"Nebraska","Arthur County",1,41,9,5,4
050,31,005,"Nebraska","Arthur County",1,42,9,5,4
050,31,005,"Nebraska","Arthur County",1,43,5,4,1
050,31,005,"Nebraska","Arthur County",1,44,5,2,3
050,31,005,"Nebraska","Arthur County",1,45,4,1,3
050,31,005,"Nebraska","Arthur County",1,46,4,2,2
050,31,005,"Nebraska","Arthur County",1,47,5,2,3
050,31,005,"Nebraska","Arthur County",1,48,6,3,3
050,31,005,"Nebraska","Arthur County",1,49,3,2,1
050,31,005,"Nebraska","Arthur County",1,50,2,1,1
050,31,005,"Nebraska","Arthur County",1,51,5,4,1
050,31,005,"Nebraska","Arthur County",1,52,3,2,1
050,31,005,"Nebraska","Arthur County",1,53,5,1,4
050,31,005,"Nebraska","Arthur County",1,54,5,2,3
050,31,005,"Nebraska","Arthur County",1,55,6,3,3
050,31,005,"Nebraska","Arthur County",1,56,3,3,0
050,31,005,"Nebraska","Arthur County",1,57,6,5,1
050,31,005,"Nebraska","Arthur County",1,58,6,3,3
050,31,005,"Nebraska","Arthur County",1,59,4,2,2
050,31,005,"Nebraska","Arthur County",1,60,3,1,2
050,31,005,"Nebraska","Arthur County",1,61,3,2,1
050,31,005,"Nebraska","Arthur County",1,62,8,4,4
050,31,005,"Nebraska","Arthur County",1,63,4,2,2
050,31,005,"Nebraska","Arthur County",1,64,4,2,2
050,31,005,"Nebraska","Arthur County",1,65,6,3,3
050,31,005,"Nebraska","Arthur County",1,66,4,2,2
050,31,005,"Nebraska","Arthur County",1,67,5,2,3
050,31,005,"Nebraska","Arthur County",1,68,7,4,3
050,31,005,"Nebraska","Arthur County",1,69,5,3,2
050,31,005,"Nebraska","Arthur County",1,70,6,4,2
050,31,005,"Nebraska","Arthur County",1,71,6,3,3
050,31,005,"Nebraska","Arthur County",1,72,4,2,2
050,31,005,"Nebraska","Arthur County",1,73,3,1,2
050,31,005,"Nebraska","Arthur County",1,74,3,1,2
050,31,005,"Nebraska","Arthur County",1,75,4,2,2
050,31,005,"Nebraska","Arthur County",1,76,3,2,1
050,31,005,"Nebraska","Arthur County",1,77,5,3,2
050,31,005,"Nebraska","Arthur County",1,78,5,3,2
050,31,005,"Nebraska","Arthur County",1,79,3,2,1
050,31,005,"Nebraska","Arthur County",1,80,3,1,2
050,31,005,"Nebraska","Arthur County",1,81,2,0,2
050,31,005,"Nebraska","Arthur County",1,82,4,2,2
050,31,005,"Nebraska","Arthur County",1,83,4,2,2
050,31,005,"Nebraska","Arthur County",1,84,4,2,2
050,31,005,"Nebraska","Arthur County",1,85,11,5,6
050,31,005,"Nebraska","Arthur County",2,0,5,2,3
050,31,005,"Nebraska","Arthur County",2,1,4,2,2
050,31,005,"Nebraska","Arthur County",2,2,4,3,1
050,31,005,"Nebraska","Arthur County",2,3,4,4,0
050,31,005,"Nebraska","Arthur County",2,4,6,4,2
050,31,005,"Nebraska","Arthur County",2,5,5,3,2
050,31,005,"Nebraska","Arthur County",2,6,4,2,2
050,31,005,"Nebraska","Arthur County",2,7,5,2,3
050,31,005,"Nebraska","Arthur County",2,8,6,3,3
050,31,005,"Nebraska","Arthur County",2,9,6,4,2
050,31,005,"Nebraska","Arthur County",2,10,8,5,3
050,31,005,"Nebraska","Arthur County",2,11,9,4,5
050,31,005,"Nebraska","Arthur County",2,12,9,2,7
050,31,005,"Nebraska","Arthur County",2,13,7,2,5
050,31,005,"Nebraska","Arthur County",2,14,8,2,6
050,31,005,"Nebraska","Arthur County",2,15,8,4,4
050,31,005,"Nebraska","Arthur County",2,16,7,3,4
050,31,005,"Nebraska","Arthur County",2,17,9,3,6
050,31,005,"Nebraska","Arthur County",2,18,7,4,3
050,31,005,"Nebraska","Arthur County",2,19,5,2,3
050,31,005,"Nebraska","Arthur County",2,20,3,2,1
050,31,005,"Nebraska","Arthur County",2,21,5,2,3
050,31,005,"Nebraska","Arthur County",2,22,7,2,5
050,31,005,"Nebraska","Arthur County",2,23,5,1,4
050,31,005,"Nebraska","Arthur County",2,24,4,1,3
050,31,005,"Nebraska","Arthur County",2,25,5,2,3
050,31,005,"Nebraska","Arthur County",2,26,4,2,2
050,31,005,"Nebraska","Arthur County",2,27,3,2,1
050,31,005,"Nebraska","Arthur County",2,28,3,2,1
050,31,005,"Nebraska","Arthur County",2,29,3,2,1
050,31,005,"Nebraska","Arthur County",2,30,5,3,2
050,31,005,"Nebraska","Arthur County",2,31,5,3,2
050,31,005,"Nebraska","Arthur County",2,32,3,2,1
050,31,005,"Nebraska","Arthur County",2,33,5,3,2
050,31,005,"Nebraska","Arthur County",2,34,7,3,4
050,31,005,"Nebraska","Arthur County",2,35,6,3,3
050,31,005,"Nebraska","Arthur County",2,36,3,2,1
050,31,005,"Nebraska","Arthur County",2,37,1,0,1
050,31,005,"Nebraska","Arthur County",2,38,3,1,2
050,31,005,"Nebraska","Arthur County",2,39,4,1,3
050,31,005,"Nebraska","Arthur County",2,40,6,2,4
050,31,005,"Nebraska","Arthur County",2,41,8,4,4
050,31,005,"Nebraska","Arthur County",2,42,9,5,4
050,31,005,"Nebraska","Arthur County",2,43,6,4,2
050,31,005,"Nebraska","Arthur County",2,44,4,2,2
050,31,005,"Nebraska","Arthur County",2,45,4,1,3
050,31,005,"Nebraska","Arthur County",2,46,4,2,2
050,31,005,"Nebraska","Arthur County",2,47,5,2,3
050,31,005,"Nebraska","Arthur County",2,48,6,3,3
050,31,005,"Nebraska","Arthur County",2,49,4,2,2
050,31,005,"Nebraska","Arthur County",2,50,2,1,1
050,31,005,"Nebraska","Arthur County",2,51,4,3,1
050,31,005,"Nebraska","Arthur County",2,52,3,2,1
050,31,005,"Nebraska","Arthur County",2,53,4,1,3
050,31,005,"Nebraska","Arthur County",2,54,5,2,3
050,31,005,"Nebraska","Arthur County",2,55,6,3,3
050,31,005,"Nebraska","Arthur County",2,56,4,3,1
050,31,005,"Nebraska","Arthur County",2,57,6,5,1
050,31,005,"Nebraska","Arthur County",2,58,6,3,3
050,31,005,"Nebraska","Arthur County",2,59,4,2,2
050,31,005,"Nebraska","Arthur County",2,60,3,1,2
050,31,005,"Nebraska","Arthur County",2,61,3,2,1
050,31,005,"Nebraska","Arthur County",2,62,6,3,3
050,31,005,"Nebraska","Arthur County",2,63,6,3,3
050,31,005,"Nebraska","Arthur County",2,64,4,2,2
050,31,005,"Nebraska","Arthur County",2,65,6,3,3
050,31,005,"Nebraska","Arthur County",2,66,4,2,2
050,31,005,"Nebraska","Arthur County",2,67,5,2,3
050,31,005,"Nebraska","Arthur County",2,68,7,4,3
050,31,005,"Nebraska","Arthur County",2,69,5,3,2
050,31,005,"Nebraska","Arthur County",2,70,6,4,2
050,31,005,"Nebraska","Arthur County",2,71,6,3,3
050,31,005,"Nebraska","Arthur County",2,72,4,2,2
050,31,005,"Nebraska","Arthur County",2,73,3,1,2
050,31,005,"Nebraska","Arthur County",2,74,3,1,2
050,31,005,"Nebraska","Arthur County",2,75,4,2,2
050,31,005,"Nebraska","Arthur County",2,76,3,2,1
050,31,005,"Nebraska","Arthur County",2,77,5,3,2
050,31,005,"Nebraska","Arthur County",2,78,4,2,2
050,31,005,"Nebraska","Arthur County",2,79,3,2,1
050,31,005,"Nebraska","Arthur County",2,80,3,1,2
050,31,005,"Nebraska","Arthur County",2,81,3,1,2
050,31,005,"Nebraska","Arthur County",2,82,4,2,2
050,31,005,"Nebraska","Arthur County",2,83,4,2,2
050,31,005,"Nebraska","Arthur County",2,84,4,2,2
050,31,005,"Nebraska","Arthur County",2,85,11,5,6
050,31,005,"Nebraska","Arthur County",3,0,1,0,1
050,31,005,"Nebraska","Arthur County",3,1,5,2,3
050,31,005,"Nebraska","Arthur County",3,2,5,3,2
050,31,005,"Nebraska","Arthur County",3,3,5,4,1
050,31,005,"Nebraska","Arthur County",3,4,3,3,0
050,31,005,"Nebraska","Arthur County",3,5,6,4,2
050,31,005,"Nebraska","Arthur County",3,6,7,5,2
050,31,005,"Nebraska","Arthur County",3,7,6,3,3
050,31,005,"Nebraska","Arthur County",3,8,5,2,3
050,31,005,"Nebraska","Arthur County",3,9,8,3,5
050,31,005,"Nebraska","Arthur County",3,10,6,4,2
050,31,005,"Nebraska","Arthur County",3,11,8,5,3
050,31,005,"Nebraska","Arthur County",3,12,9,4,5
050,31,005,"Nebraska","Arthur County",3,13,9,2,7
050,31,005,"Nebraska","Arthur County",3,14,5,2,3
050,31,005,"Nebraska","Arthur County",3,15,8,2,6
050,31,005,"Nebraska","Arthur County",3,16,7,4,3
050,31,005,"Nebraska","Arthur County",3,17,7,3,4
050,31,005,"Nebraska","Arthur County",3,18,8,3,5
050,31,005,"Nebraska","Arthur County",3,19,6,3,3
050,31,005,"Nebraska","Arthur County",3,20,4,2,2
050,31,005,"Nebraska","Arthur County",3,21,3,2,1
050,31,005,"Nebraska","Arthur County",3,22,6,2,4
050,31,005,"Nebraska","Arthur County",3,23,5,1,4
050,31,005,"Nebraska","Arthur County",3,24,5,1,4
050,31,005,"Nebraska","Arthur County",3,25,4,1,3
050,31,005,"Nebraska","Arthur County",3,26,6,2,4
050,31,005,"Nebraska","Arthur County",3,27,5,3,2
050,31,005,"Nebraska","Arthur County",3,28,3,2,1
050,31,005,"Nebraska","Arthur County",3,29,5,4,1
050,31,005,"Nebraska","Arthur County",3,30,5,3,2
050,31,005,"Nebraska","Arthur County",3,31,6,3,3
050,31,005,"Nebraska","Arthur County",3,32,4,3,1
050,31,005,"Nebraska","Arthur County",3,33,3,2,1
050,31,005,"Nebraska","Arthur County",3,34,3,3,0
050,31,005,"Nebraska","Arthur County",3,35,6,2,4
050,31,005,"Nebraska","Arthur County",3,36,6,3,3
050,31,005,"Nebraska","Arthur County",3,37,3,2,1
050,31,005,"Nebraska","Arthur County",3,38,2,1,1
050,31,005,"Nebraska","Arthur County",3,39,3,1,2
050,31,005,"Nebraska","Arthur County",3,40,4,1,3
050,31,005,"Nebraska","Arthur County",3,41,6,2,4
050,31,005,"Nebraska","Arthur County",3,42,8,4,4
050,31,005,"Nebraska","Arthur County",3,43,9,5,4
050,31,005,"Nebraska","Arthur County",3,44,6,4,2
050,31,005,"Nebraska","Arthur County",3,45,4,2,2
050,31,005,"Nebraska","Arthur County",3,46,4,1,3
050,31,005,"Nebraska","Arthur County",3,47,4,2,2
050,31,005,"Nebraska","Arthur County",3,48,5,2,3
050,31,005,"Nebraska","Arthur County",3,49,6,3,3
050,31,005,"Nebraska","Arthur County",3,50,5,2,3
050,31,005,"Nebraska","Arthur County",3,51,2,1,1
050,31,005,"Nebraska","Arthur County",3,52,4,3,1
050,31,005,"Nebraska","Arthur County",3,53,5,2,3
050,31,005,"Nebraska","Arthur County",3,54,4,1,3
050,31,005,"Nebraska","Arthur County",3,55,5,2,3
050,31,005,"Nebraska","Arthur County",3,56,5,3,2
050,31,005,"Nebraska","Arthur County",3,57,4,3,1
050,31,005,"Nebraska","Arthur County",3,58,6,5,1
050,31,005,"Nebraska","Arthur County",3,59,6,3,3
050,31,005,"Nebraska","Arthur County",3,60,4,2,2
050,31,005,"Nebraska","Arthur County",3,61,3,1,2
050,31,005,"Nebraska","Arthur County",3,62,2,2,0
050,31,005,"Nebraska","Arthur County",3,63,6,3,3
050,31,005,"Nebraska","Arthur County",3,64,6,3,3
050,31,005,"Nebraska","Arthur County",3,65,4,2,2
050,31,005,"Nebraska","Arthur County",3,66,6,3,3
050,31,005,"Nebraska","Arthur County",3,67,4,2,2
050,31,005,"Nebraska","Arthur County",3,68,5,2,3
050,31,005,"Nebraska","Arthur County",3,69,7,4,3
050,31,005,"Nebraska","Arthur County",3,70,5,3,2
050,31,005,"Nebraska","Arthur County",3,71,6,4,2
050,31,005,"Nebraska","Arthur County",3,72,6,3,3
050,31,005,"Nebraska","Arthur County",3,73,4,2,2
050,31,005,"Nebraska","Arthur County",3,74,3,1,2
050,31,005,"Nebraska","Arthur County",3,75,3,1,2
050,31,005,"Nebraska","Arthur County",3,76,4,2,2
050,31,005,"Nebraska","Arthur County",3,77,3,2,1
050,31,005,"Nebraska","Arthur County",3,78,4,2,2
050,31,005,"Nebraska","Arthur County",3,79,4,2,2
050,31,005,"Nebraska","Arthur County",3,80,3,2,1
050,31,005,"Nebraska","Arthur County",3,81,2,0,2
050,31,005,"Nebraska","Arthur County",3,82,3,1,2
050,31,005,"Nebraska","Arthur County",3,83,4,2,2
050,31,005,"Nebraska","Arthur County",3,84,3,1,2
050,31,005,"Nebraska","Arthur County",3,85,15,6,9
050,31,005,"Nebraska","Arthur County",4,0,5,1,4
050,31,005,"Nebraska","Arthur County",4,1,1,0,1
050,31,005,"Nebraska","Arthur County",4,2,5,2,3
050,31,005,"Nebraska","Arthur County",4,3,5,4,1
050,31,005,"Nebraska","Arthur County",4,4,5,4,1
050,31,005,"Nebraska","Arthur County",4,5,3,3,0
050,31,005,"Nebraska","Arthur County",4,6,7,5,2
050,31,005,"Nebraska","Arthur County",4,7,7,5,2
050,31,005,"Nebraska","Arthur County",4,8,5,3,2
050,31,005,"Nebraska","Arthur County",4,9,3,2,1
050,31,005,"Nebraska","Arthur County",4,10,6,3,3
050,31,005,"Nebraska","Arthur County",4,11,6,4,2
050,31,005,"Nebraska","Arthur County",4,12,8,5,3
050,31,005,"Nebraska","Arthur County",4,13,9,4,5
050,31,005,"Nebraska","Arthur County",4,14,9,2,7
050,31,005,"Nebraska","Arthur County",4,15,6,2,4
050,31,005,"Nebraska","Arthur County",4,16,8,2,6
050,31,005,"Nebraska","Arthur County",4,17,7,4,3
050,31,005,"Nebraska","Arthur County",4,18,6,3,3
050,31,005,"Nebraska","Arthur County",4,19,7,2,5
050,31,005,"Nebraska","Arthur County",4,20,6,3,3
050,31,005,"Nebraska","Arthur County",4,21,3,2,1
050,31,005,"Nebraska","Arthur County",4,22,4,3,1
050,31,005,"Nebraska","Arthur County",4,23,4,0,4
050,31,005,"Nebraska","Arthur County",4,24,4,2,2
050,31,005,"Nebraska","Arthur County",4,25,5,1,4
050,31,005,"Nebraska","Arthur County",4,26,5,1,4
050,31,005,"Nebraska","Arthur County",4,27,7,2,5
050,31,005,"Nebraska","Arthur County",4,28,5,3,2
050,31,005,"Nebraska","Arthur County",4,29,4,3,1
050,31,005,"Nebraska","Arthur County",4,30,5,4,1
050,31,005,"Nebraska","Arthur County",4,31,5,4,1
050,31,005,"Nebraska","Arthur County",4,32,6,3,3
050,31,005,"Nebraska","Arthur County",4,33,4,3,1
050,31,005,"Nebraska","Arthur County",4,34,3,2,1
050,31,005,"Nebraska","Arthur County",4,35,3,3,0
050,31,005,"Nebraska","Arthur County",4,36,5,2,3
050,31,005,"Nebraska","Arthur County",4,37,5,2,3
050,31,005,"Nebraska","Arthur County",4,38,3,2,1
050,31,005,"Nebraska","Arthur County",4,39,2,1,1
050,31,005,"Nebraska","Arthur County",4,40,3,1,2
050,31,005,"Nebraska","Arthur County",4,41,4,1,3
050,31,005,"Nebraska","Arthur County",4,42,6,2,4
050,31,005,"Nebraska","Arthur County",4,43,8,4,4
050,31,005,"Nebraska","Arthur County",4,44,9,5,4
050,31,005,"Nebraska","Arthur County",4,45,6,4,2
050,31,005,"Nebraska","Arthur County",4,46,4,2,2
050,31,005,"Nebraska","Arthur County",4,47,3,0,3
050,31,005,"Nebraska","Arthur County",4,48,4,2,2
050,31,005,"Nebraska","Arthur County",4,49,5,2,3
050,31,005,"Nebraska","Arthur County",4,50,6,3,3
050,31,005,"Nebraska","Arthur County",4,51,5,2,3
050,31,005,"Nebraska","Arthur County",4,52,2,1,1
050,31,005,"Nebraska","Arthur County",4,53,4,3,1
050,31,005,"Nebraska","Arthur County",4,54,5,2,3
050,31,005,"Nebraska","Arthur County",4,55,4,1,3
050,31,005,"Nebraska","Arthur County",4,56,5,2,3
050,31,005,"Nebraska","Arthur County",4,57,5,3,2
050,31,005,"Nebraska","Arthur County",4,58,4,3,1
050,31,005,"Nebraska","Arthur County",4,59,6,5,1
050,31,005,"Nebraska","Arthur County",4,60,7,3,4
050,31,005,"Nebraska","Arthur County",4,61,6,3,3
050,31,005,"Nebraska","Arthur County",4,62,3,1,2
050,31,005,"Nebraska","Arthur County",4,63,2,2,0
050,31,005,"Nebraska","Arthur County",4,64,6,3,3
050,31,005,"Nebraska","Arthur County",4,65,6,3,3
050,31,005,"Nebraska","Arthur County",4,66,4,2,2
050,31,005,"Nebraska","Arthur County",4,67,4,3,1
050,31,005,"Nebraska","Arthur County",4,68,4,2,2
050,31,005,"Nebraska","Arthur County",4,69,5,2,3
050,31,005,"Nebraska","Arthur County",4,70,7,4,3
050,31,005,"Nebraska","Arthur County",4,71,5,3,2
050,31,005,"Nebraska","Arthur County",4,72,6,4,2
050,31,005,"Nebraska","Arthur County",4,73,6,3,3
050,31,005,"Nebraska","Arthur County",4,74,4,2,2
050,31,005,"Nebraska","Arthur County",4,75,3,1,2
050,31,005,"Nebraska","Arthur County",4,76,3,1,2
050,31,005,"Nebraska","Arthur County",4,77,4,2,2
050,31,005,"Nebraska","Arthur County",4,78,3,2,1
050,31,005,"Nebraska","Arthur County",4,79,4,2,2
050,31,005,"Nebraska","Arthur County",4,80,4,2,2
050,31,005,"Nebraska","Arthur County",4,81,3,2,1
050,31,005,"Nebraska","Arthur County",4,82,2,0,2
050,31,005,"Nebraska","Arthur County",4,83,3,1,2
050,31,005,"Nebraska","Arthur County",4,84,3,1,2
050,31,005,"Nebraska","Arthur County",4,85,14,6,8
050,31,005,"Nebraska","Arthur County",5,0,4,1,3
050,31,005,"Nebraska","Arthur County",5,1,5,1,4
050,31,005,"Nebraska","Arthur County",5,2,1,0,1
050,31,005,"Nebraska","Arthur County",5,3,2,0,2
050,31,005,"Nebraska","Arthur County",5,4,5,4,1
050,31,005,"Nebraska","Arthur County",5,5,1,0,1
050,31,005,"Nebraska","Arthur County",5,6,2,2,0
050,31,005,"Nebraska","Arthur County",5,7,7,5,2
050,31,005,"Nebraska","Arthur County",5,8,5,3,2
050,31,005,"Nebraska","Arthur County",5,9,4,2,2
050,31,005,"Nebraska","Arthur County",5,10,4,2,2
050,31,005,"Nebraska","Arthur County",5,11,6,3,3
050,31,005,"Nebraska","Arthur County",5,12,8,6,2
050,31,005,"Nebraska","Arthur County",5,13,8,5,3
050,31,005,"Nebraska","Arthur County",5,14,13,6,7
050,31,005,"Nebraska","Arthur County",5,15,12,4,8
050,31,005,"Nebraska","Arthur County",5,16,2,2,0
050,31,005,"Nebraska","Arthur County",5,17,10,4,6
050,31,005,"Nebraska","Arthur County",5,18,6,4,2
050,31,005,"Nebraska","Arthur County",5,19,5,2,3
050,31,005,"Nebraska","Arthur County",5,20,8,2,6
050,31,005,"Nebraska","Arthur County",5,21,4,2,2
050,31,005,"Nebraska","Arthur County",5,22,2,2,0
050,31,005,"Nebraska","Arthur County",5,23,5,3,2
050,31,005,"Nebraska","Arthur County",5,24,4,0,4
050,31,005,"Nebraska","Arthur County",5,25,2,2,0
050,31,005,"Nebraska","Arthur County",5,26,5,1,4
050,31,005,"Nebraska","Arthur County",5,27,5,1,4
050,31,005,"Nebraska","Arthur County",5,28,7,3,4
050,31,005,"Nebraska","Arthur County",5,29,2,2,0
050,31,005,"Nebraska","Arthur County",5,30,4,3,1
050,31,005,"Nebraska","Arthur County",5,31,5,4,1
050,31,005,"Nebraska","Arthur County",5,32,5,3,2
050,31,005,"Nebraska","Arthur County",5,33,5,3,2
050,31,005,"Nebraska","Arthur County",5,34,4,3,1
050,31,005,"Nebraska","Arthur County",5,35,3,2,1
050,31,005,"Nebraska","Arthur County",5,36,3,3,0
050,31,005,"Nebraska","Arthur County",5,37,4,2,2
050,31,005,"Nebraska","Arthur County",5,38,4,1,3
050,31,005,"Nebraska","Arthur County",5,39,3,2,1
050,31,005,"Nebraska","Arthur County",5,40,2,1,1
050,31,005,"Nebraska","Arthur County",5,41,3,1,2
050,31,005,"Nebraska","Arthur County",5,42,5,1,4
050,31,005,"Nebraska","Arthur County",5,43,7,3,4
050,31,005,"Nebraska","Arthur County",5,44,9,4,5
050,31,005,"Nebraska","Arthur County",5,45,9,5,4
050,31,005,"Nebraska","Arthur County",5,46,6,4,2
050,31,005,"Nebraska","Arthur County",5,47,5,3,2
050,31,005,"Nebraska","Arthur County",5,48,3,0,3
050,31,005,"Nebraska","Arthur County",5,49,4,2,2
050,31,005,"Nebraska","Arthur County",5,50,5,2,3
050,31,005,"Nebraska","Arthur County",5,51,6,3,3
050,31,005,"Nebraska","Arthur County",5,52,5,2,3
050,31,005,"Nebraska","Arthur County",5,53,2,1,1
050,31,005,"Nebraska","Arthur County",5,54,4,3,1
050,31,005,"Nebraska","Arthur County",5,55,5,2,3
050,31,005,"Nebraska","Arthur County",5,56,4,1,3
050,31,005,"Nebraska","Arthur County",5,57,7,4,3
050,31,005,"Nebraska","Arthur County",5,58,5,3,2
050,31,005,"Nebraska","Arthur County",5,59,4,3,1
050,31,005,"Nebraska","Arthur County",5,60,6,5,1
050,31,005,"Nebraska","Arthur County",5,61,7,3,4
050,31,005,"Nebraska","Arthur County",5,62,4,3,1
050,31,005,"Nebraska","Arthur County",5,63,3,1,2
050,31,005,"Nebraska","Arthur County",5,64,2,2,0
050,31,005,"Nebraska","Arthur County",5,65,6,3,3
050,31,005,"Nebraska","Arthur County",5,66,6,3,3
050,31,005,"Nebraska","Arthur County",5,67,4,2,2
050,31,005,"Nebraska","Arthur County",5,68,4,3,1
050,31,005,"Nebraska","Arthur County",5,69,4,2,2
050,31,005,"Nebraska","Arthur County",5,70,5,2,3
050,31,005,"Nebraska","Arthur County",5,71,7,4,3
050,31,005,"Nebraska","Arthur County",5,72,4,2,2
050,31,005,"Nebraska","Arthur County",5,73,6,4,2
050,31,005,"Nebraska","Arthur County",5,74,6,3,3
050,31,005,"Nebraska","Arthur County",5,75,4,2,2
050,31,005,"Nebraska","Arthur County",5,76,3,1,2
050,31,005,"Nebraska","Arthur County",5,77,3,1,2
050,31,005,"Nebraska","Arthur County",5,78,3,1,2
050,31,005,"Nebraska","Arthur County",5,79,3,2,1
050,31,005,"Nebraska","Arthur County",5,80,4,2,2
050,31,005,"Nebraska","Arthur County",5,81,3,1,2
050,31,005,"Nebraska","Arthur County",5,82,3,2,1
050,31,005,"Nebraska","Arthur County",5,83,2,0,2
050,31,005,"Nebraska","Arthur County",5,84,1,0,1
050,31,005,"Nebraska","Arthur County",5,85,15,7,8
050,31,007,"Nebraska","Banner County",1,0,7,4,3
050,31,007,"Nebraska","Banner County",1,1,8,5,3
050,31,007,"Nebraska","Banner County",1,2,13,7,6
050,31,007,"Nebraska","Banner County",1,3,9,5,4
050,31,007,"Nebraska","Banner County",1,4,11,6,5
050,31,007,"Nebraska","Banner County",1,5,8,5,3
050,31,007,"Nebraska","Banner County",1,6,10,6,4
050,31,007,"Nebraska","Banner County",1,7,11,4,7
050,31,007,"Nebraska","Banner County",1,8,10,5,5
050,31,007,"Nebraska","Banner County",1,9,6,3,3
050,31,007,"Nebraska","Banner County",1,10,11,7,4
050,31,007,"Nebraska","Banner County",1,11,10,5,5
050,31,007,"Nebraska","Banner County",1,12,9,5,4
050,31,007,"Nebraska","Banner County",1,13,7,4,3
050,31,007,"Nebraska","Banner County",1,14,8,4,4
050,31,007,"Nebraska","Banner County",1,15,6,2,4
050,31,007,"Nebraska","Banner County",1,16,12,3,9
050,31,007,"Nebraska","Banner County",1,17,8,3,5
050,31,007,"Nebraska","Banner County",1,18,9,4,5
050,31,007,"Nebraska","Banner County",1,19,1,0,1
050,31,007,"Nebraska","Banner County",1,20,3,3,0
050,31,007,"Nebraska","Banner County",1,21,3,0,3
050,31,007,"Nebraska","Banner County",1,22,5,1,4
050,31,007,"Nebraska","Banner County",1,23,5,3,2
050,31,007,"Nebraska","Banner County",1,24,6,3,3
050,31,007,"Nebraska","Banner County",1,25,8,3,5
050,31,007,"Nebraska","Banner County",1,26,8,5,3
050,31,007,"Nebraska","Banner County",1,27,7,2,5
050,31,007,"Nebraska","Banner County",1,28,7,4,3
050,31,007,"Nebraska","Banner County",1,29,5,2,3
050,31,007,"Nebraska","Banner County",1,30,8,2,6
050,31,007,"Nebraska","Banner County",1,31,15,8,7
050,31,007,"Nebraska","Banner County",1,32,7,4,3
050,31,007,"Nebraska","Banner County",1,33,6,3,3
050,31,007,"Nebraska","Banner County",1,34,5,3,2
050,31,007,"Nebraska","Banner County",1,35,4,2,2
050,31,007,"Nebraska","Banner County",1,36,5,3,2
050,31,007,"Nebraska","Banner County",1,37,9,5,4
050,31,007,"Nebraska","Banner County",1,38,8,4,4
050,31,007,"Nebraska","Banner County",1,39,9,4,5
050,31,007,"Nebraska","Banner County",1,40,9,3,6
050,31,007,"Nebraska","Banner County",1,41,11,6,5
050,31,007,"Nebraska","Banner County",1,42,11,6,5
050,31,007,"Nebraska","Banner County",1,43,4,3,1
050,31,007,"Nebraska","Banner County",1,44,6,3,3
050,31,007,"Nebraska","Banner County",1,45,4,2,2
050,31,007,"Nebraska","Banner County",1,46,6,4,2
050,31,007,"Nebraska","Banner County",1,47,2,1,1
050,31,007,"Nebraska","Banner County",1,48,4,1,3
050,31,007,"Nebraska","Banner County",1,49,9,2,7
050,31,007,"Nebraska","Banner County",1,50,6,3,3
050,31,007,"Nebraska","Banner County",1,51,6,3,3
050,31,007,"Nebraska","Banner County",1,52,6,3,3
050,31,007,"Nebraska","Banner County",1,53,6,3,3
050,31,007,"Nebraska","Banner County",1,54,5,2,3
050,31,007,"Nebraska","Banner County",1,55,8,3,5
050,31,007,"Nebraska","Banner County",1,56,12,3,9
050,31,007,"Nebraska","Banner County",1,57,13,3,10
050,31,007,"Nebraska","Banner County",1,58,10,6,4
050,31,007,"Nebraska","Banner County",1,59,10,5,5
050,31,007,"Nebraska","Banner County",1,60,12,6,6
050,31,007,"Nebraska","Banner County",1,61,13,7,6
050,31,007,"Nebraska","Banner County",1,62,15,9,6
050,31,007,"Nebraska","Banner County",1,63,12,5,7
050,31,007,"Nebraska","Banner County",1,64,10,5,5
050,31,007,"Nebraska","Banner County",1,65,13,8,5
050,31,007,"Nebraska","Banner County",1,66,11,8,3
050,31,007,"Nebraska","Banner County",1,67,10,7,3
050,31,007,"Nebraska","Banner County",1,68,13,10,3
050,31,007,"Nebraska","Banner County",1,69,14,8,6
050,31,007,"Nebraska","Banner County",1,70,12,5,7
050,31,007,"Nebraska","Banner County",1,71,10,5,5
050,31,007,"Nebraska","Banner County",1,72,14,8,6
050,31,007,"Nebraska","Banner County",1,73,6,3,3
050,31,007,"Nebraska","Banner County",1,74,4,2,2
050,31,007,"Nebraska","Banner County",1,75,8,3,5
050,31,007,"Nebraska","Banner County",1,76,4,2,2
050,31,007,"Nebraska","Banner County",1,77,4,2,2
050,31,007,"Nebraska","Banner County",1,78,3,2,1
050,31,007,"Nebraska","Banner County",1,79,3,2,1
050,31,007,"Nebraska","Banner County",1,80,2,0,2
050,31,007,"Nebraska","Banner County",1,81,2,0,2
050,31,007,"Nebraska","Banner County",1,82,4,2,2
050,31,007,"Nebraska","Banner County",1,83,4,2,2
050,31,007,"Nebraska","Banner County",1,84,2,1,1
050,31,007,"Nebraska","Banner County",1,85,16,7,9
050,31,007,"Nebraska","Banner County",2,0,7,5,2
050,31,007,"Nebraska","Banner County",2,1,8,5,3
050,31,007,"Nebraska","Banner County",2,2,12,7,5
050,31,007,"Nebraska","Banner County",2,3,10,6,4
050,31,007,"Nebraska","Banner County",2,4,11,6,5
050,31,007,"Nebraska","Banner County",2,5,8,5,3
050,31,007,"Nebraska","Banner County",2,6,9,5,4
050,31,007,"Nebraska","Banner County",2,7,11,4,7
050,31,007,"Nebraska","Banner County",2,8,10,4,6
050,31,007,"Nebraska","Banner County",2,9,7,4,3
050,31,007,"Nebraska","Banner County",2,10,11,7,4
050,31,007,"Nebraska","Banner County",2,11,11,6,5
050,31,007,"Nebraska","Banner County",2,12,9,5,4
050,31,007,"Nebraska","Banner County",2,13,7,4,3
050,31,007,"Nebraska","Banner County",2,14,8,4,4
050,31,007,"Nebraska","Banner County",2,15,6,2,4
050,31,007,"Nebraska","Banner County",2,16,11,3,8
050,31,007,"Nebraska","Banner County",2,17,9,3,6
050,31,007,"Nebraska","Banner County",2,18,8,4,4
050,31,007,"Nebraska","Banner County",2,19,3,1,2
050,31,007,"Nebraska","Banner County",2,20,2,2,0
050,31,007,"Nebraska","Banner County",2,21,2,0,2
050,31,007,"Nebraska","Banner County",2,22,5,1,4
050,31,007,"Nebraska","Banner County",2,23,5,2,3
050,31,007,"Nebraska","Banner County",2,24,6,3,3
050,31,007,"Nebraska","Banner County",2,25,7,3,4
050,31,007,"Nebraska","Banner County",2,26,9,5,4
050,31,007,"Nebraska","Banner County",2,27,7,2,5
050,31,007,"Nebraska","Banner County",2,28,8,4,4
050,31,007,"Nebraska","Banner County",2,29,5,2,3
050,31,007,"Nebraska","Banner County",2,30,8,2,6
050,31,007,"Nebraska","Banner County",2,31,14,7,7
050,31,007,"Nebraska","Banner County",2,32,9,5,4
050,31,007,"Nebraska","Banner County",2,33,6,3,3
050,31,007,"Nebraska","Banner County",2,34,5,3,2
050,31,007,"Nebraska","Banner County",2,35,4,2,2
050,31,007,"Nebraska","Banner County",2,36,5,3,2
050,31,007,"Nebraska","Banner County",2,37,7,4,3
050,31,007,"Nebraska","Banner County",2,38,8,4,4
050,31,007,"Nebraska","Banner County",2,39,9,4,5
050,31,007,"Nebraska","Banner County",2,40,9,3,6
050,31,007,"Nebraska","Banner County",2,41,12,6,6
050,31,007,"Nebraska","Banner County",2,42,12,7,5
050,31,007,"Nebraska","Banner County",2,43,6,4,2
050,31,007,"Nebraska","Banner County",2,44,6,3,3
050,31,007,"Nebraska","Banner County",2,45,4,2,2
050,31,007,"Nebraska","Banner County",2,46,6,4,2
050,31,007,"Nebraska","Banner County",2,47,3,2,1
050,31,007,"Nebraska","Banner County",2,48,4,1,3
050,31,007,"Nebraska","Banner County",2,49,9,2,7
050,31,007,"Nebraska","Banner County",2,50,7,3,4
050,31,007,"Nebraska","Banner County",2,51,6,3,3
050,31,007,"Nebraska","Banner County",2,52,6,3,3
050,31,007,"Nebraska","Banner County",2,53,6,3,3
050,31,007,"Nebraska","Banner County",2,54,5,2,3
050,31,007,"Nebraska","Banner County",2,55,6,2,4
050,31,007,"Nebraska","Banner County",2,56,12,3,9
050,31,007,"Nebraska","Banner County",2,57,13,3,10
050,31,007,"Nebraska","Banner County",2,58,10,5,5
050,31,007,"Nebraska","Banner County",2,59,10,5,5
050,31,007,"Nebraska","Banner County",2,60,11,6,5
050,31,007,"Nebraska","Banner County",2,61,13,7,6
050,31,007,"Nebraska","Banner County",2,62,15,9,6
050,31,007,"Nebraska","Banner County",2,63,13,6,7
050,31,007,"Nebraska","Banner County",2,64,10,5,5
050,31,007,"Nebraska","Banner County",2,65,12,7,5
050,31,007,"Nebraska","Banner County",2,66,11,8,3
050,31,007,"Nebraska","Banner County",2,67,10,7,3
050,31,007,"Nebraska","Banner County",2,68,12,9,3
050,31,007,"Nebraska","Banner County",2,69,13,8,5
050,31,007,"Nebraska","Banner County",2,70,13,6,7
050,31,007,"Nebraska","Banner County",2,71,11,5,6
050,31,007,"Nebraska","Banner County",2,72,13,7,6
050,31,007,"Nebraska","Banner County",2,73,9,5,4
050,31,007,"Nebraska","Banner County",2,74,4,2,2
050,31,007,"Nebraska","Banner County",2,75,7,3,4
050,31,007,"Nebraska","Banner County",2,76,4,1,3
050,31,007,"Nebraska","Banner County",2,77,4,2,2
050,31,007,"Nebraska","Banner County",2,78,3,2,1
050,31,007,"Nebraska","Banner County",2,79,3,2,1
050,31,007,"Nebraska","Banner County",2,80,2,1,1
050,31,007,"Nebraska","Banner County",2,81,2,0,2
050,31,007,"Nebraska","Banner County",2,82,4,2,2
050,31,007,"Nebraska","Banner County",2,83,3,1,2
050,31,007,"Nebraska","Banner County",2,84,2,1,1
050,31,007,"Nebraska","Banner County",2,85,16,7,9
050,31,007,"Nebraska","Banner County",3,0,9,4,5
050,31,007,"Nebraska","Banner County",3,1,6,5,1
050,31,007,"Nebraska","Banner County",3,2,6,3,3
050,31,007,"Nebraska","Banner County",3,3,9,6,3
050,31,007,"Nebraska","Banner County",3,4,7,4,3
050,31,007,"Nebraska","Banner County",3,5,11,5,6
050,31,007,"Nebraska","Banner County",3,6,9,5,4
050,31,007,"Nebraska","Banner County",3,7,10,6,4
050,31,007,"Nebraska","Banner County",3,8,11,4,7
050,31,007,"Nebraska","Banner County",3,9,12,6,6
050,31,007,"Nebraska","Banner County",3,10,7,4,3
050,31,007,"Nebraska","Banner County",3,11,12,6,6
050,31,007,"Nebraska","Banner County",3,12,12,6,6
050,31,007,"Nebraska","Banner County",3,13,9,5,4
050,31,007,"Nebraska","Banner County",3,14,7,4,3
050,31,007,"Nebraska","Banner County",3,15,10,5,5
050,31,007,"Nebraska","Banner County",3,16,6,2,4
050,31,007,"Nebraska","Banner County",3,17,11,3,8
050,31,007,"Nebraska","Banner County",3,18,8,3,5
050,31,007,"Nebraska","Banner County",3,19,8,4,4
050,31,007,"Nebraska","Banner County",3,20,4,2,2
050,31,007,"Nebraska","Banner County",3,21,2,2,0
050,31,007,"Nebraska","Banner County",3,22,4,1,3
050,31,007,"Nebraska","Banner County",3,23,4,2,2
050,31,007,"Nebraska","Banner County",3,24,6,2,4
050,31,007,"Nebraska","Banner County",3,25,6,6,0
050,31,007,"Nebraska","Banner County",3,26,7,3,4
050,31,007,"Nebraska","Banner County",3,27,7,5,2
050,31,007,"Nebraska","Banner County",3,28,4,0,4
050,31,007,"Nebraska","Banner County",3,29,9,4,5
050,31,007,"Nebraska","Banner County",3,30,5,2,3
050,31,007,"Nebraska","Banner County",3,31,9,3,6
050,31,007,"Nebraska","Banner County",3,32,14,6,8
050,31,007,"Nebraska","Banner County",3,33,10,5,5
050,31,007,"Nebraska","Banner County",3,34,7,4,3
050,31,007,"Nebraska","Banner County",3,35,5,3,2
050,31,007,"Nebraska","Banner County",3,36,5,2,3
050,31,007,"Nebraska","Banner County",3,37,5,3,2
050,31,007,"Nebraska","Banner County",3,38,7,4,3
050,31,007,"Nebraska","Banner County",3,39,8,4,4
050,31,007,"Nebraska","Banner County",3,40,10,5,5
050,31,007,"Nebraska","Banner County",3,41,10,3,7
050,31,007,"Nebraska","Banner County",3,42,12,6,6
050,31,007,"Nebraska","Banner County",3,43,11,7,4
050,31,007,"Nebraska","Banner County",3,44,6,4,2
050,31,007,"Nebraska","Banner County",3,45,7,3,4
050,31,007,"Nebraska","Banner County",3,46,5,2,3
050,31,007,"Nebraska","Banner County",3,47,5,3,2
050,31,007,"Nebraska","Banner County",3,48,2,2,0
050,31,007,"Nebraska","Banner County",3,49,5,1,4
050,31,007,"Nebraska","Banner County",3,50,9,3,6
050,31,007,"Nebraska","Banner County",3,51,7,3,4
050,31,007,"Nebraska","Banner County",3,52,6,3,3
050,31,007,"Nebraska","Banner County",3,53,8,5,3
050,31,007,"Nebraska","Banner County",3,54,6,3,3
050,31,007,"Nebraska","Banner County",3,55,5,2,3
050,31,007,"Nebraska","Banner County",3,56,6,2,4
050,31,007,"Nebraska","Banner County",3,57,12,3,9
050,31,007,"Nebraska","Banner County",3,58,13,3,10
050,31,007,"Nebraska","Banner County",3,59,12,5,7
050,31,007,"Nebraska","Banner County",3,60,10,5,5
050,31,007,"Nebraska","Banner County",3,61,11,6,5
050,31,007,"Nebraska","Banner County",3,62,13,7,6
050,31,007,"Nebraska","Banner County",3,63,15,9,6
050,31,007,"Nebraska","Banner County",3,64,15,9,6
050,31,007,"Nebraska","Banner County",3,65,11,5,6
050,31,007,"Nebraska","Banner County",3,66,11,6,5
050,31,007,"Nebraska","Banner County",3,67,10,7,3
050,31,007,"Nebraska","Banner County",3,68,9,7,2
050,31,007,"Nebraska","Banner County",3,69,12,9,3
050,31,007,"Nebraska","Banner County",3,70,12,8,4
050,31,007,"Nebraska","Banner County",3,71,11,4,7
050,31,007,"Nebraska","Banner County",3,72,9,4,5
050,31,007,"Nebraska","Banner County",3,73,14,7,7
050,31,007,"Nebraska","Banner County",3,74,9,5,4
050,31,007,"Nebraska","Banner County",3,75,4,2,2
050,31,007,"Nebraska","Banner County",3,76,7,3,4
050,31,007,"Nebraska","Banner County",3,77,4,1,3
050,31,007,"Nebraska","Banner County",3,78,4,2,2
050,31,007,"Nebraska","Banner County",3,79,3,2,1
050,31,007,"Nebraska","Banner County",3,80,3,2,1
050,31,007,"Nebraska","Banner County",3,81,2,1,1
050,31,007,"Nebraska","Banner County",3,82,2,0,2
050,31,007,"Nebraska","Banner County",3,83,4,2,2
050,31,007,"Nebraska","Banner County",3,84,1,1,0
050,31,007,"Nebraska","Banner County",3,85,19,9,10
050,31,007,"Nebraska","Banner County",4,0,6,3,3
050,31,007,"Nebraska","Banner County",4,1,3,0,3
050,31,007,"Nebraska","Banner County",4,2,3,2,1
050,31,007,"Nebraska","Banner County",4,3,6,4,2
050,31,007,"Nebraska","Banner County",4,4,8,5,3
050,31,007,"Nebraska","Banner County",4,5,7,4,3
050,31,007,"Nebraska","Banner County",4,6,11,5,6
050,31,007,"Nebraska","Banner County",4,7,11,5,6
050,31,007,"Nebraska","Banner County",4,8,10,6,4
050,31,007,"Nebraska","Banner County",4,9,11,4,7
050,31,007,"Nebraska","Banner County",4,10,11,5,6
050,31,007,"Nebraska","Banner County",4,11,8,4,4
050,31,007,"Nebraska","Banner County",4,12,9,5,4
050,31,007,"Nebraska","Banner County",4,13,10,6,4
050,31,007,"Nebraska","Banner County",4,14,10,5,5
050,31,007,"Nebraska","Banner County",4,15,7,4,3
050,31,007,"Nebraska","Banner County",4,16,8,4,4
050,31,007,"Nebraska","Banner County",4,17,5,2,3
050,31,007,"Nebraska","Banner County",4,18,10,3,7
050,31,007,"Nebraska","Banner County",4,19,4,2,2
050,31,007,"Nebraska","Banner County",4,20,6,3,3
050,31,007,"Nebraska","Banner County",4,21,5,3,2
050,31,007,"Nebraska","Banner County",4,22,3,3,0
050,31,007,"Nebraska","Banner County",4,23,1,0,1
050,31,007,"Nebraska","Banner County",4,24,2,1,1
050,31,007,"Nebraska","Banner County",4,25,6,2,4
050,31,007,"Nebraska","Banner County",4,26,6,6,0
050,31,007,"Nebraska","Banner County",4,27,6,3,3
050,31,007,"Nebraska","Banner County",4,28,6,5,1
050,31,007,"Nebraska","Banner County",4,29,2,0,2
050,31,007,"Nebraska","Banner County",4,30,9,4,5
050,31,007,"Nebraska","Banner County",4,31,5,2,3
050,31,007,"Nebraska","Banner County",4,32,10,3,7
050,31,007,"Nebraska","Banner County",4,33,11,5,6
050,31,007,"Nebraska","Banner County",4,34,8,3,5
050,31,007,"Nebraska","Banner County",4,35,6,4,2
050,31,007,"Nebraska","Banner County",4,36,4,2,2
050,31,007,"Nebraska","Banner County",4,37,5,2,3
050,31,007,"Nebraska","Banner County",4,38,5,3,2
050,31,007,"Nebraska","Banner County",4,39,5,3,2
050,31,007,"Nebraska","Banner County",4,40,8,4,4
050,31,007,"Nebraska","Banner County",4,41,10,5,5
050,31,007,"Nebraska","Banner County",4,42,9,3,6
050,31,007,"Nebraska","Banner County",4,43,12,6,6
050,31,007,"Nebraska","Banner County",4,44,12,7,5
050,31,007,"Nebraska","Banner County",4,45,6,4,2
050,31,007,"Nebraska","Banner County",4,46,5,2,3
050,31,007,"Nebraska","Banner County",4,47,6,3,3
050,31,007,"Nebraska","Banner County",4,48,5,3,2
050,31,007,"Nebraska","Banner County",4,49,2,2,0
050,31,007,"Nebraska","Banner County",4,50,5,1,4
050,31,007,"Nebraska","Banner County",4,51,7,3,4
050,31,007,"Nebraska","Banner County",4,52,7,3,4
050,31,007,"Nebraska","Banner County",4,53,9,3,6
050,31,007,"Nebraska","Banner County",4,54,2,2,0
050,31,007,"Nebraska","Banner County",4,55,6,3,3
050,31,007,"Nebraska","Banner County",4,56,5,2,3
050,31,007,"Nebraska","Banner County",4,57,7,2,5
050,31,007,"Nebraska","Banner County",4,58,12,3,9
050,31,007,"Nebraska","Banner County",4,59,10,2,8
050,31,007,"Nebraska","Banner County",4,60,13,6,7
050,31,007,"Nebraska","Banner County",4,61,13,5,8
050,31,007,"Nebraska","Banner County",4,62,12,7,5
050,31,007,"Nebraska","Banner County",4,63,14,7,7
050,31,007,"Nebraska","Banner County",4,64,18,12,6
050,31,007,"Nebraska","Banner County",4,65,15,8,7
050,31,007,"Nebraska","Banner County",4,66,12,6,6
050,31,007,"Nebraska","Banner County",4,67,11,6,5
050,31,007,"Nebraska","Banner County",4,68,10,7,3
050,31,007,"Nebraska","Banner County",4,69,10,7,3
050,31,007,"Nebraska","Banner County",4,70,13,9,4
050,31,007,"Nebraska","Banner County",4,71,12,8,4
050,31,007,"Nebraska","Banner County",4,72,10,3,7
050,31,007,"Nebraska","Banner County",4,73,10,4,6
050,31,007,"Nebraska","Banner County",4,74,13,7,6
050,31,007,"Nebraska","Banner County",4,75,8,4,4
050,31,007,"Nebraska","Banner County",4,76,4,2,2
050,31,007,"Nebraska","Banner County",4,77,7,3,4
050,31,007,"Nebraska","Banner County",4,78,4,1,3
050,31,007,"Nebraska","Banner County",4,79,4,2,2
050,31,007,"Nebraska","Banner County",4,80,3,2,1
050,31,007,"Nebraska","Banner County",4,81,3,2,1
050,31,007,"Nebraska","Banner County",4,82,1,0,1
050,31,007,"Nebraska","Banner County",4,83,2,0,2
050,31,007,"Nebraska","Banner County",4,84,4,2,2
050,31,007,"Nebraska","Banner County",4,85,17,9,8
050,31,007,"Nebraska","Banner County",5,0,6,3,3
050,31,007,"Nebraska","Banner County",5,1,6,3,3
050,31,007,"Nebraska","Banner County",5,2,3,0,3
050,31,007,"Nebraska","Banner County",5,3,4,2,2
050,31,007,"Nebraska","Banner County",5,4,4,2,2
050,31,007,"Nebraska","Banner County",5,5,11,8,3
050,31,007,"Nebraska","Banner County",5,6,8,4,4
050,31,007,"Nebraska","Banner County",5,7,13,6,7
050,31,007,"Nebraska","Banner County",5,8,12,6,6
050,31,007,"Nebraska","Banner County",5,9,10,6,4
050,31,007,"Nebraska","Banner County",5,10,11,4,7
050,31,007,"Nebraska","Banner County",5,11,11,6,5
050,31,007,"Nebraska","Banner County",5,12,7,4,3
050,31,007,"Nebraska","Banner County",5,13,10,6,4
050,31,007,"Nebraska","Banner County",5,14,10,6,4
050,31,007,"Nebraska","Banner County",5,15,11,6,5
050,31,007,"Nebraska","Banner County",5,16,7,4,3
050,31,007,"Nebraska","Banner County",5,17,10,5,5
050,31,007,"Nebraska","Banner County",5,18,4,2,2
050,31,007,"Nebraska","Banner County",5,19,8,3,5
050,31,007,"Nebraska","Banner County",5,20,2,0,2
050,31,007,"Nebraska","Banner County",5,21,6,2,4
050,31,007,"Nebraska","Banner County",5,22,4,2,2
050,31,007,"Nebraska","Banner County",5,23,2,2,0
050,31,007,"Nebraska","Banner County",5,24,1,0,1
050,31,007,"Nebraska","Banner County",5,25,2,1,1
050,31,007,"Nebraska","Banner County",5,26,6,2,4
050,31,007,"Nebraska","Banner County",5,27,6,6,0
050,31,007,"Nebraska","Banner County",5,28,8,4,4
050,31,007,"Nebraska","Banner County",5,29,6,5,1
050,31,007,"Nebraska","Banner County",5,30,3,0,3
050,31,007,"Nebraska","Banner County",5,31,8,3,5
050,31,007,"Nebraska","Banner County",5,32,6,2,4
050,31,007,"Nebraska","Banner County",5,33,11,4,7
050,31,007,"Nebraska","Banner County",5,34,11,5,6
050,31,007,"Nebraska","Banner County",5,35,8,3,5
050,31,007,"Nebraska","Banner County",5,36,6,4,2
050,31,007,"Nebraska","Banner County",5,37,4,2,2
050,31,007,"Nebraska","Banner County",5,38,6,2,4
050,31,007,"Nebraska","Banner County",5,39,5,3,2
050,31,007,"Nebraska","Banner County",5,40,4,3,1
050,31,007,"Nebraska","Banner County",5,41,8,4,4
050,31,007,"Nebraska","Banner County",5,42,10,5,5
050,31,007,"Nebraska","Banner County",5,43,9,3,6
050,31,007,"Nebraska","Banner County",5,44,12,6,6
050,31,007,"Nebraska","Banner County",5,45,10,7,3
050,31,007,"Nebraska","Banner County",5,46,6,4,2
050,31,007,"Nebraska","Banner County",5,47,7,3,4
050,31,007,"Nebraska","Banner County",5,48,7,3,4
050,31,007,"Nebraska","Banner County",5,49,5,3,2
050,31,007,"Nebraska","Banner County",5,50,3,2,1
050,31,007,"Nebraska","Banner County",5,51,5,1,4
050,31,007,"Nebraska","Banner County",5,52,7,3,4
050,31,007,"Nebraska","Banner County",5,53,7,3,4
050,31,007,"Nebraska","Banner County",5,54,8,2,6
050,31,007,"Nebraska","Banner County",5,55,2,2,0
050,31,007,"Nebraska","Banner County",5,56,8,4,4
050,31,007,"Nebraska","Banner County",5,57,6,2,4
050,31,007,"Nebraska","Banner County",5,58,7,2,5
050,31,007,"Nebraska","Banner County",5,59,13,6,7
050,31,007,"Nebraska","Banner County",5,60,11,2,9
050,31,007,"Nebraska","Banner County",5,61,13,6,7
050,31,007,"Nebraska","Banner County",5,62,15,6,9
050,31,007,"Nebraska","Banner County",5,63,12,7,5
050,31,007,"Nebraska","Banner County",5,64,14,7,7
050,31,007,"Nebraska","Banner County",5,65,19,13,6
050,31,007,"Nebraska","Banner County",5,66,15,8,7
050,31,007,"Nebraska","Banner County",5,67,12,6,6
050,31,007,"Nebraska","Banner County",5,68,11,6,5
050,31,007,"Nebraska","Banner County",5,69,11,7,4
050,31,007,"Nebraska","Banner County",5,70,9,7,2
050,31,007,"Nebraska","Banner County",5,71,14,10,4
050,31,007,"Nebraska","Banner County",5,72,9,5,4
050,31,007,"Nebraska","Banner County",5,73,10,3,7
050,31,007,"Nebraska","Banner County",5,74,11,4,7
050,31,007,"Nebraska","Banner County",5,75,12,6,6
050,31,007,"Nebraska","Banner County",5,76,9,4,5
050,31,007,"Nebraska","Banner County",5,77,4,2,2
050,31,007,"Nebraska","Banner County",5,78,7,3,4
050,31,007,"Nebraska","Banner County",5,79,4,1,3
050,31,007,"Nebraska","Banner County",5,80,4,2,2
050,31,007,"Nebraska","Banner County",5,81,2,2,0
050,31,007,"Nebraska","Banner County",5,82,2,1,1
050,31,007,"Nebraska","Banner County",5,83,1,0,1
050,31,007,"Nebraska","Banner County",5,84,2,0,2
050,31,007,"Nebraska","Banner County",5,85,20,11,9
050,31,009,"Nebraska","Blaine County",1,0,6,3,3
050,31,009,"Nebraska","Blaine County",1,1,5,3,2
050,31,009,"Nebraska","Blaine County",1,2,4,1,3
050,31,009,"Nebraska","Blaine County",1,3,5,3,2
050,31,009,"Nebraska","Blaine County",1,4,7,3,4
050,31,009,"Nebraska","Blaine County",1,5,3,2,1
050,31,009,"Nebraska","Blaine County",1,6,5,2,3
050,31,009,"Nebraska","Blaine County",1,7,4,3,1
050,31,009,"Nebraska","Blaine County",1,8,2,1,1
050,31,009,"Nebraska","Blaine County",1,9,5,4,1
050,31,009,"Nebraska","Blaine County",1,10,7,5,2
050,31,009,"Nebraska","Blaine County",1,11,5,2,3
050,31,009,"Nebraska","Blaine County",1,12,4,2,2
050,31,009,"Nebraska","Blaine County",1,13,4,2,2
050,31,009,"Nebraska","Blaine County",1,14,5,2,3
050,31,009,"Nebraska","Blaine County",1,15,5,3,2
050,31,009,"Nebraska","Blaine County",1,16,4,2,2
050,31,009,"Nebraska","Blaine County",1,17,3,1,2
050,31,009,"Nebraska","Blaine County",1,18,4,1,3
050,31,009,"Nebraska","Blaine County",1,19,3,2,1
050,31,009,"Nebraska","Blaine County",1,20,4,2,2
050,31,009,"Nebraska","Blaine County",1,21,4,2,2
050,31,009,"Nebraska","Blaine County",1,22,6,4,2
050,31,009,"Nebraska","Blaine County",1,23,4,2,2
050,31,009,"Nebraska","Blaine County",1,24,7,4,3
050,31,009,"Nebraska","Blaine County",1,25,2,2,0
050,31,009,"Nebraska","Blaine County",1,26,4,2,2
050,31,009,"Nebraska","Blaine County",1,27,6,2,4
050,31,009,"Nebraska","Blaine County",1,28,6,2,4
050,31,009,"Nebraska","Blaine County",1,29,5,3,2
050,31,009,"Nebraska","Blaine County",1,30,5,3,2
050,31,009,"Nebraska","Blaine County",1,31,6,3,3
050,31,009,"Nebraska","Blaine County",1,32,3,2,1
050,31,009,"Nebraska","Blaine County",1,33,5,3,2
050,31,009,"Nebraska","Blaine County",1,34,1,1,0
050,31,009,"Nebraska","Blaine County",1,35,2,1,1
050,31,009,"Nebraska","Blaine County",1,36,4,2,2
050,31,009,"Nebraska","Blaine County",1,37,5,3,2
050,31,009,"Nebraska","Blaine County",1,38,8,4,4
050,31,009,"Nebraska","Blaine County",1,39,4,2,2
050,31,009,"Nebraska","Blaine County",1,40,2,0,2
050,31,009,"Nebraska","Blaine County",1,41,4,2,2
050,31,009,"Nebraska","Blaine County",1,42,5,3,2
050,31,009,"Nebraska","Blaine County",1,43,3,1,2
050,31,009,"Nebraska","Blaine County",1,44,3,1,2
050,31,009,"Nebraska","Blaine County",1,45,1,1,0
050,31,009,"Nebraska","Blaine County",1,46,2,1,1
050,31,009,"Nebraska","Blaine County",1,47,4,1,3
050,31,009,"Nebraska","Blaine County",1,48,6,3,3
050,31,009,"Nebraska","Blaine County",1,49,4,1,3
050,31,009,"Nebraska","Blaine County",1,50,6,2,4
050,31,009,"Nebraska","Blaine County",1,51,7,3,4
050,31,009,"Nebraska","Blaine County",1,52,6,3,3
050,31,009,"Nebraska","Blaine County",1,53,7,4,3
050,31,009,"Nebraska","Blaine County",1,54,7,3,4
050,31,009,"Nebraska","Blaine County",1,55,7,4,3
050,31,009,"Nebraska","Blaine County",1,56,7,4,3
050,31,009,"Nebraska","Blaine County",1,57,12,7,5
050,31,009,"Nebraska","Blaine County",1,58,10,6,4
050,31,009,"Nebraska","Blaine County",1,59,11,6,5
050,31,009,"Nebraska","Blaine County",1,60,7,4,3
050,31,009,"Nebraska","Blaine County",1,61,9,6,3
050,31,009,"Nebraska","Blaine County",1,62,8,5,3
050,31,009,"Nebraska","Blaine County",1,63,7,5,2
050,31,009,"Nebraska","Blaine County",1,64,4,4,0
050,31,009,"Nebraska","Blaine County",1,65,5,1,4
050,31,009,"Nebraska","Blaine County",1,66,7,2,5
050,31,009,"Nebraska","Blaine County",1,67,7,4,3
050,31,009,"Nebraska","Blaine County",1,68,7,4,3
050,31,009,"Nebraska","Blaine County",1,69,6,2,4
050,31,009,"Nebraska","Blaine County",1,70,7,2,5
050,31,009,"Nebraska","Blaine County",1,71,4,1,3
050,31,009,"Nebraska","Blaine County",1,72,5,3,2
050,31,009,"Nebraska","Blaine County",1,73,6,3,3
050,31,009,"Nebraska","Blaine County",1,74,4,2,2
050,31,009,"Nebraska","Blaine County",1,75,2,2,0
050,31,009,"Nebraska","Blaine County",1,76,6,5,1
050,31,009,"Nebraska","Blaine County",1,77,4,2,2
050,31,009,"Nebraska","Blaine County",1,78,3,1,2
050,31,009,"Nebraska","Blaine County",1,79,2,2,0
050,31,009,"Nebraska","Blaine County",1,80,3,2,1
050,31,009,"Nebraska","Blaine County",1,81,2,0,2
050,31,009,"Nebraska","Blaine County",1,82,2,0,2
050,31,009,"Nebraska","Blaine County",1,83,4,2,2
050,31,009,"Nebraska","Blaine County",1,84,2,0,2
050,31,009,"Nebraska","Blaine County",1,85,10,6,4
050,31,009,"Nebraska","Blaine County",2,0,4,2,2
050,31,009,"Nebraska","Blaine County",2,1,5,3,2
050,31,009,"Nebraska","Blaine County",2,2,5,2,3
050,31,009,"Nebraska","Blaine County",2,3,5,3,2
050,31,009,"Nebraska","Blaine County",2,4,7,3,4
050,31,009,"Nebraska","Blaine County",2,5,4,2,2
050,31,009,"Nebraska","Blaine County",2,6,4,2,2
050,31,009,"Nebraska","Blaine County",2,7,4,3,1
050,31,009,"Nebraska","Blaine County",2,8,2,1,1
050,31,009,"Nebraska","Blaine County",2,9,4,3,1
050,31,009,"Nebraska","Blaine County",2,10,6,4,2
050,31,009,"Nebraska","Blaine County",2,11,6,3,3
050,31,009,"Nebraska","Blaine County",2,12,4,2,2
050,31,009,"Nebraska","Blaine County",2,13,4,2,2
050,31,009,"Nebraska","Blaine County",2,14,5,2,3
050,31,009,"Nebraska","Blaine County",2,15,5,3,2
050,31,009,"Nebraska","Blaine County",2,16,4,2,2
050,31,009,"Nebraska","Blaine County",2,17,3,1,2
050,31,009,"Nebraska","Blaine County",2,18,3,1,2
050,31,009,"Nebraska","Blaine County",2,19,3,2,1
050,31,009,"Nebraska","Blaine County",2,20,3,1,2
050,31,009,"Nebraska","Blaine County",2,21,4,2,2
050,31,009,"Nebraska","Blaine County",2,22,6,4,2
050,31,009,"Nebraska","Blaine County",2,23,5,3,2
050,31,009,"Nebraska","Blaine County",2,24,7,4,3
050,31,009,"Nebraska","Blaine County",2,25,4,3,1
050,31,009,"Nebraska","Blaine County",2,26,4,2,2
050,31,009,"Nebraska","Blaine County",2,27,6,2,4
050,31,009,"Nebraska","Blaine County",2,28,7,2,5
050,31,009,"Nebraska","Blaine County",2,29,6,3,3
050,31,009,"Nebraska","Blaine County",2,30,5,3,2
050,31,009,"Nebraska","Blaine County",2,31,6,3,3
050,31,009,"Nebraska","Blaine County",2,32,4,2,2
050,31,009,"Nebraska","Blaine County",2,33,4,3,1
050,31,009,"Nebraska","Blaine County",2,34,1,1,0
050,31,009,"Nebraska","Blaine County",2,35,2,1,1
050,31,009,"Nebraska","Blaine County",2,36,4,2,2
050,31,009,"Nebraska","Blaine County",2,37,5,3,2
050,31,009,"Nebraska","Blaine County",2,38,7,4,3
050,31,009,"Nebraska","Blaine County",2,39,4,2,2
050,31,009,"Nebraska","Blaine County",2,40,3,1,2
050,31,009,"Nebraska","Blaine County",2,41,3,1,2
050,31,009,"Nebraska","Blaine County",2,42,4,2,2
050,31,009,"Nebraska","Blaine County",2,43,3,1,2
050,31,009,"Nebraska","Blaine County",2,44,3,1,2
050,31,009,"Nebraska","Blaine County",2,45,2,1,1
050,31,009,"Nebraska","Blaine County",2,46,2,1,1
050,31,009,"Nebraska","Blaine County",2,47,4,1,3
050,31,009,"Nebraska","Blaine County",2,48,6,3,3
050,31,009,"Nebraska","Blaine County",2,49,5,2,3
050,31,009,"Nebraska","Blaine County",2,50,6,2,4
050,31,009,"Nebraska","Blaine County",2,51,7,3,4
050,31,009,"Nebraska","Blaine County",2,52,6,3,3
050,31,009,"Nebraska","Blaine County",2,53,7,4,3
050,31,009,"Nebraska","Blaine County",2,54,7,3,4
050,31,009,"Nebraska","Blaine County",2,55,7,4,3
050,31,009,"Nebraska","Blaine County",2,56,7,4,3
050,31,009,"Nebraska","Blaine County",2,57,11,6,5
050,31,009,"Nebraska","Blaine County",2,58,10,6,4
050,31,009,"Nebraska","Blaine County",2,59,11,6,5
050,31,009,"Nebraska","Blaine County",2,60,8,5,3
050,31,009,"Nebraska","Blaine County",2,61,8,5,3
050,31,009,"Nebraska","Blaine County",2,62,8,5,3
050,31,009,"Nebraska","Blaine County",2,63,7,5,2
050,31,009,"Nebraska","Blaine County",2,64,4,4,0
050,31,009,"Nebraska","Blaine County",2,65,5,2,3
050,31,009,"Nebraska","Blaine County",2,66,7,2,5
050,31,009,"Nebraska","Blaine County",2,67,7,4,3
050,31,009,"Nebraska","Blaine County",2,68,7,4,3
050,31,009,"Nebraska","Blaine County",2,69,6,2,4
050,31,009,"Nebraska","Blaine County",2,70,6,2,4
050,31,009,"Nebraska","Blaine County",2,71,5,1,4
050,31,009,"Nebraska","Blaine County",2,72,5,3,2
050,31,009,"Nebraska","Blaine County",2,73,6,3,3
050,31,009,"Nebraska","Blaine County",2,74,4,2,2
050,31,009,"Nebraska","Blaine County",2,75,3,2,1
050,31,009,"Nebraska","Blaine County",2,76,5,4,1
050,31,009,"Nebraska","Blaine County",2,77,5,3,2
050,31,009,"Nebraska","Blaine County",2,78,3,1,2
050,31,009,"Nebraska","Blaine County",2,79,2,2,0
050,31,009,"Nebraska","Blaine County",2,80,3,2,1
050,31,009,"Nebraska","Blaine County",2,81,2,0,2
050,31,009,"Nebraska","Blaine County",2,82,2,0,2
050,31,009,"Nebraska","Blaine County",2,83,3,1,2
050,31,009,"Nebraska","Blaine County",2,84,2,0,2
050,31,009,"Nebraska","Blaine County",2,85,9,5,4
050,31,009,"Nebraska","Blaine County",3,0,7,3,4
050,31,009,"Nebraska","Blaine County",3,1,4,2,2
050,31,009,"Nebraska","Blaine County",3,2,6,3,3
050,31,009,"Nebraska","Blaine County",3,3,7,4,3
050,31,009,"Nebraska","Blaine County",3,4,6,4,2
050,31,009,"Nebraska","Blaine County",3,5,8,4,4
050,31,009,"Nebraska","Blaine County",3,6,5,3,2
050,31,009,"Nebraska","Blaine County",3,7,8,5,3
050,31,009,"Nebraska","Blaine County",3,8,5,3,2
050,31,009,"Nebraska","Blaine County",3,9,2,1,1
050,31,009,"Nebraska","Blaine County",3,10,5,3,2
050,31,009,"Nebraska","Blaine County",3,11,7,5,2
050,31,009,"Nebraska","Blaine County",3,12,6,3,3
050,31,009,"Nebraska","Blaine County",3,13,4,1,3
050,31,009,"Nebraska","Blaine County",3,14,4,2,2
050,31,009,"Nebraska","Blaine County",3,15,5,2,3
050,31,009,"Nebraska","Blaine County",3,16,6,4,2
050,31,009,"Nebraska","Blaine County",3,17,2,2,0
050,31,009,"Nebraska","Blaine County",3,18,3,1,2
050,31,009,"Nebraska","Blaine County",3,19,3,1,2
050,31,009,"Nebraska","Blaine County",3,20,4,2,2
050,31,009,"Nebraska","Blaine County",3,21,5,1,4
050,31,009,"Nebraska","Blaine County",3,22,1,1,0
050,31,009,"Nebraska","Blaine County",3,23,6,4,2
050,31,009,"Nebraska","Blaine County",3,24,3,0,3
050,31,009,"Nebraska","Blaine County",3,25,6,3,3
050,31,009,"Nebraska","Blaine County",3,26,8,3,5
050,31,009,"Nebraska","Blaine County",3,27,4,2,2
050,31,009,"Nebraska","Blaine County",3,28,7,3,4
050,31,009,"Nebraska","Blaine County",3,29,9,3,6
050,31,009,"Nebraska","Blaine County",3,30,8,4,4
050,31,009,"Nebraska","Blaine County",3,31,8,4,4
050,31,009,"Nebraska","Blaine County",3,32,7,3,4
050,31,009,"Nebraska","Blaine County",3,33,4,1,3
050,31,009,"Nebraska","Blaine County",3,34,4,3,1
050,31,009,"Nebraska","Blaine County",3,35,1,1,0
050,31,009,"Nebraska","Blaine County",3,36,2,1,1
050,31,009,"Nebraska","Blaine County",3,37,4,2,2
050,31,009,"Nebraska","Blaine County",3,38,5,3,2
050,31,009,"Nebraska","Blaine County",3,39,9,6,3
050,31,009,"Nebraska","Blaine County",3,40,3,2,1
050,31,009,"Nebraska","Blaine County",3,41,4,2,2
050,31,009,"Nebraska","Blaine County",3,42,3,1,2
050,31,009,"Nebraska","Blaine County",3,43,2,1,1
050,31,009,"Nebraska","Blaine County",3,44,3,1,2
050,31,009,"Nebraska","Blaine County",3,45,4,2,2
050,31,009,"Nebraska","Blaine County",3,46,2,1,1
050,31,009,"Nebraska","Blaine County",3,47,3,2,1
050,31,009,"Nebraska","Blaine County",3,48,4,1,3
050,31,009,"Nebraska","Blaine County",3,49,6,3,3
050,31,009,"Nebraska","Blaine County",3,50,5,2,3
050,31,009,"Nebraska","Blaine County",3,51,6,2,4
050,31,009,"Nebraska","Blaine County",3,52,7,3,4
050,31,009,"Nebraska","Blaine County",3,53,6,3,3
050,31,009,"Nebraska","Blaine County",3,54,8,4,4
050,31,009,"Nebraska","Blaine County",3,55,6,2,4
050,31,009,"Nebraska","Blaine County",3,56,7,4,3
050,31,009,"Nebraska","Blaine County",3,57,7,4,3
050,31,009,"Nebraska","Blaine County",3,58,11,6,5
050,31,009,"Nebraska","Blaine County",3,59,12,6,6
050,31,009,"Nebraska","Blaine County",3,60,11,6,5
050,31,009,"Nebraska","Blaine County",3,61,12,8,4
050,31,009,"Nebraska","Blaine County",3,62,8,5,3
050,31,009,"Nebraska","Blaine County",3,63,8,5,3
050,31,009,"Nebraska","Blaine County",3,64,7,5,2
050,31,009,"Nebraska","Blaine County",3,65,4,4,0
050,31,009,"Nebraska","Blaine County",3,66,5,2,3
050,31,009,"Nebraska","Blaine County",3,67,7,2,5
050,31,009,"Nebraska","Blaine County",3,68,7,4,3
050,31,009,"Nebraska","Blaine County",3,69,7,4,3
050,31,009,"Nebraska","Blaine County",3,70,5,1,4
050,31,009,"Nebraska","Blaine County",3,71,6,2,4
050,31,009,"Nebraska","Blaine County",3,72,5,1,4
050,31,009,"Nebraska","Blaine County",3,73,6,3,3
050,31,009,"Nebraska","Blaine County",3,74,5,2,3
050,31,009,"Nebraska","Blaine County",3,75,4,2,2
050,31,009,"Nebraska","Blaine County",3,76,3,2,1
050,31,009,"Nebraska","Blaine County",3,77,5,4,1
050,31,009,"Nebraska","Blaine County",3,78,5,3,2
050,31,009,"Nebraska","Blaine County",3,79,3,1,2
050,31,009,"Nebraska","Blaine County",3,80,3,2,1
050,31,009,"Nebraska","Blaine County",3,81,3,2,1
050,31,009,"Nebraska","Blaine County",3,82,2,0,2
050,31,009,"Nebraska","Blaine County",3,83,2,0,2
050,31,009,"Nebraska","Blaine County",3,84,3,1,2
050,31,009,"Nebraska","Blaine County",3,85,9,4,5
050,31,009,"Nebraska","Blaine County",4,0,6,2,4
050,31,009,"Nebraska","Blaine County",4,1,7,3,4
050,31,009,"Nebraska","Blaine County",4,2,4,2,2
050,31,009,"Nebraska","Blaine County",4,3,6,3,3
050,31,009,"Nebraska","Blaine County",4,4,7,4,3
050,31,009,"Nebraska","Blaine County",4,5,6,4,2
050,31,009,"Nebraska","Blaine County",4,6,7,3,4
050,31,009,"Nebraska","Blaine County",4,7,5,3,2
050,31,009,"Nebraska","Blaine County",4,8,9,6,3
050,31,009,"Nebraska","Blaine County",4,9,5,3,2
050,31,009,"Nebraska","Blaine County",4,10,2,1,1
050,31,009,"Nebraska","Blaine County",4,11,5,3,2
050,31,009,"Nebraska","Blaine County",4,12,6,4,2
050,31,009,"Nebraska","Blaine County",4,13,6,3,3
050,31,009,"Nebraska","Blaine County",4,14,3,3,0
050,31,009,"Nebraska","Blaine County",4,15,4,2,2
050,31,009,"Nebraska","Blaine County",4,16,5,2,3
050,31,009,"Nebraska","Blaine County",4,17,6,4,2
050,31,009,"Nebraska","Blaine County",4,18,2,2,0
050,31,009,"Nebraska","Blaine County",4,19,3,1,2
050,31,009,"Nebraska","Blaine County",4,20,3,1,2
050,31,009,"Nebraska","Blaine County",4,21,4,2,2
050,31,009,"Nebraska","Blaine County",4,22,5,1,4
050,31,009,"Nebraska","Blaine County",4,23,1,1,0
050,31,009,"Nebraska","Blaine County",4,24,6,5,1
050,31,009,"Nebraska","Blaine County",4,25,3,0,3
050,31,009,"Nebraska","Blaine County",4,26,6,3,3
050,31,009,"Nebraska","Blaine County",4,27,7,3,4
050,31,009,"Nebraska","Blaine County",4,28,4,2,2
050,31,009,"Nebraska","Blaine County",4,29,7,2,5
050,31,009,"Nebraska","Blaine County",4,30,9,3,6
050,31,009,"Nebraska","Blaine County",4,31,10,5,5
050,31,009,"Nebraska","Blaine County",4,32,7,3,4
050,31,009,"Nebraska","Blaine County",4,33,8,3,5
050,31,009,"Nebraska","Blaine County",4,34,3,1,2
050,31,009,"Nebraska","Blaine County",4,35,4,3,1
050,31,009,"Nebraska","Blaine County",4,36,1,1,0
050,31,009,"Nebraska","Blaine County",4,37,2,1,1
050,31,009,"Nebraska","Blaine County",4,38,4,2,2
050,31,009,"Nebraska","Blaine County",4,39,5,3,2
050,31,009,"Nebraska","Blaine County",4,40,8,6,2
050,31,009,"Nebraska","Blaine County",4,41,3,2,1
050,31,009,"Nebraska","Blaine County",4,42,4,2,2
050,31,009,"Nebraska","Blaine County",4,43,3,1,2
050,31,009,"Nebraska","Blaine County",4,44,2,1,1
050,31,009,"Nebraska","Blaine County",4,45,3,1,2
050,31,009,"Nebraska","Blaine County",4,46,3,2,1
050,31,009,"Nebraska","Blaine County",4,47,3,2,1
050,31,009,"Nebraska","Blaine County",4,48,3,2,1
050,31,009,"Nebraska","Blaine County",4,49,4,1,3
050,31,009,"Nebraska","Blaine County",4,50,6,3,3
050,31,009,"Nebraska","Blaine County",4,51,5,2,3
050,31,009,"Nebraska","Blaine County",4,52,6,2,4
050,31,009,"Nebraska","Blaine County",4,53,7,3,4
050,31,009,"Nebraska","Blaine County",4,54,9,3,6
050,31,009,"Nebraska","Blaine County",4,55,5,3,2
050,31,009,"Nebraska","Blaine County",4,56,6,2,4
050,31,009,"Nebraska","Blaine County",4,57,7,4,3
050,31,009,"Nebraska","Blaine County",4,58,7,4,3
050,31,009,"Nebraska","Blaine County",4,59,11,6,5
050,31,009,"Nebraska","Blaine County",4,60,12,6,6
050,31,009,"Nebraska","Blaine County",4,61,11,6,5
050,31,009,"Nebraska","Blaine County",4,62,12,8,4
050,31,009,"Nebraska","Blaine County",4,63,3,0,3
050,31,009,"Nebraska","Blaine County",4,64,7,5,2
050,31,009,"Nebraska","Blaine County",4,65,6,4,2
050,31,009,"Nebraska","Blaine County",4,66,4,4,0
050,31,009,"Nebraska","Blaine County",4,67,6,2,4
050,31,009,"Nebraska","Blaine County",4,68,7,2,5
050,31,009,"Nebraska","Blaine County",4,69,6,3,3
050,31,009,"Nebraska","Blaine County",4,70,6,4,2
050,31,009,"Nebraska","Blaine County",4,71,5,1,4
050,31,009,"Nebraska","Blaine County",4,72,6,2,4
050,31,009,"Nebraska","Blaine County",4,73,5,1,4
050,31,009,"Nebraska","Blaine County",4,74,5,2,3
050,31,009,"Nebraska","Blaine County",4,75,5,2,3
050,31,009,"Nebraska","Blaine County",4,76,4,2,2
050,31,009,"Nebraska","Blaine County",4,77,3,2,1
050,31,009,"Nebraska","Blaine County",4,78,5,4,1
050,31,009,"Nebraska","Blaine County",4,79,5,3,2
050,31,009,"Nebraska","Blaine County",4,80,2,1,1
050,31,009,"Nebraska","Blaine County",4,81,3,2,1
050,31,009,"Nebraska","Blaine County",4,82,1,1,0
050,31,009,"Nebraska","Blaine County",4,83,2,0,2
050,31,009,"Nebraska","Blaine County",4,84,2,0,2
050,31,009,"Nebraska","Blaine County",4,85,11,5,6
050,31,009,"Nebraska","Blaine County",5,0,7,2,5
050,31,009,"Nebraska","Blaine County",5,1,6,2,4
050,31,009,"Nebraska","Blaine County",5,2,6,2,4
050,31,009,"Nebraska","Blaine County",5,3,4,2,2
050,31,009,"Nebraska","Blaine County",5,4,5,3,2
050,31,009,"Nebraska","Blaine County",5,5,5,2,3
050,31,009,"Nebraska","Blaine County",5,6,6,4,2
050,31,009,"Nebraska","Blaine County",5,7,7,3,4
050,31,009,"Nebraska","Blaine County",5,8,6,3,3
050,31,009,"Nebraska","Blaine County",5,9,6,3,3
050,31,009,"Nebraska","Blaine County",5,10,4,3,1
050,31,009,"Nebraska","Blaine County",5,11,2,1,1
050,31,009,"Nebraska","Blaine County",5,12,5,3,2
050,31,009,"Nebraska","Blaine County",5,13,6,4,2
050,31,009,"Nebraska","Blaine County",5,14,6,3,3
050,31,009,"Nebraska","Blaine County",5,15,2,2,0
050,31,009,"Nebraska","Blaine County",5,16,4,2,2
050,31,009,"Nebraska","Blaine County",5,17,5,2,3
050,31,009,"Nebraska","Blaine County",5,18,5,3,2
050,31,009,"Nebraska","Blaine County",5,19,2,2,0
050,31,009,"Nebraska","Blaine County",5,20,3,1,2
050,31,009,"Nebraska","Blaine County",5,21,4,2,2
050,31,009,"Nebraska","Blaine County",5,22,3,2,1
050,31,009,"Nebraska","Blaine County",5,23,3,0,3
050,31,009,"Nebraska","Blaine County",5,24,1,1,0
050,31,009,"Nebraska","Blaine County",5,25,6,5,1
050,31,009,"Nebraska","Blaine County",5,26,3,0,3
050,31,009,"Nebraska","Blaine County",5,27,6,3,3
050,31,009,"Nebraska","Blaine County",5,28,4,1,3
050,31,009,"Nebraska","Blaine County",5,29,3,2,1
050,31,009,"Nebraska","Blaine County",5,30,6,1,5
050,31,009,"Nebraska","Blaine County",5,31,7,2,5
050,31,009,"Nebraska","Blaine County",5,32,8,4,4
050,31,009,"Nebraska","Blaine County",5,33,4,1,3
050,31,009,"Nebraska","Blaine County",5,34,8,3,5
050,31,009,"Nebraska","Blaine County",5,35,4,1,3
050,31,009,"Nebraska","Blaine County",5,36,4,2,2
050,31,009,"Nebraska","Blaine County",5,37,1,1,0
050,31,009,"Nebraska","Blaine County",5,38,3,1,2
050,31,009,"Nebraska","Blaine County",5,39,4,2,2
050,31,009,"Nebraska","Blaine County",5,40,5,3,2
050,31,009,"Nebraska","Blaine County",5,41,8,6,2
050,31,009,"Nebraska","Blaine County",5,42,3,2,1
050,31,009,"Nebraska","Blaine County",5,43,5,3,2
050,31,009,"Nebraska","Blaine County",5,44,3,1,2
050,31,009,"Nebraska","Blaine County",5,45,2,1,1
050,31,009,"Nebraska","Blaine County",5,46,3,1,2
050,31,009,"Nebraska","Blaine County",5,47,3,2,1
050,31,009,"Nebraska","Blaine County",5,48,3,2,1
050,31,009,"Nebraska","Blaine County",5,49,3,2,1
050,31,009,"Nebraska","Blaine County",5,50,4,1,3
050,31,009,"Nebraska","Blaine County",5,51,6,3,3
050,31,009,"Nebraska","Blaine County",5,52,5,2,3
050,31,009,"Nebraska","Blaine County",5,53,5,2,3
050,31,009,"Nebraska","Blaine County",5,54,7,3,4
050,31,009,"Nebraska","Blaine County",5,55,8,2,6
050,31,009,"Nebraska","Blaine County",5,56,5,3,2
050,31,009,"Nebraska","Blaine County",5,57,6,2,4
050,31,009,"Nebraska","Blaine County",5,58,7,4,3
050,31,009,"Nebraska","Blaine County",5,59,7,4,3
050,31,009,"Nebraska","Blaine County",5,60,12,6,6
050,31,009,"Nebraska","Blaine County",5,61,14,8,6
050,31,009,"Nebraska","Blaine County",5,62,12,6,6
050,31,009,"Nebraska","Blaine County",5,63,12,8,4
050,31,009,"Nebraska","Blaine County",5,64,3,0,3
050,31,009,"Nebraska","Blaine County",5,65,8,6,2
050,31,009,"Nebraska","Blaine County",5,66,5,4,1
050,31,009,"Nebraska","Blaine County",5,67,5,5,0
050,31,009,"Nebraska","Blaine County",5,68,6,2,4
050,31,009,"Nebraska","Blaine County",5,69,6,1,5
050,31,009,"Nebraska","Blaine County",5,70,6,3,3
050,31,009,"Nebraska","Blaine County",5,71,5,3,2
050,31,009,"Nebraska","Blaine County",5,72,5,1,4
050,31,009,"Nebraska","Blaine County",5,73,6,2,4
050,31,009,"Nebraska","Blaine County",5,74,5,1,4
050,31,009,"Nebraska","Blaine County",5,75,6,3,3
050,31,009,"Nebraska","Blaine County",5,76,5,2,3
050,31,009,"Nebraska","Blaine County",5,77,4,2,2
050,31,009,"Nebraska","Blaine County",5,78,3,2,1
050,31,009,"Nebraska","Blaine County",5,79,5,4,1
050,31,009,"Nebraska","Blaine County",5,80,4,3,1
050,31,009,"Nebraska","Blaine County",5,81,2,1,1
050,31,009,"Nebraska","Blaine County",5,82,1,1,0
050,31,009,"Nebraska","Blaine County",5,83,1,1,0
050,31,009,"Nebraska","Blaine County",5,84,2,0,2
050,31,009,"Nebraska","Blaine County",5,85,11,5,6
050,31,011,"Nebraska","Boone County",1,0,73,38,35
050,31,011,"Nebraska","Boone County",1,1,69,33,36
050,31,011,"Nebraska","Boone County",1,2,62,23,39
050,31,011,"Nebraska","Boone County",1,3,66,33,33
050,31,011,"Nebraska","Boone County",1,4,78,45,33
050,31,011,"Nebraska","Boone County",1,5,69,32,37
050,31,011,"Nebraska","Boone County",1,6,68,36,32
050,31,011,"Nebraska","Boone County",1,7,78,41,37
050,31,011,"Nebraska","Boone County",1,8,59,26,33
050,31,011,"Nebraska","Boone County",1,9,76,38,38
050,31,011,"Nebraska","Boone County",1,10,76,40,36
050,31,011,"Nebraska","Boone County",1,11,80,33,47
050,31,011,"Nebraska","Boone County",1,12,73,30,43
050,31,011,"Nebraska","Boone County",1,13,79,39,40
050,31,011,"Nebraska","Boone County",1,14,70,38,32
050,31,011,"Nebraska","Boone County",1,15,71,40,31
050,31,011,"Nebraska","Boone County",1,16,74,41,33
050,31,011,"Nebraska","Boone County",1,17,62,27,35
050,31,011,"Nebraska","Boone County",1,18,63,33,30
050,31,011,"Nebraska","Boone County",1,19,49,27,22
050,31,011,"Nebraska","Boone County",1,20,43,21,22
050,31,011,"Nebraska","Boone County",1,21,49,26,23
050,31,011,"Nebraska","Boone County",1,22,59,34,25
050,31,011,"Nebraska","Boone County",1,23,62,35,27
050,31,011,"Nebraska","Boone County",1,24,56,33,23
050,31,011,"Nebraska","Boone County",1,25,42,22,20
050,31,011,"Nebraska","Boone County",1,26,54,25,29
050,31,011,"Nebraska","Boone County",1,27,52,27,25
050,31,011,"Nebraska","Boone County",1,28,56,28,28
050,31,011,"Nebraska","Boone County",1,29,61,29,32
050,31,011,"Nebraska","Boone County",1,30,50,24,26
050,31,011,"Nebraska","Boone County",1,31,60,33,27
050,31,011,"Nebraska","Boone County",1,32,59,32,27
050,31,011,"Nebraska","Boone County",1,33,43,24,19
050,31,011,"Nebraska","Boone County",1,34,51,25,26
050,31,011,"Nebraska","Boone County",1,35,60,28,32
050,31,011,"Nebraska","Boone County",1,36,58,33,25
050,31,011,"Nebraska","Boone County",1,37,59,37,22
050,31,011,"Nebraska","Boone County",1,38,57,31,26
050,31,011,"Nebraska","Boone County",1,39,61,28,33
050,31,011,"Nebraska","Boone County",1,40,57,29,28
050,31,011,"Nebraska","Boone County",1,41,59,36,23
050,31,011,"Nebraska","Boone County",1,42,53,28,25
050,31,011,"Nebraska","Boone County",1,43,44,18,26
050,31,011,"Nebraska","Boone County",1,44,41,20,21
050,31,011,"Nebraska","Boone County",1,45,52,30,22
050,31,011,"Nebraska","Boone County",1,46,51,29,22
050,31,011,"Nebraska","Boone County",1,47,52,28,24
050,31,011,"Nebraska","Boone County",1,48,50,24,26
050,31,011,"Nebraska","Boone County",1,49,47,27,20
050,31,011,"Nebraska","Boone County",1,50,49,27,22
050,31,011,"Nebraska","Boone County",1,51,63,30,33
050,31,011,"Nebraska","Boone County",1,52,54,26,28
050,31,011,"Nebraska","Boone County",1,53,76,37,39
050,31,011,"Nebraska","Boone County",1,54,70,38,32
050,31,011,"Nebraska","Boone County",1,55,66,30,36
050,31,011,"Nebraska","Boone County",1,56,72,34,38
050,31,011,"Nebraska","Boone County",1,57,90,52,38
050,31,011,"Nebraska","Boone County",1,58,82,43,39
050,31,011,"Nebraska","Boone County",1,59,94,46,48
050,31,011,"Nebraska","Boone County",1,60,75,36,39
050,31,011,"Nebraska","Boone County",1,61,92,51,41
050,31,011,"Nebraska","Boone County",1,62,97,51,46
050,31,011,"Nebraska","Boone County",1,63,92,52,40
050,31,011,"Nebraska","Boone County",1,64,90,50,40
050,31,011,"Nebraska","Boone County",1,65,84,46,38
050,31,011,"Nebraska","Boone County",1,66,76,44,32
050,31,011,"Nebraska","Boone County",1,67,70,35,35
050,31,011,"Nebraska","Boone County",1,68,69,35,34
050,31,011,"Nebraska","Boone County",1,69,55,27,28
050,31,011,"Nebraska","Boone County",1,70,54,27,27
050,31,011,"Nebraska","Boone County",1,71,57,28,29
050,31,011,"Nebraska","Boone County",1,72,54,29,25
050,31,011,"Nebraska","Boone County",1,73,55,24,31
050,31,011,"Nebraska","Boone County",1,74,42,20,22
050,31,011,"Nebraska","Boone County",1,75,43,17,26
050,31,011,"Nebraska","Boone County",1,76,50,24,26
050,31,011,"Nebraska","Boone County",1,77,51,24,27
050,31,011,"Nebraska","Boone County",1,78,45,25,20
050,31,011,"Nebraska","Boone County",1,79,36,20,16
050,31,011,"Nebraska","Boone County",1,80,30,13,17
050,31,011,"Nebraska","Boone County",1,81,29,13,16
050,31,011,"Nebraska","Boone County",1,82,41,15,26
050,31,011,"Nebraska","Boone County",1,83,33,13,20
050,31,011,"Nebraska","Boone County",1,84,37,17,20
050,31,011,"Nebraska","Boone County",1,85,209,64,145
050,31,011,"Nebraska","Boone County",2,0,74,41,33
050,31,011,"Nebraska","Boone County",2,1,69,33,36
050,31,011,"Nebraska","Boone County",2,2,64,25,39
050,31,011,"Nebraska","Boone County",2,3,66,31,35
050,31,011,"Nebraska","Boone County",2,4,75,42,33
050,31,011,"Nebraska","Boone County",2,5,71,35,36
050,31,011,"Nebraska","Boone County",2,6,68,35,33
050,31,011,"Nebraska","Boone County",2,7,76,40,36
050,31,011,"Nebraska","Boone County",2,8,63,30,33
050,31,011,"Nebraska","Boone County",2,9,71,35,36
050,31,011,"Nebraska","Boone County",2,10,76,39,37
050,31,011,"Nebraska","Boone County",2,11,77,33,44
050,31,011,"Nebraska","Boone County",2,12,74,31,43
050,31,011,"Nebraska","Boone County",2,13,75,36,39
050,31,011,"Nebraska","Boone County",2,14,72,39,33
050,31,011,"Nebraska","Boone County",2,15,71,40,31
050,31,011,"Nebraska","Boone County",2,16,73,41,32
050,31,011,"Nebraska","Boone County",2,17,64,30,34
050,31,011,"Nebraska","Boone County",2,18,58,30,28
050,31,011,"Nebraska","Boone County",2,19,50,27,23
050,31,011,"Nebraska","Boone County",2,20,44,22,22
050,31,011,"Nebraska","Boone County",2,21,49,26,23
050,31,011,"Nebraska","Boone County",2,22,58,32,26
050,31,011,"Nebraska","Boone County",2,23,63,36,27
050,31,011,"Nebraska","Boone County",2,24,56,33,23
050,31,011,"Nebraska","Boone County",2,25,44,24,20
050,31,011,"Nebraska","Boone County",2,26,52,25,27
050,31,011,"Nebraska","Boone County",2,27,52,26,26
050,31,011,"Nebraska","Boone County",2,28,54,28,26
050,31,011,"Nebraska","Boone County",2,29,61,29,32
050,31,011,"Nebraska","Boone County",2,30,52,24,28
050,31,011,"Nebraska","Boone County",2,31,57,31,26
050,31,011,"Nebraska","Boone County",2,32,59,32,27
050,31,011,"Nebraska","Boone County",2,33,47,26,21
050,31,011,"Nebraska","Boone County",2,34,49,25,24
050,31,011,"Nebraska","Boone County",2,35,57,27,30
050,31,011,"Nebraska","Boone County",2,36,58,32,26
050,31,011,"Nebraska","Boone County",2,37,58,35,23
050,31,011,"Nebraska","Boone County",2,38,56,31,25
050,31,011,"Nebraska","Boone County",2,39,60,29,31
050,31,011,"Nebraska","Boone County",2,40,60,30,30
050,31,011,"Nebraska","Boone County",2,41,58,34,24
050,31,011,"Nebraska","Boone County",2,42,53,29,24
050,31,011,"Nebraska","Boone County",2,43,46,20,26
050,31,011,"Nebraska","Boone County",2,44,40,19,21
050,31,011,"Nebraska","Boone County",2,45,50,28,22
050,31,011,"Nebraska","Boone County",2,46,51,29,22
050,31,011,"Nebraska","Boone County",2,47,52,29,23
050,31,011,"Nebraska","Boone County",2,48,50,25,25
050,31,011,"Nebraska","Boone County",2,49,48,27,21
050,31,011,"Nebraska","Boone County",2,50,49,27,22
050,31,011,"Nebraska","Boone County",2,51,59,29,30
050,31,011,"Nebraska","Boone County",2,52,57,27,30
050,31,011,"Nebraska","Boone County",2,53,70,34,36
050,31,011,"Nebraska","Boone County",2,54,70,37,33
050,31,011,"Nebraska","Boone County",2,55,67,32,35
050,31,011,"Nebraska","Boone County",2,56,71,33,38
050,31,011,"Nebraska","Boone County",2,57,85,47,38
050,31,011,"Nebraska","Boone County",2,58,83,45,38
050,31,011,"Nebraska","Boone County",2,59,90,45,45
050,31,011,"Nebraska","Boone County",2,60,79,38,41
050,31,011,"Nebraska","Boone County",2,61,88,47,41
050,31,011,"Nebraska","Boone County",2,62,96,51,45
050,31,011,"Nebraska","Boone County",2,63,95,53,42
050,31,011,"Nebraska","Boone County",2,64,90,50,40
050,31,011,"Nebraska","Boone County",2,65,86,47,39
050,31,011,"Nebraska","Boone County",2,66,76,43,33
050,31,011,"Nebraska","Boone County",2,67,70,37,33
050,31,011,"Nebraska","Boone County",2,68,69,35,34
050,31,011,"Nebraska","Boone County",2,69,60,30,30
050,31,011,"Nebraska","Boone County",2,70,53,26,27
050,31,011,"Nebraska","Boone County",2,71,56,27,29
050,31,011,"Nebraska","Boone County",2,72,54,29,25
050,31,011,"Nebraska","Boone County",2,73,57,27,30
050,31,011,"Nebraska","Boone County",2,74,43,20,23
050,31,011,"Nebraska","Boone County",2,75,43,18,25
050,31,011,"Nebraska","Boone County",2,76,47,22,25
050,31,011,"Nebraska","Boone County",2,77,53,25,28
050,31,011,"Nebraska","Boone County",2,78,43,23,20
050,31,011,"Nebraska","Boone County",2,79,38,21,17
050,31,011,"Nebraska","Boone County",2,80,31,14,17
050,31,011,"Nebraska","Boone County",2,81,29,13,16
050,31,011,"Nebraska","Boone County",2,82,39,15,24
050,31,011,"Nebraska","Boone County",2,83,34,13,21
050,31,011,"Nebraska","Boone County",2,84,37,17,20
050,31,011,"Nebraska","Boone County",2,85,209,64,145
050,31,011,"Nebraska","Boone County",3,0,59,27,32
050,31,011,"Nebraska","Boone County",3,1,79,43,36
050,31,011,"Nebraska","Boone County",3,2,68,32,36
050,31,011,"Nebraska","Boone County",3,3,64,27,37
050,31,011,"Nebraska","Boone County",3,4,68,31,37
050,31,011,"Nebraska","Boone County",3,5,75,42,33
050,31,011,"Nebraska","Boone County",3,6,74,37,37
050,31,011,"Nebraska","Boone County",3,7,76,36,40
050,31,011,"Nebraska","Boone County",3,8,81,42,39
050,31,011,"Nebraska","Boone County",3,9,62,30,32
050,31,011,"Nebraska","Boone County",3,10,67,31,36
050,31,011,"Nebraska","Boone County",3,11,82,40,42
050,31,011,"Nebraska","Boone County",3,12,80,36,44
050,31,011,"Nebraska","Boone County",3,13,74,32,42
050,31,011,"Nebraska","Boone County",3,14,76,37,39
050,31,011,"Nebraska","Boone County",3,15,71,39,32
050,31,011,"Nebraska","Boone County",3,16,71,40,31
050,31,011,"Nebraska","Boone County",3,17,75,43,32
050,31,011,"Nebraska","Boone County",3,18,56,26,30
050,31,011,"Nebraska","Boone County",3,19,42,24,18
050,31,011,"Nebraska","Boone County",3,20,53,26,27
050,31,011,"Nebraska","Boone County",3,21,44,21,23
050,31,011,"Nebraska","Boone County",3,22,48,25,23
050,31,011,"Nebraska","Boone County",3,23,56,32,24
050,31,011,"Nebraska","Boone County",3,24,68,38,30
050,31,011,"Nebraska","Boone County",3,25,50,27,23
050,31,011,"Nebraska","Boone County",3,26,48,26,22
050,31,011,"Nebraska","Boone County",3,27,51,23,28
050,31,011,"Nebraska","Boone County",3,28,50,25,25
050,31,011,"Nebraska","Boone County",3,29,62,31,31
050,31,011,"Nebraska","Boone County",3,30,59,30,29
050,31,011,"Nebraska","Boone County",3,31,57,27,30
050,31,011,"Nebraska","Boone County",3,32,56,33,23
050,31,011,"Nebraska","Boone County",3,33,64,38,26
050,31,011,"Nebraska","Boone County",3,34,55,30,25
050,31,011,"Nebraska","Boone County",3,35,50,25,25
050,31,011,"Nebraska","Boone County",3,36,61,29,32
050,31,011,"Nebraska","Boone County",3,37,56,29,27
050,31,011,"Nebraska","Boone County",3,38,62,37,25
050,31,011,"Nebraska","Boone County",3,39,56,30,26
050,31,011,"Nebraska","Boone County",3,40,61,31,30
050,31,011,"Nebraska","Boone County",3,41,63,34,29
050,31,011,"Nebraska","Boone County",3,42,58,34,24
050,31,011,"Nebraska","Boone County",3,43,54,30,24
050,31,011,"Nebraska","Boone County",3,44,46,21,25
050,31,011,"Nebraska","Boone County",3,45,40,19,21
050,31,011,"Nebraska","Boone County",3,46,51,28,23
050,31,011,"Nebraska","Boone County",3,47,51,30,21
050,31,011,"Nebraska","Boone County",3,48,54,29,25
050,31,011,"Nebraska","Boone County",3,49,53,24,29
050,31,011,"Nebraska","Boone County",3,50,51,29,22
050,31,011,"Nebraska","Boone County",3,51,46,27,19
050,31,011,"Nebraska","Boone County",3,52,59,29,30
050,31,011,"Nebraska","Boone County",3,53,54,24,30
050,31,011,"Nebraska","Boone County",3,54,69,34,35
050,31,011,"Nebraska","Boone County",3,55,69,36,33
050,31,011,"Nebraska","Boone County",3,56,63,31,32
050,31,011,"Nebraska","Boone County",3,57,74,36,38
050,31,011,"Nebraska","Boone County",3,58,85,47,38
050,31,011,"Nebraska","Boone County",3,59,87,48,39
050,31,011,"Nebraska","Boone County",3,60,90,45,45
050,31,011,"Nebraska","Boone County",3,61,80,38,42
050,31,011,"Nebraska","Boone County",3,62,91,48,43
050,31,011,"Nebraska","Boone County",3,63,97,51,46
050,31,011,"Nebraska","Boone County",3,64,96,55,41
050,31,011,"Nebraska","Boone County",3,65,88,49,39
050,31,011,"Nebraska","Boone County",3,66,85,46,39
050,31,011,"Nebraska","Boone County",3,67,75,42,33
050,31,011,"Nebraska","Boone County",3,68,68,37,31
050,31,011,"Nebraska","Boone County",3,69,68,35,33
050,31,011,"Nebraska","Boone County",3,70,58,29,29
050,31,011,"Nebraska","Boone County",3,71,58,27,31
050,31,011,"Nebraska","Boone County",3,72,55,28,27
050,31,011,"Nebraska","Boone County",3,73,49,28,21
050,31,011,"Nebraska","Boone County",3,74,53,25,28
050,31,011,"Nebraska","Boone County",3,75,38,17,21
050,31,011,"Nebraska","Boone County",3,76,42,17,25
050,31,011,"Nebraska","Boone County",3,77,50,23,27
050,31,011,"Nebraska","Boone County",3,78,51,25,26
050,31,011,"Nebraska","Boone County",3,79,42,21,21
050,31,011,"Nebraska","Boone County",3,80,31,16,15
050,31,011,"Nebraska","Boone County",3,81,31,14,17
050,31,011,"Nebraska","Boone County",3,82,32,13,19
050,31,011,"Nebraska","Boone County",3,83,35,13,22
050,31,011,"Nebraska","Boone County",3,84,34,13,21
050,31,011,"Nebraska","Boone County",3,85,191,60,131
050,31,011,"Nebraska","Boone County",4,0,66,28,38
050,31,011,"Nebraska","Boone County",4,1,53,25,28
050,31,011,"Nebraska","Boone County",4,2,84,44,40
050,31,011,"Nebraska","Boone County",4,3,75,37,38
050,31,011,"Nebraska","Boone County",4,4,74,32,42
050,31,011,"Nebraska","Boone County",4,5,69,33,36
050,31,011,"Nebraska","Boone County",4,6,77,44,33
050,31,011,"Nebraska","Boone County",4,7,73,36,37
050,31,011,"Nebraska","Boone County",4,8,73,38,35
050,31,011,"Nebraska","Boone County",4,9,80,40,40
050,31,011,"Nebraska","Boone County",4,10,61,31,30
050,31,011,"Nebraska","Boone County",4,11,70,33,37
050,31,011,"Nebraska","Boone County",4,12,86,44,42
050,31,011,"Nebraska","Boone County",4,13,80,36,44
050,31,011,"Nebraska","Boone County",4,14,76,32,44
050,31,011,"Nebraska","Boone County",4,15,78,37,41
050,31,011,"Nebraska","Boone County",4,16,73,41,32
050,31,011,"Nebraska","Boone County",4,17,72,42,30
050,31,011,"Nebraska","Boone County",4,18,63,39,24
050,31,011,"Nebraska","Boone County",4,19,41,17,24
050,31,011,"Nebraska","Boone County",4,20,44,23,21
050,31,011,"Nebraska","Boone County",4,21,55,27,28
050,31,011,"Nebraska","Boone County",4,22,51,28,23
050,31,011,"Nebraska","Boone County",4,23,47,26,21
050,31,011,"Nebraska","Boone County",4,24,60,38,22
050,31,011,"Nebraska","Boone County",4,25,63,37,26
050,31,011,"Nebraska","Boone County",4,26,52,26,26
050,31,011,"Nebraska","Boone County",4,27,40,22,18
050,31,011,"Nebraska","Boone County",4,28,49,25,24
050,31,011,"Nebraska","Boone County",4,29,52,24,28
050,31,011,"Nebraska","Boone County",4,30,63,35,28
050,31,011,"Nebraska","Boone County",4,31,59,30,29
050,31,011,"Nebraska","Boone County",4,32,55,27,28
050,31,011,"Nebraska","Boone County",4,33,59,36,23
050,31,011,"Nebraska","Boone County",4,34,71,43,28
050,31,011,"Nebraska","Boone County",4,35,52,27,25
050,31,011,"Nebraska","Boone County",4,36,61,34,27
050,31,011,"Nebraska","Boone County",4,37,62,32,30
050,31,011,"Nebraska","Boone County",4,38,56,30,26
050,31,011,"Nebraska","Boone County",4,39,65,40,25
050,31,011,"Nebraska","Boone County",4,40,56,31,25
050,31,011,"Nebraska","Boone County",4,41,61,28,33
050,31,011,"Nebraska","Boone County",4,42,65,36,29
050,31,011,"Nebraska","Boone County",4,43,58,33,25
050,31,011,"Nebraska","Boone County",4,44,54,30,24
050,31,011,"Nebraska","Boone County",4,45,46,21,25
050,31,011,"Nebraska","Boone County",4,46,42,22,20
050,31,011,"Nebraska","Boone County",4,47,49,27,22
050,31,011,"Nebraska","Boone County",4,48,48,28,20
050,31,011,"Nebraska","Boone County",4,49,51,28,23
050,31,011,"Nebraska","Boone County",4,50,52,23,29
050,31,011,"Nebraska","Boone County",4,51,50,27,23
050,31,011,"Nebraska","Boone County",4,52,42,22,20
050,31,011,"Nebraska","Boone County",4,53,54,27,27
050,31,011,"Nebraska","Boone County",4,54,52,25,27
050,31,011,"Nebraska","Boone County",4,55,69,35,34
050,31,011,"Nebraska","Boone County",4,56,68,35,33
050,31,011,"Nebraska","Boone County",4,57,62,30,32
050,31,011,"Nebraska","Boone County",4,58,72,35,37
050,31,011,"Nebraska","Boone County",4,59,82,47,35
050,31,011,"Nebraska","Boone County",4,60,85,45,40
050,31,011,"Nebraska","Boone County",4,61,89,44,45
050,31,011,"Nebraska","Boone County",4,62,80,38,42
050,31,011,"Nebraska","Boone County",4,63,83,41,42
050,31,011,"Nebraska","Boone County",4,64,96,53,43
050,31,011,"Nebraska","Boone County",4,65,91,53,38
050,31,011,"Nebraska","Boone County",4,66,89,48,41
050,31,011,"Nebraska","Boone County",4,67,84,45,39
050,31,011,"Nebraska","Boone County",4,68,76,42,34
050,31,011,"Nebraska","Boone County",4,69,66,37,29
050,31,011,"Nebraska","Boone County",4,70,71,36,35
050,31,011,"Nebraska","Boone County",4,71,59,29,30
050,31,011,"Nebraska","Boone County",4,72,58,28,30
050,31,011,"Nebraska","Boone County",4,73,53,27,26
050,31,011,"Nebraska","Boone County",4,74,49,28,21
050,31,011,"Nebraska","Boone County",4,75,49,23,26
050,31,011,"Nebraska","Boone County",4,76,36,16,20
050,31,011,"Nebraska","Boone County",4,77,42,17,25
050,31,011,"Nebraska","Boone County",4,78,47,23,24
050,31,011,"Nebraska","Boone County",4,79,52,23,29
050,31,011,"Nebraska","Boone County",4,80,37,17,20
050,31,011,"Nebraska","Boone County",4,81,32,16,16
050,31,011,"Nebraska","Boone County",4,82,32,14,18
050,31,011,"Nebraska","Boone County",4,83,26,10,16
050,31,011,"Nebraska","Boone County",4,84,34,14,20
050,31,011,"Nebraska","Boone County",4,85,177,56,121
050,31,011,"Nebraska","Boone County",5,0,66,28,38
050,31,011,"Nebraska","Boone County",5,1,68,28,40
050,31,011,"Nebraska","Boone County",5,2,59,26,33
050,31,011,"Nebraska","Boone County",5,3,75,40,35
050,31,011,"Nebraska","Boone County",5,4,76,38,38
050,31,011,"Nebraska","Boone County",5,5,70,33,37
050,31,011,"Nebraska","Boone County",5,6,67,32,35
050,31,011,"Nebraska","Boone County",5,7,75,43,32
050,31,011,"Nebraska","Boone County",5,8,68,33,35
050,31,011,"Nebraska","Boone County",5,9,65,31,34
050,31,011,"Nebraska","Boone County",5,10,81,40,41
050,31,011,"Nebraska","Boone County",5,11,62,32,30
050,31,011,"Nebraska","Boone County",5,12,65,30,35
050,31,011,"Nebraska","Boone County",5,13,83,42,41
050,31,011,"Nebraska","Boone County",5,14,79,37,42
050,31,011,"Nebraska","Boone County",5,15,78,34,44
050,31,011,"Nebraska","Boone County",5,16,77,36,41
050,31,011,"Nebraska","Boone County",5,17,72,39,33
050,31,011,"Nebraska","Boone County",5,18,62,37,25
050,31,011,"Nebraska","Boone County",5,19,48,29,19
050,31,011,"Nebraska","Boone County",5,20,46,20,26
050,31,011,"Nebraska","Boone County",5,21,36,15,21
050,31,011,"Nebraska","Boone County",5,22,51,26,25
050,31,011,"Nebraska","Boone County",5,23,40,23,17
050,31,011,"Nebraska","Boone County",5,24,42,24,18
050,31,011,"Nebraska","Boone County",5,25,50,30,20
050,31,011,"Nebraska","Boone County",5,26,60,33,27
050,31,011,"Nebraska","Boone County",5,27,58,31,27
050,31,011,"Nebraska","Boone County",5,28,35,24,11
050,31,011,"Nebraska","Boone County",5,29,55,30,25
050,31,011,"Nebraska","Boone County",5,30,55,25,30
050,31,011,"Nebraska","Boone County",5,31,59,29,30
050,31,011,"Nebraska","Boone County",5,32,60,30,30
050,31,011,"Nebraska","Boone County",5,33,58,30,28
050,31,011,"Nebraska","Boone County",5,34,57,34,23
050,31,011,"Nebraska","Boone County",5,35,75,45,30
050,31,011,"Nebraska","Boone County",5,36,52,26,26
050,31,011,"Nebraska","Boone County",5,37,59,33,26
050,31,011,"Nebraska","Boone County",5,38,61,29,32
050,31,011,"Nebraska","Boone County",5,39,54,29,25
050,31,011,"Nebraska","Boone County",5,40,62,38,24
050,31,011,"Nebraska","Boone County",5,41,53,30,23
050,31,011,"Nebraska","Boone County",5,42,61,28,33
050,31,011,"Nebraska","Boone County",5,43,68,39,29
050,31,011,"Nebraska","Boone County",5,44,60,34,26
050,31,011,"Nebraska","Boone County",5,45,54,31,23
050,31,011,"Nebraska","Boone County",5,46,46,24,22
050,31,011,"Nebraska","Boone County",5,47,42,21,21
050,31,011,"Nebraska","Boone County",5,48,48,26,22
050,31,011,"Nebraska","Boone County",5,49,49,28,21
050,31,011,"Nebraska","Boone County",5,50,48,28,20
050,31,011,"Nebraska","Boone County",5,51,53,23,30
050,31,011,"Nebraska","Boone County",5,52,47,27,20
050,31,011,"Nebraska","Boone County",5,53,40,20,20
050,31,011,"Nebraska","Boone County",5,54,56,29,27
050,31,011,"Nebraska","Boone County",5,55,53,26,27
050,31,011,"Nebraska","Boone County",5,56,70,35,35
050,31,011,"Nebraska","Boone County",5,57,67,34,33
050,31,011,"Nebraska","Boone County",5,58,63,30,33
050,31,011,"Nebraska","Boone County",5,59,70,33,37
050,31,011,"Nebraska","Boone County",5,60,79,46,33
050,31,011,"Nebraska","Boone County",5,61,87,47,40
050,31,011,"Nebraska","Boone County",5,62,88,42,46
050,31,011,"Nebraska","Boone County",5,63,81,37,44
050,31,011,"Nebraska","Boone County",5,64,82,41,41
050,31,011,"Nebraska","Boone County",5,65,94,51,43
050,31,011,"Nebraska","Boone County",5,66,92,54,38
050,31,011,"Nebraska","Boone County",5,67,90,48,42
050,31,011,"Nebraska","Boone County",5,68,88,47,41
050,31,011,"Nebraska","Boone County",5,69,77,43,34
050,31,011,"Nebraska","Boone County",5,70,67,37,30
050,31,011,"Nebraska","Boone County",5,71,71,36,35
050,31,011,"Nebraska","Boone County",5,72,62,31,31
050,31,011,"Nebraska","Boone County",5,73,56,27,29
050,31,011,"Nebraska","Boone County",5,74,52,26,26
050,31,011,"Nebraska","Boone County",5,75,48,28,20
050,31,011,"Nebraska","Boone County",5,76,48,23,25
050,31,011,"Nebraska","Boone County",5,77,37,16,21
050,31,011,"Nebraska","Boone County",5,78,39,15,24
050,31,011,"Nebraska","Boone County",5,79,46,21,25
050,31,011,"Nebraska","Boone County",5,80,46,19,27
050,31,011,"Nebraska","Boone County",5,81,37,17,20
050,31,011,"Nebraska","Boone County",5,82,36,18,18
050,31,011,"Nebraska","Boone County",5,83,29,12,17
050,31,011,"Nebraska","Boone County",5,84,28,12,16
050,31,011,"Nebraska","Boone County",5,85,181,56,125
050,31,013,"Nebraska","Box Butte County",1,0,126,65,61
050,31,013,"Nebraska","Box Butte County",1,1,134,68,66
050,31,013,"Nebraska","Box Butte County",1,2,134,59,75
050,31,013,"Nebraska","Box Butte County",1,3,149,70,79
050,31,013,"Nebraska","Box Butte County",1,4,138,66,72
050,31,013,"Nebraska","Box Butte County",1,5,166,81,85
050,31,013,"Nebraska","Box Butte County",1,6,165,87,78
050,31,013,"Nebraska","Box Butte County",1,7,182,93,89
050,31,013,"Nebraska","Box Butte County",1,8,154,77,77
050,31,013,"Nebraska","Box Butte County",1,9,151,83,68
050,31,013,"Nebraska","Box Butte County",1,10,164,85,79
050,31,013,"Nebraska","Box Butte County",1,11,175,82,93
050,31,013,"Nebraska","Box Butte County",1,12,162,82,80
050,31,013,"Nebraska","Box Butte County",1,13,155,74,81
050,31,013,"Nebraska","Box Butte County",1,14,133,67,66
050,31,013,"Nebraska","Box Butte County",1,15,148,78,70
050,31,013,"Nebraska","Box Butte County",1,16,142,70,72
050,31,013,"Nebraska","Box Butte County",1,17,168,94,74
050,31,013,"Nebraska","Box Butte County",1,18,128,73,55
050,31,013,"Nebraska","Box Butte County",1,19,90,44,46
050,31,013,"Nebraska","Box Butte County",1,20,102,50,52
050,31,013,"Nebraska","Box Butte County",1,21,96,52,44
050,31,013,"Nebraska","Box Butte County",1,22,101,50,51
050,31,013,"Nebraska","Box Butte County",1,23,101,54,47
050,31,013,"Nebraska","Box Butte County",1,24,121,61,60
050,31,013,"Nebraska","Box Butte County",1,25,120,62,58
050,31,013,"Nebraska","Box Butte County",1,26,108,56,52
050,31,013,"Nebraska","Box Butte County",1,27,120,59,61
050,31,013,"Nebraska","Box Butte County",1,28,146,72,74
050,31,013,"Nebraska","Box Butte County",1,29,131,67,64
050,31,013,"Nebraska","Box Butte County",1,30,128,56,72
050,31,013,"Nebraska","Box Butte County",1,31,127,65,62
050,31,013,"Nebraska","Box Butte County",1,32,120,63,57
050,31,013,"Nebraska","Box Butte County",1,33,131,71,60
050,31,013,"Nebraska","Box Butte County",1,34,114,58,56
050,31,013,"Nebraska","Box Butte County",1,35,126,60,66
050,31,013,"Nebraska","Box Butte County",1,36,132,63,69
050,31,013,"Nebraska","Box Butte County",1,37,142,63,79
050,31,013,"Nebraska","Box Butte County",1,38,137,68,69
050,31,013,"Nebraska","Box Butte County",1,39,111,63,48
050,31,013,"Nebraska","Box Butte County",1,40,116,64,52
050,31,013,"Nebraska","Box Butte County",1,41,134,72,62
050,31,013,"Nebraska","Box Butte County",1,42,155,82,73
050,31,013,"Nebraska","Box Butte County",1,43,140,76,64
050,31,013,"Nebraska","Box Butte County",1,44,113,58,55
050,31,013,"Nebraska","Box Butte County",1,45,126,70,56
050,31,013,"Nebraska","Box Butte County",1,46,119,67,52
050,31,013,"Nebraska","Box Butte County",1,47,107,55,52
050,31,013,"Nebraska","Box Butte County",1,48,123,61,62
050,31,013,"Nebraska","Box Butte County",1,49,107,54,53
050,31,013,"Nebraska","Box Butte County",1,50,111,51,60
050,31,013,"Nebraska","Box Butte County",1,51,107,45,62
050,31,013,"Nebraska","Box Butte County",1,52,109,58,51
050,31,013,"Nebraska","Box Butte County",1,53,116,60,56
050,31,013,"Nebraska","Box Butte County",1,54,100,48,52
050,31,013,"Nebraska","Box Butte County",1,55,97,45,52
050,31,013,"Nebraska","Box Butte County",1,56,117,56,61
050,31,013,"Nebraska","Box Butte County",1,57,123,62,61
050,31,013,"Nebraska","Box Butte County",1,58,150,74,76
050,31,013,"Nebraska","Box Butte County",1,59,154,71,83
050,31,013,"Nebraska","Box Butte County",1,60,167,78,89
050,31,013,"Nebraska","Box Butte County",1,61,174,99,75
050,31,013,"Nebraska","Box Butte County",1,62,190,103,87
050,31,013,"Nebraska","Box Butte County",1,63,189,99,90
050,31,013,"Nebraska","Box Butte County",1,64,197,110,87
050,31,013,"Nebraska","Box Butte County",1,65,151,85,66
050,31,013,"Nebraska","Box Butte County",1,66,144,77,67
050,31,013,"Nebraska","Box Butte County",1,67,159,82,77
050,31,013,"Nebraska","Box Butte County",1,68,170,89,81
050,31,013,"Nebraska","Box Butte County",1,69,141,70,71
050,31,013,"Nebraska","Box Butte County",1,70,118,63,55
050,31,013,"Nebraska","Box Butte County",1,71,118,59,59
050,31,013,"Nebraska","Box Butte County",1,72,122,57,65
050,31,013,"Nebraska","Box Butte County",1,73,111,60,51
050,31,013,"Nebraska","Box Butte County",1,74,75,38,37
050,31,013,"Nebraska","Box Butte County",1,75,70,38,32
050,31,013,"Nebraska","Box Butte County",1,76,68,32,36
050,31,013,"Nebraska","Box Butte County",1,77,67,28,39
050,31,013,"Nebraska","Box Butte County",1,78,76,33,43
050,31,013,"Nebraska","Box Butte County",1,79,54,26,28
050,31,013,"Nebraska","Box Butte County",1,80,48,21,27
050,31,013,"Nebraska","Box Butte County",1,81,42,19,23
050,31,013,"Nebraska","Box Butte County",1,82,42,14,28
050,31,013,"Nebraska","Box Butte County",1,83,39,16,23
050,31,013,"Nebraska","Box Butte County",1,84,41,15,26
050,31,013,"Nebraska","Box Butte County",1,85,267,98,169
050,31,013,"Nebraska","Box Butte County",2,0,134,66,68
050,31,013,"Nebraska","Box Butte County",2,1,130,66,64
050,31,013,"Nebraska","Box Butte County",2,2,134,61,73
050,31,013,"Nebraska","Box Butte County",2,3,143,66,77
050,31,013,"Nebraska","Box Butte County",2,4,141,67,74
050,31,013,"Nebraska","Box Butte County",2,5,160,78,82
050,31,013,"Nebraska","Box Butte County",2,6,167,87,80
050,31,013,"Nebraska","Box Butte County",2,7,177,91,86
050,31,013,"Nebraska","Box Butte County",2,8,161,82,79
050,31,013,"Nebraska","Box Butte County",2,9,151,81,70
050,31,013,"Nebraska","Box Butte County",2,10,162,85,77
050,31,013,"Nebraska","Box Butte County",2,11,173,83,90
050,31,013,"Nebraska","Box Butte County",2,12,165,82,83
050,31,013,"Nebraska","Box Butte County",2,13,155,74,81
050,31,013,"Nebraska","Box Butte County",2,14,139,69,70
050,31,013,"Nebraska","Box Butte County",2,15,143,74,69
050,31,013,"Nebraska","Box Butte County",2,16,142,71,71
050,31,013,"Nebraska","Box Butte County",2,17,161,88,73
050,31,013,"Nebraska","Box Butte County",2,18,133,76,57
050,31,013,"Nebraska","Box Butte County",2,19,96,49,47
050,31,013,"Nebraska","Box Butte County",2,20,101,50,51
050,31,013,"Nebraska","Box Butte County",2,21,97,52,45
050,31,013,"Nebraska","Box Butte County",2,22,100,51,49
050,31,013,"Nebraska","Box Butte County",2,23,100,53,47
050,31,013,"Nebraska","Box Butte County",2,24,115,59,56
050,31,013,"Nebraska","Box Butte County",2,25,118,61,57
050,31,013,"Nebraska","Box Butte County",2,26,109,57,52
050,31,013,"Nebraska","Box Butte County",2,27,118,59,59
050,31,013,"Nebraska","Box Butte County",2,28,140,70,70
050,31,013,"Nebraska","Box Butte County",2,29,133,66,67
050,31,013,"Nebraska","Box Butte County",2,30,127,58,69
050,31,013,"Nebraska","Box Butte County",2,31,127,62,65
050,31,013,"Nebraska","Box Butte County",2,32,122,64,58
050,31,013,"Nebraska","Box Butte County",2,33,127,68,59
050,31,013,"Nebraska","Box Butte County",2,34,119,62,57
050,31,013,"Nebraska","Box Butte County",2,35,126,62,64
050,31,013,"Nebraska","Box Butte County",2,36,130,62,68
050,31,013,"Nebraska","Box Butte County",2,37,140,63,77
050,31,013,"Nebraska","Box Butte County",2,38,136,66,70
050,31,013,"Nebraska","Box Butte County",2,39,116,63,53
050,31,013,"Nebraska","Box Butte County",2,40,117,65,52
050,31,013,"Nebraska","Box Butte County",2,41,131,70,61
050,31,013,"Nebraska","Box Butte County",2,42,150,79,71
050,31,013,"Nebraska","Box Butte County",2,43,145,78,67
050,31,013,"Nebraska","Box Butte County",2,44,118,61,57
050,31,013,"Nebraska","Box Butte County",2,45,123,67,56
050,31,013,"Nebraska","Box Butte County",2,46,118,67,51
050,31,013,"Nebraska","Box Butte County",2,47,110,57,53
050,31,013,"Nebraska","Box Butte County",2,48,118,59,59
050,31,013,"Nebraska","Box Butte County",2,49,109,55,54
050,31,013,"Nebraska","Box Butte County",2,50,111,52,59
050,31,013,"Nebraska","Box Butte County",2,51,107,47,60
050,31,013,"Nebraska","Box Butte County",2,52,108,54,54
050,31,013,"Nebraska","Box Butte County",2,53,112,57,55
050,31,013,"Nebraska","Box Butte County",2,54,103,51,52
050,31,013,"Nebraska","Box Butte County",2,55,98,46,52
050,31,013,"Nebraska","Box Butte County",2,56,115,55,60
050,31,013,"Nebraska","Box Butte County",2,57,121,60,61
050,31,013,"Nebraska","Box Butte County",2,58,144,72,72
050,31,013,"Nebraska","Box Butte County",2,59,151,70,81
050,31,013,"Nebraska","Box Butte County",2,60,164,76,88
050,31,013,"Nebraska","Box Butte County",2,61,169,92,77
050,31,013,"Nebraska","Box Butte County",2,62,186,102,84
050,31,013,"Nebraska","Box Butte County",2,63,190,100,90
050,31,013,"Nebraska","Box Butte County",2,64,193,106,87
050,31,013,"Nebraska","Box Butte County",2,65,161,90,71
050,31,013,"Nebraska","Box Butte County",2,66,145,79,66
050,31,013,"Nebraska","Box Butte County",2,67,157,81,76
050,31,013,"Nebraska","Box Butte County",2,68,165,86,79
050,31,013,"Nebraska","Box Butte County",2,69,149,75,74
050,31,013,"Nebraska","Box Butte County",2,70,123,64,59
050,31,013,"Nebraska","Box Butte County",2,71,117,58,59
050,31,013,"Nebraska","Box Butte County",2,72,117,56,61
050,31,013,"Nebraska","Box Butte County",2,73,118,63,55
050,31,013,"Nebraska","Box Butte County",2,74,77,40,37
050,31,013,"Nebraska","Box Butte County",2,75,71,38,33
050,31,013,"Nebraska","Box Butte County",2,76,68,32,36
050,31,013,"Nebraska","Box Butte County",2,77,67,29,38
050,31,013,"Nebraska","Box Butte County",2,78,74,32,42
050,31,013,"Nebraska","Box Butte County",2,79,58,26,32
050,31,013,"Nebraska","Box Butte County",2,80,49,21,28
050,31,013,"Nebraska","Box Butte County",2,81,41,19,22
050,31,013,"Nebraska","Box Butte County",2,82,43,15,28
050,31,013,"Nebraska","Box Butte County",2,83,39,15,24
050,31,013,"Nebraska","Box Butte County",2,84,41,15,26
050,31,013,"Nebraska","Box Butte County",2,85,269,101,168
050,31,013,"Nebraska","Box Butte County",3,0,121,65,56
050,31,013,"Nebraska","Box Butte County",3,1,133,67,66
050,31,013,"Nebraska","Box Butte County",3,2,125,59,66
050,31,013,"Nebraska","Box Butte County",3,3,135,59,76
050,31,013,"Nebraska","Box Butte County",3,4,141,69,72
050,31,013,"Nebraska","Box Butte County",3,5,134,62,72
050,31,013,"Nebraska","Box Butte County",3,6,158,77,81
050,31,013,"Nebraska","Box Butte County",3,7,168,88,80
050,31,013,"Nebraska","Box Butte County",3,8,173,88,85
050,31,013,"Nebraska","Box Butte County",3,9,162,84,78
050,31,013,"Nebraska","Box Butte County",3,10,146,80,66
050,31,013,"Nebraska","Box Butte County",3,11,158,86,72
050,31,013,"Nebraska","Box Butte County",3,12,169,80,89
050,31,013,"Nebraska","Box Butte County",3,13,163,81,82
050,31,013,"Nebraska","Box Butte County",3,14,162,74,88
050,31,013,"Nebraska","Box Butte County",3,15,138,68,70
050,31,013,"Nebraska","Box Butte County",3,16,145,77,68
050,31,013,"Nebraska","Box Butte County",3,17,146,72,74
050,31,013,"Nebraska","Box Butte County",3,18,137,77,60
050,31,013,"Nebraska","Box Butte County",3,19,108,60,48
050,31,013,"Nebraska","Box Butte County",3,20,104,55,49
050,31,013,"Nebraska","Box Butte County",3,21,93,43,50
050,31,013,"Nebraska","Box Butte County",3,22,103,54,49
050,31,013,"Nebraska","Box Butte County",3,23,101,51,50
050,31,013,"Nebraska","Box Butte County",3,24,90,41,49
050,31,013,"Nebraska","Box Butte County",3,25,114,60,54
050,31,013,"Nebraska","Box Butte County",3,26,110,61,49
050,31,013,"Nebraska","Box Butte County",3,27,103,58,45
050,31,013,"Nebraska","Box Butte County",3,28,114,54,60
050,31,013,"Nebraska","Box Butte County",3,29,139,65,74
050,31,013,"Nebraska","Box Butte County",3,30,131,63,68
050,31,013,"Nebraska","Box Butte County",3,31,122,56,66
050,31,013,"Nebraska","Box Butte County",3,32,118,55,63
050,31,013,"Nebraska","Box Butte County",3,33,128,68,60
050,31,013,"Nebraska","Box Butte County",3,34,126,67,59
050,31,013,"Nebraska","Box Butte County",3,35,125,65,60
050,31,013,"Nebraska","Box Butte County",3,36,123,61,62
050,31,013,"Nebraska","Box Butte County",3,37,131,65,66
050,31,013,"Nebraska","Box Butte County",3,38,141,63,78
050,31,013,"Nebraska","Box Butte County",3,39,136,68,68
050,31,013,"Nebraska","Box Butte County",3,40,113,58,55
050,31,013,"Nebraska","Box Butte County",3,41,120,62,58
050,31,013,"Nebraska","Box Butte County",3,42,128,68,60
050,31,013,"Nebraska","Box Butte County",3,43,148,81,67
050,31,013,"Nebraska","Box Butte County",3,44,146,82,64
050,31,013,"Nebraska","Box Butte County",3,45,119,63,56
050,31,013,"Nebraska","Box Butte County",3,46,120,67,53
050,31,013,"Nebraska","Box Butte County",3,47,109,63,46
050,31,013,"Nebraska","Box Butte County",3,48,105,57,48
050,31,013,"Nebraska","Box Butte County",3,49,111,55,56
050,31,013,"Nebraska","Box Butte County",3,50,108,55,53
050,31,013,"Nebraska","Box Butte County",3,51,110,52,58
050,31,013,"Nebraska","Box Butte County",3,52,104,47,57
050,31,013,"Nebraska","Box Butte County",3,53,107,54,53
050,31,013,"Nebraska","Box Butte County",3,54,112,56,56
050,31,013,"Nebraska","Box Butte County",3,55,100,49,51
050,31,013,"Nebraska","Box Butte County",3,56,95,46,49
050,31,013,"Nebraska","Box Butte County",3,57,107,47,60
050,31,013,"Nebraska","Box Butte County",3,58,116,56,60
050,31,013,"Nebraska","Box Butte County",3,59,139,69,70
050,31,013,"Nebraska","Box Butte County",3,60,151,70,81
050,31,013,"Nebraska","Box Butte County",3,61,157,73,84
050,31,013,"Nebraska","Box Butte County",3,62,169,93,76
050,31,013,"Nebraska","Box Butte County",3,63,184,99,85
050,31,013,"Nebraska","Box Butte County",3,64,186,98,88
050,31,013,"Nebraska","Box Butte County",3,65,190,104,86
050,31,013,"Nebraska","Box Butte County",3,66,157,90,67
050,31,013,"Nebraska","Box Butte County",3,67,145,78,67
050,31,013,"Nebraska","Box Butte County",3,68,144,75,69
050,31,013,"Nebraska","Box Butte County",3,69,154,78,76
050,31,013,"Nebraska","Box Butte County",3,70,149,77,72
050,31,013,"Nebraska","Box Butte County",3,71,111,55,56
050,31,013,"Nebraska","Box Butte County",3,72,116,58,58
050,31,013,"Nebraska","Box Butte County",3,73,115,54,61
050,31,013,"Nebraska","Box Butte County",3,74,107,56,51
050,31,013,"Nebraska","Box Butte County",3,75,77,40,37
050,31,013,"Nebraska","Box Butte County",3,76,67,36,31
050,31,013,"Nebraska","Box Butte County",3,77,69,31,38
050,31,013,"Nebraska","Box Butte County",3,78,67,29,38
050,31,013,"Nebraska","Box Butte County",3,79,67,27,40
050,31,013,"Nebraska","Box Butte County",3,80,56,23,33
050,31,013,"Nebraska","Box Butte County",3,81,46,20,26
050,31,013,"Nebraska","Box Butte County",3,82,39,16,23
050,31,013,"Nebraska","Box Butte County",3,83,37,11,26
050,31,013,"Nebraska","Box Butte County",3,84,40,14,26
050,31,013,"Nebraska","Box Butte County",3,85,272,105,167
050,31,013,"Nebraska","Box Butte County",4,0,114,54,60
050,31,013,"Nebraska","Box Butte County",4,1,122,60,62
050,31,013,"Nebraska","Box Butte County",4,2,133,67,66
050,31,013,"Nebraska","Box Butte County",4,3,130,65,65
050,31,013,"Nebraska","Box Butte County",4,4,130,58,72
050,31,013,"Nebraska","Box Butte County",4,5,152,80,72
050,31,013,"Nebraska","Box Butte County",4,6,150,71,79
050,31,013,"Nebraska","Box Butte County",4,7,162,85,77
050,31,013,"Nebraska","Box Butte County",4,8,169,90,79
050,31,013,"Nebraska","Box Butte County",4,9,174,89,85
050,31,013,"Nebraska","Box Butte County",4,10,169,89,80
050,31,013,"Nebraska","Box Butte County",4,11,149,79,70
050,31,013,"Nebraska","Box Butte County",4,12,151,84,67
050,31,013,"Nebraska","Box Butte County",4,13,169,78,91
050,31,013,"Nebraska","Box Butte County",4,14,168,89,79
050,31,013,"Nebraska","Box Butte County",4,15,163,75,88
050,31,013,"Nebraska","Box Butte County",4,16,139,69,70
050,31,013,"Nebraska","Box Butte County",4,17,144,76,68
050,31,013,"Nebraska","Box Butte County",4,18,126,66,60
050,31,013,"Nebraska","Box Butte County",4,19,103,58,45
050,31,013,"Nebraska","Box Butte County",4,20,112,64,48
050,31,013,"Nebraska","Box Butte County",4,21,102,50,52
050,31,013,"Nebraska","Box Butte County",4,22,99,46,53
050,31,013,"Nebraska","Box Butte County",4,23,109,53,56
050,31,013,"Nebraska","Box Butte County",4,24,106,58,48
050,31,013,"Nebraska","Box Butte County",4,25,99,45,54
050,31,013,"Nebraska","Box Butte County",4,26,113,59,54
050,31,013,"Nebraska","Box Butte County",4,27,117,66,51
050,31,013,"Nebraska","Box Butte County",4,28,126,68,58
050,31,013,"Nebraska","Box Butte County",4,29,125,53,72
050,31,013,"Nebraska","Box Butte County",4,30,136,69,67
050,31,013,"Nebraska","Box Butte County",4,31,127,58,69
050,31,013,"Nebraska","Box Butte County",4,32,129,61,68
050,31,013,"Nebraska","Box Butte County",4,33,119,60,59
050,31,013,"Nebraska","Box Butte County",4,34,125,62,63
050,31,013,"Nebraska","Box Butte County",4,35,130,71,59
050,31,013,"Nebraska","Box Butte County",4,36,122,63,59
050,31,013,"Nebraska","Box Butte County",4,37,123,61,62
050,31,013,"Nebraska","Box Butte County",4,38,124,63,61
050,31,013,"Nebraska","Box Butte County",4,39,134,61,73
050,31,013,"Nebraska","Box Butte County",4,40,135,68,67
050,31,013,"Nebraska","Box Butte County",4,41,118,61,57
050,31,013,"Nebraska","Box Butte County",4,42,120,63,57
050,31,013,"Nebraska","Box Butte County",4,43,128,67,61
050,31,013,"Nebraska","Box Butte County",4,44,143,79,64
050,31,013,"Nebraska","Box Butte County",4,45,144,78,66
050,31,013,"Nebraska","Box Butte County",4,46,117,62,55
050,31,013,"Nebraska","Box Butte County",4,47,123,68,55
050,31,013,"Nebraska","Box Butte County",4,48,109,61,48
050,31,013,"Nebraska","Box Butte County",4,49,109,60,49
050,31,013,"Nebraska","Box Butte County",4,50,117,59,58
050,31,013,"Nebraska","Box Butte County",4,51,110,56,54
050,31,013,"Nebraska","Box Butte County",4,52,108,51,57
050,31,013,"Nebraska","Box Butte County",4,53,111,50,61
050,31,013,"Nebraska","Box Butte County",4,54,107,57,50
050,31,013,"Nebraska","Box Butte County",4,55,110,54,56
050,31,013,"Nebraska","Box Butte County",4,56,103,51,52
050,31,013,"Nebraska","Box Butte County",4,57,96,46,50
050,31,013,"Nebraska","Box Butte County",4,58,106,47,59
050,31,013,"Nebraska","Box Butte County",4,59,113,55,58
050,31,013,"Nebraska","Box Butte County",4,60,136,71,65
050,31,013,"Nebraska","Box Butte County",4,61,145,69,76
050,31,013,"Nebraska","Box Butte County",4,62,146,69,77
050,31,013,"Nebraska","Box Butte County",4,63,161,89,72
050,31,013,"Nebraska","Box Butte County",4,64,176,95,81
050,31,013,"Nebraska","Box Butte County",4,65,180,94,86
050,31,013,"Nebraska","Box Butte County",4,66,187,103,84
050,31,013,"Nebraska","Box Butte County",4,67,156,90,66
050,31,013,"Nebraska","Box Butte County",4,68,141,76,65
050,31,013,"Nebraska","Box Butte County",4,69,139,71,68
050,31,013,"Nebraska","Box Butte County",4,70,151,81,70
050,31,013,"Nebraska","Box Butte County",4,71,140,69,71
050,31,013,"Nebraska","Box Butte County",4,72,110,54,56
050,31,013,"Nebraska","Box Butte County",4,73,115,58,57
050,31,013,"Nebraska","Box Butte County",4,74,100,44,56
050,31,013,"Nebraska","Box Butte County",4,75,109,57,52
050,31,013,"Nebraska","Box Butte County",4,76,77,40,37
050,31,013,"Nebraska","Box Butte County",4,77,65,33,32
050,31,013,"Nebraska","Box Butte County",4,78,71,33,38
050,31,013,"Nebraska","Box Butte County",4,79,54,21,33
050,31,013,"Nebraska","Box Butte County",4,80,61,19,42
050,31,013,"Nebraska","Box Butte County",4,81,50,22,28
050,31,013,"Nebraska","Box Butte County",4,82,46,19,27
050,31,013,"Nebraska","Box Butte County",4,83,38,16,22
050,31,013,"Nebraska","Box Butte County",4,84,41,12,29
050,31,013,"Nebraska","Box Butte County",4,85,267,107,160
050,31,013,"Nebraska","Box Butte County",5,0,115,53,62
050,31,013,"Nebraska","Box Butte County",5,1,116,56,60
050,31,013,"Nebraska","Box Butte County",5,2,132,67,65
050,31,013,"Nebraska","Box Butte County",5,3,137,71,66
050,31,013,"Nebraska","Box Butte County",5,4,142,75,67
050,31,013,"Nebraska","Box Butte County",5,5,136,61,75
050,31,013,"Nebraska","Box Butte County",5,6,151,80,71
050,31,013,"Nebraska","Box Butte County",5,7,143,65,78
050,31,013,"Nebraska","Box Butte County",5,8,162,85,77
050,31,013,"Nebraska","Box Butte County",5,9,160,85,75
050,31,013,"Nebraska","Box Butte County",5,10,170,90,80
050,31,013,"Nebraska","Box Butte County",5,11,161,81,80
050,31,013,"Nebraska","Box Butte County",5,12,150,80,70
050,31,013,"Nebraska","Box Butte County",5,13,155,83,72
050,31,013,"Nebraska","Box Butte County",5,14,167,77,90
050,31,013,"Nebraska","Box Butte County",5,15,165,89,76
050,31,013,"Nebraska","Box Butte County",5,16,152,71,81
050,31,013,"Nebraska","Box Butte County",5,17,143,70,73
050,31,013,"Nebraska","Box Butte County",5,18,124,67,57
050,31,013,"Nebraska","Box Butte County",5,19,97,53,44
050,31,013,"Nebraska","Box Butte County",5,20,112,59,53
050,31,013,"Nebraska","Box Butte County",5,21,113,62,51
050,31,013,"Nebraska","Box Butte County",5,22,103,48,55
050,31,013,"Nebraska","Box Butte County",5,23,100,44,56
050,31,013,"Nebraska","Box Butte County",5,24,116,58,58
050,31,013,"Nebraska","Box Butte County",5,25,107,63,44
050,31,013,"Nebraska","Box Butte County",5,26,104,47,57
050,31,013,"Nebraska","Box Butte County",5,27,111,61,50
050,31,013,"Nebraska","Box Butte County",5,28,133,71,62
050,31,013,"Nebraska","Box Butte County",5,29,138,74,64
050,31,013,"Nebraska","Box Butte County",5,30,121,49,72
050,31,013,"Nebraska","Box Butte County",5,31,142,71,71
050,31,013,"Nebraska","Box Butte County",5,32,125,61,64
050,31,013,"Nebraska","Box Butte County",5,33,130,64,66
050,31,013,"Nebraska","Box Butte County",5,34,121,61,60
050,31,013,"Nebraska","Box Butte County",5,35,117,59,58
050,31,013,"Nebraska","Box Butte County",5,36,136,74,62
050,31,013,"Nebraska","Box Butte County",5,37,130,70,60
050,31,013,"Nebraska","Box Butte County",5,38,126,64,62
050,31,013,"Nebraska","Box Butte County",5,39,121,64,57
050,31,013,"Nebraska","Box Butte County",5,40,143,66,77
050,31,013,"Nebraska","Box Butte County",5,41,139,70,69
050,31,013,"Nebraska","Box Butte County",5,42,127,69,58
050,31,013,"Nebraska","Box Butte County",5,43,123,67,56
050,31,013,"Nebraska","Box Butte County",5,44,127,70,57
050,31,013,"Nebraska","Box Butte County",5,45,138,77,61
050,31,013,"Nebraska","Box Butte County",5,46,150,83,67
050,31,013,"Nebraska","Box Butte County",5,47,116,59,57
050,31,013,"Nebraska","Box Butte County",5,48,118,67,51
050,31,013,"Nebraska","Box Butte County",5,49,112,63,49
050,31,013,"Nebraska","Box Butte County",5,50,103,55,48
050,31,013,"Nebraska","Box Butte County",5,51,113,57,56
050,31,013,"Nebraska","Box Butte County",5,52,114,58,56
050,31,013,"Nebraska","Box Butte County",5,53,98,46,52
050,31,013,"Nebraska","Box Butte County",5,54,103,46,57
050,31,013,"Nebraska","Box Butte County",5,55,103,53,50
050,31,013,"Nebraska","Box Butte County",5,56,106,54,52
050,31,013,"Nebraska","Box Butte County",5,57,99,48,51
050,31,013,"Nebraska","Box Butte County",5,58,101,51,50
050,31,013,"Nebraska","Box Butte County",5,59,103,48,55
050,31,013,"Nebraska","Box Butte County",5,60,106,50,56
050,31,013,"Nebraska","Box Butte County",5,61,132,69,63
050,31,013,"Nebraska","Box Butte County",5,62,138,67,71
050,31,013,"Nebraska","Box Butte County",5,63,146,70,76
050,31,013,"Nebraska","Box Butte County",5,64,157,85,72
050,31,013,"Nebraska","Box Butte County",5,65,174,94,80
050,31,013,"Nebraska","Box Butte County",5,66,182,94,88
050,31,013,"Nebraska","Box Butte County",5,67,187,103,84
050,31,013,"Nebraska","Box Butte County",5,68,153,90,63
050,31,013,"Nebraska","Box Butte County",5,69,134,72,62
050,31,013,"Nebraska","Box Butte County",5,70,137,71,66
050,31,013,"Nebraska","Box Butte County",5,71,145,74,71
050,31,013,"Nebraska","Box Butte County",5,72,144,69,75
050,31,013,"Nebraska","Box Butte County",5,73,111,55,56
050,31,013,"Nebraska","Box Butte County",5,74,103,51,52
050,31,013,"Nebraska","Box Butte County",5,75,103,46,57
050,31,013,"Nebraska","Box Butte County",5,76,108,55,53
050,31,013,"Nebraska","Box Butte County",5,77,72,38,34
050,31,013,"Nebraska","Box Butte County",5,78,68,36,32
050,31,013,"Nebraska","Box Butte County",5,79,60,25,35
050,31,013,"Nebraska","Box Butte County",5,80,48,11,37
050,31,013,"Nebraska","Box Butte County",5,81,61,21,40
050,31,013,"Nebraska","Box Butte County",5,82,49,21,28
050,31,013,"Nebraska","Box Butte County",5,83,46,19,27
050,31,013,"Nebraska","Box Butte County",5,84,39,17,22
050,31,013,"Nebraska","Box Butte County",5,85,269,107,162
050,31,015,"Nebraska","Boyd County",1,0,12,6,6
050,31,015,"Nebraska","Boyd County",1,1,12,4,8
050,31,015,"Nebraska","Boyd County",1,2,17,3,14
050,31,015,"Nebraska","Boyd County",1,3,15,6,9
050,31,015,"Nebraska","Boyd County",1,4,20,8,12
050,31,015,"Nebraska","Boyd County",1,5,17,5,12
050,31,015,"Nebraska","Boyd County",1,6,16,10,6
050,31,015,"Nebraska","Boyd County",1,7,18,11,7
050,31,015,"Nebraska","Boyd County",1,8,28,14,14
050,31,015,"Nebraska","Boyd County",1,9,23,10,13
050,31,015,"Nebraska","Boyd County",1,10,20,12,8
050,31,015,"Nebraska","Boyd County",1,11,24,12,12
050,31,015,"Nebraska","Boyd County",1,12,23,10,13
050,31,015,"Nebraska","Boyd County",1,13,15,8,7
050,31,015,"Nebraska","Boyd County",1,14,17,9,8
050,31,015,"Nebraska","Boyd County",1,15,17,7,10
050,31,015,"Nebraska","Boyd County",1,16,24,11,13
050,31,015,"Nebraska","Boyd County",1,17,25,13,12
050,31,015,"Nebraska","Boyd County",1,18,20,10,10
050,31,015,"Nebraska","Boyd County",1,19,16,11,5
050,31,015,"Nebraska","Boyd County",1,20,18,9,9
050,31,015,"Nebraska","Boyd County",1,21,24,13,11
050,31,015,"Nebraska","Boyd County",1,22,18,8,10
050,31,015,"Nebraska","Boyd County",1,23,16,8,8
050,31,015,"Nebraska","Boyd County",1,24,19,9,10
050,31,015,"Nebraska","Boyd County",1,25,22,11,11
050,31,015,"Nebraska","Boyd County",1,26,18,12,6
050,31,015,"Nebraska","Boyd County",1,27,18,11,7
050,31,015,"Nebraska","Boyd County",1,28,10,6,4
050,31,015,"Nebraska","Boyd County",1,29,14,7,7
050,31,015,"Nebraska","Boyd County",1,30,14,6,8
050,31,015,"Nebraska","Boyd County",1,31,14,7,7
050,31,015,"Nebraska","Boyd County",1,32,15,6,9
050,31,015,"Nebraska","Boyd County",1,33,16,9,7
050,31,015,"Nebraska","Boyd County",1,34,12,5,7
050,31,015,"Nebraska","Boyd County",1,35,18,10,8
050,31,015,"Nebraska","Boyd County",1,36,15,9,6
050,31,015,"Nebraska","Boyd County",1,37,14,9,5
050,31,015,"Nebraska","Boyd County",1,38,13,6,7
050,31,015,"Nebraska","Boyd County",1,39,17,7,10
050,31,015,"Nebraska","Boyd County",1,40,20,11,9
050,31,015,"Nebraska","Boyd County",1,41,25,15,10
050,31,015,"Nebraska","Boyd County",1,42,18,10,8
050,31,015,"Nebraska","Boyd County",1,43,12,5,7
050,31,015,"Nebraska","Boyd County",1,44,20,10,10
050,31,015,"Nebraska","Boyd County",1,45,15,8,7
050,31,015,"Nebraska","Boyd County",1,46,13,7,6
050,31,015,"Nebraska","Boyd County",1,47,18,8,10
050,31,015,"Nebraska","Boyd County",1,48,16,7,9
050,31,015,"Nebraska","Boyd County",1,49,20,11,9
050,31,015,"Nebraska","Boyd County",1,50,18,13,5
050,31,015,"Nebraska","Boyd County",1,51,14,9,5
050,31,015,"Nebraska","Boyd County",1,52,16,10,6
050,31,015,"Nebraska","Boyd County",1,53,21,13,8
050,31,015,"Nebraska","Boyd County",1,54,17,11,6
050,31,015,"Nebraska","Boyd County",1,55,17,8,9
050,31,015,"Nebraska","Boyd County",1,56,29,11,18
050,31,015,"Nebraska","Boyd County",1,57,28,14,14
050,31,015,"Nebraska","Boyd County",1,58,26,14,12
050,31,015,"Nebraska","Boyd County",1,59,34,16,18
050,31,015,"Nebraska","Boyd County",1,60,39,20,19
050,31,015,"Nebraska","Boyd County",1,61,41,21,20
050,31,015,"Nebraska","Boyd County",1,62,36,18,18
050,31,015,"Nebraska","Boyd County",1,63,34,15,19
050,31,015,"Nebraska","Boyd County",1,64,27,17,10
050,31,015,"Nebraska","Boyd County",1,65,27,17,10
050,31,015,"Nebraska","Boyd County",1,66,26,13,13
050,31,015,"Nebraska","Boyd County",1,67,30,14,16
050,31,015,"Nebraska","Boyd County",1,68,37,18,19
050,31,015,"Nebraska","Boyd County",1,69,35,17,18
050,31,015,"Nebraska","Boyd County",1,70,32,20,12
050,31,015,"Nebraska","Boyd County",1,71,34,19,15
050,31,015,"Nebraska","Boyd County",1,72,29,16,13
050,31,015,"Nebraska","Boyd County",1,73,27,15,12
050,31,015,"Nebraska","Boyd County",1,74,20,9,11
050,31,015,"Nebraska","Boyd County",1,75,20,12,8
050,31,015,"Nebraska","Boyd County",1,76,13,6,7
050,31,015,"Nebraska","Boyd County",1,77,21,8,13
050,31,015,"Nebraska","Boyd County",1,78,17,8,9
050,31,015,"Nebraska","Boyd County",1,79,22,10,12
050,31,015,"Nebraska","Boyd County",1,80,15,7,8
050,31,015,"Nebraska","Boyd County",1,81,15,5,10
050,31,015,"Nebraska","Boyd County",1,82,10,4,6
050,31,015,"Nebraska","Boyd County",1,83,10,5,5
050,31,015,"Nebraska","Boyd County",1,84,9,5,4
050,31,015,"Nebraska","Boyd County",1,85,83,27,56
050,31,015,"Nebraska","Boyd County",2,0,15,8,7
050,31,015,"Nebraska","Boyd County",2,1,11,4,7
050,31,015,"Nebraska","Boyd County",2,2,15,3,12
050,31,015,"Nebraska","Boyd County",2,3,17,6,11
050,31,015,"Nebraska","Boyd County",2,4,18,7,11
050,31,015,"Nebraska","Boyd County",2,5,17,5,12
050,31,015,"Nebraska","Boyd County",2,6,17,9,8
050,31,015,"Nebraska","Boyd County",2,7,17,11,6
050,31,015,"Nebraska","Boyd County",2,8,25,13,12
050,31,015,"Nebraska","Boyd County",2,9,25,12,13
050,31,015,"Nebraska","Boyd County",2,10,21,12,9
050,31,015,"Nebraska","Boyd County",2,11,23,12,11
050,31,015,"Nebraska","Boyd County",2,12,23,10,13
050,31,015,"Nebraska","Boyd County",2,13,17,8,9
050,31,015,"Nebraska","Boyd County",2,14,17,9,8
050,31,015,"Nebraska","Boyd County",2,15,17,7,10
050,31,015,"Nebraska","Boyd County",2,16,23,10,13
050,31,015,"Nebraska","Boyd County",2,17,24,12,12
050,31,015,"Nebraska","Boyd County",2,18,20,10,10
050,31,015,"Nebraska","Boyd County",2,19,15,9,6
050,31,015,"Nebraska","Boyd County",2,20,18,10,8
050,31,015,"Nebraska","Boyd County",2,21,22,12,10
050,31,015,"Nebraska","Boyd County",2,22,19,9,10
050,31,015,"Nebraska","Boyd County",2,23,16,7,9
050,31,015,"Nebraska","Boyd County",2,24,19,9,10
050,31,015,"Nebraska","Boyd County",2,25,21,10,11
050,31,015,"Nebraska","Boyd County",2,26,18,11,7
050,31,015,"Nebraska","Boyd County",2,27,18,12,6
050,31,015,"Nebraska","Boyd County",2,28,11,6,5
050,31,015,"Nebraska","Boyd County",2,29,14,7,7
050,31,015,"Nebraska","Boyd County",2,30,13,6,7
050,31,015,"Nebraska","Boyd County",2,31,14,7,7
050,31,015,"Nebraska","Boyd County",2,32,15,6,9
050,31,015,"Nebraska","Boyd County",2,33,15,8,7
050,31,015,"Nebraska","Boyd County",2,34,13,6,7
050,31,015,"Nebraska","Boyd County",2,35,18,10,8
050,31,015,"Nebraska","Boyd County",2,36,15,9,6
050,31,015,"Nebraska","Boyd County",2,37,15,10,5
050,31,015,"Nebraska","Boyd County",2,38,13,6,7
050,31,015,"Nebraska","Boyd County",2,39,16,7,9
050,31,015,"Nebraska","Boyd County",2,40,19,10,9
050,31,015,"Nebraska","Boyd County",2,41,24,14,10
050,31,015,"Nebraska","Boyd County",2,42,19,11,8
050,31,015,"Nebraska","Boyd County",2,43,13,6,7
050,31,015,"Nebraska","Boyd County",2,44,19,9,10
050,31,015,"Nebraska","Boyd County",2,45,15,8,7
050,31,015,"Nebraska","Boyd County",2,46,14,8,6
050,31,015,"Nebraska","Boyd County",2,47,17,8,9
050,31,015,"Nebraska","Boyd County",2,48,16,7,9
050,31,015,"Nebraska","Boyd County",2,49,19,10,9
050,31,015,"Nebraska","Boyd County",2,50,19,13,6
050,31,015,"Nebraska","Boyd County",2,51,15,10,5
050,31,015,"Nebraska","Boyd County",2,52,16,10,6
050,31,015,"Nebraska","Boyd County",2,53,20,12,8
050,31,015,"Nebraska","Boyd County",2,54,17,11,6
050,31,015,"Nebraska","Boyd County",2,55,16,8,8
050,31,015,"Nebraska","Boyd County",2,56,26,10,16
050,31,015,"Nebraska","Boyd County",2,57,28,13,15
050,31,015,"Nebraska","Boyd County",2,58,27,14,13
050,31,015,"Nebraska","Boyd County",2,59,33,16,17
050,31,015,"Nebraska","Boyd County",2,60,38,19,19
050,31,015,"Nebraska","Boyd County",2,61,40,20,20
050,31,015,"Nebraska","Boyd County",2,62,37,19,18
050,31,015,"Nebraska","Boyd County",2,63,35,16,19
050,31,015,"Nebraska","Boyd County",2,64,29,17,12
050,31,015,"Nebraska","Boyd County",2,65,27,17,10
050,31,015,"Nebraska","Boyd County",2,66,26,14,12
050,31,015,"Nebraska","Boyd County",2,67,29,14,15
050,31,015,"Nebraska","Boyd County",2,68,35,17,18
050,31,015,"Nebraska","Boyd County",2,69,36,17,19
050,31,015,"Nebraska","Boyd County",2,70,32,19,13
050,31,015,"Nebraska","Boyd County",2,71,34,20,14
050,31,015,"Nebraska","Boyd County",2,72,30,17,13
050,31,015,"Nebraska","Boyd County",2,73,29,16,13
050,31,015,"Nebraska","Boyd County",2,74,20,10,10
050,31,015,"Nebraska","Boyd County",2,75,19,11,8
050,31,015,"Nebraska","Boyd County",2,76,14,7,7
050,31,015,"Nebraska","Boyd County",2,77,21,8,13
050,31,015,"Nebraska","Boyd County",2,78,18,8,10
050,31,015,"Nebraska","Boyd County",2,79,20,9,11
050,31,015,"Nebraska","Boyd County",2,80,15,7,8
050,31,015,"Nebraska","Boyd County",2,81,15,5,10
050,31,015,"Nebraska","Boyd County",2,82,11,4,7
050,31,015,"Nebraska","Boyd County",2,83,8,5,3
050,31,015,"Nebraska","Boyd County",2,84,9,4,5
050,31,015,"Nebraska","Boyd County",2,85,82,28,54
050,31,015,"Nebraska","Boyd County",3,0,14,9,5
050,31,015,"Nebraska","Boyd County",3,1,17,8,9
050,31,015,"Nebraska","Boyd County",3,2,12,5,7
050,31,015,"Nebraska","Boyd County",3,3,14,4,10
050,31,015,"Nebraska","Boyd County",3,4,18,8,10
050,31,015,"Nebraska","Boyd County",3,5,17,8,9
050,31,015,"Nebraska","Boyd County",3,6,16,6,10
050,31,015,"Nebraska","Boyd County",3,7,16,8,8
050,31,015,"Nebraska","Boyd County",3,8,16,10,6
050,31,015,"Nebraska","Boyd County",3,9,28,15,13
050,31,015,"Nebraska","Boyd County",3,10,28,13,15
050,31,015,"Nebraska","Boyd County",3,11,20,11,9
050,31,015,"Nebraska","Boyd County",3,12,25,12,13
050,31,015,"Nebraska","Boyd County",3,13,23,10,13
050,31,015,"Nebraska","Boyd County",3,14,17,8,9
050,31,015,"Nebraska","Boyd County",3,15,16,8,8
050,31,015,"Nebraska","Boyd County",3,16,19,7,12
050,31,015,"Nebraska","Boyd County",3,17,25,11,14
050,31,015,"Nebraska","Boyd County",3,18,20,11,9
050,31,015,"Nebraska","Boyd County",3,19,15,8,7
050,31,015,"Nebraska","Boyd County",3,20,16,10,6
050,31,015,"Nebraska","Boyd County",3,21,12,6,6
050,31,015,"Nebraska","Boyd County",3,22,21,12,9
050,31,015,"Nebraska","Boyd County",3,23,15,7,8
050,31,015,"Nebraska","Boyd County",3,24,16,10,6
050,31,015,"Nebraska","Boyd County",3,25,21,9,12
050,31,015,"Nebraska","Boyd County",3,26,18,8,10
050,31,015,"Nebraska","Boyd County",3,27,18,11,7
050,31,015,"Nebraska","Boyd County",3,28,20,12,8
050,31,015,"Nebraska","Boyd County",3,29,11,5,6
050,31,015,"Nebraska","Boyd County",3,30,12,5,7
050,31,015,"Nebraska","Boyd County",3,31,11,6,5
050,31,015,"Nebraska","Boyd County",3,32,14,6,8
050,31,015,"Nebraska","Boyd County",3,33,14,7,7
050,31,015,"Nebraska","Boyd County",3,34,15,8,7
050,31,015,"Nebraska","Boyd County",3,35,16,7,9
050,31,015,"Nebraska","Boyd County",3,36,18,10,8
050,31,015,"Nebraska","Boyd County",3,37,15,9,6
050,31,015,"Nebraska","Boyd County",3,38,14,8,6
050,31,015,"Nebraska","Boyd County",3,39,12,5,7
050,31,015,"Nebraska","Boyd County",3,40,16,7,9
050,31,015,"Nebraska","Boyd County",3,41,19,10,9
050,31,015,"Nebraska","Boyd County",3,42,26,15,11
050,31,015,"Nebraska","Boyd County",3,43,19,11,8
050,31,015,"Nebraska","Boyd County",3,44,14,6,8
050,31,015,"Nebraska","Boyd County",3,45,20,9,11
050,31,015,"Nebraska","Boyd County",3,46,15,8,7
050,31,015,"Nebraska","Boyd County",3,47,15,9,6
050,31,015,"Nebraska","Boyd County",3,48,15,7,8
050,31,015,"Nebraska","Boyd County",3,49,18,9,9
050,31,015,"Nebraska","Boyd County",3,50,19,10,9
050,31,015,"Nebraska","Boyd County",3,51,19,13,6
050,31,015,"Nebraska","Boyd County",3,52,15,10,5
050,31,015,"Nebraska","Boyd County",3,53,17,10,7
050,31,015,"Nebraska","Boyd County",3,54,21,12,9
050,31,015,"Nebraska","Boyd County",3,55,17,11,6
050,31,015,"Nebraska","Boyd County",3,56,19,11,8
050,31,015,"Nebraska","Boyd County",3,57,26,10,16
050,31,015,"Nebraska","Boyd County",3,58,26,11,15
050,31,015,"Nebraska","Boyd County",3,59,27,14,13
050,31,015,"Nebraska","Boyd County",3,60,33,16,17
050,31,015,"Nebraska","Boyd County",3,61,38,19,19
050,31,015,"Nebraska","Boyd County",3,62,41,22,19
050,31,015,"Nebraska","Boyd County",3,63,36,18,18
050,31,015,"Nebraska","Boyd County",3,64,33,15,18
050,31,015,"Nebraska","Boyd County",3,65,29,16,13
050,31,015,"Nebraska","Boyd County",3,66,26,16,10
050,31,015,"Nebraska","Boyd County",3,67,25,13,12
050,31,015,"Nebraska","Boyd County",3,68,27,11,16
050,31,015,"Nebraska","Boyd County",3,69,35,18,17
050,31,015,"Nebraska","Boyd County",3,70,34,17,17
050,31,015,"Nebraska","Boyd County",3,71,32,19,13
050,31,015,"Nebraska","Boyd County",3,72,31,17,14
050,31,015,"Nebraska","Boyd County",3,73,30,17,13
050,31,015,"Nebraska","Boyd County",3,74,28,15,13
050,31,015,"Nebraska","Boyd County",3,75,19,10,9
050,31,015,"Nebraska","Boyd County",3,76,18,10,8
050,31,015,"Nebraska","Boyd County",3,77,14,7,7
050,31,015,"Nebraska","Boyd County",3,78,23,8,15
050,31,015,"Nebraska","Boyd County",3,79,17,8,9
050,31,015,"Nebraska","Boyd County",3,80,20,10,10
050,31,015,"Nebraska","Boyd County",3,81,16,7,9
050,31,015,"Nebraska","Boyd County",3,82,14,5,9
050,31,015,"Nebraska","Boyd County",3,83,13,5,8
050,31,015,"Nebraska","Boyd County",3,84,10,5,5
050,31,015,"Nebraska","Boyd County",3,85,70,22,48
050,31,015,"Nebraska","Boyd County",4,0,11,3,8
050,31,015,"Nebraska","Boyd County",4,1,11,6,5
050,31,015,"Nebraska","Boyd County",4,2,15,6,9
050,31,015,"Nebraska","Boyd County",4,3,12,6,6
050,31,015,"Nebraska","Boyd County",4,4,15,3,12
050,31,015,"Nebraska","Boyd County",4,5,19,9,10
050,31,015,"Nebraska","Boyd County",4,6,16,7,9
050,31,015,"Nebraska","Boyd County",4,7,17,7,10
050,31,015,"Nebraska","Boyd County",4,8,16,8,8
050,31,015,"Nebraska","Boyd County",4,9,14,10,4
050,31,015,"Nebraska","Boyd County",4,10,26,13,13
050,31,015,"Nebraska","Boyd County",4,11,25,13,12
050,31,015,"Nebraska","Boyd County",4,12,19,9,10
050,31,015,"Nebraska","Boyd County",4,13,26,13,13
050,31,015,"Nebraska","Boyd County",4,14,23,10,13
050,31,015,"Nebraska","Boyd County",4,15,16,8,8
050,31,015,"Nebraska","Boyd County",4,16,18,9,9
050,31,015,"Nebraska","Boyd County",4,17,18,6,12
050,31,015,"Nebraska","Boyd County",4,18,23,11,12
050,31,015,"Nebraska","Boyd County",4,19,13,7,6
050,31,015,"Nebraska","Boyd County",4,20,13,7,6
050,31,015,"Nebraska","Boyd County",4,21,17,10,7
050,31,015,"Nebraska","Boyd County",4,22,12,7,5
050,31,015,"Nebraska","Boyd County",4,23,17,11,6
050,31,015,"Nebraska","Boyd County",4,24,13,7,6
050,31,015,"Nebraska","Boyd County",4,25,16,11,5
050,31,015,"Nebraska","Boyd County",4,26,20,10,10
050,31,015,"Nebraska","Boyd County",4,27,18,9,9
050,31,015,"Nebraska","Boyd County",4,28,19,11,8
050,31,015,"Nebraska","Boyd County",4,29,19,12,7
050,31,015,"Nebraska","Boyd County",4,30,10,5,5
050,31,015,"Nebraska","Boyd County",4,31,13,5,8
050,31,015,"Nebraska","Boyd County",4,32,9,6,3
050,31,015,"Nebraska","Boyd County",4,33,15,5,10
050,31,015,"Nebraska","Boyd County",4,34,11,6,5
050,31,015,"Nebraska","Boyd County",4,35,14,8,6
050,31,015,"Nebraska","Boyd County",4,36,17,8,9
050,31,015,"Nebraska","Boyd County",4,37,17,9,8
050,31,015,"Nebraska","Boyd County",4,38,14,8,6
050,31,015,"Nebraska","Boyd County",4,39,13,8,5
050,31,015,"Nebraska","Boyd County",4,40,14,6,8
050,31,015,"Nebraska","Boyd County",4,41,14,7,7
050,31,015,"Nebraska","Boyd County",4,42,19,10,9
050,31,015,"Nebraska","Boyd County",4,43,26,15,11
050,31,015,"Nebraska","Boyd County",4,44,18,11,7
050,31,015,"Nebraska","Boyd County",4,45,13,6,7
050,31,015,"Nebraska","Boyd County",4,46,20,10,10
050,31,015,"Nebraska","Boyd County",4,47,15,8,7
050,31,015,"Nebraska","Boyd County",4,48,16,9,7
050,31,015,"Nebraska","Boyd County",4,49,15,7,8
050,31,015,"Nebraska","Boyd County",4,50,18,9,9
050,31,015,"Nebraska","Boyd County",4,51,19,10,9
050,31,015,"Nebraska","Boyd County",4,52,17,12,5
050,31,015,"Nebraska","Boyd County",4,53,15,11,4
050,31,015,"Nebraska","Boyd County",4,54,18,10,8
050,31,015,"Nebraska","Boyd County",4,55,21,11,10
050,31,015,"Nebraska","Boyd County",4,56,18,11,7
050,31,015,"Nebraska","Boyd County",4,57,20,11,9
050,31,015,"Nebraska","Boyd County",4,58,27,11,16
050,31,015,"Nebraska","Boyd County",4,59,26,11,15
050,31,015,"Nebraska","Boyd County",4,60,24,11,13
050,31,015,"Nebraska","Boyd County",4,61,35,17,18
050,31,015,"Nebraska","Boyd County",4,62,38,19,19
050,31,015,"Nebraska","Boyd County",4,63,40,21,19
050,31,015,"Nebraska","Boyd County",4,64,36,18,18
050,31,015,"Nebraska","Boyd County",4,65,31,14,17
050,31,015,"Nebraska","Boyd County",4,66,30,16,14
050,31,015,"Nebraska","Boyd County",4,67,26,16,10
050,31,015,"Nebraska","Boyd County",4,68,24,13,11
050,31,015,"Nebraska","Boyd County",4,69,24,10,14
050,31,015,"Nebraska","Boyd County",4,70,34,18,16
050,31,015,"Nebraska","Boyd County",4,71,35,18,17
050,31,015,"Nebraska","Boyd County",4,72,30,17,13
050,31,015,"Nebraska","Boyd County",4,73,31,17,14
050,31,015,"Nebraska","Boyd County",4,74,33,19,14
050,31,015,"Nebraska","Boyd County",4,75,28,14,14
050,31,015,"Nebraska","Boyd County",4,76,17,9,8
050,31,015,"Nebraska","Boyd County",4,77,19,9,10
050,31,015,"Nebraska","Boyd County",4,78,17,8,9
050,31,015,"Nebraska","Boyd County",4,79,21,8,13
050,31,015,"Nebraska","Boyd County",4,80,15,8,7
050,31,015,"Nebraska","Boyd County",4,81,18,9,9
050,31,015,"Nebraska","Boyd County",4,82,15,7,8
050,31,015,"Nebraska","Boyd County",4,83,12,4,8
050,31,015,"Nebraska","Boyd County",4,84,13,5,8
050,31,015,"Nebraska","Boyd County",4,85,65,21,44
050,31,015,"Nebraska","Boyd County",5,0,10,3,7
050,31,015,"Nebraska","Boyd County",5,1,13,5,8
050,31,015,"Nebraska","Boyd County",5,2,12,6,6
050,31,015,"Nebraska","Boyd County",5,3,14,6,8
050,31,015,"Nebraska","Boyd County",5,4,13,7,6
050,31,015,"Nebraska","Boyd County",5,5,15,3,12
050,31,015,"Nebraska","Boyd County",5,6,21,10,11
050,31,015,"Nebraska","Boyd County",5,7,18,10,8
050,31,015,"Nebraska","Boyd County",5,8,18,7,11
050,31,015,"Nebraska","Boyd County",5,9,16,8,8
050,31,015,"Nebraska","Boyd County",5,10,15,11,4
050,31,015,"Nebraska","Boyd County",5,11,27,14,13
050,31,015,"Nebraska","Boyd County",5,12,25,11,14
050,31,015,"Nebraska","Boyd County",5,13,20,11,9
050,31,015,"Nebraska","Boyd County",5,14,26,13,13
050,31,015,"Nebraska","Boyd County",5,15,24,12,12
050,31,015,"Nebraska","Boyd County",5,16,17,8,9
050,31,015,"Nebraska","Boyd County",5,17,17,8,9
050,31,015,"Nebraska","Boyd County",5,18,15,5,10
050,31,015,"Nebraska","Boyd County",5,19,19,10,9
050,31,015,"Nebraska","Boyd County",5,20,16,9,7
050,31,015,"Nebraska","Boyd County",5,21,13,5,8
050,31,015,"Nebraska","Boyd County",5,22,19,11,8
050,31,015,"Nebraska","Boyd County",5,23,11,7,4
050,31,015,"Nebraska","Boyd County",5,24,18,10,8
050,31,015,"Nebraska","Boyd County",5,25,14,7,7
050,31,015,"Nebraska","Boyd County",5,26,14,11,3
050,31,015,"Nebraska","Boyd County",5,27,18,11,7
050,31,015,"Nebraska","Boyd County",5,28,19,10,9
050,31,015,"Nebraska","Boyd County",5,29,21,11,10
050,31,015,"Nebraska","Boyd County",5,30,19,12,7
050,31,015,"Nebraska","Boyd County",5,31,10,5,5
050,31,015,"Nebraska","Boyd County",5,32,13,5,8
050,31,015,"Nebraska","Boyd County",5,33,8,6,2
050,31,015,"Nebraska","Boyd County",5,34,13,3,10
050,31,015,"Nebraska","Boyd County",5,35,11,6,5
050,31,015,"Nebraska","Boyd County",5,36,14,8,6
050,31,015,"Nebraska","Boyd County",5,37,16,7,9
050,31,015,"Nebraska","Boyd County",5,38,15,7,8
050,31,015,"Nebraska","Boyd County",5,39,14,7,7
050,31,015,"Nebraska","Boyd County",5,40,12,8,4
050,31,015,"Nebraska","Boyd County",5,41,14,7,7
050,31,015,"Nebraska","Boyd County",5,42,14,7,7
050,31,015,"Nebraska","Boyd County",5,43,20,11,9
050,31,015,"Nebraska","Boyd County",5,44,27,15,12
050,31,015,"Nebraska","Boyd County",5,45,17,10,7
050,31,015,"Nebraska","Boyd County",5,46,13,6,7
050,31,015,"Nebraska","Boyd County",5,47,20,10,10
050,31,015,"Nebraska","Boyd County",5,48,15,8,7
050,31,015,"Nebraska","Boyd County",5,49,15,9,6
050,31,015,"Nebraska","Boyd County",5,50,15,7,8
050,31,015,"Nebraska","Boyd County",5,51,18,9,9
050,31,015,"Nebraska","Boyd County",5,52,18,10,8
050,31,015,"Nebraska","Boyd County",5,53,16,12,4
050,31,015,"Nebraska","Boyd County",5,54,14,10,4
050,31,015,"Nebraska","Boyd County",5,55,17,10,7
050,31,015,"Nebraska","Boyd County",5,56,21,11,10
050,31,015,"Nebraska","Boyd County",5,57,19,11,8
050,31,015,"Nebraska","Boyd County",5,58,20,11,9
050,31,015,"Nebraska","Boyd County",5,59,28,11,17
050,31,015,"Nebraska","Boyd County",5,60,27,13,14
050,31,015,"Nebraska","Boyd County",5,61,25,11,14
050,31,015,"Nebraska","Boyd County",5,62,36,19,17
050,31,015,"Nebraska","Boyd County",5,63,39,20,19
050,31,015,"Nebraska","Boyd County",5,64,43,23,20
050,31,015,"Nebraska","Boyd County",5,65,33,16,17
050,31,015,"Nebraska","Boyd County",5,66,33,15,18
050,31,015,"Nebraska","Boyd County",5,67,29,15,14
050,31,015,"Nebraska","Boyd County",5,68,25,15,10
050,31,015,"Nebraska","Boyd County",5,69,21,12,9
050,31,015,"Nebraska","Boyd County",5,70,24,11,13
050,31,015,"Nebraska","Boyd County",5,71,34,18,16
050,31,015,"Nebraska","Boyd County",5,72,32,16,16
050,31,015,"Nebraska","Boyd County",5,73,30,17,13
050,31,015,"Nebraska","Boyd County",5,74,30,17,13
050,31,015,"Nebraska","Boyd County",5,75,34,19,15
050,31,015,"Nebraska","Boyd County",5,76,29,13,16
050,31,015,"Nebraska","Boyd County",5,77,16,8,8
050,31,015,"Nebraska","Boyd County",5,78,19,9,10
050,31,015,"Nebraska","Boyd County",5,79,15,8,7
050,31,015,"Nebraska","Boyd County",5,80,19,8,11
050,31,015,"Nebraska","Boyd County",5,81,16,8,8
050,31,015,"Nebraska","Boyd County",5,82,17,9,8
050,31,015,"Nebraska","Boyd County",5,83,14,6,8
050,31,015,"Nebraska","Boyd County",5,84,13,4,9
050,31,015,"Nebraska","Boyd County",5,85,68,18,50
050,31,017,"Nebraska","Brown County",1,0,31,16,15
050,31,017,"Nebraska","Brown County",1,1,33,14,19
050,31,017,"Nebraska","Brown County",1,2,29,14,15
050,31,017,"Nebraska","Brown County",1,3,29,12,17
050,31,017,"Nebraska","Brown County",1,4,39,24,15
050,31,017,"Nebraska","Brown County",1,5,36,22,14
050,31,017,"Nebraska","Brown County",1,6,30,11,19
050,31,017,"Nebraska","Brown County",1,7,35,18,17
050,31,017,"Nebraska","Brown County",1,8,33,22,11
050,31,017,"Nebraska","Brown County",1,9,34,20,14
050,31,017,"Nebraska","Brown County",1,10,38,24,14
050,31,017,"Nebraska","Brown County",1,11,36,19,17
050,31,017,"Nebraska","Brown County",1,12,29,20,9
050,31,017,"Nebraska","Brown County",1,13,33,13,20
050,31,017,"Nebraska","Brown County",1,14,40,16,24
050,31,017,"Nebraska","Brown County",1,15,42,17,25
050,31,017,"Nebraska","Brown County",1,16,54,26,28
050,31,017,"Nebraska","Brown County",1,17,52,23,29
050,31,017,"Nebraska","Brown County",1,18,34,20,14
050,31,017,"Nebraska","Brown County",1,19,24,14,10
050,31,017,"Nebraska","Brown County",1,20,27,13,14
050,31,017,"Nebraska","Brown County",1,21,27,13,14
050,31,017,"Nebraska","Brown County",1,22,24,13,11
050,31,017,"Nebraska","Brown County",1,23,25,16,9
050,31,017,"Nebraska","Brown County",1,24,21,11,10
050,31,017,"Nebraska","Brown County",1,25,23,12,11
050,31,017,"Nebraska","Brown County",1,26,24,15,9
050,31,017,"Nebraska","Brown County",1,27,29,13,16
050,31,017,"Nebraska","Brown County",1,28,29,15,14
050,31,017,"Nebraska","Brown County",1,29,24,11,13
050,31,017,"Nebraska","Brown County",1,30,30,19,11
050,31,017,"Nebraska","Brown County",1,31,33,18,15
050,31,017,"Nebraska","Brown County",1,32,27,15,12
050,31,017,"Nebraska","Brown County",1,33,35,18,17
050,31,017,"Nebraska","Brown County",1,34,40,23,17
050,31,017,"Nebraska","Brown County",1,35,31,16,15
050,31,017,"Nebraska","Brown County",1,36,31,17,14
050,31,017,"Nebraska","Brown County",1,37,27,15,12
050,31,017,"Nebraska","Brown County",1,38,24,11,13
050,31,017,"Nebraska","Brown County",1,39,24,12,12
050,31,017,"Nebraska","Brown County",1,40,28,20,8
050,31,017,"Nebraska","Brown County",1,41,23,13,10
050,31,017,"Nebraska","Brown County",1,42,30,17,13
050,31,017,"Nebraska","Brown County",1,43,34,15,19
050,31,017,"Nebraska","Brown County",1,44,33,16,17
050,31,017,"Nebraska","Brown County",1,45,34,17,17
050,31,017,"Nebraska","Brown County",1,46,32,15,17
050,31,017,"Nebraska","Brown County",1,47,32,17,15
050,31,017,"Nebraska","Brown County",1,48,31,18,13
050,31,017,"Nebraska","Brown County",1,49,36,18,18
050,31,017,"Nebraska","Brown County",1,50,36,20,16
050,31,017,"Nebraska","Brown County",1,51,25,11,14
050,31,017,"Nebraska","Brown County",1,52,23,12,11
050,31,017,"Nebraska","Brown County",1,53,29,15,14
050,31,017,"Nebraska","Brown County",1,54,34,21,13
050,31,017,"Nebraska","Brown County",1,55,38,19,19
050,31,017,"Nebraska","Brown County",1,56,38,20,18
050,31,017,"Nebraska","Brown County",1,57,45,21,24
050,31,017,"Nebraska","Brown County",1,58,36,20,16
050,31,017,"Nebraska","Brown County",1,59,41,21,20
050,31,017,"Nebraska","Brown County",1,60,52,23,29
050,31,017,"Nebraska","Brown County",1,61,46,23,23
050,31,017,"Nebraska","Brown County",1,62,45,22,23
050,31,017,"Nebraska","Brown County",1,63,47,23,24
050,31,017,"Nebraska","Brown County",1,64,52,27,25
050,31,017,"Nebraska","Brown County",1,65,41,22,19
050,31,017,"Nebraska","Brown County",1,66,41,20,21
050,31,017,"Nebraska","Brown County",1,67,45,23,22
050,31,017,"Nebraska","Brown County",1,68,41,21,20
050,31,017,"Nebraska","Brown County",1,69,50,26,24
050,31,017,"Nebraska","Brown County",1,70,36,15,21
050,31,017,"Nebraska","Brown County",1,71,29,15,14
050,31,017,"Nebraska","Brown County",1,72,35,16,19
050,31,017,"Nebraska","Brown County",1,73,34,13,21
050,31,017,"Nebraska","Brown County",1,74,27,15,12
050,31,017,"Nebraska","Brown County",1,75,24,11,13
050,31,017,"Nebraska","Brown County",1,76,26,13,13
050,31,017,"Nebraska","Brown County",1,77,27,14,13
050,31,017,"Nebraska","Brown County",1,78,24,9,15
050,31,017,"Nebraska","Brown County",1,79,26,11,15
050,31,017,"Nebraska","Brown County",1,80,21,10,11
050,31,017,"Nebraska","Brown County",1,81,27,12,15
050,31,017,"Nebraska","Brown County",1,82,20,10,10
050,31,017,"Nebraska","Brown County",1,83,21,10,11
050,31,017,"Nebraska","Brown County",1,84,19,10,9
050,31,017,"Nebraska","Brown County",1,85,115,44,71
050,31,017,"Nebraska","Brown County",2,0,36,19,17
050,31,017,"Nebraska","Brown County",2,1,33,15,18
050,31,017,"Nebraska","Brown County",2,2,29,13,16
050,31,017,"Nebraska","Brown County",2,3,31,14,17
050,31,017,"Nebraska","Brown County",2,4,38,22,16
050,31,017,"Nebraska","Brown County",2,5,37,23,14
050,31,017,"Nebraska","Brown County",2,6,31,14,17
050,31,017,"Nebraska","Brown County",2,7,34,17,17
050,31,017,"Nebraska","Brown County",2,8,34,21,13
050,31,017,"Nebraska","Brown County",2,9,33,20,13
050,31,017,"Nebraska","Brown County",2,10,38,23,15
050,31,017,"Nebraska","Brown County",2,11,35,21,14
050,31,017,"Nebraska","Brown County",2,12,30,20,10
050,31,017,"Nebraska","Brown County",2,13,31,14,17
050,31,017,"Nebraska","Brown County",2,14,40,16,24
050,31,017,"Nebraska","Brown County",2,15,42,16,26
050,31,017,"Nebraska","Brown County",2,16,51,24,27
050,31,017,"Nebraska","Brown County",2,17,53,24,29
050,31,017,"Nebraska","Brown County",2,18,36,20,16
050,31,017,"Nebraska","Brown County",2,19,24,14,10
050,31,017,"Nebraska","Brown County",2,20,28,14,14
050,31,017,"Nebraska","Brown County",2,21,27,13,14
050,31,017,"Nebraska","Brown County",2,22,24,13,11
050,31,017,"Nebraska","Brown County",2,23,24,15,9
050,31,017,"Nebraska","Brown County",2,24,22,12,10
050,31,017,"Nebraska","Brown County",2,25,22,12,10
050,31,017,"Nebraska","Brown County",2,26,25,14,11
050,31,017,"Nebraska","Brown County",2,27,29,14,15
050,31,017,"Nebraska","Brown County",2,28,29,15,14
050,31,017,"Nebraska","Brown County",2,29,25,12,13
050,31,017,"Nebraska","Brown County",2,30,30,17,13
050,31,017,"Nebraska","Brown County",2,31,32,18,14
050,31,017,"Nebraska","Brown County",2,32,28,16,12
050,31,017,"Nebraska","Brown County",2,33,33,17,16
050,31,017,"Nebraska","Brown County",2,34,39,22,17
050,31,017,"Nebraska","Brown County",2,35,35,19,16
050,31,017,"Nebraska","Brown County",2,36,30,17,13
050,31,017,"Nebraska","Brown County",2,37,28,16,12
050,31,017,"Nebraska","Brown County",2,38,24,12,12
050,31,017,"Nebraska","Brown County",2,39,23,11,12
050,31,017,"Nebraska","Brown County",2,40,28,19,9
050,31,017,"Nebraska","Brown County",2,41,24,15,9
050,31,017,"Nebraska","Brown County",2,42,29,16,13
050,31,017,"Nebraska","Brown County",2,43,34,16,18
050,31,017,"Nebraska","Brown County",2,44,33,16,17
050,31,017,"Nebraska","Brown County",2,45,34,16,18
050,31,017,"Nebraska","Brown County",2,46,33,16,17
050,31,017,"Nebraska","Brown County",2,47,32,17,15
050,31,017,"Nebraska","Brown County",2,48,31,18,13
050,31,017,"Nebraska","Brown County",2,49,36,18,18
050,31,017,"Nebraska","Brown County",2,50,36,20,16
050,31,017,"Nebraska","Brown County",2,51,28,13,15
050,31,017,"Nebraska","Brown County",2,52,24,12,12
050,31,017,"Nebraska","Brown County",2,53,29,15,14
050,31,017,"Nebraska","Brown County",2,54,32,19,13
050,31,017,"Nebraska","Brown County",2,55,38,20,18
050,31,017,"Nebraska","Brown County",2,56,39,20,19
050,31,017,"Nebraska","Brown County",2,57,43,21,22
050,31,017,"Nebraska","Brown County",2,58,37,20,17
050,31,017,"Nebraska","Brown County",2,59,40,21,19
050,31,017,"Nebraska","Brown County",2,60,49,23,26
050,31,017,"Nebraska","Brown County",2,61,49,24,25
050,31,017,"Nebraska","Brown County",2,62,44,21,23
050,31,017,"Nebraska","Brown County",2,63,48,24,24
050,31,017,"Nebraska","Brown County",2,64,51,26,25
050,31,017,"Nebraska","Brown County",2,65,42,22,20
050,31,017,"Nebraska","Brown County",2,66,40,21,19
050,31,017,"Nebraska","Brown County",2,67,44,23,21
050,31,017,"Nebraska","Brown County",2,68,41,21,20
050,31,017,"Nebraska","Brown County",2,69,49,25,24
050,31,017,"Nebraska","Brown County",2,70,38,17,21
050,31,017,"Nebraska","Brown County",2,71,31,15,16
050,31,017,"Nebraska","Brown County",2,72,32,15,17
050,31,017,"Nebraska","Brown County",2,73,37,15,22
050,31,017,"Nebraska","Brown County",2,74,26,13,13
050,31,017,"Nebraska","Brown County",2,75,24,12,12
050,31,017,"Nebraska","Brown County",2,76,23,11,12
050,31,017,"Nebraska","Brown County",2,77,27,14,13
050,31,017,"Nebraska","Brown County",2,78,24,10,14
050,31,017,"Nebraska","Brown County",2,79,24,9,15
050,31,017,"Nebraska","Brown County",2,80,22,10,12
050,31,017,"Nebraska","Brown County",2,81,25,11,14
050,31,017,"Nebraska","Brown County",2,82,22,11,11
050,31,017,"Nebraska","Brown County",2,83,20,10,10
050,31,017,"Nebraska","Brown County",2,84,18,9,9
050,31,017,"Nebraska","Brown County",2,85,113,43,70
050,31,017,"Nebraska","Brown County",3,0,35,19,16
050,31,017,"Nebraska","Brown County",3,1,42,23,19
050,31,017,"Nebraska","Brown County",3,2,34,16,18
050,31,017,"Nebraska","Brown County",3,3,32,13,19
050,31,017,"Nebraska","Brown County",3,4,34,13,21
050,31,017,"Nebraska","Brown County",3,5,38,20,18
050,31,017,"Nebraska","Brown County",3,6,37,22,15
050,31,017,"Nebraska","Brown County",3,7,33,15,18
050,31,017,"Nebraska","Brown County",3,8,32,16,16
050,31,017,"Nebraska","Brown County",3,9,37,25,12
050,31,017,"Nebraska","Brown County",3,10,31,17,14
050,31,017,"Nebraska","Brown County",3,11,37,24,13
050,31,017,"Nebraska","Brown County",3,12,34,20,14
050,31,017,"Nebraska","Brown County",3,13,27,18,9
050,31,017,"Nebraska","Brown County",3,14,30,15,15
050,31,017,"Nebraska","Brown County",3,15,40,16,24
050,31,017,"Nebraska","Brown County",3,16,42,16,26
050,31,017,"Nebraska","Brown County",3,17,51,24,27
050,31,017,"Nebraska","Brown County",3,18,42,21,21
050,31,017,"Nebraska","Brown County",3,19,29,17,12
050,31,017,"Nebraska","Brown County",3,20,26,15,11
050,31,017,"Nebraska","Brown County",3,21,33,17,16
050,31,017,"Nebraska","Brown County",3,22,25,11,14
050,31,017,"Nebraska","Brown County",3,23,36,19,17
050,31,017,"Nebraska","Brown County",3,24,22,10,12
050,31,017,"Nebraska","Brown County",3,25,26,13,13
050,31,017,"Nebraska","Brown County",3,26,28,18,10
050,31,017,"Nebraska","Brown County",3,27,27,14,13
050,31,017,"Nebraska","Brown County",3,28,29,13,16
050,31,017,"Nebraska","Brown County",3,29,30,16,14
050,31,017,"Nebraska","Brown County",3,30,27,13,14
050,31,017,"Nebraska","Brown County",3,31,29,17,12
050,31,017,"Nebraska","Brown County",3,32,29,17,12
050,31,017,"Nebraska","Brown County",3,33,29,17,12
050,31,017,"Nebraska","Brown County",3,34,35,18,17
050,31,017,"Nebraska","Brown County",3,35,37,20,17
050,31,017,"Nebraska","Brown County",3,36,36,21,15
050,31,017,"Nebraska","Brown County",3,37,32,19,13
050,31,017,"Nebraska","Brown County",3,38,30,17,13
050,31,017,"Nebraska","Brown County",3,39,24,10,14
050,31,017,"Nebraska","Brown County",3,40,23,10,13
050,31,017,"Nebraska","Brown County",3,41,26,18,8
050,31,017,"Nebraska","Brown County",3,42,25,15,10
050,31,017,"Nebraska","Brown County",3,43,27,15,12
050,31,017,"Nebraska","Brown County",3,44,33,16,17
050,31,017,"Nebraska","Brown County",3,45,31,14,17
050,31,017,"Nebraska","Brown County",3,46,36,16,20
050,31,017,"Nebraska","Brown County",3,47,32,16,16
050,31,017,"Nebraska","Brown County",3,48,34,18,16
050,31,017,"Nebraska","Brown County",3,49,30,17,13
050,31,017,"Nebraska","Brown County",3,50,33,15,18
050,31,017,"Nebraska","Brown County",3,51,35,20,15
050,31,017,"Nebraska","Brown County",3,52,28,15,13
050,31,017,"Nebraska","Brown County",3,53,24,12,12
050,31,017,"Nebraska","Brown County",3,54,27,14,13
050,31,017,"Nebraska","Brown County",3,55,32,19,13
050,31,017,"Nebraska","Brown County",3,56,38,19,19
050,31,017,"Nebraska","Brown County",3,57,40,21,19
050,31,017,"Nebraska","Brown County",3,58,44,21,23
050,31,017,"Nebraska","Brown County",3,59,37,20,17
050,31,017,"Nebraska","Brown County",3,60,40,21,19
050,31,017,"Nebraska","Brown County",3,61,51,26,25
050,31,017,"Nebraska","Brown County",3,62,48,22,26
050,31,017,"Nebraska","Brown County",3,63,43,21,22
050,31,017,"Nebraska","Brown County",3,64,46,23,23
050,31,017,"Nebraska","Brown County",3,65,50,25,25
050,31,017,"Nebraska","Brown County",3,66,42,22,20
050,31,017,"Nebraska","Brown County",3,67,40,21,19
050,31,017,"Nebraska","Brown County",3,68,44,22,22
050,31,017,"Nebraska","Brown County",3,69,39,19,20
050,31,017,"Nebraska","Brown County",3,70,47,25,22
050,31,017,"Nebraska","Brown County",3,71,37,15,22
050,31,017,"Nebraska","Brown County",3,72,30,16,14
050,31,017,"Nebraska","Brown County",3,73,31,15,16
050,31,017,"Nebraska","Brown County",3,74,36,14,22
050,31,017,"Nebraska","Brown County",3,75,24,12,12
050,31,017,"Nebraska","Brown County",3,76,25,12,13
050,31,017,"Nebraska","Brown County",3,77,24,11,13
050,31,017,"Nebraska","Brown County",3,78,26,13,13
050,31,017,"Nebraska","Brown County",3,79,24,10,14
050,31,017,"Nebraska","Brown County",3,80,24,9,15
050,31,017,"Nebraska","Brown County",3,81,23,10,13
050,31,017,"Nebraska","Brown County",3,82,23,10,13
050,31,017,"Nebraska","Brown County",3,83,22,10,12
050,31,017,"Nebraska","Brown County",3,84,19,10,9
050,31,017,"Nebraska","Brown County",3,85,113,42,71
050,31,017,"Nebraska","Brown County",4,0,39,11,28
050,31,017,"Nebraska","Brown County",4,1,40,21,19
050,31,017,"Nebraska","Brown County",4,2,35,18,17
050,31,017,"Nebraska","Brown County",4,3,34,16,18
050,31,017,"Nebraska","Brown County",4,4,31,12,19
050,31,017,"Nebraska","Brown County",4,5,30,11,19
050,31,017,"Nebraska","Brown County",4,6,34,20,14
050,31,017,"Nebraska","Brown County",4,7,36,20,16
050,31,017,"Nebraska","Brown County",4,8,32,17,15
050,31,017,"Nebraska","Brown County",4,9,34,17,17
050,31,017,"Nebraska","Brown County",4,10,37,24,13
050,31,017,"Nebraska","Brown County",4,11,33,18,15
050,31,017,"Nebraska","Brown County",4,12,36,23,13
050,31,017,"Nebraska","Brown County",4,13,36,22,14
050,31,017,"Nebraska","Brown County",4,14,26,16,10
050,31,017,"Nebraska","Brown County",4,15,32,15,17
050,31,017,"Nebraska","Brown County",4,16,39,16,23
050,31,017,"Nebraska","Brown County",4,17,40,15,25
050,31,017,"Nebraska","Brown County",4,18,41,22,19
050,31,017,"Nebraska","Brown County",4,19,30,16,14
050,31,017,"Nebraska","Brown County",4,20,28,17,11
050,31,017,"Nebraska","Brown County",4,21,24,12,12
050,31,017,"Nebraska","Brown County",4,22,31,12,19
050,31,017,"Nebraska","Brown County",4,23,31,17,14
050,31,017,"Nebraska","Brown County",4,24,29,17,12
050,31,017,"Nebraska","Brown County",4,25,22,11,11
050,31,017,"Nebraska","Brown County",4,26,22,12,10
050,31,017,"Nebraska","Brown County",4,27,31,18,13
050,31,017,"Nebraska","Brown County",4,28,29,15,14
050,31,017,"Nebraska","Brown County",4,29,29,13,16
050,31,017,"Nebraska","Brown County",4,30,32,18,14
050,31,017,"Nebraska","Brown County",4,31,26,13,13
050,31,017,"Nebraska","Brown County",4,32,29,17,12
050,31,017,"Nebraska","Brown County",4,33,29,16,13
050,31,017,"Nebraska","Brown County",4,34,33,20,13
050,31,017,"Nebraska","Brown County",4,35,38,20,18
050,31,017,"Nebraska","Brown County",4,36,42,23,19
050,31,017,"Nebraska","Brown County",4,37,38,21,17
050,31,017,"Nebraska","Brown County",4,38,33,21,12
050,31,017,"Nebraska","Brown County",4,39,35,20,15
050,31,017,"Nebraska","Brown County",4,40,25,10,15
050,31,017,"Nebraska","Brown County",4,41,24,10,14
050,31,017,"Nebraska","Brown County",4,42,27,19,8
050,31,017,"Nebraska","Brown County",4,43,26,15,11
050,31,017,"Nebraska","Brown County",4,44,27,15,12
050,31,017,"Nebraska","Brown County",4,45,34,16,18
050,31,017,"Nebraska","Brown County",4,46,33,15,18
050,31,017,"Nebraska","Brown County",4,47,36,16,20
050,31,017,"Nebraska","Brown County",4,48,30,16,14
050,31,017,"Nebraska","Brown County",4,49,34,18,16
050,31,017,"Nebraska","Brown County",4,50,27,15,12
050,31,017,"Nebraska","Brown County",4,51,34,15,19
050,31,017,"Nebraska","Brown County",4,52,33,18,15
050,31,017,"Nebraska","Brown County",4,53,28,15,13
050,31,017,"Nebraska","Brown County",4,54,24,12,12
050,31,017,"Nebraska","Brown County",4,55,29,13,16
050,31,017,"Nebraska","Brown County",4,56,29,17,12
050,31,017,"Nebraska","Brown County",4,57,36,18,18
050,31,017,"Nebraska","Brown County",4,58,40,20,20
050,31,017,"Nebraska","Brown County",4,59,44,22,22
050,31,017,"Nebraska","Brown County",4,60,38,20,18
050,31,017,"Nebraska","Brown County",4,61,39,21,18
050,31,017,"Nebraska","Brown County",4,62,54,25,29
050,31,017,"Nebraska","Brown County",4,63,50,23,27
050,31,017,"Nebraska","Brown County",4,64,42,19,23
050,31,017,"Nebraska","Brown County",4,65,45,23,22
050,31,017,"Nebraska","Brown County",4,66,52,28,24
050,31,017,"Nebraska","Brown County",4,67,42,22,20
050,31,017,"Nebraska","Brown County",4,68,40,21,19
050,31,017,"Nebraska","Brown County",4,69,43,22,21
050,31,017,"Nebraska","Brown County",4,70,38,18,20
050,31,017,"Nebraska","Brown County",4,71,42,21,21
050,31,017,"Nebraska","Brown County",4,72,33,13,20
050,31,017,"Nebraska","Brown County",4,73,28,14,14
050,31,017,"Nebraska","Brown County",4,74,30,14,16
050,31,017,"Nebraska","Brown County",4,75,33,12,21
050,31,017,"Nebraska","Brown County",4,76,22,9,13
050,31,017,"Nebraska","Brown County",4,77,25,12,13
050,31,017,"Nebraska","Brown County",4,78,20,10,10
050,31,017,"Nebraska","Brown County",4,79,24,12,12
050,31,017,"Nebraska","Brown County",4,80,23,9,14
050,31,017,"Nebraska","Brown County",4,81,24,8,16
050,31,017,"Nebraska","Brown County",4,82,20,8,12
050,31,017,"Nebraska","Brown County",4,83,18,9,9
050,31,017,"Nebraska","Brown County",4,84,19,8,11
050,31,017,"Nebraska","Brown County",4,85,113,43,70
050,31,017,"Nebraska","Brown County",5,0,37,12,25
050,31,017,"Nebraska","Brown County",5,1,39,13,26
050,31,017,"Nebraska","Brown County",5,2,36,17,19
050,31,017,"Nebraska","Brown County",5,3,30,18,12
050,31,017,"Nebraska","Brown County",5,4,37,19,18
050,31,017,"Nebraska","Brown County",5,5,29,12,17
050,31,017,"Nebraska","Brown County",5,6,31,10,21
050,31,017,"Nebraska","Brown County",5,7,35,20,15
050,31,017,"Nebraska","Brown County",5,8,35,19,16
050,31,017,"Nebraska","Brown County",5,9,32,18,14
050,31,017,"Nebraska","Brown County",5,10,38,17,21
050,31,017,"Nebraska","Brown County",5,11,38,25,13
050,31,017,"Nebraska","Brown County",5,12,33,17,16
050,31,017,"Nebraska","Brown County",5,13,35,21,14
050,31,017,"Nebraska","Brown County",5,14,32,19,13
050,31,017,"Nebraska","Brown County",5,15,24,14,10
050,31,017,"Nebraska","Brown County",5,16,33,15,18
050,31,017,"Nebraska","Brown County",5,17,37,15,22
050,31,017,"Nebraska","Brown County",5,18,33,13,20
050,31,017,"Nebraska","Brown County",5,19,32,19,13
050,31,017,"Nebraska","Brown County",5,20,32,16,16
050,31,017,"Nebraska","Brown County",5,21,25,15,10
050,31,017,"Nebraska","Brown County",5,22,24,11,13
050,31,017,"Nebraska","Brown County",5,23,31,13,18
050,31,017,"Nebraska","Brown County",5,24,33,14,19
050,31,017,"Nebraska","Brown County",5,25,31,18,13
050,31,017,"Nebraska","Brown County",5,26,18,10,8
050,31,017,"Nebraska","Brown County",5,27,29,14,15
050,31,017,"Nebraska","Brown County",5,28,32,17,15
050,31,017,"Nebraska","Brown County",5,29,31,17,14
050,31,017,"Nebraska","Brown County",5,30,28,13,15
050,31,017,"Nebraska","Brown County",5,31,33,16,17
050,31,017,"Nebraska","Brown County",5,32,26,15,11
050,31,017,"Nebraska","Brown County",5,33,28,18,10
050,31,017,"Nebraska","Brown County",5,34,22,11,11
050,31,017,"Nebraska","Brown County",5,35,34,21,13
050,31,017,"Nebraska","Brown County",5,36,42,23,19
050,31,017,"Nebraska","Brown County",5,37,41,21,20
050,31,017,"Nebraska","Brown County",5,38,33,18,15
050,31,017,"Nebraska","Brown County",5,39,35,24,11
050,31,017,"Nebraska","Brown County",5,40,39,21,18
050,31,017,"Nebraska","Brown County",5,41,23,9,14
050,31,017,"Nebraska","Brown County",5,42,24,11,13
050,31,017,"Nebraska","Brown County",5,43,25,17,8
050,31,017,"Nebraska","Brown County",5,44,28,16,12
050,31,017,"Nebraska","Brown County",5,45,28,15,13
050,31,017,"Nebraska","Brown County",5,46,32,13,19
050,31,017,"Nebraska","Brown County",5,47,31,14,17
050,31,017,"Nebraska","Brown County",5,48,35,15,20
050,31,017,"Nebraska","Brown County",5,49,32,17,15
050,31,017,"Nebraska","Brown County",5,50,33,18,15
050,31,017,"Nebraska","Brown County",5,51,32,16,16
050,31,017,"Nebraska","Brown County",5,52,33,14,19
050,31,017,"Nebraska","Brown County",5,53,32,16,16
050,31,017,"Nebraska","Brown County",5,54,29,15,14
050,31,017,"Nebraska","Brown County",5,55,27,15,12
050,31,017,"Nebraska","Brown County",5,56,29,13,16
050,31,017,"Nebraska","Brown County",5,57,28,16,12
050,31,017,"Nebraska","Brown County",5,58,35,17,18
050,31,017,"Nebraska","Brown County",5,59,41,21,20
050,31,017,"Nebraska","Brown County",5,60,44,22,22
050,31,017,"Nebraska","Brown County",5,61,39,21,18
050,31,017,"Nebraska","Brown County",5,62,38,20,18
050,31,017,"Nebraska","Brown County",5,63,52,25,27
050,31,017,"Nebraska","Brown County",5,64,47,21,26
050,31,017,"Nebraska","Brown County",5,65,40,18,22
050,31,017,"Nebraska","Brown County",5,66,44,22,22
050,31,017,"Nebraska","Brown County",5,67,52,27,25
050,31,017,"Nebraska","Brown County",5,68,40,21,19
050,31,017,"Nebraska","Brown County",5,69,38,21,17
050,31,017,"Nebraska","Brown County",5,70,42,22,20
050,31,017,"Nebraska","Brown County",5,71,35,15,20
050,31,017,"Nebraska","Brown County",5,72,40,20,20
050,31,017,"Nebraska","Brown County",5,73,32,13,19
050,31,017,"Nebraska","Brown County",5,74,28,14,14
050,31,017,"Nebraska","Brown County",5,75,28,13,15
050,31,017,"Nebraska","Brown County",5,76,31,10,21
050,31,017,"Nebraska","Brown County",5,77,22,9,13
050,31,017,"Nebraska","Brown County",5,78,22,11,11
050,31,017,"Nebraska","Brown County",5,79,18,9,9
050,31,017,"Nebraska","Brown County",5,80,22,11,11
050,31,017,"Nebraska","Brown County",5,81,24,8,16
050,31,017,"Nebraska","Brown County",5,82,22,7,15
050,31,017,"Nebraska","Brown County",5,83,16,6,10
050,31,017,"Nebraska","Brown County",5,84,14,6,8
050,31,017,"Nebraska","Brown County",5,85,123,47,76
050,31,019,"Nebraska","Buffalo County",1,0,592,300,292
050,31,019,"Nebraska","Buffalo County",1,1,606,307,299
050,31,019,"Nebraska","Buffalo County",1,2,633,333,300
050,31,019,"Nebraska","Buffalo County",1,3,690,353,337
050,31,019,"Nebraska","Buffalo County",1,4,673,350,323
050,31,019,"Nebraska","Buffalo County",1,5,664,353,311
050,31,019,"Nebraska","Buffalo County",1,6,679,360,319
050,31,019,"Nebraska","Buffalo County",1,7,640,326,314
050,31,019,"Nebraska","Buffalo County",1,8,629,341,288
050,31,019,"Nebraska","Buffalo County",1,9,638,343,295
050,31,019,"Nebraska","Buffalo County",1,10,629,325,304
050,31,019,"Nebraska","Buffalo County",1,11,670,348,322
050,31,019,"Nebraska","Buffalo County",1,12,660,344,316
050,31,019,"Nebraska","Buffalo County",1,13,651,344,307
050,31,019,"Nebraska","Buffalo County",1,14,614,301,313
050,31,019,"Nebraska","Buffalo County",1,15,613,319,294
050,31,019,"Nebraska","Buffalo County",1,16,637,327,310
050,31,019,"Nebraska","Buffalo County",1,17,629,323,306
050,31,019,"Nebraska","Buffalo County",1,18,763,381,382
050,31,019,"Nebraska","Buffalo County",1,19,1218,604,614
050,31,019,"Nebraska","Buffalo County",1,20,1285,647,638
050,31,019,"Nebraska","Buffalo County",1,21,1346,724,622
050,31,019,"Nebraska","Buffalo County",1,22,1124,527,597
050,31,019,"Nebraska","Buffalo County",1,23,924,489,435
050,31,019,"Nebraska","Buffalo County",1,24,807,422,385
050,31,019,"Nebraska","Buffalo County",1,25,734,389,345
050,31,019,"Nebraska","Buffalo County",1,26,666,327,339
050,31,019,"Nebraska","Buffalo County",1,27,643,321,322
050,31,019,"Nebraska","Buffalo County",1,28,671,337,334
050,31,019,"Nebraska","Buffalo County",1,29,591,304,287
050,31,019,"Nebraska","Buffalo County",1,30,626,320,306
050,31,019,"Nebraska","Buffalo County",1,31,607,308,299
050,31,019,"Nebraska","Buffalo County",1,32,615,323,292
050,31,019,"Nebraska","Buffalo County",1,33,628,330,298
050,31,019,"Nebraska","Buffalo County",1,34,662,334,328
050,31,019,"Nebraska","Buffalo County",1,35,679,359,320
050,31,019,"Nebraska","Buffalo County",1,36,646,337,309
050,31,019,"Nebraska","Buffalo County",1,37,689,362,327
050,31,019,"Nebraska","Buffalo County",1,38,663,354,309
050,31,019,"Nebraska","Buffalo County",1,39,644,352,292
050,31,019,"Nebraska","Buffalo County",1,40,610,320,290
050,31,019,"Nebraska","Buffalo County",1,41,618,319,299
050,31,019,"Nebraska","Buffalo County",1,42,589,293,296
050,31,019,"Nebraska","Buffalo County",1,43,583,289,294
050,31,019,"Nebraska","Buffalo County",1,44,519,265,254
050,31,019,"Nebraska","Buffalo County",1,45,514,276,238
050,31,019,"Nebraska","Buffalo County",1,46,459,237,222
050,31,019,"Nebraska","Buffalo County",1,47,496,258,238
050,31,019,"Nebraska","Buffalo County",1,48,526,273,253
050,31,019,"Nebraska","Buffalo County",1,49,548,278,270
050,31,019,"Nebraska","Buffalo County",1,50,505,262,243
050,31,019,"Nebraska","Buffalo County",1,51,507,263,244
050,31,019,"Nebraska","Buffalo County",1,52,483,235,248
050,31,019,"Nebraska","Buffalo County",1,53,497,260,237
050,31,019,"Nebraska","Buffalo County",1,54,505,246,259
050,31,019,"Nebraska","Buffalo County",1,55,513,252,261
050,31,019,"Nebraska","Buffalo County",1,56,534,267,267
050,31,019,"Nebraska","Buffalo County",1,57,569,272,297
050,31,019,"Nebraska","Buffalo County",1,58,583,287,296
050,31,019,"Nebraska","Buffalo County",1,59,563,276,287
050,31,019,"Nebraska","Buffalo County",1,60,580,283,297
050,31,019,"Nebraska","Buffalo County",1,61,581,279,302
050,31,019,"Nebraska","Buffalo County",1,62,590,293,297
050,31,019,"Nebraska","Buffalo County",1,63,555,282,273
050,31,019,"Nebraska","Buffalo County",1,64,533,256,277
050,31,019,"Nebraska","Buffalo County",1,65,532,246,286
050,31,019,"Nebraska","Buffalo County",1,66,537,253,284
050,31,019,"Nebraska","Buffalo County",1,67,507,256,251
050,31,019,"Nebraska","Buffalo County",1,68,503,251,252
050,31,019,"Nebraska","Buffalo County",1,69,451,212,239
050,31,019,"Nebraska","Buffalo County",1,70,421,197,224
050,31,019,"Nebraska","Buffalo County",1,71,426,210,216
050,31,019,"Nebraska","Buffalo County",1,72,408,196,212
050,31,019,"Nebraska","Buffalo County",1,73,381,180,201
050,31,019,"Nebraska","Buffalo County",1,74,276,130,146
050,31,019,"Nebraska","Buffalo County",1,75,294,134,160
050,31,019,"Nebraska","Buffalo County",1,76,291,150,141
050,31,019,"Nebraska","Buffalo County",1,77,262,109,153
050,31,019,"Nebraska","Buffalo County",1,78,236,99,137
050,31,019,"Nebraska","Buffalo County",1,79,215,93,122
050,31,019,"Nebraska","Buffalo County",1,80,207,82,125
050,31,019,"Nebraska","Buffalo County",1,81,188,70,118
050,31,019,"Nebraska","Buffalo County",1,82,174,69,105
050,31,019,"Nebraska","Buffalo County",1,83,164,71,93
050,31,019,"Nebraska","Buffalo County",1,84,174,71,103
050,31,019,"Nebraska","Buffalo County",1,85,1099,363,736
050,31,019,"Nebraska","Buffalo County",2,0,614,318,296
050,31,019,"Nebraska","Buffalo County",2,1,599,306,293
050,31,019,"Nebraska","Buffalo County",2,2,625,328,297
050,31,019,"Nebraska","Buffalo County",2,3,672,346,326
050,31,019,"Nebraska","Buffalo County",2,4,676,350,326
050,31,019,"Nebraska","Buffalo County",2,5,663,350,313
050,31,019,"Nebraska","Buffalo County",2,6,676,359,317
050,31,019,"Nebraska","Buffalo County",2,7,655,337,318
050,31,019,"Nebraska","Buffalo County",2,8,627,335,292
050,31,019,"Nebraska","Buffalo County",2,9,634,342,292
050,31,019,"Nebraska","Buffalo County",2,10,627,327,300
050,31,019,"Nebraska","Buffalo County",2,11,660,344,316
050,31,019,"Nebraska","Buffalo County",2,12,664,346,318
050,31,019,"Nebraska","Buffalo County",2,13,654,342,312
050,31,019,"Nebraska","Buffalo County",2,14,624,313,311
050,31,019,"Nebraska","Buffalo County",2,15,613,313,300
050,31,019,"Nebraska","Buffalo County",2,16,630,325,305
050,31,019,"Nebraska","Buffalo County",2,17,634,326,308
050,31,019,"Nebraska","Buffalo County",2,18,773,383,390
050,31,019,"Nebraska","Buffalo County",2,19,1231,612,619
050,31,019,"Nebraska","Buffalo County",2,20,1283,648,635
050,31,019,"Nebraska","Buffalo County",2,21,1344,723,621
050,31,019,"Nebraska","Buffalo County",2,22,1117,522,595
050,31,019,"Nebraska","Buffalo County",2,23,924,491,433
050,31,019,"Nebraska","Buffalo County",2,24,797,413,384
050,31,019,"Nebraska","Buffalo County",2,25,737,391,346
050,31,019,"Nebraska","Buffalo County",2,26,669,333,336
050,31,019,"Nebraska","Buffalo County",2,27,645,321,324
050,31,019,"Nebraska","Buffalo County",2,28,666,335,331
050,31,019,"Nebraska","Buffalo County",2,29,606,313,293
050,31,019,"Nebraska","Buffalo County",2,30,622,318,304
050,31,019,"Nebraska","Buffalo County",2,31,612,312,300
050,31,019,"Nebraska","Buffalo County",2,32,614,321,293
050,31,019,"Nebraska","Buffalo County",2,33,624,327,297
050,31,019,"Nebraska","Buffalo County",2,34,651,333,318
050,31,019,"Nebraska","Buffalo County",2,35,674,353,321
050,31,019,"Nebraska","Buffalo County",2,36,648,337,311
050,31,019,"Nebraska","Buffalo County",2,37,679,356,323
050,31,019,"Nebraska","Buffalo County",2,38,665,351,314
050,31,019,"Nebraska","Buffalo County",2,39,646,352,294
050,31,019,"Nebraska","Buffalo County",2,40,619,328,291
050,31,019,"Nebraska","Buffalo County",2,41,617,319,298
050,31,019,"Nebraska","Buffalo County",2,42,597,300,297
050,31,019,"Nebraska","Buffalo County",2,43,589,294,295
050,31,019,"Nebraska","Buffalo County",2,44,530,267,263
050,31,019,"Nebraska","Buffalo County",2,45,517,274,243
050,31,019,"Nebraska","Buffalo County",2,46,470,245,225
050,31,019,"Nebraska","Buffalo County",2,47,485,250,235
050,31,019,"Nebraska","Buffalo County",2,48,518,268,250
050,31,019,"Nebraska","Buffalo County",2,49,543,278,265
050,31,019,"Nebraska","Buffalo County",2,50,517,267,250
050,31,019,"Nebraska","Buffalo County",2,51,508,262,246
050,31,019,"Nebraska","Buffalo County",2,52,487,239,248
050,31,019,"Nebraska","Buffalo County",2,53,496,256,240
050,31,019,"Nebraska","Buffalo County",2,54,503,250,253
050,31,019,"Nebraska","Buffalo County",2,55,511,252,259
050,31,019,"Nebraska","Buffalo County",2,56,529,263,266
050,31,019,"Nebraska","Buffalo County",2,57,565,270,295
050,31,019,"Nebraska","Buffalo County",2,58,575,283,292
050,31,019,"Nebraska","Buffalo County",2,59,570,279,291
050,31,019,"Nebraska","Buffalo County",2,60,572,278,294
050,31,019,"Nebraska","Buffalo County",2,61,579,275,304
050,31,019,"Nebraska","Buffalo County",2,62,588,290,298
050,31,019,"Nebraska","Buffalo County",2,63,566,287,279
050,31,019,"Nebraska","Buffalo County",2,64,537,261,276
050,31,019,"Nebraska","Buffalo County",2,65,529,246,283
050,31,019,"Nebraska","Buffalo County",2,66,542,255,287
050,31,019,"Nebraska","Buffalo County",2,67,510,250,260
050,31,019,"Nebraska","Buffalo County",2,68,502,251,251
050,31,019,"Nebraska","Buffalo County",2,69,468,222,246
050,31,019,"Nebraska","Buffalo County",2,70,422,199,223
050,31,019,"Nebraska","Buffalo County",2,71,425,207,218
050,31,019,"Nebraska","Buffalo County",2,72,403,193,210
050,31,019,"Nebraska","Buffalo County",2,73,409,195,214
050,31,019,"Nebraska","Buffalo County",2,74,284,134,150
050,31,019,"Nebraska","Buffalo County",2,75,289,135,154
050,31,019,"Nebraska","Buffalo County",2,76,289,145,144
050,31,019,"Nebraska","Buffalo County",2,77,275,121,154
050,31,019,"Nebraska","Buffalo County",2,78,237,99,138
050,31,019,"Nebraska","Buffalo County",2,79,217,95,122
050,31,019,"Nebraska","Buffalo County",2,80,212,84,128
050,31,019,"Nebraska","Buffalo County",2,81,188,71,117
050,31,019,"Nebraska","Buffalo County",2,82,178,72,106
050,31,019,"Nebraska","Buffalo County",2,83,167,69,98
050,31,019,"Nebraska","Buffalo County",2,84,175,73,102
050,31,019,"Nebraska","Buffalo County",2,85,1110,370,740
050,31,019,"Nebraska","Buffalo County",3,0,618,326,292
050,31,019,"Nebraska","Buffalo County",3,1,634,337,297
050,31,019,"Nebraska","Buffalo County",3,2,590,295,295
050,31,019,"Nebraska","Buffalo County",3,3,638,330,308
050,31,019,"Nebraska","Buffalo County",3,4,648,331,317
050,31,019,"Nebraska","Buffalo County",3,5,686,354,332
050,31,019,"Nebraska","Buffalo County",3,6,669,351,318
050,31,019,"Nebraska","Buffalo County",3,7,686,361,325
050,31,019,"Nebraska","Buffalo County",3,8,665,343,322
050,31,019,"Nebraska","Buffalo County",3,9,626,333,293
050,31,019,"Nebraska","Buffalo County",3,10,641,339,302
050,31,019,"Nebraska","Buffalo County",3,11,627,321,306
050,31,019,"Nebraska","Buffalo County",3,12,648,340,308
050,31,019,"Nebraska","Buffalo County",3,13,658,338,320
050,31,019,"Nebraska","Buffalo County",3,14,645,342,303
050,31,019,"Nebraska","Buffalo County",3,15,612,307,305
050,31,019,"Nebraska","Buffalo County",3,16,610,312,298
050,31,019,"Nebraska","Buffalo County",3,17,641,332,309
050,31,019,"Nebraska","Buffalo County",3,18,777,381,396
050,31,019,"Nebraska","Buffalo County",3,19,1164,579,585
050,31,019,"Nebraska","Buffalo County",3,20,1229,623,606
050,31,019,"Nebraska","Buffalo County",3,21,1348,728,620
050,31,019,"Nebraska","Buffalo County",3,22,1108,508,600
050,31,019,"Nebraska","Buffalo County",3,23,924,503,421
050,31,019,"Nebraska","Buffalo County",3,24,787,424,363
050,31,019,"Nebraska","Buffalo County",3,25,778,412,366
050,31,019,"Nebraska","Buffalo County",3,26,688,363,325
050,31,019,"Nebraska","Buffalo County",3,27,659,345,314
050,31,019,"Nebraska","Buffalo County",3,28,636,300,336
050,31,019,"Nebraska","Buffalo County",3,29,656,335,321
050,31,019,"Nebraska","Buffalo County",3,30,593,298,295
050,31,019,"Nebraska","Buffalo County",3,31,614,312,302
050,31,019,"Nebraska","Buffalo County",3,32,596,303,293
050,31,019,"Nebraska","Buffalo County",3,33,630,326,304
050,31,019,"Nebraska","Buffalo County",3,34,613,324,289
050,31,019,"Nebraska","Buffalo County",3,35,664,336,328
050,31,019,"Nebraska","Buffalo County",3,36,659,342,317
050,31,019,"Nebraska","Buffalo County",3,37,645,343,302
050,31,019,"Nebraska","Buffalo County",3,38,677,347,330
050,31,019,"Nebraska","Buffalo County",3,39,686,376,310
050,31,019,"Nebraska","Buffalo County",3,40,643,344,299
050,31,019,"Nebraska","Buffalo County",3,41,620,327,293
050,31,019,"Nebraska","Buffalo County",3,42,627,327,300
050,31,019,"Nebraska","Buffalo County",3,43,602,301,301
050,31,019,"Nebraska","Buffalo County",3,44,580,288,292
050,31,019,"Nebraska","Buffalo County",3,45,520,274,246
050,31,019,"Nebraska","Buffalo County",3,46,518,279,239
050,31,019,"Nebraska","Buffalo County",3,47,461,237,224
050,31,019,"Nebraska","Buffalo County",3,48,483,244,239
050,31,019,"Nebraska","Buffalo County",3,49,508,261,247
050,31,019,"Nebraska","Buffalo County",3,50,530,266,264
050,31,019,"Nebraska","Buffalo County",3,51,522,265,257
050,31,019,"Nebraska","Buffalo County",3,52,513,266,247
050,31,019,"Nebraska","Buffalo County",3,53,485,235,250
050,31,019,"Nebraska","Buffalo County",3,54,494,261,233
050,31,019,"Nebraska","Buffalo County",3,55,501,248,253
050,31,019,"Nebraska","Buffalo County",3,56,517,250,267
050,31,019,"Nebraska","Buffalo County",3,57,532,257,275
050,31,019,"Nebraska","Buffalo County",3,58,561,280,281
050,31,019,"Nebraska","Buffalo County",3,59,548,269,279
050,31,019,"Nebraska","Buffalo County",3,60,556,274,282
050,31,019,"Nebraska","Buffalo County",3,61,569,279,290
050,31,019,"Nebraska","Buffalo County",3,62,585,276,309
050,31,019,"Nebraska","Buffalo County",3,63,565,279,286
050,31,019,"Nebraska","Buffalo County",3,64,565,281,284
050,31,019,"Nebraska","Buffalo County",3,65,518,253,265
050,31,019,"Nebraska","Buffalo County",3,66,536,256,280
050,31,019,"Nebraska","Buffalo County",3,67,515,239,276
050,31,019,"Nebraska","Buffalo County",3,68,511,249,262
050,31,019,"Nebraska","Buffalo County",3,69,499,241,258
050,31,019,"Nebraska","Buffalo County",3,70,448,221,227
050,31,019,"Nebraska","Buffalo County",3,71,430,210,220
050,31,019,"Nebraska","Buffalo County",3,72,398,182,216
050,31,019,"Nebraska","Buffalo County",3,73,401,187,214
050,31,019,"Nebraska","Buffalo County",3,74,405,190,215
050,31,019,"Nebraska","Buffalo County",3,75,275,124,151
050,31,019,"Nebraska","Buffalo County",3,76,274,124,150
050,31,019,"Nebraska","Buffalo County",3,77,282,138,144
050,31,019,"Nebraska","Buffalo County",3,78,272,120,152
050,31,019,"Nebraska","Buffalo County",3,79,228,101,127
050,31,019,"Nebraska","Buffalo County",3,80,211,78,133
050,31,019,"Nebraska","Buffalo County",3,81,192,76,116
050,31,019,"Nebraska","Buffalo County",3,82,172,76,96
050,31,019,"Nebraska","Buffalo County",3,83,176,66,110
050,31,019,"Nebraska","Buffalo County",3,84,181,78,103
050,31,019,"Nebraska","Buffalo County",3,85,1098,370,728
050,31,019,"Nebraska","Buffalo County",4,0,601,319,282
050,31,019,"Nebraska","Buffalo County",4,1,611,322,289
050,31,019,"Nebraska","Buffalo County",4,2,633,328,305
050,31,019,"Nebraska","Buffalo County",4,3,591,296,295
050,31,019,"Nebraska","Buffalo County",4,4,644,324,320
050,31,019,"Nebraska","Buffalo County",4,5,652,340,312
050,31,019,"Nebraska","Buffalo County",4,6,692,351,341
050,31,019,"Nebraska","Buffalo County",4,7,646,327,319
050,31,019,"Nebraska","Buffalo County",4,8,680,354,326
050,31,019,"Nebraska","Buffalo County",4,9,649,337,312
050,31,019,"Nebraska","Buffalo County",4,10,613,324,289
050,31,019,"Nebraska","Buffalo County",4,11,631,337,294
050,31,019,"Nebraska","Buffalo County",4,12,617,318,299
050,31,019,"Nebraska","Buffalo County",4,13,653,342,311
050,31,019,"Nebraska","Buffalo County",4,14,661,340,321
050,31,019,"Nebraska","Buffalo County",4,15,655,349,306
050,31,019,"Nebraska","Buffalo County",4,16,615,309,306
050,31,019,"Nebraska","Buffalo County",4,17,618,320,298
050,31,019,"Nebraska","Buffalo County",4,18,812,401,411
050,31,019,"Nebraska","Buffalo County",4,19,1249,619,630
050,31,019,"Nebraska","Buffalo County",4,20,1252,632,620
050,31,019,"Nebraska","Buffalo County",4,21,1343,733,610
050,31,019,"Nebraska","Buffalo County",4,22,1129,525,604
050,31,019,"Nebraska","Buffalo County",4,23,899,478,421
050,31,019,"Nebraska","Buffalo County",4,24,792,420,372
050,31,019,"Nebraska","Buffalo County",4,25,706,396,310
050,31,019,"Nebraska","Buffalo County",4,26,676,346,330
050,31,019,"Nebraska","Buffalo County",4,27,655,354,301
050,31,019,"Nebraska","Buffalo County",4,28,646,332,314
050,31,019,"Nebraska","Buffalo County",4,29,608,301,307
050,31,019,"Nebraska","Buffalo County",4,30,638,332,306
050,31,019,"Nebraska","Buffalo County",4,31,588,290,298
050,31,019,"Nebraska","Buffalo County",4,32,598,296,302
050,31,019,"Nebraska","Buffalo County",4,33,597,306,291
050,31,019,"Nebraska","Buffalo County",4,34,644,339,305
050,31,019,"Nebraska","Buffalo County",4,35,613,324,289
050,31,019,"Nebraska","Buffalo County",4,36,639,322,317
050,31,019,"Nebraska","Buffalo County",4,37,668,349,319
050,31,019,"Nebraska","Buffalo County",4,38,661,335,326
050,31,019,"Nebraska","Buffalo County",4,39,691,358,333
050,31,019,"Nebraska","Buffalo County",4,40,668,356,312
050,31,019,"Nebraska","Buffalo County",4,41,646,350,296
050,31,019,"Nebraska","Buffalo County",4,42,618,324,294
050,31,019,"Nebraska","Buffalo County",4,43,621,324,297
050,31,019,"Nebraska","Buffalo County",4,44,605,298,307
050,31,019,"Nebraska","Buffalo County",4,45,572,289,283
050,31,019,"Nebraska","Buffalo County",4,46,519,274,245
050,31,019,"Nebraska","Buffalo County",4,47,527,285,242
050,31,019,"Nebraska","Buffalo County",4,48,465,237,228
050,31,019,"Nebraska","Buffalo County",4,49,492,253,239
050,31,019,"Nebraska","Buffalo County",4,50,502,255,247
050,31,019,"Nebraska","Buffalo County",4,51,527,269,258
050,31,019,"Nebraska","Buffalo County",4,52,521,268,253
050,31,019,"Nebraska","Buffalo County",4,53,509,261,248
050,31,019,"Nebraska","Buffalo County",4,54,488,238,250
050,31,019,"Nebraska","Buffalo County",4,55,493,256,237
050,31,019,"Nebraska","Buffalo County",4,56,506,244,262
050,31,019,"Nebraska","Buffalo County",4,57,515,240,275
050,31,019,"Nebraska","Buffalo County",4,58,518,260,258
050,31,019,"Nebraska","Buffalo County",4,59,541,270,271
050,31,019,"Nebraska","Buffalo County",4,60,554,270,284
050,31,019,"Nebraska","Buffalo County",4,61,546,264,282
050,31,019,"Nebraska","Buffalo County",4,62,561,278,283
050,31,019,"Nebraska","Buffalo County",4,63,595,279,316
050,31,019,"Nebraska","Buffalo County",4,64,564,271,293
050,31,019,"Nebraska","Buffalo County",4,65,563,287,276
050,31,019,"Nebraska","Buffalo County",4,66,534,264,270
050,31,019,"Nebraska","Buffalo County",4,67,509,241,268
050,31,019,"Nebraska","Buffalo County",4,68,509,238,271
050,31,019,"Nebraska","Buffalo County",4,69,515,244,271
050,31,019,"Nebraska","Buffalo County",4,70,479,241,238
050,31,019,"Nebraska","Buffalo County",4,71,445,220,225
050,31,019,"Nebraska","Buffalo County",4,72,406,188,218
050,31,019,"Nebraska","Buffalo County",4,73,399,175,224
050,31,019,"Nebraska","Buffalo County",4,74,391,182,209
050,31,019,"Nebraska","Buffalo County",4,75,383,178,205
050,31,019,"Nebraska","Buffalo County",4,76,267,123,144
050,31,019,"Nebraska","Buffalo County",4,77,276,119,157
050,31,019,"Nebraska","Buffalo County",4,78,286,136,150
050,31,019,"Nebraska","Buffalo County",4,79,273,124,149
050,31,019,"Nebraska","Buffalo County",4,80,213,87,126
050,31,019,"Nebraska","Buffalo County",4,81,197,70,127
050,31,019,"Nebraska","Buffalo County",4,82,179,80,99
050,31,019,"Nebraska","Buffalo County",4,83,174,71,103
050,31,019,"Nebraska","Buffalo County",4,84,177,69,108
050,31,019,"Nebraska","Buffalo County",4,85,1118,399,719
050,31,019,"Nebraska","Buffalo County",5,0,601,318,283
050,31,019,"Nebraska","Buffalo County",5,1,594,302,292
050,31,019,"Nebraska","Buffalo County",5,2,622,336,286
050,31,019,"Nebraska","Buffalo County",5,3,632,325,307
050,31,019,"Nebraska","Buffalo County",5,4,594,305,289
050,31,019,"Nebraska","Buffalo County",5,5,640,320,320
050,31,019,"Nebraska","Buffalo County",5,6,642,328,314
050,31,019,"Nebraska","Buffalo County",5,7,675,341,334
050,31,019,"Nebraska","Buffalo County",5,8,643,329,314
050,31,019,"Nebraska","Buffalo County",5,9,691,360,331
050,31,019,"Nebraska","Buffalo County",5,10,653,340,313
050,31,019,"Nebraska","Buffalo County",5,11,612,325,287
050,31,019,"Nebraska","Buffalo County",5,12,628,332,296
050,31,019,"Nebraska","Buffalo County",5,13,622,324,298
050,31,019,"Nebraska","Buffalo County",5,14,648,338,310
050,31,019,"Nebraska","Buffalo County",5,15,664,337,327
050,31,019,"Nebraska","Buffalo County",5,16,641,342,299
050,31,019,"Nebraska","Buffalo County",5,17,626,309,317
050,31,019,"Nebraska","Buffalo County",5,18,785,381,404
050,31,019,"Nebraska","Buffalo County",5,19,1252,623,629
050,31,019,"Nebraska","Buffalo County",5,20,1274,639,635
050,31,019,"Nebraska","Buffalo County",5,21,1338,718,620
050,31,019,"Nebraska","Buffalo County",5,22,1127,528,599
050,31,019,"Nebraska","Buffalo County",5,23,937,511,426
050,31,019,"Nebraska","Buffalo County",5,24,793,423,370
050,31,019,"Nebraska","Buffalo County",5,25,772,416,356
050,31,019,"Nebraska","Buffalo County",5,26,640,354,286
050,31,019,"Nebraska","Buffalo County",5,27,612,303,309
050,31,019,"Nebraska","Buffalo County",5,28,635,339,296
050,31,019,"Nebraska","Buffalo County",5,29,628,328,300
050,31,019,"Nebraska","Buffalo County",5,30,595,289,306
050,31,019,"Nebraska","Buffalo County",5,31,635,333,302
050,31,019,"Nebraska","Buffalo County",5,32,579,293,286
050,31,019,"Nebraska","Buffalo County",5,33,611,303,308
050,31,019,"Nebraska","Buffalo County",5,34,593,315,278
050,31,019,"Nebraska","Buffalo County",5,35,644,331,313
050,31,019,"Nebraska","Buffalo County",5,36,614,320,294
050,31,019,"Nebraska","Buffalo County",5,37,632,327,305
050,31,019,"Nebraska","Buffalo County",5,38,659,337,322
050,31,019,"Nebraska","Buffalo County",5,39,659,342,317
050,31,019,"Nebraska","Buffalo County",5,40,681,356,325
050,31,019,"Nebraska","Buffalo County",5,41,672,359,313
050,31,019,"Nebraska","Buffalo County",5,42,658,359,299
050,31,019,"Nebraska","Buffalo County",5,43,620,329,291
050,31,019,"Nebraska","Buffalo County",5,44,601,310,291
050,31,019,"Nebraska","Buffalo County",5,45,585,293,292
050,31,019,"Nebraska","Buffalo County",5,46,572,287,285
050,31,019,"Nebraska","Buffalo County",5,47,516,271,245
050,31,019,"Nebraska","Buffalo County",5,48,520,276,244
050,31,019,"Nebraska","Buffalo County",5,49,452,232,220
050,31,019,"Nebraska","Buffalo County",5,50,490,251,239
050,31,019,"Nebraska","Buffalo County",5,51,494,251,243
050,31,019,"Nebraska","Buffalo County",5,52,533,273,260
050,31,019,"Nebraska","Buffalo County",5,53,515,265,250
050,31,019,"Nebraska","Buffalo County",5,54,513,256,257
050,31,019,"Nebraska","Buffalo County",5,55,487,239,248
050,31,019,"Nebraska","Buffalo County",5,56,488,247,241
050,31,019,"Nebraska","Buffalo County",5,57,500,239,261
050,31,019,"Nebraska","Buffalo County",5,58,502,238,264
050,31,019,"Nebraska","Buffalo County",5,59,515,251,264
050,31,019,"Nebraska","Buffalo County",5,60,540,271,269
050,31,019,"Nebraska","Buffalo County",5,61,551,268,283
050,31,019,"Nebraska","Buffalo County",5,62,538,262,276
050,31,019,"Nebraska","Buffalo County",5,63,552,276,276
050,31,019,"Nebraska","Buffalo County",5,64,597,277,320
050,31,019,"Nebraska","Buffalo County",5,65,554,265,289
050,31,019,"Nebraska","Buffalo County",5,66,571,300,271
050,31,019,"Nebraska","Buffalo County",5,67,514,257,257
050,31,019,"Nebraska","Buffalo County",5,68,495,237,258
050,31,019,"Nebraska","Buffalo County",5,69,507,228,279
050,31,019,"Nebraska","Buffalo County",5,70,490,246,244
050,31,019,"Nebraska","Buffalo County",5,71,477,245,232
050,31,019,"Nebraska","Buffalo County",5,72,424,205,219
050,31,019,"Nebraska","Buffalo County",5,73,405,184,221
050,31,019,"Nebraska","Buffalo County",5,74,385,166,219
050,31,019,"Nebraska","Buffalo County",5,75,378,170,208
050,31,019,"Nebraska","Buffalo County",5,76,373,170,203
050,31,019,"Nebraska","Buffalo County",5,77,262,116,146
050,31,019,"Nebraska","Buffalo County",5,78,284,121,163
050,31,019,"Nebraska","Buffalo County",5,79,288,142,146
050,31,019,"Nebraska","Buffalo County",5,80,261,113,148
050,31,019,"Nebraska","Buffalo County",5,81,194,78,116
050,31,019,"Nebraska","Buffalo County",5,82,192,75,117
050,31,019,"Nebraska","Buffalo County",5,83,177,72,105
050,31,019,"Nebraska","Buffalo County",5,84,185,79,106
050,31,019,"Nebraska","Buffalo County",5,85,1147,412,735
050,31,021,"Nebraska","Burt County",1,0,68,35,33
050,31,021,"Nebraska","Burt County",1,1,79,42,37
050,31,021,"Nebraska","Burt County",1,2,74,45,29
050,31,021,"Nebraska","Burt County",1,3,77,46,31
050,31,021,"Nebraska","Burt County",1,4,69,40,29
050,31,021,"Nebraska","Burt County",1,5,79,43,36
050,31,021,"Nebraska","Burt County",1,6,66,40,26
050,31,021,"Nebraska","Burt County",1,7,73,38,35
050,31,021,"Nebraska","Burt County",1,8,94,45,49
050,31,021,"Nebraska","Burt County",1,9,81,33,48
050,31,021,"Nebraska","Burt County",1,10,96,49,47
050,31,021,"Nebraska","Burt County",1,11,92,48,44
050,31,021,"Nebraska","Burt County",1,12,102,50,52
050,31,021,"Nebraska","Burt County",1,13,104,50,54
050,31,021,"Nebraska","Burt County",1,14,105,57,48
050,31,021,"Nebraska","Burt County",1,15,94,51,43
050,31,021,"Nebraska","Burt County",1,16,91,53,38
050,31,021,"Nebraska","Burt County",1,17,88,54,34
050,31,021,"Nebraska","Burt County",1,18,80,46,34
050,31,021,"Nebraska","Burt County",1,19,60,33,27
050,31,021,"Nebraska","Burt County",1,20,62,36,26
050,31,021,"Nebraska","Burt County",1,21,63,37,26
050,31,021,"Nebraska","Burt County",1,22,65,34,31
050,31,021,"Nebraska","Burt County",1,23,51,27,24
050,31,021,"Nebraska","Burt County",1,24,52,33,19
050,31,021,"Nebraska","Burt County",1,25,58,29,29
050,31,021,"Nebraska","Burt County",1,26,64,33,31
050,31,021,"Nebraska","Burt County",1,27,62,35,27
050,31,021,"Nebraska","Burt County",1,28,73,40,33
050,31,021,"Nebraska","Burt County",1,29,74,33,41
050,31,021,"Nebraska","Burt County",1,30,70,32,38
050,31,021,"Nebraska","Burt County",1,31,60,31,29
050,31,021,"Nebraska","Burt County",1,32,62,26,36
050,31,021,"Nebraska","Burt County",1,33,76,38,38
050,31,021,"Nebraska","Burt County",1,34,79,43,36
050,31,021,"Nebraska","Burt County",1,35,71,36,35
050,31,021,"Nebraska","Burt County",1,36,76,30,46
050,31,021,"Nebraska","Burt County",1,37,85,44,41
050,31,021,"Nebraska","Burt County",1,38,70,36,34
050,31,021,"Nebraska","Burt County",1,39,74,40,34
050,31,021,"Nebraska","Burt County",1,40,60,29,31
050,31,021,"Nebraska","Burt County",1,41,77,38,39
050,31,021,"Nebraska","Burt County",1,42,72,34,38
050,31,021,"Nebraska","Burt County",1,43,59,33,26
050,31,021,"Nebraska","Burt County",1,44,54,26,28
050,31,021,"Nebraska","Burt County",1,45,74,39,35
050,31,021,"Nebraska","Burt County",1,46,67,33,34
050,31,021,"Nebraska","Burt County",1,47,64,33,31
050,31,021,"Nebraska","Burt County",1,48,77,38,39
050,31,021,"Nebraska","Burt County",1,49,76,38,38
050,31,021,"Nebraska","Burt County",1,50,81,42,39
050,31,021,"Nebraska","Burt County",1,51,67,35,32
050,31,021,"Nebraska","Burt County",1,52,79,47,32
050,31,021,"Nebraska","Burt County",1,53,84,45,39
050,31,021,"Nebraska","Burt County",1,54,86,42,44
050,31,021,"Nebraska","Burt County",1,55,96,42,54
050,31,021,"Nebraska","Burt County",1,56,101,50,51
050,31,021,"Nebraska","Burt County",1,57,103,51,52
050,31,021,"Nebraska","Burt County",1,58,100,51,49
050,31,021,"Nebraska","Burt County",1,59,95,48,47
050,31,021,"Nebraska","Burt County",1,60,97,55,42
050,31,021,"Nebraska","Burt County",1,61,99,52,47
050,31,021,"Nebraska","Burt County",1,62,103,54,49
050,31,021,"Nebraska","Burt County",1,63,105,57,48
050,31,021,"Nebraska","Burt County",1,64,110,56,54
050,31,021,"Nebraska","Burt County",1,65,100,54,46
050,31,021,"Nebraska","Burt County",1,66,104,58,46
050,31,021,"Nebraska","Burt County",1,67,108,55,53
050,31,021,"Nebraska","Burt County",1,68,100,51,49
050,31,021,"Nebraska","Burt County",1,69,89,42,47
050,31,021,"Nebraska","Burt County",1,70,86,44,42
050,31,021,"Nebraska","Burt County",1,71,77,39,38
050,31,021,"Nebraska","Burt County",1,72,85,42,43
050,31,021,"Nebraska","Burt County",1,73,84,40,44
050,31,021,"Nebraska","Burt County",1,74,65,28,37
050,31,021,"Nebraska","Burt County",1,75,50,20,30
050,31,021,"Nebraska","Burt County",1,76,59,27,32
050,31,021,"Nebraska","Burt County",1,77,57,29,28
050,31,021,"Nebraska","Burt County",1,78,42,24,18
050,31,021,"Nebraska","Burt County",1,79,48,22,26
050,31,021,"Nebraska","Burt County",1,80,50,22,28
050,31,021,"Nebraska","Burt County",1,81,47,22,25
050,31,021,"Nebraska","Burt County",1,82,46,15,31
050,31,021,"Nebraska","Burt County",1,83,36,17,19
050,31,021,"Nebraska","Burt County",1,84,37,20,17
050,31,021,"Nebraska","Burt County",1,85,249,87,162
050,31,021,"Nebraska","Burt County",2,0,69,32,37
050,31,021,"Nebraska","Burt County",2,1,76,40,36
050,31,021,"Nebraska","Burt County",2,2,76,44,32
050,31,021,"Nebraska","Burt County",2,3,76,45,31
050,31,021,"Nebraska","Burt County",2,4,71,42,29
050,31,021,"Nebraska","Burt County",2,5,75,41,34
050,31,021,"Nebraska","Burt County",2,6,70,40,30
050,31,021,"Nebraska","Burt County",2,7,72,39,33
050,31,021,"Nebraska","Burt County",2,8,89,43,46
050,31,021,"Nebraska","Burt County",2,9,85,37,48
050,31,021,"Nebraska","Burt County",2,10,91,44,47
050,31,021,"Nebraska","Burt County",2,11,93,49,44
050,31,021,"Nebraska","Burt County",2,12,100,50,50
050,31,021,"Nebraska","Burt County",2,13,102,49,53
050,31,021,"Nebraska","Burt County",2,14,107,57,50
050,31,021,"Nebraska","Burt County",2,15,97,53,44
050,31,021,"Nebraska","Burt County",2,16,92,53,39
050,31,021,"Nebraska","Burt County",2,17,89,54,35
050,31,021,"Nebraska","Burt County",2,18,78,46,32
050,31,021,"Nebraska","Burt County",2,19,62,35,27
050,31,021,"Nebraska","Burt County",2,20,63,36,27
050,31,021,"Nebraska","Burt County",2,21,63,37,26
050,31,021,"Nebraska","Burt County",2,22,63,34,29
050,31,021,"Nebraska","Burt County",2,23,54,29,25
050,31,021,"Nebraska","Burt County",2,24,52,33,19
050,31,021,"Nebraska","Burt County",2,25,56,29,27
050,31,021,"Nebraska","Burt County",2,26,60,31,29
050,31,021,"Nebraska","Burt County",2,27,63,35,28
050,31,021,"Nebraska","Burt County",2,28,73,39,34
050,31,021,"Nebraska","Burt County",2,29,75,35,40
050,31,021,"Nebraska","Burt County",2,30,71,33,38
050,31,021,"Nebraska","Burt County",2,31,62,31,31
050,31,021,"Nebraska","Burt County",2,32,63,28,35
050,31,021,"Nebraska","Burt County",2,33,73,35,38
050,31,021,"Nebraska","Burt County",2,34,79,42,37
050,31,021,"Nebraska","Burt County",2,35,72,37,35
050,31,021,"Nebraska","Burt County",2,36,76,32,44
050,31,021,"Nebraska","Burt County",2,37,83,41,42
050,31,021,"Nebraska","Burt County",2,38,74,39,35
050,31,021,"Nebraska","Burt County",2,39,73,39,34
050,31,021,"Nebraska","Burt County",2,40,66,33,33
050,31,021,"Nebraska","Burt County",2,41,71,35,36
050,31,021,"Nebraska","Burt County",2,42,73,35,38
050,31,021,"Nebraska","Burt County",2,43,63,34,29
050,31,021,"Nebraska","Burt County",2,44,55,27,28
050,31,021,"Nebraska","Burt County",2,45,69,36,33
050,31,021,"Nebraska","Burt County",2,46,68,33,35
050,31,021,"Nebraska","Burt County",2,47,64,33,31
050,31,021,"Nebraska","Burt County",2,48,75,38,37
050,31,021,"Nebraska","Burt County",2,49,76,38,38
050,31,021,"Nebraska","Burt County",2,50,79,41,38
050,31,021,"Nebraska","Burt County",2,51,69,36,33
050,31,021,"Nebraska","Burt County",2,52,76,44,32
050,31,021,"Nebraska","Burt County",2,53,84,46,38
050,31,021,"Nebraska","Burt County",2,54,84,42,42
050,31,021,"Nebraska","Burt County",2,55,94,42,52
050,31,021,"Nebraska","Burt County",2,56,101,49,52
050,31,021,"Nebraska","Burt County",2,57,103,51,52
050,31,021,"Nebraska","Burt County",2,58,100,50,50
050,31,021,"Nebraska","Burt County",2,59,96,48,48
050,31,021,"Nebraska","Burt County",2,60,98,55,43
050,31,021,"Nebraska","Burt County",2,61,99,53,46
050,31,021,"Nebraska","Burt County",2,62,102,53,49
050,31,021,"Nebraska","Burt County",2,63,104,57,47
050,31,021,"Nebraska","Burt County",2,64,108,56,52
050,31,021,"Nebraska","Burt County",2,65,104,56,48
050,31,021,"Nebraska","Burt County",2,66,104,58,46
050,31,021,"Nebraska","Burt County",2,67,107,56,51
050,31,021,"Nebraska","Burt County",2,68,101,51,50
050,31,021,"Nebraska","Burt County",2,69,93,44,49
050,31,021,"Nebraska","Burt County",2,70,86,44,42
050,31,021,"Nebraska","Burt County",2,71,81,41,40
050,31,021,"Nebraska","Burt County",2,72,81,40,41
050,31,021,"Nebraska","Burt County",2,73,89,43,46
050,31,021,"Nebraska","Burt County",2,74,66,29,37
050,31,021,"Nebraska","Burt County",2,75,53,22,31
050,31,021,"Nebraska","Burt County",2,76,54,24,30
050,31,021,"Nebraska","Burt County",2,77,58,30,28
050,31,021,"Nebraska","Burt County",2,78,44,24,20
050,31,021,"Nebraska","Burt County",2,79,47,22,25
050,31,021,"Nebraska","Burt County",2,80,46,20,26
050,31,021,"Nebraska","Burt County",2,81,46,21,25
050,31,021,"Nebraska","Burt County",2,82,46,15,31
050,31,021,"Nebraska","Burt County",2,83,37,17,20
050,31,021,"Nebraska","Burt County",2,84,36,19,17
050,31,021,"Nebraska","Burt County",2,85,245,87,158
050,31,021,"Nebraska","Burt County",3,0,62,33,29
050,31,021,"Nebraska","Burt County",3,1,80,34,46
050,31,021,"Nebraska","Burt County",3,2,79,42,37
050,31,021,"Nebraska","Burt County",3,3,80,45,35
050,31,021,"Nebraska","Burt County",3,4,79,48,31
050,31,021,"Nebraska","Burt County",3,5,73,42,31
050,31,021,"Nebraska","Burt County",3,6,78,38,40
050,31,021,"Nebraska","Burt County",3,7,77,49,28
050,31,021,"Nebraska","Burt County",3,8,76,39,37
050,31,021,"Nebraska","Burt County",3,9,100,46,54
050,31,021,"Nebraska","Burt County",3,10,82,36,46
050,31,021,"Nebraska","Burt County",3,11,91,44,47
050,31,021,"Nebraska","Burt County",3,12,87,44,43
050,31,021,"Nebraska","Burt County",3,13,103,53,50
050,31,021,"Nebraska","Burt County",3,14,107,47,60
050,31,021,"Nebraska","Burt County",3,15,109,58,51
050,31,021,"Nebraska","Burt County",3,16,93,50,43
050,31,021,"Nebraska","Burt County",3,17,90,54,36
050,31,021,"Nebraska","Burt County",3,18,77,48,29
050,31,021,"Nebraska","Burt County",3,19,59,34,25
050,31,021,"Nebraska","Burt County",3,20,56,30,26
050,31,021,"Nebraska","Burt County",3,21,60,33,27
050,31,021,"Nebraska","Burt County",3,22,64,35,29
050,31,021,"Nebraska","Burt County",3,23,57,31,26
050,31,021,"Nebraska","Burt County",3,24,59,30,29
050,31,021,"Nebraska","Burt County",3,25,56,34,22
050,31,021,"Nebraska","Burt County",3,26,49,25,24
050,31,021,"Nebraska","Burt County",3,27,67,36,31
050,31,021,"Nebraska","Burt County",3,28,62,34,28
050,31,021,"Nebraska","Burt County",3,29,75,38,37
050,31,021,"Nebraska","Burt County",3,30,70,30,40
050,31,021,"Nebraska","Burt County",3,31,69,31,38
050,31,021,"Nebraska","Burt County",3,32,65,32,33
050,31,021,"Nebraska","Burt County",3,33,65,30,35
050,31,021,"Nebraska","Burt County",3,34,73,34,39
050,31,021,"Nebraska","Burt County",3,35,81,40,41
050,31,021,"Nebraska","Burt County",3,36,70,38,32
050,31,021,"Nebraska","Burt County",3,37,82,37,45
050,31,021,"Nebraska","Burt County",3,38,86,42,44
050,31,021,"Nebraska","Burt County",3,39,75,40,35
050,31,021,"Nebraska","Burt County",3,40,71,37,34
050,31,021,"Nebraska","Burt County",3,41,71,38,33
050,31,021,"Nebraska","Burt County",3,42,72,35,37
050,31,021,"Nebraska","Burt County",3,43,76,36,40
050,31,021,"Nebraska","Burt County",3,44,66,35,31
050,31,021,"Nebraska","Burt County",3,45,57,28,29
050,31,021,"Nebraska","Burt County",3,46,69,35,34
050,31,021,"Nebraska","Burt County",3,47,73,37,36
050,31,021,"Nebraska","Burt County",3,48,65,32,33
050,31,021,"Nebraska","Burt County",3,49,74,39,35
050,31,021,"Nebraska","Burt County",3,50,75,35,40
050,31,021,"Nebraska","Burt County",3,51,75,37,38
050,31,021,"Nebraska","Burt County",3,52,69,37,32
050,31,021,"Nebraska","Burt County",3,53,76,42,34
050,31,021,"Nebraska","Burt County",3,54,84,46,38
050,31,021,"Nebraska","Burt County",3,55,83,43,40
050,31,021,"Nebraska","Burt County",3,56,92,41,51
050,31,021,"Nebraska","Burt County",3,57,99,49,50
050,31,021,"Nebraska","Burt County",3,58,101,50,51
050,31,021,"Nebraska","Burt County",3,59,95,46,49
050,31,021,"Nebraska","Burt County",3,60,95,48,47
050,31,021,"Nebraska","Burt County",3,61,93,51,42
050,31,021,"Nebraska","Burt County",3,62,101,56,45
050,31,021,"Nebraska","Burt County",3,63,101,53,48
050,31,021,"Nebraska","Burt County",3,64,100,52,48
050,31,021,"Nebraska","Burt County",3,65,115,61,54
050,31,021,"Nebraska","Burt County",3,66,103,54,49
050,31,021,"Nebraska","Burt County",3,67,104,56,48
050,31,021,"Nebraska","Burt County",3,68,106,55,51
050,31,021,"Nebraska","Burt County",3,69,100,50,50
050,31,021,"Nebraska","Burt County",3,70,92,44,48
050,31,021,"Nebraska","Burt County",3,71,85,43,42
050,31,021,"Nebraska","Burt County",3,72,76,39,37
050,31,021,"Nebraska","Burt County",3,73,78,37,41
050,31,021,"Nebraska","Burt County",3,74,88,44,44
050,31,021,"Nebraska","Burt County",3,75,61,27,34
050,31,021,"Nebraska","Burt County",3,76,53,21,32
050,31,021,"Nebraska","Burt County",3,77,52,24,28
050,31,021,"Nebraska","Burt County",3,78,53,27,26
050,31,021,"Nebraska","Burt County",3,79,42,21,21
050,31,021,"Nebraska","Burt County",3,80,45,23,22
050,31,021,"Nebraska","Burt County",3,81,40,17,23
050,31,021,"Nebraska","Burt County",3,82,45,18,27
050,31,021,"Nebraska","Burt County",3,83,40,15,25
050,31,021,"Nebraska","Burt County",3,84,33,14,19
050,31,021,"Nebraska","Burt County",3,85,242,89,153
050,31,021,"Nebraska","Burt County",4,0,64,36,28
050,31,021,"Nebraska","Burt County",4,1,68,44,24
050,31,021,"Nebraska","Burt County",4,2,80,37,43
050,31,021,"Nebraska","Burt County",4,3,72,36,36
050,31,021,"Nebraska","Burt County",4,4,77,40,37
050,31,021,"Nebraska","Burt County",4,5,88,53,35
050,31,021,"Nebraska","Burt County",4,6,78,45,33
050,31,021,"Nebraska","Burt County",4,7,78,39,39
050,31,021,"Nebraska","Burt County",4,8,80,52,28
050,31,021,"Nebraska","Burt County",4,9,85,42,43
050,31,021,"Nebraska","Burt County",4,10,100,46,54
050,31,021,"Nebraska","Burt County",4,11,87,40,47
050,31,021,"Nebraska","Burt County",4,12,90,43,47
050,31,021,"Nebraska","Burt County",4,13,89,46,43
050,31,021,"Nebraska","Burt County",4,14,101,51,50
050,31,021,"Nebraska","Burt County",4,15,112,53,59
050,31,021,"Nebraska","Burt County",4,16,109,60,49
050,31,021,"Nebraska","Burt County",4,17,96,52,44
050,31,021,"Nebraska","Burt County",4,18,78,45,33
050,31,021,"Nebraska","Burt County",4,19,60,39,21
050,31,021,"Nebraska","Burt County",4,20,61,37,24
050,31,021,"Nebraska","Burt County",4,21,62,35,27
050,31,021,"Nebraska","Burt County",4,22,65,34,31
050,31,021,"Nebraska","Burt County",4,23,59,32,27
050,31,021,"Nebraska","Burt County",4,24,53,28,25
050,31,021,"Nebraska","Burt County",4,25,57,30,27
050,31,021,"Nebraska","Burt County",4,26,50,29,21
050,31,021,"Nebraska","Burt County",4,27,49,24,25
050,31,021,"Nebraska","Burt County",4,28,62,37,25
050,31,021,"Nebraska","Burt County",4,29,76,37,39
050,31,021,"Nebraska","Burt County",4,30,88,50,38
050,31,021,"Nebraska","Burt County",4,31,76,34,42
050,31,021,"Nebraska","Burt County",4,32,77,37,40
050,31,021,"Nebraska","Burt County",4,33,69,32,37
050,31,021,"Nebraska","Burt County",4,34,63,30,33
050,31,021,"Nebraska","Burt County",4,35,79,35,44
050,31,021,"Nebraska","Burt County",4,36,90,41,49
050,31,021,"Nebraska","Burt County",4,37,76,42,34
050,31,021,"Nebraska","Burt County",4,38,80,37,43
050,31,021,"Nebraska","Burt County",4,39,85,41,44
050,31,021,"Nebraska","Burt County",4,40,79,43,36
050,31,021,"Nebraska","Burt County",4,41,73,36,37
050,31,021,"Nebraska","Burt County",4,42,72,38,34
050,31,021,"Nebraska","Burt County",4,43,73,34,39
050,31,021,"Nebraska","Burt County",4,44,76,34,42
050,31,021,"Nebraska","Burt County",4,45,66,33,33
050,31,021,"Nebraska","Burt County",4,46,62,33,29
050,31,021,"Nebraska","Burt County",4,47,77,36,41
050,31,021,"Nebraska","Burt County",4,48,74,39,35
050,31,021,"Nebraska","Burt County",4,49,62,31,31
050,31,021,"Nebraska","Burt County",4,50,82,43,39
050,31,021,"Nebraska","Burt County",4,51,72,33,39
050,31,021,"Nebraska","Burt County",4,52,75,37,38
050,31,021,"Nebraska","Burt County",4,53,66,36,30
050,31,021,"Nebraska","Burt County",4,54,72,40,32
050,31,021,"Nebraska","Burt County",4,55,84,46,38
050,31,021,"Nebraska","Burt County",4,56,80,40,40
050,31,021,"Nebraska","Burt County",4,57,94,43,51
050,31,021,"Nebraska","Burt County",4,58,93,46,47
050,31,021,"Nebraska","Burt County",4,59,102,50,52
050,31,021,"Nebraska","Burt County",4,60,101,52,49
050,31,021,"Nebraska","Burt County",4,61,93,48,45
050,31,021,"Nebraska","Burt County",4,62,93,50,43
050,31,021,"Nebraska","Burt County",4,63,104,60,44
050,31,021,"Nebraska","Burt County",4,64,97,51,46
050,31,021,"Nebraska","Burt County",4,65,100,53,47
050,31,021,"Nebraska","Burt County",4,66,113,59,54
050,31,021,"Nebraska","Burt County",4,67,100,53,47
050,31,021,"Nebraska","Burt County",4,68,102,58,44
050,31,021,"Nebraska","Burt County",4,69,108,56,52
050,31,021,"Nebraska","Burt County",4,70,97,48,49
050,31,021,"Nebraska","Burt County",4,71,92,42,50
050,31,021,"Nebraska","Burt County",4,72,86,45,41
050,31,021,"Nebraska","Burt County",4,73,74,39,35
050,31,021,"Nebraska","Burt County",4,74,76,38,38
050,31,021,"Nebraska","Burt County",4,75,85,41,44
050,31,021,"Nebraska","Burt County",4,76,59,27,32
050,31,021,"Nebraska","Burt County",4,77,53,22,31
050,31,021,"Nebraska","Burt County",4,78,50,23,27
050,31,021,"Nebraska","Burt County",4,79,50,22,28
050,31,021,"Nebraska","Burt County",4,80,36,20,16
050,31,021,"Nebraska","Burt County",4,81,42,21,21
050,31,021,"Nebraska","Burt County",4,82,44,15,29
050,31,021,"Nebraska","Burt County",4,83,41,19,22
050,31,021,"Nebraska","Burt County",4,84,37,13,24
050,31,021,"Nebraska","Burt County",4,85,234,86,148
050,31,021,"Nebraska","Burt County",5,0,64,35,29
050,31,021,"Nebraska","Burt County",5,1,65,35,30
050,31,021,"Nebraska","Burt County",5,2,65,41,24
050,31,021,"Nebraska","Burt County",5,3,77,36,41
050,31,021,"Nebraska","Burt County",5,4,71,33,38
050,31,021,"Nebraska","Burt County",5,5,78,42,36
050,31,021,"Nebraska","Burt County",5,6,84,51,33
050,31,021,"Nebraska","Burt County",5,7,74,44,30
050,31,021,"Nebraska","Burt County",5,8,85,43,42
050,31,021,"Nebraska","Burt County",5,9,77,50,27
050,31,021,"Nebraska","Burt County",5,10,83,43,40
050,31,021,"Nebraska","Burt County",5,11,101,45,56
050,31,021,"Nebraska","Burt County",5,12,81,36,45
050,31,021,"Nebraska","Burt County",5,13,95,47,48
050,31,021,"Nebraska","Burt County",5,14,86,47,39
050,31,021,"Nebraska","Burt County",5,15,103,53,50
050,31,021,"Nebraska","Burt County",5,16,111,51,60
050,31,021,"Nebraska","Burt County",5,17,109,57,52
050,31,021,"Nebraska","Burt County",5,18,79,43,36
050,31,021,"Nebraska","Burt County",5,19,59,35,24
050,31,021,"Nebraska","Burt County",5,20,60,39,21
050,31,021,"Nebraska","Burt County",5,21,67,37,30
050,31,021,"Nebraska","Burt County",5,22,68,35,33
050,31,021,"Nebraska","Burt County",5,23,67,36,31
050,31,021,"Nebraska","Burt County",5,24,60,36,24
050,31,021,"Nebraska","Burt County",5,25,55,30,25
050,31,021,"Nebraska","Burt County",5,26,56,31,25
050,31,021,"Nebraska","Burt County",5,27,50,34,16
050,31,021,"Nebraska","Burt County",5,28,62,30,32
050,31,021,"Nebraska","Burt County",5,29,64,36,28
050,31,021,"Nebraska","Burt County",5,30,71,33,38
050,31,021,"Nebraska","Burt County",5,31,78,44,34
050,31,021,"Nebraska","Burt County",5,32,73,32,41
050,31,021,"Nebraska","Burt County",5,33,83,41,42
050,31,021,"Nebraska","Burt County",5,34,70,30,40
050,31,021,"Nebraska","Burt County",5,35,62,31,31
050,31,021,"Nebraska","Burt County",5,36,78,33,45
050,31,021,"Nebraska","Burt County",5,37,90,44,46
050,31,021,"Nebraska","Burt County",5,38,80,45,35
050,31,021,"Nebraska","Burt County",5,39,83,38,45
050,31,021,"Nebraska","Burt County",5,40,84,41,43
050,31,021,"Nebraska","Burt County",5,41,71,37,34
050,31,021,"Nebraska","Burt County",5,42,68,31,37
050,31,021,"Nebraska","Burt County",5,43,71,40,31
050,31,021,"Nebraska","Burt County",5,44,70,31,39
050,31,021,"Nebraska","Burt County",5,45,74,36,38
050,31,021,"Nebraska","Burt County",5,46,66,32,34
050,31,021,"Nebraska","Burt County",5,47,66,31,35
050,31,021,"Nebraska","Burt County",5,48,77,36,41
050,31,021,"Nebraska","Burt County",5,49,76,40,36
050,31,021,"Nebraska","Burt County",5,50,66,36,30
050,31,021,"Nebraska","Burt County",5,51,81,43,38
050,31,021,"Nebraska","Burt County",5,52,71,33,38
050,31,021,"Nebraska","Burt County",5,53,83,41,42
050,31,021,"Nebraska","Burt County",5,54,65,37,28
050,31,021,"Nebraska","Burt County",5,55,75,40,35
050,31,021,"Nebraska","Burt County",5,56,80,42,38
050,31,021,"Nebraska","Burt County",5,57,79,38,41
050,31,021,"Nebraska","Burt County",5,58,97,45,52
050,31,021,"Nebraska","Burt County",5,59,96,46,50
050,31,021,"Nebraska","Burt County",5,60,99,47,52
050,31,021,"Nebraska","Burt County",5,61,100,52,48
050,31,021,"Nebraska","Burt County",5,62,94,48,46
050,31,021,"Nebraska","Burt County",5,63,92,50,42
050,31,021,"Nebraska","Burt County",5,64,103,59,44
050,31,021,"Nebraska","Burt County",5,65,100,54,46
050,31,021,"Nebraska","Burt County",5,66,103,55,48
050,31,021,"Nebraska","Burt County",5,67,112,60,52
050,31,021,"Nebraska","Burt County",5,68,98,53,45
050,31,021,"Nebraska","Burt County",5,69,102,59,43
050,31,021,"Nebraska","Burt County",5,70,108,56,52
050,31,021,"Nebraska","Burt County",5,71,97,45,52
050,31,021,"Nebraska","Burt County",5,72,89,42,47
050,31,021,"Nebraska","Burt County",5,73,79,41,38
050,31,021,"Nebraska","Burt County",5,74,72,39,33
050,31,021,"Nebraska","Burt County",5,75,76,40,36
050,31,021,"Nebraska","Burt County",5,76,82,42,40
050,31,021,"Nebraska","Burt County",5,77,59,27,32
050,31,021,"Nebraska","Burt County",5,78,50,21,29
050,31,021,"Nebraska","Burt County",5,79,48,20,28
050,31,021,"Nebraska","Burt County",5,80,44,21,23
050,31,021,"Nebraska","Burt County",5,81,34,20,14
050,31,021,"Nebraska","Burt County",5,82,42,19,23
050,31,021,"Nebraska","Burt County",5,83,39,15,24
050,31,021,"Nebraska","Burt County",5,84,36,16,20
050,31,021,"Nebraska","Burt County",5,85,229,84,145
050,31,023,"Nebraska","Butler County",1,0,104,54,50
050,31,023,"Nebraska","Butler County",1,1,111,59,52
050,31,023,"Nebraska","Butler County",1,2,101,56,45
050,31,023,"Nebraska","Butler County",1,3,94,46,48
050,31,023,"Nebraska","Butler County",1,4,84,39,45
050,31,023,"Nebraska","Butler County",1,5,108,47,61
050,31,023,"Nebraska","Butler County",1,6,112,45,67
050,31,023,"Nebraska","Butler County",1,7,111,55,56
050,31,023,"Nebraska","Butler County",1,8,121,63,58
050,31,023,"Nebraska","Butler County",1,9,115,60,55
050,31,023,"Nebraska","Butler County",1,10,110,58,52
050,31,023,"Nebraska","Butler County",1,11,110,59,51
050,31,023,"Nebraska","Butler County",1,12,121,65,56
050,31,023,"Nebraska","Butler County",1,13,115,61,54
050,31,023,"Nebraska","Butler County",1,14,110,55,55
050,31,023,"Nebraska","Butler County",1,15,122,60,62
050,31,023,"Nebraska","Butler County",1,16,119,64,55
050,31,023,"Nebraska","Butler County",1,17,121,55,66
050,31,023,"Nebraska","Butler County",1,18,113,60,53
050,31,023,"Nebraska","Butler County",1,19,93,50,43
050,31,023,"Nebraska","Butler County",1,20,79,46,33
050,31,023,"Nebraska","Butler County",1,21,82,43,39
050,31,023,"Nebraska","Butler County",1,22,94,49,45
050,31,023,"Nebraska","Butler County",1,23,89,42,47
050,31,023,"Nebraska","Butler County",1,24,96,53,43
050,31,023,"Nebraska","Butler County",1,25,86,48,38
050,31,023,"Nebraska","Butler County",1,26,75,41,34
050,31,023,"Nebraska","Butler County",1,27,94,48,46
050,31,023,"Nebraska","Butler County",1,28,88,45,43
050,31,023,"Nebraska","Butler County",1,29,71,31,40
050,31,023,"Nebraska","Butler County",1,30,72,40,32
050,31,023,"Nebraska","Butler County",1,31,100,50,50
050,31,023,"Nebraska","Butler County",1,32,94,53,41
050,31,023,"Nebraska","Butler County",1,33,82,44,38
050,31,023,"Nebraska","Butler County",1,34,89,49,40
050,31,023,"Nebraska","Butler County",1,35,88,51,37
050,31,023,"Nebraska","Butler County",1,36,94,55,39
050,31,023,"Nebraska","Butler County",1,37,99,53,46
050,31,023,"Nebraska","Butler County",1,38,103,53,50
050,31,023,"Nebraska","Butler County",1,39,95,50,45
050,31,023,"Nebraska","Butler County",1,40,98,48,50
050,31,023,"Nebraska","Butler County",1,41,94,48,46
050,31,023,"Nebraska","Butler County",1,42,84,51,33
050,31,023,"Nebraska","Butler County",1,43,95,49,46
050,31,023,"Nebraska","Butler County",1,44,84,42,42
050,31,023,"Nebraska","Butler County",1,45,93,52,41
050,31,023,"Nebraska","Butler County",1,46,104,58,46
050,31,023,"Nebraska","Butler County",1,47,103,53,50
050,31,023,"Nebraska","Butler County",1,48,81,40,41
050,31,023,"Nebraska","Butler County",1,49,93,52,41
050,31,023,"Nebraska","Butler County",1,50,89,51,38
050,31,023,"Nebraska","Butler County",1,51,101,57,44
050,31,023,"Nebraska","Butler County",1,52,89,46,43
050,31,023,"Nebraska","Butler County",1,53,96,48,48
050,31,023,"Nebraska","Butler County",1,54,104,53,51
050,31,023,"Nebraska","Butler County",1,55,122,65,57
050,31,023,"Nebraska","Butler County",1,56,144,76,68
050,31,023,"Nebraska","Butler County",1,57,128,59,69
050,31,023,"Nebraska","Butler County",1,58,129,65,64
050,31,023,"Nebraska","Butler County",1,59,123,64,59
050,31,023,"Nebraska","Butler County",1,60,140,68,72
050,31,023,"Nebraska","Butler County",1,61,145,77,68
050,31,023,"Nebraska","Butler County",1,62,129,70,59
050,31,023,"Nebraska","Butler County",1,63,112,61,51
050,31,023,"Nebraska","Butler County",1,64,126,70,56
050,31,023,"Nebraska","Butler County",1,65,109,53,56
050,31,023,"Nebraska","Butler County",1,66,105,52,53
050,31,023,"Nebraska","Butler County",1,67,103,56,47
050,31,023,"Nebraska","Butler County",1,68,115,58,57
050,31,023,"Nebraska","Butler County",1,69,104,56,48
050,31,023,"Nebraska","Butler County",1,70,96,46,50
050,31,023,"Nebraska","Butler County",1,71,94,51,43
050,31,023,"Nebraska","Butler County",1,72,77,37,40
050,31,023,"Nebraska","Butler County",1,73,83,39,44
050,31,023,"Nebraska","Butler County",1,74,68,36,32
050,31,023,"Nebraska","Butler County",1,75,63,28,35
050,31,023,"Nebraska","Butler County",1,76,63,28,35
050,31,023,"Nebraska","Butler County",1,77,64,28,36
050,31,023,"Nebraska","Butler County",1,78,49,23,26
050,31,023,"Nebraska","Butler County",1,79,48,22,26
050,31,023,"Nebraska","Butler County",1,80,37,13,24
050,31,023,"Nebraska","Butler County",1,81,44,15,29
050,31,023,"Nebraska","Butler County",1,82,44,20,24
050,31,023,"Nebraska","Butler County",1,83,47,20,27
050,31,023,"Nebraska","Butler County",1,84,38,21,17
050,31,023,"Nebraska","Butler County",1,85,252,89,163
050,31,023,"Nebraska","Butler County",2,0,95,48,47
050,31,023,"Nebraska","Butler County",2,1,111,58,53
050,31,023,"Nebraska","Butler County",2,2,106,58,48
050,31,023,"Nebraska","Butler County",2,3,94,47,47
050,31,023,"Nebraska","Butler County",2,4,86,40,46
050,31,023,"Nebraska","Butler County",2,5,101,44,57
050,31,023,"Nebraska","Butler County",2,6,111,46,65
050,31,023,"Nebraska","Butler County",2,7,111,53,58
050,31,023,"Nebraska","Butler County",2,8,119,62,57
050,31,023,"Nebraska","Butler County",2,9,118,62,56
050,31,023,"Nebraska","Butler County",2,10,111,59,52
050,31,023,"Nebraska","Butler County",2,11,110,59,51
050,31,023,"Nebraska","Butler County",2,12,119,64,55
050,31,023,"Nebraska","Butler County",2,13,116,62,54
050,31,023,"Nebraska","Butler County",2,14,112,57,55
050,31,023,"Nebraska","Butler County",2,15,119,58,61
050,31,023,"Nebraska","Butler County",2,16,120,63,57
050,31,023,"Nebraska","Butler County",2,17,121,57,64
050,31,023,"Nebraska","Butler County",2,18,111,58,53
050,31,023,"Nebraska","Butler County",2,19,90,48,42
050,31,023,"Nebraska","Butler County",2,20,85,48,37
050,31,023,"Nebraska","Butler County",2,21,82,45,37
050,31,023,"Nebraska","Butler County",2,22,93,47,46
050,31,023,"Nebraska","Butler County",2,23,90,43,47
050,31,023,"Nebraska","Butler County",2,24,95,51,44
050,31,023,"Nebraska","Butler County",2,25,88,48,40
050,31,023,"Nebraska","Butler County",2,26,78,44,34
050,31,023,"Nebraska","Butler County",2,27,88,46,42
050,31,023,"Nebraska","Butler County",2,28,89,45,44
050,31,023,"Nebraska","Butler County",2,29,74,33,41
050,31,023,"Nebraska","Butler County",2,30,73,38,35
050,31,023,"Nebraska","Butler County",2,31,92,48,44
050,31,023,"Nebraska","Butler County",2,32,95,52,43
050,31,023,"Nebraska","Butler County",2,33,86,47,39
050,31,023,"Nebraska","Butler County",2,34,86,46,40
050,31,023,"Nebraska","Butler County",2,35,89,51,38
050,31,023,"Nebraska","Butler County",2,36,93,55,38
050,31,023,"Nebraska","Butler County",2,37,97,52,45
050,31,023,"Nebraska","Butler County",2,38,102,53,49
050,31,023,"Nebraska","Butler County",2,39,95,50,45
050,31,023,"Nebraska","Butler County",2,40,97,48,49
050,31,023,"Nebraska","Butler County",2,41,93,47,46
050,31,023,"Nebraska","Butler County",2,42,85,49,36
050,31,023,"Nebraska","Butler County",2,43,93,50,43
050,31,023,"Nebraska","Butler County",2,44,87,44,43
050,31,023,"Nebraska","Butler County",2,45,93,51,42
050,31,023,"Nebraska","Butler County",2,46,102,57,45
050,31,023,"Nebraska","Butler County",2,47,103,54,49
050,31,023,"Nebraska","Butler County",2,48,85,42,43
050,31,023,"Nebraska","Butler County",2,49,91,50,41
050,31,023,"Nebraska","Butler County",2,50,91,52,39
050,31,023,"Nebraska","Butler County",2,51,97,55,42
050,31,023,"Nebraska","Butler County",2,52,92,49,43
050,31,023,"Nebraska","Butler County",2,53,94,47,47
050,31,023,"Nebraska","Butler County",2,54,103,52,51
050,31,023,"Nebraska","Butler County",2,55,119,63,56
050,31,023,"Nebraska","Butler County",2,56,138,72,66
050,31,023,"Nebraska","Butler County",2,57,132,64,68
050,31,023,"Nebraska","Butler County",2,58,128,62,66
050,31,023,"Nebraska","Butler County",2,59,126,65,61
050,31,023,"Nebraska","Butler County",2,60,137,68,69
050,31,023,"Nebraska","Butler County",2,61,143,74,69
050,31,023,"Nebraska","Butler County",2,62,133,72,61
050,31,023,"Nebraska","Butler County",2,63,116,62,54
050,31,023,"Nebraska","Butler County",2,64,122,68,54
050,31,023,"Nebraska","Butler County",2,65,113,57,56
050,31,023,"Nebraska","Butler County",2,66,106,53,53
050,31,023,"Nebraska","Butler County",2,67,104,55,49
050,31,023,"Nebraska","Butler County",2,68,110,56,54
050,31,023,"Nebraska","Butler County",2,69,107,57,50
050,31,023,"Nebraska","Butler County",2,70,96,48,48
050,31,023,"Nebraska","Butler County",2,71,93,50,43
050,31,023,"Nebraska","Butler County",2,72,80,40,40
050,31,023,"Nebraska","Butler County",2,73,87,42,45
050,31,023,"Nebraska","Butler County",2,74,65,33,32
050,31,023,"Nebraska","Butler County",2,75,64,30,34
050,31,023,"Nebraska","Butler County",2,76,61,28,33
050,31,023,"Nebraska","Butler County",2,77,65,28,37
050,31,023,"Nebraska","Butler County",2,78,49,22,27
050,31,023,"Nebraska","Butler County",2,79,49,23,26
050,31,023,"Nebraska","Butler County",2,80,40,15,25
050,31,023,"Nebraska","Butler County",2,81,42,14,28
050,31,023,"Nebraska","Butler County",2,82,43,18,25
050,31,023,"Nebraska","Butler County",2,83,44,18,26
050,31,023,"Nebraska","Butler County",2,84,41,22,19
050,31,023,"Nebraska","Butler County",2,85,250,90,160
050,31,023,"Nebraska","Butler County",3,0,104,52,52
050,31,023,"Nebraska","Butler County",3,1,91,49,42
050,31,023,"Nebraska","Butler County",3,2,113,58,55
050,31,023,"Nebraska","Butler County",3,3,109,62,47
050,31,023,"Nebraska","Butler County",3,4,102,44,58
050,31,023,"Nebraska","Butler County",3,5,91,39,52
050,31,023,"Nebraska","Butler County",3,6,114,50,64
050,31,023,"Nebraska","Butler County",3,7,115,47,68
050,31,023,"Nebraska","Butler County",3,8,115,50,65
050,31,023,"Nebraska","Butler County",3,9,118,66,52
050,31,023,"Nebraska","Butler County",3,10,118,62,56
050,31,023,"Nebraska","Butler County",3,11,120,64,56
050,31,023,"Nebraska","Butler County",3,12,117,64,53
050,31,023,"Nebraska","Butler County",3,13,126,65,61
050,31,023,"Nebraska","Butler County",3,14,125,68,57
050,31,023,"Nebraska","Butler County",3,15,107,57,50
050,31,023,"Nebraska","Butler County",3,16,127,57,70
050,31,023,"Nebraska","Butler County",3,17,124,65,59
050,31,023,"Nebraska","Butler County",3,18,106,56,50
050,31,023,"Nebraska","Butler County",3,19,81,46,35
050,31,023,"Nebraska","Butler County",3,20,97,52,45
050,31,023,"Nebraska","Butler County",3,21,93,56,37
050,31,023,"Nebraska","Butler County",3,22,86,45,41
050,31,023,"Nebraska","Butler County",3,23,83,43,40
050,31,023,"Nebraska","Butler County",3,24,82,44,38
050,31,023,"Nebraska","Butler County",3,25,92,47,45
050,31,023,"Nebraska","Butler County",3,26,87,49,38
050,31,023,"Nebraska","Butler County",3,27,71,35,36
050,31,023,"Nebraska","Butler County",3,28,95,47,48
050,31,023,"Nebraska","Butler County",3,29,82,41,41
050,31,023,"Nebraska","Butler County",3,30,77,36,41
050,31,023,"Nebraska","Butler County",3,31,83,39,44
050,31,023,"Nebraska","Butler County",3,32,90,44,46
050,31,023,"Nebraska","Butler County",3,33,105,59,46
050,31,023,"Nebraska","Butler County",3,34,92,51,41
050,31,023,"Nebraska","Butler County",3,35,97,49,48
050,31,023,"Nebraska","Butler County",3,36,90,55,35
050,31,023,"Nebraska","Butler County",3,37,91,55,36
050,31,023,"Nebraska","Butler County",3,38,100,52,48
050,31,023,"Nebraska","Butler County",3,39,110,55,55
050,31,023,"Nebraska","Butler County",3,40,97,47,50
050,31,023,"Nebraska","Butler County",3,41,104,50,54
050,31,023,"Nebraska","Butler County",3,42,91,48,43
050,31,023,"Nebraska","Butler County",3,43,91,53,38
050,31,023,"Nebraska","Butler County",3,44,93,49,44
050,31,023,"Nebraska","Butler County",3,45,86,43,43
050,31,023,"Nebraska","Butler County",3,46,98,52,46
050,31,023,"Nebraska","Butler County",3,47,106,64,42
050,31,023,"Nebraska","Butler County",3,48,104,55,49
050,31,023,"Nebraska","Butler County",3,49,84,43,41
050,31,023,"Nebraska","Butler County",3,50,94,54,40
050,31,023,"Nebraska","Butler County",3,51,87,51,36
050,31,023,"Nebraska","Butler County",3,52,97,56,41
050,31,023,"Nebraska","Butler County",3,53,92,45,47
050,31,023,"Nebraska","Butler County",3,54,100,50,50
050,31,023,"Nebraska","Butler County",3,55,107,57,50
050,31,023,"Nebraska","Butler County",3,56,117,60,57
050,31,023,"Nebraska","Butler County",3,57,138,74,64
050,31,023,"Nebraska","Butler County",3,58,132,63,69
050,31,023,"Nebraska","Butler County",3,59,128,61,67
050,31,023,"Nebraska","Butler County",3,60,125,64,61
050,31,023,"Nebraska","Butler County",3,61,137,67,70
050,31,023,"Nebraska","Butler County",3,62,145,79,66
050,31,023,"Nebraska","Butler County",3,63,130,69,61
050,31,023,"Nebraska","Butler County",3,64,113,58,55
050,31,023,"Nebraska","Butler County",3,65,120,63,57
050,31,023,"Nebraska","Butler County",3,66,116,59,57
050,31,023,"Nebraska","Butler County",3,67,101,49,52
050,31,023,"Nebraska","Butler County",3,68,102,54,48
050,31,023,"Nebraska","Butler County",3,69,108,56,52
050,31,023,"Nebraska","Butler County",3,70,101,51,50
050,31,023,"Nebraska","Butler County",3,71,96,48,48
050,31,023,"Nebraska","Butler County",3,72,90,49,41
050,31,023,"Nebraska","Butler County",3,73,81,43,38
050,31,023,"Nebraska","Butler County",3,74,79,36,43
050,31,023,"Nebraska","Butler County",3,75,64,32,32
050,31,023,"Nebraska","Butler County",3,76,56,28,28
050,31,023,"Nebraska","Butler County",3,77,62,27,35
050,31,023,"Nebraska","Butler County",3,78,59,25,34
050,31,023,"Nebraska","Butler County",3,79,50,24,26
050,31,023,"Nebraska","Butler County",3,80,47,21,26
050,31,023,"Nebraska","Butler County",3,81,38,12,26
050,31,023,"Nebraska","Butler County",3,82,32,11,21
050,31,023,"Nebraska","Butler County",3,83,39,14,25
050,31,023,"Nebraska","Butler County",3,84,43,20,23
050,31,023,"Nebraska","Butler County",3,85,248,87,161
050,31,023,"Nebraska","Butler County",4,0,101,58,43
050,31,023,"Nebraska","Butler County",4,1,95,43,52
050,31,023,"Nebraska","Butler County",4,2,94,50,44
050,31,023,"Nebraska","Butler County",4,3,121,62,59
050,31,023,"Nebraska","Butler County",4,4,112,68,44
050,31,023,"Nebraska","Butler County",4,5,105,43,62
050,31,023,"Nebraska","Butler County",4,6,92,41,51
050,31,023,"Nebraska","Butler County",4,7,117,51,66
050,31,023,"Nebraska","Butler County",4,8,116,44,72
050,31,023,"Nebraska","Butler County",4,9,119,52,67
050,31,023,"Nebraska","Butler County",4,10,114,61,53
050,31,023,"Nebraska","Butler County",4,11,120,60,60
050,31,023,"Nebraska","Butler County",4,12,125,64,61
050,31,023,"Nebraska","Butler County",4,13,118,64,54
050,31,023,"Nebraska","Butler County",4,14,126,62,64
050,31,023,"Nebraska","Butler County",4,15,132,72,60
050,31,023,"Nebraska","Butler County",4,16,107,56,51
050,31,023,"Nebraska","Butler County",4,17,128,60,68
050,31,023,"Nebraska","Butler County",4,18,104,53,51
050,31,023,"Nebraska","Butler County",4,19,85,44,41
050,31,023,"Nebraska","Butler County",4,20,89,49,40
050,31,023,"Nebraska","Butler County",4,21,102,56,46
050,31,023,"Nebraska","Butler County",4,22,87,51,36
050,31,023,"Nebraska","Butler County",4,23,80,41,39
050,31,023,"Nebraska","Butler County",4,24,92,47,45
050,31,023,"Nebraska","Butler County",4,25,82,47,35
050,31,023,"Nebraska","Butler County",4,26,86,43,43
050,31,023,"Nebraska","Butler County",4,27,83,49,34
050,31,023,"Nebraska","Butler County",4,28,72,40,32
050,31,023,"Nebraska","Butler County",4,29,93,48,45
050,31,023,"Nebraska","Butler County",4,30,84,42,42
050,31,023,"Nebraska","Butler County",4,31,84,40,44
050,31,023,"Nebraska","Butler County",4,32,83,39,44
050,31,023,"Nebraska","Butler County",4,33,101,51,50
050,31,023,"Nebraska","Butler County",4,34,96,51,45
050,31,023,"Nebraska","Butler County",4,35,92,51,41
050,31,023,"Nebraska","Butler County",4,36,96,51,45
050,31,023,"Nebraska","Butler County",4,37,89,53,36
050,31,023,"Nebraska","Butler County",4,38,98,60,38
050,31,023,"Nebraska","Butler County",4,39,100,54,46
050,31,023,"Nebraska","Butler County",4,40,113,54,59
050,31,023,"Nebraska","Butler County",4,41,99,47,52
050,31,023,"Nebraska","Butler County",4,42,104,51,53
050,31,023,"Nebraska","Butler County",4,43,94,48,46
050,31,023,"Nebraska","Butler County",4,44,93,54,39
050,31,023,"Nebraska","Butler County",4,45,101,53,48
050,31,023,"Nebraska","Butler County",4,46,86,44,42
050,31,023,"Nebraska","Butler County",4,47,95,52,43
050,31,023,"Nebraska","Butler County",4,48,114,67,47
050,31,023,"Nebraska","Butler County",4,49,106,58,48
050,31,023,"Nebraska","Butler County",4,50,89,45,44
050,31,023,"Nebraska","Butler County",4,51,91,53,38
050,31,023,"Nebraska","Butler County",4,52,92,54,38
050,31,023,"Nebraska","Butler County",4,53,95,55,40
050,31,023,"Nebraska","Butler County",4,54,85,41,44
050,31,023,"Nebraska","Butler County",4,55,97,50,47
050,31,023,"Nebraska","Butler County",4,56,108,56,52
050,31,023,"Nebraska","Butler County",4,57,113,60,53
050,31,023,"Nebraska","Butler County",4,58,138,74,64
050,31,023,"Nebraska","Butler County",4,59,133,64,69
050,31,023,"Nebraska","Butler County",4,60,126,60,66
050,31,023,"Nebraska","Butler County",4,61,125,63,62
050,31,023,"Nebraska","Butler County",4,62,140,70,70
050,31,023,"Nebraska","Butler County",4,63,142,75,67
050,31,023,"Nebraska","Butler County",4,64,126,69,57
050,31,023,"Nebraska","Butler County",4,65,112,58,54
050,31,023,"Nebraska","Butler County",4,66,120,64,56
050,31,023,"Nebraska","Butler County",4,67,111,55,56
050,31,023,"Nebraska","Butler County",4,68,102,50,52
050,31,023,"Nebraska","Butler County",4,69,98,53,45
050,31,023,"Nebraska","Butler County",4,70,102,52,50
050,31,023,"Nebraska","Butler County",4,71,97,49,48
050,31,023,"Nebraska","Butler County",4,72,92,48,44
050,31,023,"Nebraska","Butler County",4,73,90,52,38
050,31,023,"Nebraska","Butler County",4,74,77,39,38
050,31,023,"Nebraska","Butler County",4,75,74,32,42
050,31,023,"Nebraska","Butler County",4,76,58,31,27
050,31,023,"Nebraska","Butler County",4,77,57,29,28
050,31,023,"Nebraska","Butler County",4,78,57,25,32
050,31,023,"Nebraska","Butler County",4,79,60,27,33
050,31,023,"Nebraska","Butler County",4,80,44,19,25
050,31,023,"Nebraska","Butler County",4,81,43,18,25
050,31,023,"Nebraska","Butler County",4,82,31,11,20
050,31,023,"Nebraska","Butler County",4,83,28,9,19
050,31,023,"Nebraska","Butler County",4,84,33,12,21
050,31,023,"Nebraska","Butler County",4,85,232,84,148
050,31,023,"Nebraska","Butler County",5,0,96,55,41
050,31,023,"Nebraska","Butler County",5,1,98,55,43
050,31,023,"Nebraska","Butler County",5,2,108,53,55
050,31,023,"Nebraska","Butler County",5,3,93,50,43
050,31,023,"Nebraska","Butler County",5,4,128,65,63
050,31,023,"Nebraska","Butler County",5,5,117,68,49
050,31,023,"Nebraska","Butler County",5,6,108,48,60
050,31,023,"Nebraska","Butler County",5,7,95,45,50
050,31,023,"Nebraska","Butler County",5,8,119,51,68
050,31,023,"Nebraska","Butler County",5,9,115,48,67
050,31,023,"Nebraska","Butler County",5,10,121,54,67
050,31,023,"Nebraska","Butler County",5,11,117,64,53
050,31,023,"Nebraska","Butler County",5,12,127,63,64
050,31,023,"Nebraska","Butler County",5,13,125,63,62
050,31,023,"Nebraska","Butler County",5,14,115,64,51
050,31,023,"Nebraska","Butler County",5,15,128,63,65
050,31,023,"Nebraska","Butler County",5,16,132,72,60
050,31,023,"Nebraska","Butler County",5,17,109,58,51
050,31,023,"Nebraska","Butler County",5,18,108,53,55
050,31,023,"Nebraska","Butler County",5,19,78,39,39
050,31,023,"Nebraska","Butler County",5,20,84,42,42
050,31,023,"Nebraska","Butler County",5,21,88,47,41
050,31,023,"Nebraska","Butler County",5,22,112,60,52
050,31,023,"Nebraska","Butler County",5,23,87,51,36
050,31,023,"Nebraska","Butler County",5,24,67,33,34
050,31,023,"Nebraska","Butler County",5,25,91,46,45
050,31,023,"Nebraska","Butler County",5,26,86,50,36
050,31,023,"Nebraska","Butler County",5,27,82,38,44
050,31,023,"Nebraska","Butler County",5,28,83,47,36
050,31,023,"Nebraska","Butler County",5,29,72,42,30
050,31,023,"Nebraska","Butler County",5,30,99,50,49
050,31,023,"Nebraska","Butler County",5,31,90,44,46
050,31,023,"Nebraska","Butler County",5,32,82,41,41
050,31,023,"Nebraska","Butler County",5,33,80,38,42
050,31,023,"Nebraska","Butler County",5,34,99,49,50
050,31,023,"Nebraska","Butler County",5,35,100,53,47
050,31,023,"Nebraska","Butler County",5,36,91,50,41
050,31,023,"Nebraska","Butler County",5,37,99,51,48
050,31,023,"Nebraska","Butler County",5,38,90,54,36
050,31,023,"Nebraska","Butler County",5,39,98,63,35
050,31,023,"Nebraska","Butler County",5,40,103,56,47
050,31,023,"Nebraska","Butler County",5,41,116,57,59
050,31,023,"Nebraska","Butler County",5,42,98,47,51
050,31,023,"Nebraska","Butler County",5,43,107,52,55
050,31,023,"Nebraska","Butler County",5,44,98,52,46
050,31,023,"Nebraska","Butler County",5,45,93,54,39
050,31,023,"Nebraska","Butler County",5,46,108,56,52
050,31,023,"Nebraska","Butler County",5,47,86,42,44
050,31,023,"Nebraska","Butler County",5,48,100,56,44
050,31,023,"Nebraska","Butler County",5,49,113,66,47
050,31,023,"Nebraska","Butler County",5,50,98,51,47
050,31,023,"Nebraska","Butler County",5,51,90,46,44
050,31,023,"Nebraska","Butler County",5,52,94,55,39
050,31,023,"Nebraska","Butler County",5,53,87,51,36
050,31,023,"Nebraska","Butler County",5,54,93,54,39
050,31,023,"Nebraska","Butler County",5,55,86,42,44
050,31,023,"Nebraska","Butler County",5,56,93,48,45
050,31,023,"Nebraska","Butler County",5,57,105,55,50
050,31,023,"Nebraska","Butler County",5,58,114,60,54
050,31,023,"Nebraska","Butler County",5,59,142,75,67
050,31,023,"Nebraska","Butler County",5,60,134,65,69
050,31,023,"Nebraska","Butler County",5,61,126,58,68
050,31,023,"Nebraska","Butler County",5,62,127,63,64
050,31,023,"Nebraska","Butler County",5,63,137,69,68
050,31,023,"Nebraska","Butler County",5,64,145,79,66
050,31,023,"Nebraska","Butler County",5,65,124,69,55
050,31,023,"Nebraska","Butler County",5,66,110,58,52
050,31,023,"Nebraska","Butler County",5,67,116,60,56
050,31,023,"Nebraska","Butler County",5,68,113,56,57
050,31,023,"Nebraska","Butler County",5,69,98,49,49
050,31,023,"Nebraska","Butler County",5,70,90,47,43
050,31,023,"Nebraska","Butler County",5,71,102,52,50
050,31,023,"Nebraska","Butler County",5,72,92,48,44
050,31,023,"Nebraska","Butler County",5,73,92,50,42
050,31,023,"Nebraska","Butler County",5,74,85,48,37
050,31,023,"Nebraska","Butler County",5,75,77,38,39
050,31,023,"Nebraska","Butler County",5,76,71,32,39
050,31,023,"Nebraska","Butler County",5,77,59,31,28
050,31,023,"Nebraska","Butler County",5,78,51,27,24
050,31,023,"Nebraska","Butler County",5,79,60,28,32
050,31,023,"Nebraska","Butler County",5,80,55,23,32
050,31,023,"Nebraska","Butler County",5,81,43,17,26
050,31,023,"Nebraska","Butler County",5,82,38,17,21
050,31,023,"Nebraska","Butler County",5,83,27,9,18
050,31,023,"Nebraska","Butler County",5,84,26,9,17
050,31,023,"Nebraska","Butler County",5,85,220,75,145
050,31,025,"Nebraska","Cass County",1,0,254,132,122
050,31,025,"Nebraska","Cass County",1,1,261,133,128
050,31,025,"Nebraska","Cass County",1,2,271,144,127
050,31,025,"Nebraska","Cass County",1,3,302,168,134
050,31,025,"Nebraska","Cass County",1,4,322,161,161
050,31,025,"Nebraska","Cass County",1,5,361,187,174
050,31,025,"Nebraska","Cass County",1,6,345,180,165
050,31,025,"Nebraska","Cass County",1,7,341,185,156
050,31,025,"Nebraska","Cass County",1,8,339,171,168
050,31,025,"Nebraska","Cass County",1,9,361,183,178
050,31,025,"Nebraska","Cass County",1,10,387,224,163
050,31,025,"Nebraska","Cass County",1,11,394,206,188
050,31,025,"Nebraska","Cass County",1,12,398,205,193
050,31,025,"Nebraska","Cass County",1,13,399,216,183
050,31,025,"Nebraska","Cass County",1,14,372,202,170
050,31,025,"Nebraska","Cass County",1,15,390,199,191
050,31,025,"Nebraska","Cass County",1,16,393,211,182
050,31,025,"Nebraska","Cass County",1,17,402,212,190
050,31,025,"Nebraska","Cass County",1,18,314,174,140
050,31,025,"Nebraska","Cass County",1,19,244,139,105
050,31,025,"Nebraska","Cass County",1,20,253,137,116
050,31,025,"Nebraska","Cass County",1,21,260,131,129
050,31,025,"Nebraska","Cass County",1,22,286,154,132
050,31,025,"Nebraska","Cass County",1,23,280,145,135
050,31,025,"Nebraska","Cass County",1,24,257,139,118
050,31,025,"Nebraska","Cass County",1,25,264,128,136
050,31,025,"Nebraska","Cass County",1,26,254,128,126
050,31,025,"Nebraska","Cass County",1,27,249,123,126
050,31,025,"Nebraska","Cass County",1,28,240,123,117
050,31,025,"Nebraska","Cass County",1,29,271,131,140
050,31,025,"Nebraska","Cass County",1,30,271,141,130
050,31,025,"Nebraska","Cass County",1,31,250,143,107
050,31,025,"Nebraska","Cass County",1,32,287,152,135
050,31,025,"Nebraska","Cass County",1,33,315,166,149
050,31,025,"Nebraska","Cass County",1,34,308,159,149
050,31,025,"Nebraska","Cass County",1,35,349,186,163
050,31,025,"Nebraska","Cass County",1,36,340,175,165
050,31,025,"Nebraska","Cass County",1,37,354,174,180
050,31,025,"Nebraska","Cass County",1,38,331,167,164
050,31,025,"Nebraska","Cass County",1,39,345,178,167
050,31,025,"Nebraska","Cass County",1,40,353,176,177
050,31,025,"Nebraska","Cass County",1,41,336,168,168
050,31,025,"Nebraska","Cass County",1,42,315,158,157
050,31,025,"Nebraska","Cass County",1,43,314,156,158
050,31,025,"Nebraska","Cass County",1,44,326,175,151
050,31,025,"Nebraska","Cass County",1,45,364,186,178
050,31,025,"Nebraska","Cass County",1,46,338,171,167
050,31,025,"Nebraska","Cass County",1,47,323,159,164
050,31,025,"Nebraska","Cass County",1,48,333,168,165
050,31,025,"Nebraska","Cass County",1,49,347,177,170
050,31,025,"Nebraska","Cass County",1,50,363,169,194
050,31,025,"Nebraska","Cass County",1,51,348,168,180
050,31,025,"Nebraska","Cass County",1,52,336,160,176
050,31,025,"Nebraska","Cass County",1,53,348,174,174
050,31,025,"Nebraska","Cass County",1,54,367,191,176
050,31,025,"Nebraska","Cass County",1,55,404,204,200
050,31,025,"Nebraska","Cass County",1,56,435,214,221
050,31,025,"Nebraska","Cass County",1,57,431,216,215
050,31,025,"Nebraska","Cass County",1,58,439,234,205
050,31,025,"Nebraska","Cass County",1,59,432,224,208
050,31,025,"Nebraska","Cass County",1,60,430,227,203
050,31,025,"Nebraska","Cass County",1,61,410,223,187
050,31,025,"Nebraska","Cass County",1,62,384,198,186
050,31,025,"Nebraska","Cass County",1,63,374,190,184
050,31,025,"Nebraska","Cass County",1,64,353,173,180
050,31,025,"Nebraska","Cass County",1,65,360,172,188
050,31,025,"Nebraska","Cass County",1,66,365,175,190
050,31,025,"Nebraska","Cass County",1,67,347,180,167
050,31,025,"Nebraska","Cass County",1,68,332,165,167
050,31,025,"Nebraska","Cass County",1,69,299,150,149
050,31,025,"Nebraska","Cass County",1,70,302,149,153
050,31,025,"Nebraska","Cass County",1,71,291,144,147
050,31,025,"Nebraska","Cass County",1,72,263,133,130
050,31,025,"Nebraska","Cass County",1,73,256,131,125
050,31,025,"Nebraska","Cass County",1,74,179,93,86
050,31,025,"Nebraska","Cass County",1,75,194,98,96
050,31,025,"Nebraska","Cass County",1,76,184,95,89
050,31,025,"Nebraska","Cass County",1,77,158,72,86
050,31,025,"Nebraska","Cass County",1,78,136,64,72
050,31,025,"Nebraska","Cass County",1,79,123,58,65
050,31,025,"Nebraska","Cass County",1,80,115,56,59
050,31,025,"Nebraska","Cass County",1,81,99,41,58
050,31,025,"Nebraska","Cass County",1,82,103,49,54
050,31,025,"Nebraska","Cass County",1,83,87,44,43
050,31,025,"Nebraska","Cass County",1,84,81,36,45
050,31,025,"Nebraska","Cass County",1,85,513,179,334
050,31,025,"Nebraska","Cass County",2,0,249,132,117
050,31,025,"Nebraska","Cass County",2,1,260,134,126
050,31,025,"Nebraska","Cass County",2,2,271,144,127
050,31,025,"Nebraska","Cass County",2,3,293,161,132
050,31,025,"Nebraska","Cass County",2,4,321,163,158
050,31,025,"Nebraska","Cass County",2,5,352,181,171
050,31,025,"Nebraska","Cass County",2,6,353,185,168
050,31,025,"Nebraska","Cass County",2,7,343,186,157
050,31,025,"Nebraska","Cass County",2,8,339,174,165
050,31,025,"Nebraska","Cass County",2,9,358,183,175
050,31,025,"Nebraska","Cass County",2,10,382,214,168
050,31,025,"Nebraska","Cass County",2,11,389,210,179
050,31,025,"Nebraska","Cass County",2,12,402,209,193
050,31,025,"Nebraska","Cass County",2,13,398,214,184
050,31,025,"Nebraska","Cass County",2,14,378,204,174
050,31,025,"Nebraska","Cass County",2,15,385,200,185
050,31,025,"Nebraska","Cass County",2,16,395,209,186
050,31,025,"Nebraska","Cass County",2,17,398,210,188
050,31,025,"Nebraska","Cass County",2,18,315,174,141
050,31,025,"Nebraska","Cass County",2,19,244,138,106
050,31,025,"Nebraska","Cass County",2,20,256,139,117
050,31,025,"Nebraska","Cass County",2,21,260,132,128
050,31,025,"Nebraska","Cass County",2,22,285,152,133
050,31,025,"Nebraska","Cass County",2,23,284,147,137
050,31,025,"Nebraska","Cass County",2,24,261,138,123
050,31,025,"Nebraska","Cass County",2,25,263,130,133
050,31,025,"Nebraska","Cass County",2,26,256,127,129
050,31,025,"Nebraska","Cass County",2,27,251,125,126
050,31,025,"Nebraska","Cass County",2,28,247,124,123
050,31,025,"Nebraska","Cass County",2,29,266,129,137
050,31,025,"Nebraska","Cass County",2,30,273,140,133
050,31,025,"Nebraska","Cass County",2,31,259,145,114
050,31,025,"Nebraska","Cass County",2,32,281,152,129
050,31,025,"Nebraska","Cass County",2,33,308,162,146
050,31,025,"Nebraska","Cass County",2,34,314,162,152
050,31,025,"Nebraska","Cass County",2,35,346,183,163
050,31,025,"Nebraska","Cass County",2,36,342,177,165
050,31,025,"Nebraska","Cass County",2,37,350,174,176
050,31,025,"Nebraska","Cass County",2,38,336,169,167
050,31,025,"Nebraska","Cass County",2,39,345,177,168
050,31,025,"Nebraska","Cass County",2,40,354,178,176
050,31,025,"Nebraska","Cass County",2,41,339,170,169
050,31,025,"Nebraska","Cass County",2,42,319,160,159
050,31,025,"Nebraska","Cass County",2,43,317,158,159
050,31,025,"Nebraska","Cass County",2,44,324,171,153
050,31,025,"Nebraska","Cass County",2,45,360,185,175
050,31,025,"Nebraska","Cass County",2,46,342,172,170
050,31,025,"Nebraska","Cass County",2,47,326,162,164
050,31,025,"Nebraska","Cass County",2,48,331,167,164
050,31,025,"Nebraska","Cass County",2,49,347,175,172
050,31,025,"Nebraska","Cass County",2,50,361,172,189
050,31,025,"Nebraska","Cass County",2,51,348,165,183
050,31,025,"Nebraska","Cass County",2,52,337,160,177
050,31,025,"Nebraska","Cass County",2,53,346,171,175
050,31,025,"Nebraska","Cass County",2,54,359,185,174
050,31,025,"Nebraska","Cass County",2,55,396,200,196
050,31,025,"Nebraska","Cass County",2,56,427,212,215
050,31,025,"Nebraska","Cass County",2,57,430,216,214
050,31,025,"Nebraska","Cass County",2,58,435,229,206
050,31,025,"Nebraska","Cass County",2,59,434,227,207
050,31,025,"Nebraska","Cass County",2,60,429,226,203
050,31,025,"Nebraska","Cass County",2,61,410,221,189
050,31,025,"Nebraska","Cass County",2,62,386,201,185
050,31,025,"Nebraska","Cass County",2,63,375,190,185
050,31,025,"Nebraska","Cass County",2,64,354,174,180
050,31,025,"Nebraska","Cass County",2,65,359,173,186
050,31,025,"Nebraska","Cass County",2,66,363,174,189
050,31,025,"Nebraska","Cass County",2,67,352,179,173
050,31,025,"Nebraska","Cass County",2,68,333,169,164
050,31,025,"Nebraska","Cass County",2,69,303,152,151
050,31,025,"Nebraska","Cass County",2,70,302,151,151
050,31,025,"Nebraska","Cass County",2,71,292,143,149
050,31,025,"Nebraska","Cass County",2,72,264,133,131
050,31,025,"Nebraska","Cass County",2,73,269,137,132
050,31,025,"Nebraska","Cass County",2,74,184,94,90
050,31,025,"Nebraska","Cass County",2,75,189,96,93
050,31,025,"Nebraska","Cass County",2,76,185,96,89
050,31,025,"Nebraska","Cass County",2,77,166,77,89
050,31,025,"Nebraska","Cass County",2,78,136,64,72
050,31,025,"Nebraska","Cass County",2,79,124,59,65
050,31,025,"Nebraska","Cass County",2,80,114,55,59
050,31,025,"Nebraska","Cass County",2,81,103,44,59
050,31,025,"Nebraska","Cass County",2,82,99,45,54
050,31,025,"Nebraska","Cass County",2,83,89,44,45
050,31,025,"Nebraska","Cass County",2,84,80,36,44
050,31,025,"Nebraska","Cass County",2,85,511,177,334
050,31,025,"Nebraska","Cass County",3,0,259,149,110
050,31,025,"Nebraska","Cass County",3,1,275,143,132
050,31,025,"Nebraska","Cass County",3,2,269,143,126
050,31,025,"Nebraska","Cass County",3,3,290,153,137
050,31,025,"Nebraska","Cass County",3,4,307,164,143
050,31,025,"Nebraska","Cass County",3,5,320,176,144
050,31,025,"Nebraska","Cass County",3,6,363,185,178
050,31,025,"Nebraska","Cass County",3,7,357,187,170
050,31,025,"Nebraska","Cass County",3,8,362,198,164
050,31,025,"Nebraska","Cass County",3,9,349,177,172
050,31,025,"Nebraska","Cass County",3,10,383,200,183
050,31,025,"Nebraska","Cass County",3,11,384,213,171
050,31,025,"Nebraska","Cass County",3,12,392,209,183
050,31,025,"Nebraska","Cass County",3,13,410,212,198
050,31,025,"Nebraska","Cass County",3,14,412,221,191
050,31,025,"Nebraska","Cass County",3,15,376,194,182
050,31,025,"Nebraska","Cass County",3,16,410,214,196
050,31,025,"Nebraska","Cass County",3,17,394,205,189
050,31,025,"Nebraska","Cass County",3,18,343,191,152
050,31,025,"Nebraska","Cass County",3,19,255,142,113
050,31,025,"Nebraska","Cass County",3,20,263,146,117
050,31,025,"Nebraska","Cass County",3,21,276,147,129
050,31,025,"Nebraska","Cass County",3,22,294,152,142
050,31,025,"Nebraska","Cass County",3,23,293,155,138
050,31,025,"Nebraska","Cass County",3,24,277,148,129
050,31,025,"Nebraska","Cass County",3,25,261,143,118
050,31,025,"Nebraska","Cass County",3,26,253,127,126
050,31,025,"Nebraska","Cass County",3,27,262,126,136
050,31,025,"Nebraska","Cass County",3,28,257,130,127
050,31,025,"Nebraska","Cass County",3,29,281,144,137
050,31,025,"Nebraska","Cass County",3,30,262,130,132
050,31,025,"Nebraska","Cass County",3,31,293,154,139
050,31,025,"Nebraska","Cass County",3,32,276,155,121
050,31,025,"Nebraska","Cass County",3,33,321,173,148
050,31,025,"Nebraska","Cass County",3,34,329,172,157
050,31,025,"Nebraska","Cass County",3,35,329,169,160
050,31,025,"Nebraska","Cass County",3,36,358,194,164
050,31,025,"Nebraska","Cass County",3,37,364,190,174
050,31,025,"Nebraska","Cass County",3,38,348,175,173
050,31,025,"Nebraska","Cass County",3,39,356,178,178
050,31,025,"Nebraska","Cass County",3,40,354,183,171
050,31,025,"Nebraska","Cass County",3,41,379,188,191
050,31,025,"Nebraska","Cass County",3,42,346,175,171
050,31,025,"Nebraska","Cass County",3,43,319,160,159
050,31,025,"Nebraska","Cass County",3,44,324,161,163
050,31,025,"Nebraska","Cass County",3,45,328,175,153
050,31,025,"Nebraska","Cass County",3,46,355,182,173
050,31,025,"Nebraska","Cass County",3,47,341,172,169
050,31,025,"Nebraska","Cass County",3,48,310,147,163
050,31,025,"Nebraska","Cass County",3,49,337,169,168
050,31,025,"Nebraska","Cass County",3,50,368,187,181
050,31,025,"Nebraska","Cass County",3,51,367,181,186
050,31,025,"Nebraska","Cass County",3,52,364,169,195
050,31,025,"Nebraska","Cass County",3,53,344,162,182
050,31,025,"Nebraska","Cass County",3,54,353,176,177
050,31,025,"Nebraska","Cass County",3,55,366,189,177
050,31,025,"Nebraska","Cass County",3,56,399,199,200
050,31,025,"Nebraska","Cass County",3,57,428,216,212
050,31,025,"Nebraska","Cass County",3,58,449,227,222
050,31,025,"Nebraska","Cass County",3,59,433,229,204
050,31,025,"Nebraska","Cass County",3,60,420,223,197
050,31,025,"Nebraska","Cass County",3,61,431,228,203
050,31,025,"Nebraska","Cass County",3,62,402,212,190
050,31,025,"Nebraska","Cass County",3,63,373,194,179
050,31,025,"Nebraska","Cass County",3,64,374,188,186
050,31,025,"Nebraska","Cass County",3,65,352,172,180
050,31,025,"Nebraska","Cass County",3,66,358,176,182
050,31,025,"Nebraska","Cass County",3,67,360,177,183
050,31,025,"Nebraska","Cass County",3,68,351,176,175
050,31,025,"Nebraska","Cass County",3,69,330,166,164
050,31,025,"Nebraska","Cass County",3,70,303,154,149
050,31,025,"Nebraska","Cass County",3,71,299,152,147
050,31,025,"Nebraska","Cass County",3,72,279,133,146
050,31,025,"Nebraska","Cass County",3,73,259,128,131
050,31,025,"Nebraska","Cass County",3,74,253,131,122
050,31,025,"Nebraska","Cass County",3,75,174,90,84
050,31,025,"Nebraska","Cass County",3,76,190,97,93
050,31,025,"Nebraska","Cass County",3,77,180,92,88
050,31,025,"Nebraska","Cass County",3,78,153,69,84
050,31,025,"Nebraska","Cass County",3,79,121,53,68
050,31,025,"Nebraska","Cass County",3,80,111,53,58
050,31,025,"Nebraska","Cass County",3,81,119,57,62
050,31,025,"Nebraska","Cass County",3,82,96,40,56
050,31,025,"Nebraska","Cass County",3,83,83,32,51
050,31,025,"Nebraska","Cass County",3,84,80,40,40
050,31,025,"Nebraska","Cass County",3,85,502,178,324
050,31,025,"Nebraska","Cass County",4,0,261,140,121
050,31,025,"Nebraska","Cass County",4,1,266,154,112
050,31,025,"Nebraska","Cass County",4,2,288,154,134
050,31,025,"Nebraska","Cass County",4,3,287,147,140
050,31,025,"Nebraska","Cass County",4,4,305,158,147
050,31,025,"Nebraska","Cass County",4,5,321,167,154
050,31,025,"Nebraska","Cass County",4,6,333,178,155
050,31,025,"Nebraska","Cass County",4,7,378,187,191
050,31,025,"Nebraska","Cass County",4,8,371,190,181
050,31,025,"Nebraska","Cass County",4,9,372,207,165
050,31,025,"Nebraska","Cass County",4,10,367,183,184
050,31,025,"Nebraska","Cass County",4,11,367,189,178
050,31,025,"Nebraska","Cass County",4,12,376,214,162
050,31,025,"Nebraska","Cass County",4,13,395,207,188
050,31,025,"Nebraska","Cass County",4,14,418,217,201
050,31,025,"Nebraska","Cass County",4,15,399,210,189
050,31,025,"Nebraska","Cass County",4,16,359,190,169
050,31,025,"Nebraska","Cass County",4,17,402,212,190
050,31,025,"Nebraska","Cass County",4,18,329,186,143
050,31,025,"Nebraska","Cass County",4,19,247,138,109
050,31,025,"Nebraska","Cass County",4,20,252,141,111
050,31,025,"Nebraska","Cass County",4,21,269,153,116
050,31,025,"Nebraska","Cass County",4,22,294,155,139
050,31,025,"Nebraska","Cass County",4,23,294,147,147
050,31,025,"Nebraska","Cass County",4,24,275,145,130
050,31,025,"Nebraska","Cass County",4,25,282,147,135
050,31,025,"Nebraska","Cass County",4,26,249,136,113
050,31,025,"Nebraska","Cass County",4,27,268,138,130
050,31,025,"Nebraska","Cass County",4,28,265,124,141
050,31,025,"Nebraska","Cass County",4,29,266,127,139
050,31,025,"Nebraska","Cass County",4,30,291,140,151
050,31,025,"Nebraska","Cass County",4,31,281,139,142
050,31,025,"Nebraska","Cass County",4,32,306,152,154
050,31,025,"Nebraska","Cass County",4,33,279,153,126
050,31,025,"Nebraska","Cass County",4,34,317,168,149
050,31,025,"Nebraska","Cass County",4,35,339,173,166
050,31,025,"Nebraska","Cass County",4,36,338,175,163
050,31,025,"Nebraska","Cass County",4,37,373,204,169
050,31,025,"Nebraska","Cass County",4,38,356,180,176
050,31,025,"Nebraska","Cass County",4,39,368,184,184
050,31,025,"Nebraska","Cass County",4,40,368,187,181
050,31,025,"Nebraska","Cass County",4,41,367,191,176
050,31,025,"Nebraska","Cass County",4,42,376,193,183
050,31,025,"Nebraska","Cass County",4,43,337,174,163
050,31,025,"Nebraska","Cass County",4,44,301,147,154
050,31,025,"Nebraska","Cass County",4,45,323,159,164
050,31,025,"Nebraska","Cass County",4,46,319,172,147
050,31,025,"Nebraska","Cass County",4,47,363,190,173
050,31,025,"Nebraska","Cass County",4,48,349,173,176
050,31,025,"Nebraska","Cass County",4,49,315,154,161
050,31,025,"Nebraska","Cass County",4,50,339,171,168
050,31,025,"Nebraska","Cass County",4,51,358,180,178
050,31,025,"Nebraska","Cass County",4,52,374,179,195
050,31,025,"Nebraska","Cass County",4,53,373,181,192
050,31,025,"Nebraska","Cass County",4,54,354,165,189
050,31,025,"Nebraska","Cass County",4,55,363,183,180
050,31,025,"Nebraska","Cass County",4,56,366,185,181
050,31,025,"Nebraska","Cass County",4,57,400,203,197
050,31,025,"Nebraska","Cass County",4,58,423,215,208
050,31,025,"Nebraska","Cass County",4,59,436,221,215
050,31,025,"Nebraska","Cass County",4,60,437,230,207
050,31,025,"Nebraska","Cass County",4,61,420,217,203
050,31,025,"Nebraska","Cass County",4,62,427,227,200
050,31,025,"Nebraska","Cass County",4,63,395,200,195
050,31,025,"Nebraska","Cass County",4,64,378,202,176
050,31,025,"Nebraska","Cass County",4,65,367,184,183
050,31,025,"Nebraska","Cass County",4,66,354,173,181
050,31,025,"Nebraska","Cass County",4,67,348,171,177
050,31,025,"Nebraska","Cass County",4,68,355,174,181
050,31,025,"Nebraska","Cass County",4,69,347,173,174
050,31,025,"Nebraska","Cass County",4,70,325,162,163
050,31,025,"Nebraska","Cass County",4,71,291,148,143
050,31,025,"Nebraska","Cass County",4,72,288,145,143
050,31,025,"Nebraska","Cass County",4,73,272,132,140
050,31,025,"Nebraska","Cass County",4,74,245,117,128
050,31,025,"Nebraska","Cass County",4,75,241,126,115
050,31,025,"Nebraska","Cass County",4,76,170,88,82
050,31,025,"Nebraska","Cass County",4,77,183,91,92
050,31,025,"Nebraska","Cass County",4,78,173,90,83
050,31,025,"Nebraska","Cass County",4,79,140,60,80
050,31,025,"Nebraska","Cass County",4,80,118,53,65
050,31,025,"Nebraska","Cass County",4,81,115,52,63
050,31,025,"Nebraska","Cass County",4,82,111,56,55
050,31,025,"Nebraska","Cass County",4,83,78,30,48
050,31,025,"Nebraska","Cass County",4,84,73,30,43
050,31,025,"Nebraska","Cass County",4,85,494,182,312
050,31,025,"Nebraska","Cass County",5,0,260,142,118
050,31,025,"Nebraska","Cass County",5,1,292,154,138
050,31,025,"Nebraska","Cass County",5,2,262,147,115
050,31,025,"Nebraska","Cass County",5,3,301,162,139
050,31,025,"Nebraska","Cass County",5,4,321,167,154
050,31,025,"Nebraska","Cass County",5,5,300,151,149
050,31,025,"Nebraska","Cass County",5,6,331,170,161
050,31,025,"Nebraska","Cass County",5,7,340,184,156
050,31,025,"Nebraska","Cass County",5,8,385,194,191
050,31,025,"Nebraska","Cass County",5,9,385,195,190
050,31,025,"Nebraska","Cass County",5,10,370,207,163
050,31,025,"Nebraska","Cass County",5,11,366,195,171
050,31,025,"Nebraska","Cass County",5,12,360,189,171
050,31,025,"Nebraska","Cass County",5,13,386,214,172
050,31,025,"Nebraska","Cass County",5,14,390,198,192
050,31,025,"Nebraska","Cass County",5,15,417,218,199
050,31,025,"Nebraska","Cass County",5,16,398,207,191
050,31,025,"Nebraska","Cass County",5,17,367,189,178
050,31,025,"Nebraska","Cass County",5,18,347,190,157
050,31,025,"Nebraska","Cass County",5,19,254,140,114
050,31,025,"Nebraska","Cass County",5,20,270,150,120
050,31,025,"Nebraska","Cass County",5,21,274,150,124
050,31,025,"Nebraska","Cass County",5,22,289,164,125
050,31,025,"Nebraska","Cass County",5,23,310,168,142
050,31,025,"Nebraska","Cass County",5,24,269,136,133
050,31,025,"Nebraska","Cass County",5,25,287,149,138
050,31,025,"Nebraska","Cass County",5,26,283,141,142
050,31,025,"Nebraska","Cass County",5,27,276,144,132
050,31,025,"Nebraska","Cass County",5,28,286,146,140
050,31,025,"Nebraska","Cass County",5,29,286,135,151
050,31,025,"Nebraska","Cass County",5,30,292,142,150
050,31,025,"Nebraska","Cass County",5,31,305,149,156
050,31,025,"Nebraska","Cass County",5,32,291,148,143
050,31,025,"Nebraska","Cass County",5,33,307,157,150
050,31,025,"Nebraska","Cass County",5,34,281,153,128
050,31,025,"Nebraska","Cass County",5,35,327,176,151
050,31,025,"Nebraska","Cass County",5,36,347,169,178
050,31,025,"Nebraska","Cass County",5,37,351,184,167
050,31,025,"Nebraska","Cass County",5,38,383,206,177
050,31,025,"Nebraska","Cass County",5,39,369,189,180
050,31,025,"Nebraska","Cass County",5,40,358,173,185
050,31,025,"Nebraska","Cass County",5,41,381,199,182
050,31,025,"Nebraska","Cass County",5,42,373,195,178
050,31,025,"Nebraska","Cass County",5,43,374,186,188
050,31,025,"Nebraska","Cass County",5,44,339,171,168
050,31,025,"Nebraska","Cass County",5,45,310,151,159
050,31,025,"Nebraska","Cass County",5,46,321,158,163
050,31,025,"Nebraska","Cass County",5,47,322,171,151
050,31,025,"Nebraska","Cass County",5,48,366,188,178
050,31,025,"Nebraska","Cass County",5,49,362,183,179
050,31,025,"Nebraska","Cass County",5,50,315,151,164
050,31,025,"Nebraska","Cass County",5,51,337,171,166
050,31,025,"Nebraska","Cass County",5,52,355,176,179
050,31,025,"Nebraska","Cass County",5,53,378,183,195
050,31,025,"Nebraska","Cass County",5,54,365,180,185
050,31,025,"Nebraska","Cass County",5,55,374,174,200
050,31,025,"Nebraska","Cass County",5,56,361,181,180
050,31,025,"Nebraska","Cass County",5,57,363,183,180
050,31,025,"Nebraska","Cass County",5,58,402,206,196
050,31,025,"Nebraska","Cass County",5,59,428,220,208
050,31,025,"Nebraska","Cass County",5,60,427,218,209
050,31,025,"Nebraska","Cass County",5,61,435,229,206
050,31,025,"Nebraska","Cass County",5,62,418,220,198
050,31,025,"Nebraska","Cass County",5,63,414,221,193
050,31,025,"Nebraska","Cass County",5,64,394,197,197
050,31,025,"Nebraska","Cass County",5,65,374,203,171
050,31,025,"Nebraska","Cass County",5,66,361,185,176
050,31,025,"Nebraska","Cass County",5,67,341,167,174
050,31,025,"Nebraska","Cass County",5,68,348,170,178
050,31,025,"Nebraska","Cass County",5,69,342,169,173
050,31,025,"Nebraska","Cass County",5,70,348,173,175
050,31,025,"Nebraska","Cass County",5,71,319,158,161
050,31,025,"Nebraska","Cass County",5,72,288,148,140
050,31,025,"Nebraska","Cass County",5,73,281,140,141
050,31,025,"Nebraska","Cass County",5,74,267,129,138
050,31,025,"Nebraska","Cass County",5,75,237,117,120
050,31,025,"Nebraska","Cass County",5,76,232,123,109
050,31,025,"Nebraska","Cass County",5,77,168,89,79
050,31,025,"Nebraska","Cass County",5,78,170,84,86
050,31,025,"Nebraska","Cass County",5,79,161,82,79
050,31,025,"Nebraska","Cass County",5,80,136,58,78
050,31,025,"Nebraska","Cass County",5,81,117,50,67
050,31,025,"Nebraska","Cass County",5,82,111,50,61
050,31,025,"Nebraska","Cass County",5,83,97,46,51
050,31,025,"Nebraska","Cass County",5,84,74,29,45
050,31,025,"Nebraska","Cass County",5,85,487,182,305
050,31,027,"Nebraska","Cedar County",1,0,111,56,55
050,31,027,"Nebraska","Cedar County",1,1,117,56,61
050,31,027,"Nebraska","Cedar County",1,2,104,54,50
050,31,027,"Nebraska","Cedar County",1,3,108,62,46
050,31,027,"Nebraska","Cedar County",1,4,111,58,53
050,31,027,"Nebraska","Cedar County",1,5,119,62,57
050,31,027,"Nebraska","Cedar County",1,6,116,66,50
050,31,027,"Nebraska","Cedar County",1,7,121,68,53
050,31,027,"Nebraska","Cedar County",1,8,123,72,51
050,31,027,"Nebraska","Cedar County",1,9,113,61,52
050,31,027,"Nebraska","Cedar County",1,10,130,78,52
050,31,027,"Nebraska","Cedar County",1,11,135,70,65
050,31,027,"Nebraska","Cedar County",1,12,135,71,64
050,31,027,"Nebraska","Cedar County",1,13,121,65,56
050,31,027,"Nebraska","Cedar County",1,14,134,65,69
050,31,027,"Nebraska","Cedar County",1,15,125,68,57
050,31,027,"Nebraska","Cedar County",1,16,123,67,56
050,31,027,"Nebraska","Cedar County",1,17,124,63,61
050,31,027,"Nebraska","Cedar County",1,18,102,58,44
050,31,027,"Nebraska","Cedar County",1,19,79,37,42
050,31,027,"Nebraska","Cedar County",1,20,83,41,42
050,31,027,"Nebraska","Cedar County",1,21,87,48,39
050,31,027,"Nebraska","Cedar County",1,22,92,50,42
050,31,027,"Nebraska","Cedar County",1,23,84,42,42
050,31,027,"Nebraska","Cedar County",1,24,81,48,33
050,31,027,"Nebraska","Cedar County",1,25,73,43,30
050,31,027,"Nebraska","Cedar County",1,26,71,36,35
050,31,027,"Nebraska","Cedar County",1,27,83,41,42
050,31,027,"Nebraska","Cedar County",1,28,73,40,33
050,31,027,"Nebraska","Cedar County",1,29,68,33,35
050,31,027,"Nebraska","Cedar County",1,30,67,35,32
050,31,027,"Nebraska","Cedar County",1,31,75,39,36
050,31,027,"Nebraska","Cedar County",1,32,80,38,42
050,31,027,"Nebraska","Cedar County",1,33,92,45,47
050,31,027,"Nebraska","Cedar County",1,34,87,48,39
050,31,027,"Nebraska","Cedar County",1,35,89,46,43
050,31,027,"Nebraska","Cedar County",1,36,87,43,44
050,31,027,"Nebraska","Cedar County",1,37,83,46,37
050,31,027,"Nebraska","Cedar County",1,38,85,47,38
050,31,027,"Nebraska","Cedar County",1,39,86,44,42
050,31,027,"Nebraska","Cedar County",1,40,84,50,34
050,31,027,"Nebraska","Cedar County",1,41,93,48,45
050,31,027,"Nebraska","Cedar County",1,42,85,47,38
050,31,027,"Nebraska","Cedar County",1,43,87,38,49
050,31,027,"Nebraska","Cedar County",1,44,85,40,45
050,31,027,"Nebraska","Cedar County",1,45,74,40,34
050,31,027,"Nebraska","Cedar County",1,46,75,39,36
050,31,027,"Nebraska","Cedar County",1,47,84,46,38
050,31,027,"Nebraska","Cedar County",1,48,92,42,50
050,31,027,"Nebraska","Cedar County",1,49,90,41,49
050,31,027,"Nebraska","Cedar County",1,50,93,43,50
050,31,027,"Nebraska","Cedar County",1,51,85,38,47
050,31,027,"Nebraska","Cedar County",1,52,76,41,35
050,31,027,"Nebraska","Cedar County",1,53,98,55,43
050,31,027,"Nebraska","Cedar County",1,54,110,57,53
050,31,027,"Nebraska","Cedar County",1,55,111,50,61
050,31,027,"Nebraska","Cedar County",1,56,109,56,53
050,31,027,"Nebraska","Cedar County",1,57,116,63,53
050,31,027,"Nebraska","Cedar County",1,58,140,69,71
050,31,027,"Nebraska","Cedar County",1,59,136,69,67
050,31,027,"Nebraska","Cedar County",1,60,138,75,63
050,31,027,"Nebraska","Cedar County",1,61,133,72,61
050,31,027,"Nebraska","Cedar County",1,62,140,73,67
050,31,027,"Nebraska","Cedar County",1,63,139,66,73
050,31,027,"Nebraska","Cedar County",1,64,141,75,66
050,31,027,"Nebraska","Cedar County",1,65,130,69,61
050,31,027,"Nebraska","Cedar County",1,66,111,59,52
050,31,027,"Nebraska","Cedar County",1,67,102,50,52
050,31,027,"Nebraska","Cedar County",1,68,102,55,47
050,31,027,"Nebraska","Cedar County",1,69,93,54,39
050,31,027,"Nebraska","Cedar County",1,70,101,55,46
050,31,027,"Nebraska","Cedar County",1,71,94,51,43
050,31,027,"Nebraska","Cedar County",1,72,84,47,37
050,31,027,"Nebraska","Cedar County",1,73,74,37,37
050,31,027,"Nebraska","Cedar County",1,74,56,27,29
050,31,027,"Nebraska","Cedar County",1,75,71,37,34
050,31,027,"Nebraska","Cedar County",1,76,72,36,36
050,31,027,"Nebraska","Cedar County",1,77,61,29,32
050,31,027,"Nebraska","Cedar County",1,78,50,21,29
050,31,027,"Nebraska","Cedar County",1,79,54,23,31
050,31,027,"Nebraska","Cedar County",1,80,48,22,26
050,31,027,"Nebraska","Cedar County",1,81,56,27,29
050,31,027,"Nebraska","Cedar County",1,82,48,18,30
050,31,027,"Nebraska","Cedar County",1,83,46,18,28
050,31,027,"Nebraska","Cedar County",1,84,38,13,25
050,31,027,"Nebraska","Cedar County",1,85,298,108,190
050,31,027,"Nebraska","Cedar County",2,0,111,57,54
050,31,027,"Nebraska","Cedar County",2,1,116,56,60
050,31,027,"Nebraska","Cedar County",2,2,107,55,52
050,31,027,"Nebraska","Cedar County",2,3,106,59,47
050,31,027,"Nebraska","Cedar County",2,4,111,59,52
050,31,027,"Nebraska","Cedar County",2,5,117,61,56
050,31,027,"Nebraska","Cedar County",2,6,119,66,53
050,31,027,"Nebraska","Cedar County",2,7,120,68,52
050,31,027,"Nebraska","Cedar County",2,8,124,71,53
050,31,027,"Nebraska","Cedar County",2,9,117,65,52
050,31,027,"Nebraska","Cedar County",2,10,126,73,53
050,31,027,"Nebraska","Cedar County",2,11,131,71,60
050,31,027,"Nebraska","Cedar County",2,12,135,71,64
050,31,027,"Nebraska","Cedar County",2,13,125,66,59
050,31,027,"Nebraska","Cedar County",2,14,131,65,66
050,31,027,"Nebraska","Cedar County",2,15,126,67,59
050,31,027,"Nebraska","Cedar County",2,16,123,67,56
050,31,027,"Nebraska","Cedar County",2,17,123,64,59
050,31,027,"Nebraska","Cedar County",2,18,101,56,45
050,31,027,"Nebraska","Cedar County",2,19,81,40,41
050,31,027,"Nebraska","Cedar County",2,20,84,42,42
050,31,027,"Nebraska","Cedar County",2,21,87,47,40
050,31,027,"Nebraska","Cedar County",2,22,91,49,42
050,31,027,"Nebraska","Cedar County",2,23,85,44,41
050,31,027,"Nebraska","Cedar County",2,24,81,47,34
050,31,027,"Nebraska","Cedar County",2,25,74,44,30
050,31,027,"Nebraska","Cedar County",2,26,71,37,34
050,31,027,"Nebraska","Cedar County",2,27,81,41,40
050,31,027,"Nebraska","Cedar County",2,28,76,41,35
050,31,027,"Nebraska","Cedar County",2,29,69,34,35
050,31,027,"Nebraska","Cedar County",2,30,71,36,35
050,31,027,"Nebraska","Cedar County",2,31,73,38,35
050,31,027,"Nebraska","Cedar County",2,32,80,39,41
050,31,027,"Nebraska","Cedar County",2,33,87,42,45
050,31,027,"Nebraska","Cedar County",2,34,87,47,40
050,31,027,"Nebraska","Cedar County",2,35,90,47,43
050,31,027,"Nebraska","Cedar County",2,36,87,43,44
050,31,027,"Nebraska","Cedar County",2,37,83,45,38
050,31,027,"Nebraska","Cedar County",2,38,85,47,38
050,31,027,"Nebraska","Cedar County",2,39,85,44,41
050,31,027,"Nebraska","Cedar County",2,40,86,50,36
050,31,027,"Nebraska","Cedar County",2,41,90,48,42
050,31,027,"Nebraska","Cedar County",2,42,87,47,40
050,31,027,"Nebraska","Cedar County",2,43,86,40,46
050,31,027,"Nebraska","Cedar County",2,44,85,40,45
050,31,027,"Nebraska","Cedar County",2,45,76,40,36
050,31,027,"Nebraska","Cedar County",2,46,76,40,36
050,31,027,"Nebraska","Cedar County",2,47,83,44,39
050,31,027,"Nebraska","Cedar County",2,48,89,43,46
050,31,027,"Nebraska","Cedar County",2,49,92,42,50
050,31,027,"Nebraska","Cedar County",2,50,93,43,50
050,31,027,"Nebraska","Cedar County",2,51,86,38,48
050,31,027,"Nebraska","Cedar County",2,52,78,40,38
050,31,027,"Nebraska","Cedar County",2,53,93,52,41
050,31,027,"Nebraska","Cedar County",2,54,105,55,50
050,31,027,"Nebraska","Cedar County",2,55,111,52,59
050,31,027,"Nebraska","Cedar County",2,56,110,55,55
050,31,027,"Nebraska","Cedar County",2,57,115,62,53
050,31,027,"Nebraska","Cedar County",2,58,133,67,66
050,31,027,"Nebraska","Cedar County",2,59,137,69,68
050,31,027,"Nebraska","Cedar County",2,60,138,73,65
050,31,027,"Nebraska","Cedar County",2,61,133,72,61
050,31,027,"Nebraska","Cedar County",2,62,137,73,64
050,31,027,"Nebraska","Cedar County",2,63,141,68,73
050,31,027,"Nebraska","Cedar County",2,64,139,72,67
050,31,027,"Nebraska","Cedar County",2,65,133,71,62
050,31,027,"Nebraska","Cedar County",2,66,117,62,55
050,31,027,"Nebraska","Cedar County",2,67,104,52,52
050,31,027,"Nebraska","Cedar County",2,68,102,54,48
050,31,027,"Nebraska","Cedar County",2,69,97,55,42
050,31,027,"Nebraska","Cedar County",2,70,99,55,44
050,31,027,"Nebraska","Cedar County",2,71,94,50,44
050,31,027,"Nebraska","Cedar County",2,72,84,46,38
050,31,027,"Nebraska","Cedar County",2,73,79,41,38
050,31,027,"Nebraska","Cedar County",2,74,56,27,29
050,31,027,"Nebraska","Cedar County",2,75,65,34,31
050,31,027,"Nebraska","Cedar County",2,76,72,36,36
050,31,027,"Nebraska","Cedar County",2,77,63,30,33
050,31,027,"Nebraska","Cedar County",2,78,51,22,29
050,31,027,"Nebraska","Cedar County",2,79,54,23,31
050,31,027,"Nebraska","Cedar County",2,80,48,21,27
050,31,027,"Nebraska","Cedar County",2,81,53,25,28
050,31,027,"Nebraska","Cedar County",2,82,48,19,29
050,31,027,"Nebraska","Cedar County",2,83,46,18,28
050,31,027,"Nebraska","Cedar County",2,84,38,14,24
050,31,027,"Nebraska","Cedar County",2,85,296,109,187
050,31,027,"Nebraska","Cedar County",3,0,108,57,51
050,31,027,"Nebraska","Cedar County",3,1,113,57,56
050,31,027,"Nebraska","Cedar County",3,2,107,51,56
050,31,027,"Nebraska","Cedar County",3,3,108,57,51
050,31,027,"Nebraska","Cedar County",3,4,108,59,49
050,31,027,"Nebraska","Cedar County",3,5,111,58,53
050,31,027,"Nebraska","Cedar County",3,6,112,60,52
050,31,027,"Nebraska","Cedar County",3,7,119,65,54
050,31,027,"Nebraska","Cedar County",3,8,121,70,51
050,31,027,"Nebraska","Cedar County",3,9,124,72,52
050,31,027,"Nebraska","Cedar County",3,10,118,67,51
050,31,027,"Nebraska","Cedar County",3,11,119,71,48
050,31,027,"Nebraska","Cedar County",3,12,135,76,59
050,31,027,"Nebraska","Cedar County",3,13,141,75,66
050,31,027,"Nebraska","Cedar County",3,14,124,66,58
050,31,027,"Nebraska","Cedar County",3,15,131,66,65
050,31,027,"Nebraska","Cedar County",3,16,129,68,61
050,31,027,"Nebraska","Cedar County",3,17,122,67,55
050,31,027,"Nebraska","Cedar County",3,18,104,58,46
050,31,027,"Nebraska","Cedar County",3,19,79,42,37
050,31,027,"Nebraska","Cedar County",3,20,83,42,41
050,31,027,"Nebraska","Cedar County",3,21,84,40,44
050,31,027,"Nebraska","Cedar County",3,22,87,48,39
050,31,027,"Nebraska","Cedar County",3,23,90,51,39
050,31,027,"Nebraska","Cedar County",3,24,80,42,38
050,31,027,"Nebraska","Cedar County",3,25,82,46,36
050,31,027,"Nebraska","Cedar County",3,26,71,44,27
050,31,027,"Nebraska","Cedar County",3,27,72,35,37
050,31,027,"Nebraska","Cedar County",3,28,80,44,36
050,31,027,"Nebraska","Cedar County",3,29,72,40,32
050,31,027,"Nebraska","Cedar County",3,30,70,34,36
050,31,027,"Nebraska","Cedar County",3,31,66,29,37
050,31,027,"Nebraska","Cedar County",3,32,78,42,36
050,31,027,"Nebraska","Cedar County",3,33,78,37,41
050,31,027,"Nebraska","Cedar County",3,34,83,40,43
050,31,027,"Nebraska","Cedar County",3,35,88,45,43
050,31,027,"Nebraska","Cedar County",3,36,93,49,44
050,31,027,"Nebraska","Cedar County",3,37,93,46,47
050,31,027,"Nebraska","Cedar County",3,38,84,46,38
050,31,027,"Nebraska","Cedar County",3,39,83,44,39
050,31,027,"Nebraska","Cedar County",3,40,89,48,41
050,31,027,"Nebraska","Cedar County",3,41,92,52,40
050,31,027,"Nebraska","Cedar County",3,42,90,48,42
050,31,027,"Nebraska","Cedar County",3,43,83,44,39
050,31,027,"Nebraska","Cedar County",3,44,87,41,46
050,31,027,"Nebraska","Cedar County",3,45,88,44,44
050,31,027,"Nebraska","Cedar County",3,46,71,35,36
050,31,027,"Nebraska","Cedar County",3,47,75,40,35
050,31,027,"Nebraska","Cedar County",3,48,82,45,37
050,31,027,"Nebraska","Cedar County",3,49,90,45,45
050,31,027,"Nebraska","Cedar County",3,50,91,43,48
050,31,027,"Nebraska","Cedar County",3,51,95,44,51
050,31,027,"Nebraska","Cedar County",3,52,85,36,49
050,31,027,"Nebraska","Cedar County",3,53,75,39,36
050,31,027,"Nebraska","Cedar County",3,54,99,57,42
050,31,027,"Nebraska","Cedar County",3,55,100,54,46
050,31,027,"Nebraska","Cedar County",3,56,112,53,59
050,31,027,"Nebraska","Cedar County",3,57,113,54,59
050,31,027,"Nebraska","Cedar County",3,58,115,62,53
050,31,027,"Nebraska","Cedar County",3,59,132,66,66
050,31,027,"Nebraska","Cedar County",3,60,138,70,68
050,31,027,"Nebraska","Cedar County",3,61,138,71,67
050,31,027,"Nebraska","Cedar County",3,62,133,73,60
050,31,027,"Nebraska","Cedar County",3,63,133,70,63
050,31,027,"Nebraska","Cedar County",3,64,142,68,74
050,31,027,"Nebraska","Cedar County",3,65,133,69,64
050,31,027,"Nebraska","Cedar County",3,66,134,71,63
050,31,027,"Nebraska","Cedar County",3,67,115,60,55
050,31,027,"Nebraska","Cedar County",3,68,106,52,54
050,31,027,"Nebraska","Cedar County",3,69,99,50,49
050,31,027,"Nebraska","Cedar County",3,70,99,57,42
050,31,027,"Nebraska","Cedar County",3,71,100,53,47
050,31,027,"Nebraska","Cedar County",3,72,93,49,44
050,31,027,"Nebraska","Cedar County",3,73,80,45,35
050,31,027,"Nebraska","Cedar County",3,74,76,39,37
050,31,027,"Nebraska","Cedar County",3,75,52,26,26
050,31,027,"Nebraska","Cedar County",3,76,67,33,34
050,31,027,"Nebraska","Cedar County",3,77,69,35,34
050,31,027,"Nebraska","Cedar County",3,78,63,29,34
050,31,027,"Nebraska","Cedar County",3,79,47,19,28
050,31,027,"Nebraska","Cedar County",3,80,53,22,31
050,31,027,"Nebraska","Cedar County",3,81,46,20,26
050,31,027,"Nebraska","Cedar County",3,82,44,19,25
050,31,027,"Nebraska","Cedar County",3,83,43,15,28
050,31,027,"Nebraska","Cedar County",3,84,40,14,26
050,31,027,"Nebraska","Cedar County",3,85,275,98,177
050,31,027,"Nebraska","Cedar County",4,0,98,53,45
050,31,027,"Nebraska","Cedar County",4,1,117,58,59
050,31,027,"Nebraska","Cedar County",4,2,121,59,62
050,31,027,"Nebraska","Cedar County",4,3,115,56,59
050,31,027,"Nebraska","Cedar County",4,4,110,51,59
050,31,027,"Nebraska","Cedar County",4,5,114,64,50
050,31,027,"Nebraska","Cedar County",4,6,110,57,53
050,31,027,"Nebraska","Cedar County",4,7,115,62,53
050,31,027,"Nebraska","Cedar County",4,8,125,68,57
050,31,027,"Nebraska","Cedar County",4,9,121,71,50
050,31,027,"Nebraska","Cedar County",4,10,126,72,54
050,31,027,"Nebraska","Cedar County",4,11,113,62,51
050,31,027,"Nebraska","Cedar County",4,12,118,70,48
050,31,027,"Nebraska","Cedar County",4,13,133,73,60
050,31,027,"Nebraska","Cedar County",4,14,145,79,66
050,31,027,"Nebraska","Cedar County",4,15,129,65,64
050,31,027,"Nebraska","Cedar County",4,16,127,61,66
050,31,027,"Nebraska","Cedar County",4,17,131,70,61
050,31,027,"Nebraska","Cedar County",4,18,103,60,43
050,31,027,"Nebraska","Cedar County",4,19,72,40,32
050,31,027,"Nebraska","Cedar County",4,20,80,44,36
050,31,027,"Nebraska","Cedar County",4,21,85,41,44
050,31,027,"Nebraska","Cedar County",4,22,90,43,47
050,31,027,"Nebraska","Cedar County",4,23,83,47,36
050,31,027,"Nebraska","Cedar County",4,24,90,48,42
050,31,027,"Nebraska","Cedar County",4,25,79,39,40
050,31,027,"Nebraska","Cedar County",4,26,81,47,34
050,31,027,"Nebraska","Cedar County",4,27,80,51,29
050,31,027,"Nebraska","Cedar County",4,28,75,39,36
050,31,027,"Nebraska","Cedar County",4,29,83,43,40
050,31,027,"Nebraska","Cedar County",4,30,70,37,33
050,31,027,"Nebraska","Cedar County",4,31,75,39,36
050,31,027,"Nebraska","Cedar County",4,32,65,28,37
050,31,027,"Nebraska","Cedar County",4,33,76,41,35
050,31,027,"Nebraska","Cedar County",4,34,79,38,41
050,31,027,"Nebraska","Cedar County",4,35,83,41,42
050,31,027,"Nebraska","Cedar County",4,36,85,47,38
050,31,027,"Nebraska","Cedar County",4,37,93,47,46
050,31,027,"Nebraska","Cedar County",4,38,95,45,50
050,31,027,"Nebraska","Cedar County",4,39,81,43,38
050,31,027,"Nebraska","Cedar County",4,40,87,45,42
050,31,027,"Nebraska","Cedar County",4,41,89,50,39
050,31,027,"Nebraska","Cedar County",4,42,91,53,38
050,31,027,"Nebraska","Cedar County",4,43,92,51,41
050,31,027,"Nebraska","Cedar County",4,44,84,44,40
050,31,027,"Nebraska","Cedar County",4,45,87,41,46
050,31,027,"Nebraska","Cedar County",4,46,92,46,46
050,31,027,"Nebraska","Cedar County",4,47,76,39,37
050,31,027,"Nebraska","Cedar County",4,48,79,44,35
050,31,027,"Nebraska","Cedar County",4,49,83,47,36
050,31,027,"Nebraska","Cedar County",4,50,85,40,45
050,31,027,"Nebraska","Cedar County",4,51,90,42,48
050,31,027,"Nebraska","Cedar County",4,52,93,44,49
050,31,027,"Nebraska","Cedar County",4,53,87,39,48
050,31,027,"Nebraska","Cedar County",4,54,72,38,34
050,31,027,"Nebraska","Cedar County",4,55,105,59,46
050,31,027,"Nebraska","Cedar County",4,56,100,54,46
050,31,027,"Nebraska","Cedar County",4,57,112,52,60
050,31,027,"Nebraska","Cedar County",4,58,114,55,59
050,31,027,"Nebraska","Cedar County",4,59,117,64,53
050,31,027,"Nebraska","Cedar County",4,60,129,62,67
050,31,027,"Nebraska","Cedar County",4,61,139,73,66
050,31,027,"Nebraska","Cedar County",4,62,139,71,68
050,31,027,"Nebraska","Cedar County",4,63,132,72,60
050,31,027,"Nebraska","Cedar County",4,64,129,67,62
050,31,027,"Nebraska","Cedar County",4,65,139,65,74
050,31,027,"Nebraska","Cedar County",4,66,130,68,62
050,31,027,"Nebraska","Cedar County",4,67,132,71,61
050,31,027,"Nebraska","Cedar County",4,68,116,60,56
050,31,027,"Nebraska","Cedar County",4,69,104,50,54
050,31,027,"Nebraska","Cedar County",4,70,98,49,49
050,31,027,"Nebraska","Cedar County",4,71,98,56,42
050,31,027,"Nebraska","Cedar County",4,72,97,52,45
050,31,027,"Nebraska","Cedar County",4,73,89,46,43
050,31,027,"Nebraska","Cedar County",4,74,83,46,37
050,31,027,"Nebraska","Cedar County",4,75,72,39,33
050,31,027,"Nebraska","Cedar County",4,76,55,26,29
050,31,027,"Nebraska","Cedar County",4,77,65,31,34
050,31,027,"Nebraska","Cedar County",4,78,71,37,34
050,31,027,"Nebraska","Cedar County",4,79,60,27,33
050,31,027,"Nebraska","Cedar County",4,80,48,20,28
050,31,027,"Nebraska","Cedar County",4,81,56,25,31
050,31,027,"Nebraska","Cedar County",4,82,36,15,21
050,31,027,"Nebraska","Cedar County",4,83,42,16,26
050,31,027,"Nebraska","Cedar County",4,84,32,12,20
050,31,027,"Nebraska","Cedar County",4,85,269,95,174
050,31,027,"Nebraska","Cedar County",5,0,82,44,38
050,31,027,"Nebraska","Cedar County",5,1,107,60,47
050,31,027,"Nebraska","Cedar County",5,2,111,55,56
050,31,027,"Nebraska","Cedar County",5,3,121,63,58
050,31,027,"Nebraska","Cedar County",5,4,108,54,54
050,31,027,"Nebraska","Cedar County",5,5,106,50,56
050,31,027,"Nebraska","Cedar County",5,6,103,57,46
050,31,027,"Nebraska","Cedar County",5,7,107,55,52
050,31,027,"Nebraska","Cedar County",5,8,116,61,55
050,31,027,"Nebraska","Cedar County",5,9,128,67,61
050,31,027,"Nebraska","Cedar County",5,10,115,66,49
050,31,027,"Nebraska","Cedar County",5,11,122,70,52
050,31,027,"Nebraska","Cedar County",5,12,107,57,50
050,31,027,"Nebraska","Cedar County",5,13,119,72,47
050,31,027,"Nebraska","Cedar County",5,14,126,67,59
050,31,027,"Nebraska","Cedar County",5,15,148,81,67
050,31,027,"Nebraska","Cedar County",5,16,127,66,61
050,31,027,"Nebraska","Cedar County",5,17,129,63,66
050,31,027,"Nebraska","Cedar County",5,18,110,64,46
050,31,027,"Nebraska","Cedar County",5,19,80,47,33
050,31,027,"Nebraska","Cedar County",5,20,80,44,36
050,31,027,"Nebraska","Cedar County",5,21,82,44,38
050,31,027,"Nebraska","Cedar County",5,22,85,39,46
050,31,027,"Nebraska","Cedar County",5,23,87,37,50
050,31,027,"Nebraska","Cedar County",5,24,84,49,35
050,31,027,"Nebraska","Cedar County",5,25,86,48,38
050,31,027,"Nebraska","Cedar County",5,26,76,39,37
050,31,027,"Nebraska","Cedar County",5,27,82,49,33
050,31,027,"Nebraska","Cedar County",5,28,78,49,29
050,31,027,"Nebraska","Cedar County",5,29,74,36,38
050,31,027,"Nebraska","Cedar County",5,30,83,43,40
050,31,027,"Nebraska","Cedar County",5,31,78,43,35
050,31,027,"Nebraska","Cedar County",5,32,72,37,35
050,31,027,"Nebraska","Cedar County",5,33,67,31,36
050,31,027,"Nebraska","Cedar County",5,34,74,40,34
050,31,027,"Nebraska","Cedar County",5,35,80,41,39
050,31,027,"Nebraska","Cedar County",5,36,82,41,41
050,31,027,"Nebraska","Cedar County",5,37,86,47,39
050,31,027,"Nebraska","Cedar County",5,38,92,46,46
050,31,027,"Nebraska","Cedar County",5,39,95,44,51
050,31,027,"Nebraska","Cedar County",5,40,82,44,38
050,31,027,"Nebraska","Cedar County",5,41,86,45,41
050,31,027,"Nebraska","Cedar County",5,42,89,49,40
050,31,027,"Nebraska","Cedar County",5,43,91,51,40
050,31,027,"Nebraska","Cedar County",5,44,93,52,41
050,31,027,"Nebraska","Cedar County",5,45,81,44,37
050,31,027,"Nebraska","Cedar County",5,46,90,44,46
050,31,027,"Nebraska","Cedar County",5,47,98,48,50
050,31,027,"Nebraska","Cedar County",5,48,78,39,39
050,31,027,"Nebraska","Cedar County",5,49,77,42,35
050,31,027,"Nebraska","Cedar County",5,50,81,43,38
050,31,027,"Nebraska","Cedar County",5,51,86,41,45
050,31,027,"Nebraska","Cedar County",5,52,93,43,50
050,31,027,"Nebraska","Cedar County",5,53,94,45,49
050,31,027,"Nebraska","Cedar County",5,54,87,39,48
050,31,027,"Nebraska","Cedar County",5,55,67,36,31
050,31,027,"Nebraska","Cedar County",5,56,104,59,45
050,31,027,"Nebraska","Cedar County",5,57,102,56,46
050,31,027,"Nebraska","Cedar County",5,58,113,53,60
050,31,027,"Nebraska","Cedar County",5,59,111,55,56
050,31,027,"Nebraska","Cedar County",5,60,107,58,49
050,31,027,"Nebraska","Cedar County",5,61,130,63,67
050,31,027,"Nebraska","Cedar County",5,62,139,72,67
050,31,027,"Nebraska","Cedar County",5,63,138,70,68
050,31,027,"Nebraska","Cedar County",5,64,131,71,60
050,31,027,"Nebraska","Cedar County",5,65,125,65,60
050,31,027,"Nebraska","Cedar County",5,66,143,64,79
050,31,027,"Nebraska","Cedar County",5,67,132,67,65
050,31,027,"Nebraska","Cedar County",5,68,133,72,61
050,31,027,"Nebraska","Cedar County",5,69,112,56,56
050,31,027,"Nebraska","Cedar County",5,70,103,52,51
050,31,027,"Nebraska","Cedar County",5,71,94,48,46
050,31,027,"Nebraska","Cedar County",5,72,92,55,37
050,31,027,"Nebraska","Cedar County",5,73,94,51,43
050,31,027,"Nebraska","Cedar County",5,74,88,46,42
050,31,027,"Nebraska","Cedar County",5,75,79,43,36
050,31,027,"Nebraska","Cedar County",5,76,77,40,37
050,31,027,"Nebraska","Cedar County",5,77,49,24,25
050,31,027,"Nebraska","Cedar County",5,78,64,32,32
050,31,027,"Nebraska","Cedar County",5,79,68,33,35
050,31,027,"Nebraska","Cedar County",5,80,58,27,31
050,31,027,"Nebraska","Cedar County",5,81,47,22,25
050,31,027,"Nebraska","Cedar County",5,82,44,18,26
050,31,027,"Nebraska","Cedar County",5,83,31,13,18
050,31,027,"Nebraska","Cedar County",5,84,33,12,21
050,31,027,"Nebraska","Cedar County",5,85,253,93,160
050,31,029,"Nebraska","Chase County",1,0,48,25,23
050,31,029,"Nebraska","Chase County",1,1,47,28,19
050,31,029,"Nebraska","Chase County",1,2,52,25,27
050,31,029,"Nebraska","Chase County",1,3,51,25,26
050,31,029,"Nebraska","Chase County",1,4,43,20,23
050,31,029,"Nebraska","Chase County",1,5,46,23,23
050,31,029,"Nebraska","Chase County",1,6,38,22,16
050,31,029,"Nebraska","Chase County",1,7,41,21,20
050,31,029,"Nebraska","Chase County",1,8,53,27,26
050,31,029,"Nebraska","Chase County",1,9,66,36,30
050,31,029,"Nebraska","Chase County",1,10,66,40,26
050,31,029,"Nebraska","Chase County",1,11,65,32,33
050,31,029,"Nebraska","Chase County",1,12,61,32,29
050,31,029,"Nebraska","Chase County",1,13,71,36,35
050,31,029,"Nebraska","Chase County",1,14,60,29,31
050,31,029,"Nebraska","Chase County",1,15,56,24,32
050,31,029,"Nebraska","Chase County",1,16,51,17,34
050,31,029,"Nebraska","Chase County",1,17,50,24,26
050,31,029,"Nebraska","Chase County",1,18,50,22,28
050,31,029,"Nebraska","Chase County",1,19,40,21,19
050,31,029,"Nebraska","Chase County",1,20,40,20,20
050,31,029,"Nebraska","Chase County",1,21,35,17,18
050,31,029,"Nebraska","Chase County",1,22,34,17,17
050,31,029,"Nebraska","Chase County",1,23,40,18,22
050,31,029,"Nebraska","Chase County",1,24,35,17,18
050,31,029,"Nebraska","Chase County",1,25,40,16,24
050,31,029,"Nebraska","Chase County",1,26,36,17,19
050,31,029,"Nebraska","Chase County",1,27,43,20,23
050,31,029,"Nebraska","Chase County",1,28,44,23,21
050,31,029,"Nebraska","Chase County",1,29,32,14,18
050,31,029,"Nebraska","Chase County",1,30,41,23,18
050,31,029,"Nebraska","Chase County",1,31,32,20,12
050,31,029,"Nebraska","Chase County",1,32,32,17,15
050,31,029,"Nebraska","Chase County",1,33,40,19,21
050,31,029,"Nebraska","Chase County",1,34,42,29,13
050,31,029,"Nebraska","Chase County",1,35,48,30,18
050,31,029,"Nebraska","Chase County",1,36,51,22,29
050,31,029,"Nebraska","Chase County",1,37,45,20,25
050,31,029,"Nebraska","Chase County",1,38,45,25,20
050,31,029,"Nebraska","Chase County",1,39,47,29,18
050,31,029,"Nebraska","Chase County",1,40,35,19,16
050,31,029,"Nebraska","Chase County",1,41,50,25,25
050,31,029,"Nebraska","Chase County",1,42,47,23,24
050,31,029,"Nebraska","Chase County",1,43,48,19,29
050,31,029,"Nebraska","Chase County",1,44,39,17,22
050,31,029,"Nebraska","Chase County",1,45,48,25,23
050,31,029,"Nebraska","Chase County",1,46,34,20,14
050,31,029,"Nebraska","Chase County",1,47,37,20,17
050,31,029,"Nebraska","Chase County",1,48,47,29,18
050,31,029,"Nebraska","Chase County",1,49,47,23,24
050,31,029,"Nebraska","Chase County",1,50,37,16,21
050,31,029,"Nebraska","Chase County",1,51,42,20,22
050,31,029,"Nebraska","Chase County",1,52,54,33,21
050,31,029,"Nebraska","Chase County",1,53,41,26,15
050,31,029,"Nebraska","Chase County",1,54,38,21,17
050,31,029,"Nebraska","Chase County",1,55,40,19,21
050,31,029,"Nebraska","Chase County",1,56,50,24,26
050,31,029,"Nebraska","Chase County",1,57,52,24,28
050,31,029,"Nebraska","Chase County",1,58,52,25,27
050,31,029,"Nebraska","Chase County",1,59,61,34,27
050,31,029,"Nebraska","Chase County",1,60,55,30,25
050,31,029,"Nebraska","Chase County",1,61,56,28,28
050,31,029,"Nebraska","Chase County",1,62,64,29,35
050,31,029,"Nebraska","Chase County",1,63,71,31,40
050,31,029,"Nebraska","Chase County",1,64,57,24,33
050,31,029,"Nebraska","Chase County",1,65,58,30,28
050,31,029,"Nebraska","Chase County",1,66,55,28,27
050,31,029,"Nebraska","Chase County",1,67,48,26,22
050,31,029,"Nebraska","Chase County",1,68,49,24,25
050,31,029,"Nebraska","Chase County",1,69,39,22,17
050,31,029,"Nebraska","Chase County",1,70,32,16,16
050,31,029,"Nebraska","Chase County",1,71,40,22,18
050,31,029,"Nebraska","Chase County",1,72,39,21,18
050,31,029,"Nebraska","Chase County",1,73,28,13,15
050,31,029,"Nebraska","Chase County",1,74,22,10,12
050,31,029,"Nebraska","Chase County",1,75,36,20,16
050,31,029,"Nebraska","Chase County",1,76,31,14,17
050,31,029,"Nebraska","Chase County",1,77,38,16,22
050,31,029,"Nebraska","Chase County",1,78,28,15,13
050,31,029,"Nebraska","Chase County",1,79,24,12,12
050,31,029,"Nebraska","Chase County",1,80,22,12,10
050,31,029,"Nebraska","Chase County",1,81,32,13,19
050,31,029,"Nebraska","Chase County",1,82,21,8,13
050,31,029,"Nebraska","Chase County",1,83,15,7,8
050,31,029,"Nebraska","Chase County",1,84,16,5,11
050,31,029,"Nebraska","Chase County",1,85,163,50,113
050,31,029,"Nebraska","Chase County",2,0,55,28,27
050,31,029,"Nebraska","Chase County",2,1,46,27,19
050,31,029,"Nebraska","Chase County",2,2,51,26,25
050,31,029,"Nebraska","Chase County",2,3,51,25,26
050,31,029,"Nebraska","Chase County",2,4,45,21,24
050,31,029,"Nebraska","Chase County",2,5,47,23,24
050,31,029,"Nebraska","Chase County",2,6,39,22,17
050,31,029,"Nebraska","Chase County",2,7,41,21,20
050,31,029,"Nebraska","Chase County",2,8,48,25,23
050,31,029,"Nebraska","Chase County",2,9,63,34,29
050,31,029,"Nebraska","Chase County",2,10,67,40,27
050,31,029,"Nebraska","Chase County",2,11,64,34,30
050,31,029,"Nebraska","Chase County",2,12,62,32,30
050,31,029,"Nebraska","Chase County",2,13,69,35,34
050,31,029,"Nebraska","Chase County",2,14,62,30,32
050,31,029,"Nebraska","Chase County",2,15,58,25,33
050,31,029,"Nebraska","Chase County",2,16,51,18,33
050,31,029,"Nebraska","Chase County",2,17,50,22,28
050,31,029,"Nebraska","Chase County",2,18,47,21,26
050,31,029,"Nebraska","Chase County",2,19,40,20,20
050,31,029,"Nebraska","Chase County",2,20,41,21,20
050,31,029,"Nebraska","Chase County",2,21,35,17,18
050,31,029,"Nebraska","Chase County",2,22,35,17,18
050,31,029,"Nebraska","Chase County",2,23,37,17,20
050,31,029,"Nebraska","Chase County",2,24,35,16,19
050,31,029,"Nebraska","Chase County",2,25,38,16,22
050,31,029,"Nebraska","Chase County",2,26,36,16,20
050,31,029,"Nebraska","Chase County",2,27,42,20,22
050,31,029,"Nebraska","Chase County",2,28,41,20,21
050,31,029,"Nebraska","Chase County",2,29,34,16,18
050,31,029,"Nebraska","Chase County",2,30,40,22,18
050,31,029,"Nebraska","Chase County",2,31,34,20,14
050,31,029,"Nebraska","Chase County",2,32,31,17,14
050,31,029,"Nebraska","Chase County",2,33,39,19,20
050,31,029,"Nebraska","Chase County",2,34,43,28,15
050,31,029,"Nebraska","Chase County",2,35,47,30,17
050,31,029,"Nebraska","Chase County",2,36,50,24,26
050,31,029,"Nebraska","Chase County",2,37,46,20,26
050,31,029,"Nebraska","Chase County",2,38,46,25,21
050,31,029,"Nebraska","Chase County",2,39,46,28,18
050,31,029,"Nebraska","Chase County",2,40,39,22,17
050,31,029,"Nebraska","Chase County",2,41,46,24,22
050,31,029,"Nebraska","Chase County",2,42,47,23,24
050,31,029,"Nebraska","Chase County",2,43,48,20,28
050,31,029,"Nebraska","Chase County",2,44,40,17,23
050,31,029,"Nebraska","Chase County",2,45,46,24,22
050,31,029,"Nebraska","Chase County",2,46,37,21,16
050,31,029,"Nebraska","Chase County",2,47,35,19,16
050,31,029,"Nebraska","Chase County",2,48,45,27,18
050,31,029,"Nebraska","Chase County",2,49,46,24,22
050,31,029,"Nebraska","Chase County",2,50,40,18,22
050,31,029,"Nebraska","Chase County",2,51,41,20,21
050,31,029,"Nebraska","Chase County",2,52,51,30,21
050,31,029,"Nebraska","Chase County",2,53,43,27,16
050,31,029,"Nebraska","Chase County",2,54,39,22,17
050,31,029,"Nebraska","Chase County",2,55,40,19,21
050,31,029,"Nebraska","Chase County",2,56,48,23,25
050,31,029,"Nebraska","Chase County",2,57,51,24,27
050,31,029,"Nebraska","Chase County",2,58,53,25,28
050,31,029,"Nebraska","Chase County",2,59,59,31,28
050,31,029,"Nebraska","Chase County",2,60,55,31,24
050,31,029,"Nebraska","Chase County",2,61,56,28,28
050,31,029,"Nebraska","Chase County",2,62,62,29,33
050,31,029,"Nebraska","Chase County",2,63,70,30,40
050,31,029,"Nebraska","Chase County",2,64,61,26,35
050,31,029,"Nebraska","Chase County",2,65,58,28,30
050,31,029,"Nebraska","Chase County",2,66,55,28,27
050,31,029,"Nebraska","Chase County",2,67,50,27,23
050,31,029,"Nebraska","Chase County",2,68,47,24,23
050,31,029,"Nebraska","Chase County",2,69,40,22,18
050,31,029,"Nebraska","Chase County",2,70,33,17,16
050,31,029,"Nebraska","Chase County",2,71,38,21,17
050,31,029,"Nebraska","Chase County",2,72,39,21,18
050,31,029,"Nebraska","Chase County",2,73,32,15,17
050,31,029,"Nebraska","Chase County",2,74,21,10,11
050,31,029,"Nebraska","Chase County",2,75,33,18,15
050,31,029,"Nebraska","Chase County",2,76,32,15,17
050,31,029,"Nebraska","Chase County",2,77,39,17,22
050,31,029,"Nebraska","Chase County",2,78,30,16,14
050,31,029,"Nebraska","Chase County",2,79,23,11,12
050,31,029,"Nebraska","Chase County",2,80,21,11,10
050,31,029,"Nebraska","Chase County",2,81,31,13,18
050,31,029,"Nebraska","Chase County",2,82,22,9,13
050,31,029,"Nebraska","Chase County",2,83,16,7,9
050,31,029,"Nebraska","Chase County",2,84,16,6,10
050,31,029,"Nebraska","Chase County",2,85,162,50,112
050,31,029,"Nebraska","Chase County",3,0,42,20,22
050,31,029,"Nebraska","Chase County",3,1,58,31,27
050,31,029,"Nebraska","Chase County",3,2,47,24,23
050,31,029,"Nebraska","Chase County",3,3,50,24,26
050,31,029,"Nebraska","Chase County",3,4,54,28,26
050,31,029,"Nebraska","Chase County",3,5,46,23,23
050,31,029,"Nebraska","Chase County",3,6,44,20,24
050,31,029,"Nebraska","Chase County",3,7,38,22,16
050,31,029,"Nebraska","Chase County",3,8,39,22,17
050,31,029,"Nebraska","Chase County",3,9,44,24,20
050,31,029,"Nebraska","Chase County",3,10,59,32,27
050,31,029,"Nebraska","Chase County",3,11,68,41,27
050,31,029,"Nebraska","Chase County",3,12,59,33,26
050,31,029,"Nebraska","Chase County",3,13,65,35,30
050,31,029,"Nebraska","Chase County",3,14,69,36,33
050,31,029,"Nebraska","Chase County",3,15,63,31,32
050,31,029,"Nebraska","Chase County",3,16,57,25,32
050,31,029,"Nebraska","Chase County",3,17,49,19,30
050,31,029,"Nebraska","Chase County",3,18,44,17,27
050,31,029,"Nebraska","Chase County",3,19,37,17,20
050,31,029,"Nebraska","Chase County",3,20,38,22,16
050,31,029,"Nebraska","Chase County",3,21,38,21,17
050,31,029,"Nebraska","Chase County",3,22,31,13,18
050,31,029,"Nebraska","Chase County",3,23,36,18,18
050,31,029,"Nebraska","Chase County",3,24,38,18,20
050,31,029,"Nebraska","Chase County",3,25,31,14,17
050,31,029,"Nebraska","Chase County",3,26,33,13,20
050,31,029,"Nebraska","Chase County",3,27,32,16,16
050,31,029,"Nebraska","Chase County",3,28,39,18,21
050,31,029,"Nebraska","Chase County",3,29,44,21,23
050,31,029,"Nebraska","Chase County",3,30,34,16,18
050,31,029,"Nebraska","Chase County",3,31,46,26,20
050,31,029,"Nebraska","Chase County",3,32,35,20,15
050,31,029,"Nebraska","Chase County",3,33,28,15,13
050,31,029,"Nebraska","Chase County",3,34,38,18,20
050,31,029,"Nebraska","Chase County",3,35,47,30,17
050,31,029,"Nebraska","Chase County",3,36,44,26,18
050,31,029,"Nebraska","Chase County",3,37,49,25,24
050,31,029,"Nebraska","Chase County",3,38,47,23,24
050,31,029,"Nebraska","Chase County",3,39,45,25,20
050,31,029,"Nebraska","Chase County",3,40,39,25,14
050,31,029,"Nebraska","Chase County",3,41,40,23,17
050,31,029,"Nebraska","Chase County",3,42,45,24,21
050,31,029,"Nebraska","Chase County",3,43,46,22,24
050,31,029,"Nebraska","Chase County",3,44,47,20,27
050,31,029,"Nebraska","Chase County",3,45,43,17,26
050,31,029,"Nebraska","Chase County",3,46,46,24,22
050,31,029,"Nebraska","Chase County",3,47,37,21,16
050,31,029,"Nebraska","Chase County",3,48,36,19,17
050,31,029,"Nebraska","Chase County",3,49,43,27,16
050,31,029,"Nebraska","Chase County",3,50,48,25,23
050,31,029,"Nebraska","Chase County",3,51,38,18,20
050,31,029,"Nebraska","Chase County",3,52,42,20,22
050,31,029,"Nebraska","Chase County",3,53,52,30,22
050,31,029,"Nebraska","Chase County",3,54,41,25,16
050,31,029,"Nebraska","Chase County",3,55,43,23,20
050,31,029,"Nebraska","Chase County",3,56,39,18,21
050,31,029,"Nebraska","Chase County",3,57,49,23,26
050,31,029,"Nebraska","Chase County",3,58,49,23,26
050,31,029,"Nebraska","Chase County",3,59,54,26,28
050,31,029,"Nebraska","Chase County",3,60,57,31,26
050,31,029,"Nebraska","Chase County",3,61,57,33,24
050,31,029,"Nebraska","Chase County",3,62,53,27,26
050,31,029,"Nebraska","Chase County",3,63,61,29,32
050,31,029,"Nebraska","Chase County",3,64,72,31,41
050,31,029,"Nebraska","Chase County",3,65,58,24,34
050,31,029,"Nebraska","Chase County",3,66,54,27,27
050,31,029,"Nebraska","Chase County",3,67,54,28,26
050,31,029,"Nebraska","Chase County",3,68,45,25,20
050,31,029,"Nebraska","Chase County",3,69,47,25,22
050,31,029,"Nebraska","Chase County",3,70,38,19,19
050,31,029,"Nebraska","Chase County",3,71,35,17,18
050,31,029,"Nebraska","Chase County",3,72,40,21,19
050,31,029,"Nebraska","Chase County",3,73,40,21,19
050,31,029,"Nebraska","Chase County",3,74,29,16,13
050,31,029,"Nebraska","Chase County",3,75,22,10,12
050,31,029,"Nebraska","Chase County",3,76,31,17,14
050,31,029,"Nebraska","Chase County",3,77,31,15,16
050,31,029,"Nebraska","Chase County",3,78,34,18,16
050,31,029,"Nebraska","Chase County",3,79,25,12,13
050,31,029,"Nebraska","Chase County",3,80,18,8,10
050,31,029,"Nebraska","Chase County",3,81,28,13,15
050,31,029,"Nebraska","Chase County",3,82,23,11,12
050,31,029,"Nebraska","Chase County",3,83,21,7,14
050,31,029,"Nebraska","Chase County",3,84,19,8,11
050,31,029,"Nebraska","Chase County",3,85,150,43,107
050,31,029,"Nebraska","Chase County",4,0,42,20,22
050,31,029,"Nebraska","Chase County",4,1,42,20,22
050,31,029,"Nebraska","Chase County",4,2,53,27,26
050,31,029,"Nebraska","Chase County",4,3,47,23,24
050,31,029,"Nebraska","Chase County",4,4,53,23,30
050,31,029,"Nebraska","Chase County",4,5,51,29,22
050,31,029,"Nebraska","Chase County",4,6,44,23,21
050,31,029,"Nebraska","Chase County",4,7,46,22,24
050,31,029,"Nebraska","Chase County",4,8,39,23,16
050,31,029,"Nebraska","Chase County",4,9,37,20,17
050,31,029,"Nebraska","Chase County",4,10,45,23,22
050,31,029,"Nebraska","Chase County",4,11,58,33,25
050,31,029,"Nebraska","Chase County",4,12,68,42,26
050,31,029,"Nebraska","Chase County",4,13,59,30,29
050,31,029,"Nebraska","Chase County",4,14,62,34,28
050,31,029,"Nebraska","Chase County",4,15,66,33,33
050,31,029,"Nebraska","Chase County",4,16,60,31,29
050,31,029,"Nebraska","Chase County",4,17,60,28,32
050,31,029,"Nebraska","Chase County",4,18,42,18,24
050,31,029,"Nebraska","Chase County",4,19,31,11,20
050,31,029,"Nebraska","Chase County",4,20,37,18,19
050,31,029,"Nebraska","Chase County",4,21,35,18,17
050,31,029,"Nebraska","Chase County",4,22,37,19,18
050,31,029,"Nebraska","Chase County",4,23,34,16,18
050,31,029,"Nebraska","Chase County",4,24,30,19,11
050,31,029,"Nebraska","Chase County",4,25,37,17,20
050,31,029,"Nebraska","Chase County",4,26,28,13,15
050,31,029,"Nebraska","Chase County",4,27,32,11,21
050,31,029,"Nebraska","Chase County",4,28,37,20,17
050,31,029,"Nebraska","Chase County",4,29,38,15,23
050,31,029,"Nebraska","Chase County",4,30,45,23,22
050,31,029,"Nebraska","Chase County",4,31,36,18,18
050,31,029,"Nebraska","Chase County",4,32,41,25,16
050,31,029,"Nebraska","Chase County",4,33,30,19,11
050,31,029,"Nebraska","Chase County",4,34,28,15,13
050,31,029,"Nebraska","Chase County",4,35,37,17,20
050,31,029,"Nebraska","Chase County",4,36,46,29,17
050,31,029,"Nebraska","Chase County",4,37,49,28,21
050,31,029,"Nebraska","Chase County",4,38,55,30,25
050,31,029,"Nebraska","Chase County",4,39,45,22,23
050,31,029,"Nebraska","Chase County",4,40,40,21,19
050,31,029,"Nebraska","Chase County",4,41,40,24,16
050,31,029,"Nebraska","Chase County",4,42,44,27,17
050,31,029,"Nebraska","Chase County",4,43,44,23,21
050,31,029,"Nebraska","Chase County",4,44,49,25,24
050,31,029,"Nebraska","Chase County",4,45,44,18,26
050,31,029,"Nebraska","Chase County",4,46,41,17,24
050,31,029,"Nebraska","Chase County",4,47,49,26,23
050,31,029,"Nebraska","Chase County",4,48,37,21,16
050,31,029,"Nebraska","Chase County",4,49,36,21,15
050,31,029,"Nebraska","Chase County",4,50,43,27,16
050,31,029,"Nebraska","Chase County",4,51,42,25,17
050,31,029,"Nebraska","Chase County",4,52,32,14,18
050,31,029,"Nebraska","Chase County",4,53,41,16,25
050,31,029,"Nebraska","Chase County",4,54,44,22,22
050,31,029,"Nebraska","Chase County",4,55,41,22,19
050,31,029,"Nebraska","Chase County",4,56,40,21,19
050,31,029,"Nebraska","Chase County",4,57,41,21,20
050,31,029,"Nebraska","Chase County",4,58,44,20,24
050,31,029,"Nebraska","Chase County",4,59,51,24,27
050,31,029,"Nebraska","Chase County",4,60,53,27,26
050,31,029,"Nebraska","Chase County",4,61,58,33,25
050,31,029,"Nebraska","Chase County",4,62,55,31,24
050,31,029,"Nebraska","Chase County",4,63,53,27,26
050,31,029,"Nebraska","Chase County",4,64,60,29,31
050,31,029,"Nebraska","Chase County",4,65,66,29,37
050,31,029,"Nebraska","Chase County",4,66,57,25,32
050,31,029,"Nebraska","Chase County",4,67,51,24,27
050,31,029,"Nebraska","Chase County",4,68,55,27,28
050,31,029,"Nebraska","Chase County",4,69,45,26,19
050,31,029,"Nebraska","Chase County",4,70,45,24,21
050,31,029,"Nebraska","Chase County",4,71,38,19,19
050,31,029,"Nebraska","Chase County",4,72,36,17,19
050,31,029,"Nebraska","Chase County",4,73,41,21,20
050,31,029,"Nebraska","Chase County",4,74,36,22,14
050,31,029,"Nebraska","Chase County",4,75,31,16,15
050,31,029,"Nebraska","Chase County",4,76,21,10,11
050,31,029,"Nebraska","Chase County",4,77,33,17,16
050,31,029,"Nebraska","Chase County",4,78,28,16,12
050,31,029,"Nebraska","Chase County",4,79,31,15,16
050,31,029,"Nebraska","Chase County",4,80,22,10,12
050,31,029,"Nebraska","Chase County",4,81,25,10,15
050,31,029,"Nebraska","Chase County",4,82,20,12,8
050,31,029,"Nebraska","Chase County",4,83,22,8,14
050,31,029,"Nebraska","Chase County",4,84,24,8,16
050,31,029,"Nebraska","Chase County",4,85,143,39,104
050,31,029,"Nebraska","Chase County",5,0,42,21,21
050,31,029,"Nebraska","Chase County",5,1,44,17,27
050,31,029,"Nebraska","Chase County",5,2,41,21,20
050,31,029,"Nebraska","Chase County",5,3,52,24,28
050,31,029,"Nebraska","Chase County",5,4,45,23,22
050,31,029,"Nebraska","Chase County",5,5,53,22,31
050,31,029,"Nebraska","Chase County",5,6,50,28,22
050,31,029,"Nebraska","Chase County",5,7,47,26,21
050,31,029,"Nebraska","Chase County",5,8,45,22,23
050,31,029,"Nebraska","Chase County",5,9,40,22,18
050,31,029,"Nebraska","Chase County",5,10,38,22,16
050,31,029,"Nebraska","Chase County",5,11,47,26,21
050,31,029,"Nebraska","Chase County",5,12,60,34,26
050,31,029,"Nebraska","Chase County",5,13,69,40,29
050,31,029,"Nebraska","Chase County",5,14,57,27,30
050,31,029,"Nebraska","Chase County",5,15,59,35,24
050,31,029,"Nebraska","Chase County",5,16,68,36,32
050,31,029,"Nebraska","Chase County",5,17,59,32,27
050,31,029,"Nebraska","Chase County",5,18,49,24,25
050,31,029,"Nebraska","Chase County",5,19,31,14,17
050,31,029,"Nebraska","Chase County",5,20,25,10,15
050,31,029,"Nebraska","Chase County",5,21,39,20,19
050,31,029,"Nebraska","Chase County",5,22,34,16,18
050,31,029,"Nebraska","Chase County",5,23,31,16,15
050,31,029,"Nebraska","Chase County",5,24,35,16,19
050,31,029,"Nebraska","Chase County",5,25,31,18,13
050,31,029,"Nebraska","Chase County",5,26,35,17,18
050,31,029,"Nebraska","Chase County",5,27,26,12,14
050,31,029,"Nebraska","Chase County",5,28,34,13,21
050,31,029,"Nebraska","Chase County",5,29,33,17,16
050,31,029,"Nebraska","Chase County",5,30,37,15,22
050,31,029,"Nebraska","Chase County",5,31,42,22,20
050,31,029,"Nebraska","Chase County",5,32,40,20,20
050,31,029,"Nebraska","Chase County",5,33,43,22,21
050,31,029,"Nebraska","Chase County",5,34,31,19,12
050,31,029,"Nebraska","Chase County",5,35,25,12,13
050,31,029,"Nebraska","Chase County",5,36,41,17,24
050,31,029,"Nebraska","Chase County",5,37,51,30,21
050,31,029,"Nebraska","Chase County",5,38,56,34,22
050,31,029,"Nebraska","Chase County",5,39,54,30,24
050,31,029,"Nebraska","Chase County",5,40,47,25,22
050,31,029,"Nebraska","Chase County",5,41,35,17,18
050,31,029,"Nebraska","Chase County",5,42,41,24,17
050,31,029,"Nebraska","Chase County",5,43,44,29,15
050,31,029,"Nebraska","Chase County",5,44,41,22,19
050,31,029,"Nebraska","Chase County",5,45,49,25,24
050,31,029,"Nebraska","Chase County",5,46,41,18,23
050,31,029,"Nebraska","Chase County",5,47,45,18,27
050,31,029,"Nebraska","Chase County",5,48,49,26,23
050,31,029,"Nebraska","Chase County",5,49,41,23,18
050,31,029,"Nebraska","Chase County",5,50,38,22,16
050,31,029,"Nebraska","Chase County",5,51,44,27,17
050,31,029,"Nebraska","Chase County",5,52,40,24,16
050,31,029,"Nebraska","Chase County",5,53,31,13,18
050,31,029,"Nebraska","Chase County",5,54,42,17,25
050,31,029,"Nebraska","Chase County",5,55,41,20,21
050,31,029,"Nebraska","Chase County",5,56,47,25,22
050,31,029,"Nebraska","Chase County",5,57,41,22,19
050,31,029,"Nebraska","Chase County",5,58,40,20,20
050,31,029,"Nebraska","Chase County",5,59,46,19,27
050,31,029,"Nebraska","Chase County",5,60,47,22,25
050,31,029,"Nebraska","Chase County",5,61,52,28,24
050,31,029,"Nebraska","Chase County",5,62,55,30,25
050,31,029,"Nebraska","Chase County",5,63,55,31,24
050,31,029,"Nebraska","Chase County",5,64,51,27,24
050,31,029,"Nebraska","Chase County",5,65,57,27,30
050,31,029,"Nebraska","Chase County",5,66,62,27,35
050,31,029,"Nebraska","Chase County",5,67,50,22,28
050,31,029,"Nebraska","Chase County",5,68,50,23,27
050,31,029,"Nebraska","Chase County",5,69,53,28,25
050,31,029,"Nebraska","Chase County",5,70,41,23,18
050,31,029,"Nebraska","Chase County",5,71,47,25,22
050,31,029,"Nebraska","Chase County",5,72,38,19,19
050,31,029,"Nebraska","Chase County",5,73,36,17,19
050,31,029,"Nebraska","Chase County",5,74,37,20,17
050,31,029,"Nebraska","Chase County",5,75,40,23,17
050,31,029,"Nebraska","Chase County",5,76,31,16,15
050,31,029,"Nebraska","Chase County",5,77,24,11,13
050,31,029,"Nebraska","Chase County",5,78,29,19,10
050,31,029,"Nebraska","Chase County",5,79,25,12,13
050,31,029,"Nebraska","Chase County",5,80,29,13,16
050,31,029,"Nebraska","Chase County",5,81,30,12,18
050,31,029,"Nebraska","Chase County",5,82,13,6,7
050,31,029,"Nebraska","Chase County",5,83,19,9,10
050,31,029,"Nebraska","Chase County",5,84,23,8,15
050,31,029,"Nebraska","Chase County",5,85,148,37,111
050,31,031,"Nebraska","Cherry County",1,0,72,37,35
050,31,031,"Nebraska","Cherry County",1,1,67,35,32
050,31,031,"Nebraska","Cherry County",1,2,72,35,37
050,31,031,"Nebraska","Cherry County",1,3,71,29,42
050,31,031,"Nebraska","Cherry County",1,4,79,37,42
050,31,031,"Nebraska","Cherry County",1,5,86,49,37
050,31,031,"Nebraska","Cherry County",1,6,75,38,37
050,31,031,"Nebraska","Cherry County",1,7,77,40,37
050,31,031,"Nebraska","Cherry County",1,8,65,40,25
050,31,031,"Nebraska","Cherry County",1,9,65,34,31
050,31,031,"Nebraska","Cherry County",1,10,58,28,30
050,31,031,"Nebraska","Cherry County",1,11,75,39,36
050,31,031,"Nebraska","Cherry County",1,12,67,35,32
050,31,031,"Nebraska","Cherry County",1,13,66,31,35
050,31,031,"Nebraska","Cherry County",1,14,76,40,36
050,31,031,"Nebraska","Cherry County",1,15,76,45,31
050,31,031,"Nebraska","Cherry County",1,16,81,45,36
050,31,031,"Nebraska","Cherry County",1,17,67,34,33
050,31,031,"Nebraska","Cherry County",1,18,50,23,27
050,31,031,"Nebraska","Cherry County",1,19,46,26,20
050,31,031,"Nebraska","Cherry County",1,20,40,23,17
050,31,031,"Nebraska","Cherry County",1,21,42,22,20
050,31,031,"Nebraska","Cherry County",1,22,48,22,26
050,31,031,"Nebraska","Cherry County",1,23,63,32,31
050,31,031,"Nebraska","Cherry County",1,24,49,30,19
050,31,031,"Nebraska","Cherry County",1,25,56,33,23
050,31,031,"Nebraska","Cherry County",1,26,51,31,20
050,31,031,"Nebraska","Cherry County",1,27,47,26,21
050,31,031,"Nebraska","Cherry County",1,28,49,29,20
050,31,031,"Nebraska","Cherry County",1,29,56,32,24
050,31,031,"Nebraska","Cherry County",1,30,66,33,33
050,31,031,"Nebraska","Cherry County",1,31,55,28,27
050,31,031,"Nebraska","Cherry County",1,32,57,27,30
050,31,031,"Nebraska","Cherry County",1,33,57,29,28
050,31,031,"Nebraska","Cherry County",1,34,59,36,23
050,31,031,"Nebraska","Cherry County",1,35,56,27,29
050,31,031,"Nebraska","Cherry County",1,36,70,33,37
050,31,031,"Nebraska","Cherry County",1,37,85,49,36
050,31,031,"Nebraska","Cherry County",1,38,63,36,27
050,31,031,"Nebraska","Cherry County",1,39,72,36,36
050,31,031,"Nebraska","Cherry County",1,40,68,38,30
050,31,031,"Nebraska","Cherry County",1,41,68,37,31
050,31,031,"Nebraska","Cherry County",1,42,61,35,26
050,31,031,"Nebraska","Cherry County",1,43,59,31,28
050,31,031,"Nebraska","Cherry County",1,44,63,34,29
050,31,031,"Nebraska","Cherry County",1,45,63,38,25
050,31,031,"Nebraska","Cherry County",1,46,55,26,29
050,31,031,"Nebraska","Cherry County",1,47,57,29,28
050,31,031,"Nebraska","Cherry County",1,48,58,25,33
050,31,031,"Nebraska","Cherry County",1,49,64,35,29
050,31,031,"Nebraska","Cherry County",1,50,60,34,26
050,31,031,"Nebraska","Cherry County",1,51,74,40,34
050,31,031,"Nebraska","Cherry County",1,52,55,27,28
050,31,031,"Nebraska","Cherry County",1,53,53,20,33
050,31,031,"Nebraska","Cherry County",1,54,58,28,30
050,31,031,"Nebraska","Cherry County",1,55,60,32,28
050,31,031,"Nebraska","Cherry County",1,56,69,33,36
050,31,031,"Nebraska","Cherry County",1,57,71,38,33
050,31,031,"Nebraska","Cherry County",1,58,75,37,38
050,31,031,"Nebraska","Cherry County",1,59,81,43,38
050,31,031,"Nebraska","Cherry County",1,60,84,44,40
050,31,031,"Nebraska","Cherry County",1,61,89,43,46
050,31,031,"Nebraska","Cherry County",1,62,85,43,42
050,31,031,"Nebraska","Cherry County",1,63,86,45,41
050,31,031,"Nebraska","Cherry County",1,64,89,45,44
050,31,031,"Nebraska","Cherry County",1,65,80,43,37
050,31,031,"Nebraska","Cherry County",1,66,81,46,35
050,31,031,"Nebraska","Cherry County",1,67,84,44,40
050,31,031,"Nebraska","Cherry County",1,68,63,30,33
050,31,031,"Nebraska","Cherry County",1,69,62,31,31
050,31,031,"Nebraska","Cherry County",1,70,63,34,29
050,31,031,"Nebraska","Cherry County",1,71,51,26,25
050,31,031,"Nebraska","Cherry County",1,72,62,28,34
050,31,031,"Nebraska","Cherry County",1,73,53,24,29
050,31,031,"Nebraska","Cherry County",1,74,32,14,18
050,31,031,"Nebraska","Cherry County",1,75,50,18,32
050,31,031,"Nebraska","Cherry County",1,76,59,28,31
050,31,031,"Nebraska","Cherry County",1,77,48,26,22
050,31,031,"Nebraska","Cherry County",1,78,41,27,14
050,31,031,"Nebraska","Cherry County",1,79,40,24,16
050,31,031,"Nebraska","Cherry County",1,80,38,19,19
050,31,031,"Nebraska","Cherry County",1,81,39,17,22
050,31,031,"Nebraska","Cherry County",1,82,31,13,18
050,31,031,"Nebraska","Cherry County",1,83,25,12,13
050,31,031,"Nebraska","Cherry County",1,84,34,16,18
050,31,031,"Nebraska","Cherry County",1,85,180,69,111
050,31,031,"Nebraska","Cherry County",2,0,66,32,34
050,31,031,"Nebraska","Cherry County",2,1,69,36,33
050,31,031,"Nebraska","Cherry County",2,2,71,35,36
050,31,031,"Nebraska","Cherry County",2,3,71,30,41
050,31,031,"Nebraska","Cherry County",2,4,78,35,43
050,31,031,"Nebraska","Cherry County",2,5,87,47,40
050,31,031,"Nebraska","Cherry County",2,6,78,41,37
050,31,031,"Nebraska","Cherry County",2,7,76,40,36
050,31,031,"Nebraska","Cherry County",2,8,69,40,29
050,31,031,"Nebraska","Cherry County",2,9,66,35,31
050,31,031,"Nebraska","Cherry County",2,10,61,30,31
050,31,031,"Nebraska","Cherry County",2,11,69,35,34
050,31,031,"Nebraska","Cherry County",2,12,69,36,33
050,31,031,"Nebraska","Cherry County",2,13,67,33,34
050,31,031,"Nebraska","Cherry County",2,14,73,38,35
050,31,031,"Nebraska","Cherry County",2,15,76,44,32
050,31,031,"Nebraska","Cherry County",2,16,80,45,35
050,31,031,"Nebraska","Cherry County",2,17,70,36,34
050,31,031,"Nebraska","Cherry County",2,18,50,24,26
050,31,031,"Nebraska","Cherry County",2,19,43,24,19
050,31,031,"Nebraska","Cherry County",2,20,42,25,17
050,31,031,"Nebraska","Cherry County",2,21,42,22,20
050,31,031,"Nebraska","Cherry County",2,22,46,21,25
050,31,031,"Nebraska","Cherry County",2,23,58,30,28
050,31,031,"Nebraska","Cherry County",2,24,53,31,22
050,31,031,"Nebraska","Cherry County",2,25,54,32,22
050,31,031,"Nebraska","Cherry County",2,26,51,31,20
050,31,031,"Nebraska","Cherry County",2,27,49,28,21
050,31,031,"Nebraska","Cherry County",2,28,47,28,19
050,31,031,"Nebraska","Cherry County",2,29,56,33,23
050,31,031,"Nebraska","Cherry County",2,30,64,33,31
050,31,031,"Nebraska","Cherry County",2,31,57,29,28
050,31,031,"Nebraska","Cherry County",2,32,55,26,29
050,31,031,"Nebraska","Cherry County",2,33,57,29,28
050,31,031,"Nebraska","Cherry County",2,34,58,35,23
050,31,031,"Nebraska","Cherry County",2,35,57,29,28
050,31,031,"Nebraska","Cherry County",2,36,68,32,36
050,31,031,"Nebraska","Cherry County",2,37,80,45,35
050,31,031,"Nebraska","Cherry County",2,38,70,40,30
050,31,031,"Nebraska","Cherry County",2,39,71,36,35
050,31,031,"Nebraska","Cherry County",2,40,71,39,32
050,31,031,"Nebraska","Cherry County",2,41,68,37,31
050,31,031,"Nebraska","Cherry County",2,42,63,36,27
050,31,031,"Nebraska","Cherry County",2,43,60,31,29
050,31,031,"Nebraska","Cherry County",2,44,61,33,28
050,31,031,"Nebraska","Cherry County",2,45,63,37,26
050,31,031,"Nebraska","Cherry County",2,46,56,28,28
050,31,031,"Nebraska","Cherry County",2,47,56,28,28
050,31,031,"Nebraska","Cherry County",2,48,58,27,31
050,31,031,"Nebraska","Cherry County",2,49,63,33,30
050,31,031,"Nebraska","Cherry County",2,50,61,34,27
050,31,031,"Nebraska","Cherry County",2,51,72,39,33
050,31,031,"Nebraska","Cherry County",2,52,58,29,29
050,31,031,"Nebraska","Cherry County",2,53,56,23,33
050,31,031,"Nebraska","Cherry County",2,54,57,26,31
050,31,031,"Nebraska","Cherry County",2,55,60,30,30
050,31,031,"Nebraska","Cherry County",2,56,66,33,33
050,31,031,"Nebraska","Cherry County",2,57,70,37,33
050,31,031,"Nebraska","Cherry County",2,58,75,38,37
050,31,031,"Nebraska","Cherry County",2,59,80,42,38
050,31,031,"Nebraska","Cherry County",2,60,83,44,39
050,31,031,"Nebraska","Cherry County",2,61,88,44,44
050,31,031,"Nebraska","Cherry County",2,62,86,43,43
050,31,031,"Nebraska","Cherry County",2,63,88,46,42
050,31,031,"Nebraska","Cherry County",2,64,87,44,43
050,31,031,"Nebraska","Cherry County",2,65,82,43,39
050,31,031,"Nebraska","Cherry County",2,66,79,43,36
050,31,031,"Nebraska","Cherry County",2,67,83,45,38
050,31,031,"Nebraska","Cherry County",2,68,67,33,34
050,31,031,"Nebraska","Cherry County",2,69,63,30,33
050,31,031,"Nebraska","Cherry County",2,70,63,33,30
050,31,031,"Nebraska","Cherry County",2,71,54,28,26
050,31,031,"Nebraska","Cherry County",2,72,58,27,31
050,31,031,"Nebraska","Cherry County",2,73,58,26,32
050,31,031,"Nebraska","Cherry County",2,74,33,15,18
050,31,031,"Nebraska","Cherry County",2,75,47,17,30
050,31,031,"Nebraska","Cherry County",2,76,56,25,31
050,31,031,"Nebraska","Cherry County",2,77,52,27,25
050,31,031,"Nebraska","Cherry County",2,78,41,26,15
050,31,031,"Nebraska","Cherry County",2,79,41,25,16
050,31,031,"Nebraska","Cherry County",2,80,39,21,18
050,31,031,"Nebraska","Cherry County",2,81,39,17,22
050,31,031,"Nebraska","Cherry County",2,82,32,14,18
050,31,031,"Nebraska","Cherry County",2,83,26,12,14
050,31,031,"Nebraska","Cherry County",2,84,31,14,17
050,31,031,"Nebraska","Cherry County",2,85,178,68,110
050,31,031,"Nebraska","Cherry County",3,0,78,37,41
050,31,031,"Nebraska","Cherry County",3,1,67,31,36
050,31,031,"Nebraska","Cherry County",3,2,66,33,33
050,31,031,"Nebraska","Cherry County",3,3,72,38,34
050,31,031,"Nebraska","Cherry County",3,4,72,29,43
050,31,031,"Nebraska","Cherry County",3,5,74,36,38
050,31,031,"Nebraska","Cherry County",3,6,84,46,38
050,31,031,"Nebraska","Cherry County",3,7,74,39,35
050,31,031,"Nebraska","Cherry County",3,8,78,42,36
050,31,031,"Nebraska","Cherry County",3,9,68,40,28
050,31,031,"Nebraska","Cherry County",3,10,65,35,30
050,31,031,"Nebraska","Cherry County",3,11,67,31,36
050,31,031,"Nebraska","Cherry County",3,12,68,34,34
050,31,031,"Nebraska","Cherry County",3,13,76,40,36
050,31,031,"Nebraska","Cherry County",3,14,69,37,32
050,31,031,"Nebraska","Cherry County",3,15,71,40,31
050,31,031,"Nebraska","Cherry County",3,16,80,43,37
050,31,031,"Nebraska","Cherry County",3,17,79,44,35
050,31,031,"Nebraska","Cherry County",3,18,60,33,27
050,31,031,"Nebraska","Cherry County",3,19,41,20,21
050,31,031,"Nebraska","Cherry County",3,20,52,32,20
050,31,031,"Nebraska","Cherry County",3,21,42,24,18
050,31,031,"Nebraska","Cherry County",3,22,45,23,22
050,31,031,"Nebraska","Cherry County",3,23,52,28,24
050,31,031,"Nebraska","Cherry County",3,24,55,25,30
050,31,031,"Nebraska","Cherry County",3,25,56,31,25
050,31,031,"Nebraska","Cherry County",3,26,59,35,24
050,31,031,"Nebraska","Cherry County",3,27,46,31,15
050,31,031,"Nebraska","Cherry County",3,28,47,26,21
050,31,031,"Nebraska","Cherry County",3,29,43,25,18
050,31,031,"Nebraska","Cherry County",3,30,56,31,25
050,31,031,"Nebraska","Cherry County",3,31,59,29,30
050,31,031,"Nebraska","Cherry County",3,32,52,28,24
050,31,031,"Nebraska","Cherry County",3,33,53,25,28
050,31,031,"Nebraska","Cherry County",3,34,59,30,29
050,31,031,"Nebraska","Cherry County",3,35,59,35,24
050,31,031,"Nebraska","Cherry County",3,36,63,31,32
050,31,031,"Nebraska","Cherry County",3,37,69,32,37
050,31,031,"Nebraska","Cherry County",3,38,69,36,33
050,31,031,"Nebraska","Cherry County",3,39,71,40,31
050,31,031,"Nebraska","Cherry County",3,40,75,40,35
050,31,031,"Nebraska","Cherry County",3,41,73,40,33
050,31,031,"Nebraska","Cherry County",3,42,69,37,32
050,31,031,"Nebraska","Cherry County",3,43,66,39,27
050,31,031,"Nebraska","Cherry County",3,44,59,31,28
050,31,031,"Nebraska","Cherry County",3,45,64,33,31
050,31,031,"Nebraska","Cherry County",3,46,63,35,28
050,31,031,"Nebraska","Cherry County",3,47,58,29,29
050,31,031,"Nebraska","Cherry County",3,48,54,27,27
050,31,031,"Nebraska","Cherry County",3,49,62,28,34
050,31,031,"Nebraska","Cherry County",3,50,65,35,30
050,31,031,"Nebraska","Cherry County",3,51,59,33,26
050,31,031,"Nebraska","Cherry County",3,52,67,35,32
050,31,031,"Nebraska","Cherry County",3,53,63,33,30
050,31,031,"Nebraska","Cherry County",3,54,57,24,33
050,31,031,"Nebraska","Cherry County",3,55,59,25,34
050,31,031,"Nebraska","Cherry County",3,56,60,32,28
050,31,031,"Nebraska","Cherry County",3,57,69,33,36
050,31,031,"Nebraska","Cherry County",3,58,68,36,32
050,31,031,"Nebraska","Cherry County",3,59,80,43,37
050,31,031,"Nebraska","Cherry County",3,60,76,38,38
050,31,031,"Nebraska","Cherry County",3,61,87,45,42
050,31,031,"Nebraska","Cherry County",3,62,81,39,42
050,31,031,"Nebraska","Cherry County",3,63,83,42,41
050,31,031,"Nebraska","Cherry County",3,64,88,46,42
050,31,031,"Nebraska","Cherry County",3,65,91,45,46
050,31,031,"Nebraska","Cherry County",3,66,79,43,36
050,31,031,"Nebraska","Cherry County",3,67,77,40,37
050,31,031,"Nebraska","Cherry County",3,68,81,44,37
050,31,031,"Nebraska","Cherry County",3,69,66,31,35
050,31,031,"Nebraska","Cherry County",3,70,58,29,29
050,31,031,"Nebraska","Cherry County",3,71,64,33,31
050,31,031,"Nebraska","Cherry County",3,72,52,26,26
050,31,031,"Nebraska","Cherry County",3,73,53,27,26
050,31,031,"Nebraska","Cherry County",3,74,57,26,31
050,31,031,"Nebraska","Cherry County",3,75,32,13,19
050,31,031,"Nebraska","Cherry County",3,76,44,17,27
050,31,031,"Nebraska","Cherry County",3,77,50,21,29
050,31,031,"Nebraska","Cherry County",3,78,52,27,25
050,31,031,"Nebraska","Cherry County",3,79,38,22,16
050,31,031,"Nebraska","Cherry County",3,80,36,21,15
050,31,031,"Nebraska","Cherry County",3,81,38,22,16
050,31,031,"Nebraska","Cherry County",3,82,33,17,16
050,31,031,"Nebraska","Cherry County",3,83,27,10,17
050,31,031,"Nebraska","Cherry County",3,84,25,12,13
050,31,031,"Nebraska","Cherry County",3,85,173,66,107
050,31,031,"Nebraska","Cherry County",4,0,79,38,41
050,31,031,"Nebraska","Cherry County",4,1,81,39,42
050,31,031,"Nebraska","Cherry County",4,2,74,34,40
050,31,031,"Nebraska","Cherry County",4,3,73,40,33
050,31,031,"Nebraska","Cherry County",4,4,73,39,34
050,31,031,"Nebraska","Cherry County",4,5,74,29,45
050,31,031,"Nebraska","Cherry County",4,6,79,40,39
050,31,031,"Nebraska","Cherry County",4,7,85,46,39
050,31,031,"Nebraska","Cherry County",4,8,76,42,34
050,31,031,"Nebraska","Cherry County",4,9,85,42,43
050,31,031,"Nebraska","Cherry County",4,10,68,39,29
050,31,031,"Nebraska","Cherry County",4,11,69,38,31
050,31,031,"Nebraska","Cherry County",4,12,66,31,35
050,31,031,"Nebraska","Cherry County",4,13,74,36,38
050,31,031,"Nebraska","Cherry County",4,14,74,41,33
050,31,031,"Nebraska","Cherry County",4,15,68,37,31
050,31,031,"Nebraska","Cherry County",4,16,75,41,34
050,31,031,"Nebraska","Cherry County",4,17,83,46,37
050,31,031,"Nebraska","Cherry County",4,18,66,42,24
050,31,031,"Nebraska","Cherry County",4,19,48,25,23
050,31,031,"Nebraska","Cherry County",4,20,44,22,22
050,31,031,"Nebraska","Cherry County",4,21,40,27,13
050,31,031,"Nebraska","Cherry County",4,22,44,23,21
050,31,031,"Nebraska","Cherry County",4,23,46,24,22
050,31,031,"Nebraska","Cherry County",4,24,59,27,32
050,31,031,"Nebraska","Cherry County",4,25,52,21,31
050,31,031,"Nebraska","Cherry County",4,26,58,33,25
050,31,031,"Nebraska","Cherry County",4,27,55,35,20
050,31,031,"Nebraska","Cherry County",4,28,46,28,18
050,31,031,"Nebraska","Cherry County",4,29,52,28,24
050,31,031,"Nebraska","Cherry County",4,30,53,24,29
050,31,031,"Nebraska","Cherry County",4,31,59,32,27
050,31,031,"Nebraska","Cherry County",4,32,60,31,29
050,31,031,"Nebraska","Cherry County",4,33,60,34,26
050,31,031,"Nebraska","Cherry County",4,34,59,28,31
050,31,031,"Nebraska","Cherry County",4,35,61,31,30
050,31,031,"Nebraska","Cherry County",4,36,53,35,18
050,31,031,"Nebraska","Cherry County",4,37,66,38,28
050,31,031,"Nebraska","Cherry County",4,38,71,34,37
050,31,031,"Nebraska","Cherry County",4,39,65,32,33
050,31,031,"Nebraska","Cherry County",4,40,74,42,32
050,31,031,"Nebraska","Cherry County",4,41,70,40,30
050,31,031,"Nebraska","Cherry County",4,42,72,38,34
050,31,031,"Nebraska","Cherry County",4,43,71,37,34
050,31,031,"Nebraska","Cherry County",4,44,66,39,27
050,31,031,"Nebraska","Cherry County",4,45,62,34,28
050,31,031,"Nebraska","Cherry County",4,46,66,36,30
050,31,031,"Nebraska","Cherry County",4,47,61,34,27
050,31,031,"Nebraska","Cherry County",4,48,56,29,27
050,31,031,"Nebraska","Cherry County",4,49,58,31,27
050,31,031,"Nebraska","Cherry County",4,50,63,27,36
050,31,031,"Nebraska","Cherry County",4,51,62,32,30
050,31,031,"Nebraska","Cherry County",4,52,57,33,24
050,31,031,"Nebraska","Cherry County",4,53,65,32,33
050,31,031,"Nebraska","Cherry County",4,54,64,33,31
050,31,031,"Nebraska","Cherry County",4,55,57,24,33
050,31,031,"Nebraska","Cherry County",4,56,58,24,34
050,31,031,"Nebraska","Cherry County",4,57,60,31,29
050,31,031,"Nebraska","Cherry County",4,58,70,33,37
050,31,031,"Nebraska","Cherry County",4,59,64,37,27
050,31,031,"Nebraska","Cherry County",4,60,74,37,37
050,31,031,"Nebraska","Cherry County",4,61,77,38,39
050,31,031,"Nebraska","Cherry County",4,62,89,45,44
050,31,031,"Nebraska","Cherry County",4,63,79,39,40
050,31,031,"Nebraska","Cherry County",4,64,83,42,41
050,31,031,"Nebraska","Cherry County",4,65,90,49,41
050,31,031,"Nebraska","Cherry County",4,66,93,47,46
050,31,031,"Nebraska","Cherry County",4,67,77,38,39
050,31,031,"Nebraska","Cherry County",4,68,75,38,37
050,31,031,"Nebraska","Cherry County",4,69,81,43,38
050,31,031,"Nebraska","Cherry County",4,70,63,32,31
050,31,031,"Nebraska","Cherry County",4,71,58,30,28
050,31,031,"Nebraska","Cherry County",4,72,62,31,31
050,31,031,"Nebraska","Cherry County",4,73,49,25,24
050,31,031,"Nebraska","Cherry County",4,74,54,28,26
050,31,031,"Nebraska","Cherry County",4,75,55,26,29
050,31,031,"Nebraska","Cherry County",4,76,31,12,19
050,31,031,"Nebraska","Cherry County",4,77,40,14,26
050,31,031,"Nebraska","Cherry County",4,78,47,17,30
050,31,031,"Nebraska","Cherry County",4,79,48,24,24
050,31,031,"Nebraska","Cherry County",4,80,31,19,12
050,31,031,"Nebraska","Cherry County",4,81,34,21,13
050,31,031,"Nebraska","Cherry County",4,82,31,19,12
050,31,031,"Nebraska","Cherry County",4,83,31,16,15
050,31,031,"Nebraska","Cherry County",4,84,24,8,16
050,31,031,"Nebraska","Cherry County",4,85,160,66,94
050,31,031,"Nebraska","Cherry County",5,0,76,39,37
050,31,031,"Nebraska","Cherry County",5,1,84,44,40
050,31,031,"Nebraska","Cherry County",5,2,77,42,35
050,31,031,"Nebraska","Cherry County",5,3,77,28,49
050,31,031,"Nebraska","Cherry County",5,4,71,36,35
050,31,031,"Nebraska","Cherry County",5,5,74,39,35
050,31,031,"Nebraska","Cherry County",5,6,69,25,44
050,31,031,"Nebraska","Cherry County",5,7,78,39,39
050,31,031,"Nebraska","Cherry County",5,8,92,52,40
050,31,031,"Nebraska","Cherry County",5,9,76,41,35
050,31,031,"Nebraska","Cherry County",5,10,81,39,42
050,31,031,"Nebraska","Cherry County",5,11,69,40,29
050,31,031,"Nebraska","Cherry County",5,12,66,38,28
050,31,031,"Nebraska","Cherry County",5,13,64,28,36
050,31,031,"Nebraska","Cherry County",5,14,71,36,35
050,31,031,"Nebraska","Cherry County",5,15,71,38,33
050,31,031,"Nebraska","Cherry County",5,16,66,36,30
050,31,031,"Nebraska","Cherry County",5,17,68,38,30
050,31,031,"Nebraska","Cherry County",5,18,73,42,31
050,31,031,"Nebraska","Cherry County",5,19,47,30,17
050,31,031,"Nebraska","Cherry County",5,20,53,26,27
050,31,031,"Nebraska","Cherry County",5,21,44,22,22
050,31,031,"Nebraska","Cherry County",5,22,40,27,13
050,31,031,"Nebraska","Cherry County",5,23,41,25,16
050,31,031,"Nebraska","Cherry County",5,24,55,29,26
050,31,031,"Nebraska","Cherry County",5,25,56,27,29
050,31,031,"Nebraska","Cherry County",5,26,49,18,31
050,31,031,"Nebraska","Cherry County",5,27,72,42,30
050,31,031,"Nebraska","Cherry County",5,28,57,38,19
050,31,031,"Nebraska","Cherry County",5,29,46,28,18
050,31,031,"Nebraska","Cherry County",5,30,50,26,24
050,31,031,"Nebraska","Cherry County",5,31,61,31,30
050,31,031,"Nebraska","Cherry County",5,32,55,27,28
050,31,031,"Nebraska","Cherry County",5,33,64,34,30
050,31,031,"Nebraska","Cherry County",5,34,56,30,26
050,31,031,"Nebraska","Cherry County",5,35,62,30,32
050,31,031,"Nebraska","Cherry County",5,36,63,33,30
050,31,031,"Nebraska","Cherry County",5,37,54,36,18
050,31,031,"Nebraska","Cherry County",5,38,64,37,27
050,31,031,"Nebraska","Cherry County",5,39,73,34,39
050,31,031,"Nebraska","Cherry County",5,40,68,33,35
050,31,031,"Nebraska","Cherry County",5,41,76,43,33
050,31,031,"Nebraska","Cherry County",5,42,74,40,34
050,31,031,"Nebraska","Cherry County",5,43,76,41,35
050,31,031,"Nebraska","Cherry County",5,44,68,37,31
050,31,031,"Nebraska","Cherry County",5,45,64,39,25
050,31,031,"Nebraska","Cherry County",5,46,59,31,28
050,31,031,"Nebraska","Cherry County",5,47,61,33,28
050,31,031,"Nebraska","Cherry County",5,48,60,34,26
050,31,031,"Nebraska","Cherry County",5,49,60,33,27
050,31,031,"Nebraska","Cherry County",5,50,59,31,28
050,31,031,"Nebraska","Cherry County",5,51,59,27,32
050,31,031,"Nebraska","Cherry County",5,52,63,33,30
050,31,031,"Nebraska","Cherry County",5,53,58,32,26
050,31,031,"Nebraska","Cherry County",5,54,67,33,34
050,31,031,"Nebraska","Cherry County",5,55,62,33,29
050,31,031,"Nebraska","Cherry County",5,56,57,26,31
050,31,031,"Nebraska","Cherry County",5,57,60,23,37
050,31,031,"Nebraska","Cherry County",5,58,59,31,28
050,31,031,"Nebraska","Cherry County",5,59,72,34,38
050,31,031,"Nebraska","Cherry County",5,60,62,33,29
050,31,031,"Nebraska","Cherry County",5,61,69,36,33
050,31,031,"Nebraska","Cherry County",5,62,79,39,40
050,31,031,"Nebraska","Cherry County",5,63,93,48,45
050,31,031,"Nebraska","Cherry County",5,64,79,40,39
050,31,031,"Nebraska","Cherry County",5,65,79,40,39
050,31,031,"Nebraska","Cherry County",5,66,89,48,41
050,31,031,"Nebraska","Cherry County",5,67,92,47,45
050,31,031,"Nebraska","Cherry County",5,68,75,38,37
050,31,031,"Nebraska","Cherry County",5,69,74,38,36
050,31,031,"Nebraska","Cherry County",5,70,80,43,37
050,31,031,"Nebraska","Cherry County",5,71,61,31,30
050,31,031,"Nebraska","Cherry County",5,72,59,29,30
050,31,031,"Nebraska","Cherry County",5,73,61,31,30
050,31,031,"Nebraska","Cherry County",5,74,48,24,24
050,31,031,"Nebraska","Cherry County",5,75,53,26,27
050,31,031,"Nebraska","Cherry County",5,76,52,25,27
050,31,031,"Nebraska","Cherry County",5,77,29,11,18
050,31,031,"Nebraska","Cherry County",5,78,41,13,28
050,31,031,"Nebraska","Cherry County",5,79,45,17,28
050,31,031,"Nebraska","Cherry County",5,80,49,24,25
050,31,031,"Nebraska","Cherry County",5,81,28,19,9
050,31,031,"Nebraska","Cherry County",5,82,34,21,13
050,31,031,"Nebraska","Cherry County",5,83,29,19,10
050,31,031,"Nebraska","Cherry County",5,84,30,16,14
050,31,031,"Nebraska","Cherry County",5,85,155,64,91
050,31,033,"Nebraska","Cheyenne County",1,0,108,56,52
050,31,033,"Nebraska","Cheyenne County",1,1,108,52,56
050,31,033,"Nebraska","Cheyenne County",1,2,116,53,63
050,31,033,"Nebraska","Cheyenne County",1,3,133,65,68
050,31,033,"Nebraska","Cheyenne County",1,4,114,62,52
050,31,033,"Nebraska","Cheyenne County",1,5,115,58,57
050,31,033,"Nebraska","Cheyenne County",1,6,136,60,76
050,31,033,"Nebraska","Cheyenne County",1,7,121,60,61
050,31,033,"Nebraska","Cheyenne County",1,8,117,66,51
050,31,033,"Nebraska","Cheyenne County",1,9,124,65,59
050,31,033,"Nebraska","Cheyenne County",1,10,128,71,57
050,31,033,"Nebraska","Cheyenne County",1,11,135,65,70
050,31,033,"Nebraska","Cheyenne County",1,12,128,54,74
050,31,033,"Nebraska","Cheyenne County",1,13,134,67,67
050,31,033,"Nebraska","Cheyenne County",1,14,108,60,48
050,31,033,"Nebraska","Cheyenne County",1,15,118,72,46
050,31,033,"Nebraska","Cheyenne County",1,16,123,67,56
050,31,033,"Nebraska","Cheyenne County",1,17,116,60,56
050,31,033,"Nebraska","Cheyenne County",1,18,119,64,55
050,31,033,"Nebraska","Cheyenne County",1,19,100,45,55
050,31,033,"Nebraska","Cheyenne County",1,20,104,57,47
050,31,033,"Nebraska","Cheyenne County",1,21,89,47,42
050,31,033,"Nebraska","Cheyenne County",1,22,91,49,42
050,31,033,"Nebraska","Cheyenne County",1,23,85,45,40
050,31,033,"Nebraska","Cheyenne County",1,24,93,51,42
050,31,033,"Nebraska","Cheyenne County",1,25,81,39,42
050,31,033,"Nebraska","Cheyenne County",1,26,87,44,43
050,31,033,"Nebraska","Cheyenne County",1,27,94,42,52
050,31,033,"Nebraska","Cheyenne County",1,28,95,47,48
050,31,033,"Nebraska","Cheyenne County",1,29,117,67,50
050,31,033,"Nebraska","Cheyenne County",1,30,135,77,58
050,31,033,"Nebraska","Cheyenne County",1,31,107,54,53
050,31,033,"Nebraska","Cheyenne County",1,32,112,56,56
050,31,033,"Nebraska","Cheyenne County",1,33,107,55,52
050,31,033,"Nebraska","Cheyenne County",1,34,99,44,55
050,31,033,"Nebraska","Cheyenne County",1,35,115,59,56
050,31,033,"Nebraska","Cheyenne County",1,36,129,63,66
050,31,033,"Nebraska","Cheyenne County",1,37,128,64,64
050,31,033,"Nebraska","Cheyenne County",1,38,130,68,62
050,31,033,"Nebraska","Cheyenne County",1,39,119,61,58
050,31,033,"Nebraska","Cheyenne County",1,40,101,55,46
050,31,033,"Nebraska","Cheyenne County",1,41,99,45,54
050,31,033,"Nebraska","Cheyenne County",1,42,97,43,54
050,31,033,"Nebraska","Cheyenne County",1,43,109,53,56
050,31,033,"Nebraska","Cheyenne County",1,44,107,55,52
050,31,033,"Nebraska","Cheyenne County",1,45,105,48,57
050,31,033,"Nebraska","Cheyenne County",1,46,97,50,47
050,31,033,"Nebraska","Cheyenne County",1,47,111,64,47
050,31,033,"Nebraska","Cheyenne County",1,48,119,71,48
050,31,033,"Nebraska","Cheyenne County",1,49,109,54,55
050,31,033,"Nebraska","Cheyenne County",1,50,100,52,48
050,31,033,"Nebraska","Cheyenne County",1,51,96,51,45
050,31,033,"Nebraska","Cheyenne County",1,52,108,56,52
050,31,033,"Nebraska","Cheyenne County",1,53,107,61,46
050,31,033,"Nebraska","Cheyenne County",1,54,101,50,51
050,31,033,"Nebraska","Cheyenne County",1,55,111,60,51
050,31,033,"Nebraska","Cheyenne County",1,56,135,78,57
050,31,033,"Nebraska","Cheyenne County",1,57,143,71,72
050,31,033,"Nebraska","Cheyenne County",1,58,138,70,68
050,31,033,"Nebraska","Cheyenne County",1,59,145,65,80
050,31,033,"Nebraska","Cheyenne County",1,60,156,83,73
050,31,033,"Nebraska","Cheyenne County",1,61,134,77,57
050,31,033,"Nebraska","Cheyenne County",1,62,140,79,61
050,31,033,"Nebraska","Cheyenne County",1,63,145,71,74
050,31,033,"Nebraska","Cheyenne County",1,64,146,78,68
050,31,033,"Nebraska","Cheyenne County",1,65,132,67,65
050,31,033,"Nebraska","Cheyenne County",1,66,136,62,74
050,31,033,"Nebraska","Cheyenne County",1,67,128,67,61
050,31,033,"Nebraska","Cheyenne County",1,68,136,72,64
050,31,033,"Nebraska","Cheyenne County",1,69,125,58,67
050,31,033,"Nebraska","Cheyenne County",1,70,115,60,55
050,31,033,"Nebraska","Cheyenne County",1,71,113,57,56
050,31,033,"Nebraska","Cheyenne County",1,72,113,54,59
050,31,033,"Nebraska","Cheyenne County",1,73,96,46,50
050,31,033,"Nebraska","Cheyenne County",1,74,68,39,29
050,31,033,"Nebraska","Cheyenne County",1,75,70,36,34
050,31,033,"Nebraska","Cheyenne County",1,76,73,33,40
050,31,033,"Nebraska","Cheyenne County",1,77,65,29,36
050,31,033,"Nebraska","Cheyenne County",1,78,52,23,29
050,31,033,"Nebraska","Cheyenne County",1,79,59,23,36
050,31,033,"Nebraska","Cheyenne County",1,80,50,23,27
050,31,033,"Nebraska","Cheyenne County",1,81,50,21,29
050,31,033,"Nebraska","Cheyenne County",1,82,47,20,27
050,31,033,"Nebraska","Cheyenne County",1,83,41,17,24
050,31,033,"Nebraska","Cheyenne County",1,84,45,17,28
050,31,033,"Nebraska","Cheyenne County",1,85,273,98,175
050,31,033,"Nebraska","Cheyenne County",2,0,101,50,51
050,31,033,"Nebraska","Cheyenne County",2,1,108,51,57
050,31,033,"Nebraska","Cheyenne County",2,2,117,54,63
050,31,033,"Nebraska","Cheyenne County",2,3,129,62,67
050,31,033,"Nebraska","Cheyenne County",2,4,121,64,57
050,31,033,"Nebraska","Cheyenne County",2,5,117,60,57
050,31,033,"Nebraska","Cheyenne County",2,6,135,61,74
050,31,033,"Nebraska","Cheyenne County",2,7,124,60,64
050,31,033,"Nebraska","Cheyenne County",2,8,118,65,53
050,31,033,"Nebraska","Cheyenne County",2,9,122,66,56
050,31,033,"Nebraska","Cheyenne County",2,10,127,69,58
050,31,033,"Nebraska","Cheyenne County",2,11,135,66,69
050,31,033,"Nebraska","Cheyenne County",2,12,131,58,73
050,31,033,"Nebraska","Cheyenne County",2,13,131,63,68
050,31,033,"Nebraska","Cheyenne County",2,14,116,62,54
050,31,033,"Nebraska","Cheyenne County",2,15,114,69,45
050,31,033,"Nebraska","Cheyenne County",2,16,121,67,54
050,31,033,"Nebraska","Cheyenne County",2,17,119,62,57
050,31,033,"Nebraska","Cheyenne County",2,18,114,61,53
050,31,033,"Nebraska","Cheyenne County",2,19,99,47,52
050,31,033,"Nebraska","Cheyenne County",2,20,102,54,48
050,31,033,"Nebraska","Cheyenne County",2,21,90,48,42
050,31,033,"Nebraska","Cheyenne County",2,22,90,48,42
050,31,033,"Nebraska","Cheyenne County",2,23,86,46,40
050,31,033,"Nebraska","Cheyenne County",2,24,91,49,42
050,31,033,"Nebraska","Cheyenne County",2,25,86,43,43
050,31,033,"Nebraska","Cheyenne County",2,26,87,44,43
050,31,033,"Nebraska","Cheyenne County",2,27,94,43,51
050,31,033,"Nebraska","Cheyenne County",2,28,96,47,49
050,31,033,"Nebraska","Cheyenne County",2,29,116,65,51
050,31,033,"Nebraska","Cheyenne County",2,30,132,74,58
050,31,033,"Nebraska","Cheyenne County",2,31,111,57,54
050,31,033,"Nebraska","Cheyenne County",2,32,109,54,55
050,31,033,"Nebraska","Cheyenne County",2,33,107,54,53
050,31,033,"Nebraska","Cheyenne County",2,34,101,47,54
050,31,033,"Nebraska","Cheyenne County",2,35,115,58,57
050,31,033,"Nebraska","Cheyenne County",2,36,123,62,61
050,31,033,"Nebraska","Cheyenne County",2,37,127,63,64
050,31,033,"Nebraska","Cheyenne County",2,38,129,67,62
050,31,033,"Nebraska","Cheyenne County",2,39,119,62,57
050,31,033,"Nebraska","Cheyenne County",2,40,106,56,50
050,31,033,"Nebraska","Cheyenne County",2,41,98,46,52
050,31,033,"Nebraska","Cheyenne County",2,42,98,44,54
050,31,033,"Nebraska","Cheyenne County",2,43,108,53,55
050,31,033,"Nebraska","Cheyenne County",2,44,107,54,53
050,31,033,"Nebraska","Cheyenne County",2,45,104,49,55
050,31,033,"Nebraska","Cheyenne County",2,46,99,50,49
050,31,033,"Nebraska","Cheyenne County",2,47,107,60,47
050,31,033,"Nebraska","Cheyenne County",2,48,119,71,48
050,31,033,"Nebraska","Cheyenne County",2,49,110,58,52
050,31,033,"Nebraska","Cheyenne County",2,50,102,52,50
050,31,033,"Nebraska","Cheyenne County",2,51,97,50,47
050,31,033,"Nebraska","Cheyenne County",2,52,105,55,50
050,31,033,"Nebraska","Cheyenne County",2,53,107,60,47
050,31,033,"Nebraska","Cheyenne County",2,54,105,54,51
050,31,033,"Nebraska","Cheyenne County",2,55,111,59,52
050,31,033,"Nebraska","Cheyenne County",2,56,130,75,55
050,31,033,"Nebraska","Cheyenne County",2,57,142,73,69
050,31,033,"Nebraska","Cheyenne County",2,58,141,70,71
050,31,033,"Nebraska","Cheyenne County",2,59,143,66,77
050,31,033,"Nebraska","Cheyenne County",2,60,153,78,75
050,31,033,"Nebraska","Cheyenne County",2,61,136,77,59
050,31,033,"Nebraska","Cheyenne County",2,62,137,77,60
050,31,033,"Nebraska","Cheyenne County",2,63,148,76,72
050,31,033,"Nebraska","Cheyenne County",2,64,145,76,69
050,31,033,"Nebraska","Cheyenne County",2,65,139,71,68
050,31,033,"Nebraska","Cheyenne County",2,66,134,61,73
050,31,033,"Nebraska","Cheyenne County",2,67,130,67,63
050,31,033,"Nebraska","Cheyenne County",2,68,135,71,64
050,31,033,"Nebraska","Cheyenne County",2,69,129,62,67
050,31,033,"Nebraska","Cheyenne County",2,70,119,60,59
050,31,033,"Nebraska","Cheyenne County",2,71,115,58,57
050,31,033,"Nebraska","Cheyenne County",2,72,111,55,56
050,31,033,"Nebraska","Cheyenne County",2,73,107,52,55
050,31,033,"Nebraska","Cheyenne County",2,74,67,38,29
050,31,033,"Nebraska","Cheyenne County",2,75,70,37,33
050,31,033,"Nebraska","Cheyenne County",2,76,73,35,38
050,31,033,"Nebraska","Cheyenne County",2,77,70,31,39
050,31,033,"Nebraska","Cheyenne County",2,78,55,24,31
050,31,033,"Nebraska","Cheyenne County",2,79,58,23,35
050,31,033,"Nebraska","Cheyenne County",2,80,52,23,29
050,31,033,"Nebraska","Cheyenne County",2,81,49,20,29
050,31,033,"Nebraska","Cheyenne County",2,82,48,21,27
050,31,033,"Nebraska","Cheyenne County",2,83,42,17,25
050,31,033,"Nebraska","Cheyenne County",2,84,41,16,25
050,31,033,"Nebraska","Cheyenne County",2,85,271,96,175
050,31,033,"Nebraska","Cheyenne County",3,0,96,57,39
050,31,033,"Nebraska","Cheyenne County",3,1,118,68,50
050,31,033,"Nebraska","Cheyenne County",3,2,111,51,60
050,31,033,"Nebraska","Cheyenne County",3,3,114,60,54
050,31,033,"Nebraska","Cheyenne County",3,4,128,59,69
050,31,033,"Nebraska","Cheyenne County",3,5,127,65,62
050,31,033,"Nebraska","Cheyenne County",3,6,123,60,63
050,31,033,"Nebraska","Cheyenne County",3,7,124,58,66
050,31,033,"Nebraska","Cheyenne County",3,8,131,69,62
050,31,033,"Nebraska","Cheyenne County",3,9,108,57,51
050,31,033,"Nebraska","Cheyenne County",3,10,129,67,62
050,31,033,"Nebraska","Cheyenne County",3,11,125,68,57
050,31,033,"Nebraska","Cheyenne County",3,12,129,64,65
050,31,033,"Nebraska","Cheyenne County",3,13,127,56,71
050,31,033,"Nebraska","Cheyenne County",3,14,134,65,69
050,31,033,"Nebraska","Cheyenne County",3,15,124,65,59
050,31,033,"Nebraska","Cheyenne County",3,16,128,78,50
050,31,033,"Nebraska","Cheyenne County",3,17,130,69,61
050,31,033,"Nebraska","Cheyenne County",3,18,110,58,52
050,31,033,"Nebraska","Cheyenne County",3,19,90,48,42
050,31,033,"Nebraska","Cheyenne County",3,20,94,50,44
050,31,033,"Nebraska","Cheyenne County",3,21,98,46,52
050,31,033,"Nebraska","Cheyenne County",3,22,92,46,46
050,31,033,"Nebraska","Cheyenne County",3,23,97,48,49
050,31,033,"Nebraska","Cheyenne County",3,24,85,44,41
050,31,033,"Nebraska","Cheyenne County",3,25,89,46,43
050,31,033,"Nebraska","Cheyenne County",3,26,90,44,46
050,31,033,"Nebraska","Cheyenne County",3,27,89,47,42
050,31,033,"Nebraska","Cheyenne County",3,28,92,41,51
050,31,033,"Nebraska","Cheyenne County",3,29,92,44,48
050,31,033,"Nebraska","Cheyenne County",3,30,117,64,53
050,31,033,"Nebraska","Cheyenne County",3,31,119,64,55
050,31,033,"Nebraska","Cheyenne County",3,32,110,54,56
050,31,033,"Nebraska","Cheyenne County",3,33,107,56,51
050,31,033,"Nebraska","Cheyenne County",3,34,114,60,54
050,31,033,"Nebraska","Cheyenne County",3,35,103,50,53
050,31,033,"Nebraska","Cheyenne County",3,36,130,67,63
050,31,033,"Nebraska","Cheyenne County",3,37,118,59,59
050,31,033,"Nebraska","Cheyenne County",3,38,126,61,65
050,31,033,"Nebraska","Cheyenne County",3,39,133,67,66
050,31,033,"Nebraska","Cheyenne County",3,40,131,67,64
050,31,033,"Nebraska","Cheyenne County",3,41,103,55,48
050,31,033,"Nebraska","Cheyenne County",3,42,95,46,49
050,31,033,"Nebraska","Cheyenne County",3,43,101,45,56
050,31,033,"Nebraska","Cheyenne County",3,44,105,51,54
050,31,033,"Nebraska","Cheyenne County",3,45,107,55,52
050,31,033,"Nebraska","Cheyenne County",3,46,110,55,55
050,31,033,"Nebraska","Cheyenne County",3,47,101,53,48
050,31,033,"Nebraska","Cheyenne County",3,48,104,60,44
050,31,033,"Nebraska","Cheyenne County",3,49,118,72,46
050,31,033,"Nebraska","Cheyenne County",3,50,112,61,51
050,31,033,"Nebraska","Cheyenne County",3,51,100,49,51
050,31,033,"Nebraska","Cheyenne County",3,52,98,50,48
050,31,033,"Nebraska","Cheyenne County",3,53,106,56,50
050,31,033,"Nebraska","Cheyenne County",3,54,106,58,48
050,31,033,"Nebraska","Cheyenne County",3,55,108,53,55
050,31,033,"Nebraska","Cheyenne County",3,56,106,56,50
050,31,033,"Nebraska","Cheyenne County",3,57,125,73,52
050,31,033,"Nebraska","Cheyenne County",3,58,142,73,69
050,31,033,"Nebraska","Cheyenne County",3,59,137,64,73
050,31,033,"Nebraska","Cheyenne County",3,60,146,66,80
050,31,033,"Nebraska","Cheyenne County",3,61,145,74,71
050,31,033,"Nebraska","Cheyenne County",3,62,136,75,61
050,31,033,"Nebraska","Cheyenne County",3,63,137,77,60
050,31,033,"Nebraska","Cheyenne County",3,64,151,74,77
050,31,033,"Nebraska","Cheyenne County",3,65,143,74,69
050,31,033,"Nebraska","Cheyenne County",3,66,144,73,71
050,31,033,"Nebraska","Cheyenne County",3,67,134,61,73
050,31,033,"Nebraska","Cheyenne County",3,68,126,63,63
050,31,033,"Nebraska","Cheyenne County",3,69,136,74,62
050,31,033,"Nebraska","Cheyenne County",3,70,121,55,66
050,31,033,"Nebraska","Cheyenne County",3,71,114,58,56
050,31,033,"Nebraska","Cheyenne County",3,72,112,60,52
050,31,033,"Nebraska","Cheyenne County",3,73,109,55,54
050,31,033,"Nebraska","Cheyenne County",3,74,106,50,56
050,31,033,"Nebraska","Cheyenne County",3,75,62,35,27
050,31,033,"Nebraska","Cheyenne County",3,76,71,39,32
050,31,033,"Nebraska","Cheyenne County",3,77,66,28,38
050,31,033,"Nebraska","Cheyenne County",3,78,67,29,38
050,31,033,"Nebraska","Cheyenne County",3,79,53,21,32
050,31,033,"Nebraska","Cheyenne County",3,80,57,23,34
050,31,033,"Nebraska","Cheyenne County",3,81,56,23,33
050,31,033,"Nebraska","Cheyenne County",3,82,48,23,25
050,31,033,"Nebraska","Cheyenne County",3,83,43,18,25
050,31,033,"Nebraska","Cheyenne County",3,84,36,16,20
050,31,033,"Nebraska","Cheyenne County",3,85,263,96,167
050,31,033,"Nebraska","Cheyenne County",4,0,101,51,50
050,31,033,"Nebraska","Cheyenne County",4,1,101,60,41
050,31,033,"Nebraska","Cheyenne County",4,2,120,69,51
050,31,033,"Nebraska","Cheyenne County",4,3,110,52,58
050,31,033,"Nebraska","Cheyenne County",4,4,113,58,55
050,31,033,"Nebraska","Cheyenne County",4,5,126,56,70
050,31,033,"Nebraska","Cheyenne County",4,6,125,66,59
050,31,033,"Nebraska","Cheyenne County",4,7,118,62,56
050,31,033,"Nebraska","Cheyenne County",4,8,130,57,73
050,31,033,"Nebraska","Cheyenne County",4,9,135,65,70
050,31,033,"Nebraska","Cheyenne County",4,10,104,57,47
050,31,033,"Nebraska","Cheyenne County",4,11,134,70,64
050,31,033,"Nebraska","Cheyenne County",4,12,122,72,50
050,31,033,"Nebraska","Cheyenne County",4,13,132,66,66
050,31,033,"Nebraska","Cheyenne County",4,14,131,55,76
050,31,033,"Nebraska","Cheyenne County",4,15,138,70,68
050,31,033,"Nebraska","Cheyenne County",4,16,127,68,59
050,31,033,"Nebraska","Cheyenne County",4,17,125,77,48
050,31,033,"Nebraska","Cheyenne County",4,18,111,62,49
050,31,033,"Nebraska","Cheyenne County",4,19,98,50,48
050,31,033,"Nebraska","Cheyenne County",4,20,92,50,42
050,31,033,"Nebraska","Cheyenne County",4,21,97,52,45
050,31,033,"Nebraska","Cheyenne County",4,22,100,51,49
050,31,033,"Nebraska","Cheyenne County",4,23,92,42,50
050,31,033,"Nebraska","Cheyenne County",4,24,98,54,44
050,31,033,"Nebraska","Cheyenne County",4,25,85,45,40
050,31,033,"Nebraska","Cheyenne County",4,26,96,47,49
050,31,033,"Nebraska","Cheyenne County",4,27,91,40,51
050,31,033,"Nebraska","Cheyenne County",4,28,84,47,37
050,31,033,"Nebraska","Cheyenne County",4,29,99,49,50
050,31,033,"Nebraska","Cheyenne County",4,30,87,41,46
050,31,033,"Nebraska","Cheyenne County",4,31,111,62,49
050,31,033,"Nebraska","Cheyenne County",4,32,110,56,54
050,31,033,"Nebraska","Cheyenne County",4,33,105,53,52
050,31,033,"Nebraska","Cheyenne County",4,34,114,60,54
050,31,033,"Nebraska","Cheyenne County",4,35,119,60,59
050,31,033,"Nebraska","Cheyenne County",4,36,100,46,54
050,31,033,"Nebraska","Cheyenne County",4,37,129,65,64
050,31,033,"Nebraska","Cheyenne County",4,38,126,65,61
050,31,033,"Nebraska","Cheyenne County",4,39,135,67,68
050,31,033,"Nebraska","Cheyenne County",4,40,140,74,66
050,31,033,"Nebraska","Cheyenne County",4,41,133,69,64
050,31,033,"Nebraska","Cheyenne County",4,42,111,59,52
050,31,033,"Nebraska","Cheyenne County",4,43,90,46,44
050,31,033,"Nebraska","Cheyenne County",4,44,106,47,59
050,31,033,"Nebraska","Cheyenne County",4,45,106,54,52
050,31,033,"Nebraska","Cheyenne County",4,46,101,47,54
050,31,033,"Nebraska","Cheyenne County",4,47,110,57,53
050,31,033,"Nebraska","Cheyenne County",4,48,99,53,46
050,31,033,"Nebraska","Cheyenne County",4,49,100,56,44
050,31,033,"Nebraska","Cheyenne County",4,50,114,68,46
050,31,033,"Nebraska","Cheyenne County",4,51,110,60,50
050,31,033,"Nebraska","Cheyenne County",4,52,101,50,51
050,31,033,"Nebraska","Cheyenne County",4,53,94,47,47
050,31,033,"Nebraska","Cheyenne County",4,54,97,50,47
050,31,033,"Nebraska","Cheyenne County",4,55,106,55,51
050,31,033,"Nebraska","Cheyenne County",4,56,112,59,53
050,31,033,"Nebraska","Cheyenne County",4,57,105,55,50
050,31,033,"Nebraska","Cheyenne County",4,58,127,73,54
050,31,033,"Nebraska","Cheyenne County",4,59,144,74,70
050,31,033,"Nebraska","Cheyenne County",4,60,134,62,72
050,31,033,"Nebraska","Cheyenne County",4,61,155,68,87
050,31,033,"Nebraska","Cheyenne County",4,62,151,78,73
050,31,033,"Nebraska","Cheyenne County",4,63,138,75,63
050,31,033,"Nebraska","Cheyenne County",4,64,137,77,60
050,31,033,"Nebraska","Cheyenne County",4,65,150,73,77
050,31,033,"Nebraska","Cheyenne County",4,66,138,73,65
050,31,033,"Nebraska","Cheyenne County",4,67,146,76,70
050,31,033,"Nebraska","Cheyenne County",4,68,130,60,70
050,31,033,"Nebraska","Cheyenne County",4,69,119,61,58
050,31,033,"Nebraska","Cheyenne County",4,70,140,76,64
050,31,033,"Nebraska","Cheyenne County",4,71,112,49,63
050,31,033,"Nebraska","Cheyenne County",4,72,113,58,55
050,31,033,"Nebraska","Cheyenne County",4,73,110,60,50
050,31,033,"Nebraska","Cheyenne County",4,74,106,51,55
050,31,033,"Nebraska","Cheyenne County",4,75,106,50,56
050,31,033,"Nebraska","Cheyenne County",4,76,62,37,25
050,31,033,"Nebraska","Cheyenne County",4,77,72,36,36
050,31,033,"Nebraska","Cheyenne County",4,78,66,27,39
050,31,033,"Nebraska","Cheyenne County",4,79,66,28,38
050,31,033,"Nebraska","Cheyenne County",4,80,53,20,33
050,31,033,"Nebraska","Cheyenne County",4,81,54,22,32
050,31,033,"Nebraska","Cheyenne County",4,82,53,23,30
050,31,033,"Nebraska","Cheyenne County",4,83,42,18,24
050,31,033,"Nebraska","Cheyenne County",4,84,39,17,22
050,31,033,"Nebraska","Cheyenne County",4,85,257,95,162
050,31,033,"Nebraska","Cheyenne County",5,0,103,54,49
050,31,033,"Nebraska","Cheyenne County",5,1,117,51,66
050,31,033,"Nebraska","Cheyenne County",5,2,98,57,41
050,31,033,"Nebraska","Cheyenne County",5,3,112,63,49
050,31,033,"Nebraska","Cheyenne County",5,4,109,50,59
050,31,033,"Nebraska","Cheyenne County",5,5,121,63,58
050,31,033,"Nebraska","Cheyenne County",5,6,129,57,72
050,31,033,"Nebraska","Cheyenne County",5,7,124,63,61
050,31,033,"Nebraska","Cheyenne County",5,8,113,58,55
050,31,033,"Nebraska","Cheyenne County",5,9,136,65,71
050,31,033,"Nebraska","Cheyenne County",5,10,135,63,72
050,31,033,"Nebraska","Cheyenne County",5,11,109,56,53
050,31,033,"Nebraska","Cheyenne County",5,12,141,73,68
050,31,033,"Nebraska","Cheyenne County",5,13,120,70,50
050,31,033,"Nebraska","Cheyenne County",5,14,130,63,67
050,31,033,"Nebraska","Cheyenne County",5,15,131,58,73
050,31,033,"Nebraska","Cheyenne County",5,16,136,65,71
050,31,033,"Nebraska","Cheyenne County",5,17,126,65,61
050,31,033,"Nebraska","Cheyenne County",5,18,112,71,41
050,31,033,"Nebraska","Cheyenne County",5,19,90,49,41
050,31,033,"Nebraska","Cheyenne County",5,20,100,52,48
050,31,033,"Nebraska","Cheyenne County",5,21,96,51,45
050,31,033,"Nebraska","Cheyenne County",5,22,99,51,48
050,31,033,"Nebraska","Cheyenne County",5,23,93,45,48
050,31,033,"Nebraska","Cheyenne County",5,24,106,53,53
050,31,033,"Nebraska","Cheyenne County",5,25,105,57,48
050,31,033,"Nebraska","Cheyenne County",5,26,85,44,41
050,31,033,"Nebraska","Cheyenne County",5,27,97,51,46
050,31,033,"Nebraska","Cheyenne County",5,28,101,48,53
050,31,033,"Nebraska","Cheyenne County",5,29,83,44,39
050,31,033,"Nebraska","Cheyenne County",5,30,94,46,48
050,31,033,"Nebraska","Cheyenne County",5,31,78,35,43
050,31,033,"Nebraska","Cheyenne County",5,32,106,60,46
050,31,033,"Nebraska","Cheyenne County",5,33,107,59,48
050,31,033,"Nebraska","Cheyenne County",5,34,101,49,52
050,31,033,"Nebraska","Cheyenne County",5,35,118,66,52
050,31,033,"Nebraska","Cheyenne County",5,36,118,59,59
050,31,033,"Nebraska","Cheyenne County",5,37,104,49,55
050,31,033,"Nebraska","Cheyenne County",5,38,140,74,66
050,31,033,"Nebraska","Cheyenne County",5,39,130,67,63
050,31,033,"Nebraska","Cheyenne County",5,40,141,71,70
050,31,033,"Nebraska","Cheyenne County",5,41,136,67,69
050,31,033,"Nebraska","Cheyenne County",5,42,129,63,66
050,31,033,"Nebraska","Cheyenne County",5,43,117,64,53
050,31,033,"Nebraska","Cheyenne County",5,44,80,40,40
050,31,033,"Nebraska","Cheyenne County",5,45,107,47,60
050,31,033,"Nebraska","Cheyenne County",5,46,103,52,51
050,31,033,"Nebraska","Cheyenne County",5,47,100,49,51
050,31,033,"Nebraska","Cheyenne County",5,48,110,57,53
050,31,033,"Nebraska","Cheyenne County",5,49,92,50,42
050,31,033,"Nebraska","Cheyenne County",5,50,104,59,45
050,31,033,"Nebraska","Cheyenne County",5,51,106,60,46
050,31,033,"Nebraska","Cheyenne County",5,52,109,63,46
050,31,033,"Nebraska","Cheyenne County",5,53,100,49,51
050,31,033,"Nebraska","Cheyenne County",5,54,100,52,48
050,31,033,"Nebraska","Cheyenne County",5,55,99,55,44
050,31,033,"Nebraska","Cheyenne County",5,56,102,54,48
050,31,033,"Nebraska","Cheyenne County",5,57,107,56,51
050,31,033,"Nebraska","Cheyenne County",5,58,105,58,47
050,31,033,"Nebraska","Cheyenne County",5,59,126,76,50
050,31,033,"Nebraska","Cheyenne County",5,60,144,78,66
050,31,033,"Nebraska","Cheyenne County",5,61,133,61,72
050,31,033,"Nebraska","Cheyenne County",5,62,148,64,84
050,31,033,"Nebraska","Cheyenne County",5,63,153,77,76
050,31,033,"Nebraska","Cheyenne County",5,64,141,74,67
050,31,033,"Nebraska","Cheyenne County",5,65,139,77,62
050,31,033,"Nebraska","Cheyenne County",5,66,147,73,74
050,31,033,"Nebraska","Cheyenne County",5,67,143,72,71
050,31,033,"Nebraska","Cheyenne County",5,68,146,75,71
050,31,033,"Nebraska","Cheyenne County",5,69,131,61,70
050,31,033,"Nebraska","Cheyenne County",5,70,114,59,55
050,31,033,"Nebraska","Cheyenne County",5,71,136,74,62
050,31,033,"Nebraska","Cheyenne County",5,72,116,53,63
050,31,033,"Nebraska","Cheyenne County",5,73,110,57,53
050,31,033,"Nebraska","Cheyenne County",5,74,108,59,49
050,31,033,"Nebraska","Cheyenne County",5,75,105,50,55
050,31,033,"Nebraska","Cheyenne County",5,76,103,51,52
050,31,033,"Nebraska","Cheyenne County",5,77,56,31,25
050,31,033,"Nebraska","Cheyenne County",5,78,67,30,37
050,31,033,"Nebraska","Cheyenne County",5,79,64,26,38
050,31,033,"Nebraska","Cheyenne County",5,80,65,27,38
050,31,033,"Nebraska","Cheyenne County",5,81,46,14,32
050,31,033,"Nebraska","Cheyenne County",5,82,55,23,32
050,31,033,"Nebraska","Cheyenne County",5,83,49,20,29
050,31,033,"Nebraska","Cheyenne County",5,84,41,18,23
050,31,033,"Nebraska","Cheyenne County",5,85,255,94,161
050,31,035,"Nebraska","Clay County",1,0,72,37,35
050,31,035,"Nebraska","Clay County",1,1,69,31,38
050,31,035,"Nebraska","Clay County",1,2,76,36,40
050,31,035,"Nebraska","Clay County",1,3,82,37,45
050,31,035,"Nebraska","Clay County",1,4,87,45,42
050,31,035,"Nebraska","Clay County",1,5,93,43,50
050,31,035,"Nebraska","Clay County",1,6,84,48,36
050,31,035,"Nebraska","Clay County",1,7,77,41,36
050,31,035,"Nebraska","Clay County",1,8,77,46,31
050,31,035,"Nebraska","Clay County",1,9,86,49,37
050,31,035,"Nebraska","Clay County",1,10,76,35,41
050,31,035,"Nebraska","Clay County",1,11,88,43,45
050,31,035,"Nebraska","Clay County",1,12,82,40,42
050,31,035,"Nebraska","Clay County",1,13,81,41,40
050,31,035,"Nebraska","Clay County",1,14,103,51,52
050,31,035,"Nebraska","Clay County",1,15,98,46,52
050,31,035,"Nebraska","Clay County",1,16,83,40,43
050,31,035,"Nebraska","Clay County",1,17,90,49,41
050,31,035,"Nebraska","Clay County",1,18,81,44,37
050,31,035,"Nebraska","Clay County",1,19,58,34,24
050,31,035,"Nebraska","Clay County",1,20,54,27,27
050,31,035,"Nebraska","Clay County",1,21,55,26,29
050,31,035,"Nebraska","Clay County",1,22,53,31,22
050,31,035,"Nebraska","Clay County",1,23,55,27,28
050,31,035,"Nebraska","Clay County",1,24,67,37,30
050,31,035,"Nebraska","Clay County",1,25,71,43,28
050,31,035,"Nebraska","Clay County",1,26,76,39,37
050,31,035,"Nebraska","Clay County",1,27,77,41,36
050,31,035,"Nebraska","Clay County",1,28,73,38,35
050,31,035,"Nebraska","Clay County",1,29,62,29,33
050,31,035,"Nebraska","Clay County",1,30,70,34,36
050,31,035,"Nebraska","Clay County",1,31,60,29,31
050,31,035,"Nebraska","Clay County",1,32,63,35,28
050,31,035,"Nebraska","Clay County",1,33,76,40,36
050,31,035,"Nebraska","Clay County",1,34,73,41,32
050,31,035,"Nebraska","Clay County",1,35,80,49,31
050,31,035,"Nebraska","Clay County",1,36,67,38,29
050,31,035,"Nebraska","Clay County",1,37,62,32,30
050,31,035,"Nebraska","Clay County",1,38,65,31,34
050,31,035,"Nebraska","Clay County",1,39,67,30,37
050,31,035,"Nebraska","Clay County",1,40,63,28,35
050,31,035,"Nebraska","Clay County",1,41,56,30,26
050,31,035,"Nebraska","Clay County",1,42,61,32,29
050,31,035,"Nebraska","Clay County",1,43,61,28,33
050,31,035,"Nebraska","Clay County",1,44,60,29,31
050,31,035,"Nebraska","Clay County",1,45,70,35,35
050,31,035,"Nebraska","Clay County",1,46,65,30,35
050,31,035,"Nebraska","Clay County",1,47,59,26,33
050,31,035,"Nebraska","Clay County",1,48,61,27,34
050,31,035,"Nebraska","Clay County",1,49,69,36,33
050,31,035,"Nebraska","Clay County",1,50,63,37,26
050,31,035,"Nebraska","Clay County",1,51,69,35,34
050,31,035,"Nebraska","Clay County",1,52,67,34,33
050,31,035,"Nebraska","Clay County",1,53,77,42,35
050,31,035,"Nebraska","Clay County",1,54,73,39,34
050,31,035,"Nebraska","Clay County",1,55,73,38,35
050,31,035,"Nebraska","Clay County",1,56,84,42,42
050,31,035,"Nebraska","Clay County",1,57,99,51,48
050,31,035,"Nebraska","Clay County",1,58,98,53,45
050,31,035,"Nebraska","Clay County",1,59,102,55,47
050,31,035,"Nebraska","Clay County",1,60,96,50,46
050,31,035,"Nebraska","Clay County",1,61,86,48,38
050,31,035,"Nebraska","Clay County",1,62,80,42,38
050,31,035,"Nebraska","Clay County",1,63,97,47,50
050,31,035,"Nebraska","Clay County",1,64,105,54,51
050,31,035,"Nebraska","Clay County",1,65,89,42,47
050,31,035,"Nebraska","Clay County",1,66,77,42,35
050,31,035,"Nebraska","Clay County",1,67,69,44,25
050,31,035,"Nebraska","Clay County",1,68,81,47,34
050,31,035,"Nebraska","Clay County",1,69,73,36,37
050,31,035,"Nebraska","Clay County",1,70,70,37,33
050,31,035,"Nebraska","Clay County",1,71,76,38,38
050,31,035,"Nebraska","Clay County",1,72,78,37,41
050,31,035,"Nebraska","Clay County",1,73,72,35,37
050,31,035,"Nebraska","Clay County",1,74,48,26,22
050,31,035,"Nebraska","Clay County",1,75,50,26,24
050,31,035,"Nebraska","Clay County",1,76,45,24,21
050,31,035,"Nebraska","Clay County",1,77,45,24,21
050,31,035,"Nebraska","Clay County",1,78,35,19,16
050,31,035,"Nebraska","Clay County",1,79,35,13,22
050,31,035,"Nebraska","Clay County",1,80,31,13,18
050,31,035,"Nebraska","Clay County",1,81,33,15,18
050,31,035,"Nebraska","Clay County",1,82,30,16,14
050,31,035,"Nebraska","Clay County",1,83,25,14,11
050,31,035,"Nebraska","Clay County",1,84,18,10,8
050,31,035,"Nebraska","Clay County",1,85,156,55,101
050,31,035,"Nebraska","Clay County",2,0,69,35,34
050,31,035,"Nebraska","Clay County",2,1,69,32,37
050,31,035,"Nebraska","Clay County",2,2,74,35,39
050,31,035,"Nebraska","Clay County",2,3,80,37,43
050,31,035,"Nebraska","Clay County",2,4,85,43,42
050,31,035,"Nebraska","Clay County",2,5,91,44,47
050,31,035,"Nebraska","Clay County",2,6,86,47,39
050,31,035,"Nebraska","Clay County",2,7,79,43,36
050,31,035,"Nebraska","Clay County",2,8,75,43,32
050,31,035,"Nebraska","Clay County",2,9,83,47,36
050,31,035,"Nebraska","Clay County",2,10,78,38,40
050,31,035,"Nebraska","Clay County",2,11,85,42,43
050,31,035,"Nebraska","Clay County",2,12,83,40,43
050,31,035,"Nebraska","Clay County",2,13,80,39,41
050,31,035,"Nebraska","Clay County",2,14,100,48,52
050,31,035,"Nebraska","Clay County",2,15,99,48,51
050,31,035,"Nebraska","Clay County",2,16,87,41,46
050,31,035,"Nebraska","Clay County",2,17,89,47,42
050,31,035,"Nebraska","Clay County",2,18,79,44,35
050,31,035,"Nebraska","Clay County",2,19,59,34,25
050,31,035,"Nebraska","Clay County",2,20,56,29,27
050,31,035,"Nebraska","Clay County",2,21,57,28,29
050,31,035,"Nebraska","Clay County",2,22,54,30,24
050,31,035,"Nebraska","Clay County",2,23,57,30,27
050,31,035,"Nebraska","Clay County",2,24,64,35,29
050,31,035,"Nebraska","Clay County",2,25,72,43,29
050,31,035,"Nebraska","Clay County",2,26,77,41,36
050,31,035,"Nebraska","Clay County",2,27,77,41,36
050,31,035,"Nebraska","Clay County",2,28,75,39,36
050,31,035,"Nebraska","Clay County",2,29,65,31,34
050,31,035,"Nebraska","Clay County",2,30,69,33,36
050,31,035,"Nebraska","Clay County",2,31,62,30,32
050,31,035,"Nebraska","Clay County",2,32,62,33,29
050,31,035,"Nebraska","Clay County",2,33,71,38,33
050,31,035,"Nebraska","Clay County",2,34,73,41,32
050,31,035,"Nebraska","Clay County",2,35,81,49,32
050,31,035,"Nebraska","Clay County",2,36,71,41,30
050,31,035,"Nebraska","Clay County",2,37,64,33,31
050,31,035,"Nebraska","Clay County",2,38,65,32,33
050,31,035,"Nebraska","Clay County",2,39,66,29,37
050,31,035,"Nebraska","Clay County",2,40,64,29,35
050,31,035,"Nebraska","Clay County",2,41,57,30,27
050,31,035,"Nebraska","Clay County",2,42,59,31,28
050,31,035,"Nebraska","Clay County",2,43,62,29,33
050,31,035,"Nebraska","Clay County",2,44,59,28,31
050,31,035,"Nebraska","Clay County",2,45,70,34,36
050,31,035,"Nebraska","Clay County",2,46,66,31,35
050,31,035,"Nebraska","Clay County",2,47,59,27,32
050,31,035,"Nebraska","Clay County",2,48,61,28,33
050,31,035,"Nebraska","Clay County",2,49,67,34,33
050,31,035,"Nebraska","Clay County",2,50,65,37,28
050,31,035,"Nebraska","Clay County",2,51,68,35,33
050,31,035,"Nebraska","Clay County",2,52,66,34,32
050,31,035,"Nebraska","Clay County",2,53,75,40,35
050,31,035,"Nebraska","Clay County",2,54,74,40,34
050,31,035,"Nebraska","Clay County",2,55,74,39,35
050,31,035,"Nebraska","Clay County",2,56,82,41,41
050,31,035,"Nebraska","Clay County",2,57,95,49,46
050,31,035,"Nebraska","Clay County",2,58,98,53,45
050,31,035,"Nebraska","Clay County",2,59,102,55,47
050,31,035,"Nebraska","Clay County",2,60,97,51,46
050,31,035,"Nebraska","Clay County",2,61,88,48,40
050,31,035,"Nebraska","Clay County",2,62,81,44,37
050,31,035,"Nebraska","Clay County",2,63,94,46,48
050,31,035,"Nebraska","Clay County",2,64,102,51,51
050,31,035,"Nebraska","Clay County",2,65,91,44,47
050,31,035,"Nebraska","Clay County",2,66,80,42,38
050,31,035,"Nebraska","Clay County",2,67,69,42,27
050,31,035,"Nebraska","Clay County",2,68,79,47,32
050,31,035,"Nebraska","Clay County",2,69,76,39,37
050,31,035,"Nebraska","Clay County",2,70,71,37,34
050,31,035,"Nebraska","Clay County",2,71,73,36,37
050,31,035,"Nebraska","Clay County",2,72,76,37,39
050,31,035,"Nebraska","Clay County",2,73,77,38,39
050,31,035,"Nebraska","Clay County",2,74,50,26,24
050,31,035,"Nebraska","Clay County",2,75,49,25,24
050,31,035,"Nebraska","Clay County",2,76,47,25,22
050,31,035,"Nebraska","Clay County",2,77,45,24,21
050,31,035,"Nebraska","Clay County",2,78,36,19,17
050,31,035,"Nebraska","Clay County",2,79,35,15,20
050,31,035,"Nebraska","Clay County",2,80,32,13,19
050,31,035,"Nebraska","Clay County",2,81,31,13,18
050,31,035,"Nebraska","Clay County",2,82,30,16,14
050,31,035,"Nebraska","Clay County",2,83,25,15,10
050,31,035,"Nebraska","Clay County",2,84,20,11,9
050,31,035,"Nebraska","Clay County",2,85,155,55,100
050,31,035,"Nebraska","Clay County",3,0,76,48,28
050,31,035,"Nebraska","Clay County",3,1,72,35,37
050,31,035,"Nebraska","Clay County",3,2,72,33,39
050,31,035,"Nebraska","Clay County",3,3,68,30,38
050,31,035,"Nebraska","Clay County",3,4,78,34,44
050,31,035,"Nebraska","Clay County",3,5,87,45,42
050,31,035,"Nebraska","Clay County",3,6,97,52,45
050,31,035,"Nebraska","Clay County",3,7,86,47,39
050,31,035,"Nebraska","Clay County",3,8,80,46,34
050,31,035,"Nebraska","Clay County",3,9,74,44,30
050,31,035,"Nebraska","Clay County",3,10,94,54,40
050,31,035,"Nebraska","Clay County",3,11,86,43,43
050,31,035,"Nebraska","Clay County",3,12,85,43,42
050,31,035,"Nebraska","Clay County",3,13,85,39,46
050,31,035,"Nebraska","Clay County",3,14,77,38,39
050,31,035,"Nebraska","Clay County",3,15,104,49,55
050,31,035,"Nebraska","Clay County",3,16,96,49,47
050,31,035,"Nebraska","Clay County",3,17,88,39,49
050,31,035,"Nebraska","Clay County",3,18,81,43,38
050,31,035,"Nebraska","Clay County",3,19,58,31,27
050,31,035,"Nebraska","Clay County",3,20,62,36,26
050,31,035,"Nebraska","Clay County",3,21,59,29,30
050,31,035,"Nebraska","Clay County",3,22,53,29,24
050,31,035,"Nebraska","Clay County",3,23,50,29,21
050,31,035,"Nebraska","Clay County",3,24,53,30,23
050,31,035,"Nebraska","Clay County",3,25,55,28,27
050,31,035,"Nebraska","Clay County",3,26,66,37,29
050,31,035,"Nebraska","Clay County",3,27,77,39,38
050,31,035,"Nebraska","Clay County",3,28,82,44,38
050,31,035,"Nebraska","Clay County",3,29,74,36,38
050,31,035,"Nebraska","Clay County",3,30,62,29,33
050,31,035,"Nebraska","Clay County",3,31,71,35,36
050,31,035,"Nebraska","Clay County",3,32,68,34,34
050,31,035,"Nebraska","Clay County",3,33,64,36,28
050,31,035,"Nebraska","Clay County",3,34,74,41,33
050,31,035,"Nebraska","Clay County",3,35,79,44,35
050,31,035,"Nebraska","Clay County",3,36,83,49,34
050,31,035,"Nebraska","Clay County",3,37,67,38,29
050,31,035,"Nebraska","Clay County",3,38,61,32,29
050,31,035,"Nebraska","Clay County",3,39,71,38,33
050,31,035,"Nebraska","Clay County",3,40,65,27,38
050,31,035,"Nebraska","Clay County",3,41,63,27,36
050,31,035,"Nebraska","Clay County",3,42,62,34,28
050,31,035,"Nebraska","Clay County",3,43,55,29,26
050,31,035,"Nebraska","Clay County",3,44,62,28,34
050,31,035,"Nebraska","Clay County",3,45,64,32,32
050,31,035,"Nebraska","Clay County",3,46,71,33,38
050,31,035,"Nebraska","Clay County",3,47,63,28,35
050,31,035,"Nebraska","Clay County",3,48,54,27,27
050,31,035,"Nebraska","Clay County",3,49,63,28,35
050,31,035,"Nebraska","Clay County",3,50,66,35,31
050,31,035,"Nebraska","Clay County",3,51,64,35,29
050,31,035,"Nebraska","Clay County",3,52,69,36,33
050,31,035,"Nebraska","Clay County",3,53,59,32,27
050,31,035,"Nebraska","Clay County",3,54,72,40,32
050,31,035,"Nebraska","Clay County",3,55,76,42,34
050,31,035,"Nebraska","Clay County",3,56,77,40,37
050,31,035,"Nebraska","Clay County",3,57,80,40,40
050,31,035,"Nebraska","Clay County",3,58,92,46,46
050,31,035,"Nebraska","Clay County",3,59,95,51,44
050,31,035,"Nebraska","Clay County",3,60,105,59,46
050,31,035,"Nebraska","Clay County",3,61,95,50,45
050,31,035,"Nebraska","Clay County",3,62,85,45,40
050,31,035,"Nebraska","Clay County",3,63,81,44,37
050,31,035,"Nebraska","Clay County",3,64,91,45,46
050,31,035,"Nebraska","Clay County",3,65,105,53,52
050,31,035,"Nebraska","Clay County",3,66,86,41,45
050,31,035,"Nebraska","Clay County",3,67,76,38,38
050,31,035,"Nebraska","Clay County",3,68,67,40,27
050,31,035,"Nebraska","Clay County",3,69,78,47,31
050,31,035,"Nebraska","Clay County",3,70,76,39,37
050,31,035,"Nebraska","Clay County",3,71,70,35,35
050,31,035,"Nebraska","Clay County",3,72,71,33,38
050,31,035,"Nebraska","Clay County",3,73,70,35,35
050,31,035,"Nebraska","Clay County",3,74,72,36,36
050,31,035,"Nebraska","Clay County",3,75,47,25,22
050,31,035,"Nebraska","Clay County",3,76,39,18,21
050,31,035,"Nebraska","Clay County",3,77,39,22,17
050,31,035,"Nebraska","Clay County",3,78,44,22,22
050,31,035,"Nebraska","Clay County",3,79,33,16,17
050,31,035,"Nebraska","Clay County",3,80,31,12,19
050,31,035,"Nebraska","Clay County",3,81,28,11,17
050,31,035,"Nebraska","Clay County",3,82,30,12,18
050,31,035,"Nebraska","Clay County",3,83,28,16,12
050,31,035,"Nebraska","Clay County",3,84,16,9,7
050,31,035,"Nebraska","Clay County",3,85,129,49,80
050,31,035,"Nebraska","Clay County",4,0,81,38,43
050,31,035,"Nebraska","Clay County",4,1,84,47,37
050,31,035,"Nebraska","Clay County",4,2,65,31,34
050,31,035,"Nebraska","Clay County",4,3,72,33,39
050,31,035,"Nebraska","Clay County",4,4,76,33,43
050,31,035,"Nebraska","Clay County",4,5,80,37,43
050,31,035,"Nebraska","Clay County",4,6,90,48,42
050,31,035,"Nebraska","Clay County",4,7,91,44,47
050,31,035,"Nebraska","Clay County",4,8,90,49,41
050,31,035,"Nebraska","Clay County",4,9,86,48,38
050,31,035,"Nebraska","Clay County",4,10,68,40,28
050,31,035,"Nebraska","Clay County",4,11,93,56,37
050,31,035,"Nebraska","Clay County",4,12,85,43,42
050,31,035,"Nebraska","Clay County",4,13,81,40,41
050,31,035,"Nebraska","Clay County",4,14,86,43,43
050,31,035,"Nebraska","Clay County",4,15,77,38,39
050,31,035,"Nebraska","Clay County",4,16,105,49,56
050,31,035,"Nebraska","Clay County",4,17,89,45,44
050,31,035,"Nebraska","Clay County",4,18,77,39,38
050,31,035,"Nebraska","Clay County",4,19,56,29,27
050,31,035,"Nebraska","Clay County",4,20,56,31,25
050,31,035,"Nebraska","Clay County",4,21,55,33,22
050,31,035,"Nebraska","Clay County",4,22,56,28,28
050,31,035,"Nebraska","Clay County",4,23,58,30,28
050,31,035,"Nebraska","Clay County",4,24,52,28,24
050,31,035,"Nebraska","Clay County",4,25,60,35,25
050,31,035,"Nebraska","Clay County",4,26,57,29,28
050,31,035,"Nebraska","Clay County",4,27,66,36,30
050,31,035,"Nebraska","Clay County",4,28,79,39,40
050,31,035,"Nebraska","Clay County",4,29,82,47,35
050,31,035,"Nebraska","Clay County",4,30,76,36,40
050,31,035,"Nebraska","Clay County",4,31,75,38,37
050,31,035,"Nebraska","Clay County",4,32,74,38,36
050,31,035,"Nebraska","Clay County",4,33,65,35,30
050,31,035,"Nebraska","Clay County",4,34,62,31,31
050,31,035,"Nebraska","Clay County",4,35,75,42,33
050,31,035,"Nebraska","Clay County",4,36,86,48,38
050,31,035,"Nebraska","Clay County",4,37,88,52,36
050,31,035,"Nebraska","Clay County",4,38,64,36,28
050,31,035,"Nebraska","Clay County",4,39,63,33,30
050,31,035,"Nebraska","Clay County",4,40,72,40,32
050,31,035,"Nebraska","Clay County",4,41,67,29,38
050,31,035,"Nebraska","Clay County",4,42,66,28,38
050,31,035,"Nebraska","Clay County",4,43,59,31,28
050,31,035,"Nebraska","Clay County",4,44,56,29,27
050,31,035,"Nebraska","Clay County",4,45,61,28,33
050,31,035,"Nebraska","Clay County",4,46,65,33,32
050,31,035,"Nebraska","Clay County",4,47,70,32,38
050,31,035,"Nebraska","Clay County",4,48,62,29,33
050,31,035,"Nebraska","Clay County",4,49,54,28,26
050,31,035,"Nebraska","Clay County",4,50,64,27,37
050,31,035,"Nebraska","Clay County",4,51,64,31,33
050,31,035,"Nebraska","Clay County",4,52,58,33,25
050,31,035,"Nebraska","Clay County",4,53,68,36,32
050,31,035,"Nebraska","Clay County",4,54,62,33,29
050,31,035,"Nebraska","Clay County",4,55,73,41,32
050,31,035,"Nebraska","Clay County",4,56,79,44,35
050,31,035,"Nebraska","Clay County",4,57,82,43,39
050,31,035,"Nebraska","Clay County",4,58,81,41,40
050,31,035,"Nebraska","Clay County",4,59,88,44,44
050,31,035,"Nebraska","Clay County",4,60,95,49,46
050,31,035,"Nebraska","Clay County",4,61,105,58,47
050,31,035,"Nebraska","Clay County",4,62,95,50,45
050,31,035,"Nebraska","Clay County",4,63,85,43,42
050,31,035,"Nebraska","Clay County",4,64,78,44,34
050,31,035,"Nebraska","Clay County",4,65,95,48,47
050,31,035,"Nebraska","Clay County",4,66,103,53,50
050,31,035,"Nebraska","Clay County",4,67,82,37,45
050,31,035,"Nebraska","Clay County",4,68,79,40,39
050,31,035,"Nebraska","Clay County",4,69,66,39,27
050,31,035,"Nebraska","Clay County",4,70,77,47,30
050,31,035,"Nebraska","Clay County",4,71,72,36,36
050,31,035,"Nebraska","Clay County",4,72,67,34,33
050,31,035,"Nebraska","Clay County",4,73,64,31,33
050,31,035,"Nebraska","Clay County",4,74,63,33,30
050,31,035,"Nebraska","Clay County",4,75,66,30,36
050,31,035,"Nebraska","Clay County",4,76,42,22,20
050,31,035,"Nebraska","Clay County",4,77,38,16,22
050,31,035,"Nebraska","Clay County",4,78,40,22,18
050,31,035,"Nebraska","Clay County",4,79,45,23,22
050,31,035,"Nebraska","Clay County",4,80,31,15,16
050,31,035,"Nebraska","Clay County",4,81,29,11,18
050,31,035,"Nebraska","Clay County",4,82,25,9,16
050,31,035,"Nebraska","Clay County",4,83,29,12,17
050,31,035,"Nebraska","Clay County",4,84,21,12,9
050,31,035,"Nebraska","Clay County",4,85,125,47,78
050,31,035,"Nebraska","Clay County",5,0,79,39,40
050,31,035,"Nebraska","Clay County",5,1,101,60,41
050,31,035,"Nebraska","Clay County",5,2,93,52,41
050,31,035,"Nebraska","Clay County",5,3,71,34,37
050,31,035,"Nebraska","Clay County",5,4,74,33,41
050,31,035,"Nebraska","Clay County",5,5,71,34,37
050,31,035,"Nebraska","Clay County",5,6,84,38,46
050,31,035,"Nebraska","Clay County",5,7,105,54,51
050,31,035,"Nebraska","Clay County",5,8,89,45,44
050,31,035,"Nebraska","Clay County",5,9,91,48,43
050,31,035,"Nebraska","Clay County",5,10,86,47,39
050,31,035,"Nebraska","Clay County",5,11,78,46,32
050,31,035,"Nebraska","Clay County",5,12,95,58,37
050,31,035,"Nebraska","Clay County",5,13,86,46,40
050,31,035,"Nebraska","Clay County",5,14,85,44,41
050,31,035,"Nebraska","Clay County",5,15,89,43,46
050,31,035,"Nebraska","Clay County",5,16,79,40,39
050,31,035,"Nebraska","Clay County",5,17,101,47,54
050,31,035,"Nebraska","Clay County",5,18,78,42,36
050,31,035,"Nebraska","Clay County",5,19,56,30,26
050,31,035,"Nebraska","Clay County",5,20,58,30,28
050,31,035,"Nebraska","Clay County",5,21,60,31,29
050,31,035,"Nebraska","Clay County",5,22,48,29,19
050,31,035,"Nebraska","Clay County",5,23,62,33,29
050,31,035,"Nebraska","Clay County",5,24,57,31,26
050,31,035,"Nebraska","Clay County",5,25,55,25,30
050,31,035,"Nebraska","Clay County",5,26,67,40,27
050,31,035,"Nebraska","Clay County",5,27,58,27,31
050,31,035,"Nebraska","Clay County",5,28,59,32,27
050,31,035,"Nebraska","Clay County",5,29,79,39,40
050,31,035,"Nebraska","Clay County",5,30,82,46,36
050,31,035,"Nebraska","Clay County",5,31,79,37,42
050,31,035,"Nebraska","Clay County",5,32,81,45,36
050,31,035,"Nebraska","Clay County",5,33,70,39,31
050,31,035,"Nebraska","Clay County",5,34,76,41,35
050,31,035,"Nebraska","Clay County",5,35,59,31,28
050,31,035,"Nebraska","Clay County",5,36,74,42,32
050,31,035,"Nebraska","Clay County",5,37,87,47,40
050,31,035,"Nebraska","Clay County",5,38,89,52,37
050,31,035,"Nebraska","Clay County",5,39,65,35,30
050,31,035,"Nebraska","Clay County",5,40,62,32,30
050,31,035,"Nebraska","Clay County",5,41,69,36,33
050,31,035,"Nebraska","Clay County",5,42,69,32,37
050,31,035,"Nebraska","Clay County",5,43,66,30,36
050,31,035,"Nebraska","Clay County",5,44,63,33,30
050,31,035,"Nebraska","Clay County",5,45,54,27,27
050,31,035,"Nebraska","Clay County",5,46,62,32,30
050,31,035,"Nebraska","Clay County",5,47,63,32,31
050,31,035,"Nebraska","Clay County",5,48,73,35,38
050,31,035,"Nebraska","Clay County",5,49,61,29,32
050,31,035,"Nebraska","Clay County",5,50,55,28,27
050,31,035,"Nebraska","Clay County",5,51,67,30,37
050,31,035,"Nebraska","Clay County",5,52,65,32,33
050,31,035,"Nebraska","Clay County",5,53,61,36,25
050,31,035,"Nebraska","Clay County",5,54,68,36,32
050,31,035,"Nebraska","Clay County",5,55,64,34,30
050,31,035,"Nebraska","Clay County",5,56,72,41,31
050,31,035,"Nebraska","Clay County",5,57,78,43,35
050,31,035,"Nebraska","Clay County",5,58,81,43,38
050,31,035,"Nebraska","Clay County",5,59,75,36,39
050,31,035,"Nebraska","Clay County",5,60,88,43,45
050,31,035,"Nebraska","Clay County",5,61,98,47,51
050,31,035,"Nebraska","Clay County",5,62,100,54,46
050,31,035,"Nebraska","Clay County",5,63,91,48,43
050,31,035,"Nebraska","Clay County",5,64,80,43,37
050,31,035,"Nebraska","Clay County",5,65,78,44,34
050,31,035,"Nebraska","Clay County",5,66,91,45,46
050,31,035,"Nebraska","Clay County",5,67,100,50,50
050,31,035,"Nebraska","Clay County",5,68,79,35,44
050,31,035,"Nebraska","Clay County",5,69,76,39,37
050,31,035,"Nebraska","Clay County",5,70,65,38,27
050,31,035,"Nebraska","Clay County",5,71,76,45,31
050,31,035,"Nebraska","Clay County",5,72,70,35,35
050,31,035,"Nebraska","Clay County",5,73,63,34,29
050,31,035,"Nebraska","Clay County",5,74,63,33,30
050,31,035,"Nebraska","Clay County",5,75,62,31,31
050,31,035,"Nebraska","Clay County",5,76,62,28,34
050,31,035,"Nebraska","Clay County",5,77,40,20,20
050,31,035,"Nebraska","Clay County",5,78,36,15,21
050,31,035,"Nebraska","Clay County",5,79,42,24,18
050,31,035,"Nebraska","Clay County",5,80,43,22,21
050,31,035,"Nebraska","Clay County",5,81,29,14,15
050,31,035,"Nebraska","Clay County",5,82,27,10,17
050,31,035,"Nebraska","Clay County",5,83,24,8,16
050,31,035,"Nebraska","Clay County",5,84,22,8,14
050,31,035,"Nebraska","Clay County",5,85,127,47,80
050,31,037,"Nebraska","Colfax County",1,0,193,97,96
050,31,037,"Nebraska","Colfax County",1,1,179,90,89
050,31,037,"Nebraska","Colfax County",1,2,187,91,96
050,31,037,"Nebraska","Colfax County",1,3,186,77,109
050,31,037,"Nebraska","Colfax County",1,4,200,78,122
050,31,037,"Nebraska","Colfax County",1,5,189,100,89
050,31,037,"Nebraska","Colfax County",1,6,175,86,89
050,31,037,"Nebraska","Colfax County",1,7,159,72,87
050,31,037,"Nebraska","Colfax County",1,8,151,76,75
050,31,037,"Nebraska","Colfax County",1,9,172,77,95
050,31,037,"Nebraska","Colfax County",1,10,183,79,104
050,31,037,"Nebraska","Colfax County",1,11,202,92,110
050,31,037,"Nebraska","Colfax County",1,12,193,93,100
050,31,037,"Nebraska","Colfax County",1,13,184,93,91
050,31,037,"Nebraska","Colfax County",1,14,186,84,102
050,31,037,"Nebraska","Colfax County",1,15,162,88,74
050,31,037,"Nebraska","Colfax County",1,16,174,96,78
050,31,037,"Nebraska","Colfax County",1,17,172,94,78
050,31,037,"Nebraska","Colfax County",1,18,143,79,64
050,31,037,"Nebraska","Colfax County",1,19,121,76,45
050,31,037,"Nebraska","Colfax County",1,20,129,81,48
050,31,037,"Nebraska","Colfax County",1,21,124,71,53
050,31,037,"Nebraska","Colfax County",1,22,120,70,50
050,31,037,"Nebraska","Colfax County",1,23,117,70,47
050,31,037,"Nebraska","Colfax County",1,24,116,71,45
050,31,037,"Nebraska","Colfax County",1,25,118,67,51
050,31,037,"Nebraska","Colfax County",1,26,124,66,58
050,31,037,"Nebraska","Colfax County",1,27,117,73,44
050,31,037,"Nebraska","Colfax County",1,28,98,51,47
050,31,037,"Nebraska","Colfax County",1,29,122,66,56
050,31,037,"Nebraska","Colfax County",1,30,111,63,48
050,31,037,"Nebraska","Colfax County",1,31,114,60,54
050,31,037,"Nebraska","Colfax County",1,32,130,76,54
050,31,037,"Nebraska","Colfax County",1,33,126,77,49
050,31,037,"Nebraska","Colfax County",1,34,143,87,56
050,31,037,"Nebraska","Colfax County",1,35,151,95,56
050,31,037,"Nebraska","Colfax County",1,36,163,90,73
050,31,037,"Nebraska","Colfax County",1,37,143,83,60
050,31,037,"Nebraska","Colfax County",1,38,155,99,56
050,31,037,"Nebraska","Colfax County",1,39,152,110,42
050,31,037,"Nebraska","Colfax County",1,40,152,109,43
050,31,037,"Nebraska","Colfax County",1,41,140,84,56
050,31,037,"Nebraska","Colfax County",1,42,140,87,53
050,31,037,"Nebraska","Colfax County",1,43,131,79,52
050,31,037,"Nebraska","Colfax County",1,44,113,62,51
050,31,037,"Nebraska","Colfax County",1,45,113,58,55
050,31,037,"Nebraska","Colfax County",1,46,122,70,52
050,31,037,"Nebraska","Colfax County",1,47,119,67,52
050,31,037,"Nebraska","Colfax County",1,48,126,66,60
050,31,037,"Nebraska","Colfax County",1,49,113,62,51
050,31,037,"Nebraska","Colfax County",1,50,110,62,48
050,31,037,"Nebraska","Colfax County",1,51,111,65,46
050,31,037,"Nebraska","Colfax County",1,52,119,67,52
050,31,037,"Nebraska","Colfax County",1,53,105,64,41
050,31,037,"Nebraska","Colfax County",1,54,107,60,47
050,31,037,"Nebraska","Colfax County",1,55,124,77,47
050,31,037,"Nebraska","Colfax County",1,56,148,98,50
050,31,037,"Nebraska","Colfax County",1,57,140,84,56
050,31,037,"Nebraska","Colfax County",1,58,123,68,55
050,31,037,"Nebraska","Colfax County",1,59,135,73,62
050,31,037,"Nebraska","Colfax County",1,60,139,76,63
050,31,037,"Nebraska","Colfax County",1,61,130,67,63
050,31,037,"Nebraska","Colfax County",1,62,114,58,56
050,31,037,"Nebraska","Colfax County",1,63,118,57,61
050,31,037,"Nebraska","Colfax County",1,64,110,56,54
050,31,037,"Nebraska","Colfax County",1,65,99,51,48
050,31,037,"Nebraska","Colfax County",1,66,105,58,47
050,31,037,"Nebraska","Colfax County",1,67,97,46,51
050,31,037,"Nebraska","Colfax County",1,68,92,49,43
050,31,037,"Nebraska","Colfax County",1,69,80,43,37
050,31,037,"Nebraska","Colfax County",1,70,73,41,32
050,31,037,"Nebraska","Colfax County",1,71,63,34,29
050,31,037,"Nebraska","Colfax County",1,72,68,34,34
050,31,037,"Nebraska","Colfax County",1,73,65,37,28
050,31,037,"Nebraska","Colfax County",1,74,51,25,26
050,31,037,"Nebraska","Colfax County",1,75,59,32,27
050,31,037,"Nebraska","Colfax County",1,76,48,25,23
050,31,037,"Nebraska","Colfax County",1,77,50,26,24
050,31,037,"Nebraska","Colfax County",1,78,46,27,19
050,31,037,"Nebraska","Colfax County",1,79,38,19,19
050,31,037,"Nebraska","Colfax County",1,80,41,16,25
050,31,037,"Nebraska","Colfax County",1,81,29,12,17
050,31,037,"Nebraska","Colfax County",1,82,32,17,15
050,31,037,"Nebraska","Colfax County",1,83,31,14,17
050,31,037,"Nebraska","Colfax County",1,84,32,15,17
050,31,037,"Nebraska","Colfax County",1,85,195,68,127
050,31,037,"Nebraska","Colfax County",2,0,200,107,93
050,31,037,"Nebraska","Colfax County",2,1,179,91,88
050,31,037,"Nebraska","Colfax County",2,2,183,89,94
050,31,037,"Nebraska","Colfax County",2,3,185,79,106
050,31,037,"Nebraska","Colfax County",2,4,193,77,116
050,31,037,"Nebraska","Colfax County",2,5,192,94,98
050,31,037,"Nebraska","Colfax County",2,6,179,90,89
050,31,037,"Nebraska","Colfax County",2,7,161,75,86
050,31,037,"Nebraska","Colfax County",2,8,153,74,79
050,31,037,"Nebraska","Colfax County",2,9,164,75,89
050,31,037,"Nebraska","Colfax County",2,10,180,78,102
050,31,037,"Nebraska","Colfax County",2,11,194,86,108
050,31,037,"Nebraska","Colfax County",2,12,195,93,102
050,31,037,"Nebraska","Colfax County",2,13,187,93,94
050,31,037,"Nebraska","Colfax County",2,14,183,85,98
050,31,037,"Nebraska","Colfax County",2,15,166,87,79
050,31,037,"Nebraska","Colfax County",2,16,171,93,78
050,31,037,"Nebraska","Colfax County",2,17,170,93,77
050,31,037,"Nebraska","Colfax County",2,18,143,80,63
050,31,037,"Nebraska","Colfax County",2,19,125,75,50
050,31,037,"Nebraska","Colfax County",2,20,129,82,47
050,31,037,"Nebraska","Colfax County",2,21,127,75,52
050,31,037,"Nebraska","Colfax County",2,22,119,70,49
050,31,037,"Nebraska","Colfax County",2,23,117,69,48
050,31,037,"Nebraska","Colfax County",2,24,111,68,43
050,31,037,"Nebraska","Colfax County",2,25,115,66,49
050,31,037,"Nebraska","Colfax County",2,26,122,68,54
050,31,037,"Nebraska","Colfax County",2,27,118,71,47
050,31,037,"Nebraska","Colfax County",2,28,105,58,47
050,31,037,"Nebraska","Colfax County",2,29,115,63,52
050,31,037,"Nebraska","Colfax County",2,30,113,63,50
050,31,037,"Nebraska","Colfax County",2,31,115,61,54
050,31,037,"Nebraska","Colfax County",2,32,125,72,53
050,31,037,"Nebraska","Colfax County",2,33,124,75,49
050,31,037,"Nebraska","Colfax County",2,34,140,85,55
050,31,037,"Nebraska","Colfax County",2,35,151,94,57
050,31,037,"Nebraska","Colfax County",2,36,160,91,69
050,31,037,"Nebraska","Colfax County",2,37,147,85,62
050,31,037,"Nebraska","Colfax County",2,38,153,96,57
050,31,037,"Nebraska","Colfax County",2,39,150,107,43
050,31,037,"Nebraska","Colfax County",2,40,149,106,43
050,31,037,"Nebraska","Colfax County",2,41,141,89,52
050,31,037,"Nebraska","Colfax County",2,42,141,86,55
050,31,037,"Nebraska","Colfax County",2,43,132,80,52
050,31,037,"Nebraska","Colfax County",2,44,115,65,50
050,31,037,"Nebraska","Colfax County",2,45,114,60,54
050,31,037,"Nebraska","Colfax County",2,46,119,67,52
050,31,037,"Nebraska","Colfax County",2,47,120,68,52
050,31,037,"Nebraska","Colfax County",2,48,124,65,59
050,31,037,"Nebraska","Colfax County",2,49,116,63,53
050,31,037,"Nebraska","Colfax County",2,50,109,61,48
050,31,037,"Nebraska","Colfax County",2,51,107,62,45
050,31,037,"Nebraska","Colfax County",2,52,117,67,50
050,31,037,"Nebraska","Colfax County",2,53,107,64,43
050,31,037,"Nebraska","Colfax County",2,54,106,60,46
050,31,037,"Nebraska","Colfax County",2,55,119,72,47
050,31,037,"Nebraska","Colfax County",2,56,145,96,49
050,31,037,"Nebraska","Colfax County",2,57,141,85,56
050,31,037,"Nebraska","Colfax County",2,58,128,72,56
050,31,037,"Nebraska","Colfax County",2,59,133,72,61
050,31,037,"Nebraska","Colfax County",2,60,140,76,64
050,31,037,"Nebraska","Colfax County",2,61,130,68,62
050,31,037,"Nebraska","Colfax County",2,62,118,60,58
050,31,037,"Nebraska","Colfax County",2,63,118,58,60
050,31,037,"Nebraska","Colfax County",2,64,110,55,55
050,31,037,"Nebraska","Colfax County",2,65,101,51,50
050,31,037,"Nebraska","Colfax County",2,66,102,56,46
050,31,037,"Nebraska","Colfax County",2,67,97,49,48
050,31,037,"Nebraska","Colfax County",2,68,93,48,45
050,31,037,"Nebraska","Colfax County",2,69,83,45,38
050,31,037,"Nebraska","Colfax County",2,70,74,41,33
050,31,037,"Nebraska","Colfax County",2,71,63,34,29
050,31,037,"Nebraska","Colfax County",2,72,66,33,33
050,31,037,"Nebraska","Colfax County",2,73,69,38,31
050,31,037,"Nebraska","Colfax County",2,74,51,26,25
050,31,037,"Nebraska","Colfax County",2,75,56,30,26
050,31,037,"Nebraska","Colfax County",2,76,50,27,23
050,31,037,"Nebraska","Colfax County",2,77,50,26,24
050,31,037,"Nebraska","Colfax County",2,78,46,26,20
050,31,037,"Nebraska","Colfax County",2,79,39,20,19
050,31,037,"Nebraska","Colfax County",2,80,40,16,24
050,31,037,"Nebraska","Colfax County",2,81,32,13,19
050,31,037,"Nebraska","Colfax County",2,82,30,16,14
050,31,037,"Nebraska","Colfax County",2,83,30,14,16
050,31,037,"Nebraska","Colfax County",2,84,31,15,16
050,31,037,"Nebraska","Colfax County",2,85,196,68,128
050,31,037,"Nebraska","Colfax County",3,0,176,84,92
050,31,037,"Nebraska","Colfax County",3,1,191,111,80
050,31,037,"Nebraska","Colfax County",3,2,169,84,85
050,31,037,"Nebraska","Colfax County",3,3,180,90,90
050,31,037,"Nebraska","Colfax County",3,4,187,85,102
050,31,037,"Nebraska","Colfax County",3,5,195,79,116
050,31,037,"Nebraska","Colfax County",3,6,195,92,103
050,31,037,"Nebraska","Colfax County",3,7,164,78,86
050,31,037,"Nebraska","Colfax County",3,8,155,72,83
050,31,037,"Nebraska","Colfax County",3,9,156,75,81
050,31,037,"Nebraska","Colfax County",3,10,158,69,89
050,31,037,"Nebraska","Colfax County",3,11,177,75,102
050,31,037,"Nebraska","Colfax County",3,12,193,86,107
050,31,037,"Nebraska","Colfax County",3,13,198,98,100
050,31,037,"Nebraska","Colfax County",3,14,184,92,92
050,31,037,"Nebraska","Colfax County",3,15,183,83,100
050,31,037,"Nebraska","Colfax County",3,16,170,94,76
050,31,037,"Nebraska","Colfax County",3,17,165,93,72
050,31,037,"Nebraska","Colfax County",3,18,161,94,67
050,31,037,"Nebraska","Colfax County",3,19,123,69,54
050,31,037,"Nebraska","Colfax County",3,20,132,78,54
050,31,037,"Nebraska","Colfax County",3,21,140,87,53
050,31,037,"Nebraska","Colfax County",3,22,125,73,52
050,31,037,"Nebraska","Colfax County",3,23,116,64,52
050,31,037,"Nebraska","Colfax County",3,24,114,64,50
050,31,037,"Nebraska","Colfax County",3,25,92,58,34
050,31,037,"Nebraska","Colfax County",3,26,106,67,39
050,31,037,"Nebraska","Colfax County",3,27,109,58,51
050,31,037,"Nebraska","Colfax County",3,28,122,72,50
050,31,037,"Nebraska","Colfax County",3,29,108,55,53
050,31,037,"Nebraska","Colfax County",3,30,105,58,47
050,31,037,"Nebraska","Colfax County",3,31,106,57,49
050,31,037,"Nebraska","Colfax County",3,32,115,61,54
050,31,037,"Nebraska","Colfax County",3,33,121,70,51
050,31,037,"Nebraska","Colfax County",3,34,118,68,50
050,31,037,"Nebraska","Colfax County",3,35,129,76,53
050,31,037,"Nebraska","Colfax County",3,36,147,89,58
050,31,037,"Nebraska","Colfax County",3,37,158,90,68
050,31,037,"Nebraska","Colfax County",3,38,142,82,60
050,31,037,"Nebraska","Colfax County",3,39,151,95,56
050,31,037,"Nebraska","Colfax County",3,40,148,102,46
050,31,037,"Nebraska","Colfax County",3,41,147,102,45
050,31,037,"Nebraska","Colfax County",3,42,142,88,54
050,31,037,"Nebraska","Colfax County",3,43,139,86,53
050,31,037,"Nebraska","Colfax County",3,44,134,85,49
050,31,037,"Nebraska","Colfax County",3,45,108,61,47
050,31,037,"Nebraska","Colfax County",3,46,116,61,55
050,31,037,"Nebraska","Colfax County",3,47,122,69,53
050,31,037,"Nebraska","Colfax County",3,48,123,70,53
050,31,037,"Nebraska","Colfax County",3,49,119,63,56
050,31,037,"Nebraska","Colfax County",3,50,115,62,53
050,31,037,"Nebraska","Colfax County",3,51,111,60,51
050,31,037,"Nebraska","Colfax County",3,52,114,68,46
050,31,037,"Nebraska","Colfax County",3,53,112,63,49
050,31,037,"Nebraska","Colfax County",3,54,108,65,43
050,31,037,"Nebraska","Colfax County",3,55,104,61,43
050,31,037,"Nebraska","Colfax County",3,56,122,74,48
050,31,037,"Nebraska","Colfax County",3,57,137,88,49
050,31,037,"Nebraska","Colfax County",3,58,145,87,58
050,31,037,"Nebraska","Colfax County",3,59,123,69,54
050,31,037,"Nebraska","Colfax County",3,60,122,63,59
050,31,037,"Nebraska","Colfax County",3,61,142,78,64
050,31,037,"Nebraska","Colfax County",3,62,125,65,60
050,31,037,"Nebraska","Colfax County",3,63,116,61,55
050,31,037,"Nebraska","Colfax County",3,64,116,57,59
050,31,037,"Nebraska","Colfax County",3,65,110,53,57
050,31,037,"Nebraska","Colfax County",3,66,101,50,51
050,31,037,"Nebraska","Colfax County",3,67,97,53,44
050,31,037,"Nebraska","Colfax County",3,68,96,49,47
050,31,037,"Nebraska","Colfax County",3,69,88,46,42
050,31,037,"Nebraska","Colfax County",3,70,83,46,37
050,31,037,"Nebraska","Colfax County",3,71,72,40,32
050,31,037,"Nebraska","Colfax County",3,72,62,35,27
050,31,037,"Nebraska","Colfax County",3,73,63,33,30
050,31,037,"Nebraska","Colfax County",3,74,68,37,31
050,31,037,"Nebraska","Colfax County",3,75,48,24,24
050,31,037,"Nebraska","Colfax County",3,76,51,26,25
050,31,037,"Nebraska","Colfax County",3,77,48,27,21
050,31,037,"Nebraska","Colfax County",3,78,48,25,23
050,31,037,"Nebraska","Colfax County",3,79,47,25,22
050,31,037,"Nebraska","Colfax County",3,80,38,19,19
050,31,037,"Nebraska","Colfax County",3,81,35,13,22
050,31,037,"Nebraska","Colfax County",3,82,30,11,19
050,31,037,"Nebraska","Colfax County",3,83,27,12,15
050,31,037,"Nebraska","Colfax County",3,84,26,12,14
050,31,037,"Nebraska","Colfax County",3,85,193,70,123
050,31,037,"Nebraska","Colfax County",4,0,161,75,86
050,31,037,"Nebraska","Colfax County",4,1,196,96,100
050,31,037,"Nebraska","Colfax County",4,2,175,100,75
050,31,037,"Nebraska","Colfax County",4,3,165,82,83
050,31,037,"Nebraska","Colfax County",4,4,178,85,93
050,31,037,"Nebraska","Colfax County",4,5,164,67,97
050,31,037,"Nebraska","Colfax County",4,6,201,78,123
050,31,037,"Nebraska","Colfax County",4,7,197,90,107
050,31,037,"Nebraska","Colfax County",4,8,147,68,79
050,31,037,"Nebraska","Colfax County",4,9,165,74,91
050,31,037,"Nebraska","Colfax County",4,10,157,79,78
050,31,037,"Nebraska","Colfax County",4,11,167,74,93
050,31,037,"Nebraska","Colfax County",4,12,164,75,89
050,31,037,"Nebraska","Colfax County",4,13,192,86,106
050,31,037,"Nebraska","Colfax County",4,14,189,93,96
050,31,037,"Nebraska","Colfax County",4,15,188,100,88
050,31,037,"Nebraska","Colfax County",4,16,195,95,100
050,31,037,"Nebraska","Colfax County",4,17,162,95,67
050,31,037,"Nebraska","Colfax County",4,18,153,87,66
050,31,037,"Nebraska","Colfax County",4,19,145,89,56
050,31,037,"Nebraska","Colfax County",4,20,133,70,63
050,31,037,"Nebraska","Colfax County",4,21,130,77,53
050,31,037,"Nebraska","Colfax County",4,22,131,85,46
050,31,037,"Nebraska","Colfax County",4,23,121,77,44
050,31,037,"Nebraska","Colfax County",4,24,111,62,49
050,31,037,"Nebraska","Colfax County",4,25,111,60,51
050,31,037,"Nebraska","Colfax County",4,26,89,52,37
050,31,037,"Nebraska","Colfax County",4,27,102,60,42
050,31,037,"Nebraska","Colfax County",4,28,110,58,52
050,31,037,"Nebraska","Colfax County",4,29,117,66,51
050,31,037,"Nebraska","Colfax County",4,30,111,59,52
050,31,037,"Nebraska","Colfax County",4,31,99,54,45
050,31,037,"Nebraska","Colfax County",4,32,107,61,46
050,31,037,"Nebraska","Colfax County",4,33,121,64,57
050,31,037,"Nebraska","Colfax County",4,34,118,71,47
050,31,037,"Nebraska","Colfax County",4,35,114,64,50
050,31,037,"Nebraska","Colfax County",4,36,122,74,48
050,31,037,"Nebraska","Colfax County",4,37,154,95,59
050,31,037,"Nebraska","Colfax County",4,38,147,82,65
050,31,037,"Nebraska","Colfax County",4,39,147,85,62
050,31,037,"Nebraska","Colfax County",4,40,142,84,58
050,31,037,"Nebraska","Colfax County",4,41,148,100,48
050,31,037,"Nebraska","Colfax County",4,42,139,92,47
050,31,037,"Nebraska","Colfax County",4,43,143,91,52
050,31,037,"Nebraska","Colfax County",4,44,129,77,52
050,31,037,"Nebraska","Colfax County",4,45,120,75,45
050,31,037,"Nebraska","Colfax County",4,46,106,57,49
050,31,037,"Nebraska","Colfax County",4,47,115,61,54
050,31,037,"Nebraska","Colfax County",4,48,128,72,56
050,31,037,"Nebraska","Colfax County",4,49,115,66,49
050,31,037,"Nebraska","Colfax County",4,50,119,62,57
050,31,037,"Nebraska","Colfax County",4,51,122,66,56
050,31,037,"Nebraska","Colfax County",4,52,113,61,52
050,31,037,"Nebraska","Colfax County",4,53,110,66,44
050,31,037,"Nebraska","Colfax County",4,54,113,66,47
050,31,037,"Nebraska","Colfax County",4,55,114,67,47
050,31,037,"Nebraska","Colfax County",4,56,102,58,44
050,31,037,"Nebraska","Colfax County",4,57,130,78,52
050,31,037,"Nebraska","Colfax County",4,58,138,85,53
050,31,037,"Nebraska","Colfax County",4,59,143,85,58
050,31,037,"Nebraska","Colfax County",4,60,122,67,55
050,31,037,"Nebraska","Colfax County",4,61,130,65,65
050,31,037,"Nebraska","Colfax County",4,62,139,76,63
050,31,037,"Nebraska","Colfax County",4,63,121,66,55
050,31,037,"Nebraska","Colfax County",4,64,119,64,55
050,31,037,"Nebraska","Colfax County",4,65,122,58,64
050,31,037,"Nebraska","Colfax County",4,66,106,48,58
050,31,037,"Nebraska","Colfax County",4,67,95,46,49
050,31,037,"Nebraska","Colfax County",4,68,94,50,44
050,31,037,"Nebraska","Colfax County",4,69,92,47,45
050,31,037,"Nebraska","Colfax County",4,70,87,46,41
050,31,037,"Nebraska","Colfax County",4,71,82,45,37
050,31,037,"Nebraska","Colfax County",4,72,67,37,30
050,31,037,"Nebraska","Colfax County",4,73,60,34,26
050,31,037,"Nebraska","Colfax County",4,74,60,32,28
050,31,037,"Nebraska","Colfax County",4,75,66,37,29
050,31,037,"Nebraska","Colfax County",4,76,48,24,24
050,31,037,"Nebraska","Colfax County",4,77,47,26,21
050,31,037,"Nebraska","Colfax County",4,78,47,27,20
050,31,037,"Nebraska","Colfax County",4,79,48,25,23
050,31,037,"Nebraska","Colfax County",4,80,43,21,22
050,31,037,"Nebraska","Colfax County",4,81,34,18,16
050,31,037,"Nebraska","Colfax County",4,82,33,12,21
050,31,037,"Nebraska","Colfax County",4,83,30,10,20
050,31,037,"Nebraska","Colfax County",4,84,23,9,14
050,31,037,"Nebraska","Colfax County",4,85,193,73,120
050,31,037,"Nebraska","Colfax County",5,0,161,76,85
050,31,037,"Nebraska","Colfax County",5,1,184,104,80
050,31,037,"Nebraska","Colfax County",5,2,186,94,92
050,31,037,"Nebraska","Colfax County",5,3,176,105,71
050,31,037,"Nebraska","Colfax County",5,4,166,89,77
050,31,037,"Nebraska","Colfax County",5,5,180,81,99
050,31,037,"Nebraska","Colfax County",5,6,173,64,109
050,31,037,"Nebraska","Colfax County",5,7,204,77,127
050,31,037,"Nebraska","Colfax County",5,8,184,79,105
050,31,037,"Nebraska","Colfax County",5,9,158,68,90
050,31,037,"Nebraska","Colfax County",5,10,161,75,86
050,31,037,"Nebraska","Colfax County",5,11,158,81,77
050,31,037,"Nebraska","Colfax County",5,12,162,75,87
050,31,037,"Nebraska","Colfax County",5,13,160,80,80
050,31,037,"Nebraska","Colfax County",5,14,197,86,111
050,31,037,"Nebraska","Colfax County",5,15,203,110,93
050,31,037,"Nebraska","Colfax County",5,16,206,119,87
050,31,037,"Nebraska","Colfax County",5,17,190,95,95
050,31,037,"Nebraska","Colfax County",5,18,154,91,63
050,31,037,"Nebraska","Colfax County",5,19,139,74,65
050,31,037,"Nebraska","Colfax County",5,20,151,80,71
050,31,037,"Nebraska","Colfax County",5,21,148,75,73
050,31,037,"Nebraska","Colfax County",5,22,136,78,58
050,31,037,"Nebraska","Colfax County",5,23,138,92,46
050,31,037,"Nebraska","Colfax County",5,24,115,74,41
050,31,037,"Nebraska","Colfax County",5,25,111,64,47
050,31,037,"Nebraska","Colfax County",5,26,101,52,49
050,31,037,"Nebraska","Colfax County",5,27,93,53,40
050,31,037,"Nebraska","Colfax County",5,28,101,60,41
050,31,037,"Nebraska","Colfax County",5,29,104,53,51
050,31,037,"Nebraska","Colfax County",5,30,114,65,49
050,31,037,"Nebraska","Colfax County",5,31,113,64,49
050,31,037,"Nebraska","Colfax County",5,32,91,46,45
050,31,037,"Nebraska","Colfax County",5,33,111,63,48
050,31,037,"Nebraska","Colfax County",5,34,123,66,57
050,31,037,"Nebraska","Colfax County",5,35,120,74,46
050,31,037,"Nebraska","Colfax County",5,36,114,65,49
050,31,037,"Nebraska","Colfax County",5,37,127,79,48
050,31,037,"Nebraska","Colfax County",5,38,160,101,59
050,31,037,"Nebraska","Colfax County",5,39,143,78,65
050,31,037,"Nebraska","Colfax County",5,40,136,80,56
050,31,037,"Nebraska","Colfax County",5,41,144,87,57
050,31,037,"Nebraska","Colfax County",5,42,142,97,45
050,31,037,"Nebraska","Colfax County",5,43,139,90,49
050,31,037,"Nebraska","Colfax County",5,44,140,90,50
050,31,037,"Nebraska","Colfax County",5,45,125,75,50
050,31,037,"Nebraska","Colfax County",5,46,125,77,48
050,31,037,"Nebraska","Colfax County",5,47,113,62,51
050,31,037,"Nebraska","Colfax County",5,48,107,53,54
050,31,037,"Nebraska","Colfax County",5,49,123,68,55
050,31,037,"Nebraska","Colfax County",5,50,117,70,47
050,31,037,"Nebraska","Colfax County",5,51,139,72,67
050,31,037,"Nebraska","Colfax County",5,52,124,67,57
050,31,037,"Nebraska","Colfax County",5,53,105,54,51
050,31,037,"Nebraska","Colfax County",5,54,108,64,44
050,31,037,"Nebraska","Colfax County",5,55,114,68,46
050,31,037,"Nebraska","Colfax County",5,56,117,71,46
050,31,037,"Nebraska","Colfax County",5,57,106,61,45
050,31,037,"Nebraska","Colfax County",5,58,127,77,50
050,31,037,"Nebraska","Colfax County",5,59,135,81,54
050,31,037,"Nebraska","Colfax County",5,60,139,82,57
050,31,037,"Nebraska","Colfax County",5,61,122,67,55
050,31,037,"Nebraska","Colfax County",5,62,129,65,64
050,31,037,"Nebraska","Colfax County",5,63,131,72,59
050,31,037,"Nebraska","Colfax County",5,64,119,64,55
050,31,037,"Nebraska","Colfax County",5,65,116,61,55
050,31,037,"Nebraska","Colfax County",5,66,122,57,65
050,31,037,"Nebraska","Colfax County",5,67,105,48,57
050,31,037,"Nebraska","Colfax County",5,68,93,44,49
050,31,037,"Nebraska","Colfax County",5,69,90,49,41
050,31,037,"Nebraska","Colfax County",5,70,94,49,45
050,31,037,"Nebraska","Colfax County",5,71,85,44,41
050,31,037,"Nebraska","Colfax County",5,72,80,45,35
050,31,037,"Nebraska","Colfax County",5,73,65,37,28
050,31,037,"Nebraska","Colfax County",5,74,56,32,24
050,31,037,"Nebraska","Colfax County",5,75,57,31,26
050,31,037,"Nebraska","Colfax County",5,76,63,36,27
050,31,037,"Nebraska","Colfax County",5,77,43,24,19
050,31,037,"Nebraska","Colfax County",5,78,44,25,19
050,31,037,"Nebraska","Colfax County",5,79,46,26,20
050,31,037,"Nebraska","Colfax County",5,80,46,21,25
050,31,037,"Nebraska","Colfax County",5,81,40,21,19
050,31,037,"Nebraska","Colfax County",5,82,30,16,14
050,31,037,"Nebraska","Colfax County",5,83,33,11,22
050,31,037,"Nebraska","Colfax County",5,84,27,9,18
050,31,037,"Nebraska","Colfax County",5,85,189,73,116
050,31,039,"Nebraska","Cuming County",1,0,119,60,59
050,31,039,"Nebraska","Cuming County",1,1,118,56,62
050,31,039,"Nebraska","Cuming County",1,2,123,65,58
050,31,039,"Nebraska","Cuming County",1,3,116,63,53
050,31,039,"Nebraska","Cuming County",1,4,121,63,58
050,31,039,"Nebraska","Cuming County",1,5,138,71,67
050,31,039,"Nebraska","Cuming County",1,6,126,70,56
050,31,039,"Nebraska","Cuming County",1,7,107,56,51
050,31,039,"Nebraska","Cuming County",1,8,120,60,60
050,31,039,"Nebraska","Cuming County",1,9,122,68,54
050,31,039,"Nebraska","Cuming County",1,10,119,57,62
050,31,039,"Nebraska","Cuming County",1,11,126,68,58
050,31,039,"Nebraska","Cuming County",1,12,129,65,64
050,31,039,"Nebraska","Cuming County",1,13,143,73,70
050,31,039,"Nebraska","Cuming County",1,14,135,69,66
050,31,039,"Nebraska","Cuming County",1,15,135,74,61
050,31,039,"Nebraska","Cuming County",1,16,143,69,74
050,31,039,"Nebraska","Cuming County",1,17,150,78,72
050,31,039,"Nebraska","Cuming County",1,18,115,58,57
050,31,039,"Nebraska","Cuming County",1,19,95,46,49
050,31,039,"Nebraska","Cuming County",1,20,96,42,54
050,31,039,"Nebraska","Cuming County",1,21,95,44,51
050,31,039,"Nebraska","Cuming County",1,22,101,54,47
050,31,039,"Nebraska","Cuming County",1,23,98,49,49
050,31,039,"Nebraska","Cuming County",1,24,109,58,51
050,31,039,"Nebraska","Cuming County",1,25,99,51,48
050,31,039,"Nebraska","Cuming County",1,26,93,49,44
050,31,039,"Nebraska","Cuming County",1,27,80,42,38
050,31,039,"Nebraska","Cuming County",1,28,90,47,43
050,31,039,"Nebraska","Cuming County",1,29,92,55,37
050,31,039,"Nebraska","Cuming County",1,30,93,45,48
050,31,039,"Nebraska","Cuming County",1,31,89,47,42
050,31,039,"Nebraska","Cuming County",1,32,91,47,44
050,31,039,"Nebraska","Cuming County",1,33,85,35,50
050,31,039,"Nebraska","Cuming County",1,34,101,45,56
050,31,039,"Nebraska","Cuming County",1,35,98,50,48
050,31,039,"Nebraska","Cuming County",1,36,107,55,52
050,31,039,"Nebraska","Cuming County",1,37,103,48,55
050,31,039,"Nebraska","Cuming County",1,38,108,47,61
050,31,039,"Nebraska","Cuming County",1,39,109,58,51
050,31,039,"Nebraska","Cuming County",1,40,92,47,45
050,31,039,"Nebraska","Cuming County",1,41,84,43,41
050,31,039,"Nebraska","Cuming County",1,42,96,47,49
050,31,039,"Nebraska","Cuming County",1,43,87,43,44
050,31,039,"Nebraska","Cuming County",1,44,76,35,41
050,31,039,"Nebraska","Cuming County",1,45,96,44,52
050,31,039,"Nebraska","Cuming County",1,46,80,40,40
050,31,039,"Nebraska","Cuming County",1,47,81,40,41
050,31,039,"Nebraska","Cuming County",1,48,102,53,49
050,31,039,"Nebraska","Cuming County",1,49,95,51,44
050,31,039,"Nebraska","Cuming County",1,50,87,46,41
050,31,039,"Nebraska","Cuming County",1,51,100,55,45
050,31,039,"Nebraska","Cuming County",1,52,114,60,54
050,31,039,"Nebraska","Cuming County",1,53,112,61,51
050,31,039,"Nebraska","Cuming County",1,54,113,64,49
050,31,039,"Nebraska","Cuming County",1,55,121,62,59
050,31,039,"Nebraska","Cuming County",1,56,128,73,55
050,31,039,"Nebraska","Cuming County",1,57,114,62,52
050,31,039,"Nebraska","Cuming County",1,58,151,76,75
050,31,039,"Nebraska","Cuming County",1,59,133,72,61
050,31,039,"Nebraska","Cuming County",1,60,119,69,50
050,31,039,"Nebraska","Cuming County",1,61,123,71,52
050,31,039,"Nebraska","Cuming County",1,62,133,73,60
050,31,039,"Nebraska","Cuming County",1,63,124,62,62
050,31,039,"Nebraska","Cuming County",1,64,130,72,58
050,31,039,"Nebraska","Cuming County",1,65,114,58,56
050,31,039,"Nebraska","Cuming County",1,66,108,59,49
050,31,039,"Nebraska","Cuming County",1,67,104,54,50
050,31,039,"Nebraska","Cuming County",1,68,107,55,52
050,31,039,"Nebraska","Cuming County",1,69,93,49,44
050,31,039,"Nebraska","Cuming County",1,70,92,47,45
050,31,039,"Nebraska","Cuming County",1,71,98,46,52
050,31,039,"Nebraska","Cuming County",1,72,99,46,53
050,31,039,"Nebraska","Cuming County",1,73,91,42,49
050,31,039,"Nebraska","Cuming County",1,74,64,28,36
050,31,039,"Nebraska","Cuming County",1,75,70,36,34
050,31,039,"Nebraska","Cuming County",1,76,66,30,36
050,31,039,"Nebraska","Cuming County",1,77,65,34,31
050,31,039,"Nebraska","Cuming County",1,78,60,27,33
050,31,039,"Nebraska","Cuming County",1,79,66,32,34
050,31,039,"Nebraska","Cuming County",1,80,53,26,27
050,31,039,"Nebraska","Cuming County",1,81,48,22,26
050,31,039,"Nebraska","Cuming County",1,82,48,24,24
050,31,039,"Nebraska","Cuming County",1,83,52,26,26
050,31,039,"Nebraska","Cuming County",1,84,57,27,30
050,31,039,"Nebraska","Cuming County",1,85,327,118,209
050,31,039,"Nebraska","Cuming County",2,0,109,55,54
050,31,039,"Nebraska","Cuming County",2,1,118,58,60
050,31,039,"Nebraska","Cuming County",2,2,121,63,58
050,31,039,"Nebraska","Cuming County",2,3,117,63,54
050,31,039,"Nebraska","Cuming County",2,4,121,65,56
050,31,039,"Nebraska","Cuming County",2,5,135,70,65
050,31,039,"Nebraska","Cuming County",2,6,130,71,59
050,31,039,"Nebraska","Cuming County",2,7,112,59,53
050,31,039,"Nebraska","Cuming County",2,8,119,60,59
050,31,039,"Nebraska","Cuming County",2,9,121,67,54
050,31,039,"Nebraska","Cuming County",2,10,120,60,60
050,31,039,"Nebraska","Cuming County",2,11,123,64,59
050,31,039,"Nebraska","Cuming County",2,12,131,66,65
050,31,039,"Nebraska","Cuming County",2,13,141,72,69
050,31,039,"Nebraska","Cuming County",2,14,137,70,67
050,31,039,"Nebraska","Cuming County",2,15,134,72,62
050,31,039,"Nebraska","Cuming County",2,16,144,71,73
050,31,039,"Nebraska","Cuming County",2,17,146,74,72
050,31,039,"Nebraska","Cuming County",2,18,118,60,58
050,31,039,"Nebraska","Cuming County",2,19,94,46,48
050,31,039,"Nebraska","Cuming County",2,20,98,44,54
050,31,039,"Nebraska","Cuming County",2,21,95,44,51
050,31,039,"Nebraska","Cuming County",2,22,101,52,49
050,31,039,"Nebraska","Cuming County",2,23,100,51,49
050,31,039,"Nebraska","Cuming County",2,24,105,55,50
050,31,039,"Nebraska","Cuming County",2,25,100,53,47
050,31,039,"Nebraska","Cuming County",2,26,93,49,44
050,31,039,"Nebraska","Cuming County",2,27,83,43,40
050,31,039,"Nebraska","Cuming County",2,28,89,46,43
050,31,039,"Nebraska","Cuming County",2,29,92,53,39
050,31,039,"Nebraska","Cuming County",2,30,95,48,47
050,31,039,"Nebraska","Cuming County",2,31,90,46,44
050,31,039,"Nebraska","Cuming County",2,32,92,47,45
050,31,039,"Nebraska","Cuming County",2,33,85,36,49
050,31,039,"Nebraska","Cuming County",2,34,97,42,55
050,31,039,"Nebraska","Cuming County",2,35,100,50,50
050,31,039,"Nebraska","Cuming County",2,36,103,53,50
050,31,039,"Nebraska","Cuming County",2,37,106,51,55
050,31,039,"Nebraska","Cuming County",2,38,108,48,60
050,31,039,"Nebraska","Cuming County",2,39,108,55,53
050,31,039,"Nebraska","Cuming County",2,40,96,50,46
050,31,039,"Nebraska","Cuming County",2,41,87,44,43
050,31,039,"Nebraska","Cuming County",2,42,92,45,47
050,31,039,"Nebraska","Cuming County",2,43,89,44,45
050,31,039,"Nebraska","Cuming County",2,44,79,37,42
050,31,039,"Nebraska","Cuming County",2,45,92,42,50
050,31,039,"Nebraska","Cuming County",2,46,83,41,42
050,31,039,"Nebraska","Cuming County",2,47,81,41,40
050,31,039,"Nebraska","Cuming County",2,48,97,50,47
050,31,039,"Nebraska","Cuming County",2,49,96,51,45
050,31,039,"Nebraska","Cuming County",2,50,89,47,42
050,31,039,"Nebraska","Cuming County",2,51,96,52,44
050,31,039,"Nebraska","Cuming County",2,52,111,59,52
050,31,039,"Nebraska","Cuming County",2,53,114,61,53
050,31,039,"Nebraska","Cuming County",2,54,114,65,49
050,31,039,"Nebraska","Cuming County",2,55,118,62,56
050,31,039,"Nebraska","Cuming County",2,56,125,70,55
050,31,039,"Nebraska","Cuming County",2,57,119,65,54
050,31,039,"Nebraska","Cuming County",2,58,143,73,70
050,31,039,"Nebraska","Cuming County",2,59,138,73,65
050,31,039,"Nebraska","Cuming County",2,60,121,69,52
050,31,039,"Nebraska","Cuming County",2,61,122,71,51
050,31,039,"Nebraska","Cuming County",2,62,129,72,57
050,31,039,"Nebraska","Cuming County",2,63,127,65,62
050,31,039,"Nebraska","Cuming County",2,64,128,69,59
050,31,039,"Nebraska","Cuming County",2,65,118,61,57
050,31,039,"Nebraska","Cuming County",2,66,108,58,50
050,31,039,"Nebraska","Cuming County",2,67,104,55,49
050,31,039,"Nebraska","Cuming County",2,68,105,54,51
050,31,039,"Nebraska","Cuming County",2,69,97,51,46
050,31,039,"Nebraska","Cuming County",2,70,92,47,45
050,31,039,"Nebraska","Cuming County",2,71,97,46,51
050,31,039,"Nebraska","Cuming County",2,72,97,46,51
050,31,039,"Nebraska","Cuming County",2,73,97,45,52
050,31,039,"Nebraska","Cuming County",2,74,66,29,37
050,31,039,"Nebraska","Cuming County",2,75,68,33,35
050,31,039,"Nebraska","Cuming County",2,76,66,30,36
050,31,039,"Nebraska","Cuming County",2,77,66,33,33
050,31,039,"Nebraska","Cuming County",2,78,59,27,32
050,31,039,"Nebraska","Cuming County",2,79,63,30,33
050,31,039,"Nebraska","Cuming County",2,80,54,27,27
050,31,039,"Nebraska","Cuming County",2,81,49,23,26
050,31,039,"Nebraska","Cuming County",2,82,48,23,25
050,31,039,"Nebraska","Cuming County",2,83,50,25,25
050,31,039,"Nebraska","Cuming County",2,84,56,27,29
050,31,039,"Nebraska","Cuming County",2,85,332,122,210
050,31,039,"Nebraska","Cuming County",3,0,128,65,63
050,31,039,"Nebraska","Cuming County",3,1,112,61,51
050,31,039,"Nebraska","Cuming County",3,2,120,63,57
050,31,039,"Nebraska","Cuming County",3,3,129,67,62
050,31,039,"Nebraska","Cuming County",3,4,124,66,58
050,31,039,"Nebraska","Cuming County",3,5,122,67,55
050,31,039,"Nebraska","Cuming County",3,6,135,67,68
050,31,039,"Nebraska","Cuming County",3,7,127,67,60
050,31,039,"Nebraska","Cuming County",3,8,114,59,55
050,31,039,"Nebraska","Cuming County",3,9,115,57,58
050,31,039,"Nebraska","Cuming County",3,10,114,64,50
050,31,039,"Nebraska","Cuming County",3,11,117,57,60
050,31,039,"Nebraska","Cuming County",3,12,122,64,58
050,31,039,"Nebraska","Cuming County",3,13,126,63,63
050,31,039,"Nebraska","Cuming County",3,14,130,63,67
050,31,039,"Nebraska","Cuming County",3,15,129,67,62
050,31,039,"Nebraska","Cuming County",3,16,140,74,66
050,31,039,"Nebraska","Cuming County",3,17,142,68,74
050,31,039,"Nebraska","Cuming County",3,18,129,66,63
050,31,039,"Nebraska","Cuming County",3,19,100,52,48
050,31,039,"Nebraska","Cuming County",3,20,103,50,53
050,31,039,"Nebraska","Cuming County",3,21,98,42,56
050,31,039,"Nebraska","Cuming County",3,22,96,43,53
050,31,039,"Nebraska","Cuming County",3,23,102,54,48
050,31,039,"Nebraska","Cuming County",3,24,95,47,48
050,31,039,"Nebraska","Cuming County",3,25,105,59,46
050,31,039,"Nebraska","Cuming County",3,26,95,47,48
050,31,039,"Nebraska","Cuming County",3,27,95,48,47
050,31,039,"Nebraska","Cuming County",3,28,86,42,44
050,31,039,"Nebraska","Cuming County",3,29,93,46,47
050,31,039,"Nebraska","Cuming County",3,30,96,52,44
050,31,039,"Nebraska","Cuming County",3,31,96,48,48
050,31,039,"Nebraska","Cuming County",3,32,90,48,42
050,31,039,"Nebraska","Cuming County",3,33,95,49,46
050,31,039,"Nebraska","Cuming County",3,34,88,41,47
050,31,039,"Nebraska","Cuming County",3,35,97,45,52
050,31,039,"Nebraska","Cuming County",3,36,99,51,48
050,31,039,"Nebraska","Cuming County",3,37,98,51,47
050,31,039,"Nebraska","Cuming County",3,38,111,53,58
050,31,039,"Nebraska","Cuming County",3,39,111,51,60
050,31,039,"Nebraska","Cuming County",3,40,107,56,51
050,31,039,"Nebraska","Cuming County",3,41,96,48,48
050,31,039,"Nebraska","Cuming County",3,42,82,44,38
050,31,039,"Nebraska","Cuming County",3,43,92,47,45
050,31,039,"Nebraska","Cuming County",3,44,89,40,49
050,31,039,"Nebraska","Cuming County",3,45,83,41,42
050,31,039,"Nebraska","Cuming County",3,46,94,41,53
050,31,039,"Nebraska","Cuming County",3,47,82,40,42
050,31,039,"Nebraska","Cuming County",3,48,76,34,42
050,31,039,"Nebraska","Cuming County",3,49,95,48,47
050,31,039,"Nebraska","Cuming County",3,50,92,47,45
050,31,039,"Nebraska","Cuming County",3,51,90,48,42
050,31,039,"Nebraska","Cuming County",3,52,96,55,41
050,31,039,"Nebraska","Cuming County",3,53,113,58,55
050,31,039,"Nebraska","Cuming County",3,54,120,66,54
050,31,039,"Nebraska","Cuming County",3,55,109,63,46
050,31,039,"Nebraska","Cuming County",3,56,117,60,57
050,31,039,"Nebraska","Cuming County",3,57,124,68,56
050,31,039,"Nebraska","Cuming County",3,58,116,62,54
050,31,039,"Nebraska","Cuming County",3,59,140,71,69
050,31,039,"Nebraska","Cuming County",3,60,137,71,66
050,31,039,"Nebraska","Cuming County",3,61,118,67,51
050,31,039,"Nebraska","Cuming County",3,62,124,72,52
050,31,039,"Nebraska","Cuming County",3,63,129,70,59
050,31,039,"Nebraska","Cuming County",3,64,124,64,60
050,31,039,"Nebraska","Cuming County",3,65,126,65,61
050,31,039,"Nebraska","Cuming County",3,66,113,58,55
050,31,039,"Nebraska","Cuming County",3,67,106,57,49
050,31,039,"Nebraska","Cuming County",3,68,100,52,48
050,31,039,"Nebraska","Cuming County",3,69,99,51,48
050,31,039,"Nebraska","Cuming County",3,70,94,49,45
050,31,039,"Nebraska","Cuming County",3,71,90,46,44
050,31,039,"Nebraska","Cuming County",3,72,97,44,53
050,31,039,"Nebraska","Cuming County",3,73,96,47,49
050,31,039,"Nebraska","Cuming County",3,74,93,43,50
050,31,039,"Nebraska","Cuming County",3,75,64,28,36
050,31,039,"Nebraska","Cuming County",3,76,63,27,36
050,31,039,"Nebraska","Cuming County",3,77,66,30,36
050,31,039,"Nebraska","Cuming County",3,78,63,31,32
050,31,039,"Nebraska","Cuming County",3,79,59,27,32
050,31,039,"Nebraska","Cuming County",3,80,56,26,30
050,31,039,"Nebraska","Cuming County",3,81,55,26,29
050,31,039,"Nebraska","Cuming County",3,82,50,24,26
050,31,039,"Nebraska","Cuming County",3,83,44,17,27
050,31,039,"Nebraska","Cuming County",3,84,49,24,25
050,31,039,"Nebraska","Cuming County",3,85,338,125,213
050,31,039,"Nebraska","Cuming County",4,0,123,59,64
050,31,039,"Nebraska","Cuming County",4,1,127,65,62
050,31,039,"Nebraska","Cuming County",4,2,113,65,48
050,31,039,"Nebraska","Cuming County",4,3,124,67,57
050,31,039,"Nebraska","Cuming County",4,4,134,72,62
050,31,039,"Nebraska","Cuming County",4,5,115,62,53
050,31,039,"Nebraska","Cuming County",4,6,120,63,57
050,31,039,"Nebraska","Cuming County",4,7,127,65,62
050,31,039,"Nebraska","Cuming County",4,8,124,67,57
050,31,039,"Nebraska","Cuming County",4,9,113,61,52
050,31,039,"Nebraska","Cuming County",4,10,116,56,60
050,31,039,"Nebraska","Cuming County",4,11,118,69,49
050,31,039,"Nebraska","Cuming County",4,12,116,57,59
050,31,039,"Nebraska","Cuming County",4,13,119,64,55
050,31,039,"Nebraska","Cuming County",4,14,130,62,68
050,31,039,"Nebraska","Cuming County",4,15,139,68,71
050,31,039,"Nebraska","Cuming County",4,16,130,65,65
050,31,039,"Nebraska","Cuming County",4,17,139,73,66
050,31,039,"Nebraska","Cuming County",4,18,123,60,63
050,31,039,"Nebraska","Cuming County",4,19,99,51,48
050,31,039,"Nebraska","Cuming County",4,20,99,52,47
050,31,039,"Nebraska","Cuming County",4,21,105,53,52
050,31,039,"Nebraska","Cuming County",4,22,96,43,53
050,31,039,"Nebraska","Cuming County",4,23,98,45,53
050,31,039,"Nebraska","Cuming County",4,24,96,53,43
050,31,039,"Nebraska","Cuming County",4,25,95,47,48
050,31,039,"Nebraska","Cuming County",4,26,92,51,41
050,31,039,"Nebraska","Cuming County",4,27,94,48,46
050,31,039,"Nebraska","Cuming County",4,28,99,49,50
050,31,039,"Nebraska","Cuming County",4,29,78,33,45
050,31,039,"Nebraska","Cuming County",4,30,96,49,47
050,31,039,"Nebraska","Cuming County",4,31,96,49,47
050,31,039,"Nebraska","Cuming County",4,32,98,49,49
050,31,039,"Nebraska","Cuming County",4,33,94,50,44
050,31,039,"Nebraska","Cuming County",4,34,98,46,52
050,31,039,"Nebraska","Cuming County",4,35,90,45,45
050,31,039,"Nebraska","Cuming County",4,36,91,43,48
050,31,039,"Nebraska","Cuming County",4,37,101,56,45
050,31,039,"Nebraska","Cuming County",4,38,100,52,48
050,31,039,"Nebraska","Cuming County",4,39,109,51,58
050,31,039,"Nebraska","Cuming County",4,40,118,53,65
050,31,039,"Nebraska","Cuming County",4,41,112,59,53
050,31,039,"Nebraska","Cuming County",4,42,96,48,48
050,31,039,"Nebraska","Cuming County",4,43,84,45,39
050,31,039,"Nebraska","Cuming County",4,44,92,47,45
050,31,039,"Nebraska","Cuming County",4,45,89,40,49
050,31,039,"Nebraska","Cuming County",4,46,82,40,42
050,31,039,"Nebraska","Cuming County",4,47,92,41,51
050,31,039,"Nebraska","Cuming County",4,48,80,39,41
050,31,039,"Nebraska","Cuming County",4,49,72,33,39
050,31,039,"Nebraska","Cuming County",4,50,93,47,46
050,31,039,"Nebraska","Cuming County",4,51,96,50,46
050,31,039,"Nebraska","Cuming County",4,52,88,47,41
050,31,039,"Nebraska","Cuming County",4,53,91,53,38
050,31,039,"Nebraska","Cuming County",4,54,115,61,54
050,31,039,"Nebraska","Cuming County",4,55,116,65,51
050,31,039,"Nebraska","Cuming County",4,56,107,61,46
050,31,039,"Nebraska","Cuming County",4,57,120,63,57
050,31,039,"Nebraska","Cuming County",4,58,124,67,57
050,31,039,"Nebraska","Cuming County",4,59,119,65,54
050,31,039,"Nebraska","Cuming County",4,60,141,73,68
050,31,039,"Nebraska","Cuming County",4,61,136,71,65
050,31,039,"Nebraska","Cuming County",4,62,114,64,50
050,31,039,"Nebraska","Cuming County",4,63,121,69,52
050,31,039,"Nebraska","Cuming County",4,64,129,68,61
050,31,039,"Nebraska","Cuming County",4,65,123,64,59
050,31,039,"Nebraska","Cuming County",4,66,127,68,59
050,31,039,"Nebraska","Cuming County",4,67,111,58,53
050,31,039,"Nebraska","Cuming County",4,68,103,56,47
050,31,039,"Nebraska","Cuming County",4,69,98,51,47
050,31,039,"Nebraska","Cuming County",4,70,97,50,47
050,31,039,"Nebraska","Cuming County",4,71,86,46,40
050,31,039,"Nebraska","Cuming County",4,72,91,47,44
050,31,039,"Nebraska","Cuming County",4,73,94,43,51
050,31,039,"Nebraska","Cuming County",4,74,94,44,50
050,31,039,"Nebraska","Cuming County",4,75,89,41,48
050,31,039,"Nebraska","Cuming County",4,76,61,24,37
050,31,039,"Nebraska","Cuming County",4,77,63,28,35
050,31,039,"Nebraska","Cuming County",4,78,61,27,34
050,31,039,"Nebraska","Cuming County",4,79,62,31,31
050,31,039,"Nebraska","Cuming County",4,80,52,23,29
050,31,039,"Nebraska","Cuming County",4,81,54,23,31
050,31,039,"Nebraska","Cuming County",4,82,53,24,29
050,31,039,"Nebraska","Cuming County",4,83,51,24,27
050,31,039,"Nebraska","Cuming County",4,84,43,15,28
050,31,039,"Nebraska","Cuming County",4,85,339,126,213
050,31,039,"Nebraska","Cuming County",5,0,121,59,62
050,31,039,"Nebraska","Cuming County",5,1,136,66,70
050,31,039,"Nebraska","Cuming County",5,2,133,72,61
050,31,039,"Nebraska","Cuming County",5,3,116,67,49
050,31,039,"Nebraska","Cuming County",5,4,127,63,64
050,31,039,"Nebraska","Cuming County",5,5,121,60,61
050,31,039,"Nebraska","Cuming County",5,6,120,61,59
050,31,039,"Nebraska","Cuming County",5,7,112,58,54
050,31,039,"Nebraska","Cuming County",5,8,129,67,62
050,31,039,"Nebraska","Cuming County",5,9,129,70,59
050,31,039,"Nebraska","Cuming County",5,10,115,60,55
050,31,039,"Nebraska","Cuming County",5,11,117,56,61
050,31,039,"Nebraska","Cuming County",5,12,119,65,54
050,31,039,"Nebraska","Cuming County",5,13,113,55,58
050,31,039,"Nebraska","Cuming County",5,14,123,60,63
050,31,039,"Nebraska","Cuming County",5,15,129,62,67
050,31,039,"Nebraska","Cuming County",5,16,136,64,72
050,31,039,"Nebraska","Cuming County",5,17,127,65,62
050,31,039,"Nebraska","Cuming County",5,18,123,67,56
050,31,039,"Nebraska","Cuming County",5,19,91,42,49
050,31,039,"Nebraska","Cuming County",5,20,103,52,51
050,31,039,"Nebraska","Cuming County",5,21,99,50,49
050,31,039,"Nebraska","Cuming County",5,22,102,47,55
050,31,039,"Nebraska","Cuming County",5,23,93,46,47
050,31,039,"Nebraska","Cuming County",5,24,97,44,53
050,31,039,"Nebraska","Cuming County",5,25,89,51,38
050,31,039,"Nebraska","Cuming County",5,26,85,45,40
050,31,039,"Nebraska","Cuming County",5,27,102,54,48
050,31,039,"Nebraska","Cuming County",5,28,91,48,43
050,31,039,"Nebraska","Cuming County",5,29,97,49,48
050,31,039,"Nebraska","Cuming County",5,30,79,34,45
050,31,039,"Nebraska","Cuming County",5,31,95,48,47
050,31,039,"Nebraska","Cuming County",5,32,100,50,50
050,31,039,"Nebraska","Cuming County",5,33,96,48,48
050,31,039,"Nebraska","Cuming County",5,34,91,49,42
050,31,039,"Nebraska","Cuming County",5,35,101,49,52
050,31,039,"Nebraska","Cuming County",5,36,90,47,43
050,31,039,"Nebraska","Cuming County",5,37,94,41,53
050,31,039,"Nebraska","Cuming County",5,38,102,55,47
050,31,039,"Nebraska","Cuming County",5,39,101,53,48
050,31,039,"Nebraska","Cuming County",5,40,108,52,56
050,31,039,"Nebraska","Cuming County",5,41,113,52,61
050,31,039,"Nebraska","Cuming County",5,42,114,60,54
050,31,039,"Nebraska","Cuming County",5,43,98,47,51
050,31,039,"Nebraska","Cuming County",5,44,82,45,37
050,31,039,"Nebraska","Cuming County",5,45,96,52,44
050,31,039,"Nebraska","Cuming County",5,46,87,39,48
050,31,039,"Nebraska","Cuming County",5,47,82,41,41
050,31,039,"Nebraska","Cuming County",5,48,92,41,51
050,31,039,"Nebraska","Cuming County",5,49,75,35,40
050,31,039,"Nebraska","Cuming County",5,50,77,35,42
050,31,039,"Nebraska","Cuming County",5,51,93,47,46
050,31,039,"Nebraska","Cuming County",5,52,93,51,42
050,31,039,"Nebraska","Cuming County",5,53,83,40,43
050,31,039,"Nebraska","Cuming County",5,54,93,55,38
050,31,039,"Nebraska","Cuming County",5,55,112,60,52
050,31,039,"Nebraska","Cuming County",5,56,111,61,50
050,31,039,"Nebraska","Cuming County",5,57,103,60,43
050,31,039,"Nebraska","Cuming County",5,58,124,66,58
050,31,039,"Nebraska","Cuming County",5,59,124,69,55
050,31,039,"Nebraska","Cuming County",5,60,124,68,56
050,31,039,"Nebraska","Cuming County",5,61,141,72,69
050,31,039,"Nebraska","Cuming County",5,62,133,69,64
050,31,039,"Nebraska","Cuming County",5,63,115,64,51
050,31,039,"Nebraska","Cuming County",5,64,117,67,50
050,31,039,"Nebraska","Cuming County",5,65,132,68,64
050,31,039,"Nebraska","Cuming County",5,66,120,62,58
050,31,039,"Nebraska","Cuming County",5,67,124,66,58
050,31,039,"Nebraska","Cuming County",5,68,107,55,52
050,31,039,"Nebraska","Cuming County",5,69,106,58,48
050,31,039,"Nebraska","Cuming County",5,70,95,51,44
050,31,039,"Nebraska","Cuming County",5,71,93,49,44
050,31,039,"Nebraska","Cuming County",5,72,87,45,42
050,31,039,"Nebraska","Cuming County",5,73,85,45,40
050,31,039,"Nebraska","Cuming County",5,74,93,41,52
050,31,039,"Nebraska","Cuming County",5,75,92,44,48
050,31,039,"Nebraska","Cuming County",5,76,86,37,49
050,31,039,"Nebraska","Cuming County",5,77,61,25,36
050,31,039,"Nebraska","Cuming County",5,78,59,26,33
050,31,039,"Nebraska","Cuming County",5,79,61,28,33
050,31,039,"Nebraska","Cuming County",5,80,53,27,26
050,31,039,"Nebraska","Cuming County",5,81,50,21,29
050,31,039,"Nebraska","Cuming County",5,82,53,21,32
050,31,039,"Nebraska","Cuming County",5,83,49,21,28
050,31,039,"Nebraska","Cuming County",5,84,48,22,26
050,31,039,"Nebraska","Cuming County",5,85,330,121,209
050,31,041,"Nebraska","Custer County",1,0,122,62,60
050,31,041,"Nebraska","Custer County",1,1,113,57,56
050,31,041,"Nebraska","Custer County",1,2,125,71,54
050,31,041,"Nebraska","Custer County",1,3,143,76,67
050,31,041,"Nebraska","Custer County",1,4,141,73,68
050,31,041,"Nebraska","Custer County",1,5,150,77,73
050,31,041,"Nebraska","Custer County",1,6,141,64,77
050,31,041,"Nebraska","Custer County",1,7,133,56,77
050,31,041,"Nebraska","Custer County",1,8,141,74,67
050,31,041,"Nebraska","Custer County",1,9,144,76,68
050,31,041,"Nebraska","Custer County",1,10,148,76,72
050,31,041,"Nebraska","Custer County",1,11,157,85,72
050,31,041,"Nebraska","Custer County",1,12,155,78,77
050,31,041,"Nebraska","Custer County",1,13,143,71,72
050,31,041,"Nebraska","Custer County",1,14,160,82,78
050,31,041,"Nebraska","Custer County",1,15,150,76,74
050,31,041,"Nebraska","Custer County",1,16,160,79,81
050,31,041,"Nebraska","Custer County",1,17,148,81,67
050,31,041,"Nebraska","Custer County",1,18,114,61,53
050,31,041,"Nebraska","Custer County",1,19,84,47,37
050,31,041,"Nebraska","Custer County",1,20,92,49,43
050,31,041,"Nebraska","Custer County",1,21,79,46,33
050,31,041,"Nebraska","Custer County",1,22,104,51,53
050,31,041,"Nebraska","Custer County",1,23,112,65,47
050,31,041,"Nebraska","Custer County",1,24,103,52,51
050,31,041,"Nebraska","Custer County",1,25,105,52,53
050,31,041,"Nebraska","Custer County",1,26,110,58,52
050,31,041,"Nebraska","Custer County",1,27,116,60,56
050,31,041,"Nebraska","Custer County",1,28,123,62,61
050,31,041,"Nebraska","Custer County",1,29,120,55,65
050,31,041,"Nebraska","Custer County",1,30,114,52,62
050,31,041,"Nebraska","Custer County",1,31,104,47,57
050,31,041,"Nebraska","Custer County",1,32,120,65,55
050,31,041,"Nebraska","Custer County",1,33,114,68,46
050,31,041,"Nebraska","Custer County",1,34,107,53,54
050,31,041,"Nebraska","Custer County",1,35,119,66,53
050,31,041,"Nebraska","Custer County",1,36,112,53,59
050,31,041,"Nebraska","Custer County",1,37,110,51,59
050,31,041,"Nebraska","Custer County",1,38,121,68,53
050,31,041,"Nebraska","Custer County",1,39,122,62,60
050,31,041,"Nebraska","Custer County",1,40,110,56,54
050,31,041,"Nebraska","Custer County",1,41,103,50,53
050,31,041,"Nebraska","Custer County",1,42,114,56,58
050,31,041,"Nebraska","Custer County",1,43,119,72,47
050,31,041,"Nebraska","Custer County",1,44,118,64,54
050,31,041,"Nebraska","Custer County",1,45,112,57,55
050,31,041,"Nebraska","Custer County",1,46,110,53,57
050,31,041,"Nebraska","Custer County",1,47,101,50,51
050,31,041,"Nebraska","Custer County",1,48,114,57,57
050,31,041,"Nebraska","Custer County",1,49,132,65,67
050,31,041,"Nebraska","Custer County",1,50,108,56,52
050,31,041,"Nebraska","Custer County",1,51,103,55,48
050,31,041,"Nebraska","Custer County",1,52,106,49,57
050,31,041,"Nebraska","Custer County",1,53,97,49,48
050,31,041,"Nebraska","Custer County",1,54,115,66,49
050,31,041,"Nebraska","Custer County",1,55,134,66,68
050,31,041,"Nebraska","Custer County",1,56,157,72,85
050,31,041,"Nebraska","Custer County",1,57,161,79,82
050,31,041,"Nebraska","Custer County",1,58,161,81,80
050,31,041,"Nebraska","Custer County",1,59,168,90,78
050,31,041,"Nebraska","Custer County",1,60,172,94,78
050,31,041,"Nebraska","Custer County",1,61,156,76,80
050,31,041,"Nebraska","Custer County",1,62,141,64,77
050,31,041,"Nebraska","Custer County",1,63,156,84,72
050,31,041,"Nebraska","Custer County",1,64,147,81,66
050,31,041,"Nebraska","Custer County",1,65,144,75,69
050,31,041,"Nebraska","Custer County",1,66,140,73,67
050,31,041,"Nebraska","Custer County",1,67,139,73,66
050,31,041,"Nebraska","Custer County",1,68,143,74,69
050,31,041,"Nebraska","Custer County",1,69,141,64,77
050,31,041,"Nebraska","Custer County",1,70,134,66,68
050,31,041,"Nebraska","Custer County",1,71,123,68,55
050,31,041,"Nebraska","Custer County",1,72,115,55,60
050,31,041,"Nebraska","Custer County",1,73,129,58,71
050,31,041,"Nebraska","Custer County",1,74,87,39,48
050,31,041,"Nebraska","Custer County",1,75,88,48,40
050,31,041,"Nebraska","Custer County",1,76,90,43,47
050,31,041,"Nebraska","Custer County",1,77,68,31,37
050,31,041,"Nebraska","Custer County",1,78,77,35,42
050,31,041,"Nebraska","Custer County",1,79,73,35,38
050,31,041,"Nebraska","Custer County",1,80,59,27,32
050,31,041,"Nebraska","Custer County",1,81,61,27,34
050,31,041,"Nebraska","Custer County",1,82,70,36,34
050,31,041,"Nebraska","Custer County",1,83,65,30,35
050,31,041,"Nebraska","Custer County",1,84,46,14,32
050,31,041,"Nebraska","Custer County",1,85,346,115,231
050,31,041,"Nebraska","Custer County",2,0,114,58,56
050,31,041,"Nebraska","Custer County",2,1,114,58,56
050,31,041,"Nebraska","Custer County",2,2,123,69,54
050,31,041,"Nebraska","Custer County",2,3,140,75,65
050,31,041,"Nebraska","Custer County",2,4,143,74,69
050,31,041,"Nebraska","Custer County",2,5,148,76,72
050,31,041,"Nebraska","Custer County",2,6,142,66,76
050,31,041,"Nebraska","Custer County",2,7,133,57,76
050,31,041,"Nebraska","Custer County",2,8,141,71,70
050,31,041,"Nebraska","Custer County",2,9,143,76,67
050,31,041,"Nebraska","Custer County",2,10,146,76,70
050,31,041,"Nebraska","Custer County",2,11,155,82,73
050,31,041,"Nebraska","Custer County",2,12,158,82,76
050,31,041,"Nebraska","Custer County",2,13,144,72,72
050,31,041,"Nebraska","Custer County",2,14,154,78,76
050,31,041,"Nebraska","Custer County",2,15,151,77,74
050,31,041,"Nebraska","Custer County",2,16,157,77,80
050,31,041,"Nebraska","Custer County",2,17,148,79,69
050,31,041,"Nebraska","Custer County",2,18,115,63,52
050,31,041,"Nebraska","Custer County",2,19,87,48,39
050,31,041,"Nebraska","Custer County",2,20,89,48,41
050,31,041,"Nebraska","Custer County",2,21,82,46,36
050,31,041,"Nebraska","Custer County",2,22,98,50,48
050,31,041,"Nebraska","Custer County",2,23,112,62,50
050,31,041,"Nebraska","Custer County",2,24,106,55,51
050,31,041,"Nebraska","Custer County",2,25,103,51,52
050,31,041,"Nebraska","Custer County",2,26,109,57,52
050,31,041,"Nebraska","Custer County",2,27,115,61,54
050,31,041,"Nebraska","Custer County",2,28,122,61,61
050,31,041,"Nebraska","Custer County",2,29,123,58,65
050,31,041,"Nebraska","Custer County",2,30,117,53,64
050,31,041,"Nebraska","Custer County",2,31,106,48,58
050,31,041,"Nebraska","Custer County",2,32,116,61,55
050,31,041,"Nebraska","Custer County",2,33,114,66,48
050,31,041,"Nebraska","Custer County",2,34,109,57,52
050,31,041,"Nebraska","Custer County",2,35,117,63,54
050,31,041,"Nebraska","Custer County",2,36,111,55,56
050,31,041,"Nebraska","Custer County",2,37,109,51,58
050,31,041,"Nebraska","Custer County",2,38,117,64,53
050,31,041,"Nebraska","Custer County",2,39,119,62,57
050,31,041,"Nebraska","Custer County",2,40,114,57,57
050,31,041,"Nebraska","Custer County",2,41,104,51,53
050,31,041,"Nebraska","Custer County",2,42,111,54,57
050,31,041,"Nebraska","Custer County",2,43,118,68,50
050,31,041,"Nebraska","Custer County",2,44,115,64,51
050,31,041,"Nebraska","Custer County",2,45,113,59,54
050,31,041,"Nebraska","Custer County",2,46,109,53,56
050,31,041,"Nebraska","Custer County",2,47,101,50,51
050,31,041,"Nebraska","Custer County",2,48,109,54,55
050,31,041,"Nebraska","Custer County",2,49,127,63,64
050,31,041,"Nebraska","Custer County",2,50,114,59,55
050,31,041,"Nebraska","Custer County",2,51,104,55,49
050,31,041,"Nebraska","Custer County",2,52,104,49,55
050,31,041,"Nebraska","Custer County",2,53,100,49,51
050,31,041,"Nebraska","Custer County",2,54,110,62,48
050,31,041,"Nebraska","Custer County",2,55,130,67,63
050,31,041,"Nebraska","Custer County",2,56,151,71,80
050,31,041,"Nebraska","Custer County",2,57,160,77,83
050,31,041,"Nebraska","Custer County",2,58,160,80,80
050,31,041,"Nebraska","Custer County",2,59,168,88,80
050,31,041,"Nebraska","Custer County",2,60,169,92,77
050,31,041,"Nebraska","Custer County",2,61,159,80,79
050,31,041,"Nebraska","Custer County",2,62,145,67,78
050,31,041,"Nebraska","Custer County",2,63,155,81,74
050,31,041,"Nebraska","Custer County",2,64,147,81,66
050,31,041,"Nebraska","Custer County",2,65,145,77,68
050,31,041,"Nebraska","Custer County",2,66,138,72,66
050,31,041,"Nebraska","Custer County",2,67,139,73,66
050,31,041,"Nebraska","Custer County",2,68,141,73,68
050,31,041,"Nebraska","Custer County",2,69,143,67,76
050,31,041,"Nebraska","Custer County",2,70,133,64,69
050,31,041,"Nebraska","Custer County",2,71,126,67,59
050,31,041,"Nebraska","Custer County",2,72,114,56,58
050,31,041,"Nebraska","Custer County",2,73,131,59,72
050,31,041,"Nebraska","Custer County",2,74,89,40,49
050,31,041,"Nebraska","Custer County",2,75,88,46,42
050,31,041,"Nebraska","Custer County",2,76,88,43,45
050,31,041,"Nebraska","Custer County",2,77,76,35,41
050,31,041,"Nebraska","Custer County",2,78,74,34,40
050,31,041,"Nebraska","Custer County",2,79,72,35,37
050,31,041,"Nebraska","Custer County",2,80,61,28,33
050,31,041,"Nebraska","Custer County",2,81,59,26,33
050,31,041,"Nebraska","Custer County",2,82,65,32,33
050,31,041,"Nebraska","Custer County",2,83,66,31,35
050,31,041,"Nebraska","Custer County",2,84,49,17,32
050,31,041,"Nebraska","Custer County",2,85,339,114,225
050,31,041,"Nebraska","Custer County",3,0,121,65,56
050,31,041,"Nebraska","Custer County",3,1,117,62,55
050,31,041,"Nebraska","Custer County",3,2,120,62,58
050,31,041,"Nebraska","Custer County",3,3,125,69,56
050,31,041,"Nebraska","Custer County",3,4,149,84,65
050,31,041,"Nebraska","Custer County",3,5,147,75,72
050,31,041,"Nebraska","Custer County",3,6,146,75,71
050,31,041,"Nebraska","Custer County",3,7,140,67,73
050,31,041,"Nebraska","Custer County",3,8,135,63,72
050,31,041,"Nebraska","Custer County",3,9,133,63,70
050,31,041,"Nebraska","Custer County",3,10,146,76,70
050,31,041,"Nebraska","Custer County",3,11,144,75,69
050,31,041,"Nebraska","Custer County",3,12,153,83,70
050,31,041,"Nebraska","Custer County",3,13,162,83,79
050,31,041,"Nebraska","Custer County",3,14,145,72,73
050,31,041,"Nebraska","Custer County",3,15,161,82,79
050,31,041,"Nebraska","Custer County",3,16,146,79,67
050,31,041,"Nebraska","Custer County",3,17,158,79,79
050,31,041,"Nebraska","Custer County",3,18,126,65,61
050,31,041,"Nebraska","Custer County",3,19,85,45,40
050,31,041,"Nebraska","Custer County",3,20,90,50,40
050,31,041,"Nebraska","Custer County",3,21,85,48,37
050,31,041,"Nebraska","Custer County",3,22,89,48,41
050,31,041,"Nebraska","Custer County",3,23,110,57,53
050,31,041,"Nebraska","Custer County",3,24,119,64,55
050,31,041,"Nebraska","Custer County",3,25,97,50,47
050,31,041,"Nebraska","Custer County",3,26,105,56,49
050,31,041,"Nebraska","Custer County",3,27,99,55,44
050,31,041,"Nebraska","Custer County",3,28,119,58,61
050,31,041,"Nebraska","Custer County",3,29,122,60,62
050,31,041,"Nebraska","Custer County",3,30,134,66,68
050,31,041,"Nebraska","Custer County",3,31,115,53,62
050,31,041,"Nebraska","Custer County",3,32,109,50,59
050,31,041,"Nebraska","Custer County",3,33,120,65,55
050,31,041,"Nebraska","Custer County",3,34,119,71,48
050,31,041,"Nebraska","Custer County",3,35,115,59,56
050,31,041,"Nebraska","Custer County",3,36,122,65,57
050,31,041,"Nebraska","Custer County",3,37,113,57,56
050,31,041,"Nebraska","Custer County",3,38,115,56,59
050,31,041,"Nebraska","Custer County",3,39,119,66,53
050,31,041,"Nebraska","Custer County",3,40,123,66,57
050,31,041,"Nebraska","Custer County",3,41,111,54,57
050,31,041,"Nebraska","Custer County",3,42,105,50,55
050,31,041,"Nebraska","Custer County",3,43,117,55,62
050,31,041,"Nebraska","Custer County",3,44,116,65,51
050,31,041,"Nebraska","Custer County",3,45,119,66,53
050,31,041,"Nebraska","Custer County",3,46,113,58,55
050,31,041,"Nebraska","Custer County",3,47,108,52,56
050,31,041,"Nebraska","Custer County",3,48,99,48,51
050,31,041,"Nebraska","Custer County",3,49,109,55,54
050,31,041,"Nebraska","Custer County",3,50,132,67,65
050,31,041,"Nebraska","Custer County",3,51,113,61,52
050,31,041,"Nebraska","Custer County",3,52,101,51,50
050,31,041,"Nebraska","Custer County",3,53,101,47,54
050,31,041,"Nebraska","Custer County",3,54,97,48,49
050,31,041,"Nebraska","Custer County",3,55,111,64,47
050,31,041,"Nebraska","Custer County",3,56,128,67,61
050,31,041,"Nebraska","Custer County",3,57,153,69,84
050,31,041,"Nebraska","Custer County",3,58,159,78,81
050,31,041,"Nebraska","Custer County",3,59,154,78,76
050,31,041,"Nebraska","Custer County",3,60,167,89,78
050,31,041,"Nebraska","Custer County",3,61,169,89,80
050,31,041,"Nebraska","Custer County",3,62,155,79,76
050,31,041,"Nebraska","Custer County",3,63,147,64,83
050,31,041,"Nebraska","Custer County",3,64,152,80,72
050,31,041,"Nebraska","Custer County",3,65,145,81,64
050,31,041,"Nebraska","Custer County",3,66,145,78,67
050,31,041,"Nebraska","Custer County",3,67,140,72,68
050,31,041,"Nebraska","Custer County",3,68,137,71,66
050,31,041,"Nebraska","Custer County",3,69,137,71,66
050,31,041,"Nebraska","Custer County",3,70,138,65,73
050,31,041,"Nebraska","Custer County",3,71,128,61,67
050,31,041,"Nebraska","Custer County",3,72,121,63,58
050,31,041,"Nebraska","Custer County",3,73,112,56,56
050,31,041,"Nebraska","Custer County",3,74,126,55,71
050,31,041,"Nebraska","Custer County",3,75,85,37,48
050,31,041,"Nebraska","Custer County",3,76,85,43,42
050,31,041,"Nebraska","Custer County",3,77,81,39,42
050,31,041,"Nebraska","Custer County",3,78,73,33,40
050,31,041,"Nebraska","Custer County",3,79,76,35,41
050,31,041,"Nebraska","Custer County",3,80,68,35,33
050,31,041,"Nebraska","Custer County",3,81,57,23,34
050,31,041,"Nebraska","Custer County",3,82,55,23,32
050,31,041,"Nebraska","Custer County",3,83,65,32,33
050,31,041,"Nebraska","Custer County",3,84,57,27,30
050,31,041,"Nebraska","Custer County",3,85,321,102,219
050,31,041,"Nebraska","Custer County",4,0,131,66,65
050,31,041,"Nebraska","Custer County",4,1,126,70,56
050,31,041,"Nebraska","Custer County",4,2,125,69,56
050,31,041,"Nebraska","Custer County",4,3,124,65,59
050,31,041,"Nebraska","Custer County",4,4,125,71,54
050,31,041,"Nebraska","Custer County",4,5,153,88,65
050,31,041,"Nebraska","Custer County",4,6,135,65,70
050,31,041,"Nebraska","Custer County",4,7,145,75,70
050,31,041,"Nebraska","Custer County",4,8,139,66,73
050,31,041,"Nebraska","Custer County",4,9,140,69,71
050,31,041,"Nebraska","Custer County",4,10,139,69,70
050,31,041,"Nebraska","Custer County",4,11,147,83,64
050,31,041,"Nebraska","Custer County",4,12,146,76,70
050,31,041,"Nebraska","Custer County",4,13,153,83,70
050,31,041,"Nebraska","Custer County",4,14,162,84,78
050,31,041,"Nebraska","Custer County",4,15,144,73,71
050,31,041,"Nebraska","Custer County",4,16,156,82,74
050,31,041,"Nebraska","Custer County",4,17,158,81,77
050,31,041,"Nebraska","Custer County",4,18,133,66,67
050,31,041,"Nebraska","Custer County",4,19,96,50,46
050,31,041,"Nebraska","Custer County",4,20,88,50,38
050,31,041,"Nebraska","Custer County",4,21,87,45,42
050,31,041,"Nebraska","Custer County",4,22,90,52,38
050,31,041,"Nebraska","Custer County",4,23,95,57,38
050,31,041,"Nebraska","Custer County",4,24,102,47,55
050,31,041,"Nebraska","Custer County",4,25,118,61,57
050,31,041,"Nebraska","Custer County",4,26,105,57,48
050,31,041,"Nebraska","Custer County",4,27,112,58,54
050,31,041,"Nebraska","Custer County",4,28,109,57,52
050,31,041,"Nebraska","Custer County",4,29,114,59,55
050,31,041,"Nebraska","Custer County",4,30,123,57,66
050,31,041,"Nebraska","Custer County",4,31,137,64,73
050,31,041,"Nebraska","Custer County",4,32,113,54,59
050,31,041,"Nebraska","Custer County",4,33,112,52,60
050,31,041,"Nebraska","Custer County",4,34,118,64,54
050,31,041,"Nebraska","Custer County",4,35,121,72,49
050,31,041,"Nebraska","Custer County",4,36,117,61,56
050,31,041,"Nebraska","Custer County",4,37,124,67,57
050,31,041,"Nebraska","Custer County",4,38,117,62,55
050,31,041,"Nebraska","Custer County",4,39,115,57,58
050,31,041,"Nebraska","Custer County",4,40,115,64,51
050,31,041,"Nebraska","Custer County",4,41,122,64,58
050,31,041,"Nebraska","Custer County",4,42,120,60,60
050,31,041,"Nebraska","Custer County",4,43,115,55,60
050,31,041,"Nebraska","Custer County",4,44,118,58,60
050,31,041,"Nebraska","Custer County",4,45,119,64,55
050,31,041,"Nebraska","Custer County",4,46,118,66,52
050,31,041,"Nebraska","Custer County",4,47,112,57,55
050,31,041,"Nebraska","Custer County",4,48,100,48,52
050,31,041,"Nebraska","Custer County",4,49,98,48,50
050,31,041,"Nebraska","Custer County",4,50,107,53,54
050,31,041,"Nebraska","Custer County",4,51,140,74,66
050,31,041,"Nebraska","Custer County",4,52,107,57,50
050,31,041,"Nebraska","Custer County",4,53,101,50,51
050,31,041,"Nebraska","Custer County",4,54,96,46,50
050,31,041,"Nebraska","Custer County",4,55,94,47,47
050,31,041,"Nebraska","Custer County",4,56,109,60,49
050,31,041,"Nebraska","Custer County",4,57,129,71,58
050,31,041,"Nebraska","Custer County",4,58,153,73,80
050,31,041,"Nebraska","Custer County",4,59,157,76,81
050,31,041,"Nebraska","Custer County",4,60,150,77,73
050,31,041,"Nebraska","Custer County",4,61,164,87,77
050,31,041,"Nebraska","Custer County",4,62,174,92,82
050,31,041,"Nebraska","Custer County",4,63,158,78,80
050,31,041,"Nebraska","Custer County",4,64,145,63,82
050,31,041,"Nebraska","Custer County",4,65,148,79,69
050,31,041,"Nebraska","Custer County",4,66,143,82,61
050,31,041,"Nebraska","Custer County",4,67,142,74,68
050,31,041,"Nebraska","Custer County",4,68,140,71,69
050,31,041,"Nebraska","Custer County",4,69,135,68,67
050,31,041,"Nebraska","Custer County",4,70,130,66,64
050,31,041,"Nebraska","Custer County",4,71,138,66,72
050,31,041,"Nebraska","Custer County",4,72,124,58,66
050,31,041,"Nebraska","Custer County",4,73,119,60,59
050,31,041,"Nebraska","Custer County",4,74,106,51,55
050,31,041,"Nebraska","Custer County",4,75,127,56,71
050,31,041,"Nebraska","Custer County",4,76,85,36,49
050,31,041,"Nebraska","Custer County",4,77,80,41,39
050,31,041,"Nebraska","Custer County",4,78,82,38,44
050,31,041,"Nebraska","Custer County",4,79,74,33,41
050,31,041,"Nebraska","Custer County",4,80,71,33,38
050,31,041,"Nebraska","Custer County",4,81,59,30,29
050,31,041,"Nebraska","Custer County",4,82,52,19,33
050,31,041,"Nebraska","Custer County",4,83,53,21,32
050,31,041,"Nebraska","Custer County",4,84,58,27,31
050,31,041,"Nebraska","Custer County",4,85,323,103,220
050,31,041,"Nebraska","Custer County",5,0,128,63,65
050,31,041,"Nebraska","Custer County",5,1,132,71,61
050,31,041,"Nebraska","Custer County",5,2,133,75,58
050,31,041,"Nebraska","Custer County",5,3,129,71,58
050,31,041,"Nebraska","Custer County",5,4,119,63,56
050,31,041,"Nebraska","Custer County",5,5,133,73,60
050,31,041,"Nebraska","Custer County",5,6,167,94,73
050,31,041,"Nebraska","Custer County",5,7,139,67,72
050,31,041,"Nebraska","Custer County",5,8,153,80,73
050,31,041,"Nebraska","Custer County",5,9,142,67,75
050,31,041,"Nebraska","Custer County",5,10,148,76,72
050,31,041,"Nebraska","Custer County",5,11,136,62,74
050,31,041,"Nebraska","Custer County",5,12,148,84,64
050,31,041,"Nebraska","Custer County",5,13,141,70,71
050,31,041,"Nebraska","Custer County",5,14,151,80,71
050,31,041,"Nebraska","Custer County",5,15,164,85,79
050,31,041,"Nebraska","Custer County",5,16,138,72,66
050,31,041,"Nebraska","Custer County",5,17,161,83,78
050,31,041,"Nebraska","Custer County",5,18,126,66,60
050,31,041,"Nebraska","Custer County",5,19,101,51,50
050,31,041,"Nebraska","Custer County",5,20,105,56,49
050,31,041,"Nebraska","Custer County",5,21,94,51,43
050,31,041,"Nebraska","Custer County",5,22,98,50,48
050,31,041,"Nebraska","Custer County",5,23,92,57,35
050,31,041,"Nebraska","Custer County",5,24,93,59,34
050,31,041,"Nebraska","Custer County",5,25,101,50,51
050,31,041,"Nebraska","Custer County",5,26,117,62,55
050,31,041,"Nebraska","Custer County",5,27,102,53,49
050,31,041,"Nebraska","Custer County",5,28,108,55,53
050,31,041,"Nebraska","Custer County",5,29,114,59,55
050,31,041,"Nebraska","Custer County",5,30,112,56,56
050,31,041,"Nebraska","Custer County",5,31,121,57,64
050,31,041,"Nebraska","Custer County",5,32,137,63,74
050,31,041,"Nebraska","Custer County",5,33,126,59,67
050,31,041,"Nebraska","Custer County",5,34,110,52,58
050,31,041,"Nebraska","Custer County",5,35,120,66,54
050,31,041,"Nebraska","Custer County",5,36,124,74,50
050,31,041,"Nebraska","Custer County",5,37,119,65,54
050,31,041,"Nebraska","Custer County",5,38,131,70,61
050,31,041,"Nebraska","Custer County",5,39,121,63,58
050,31,041,"Nebraska","Custer County",5,40,116,58,58
050,31,041,"Nebraska","Custer County",5,41,118,67,51
050,31,041,"Nebraska","Custer County",5,42,123,65,58
050,31,041,"Nebraska","Custer County",5,43,125,59,66
050,31,041,"Nebraska","Custer County",5,44,118,58,60
050,31,041,"Nebraska","Custer County",5,45,120,59,61
050,31,041,"Nebraska","Custer County",5,46,118,66,52
050,31,041,"Nebraska","Custer County",5,47,124,70,54
050,31,041,"Nebraska","Custer County",5,48,107,50,57
050,31,041,"Nebraska","Custer County",5,49,100,49,51
050,31,041,"Nebraska","Custer County",5,50,97,48,49
050,31,041,"Nebraska","Custer County",5,51,115,57,58
050,31,041,"Nebraska","Custer County",5,52,139,72,67
050,31,041,"Nebraska","Custer County",5,53,107,56,51
050,31,041,"Nebraska","Custer County",5,54,105,51,54
050,31,041,"Nebraska","Custer County",5,55,99,49,50
050,31,041,"Nebraska","Custer County",5,56,95,47,48
050,31,041,"Nebraska","Custer County",5,57,109,60,49
050,31,041,"Nebraska","Custer County",5,58,125,69,56
050,31,041,"Nebraska","Custer County",5,59,153,74,79
050,31,041,"Nebraska","Custer County",5,60,160,78,82
050,31,041,"Nebraska","Custer County",5,61,144,73,71
050,31,041,"Nebraska","Custer County",5,62,166,90,76
050,31,041,"Nebraska","Custer County",5,63,176,92,84
050,31,041,"Nebraska","Custer County",5,64,155,78,77
050,31,041,"Nebraska","Custer County",5,65,146,65,81
050,31,041,"Nebraska","Custer County",5,66,146,77,69
050,31,041,"Nebraska","Custer County",5,67,142,81,61
050,31,041,"Nebraska","Custer County",5,68,143,75,68
050,31,041,"Nebraska","Custer County",5,69,141,70,71
050,31,041,"Nebraska","Custer County",5,70,136,67,69
050,31,041,"Nebraska","Custer County",5,71,134,70,64
050,31,041,"Nebraska","Custer County",5,72,132,62,70
050,31,041,"Nebraska","Custer County",5,73,121,56,65
050,31,041,"Nebraska","Custer County",5,74,114,55,59
050,31,041,"Nebraska","Custer County",5,75,104,51,53
050,31,041,"Nebraska","Custer County",5,76,125,53,72
050,31,041,"Nebraska","Custer County",5,77,79,33,46
050,31,041,"Nebraska","Custer County",5,78,82,40,42
050,31,041,"Nebraska","Custer County",5,79,84,39,45
050,31,041,"Nebraska","Custer County",5,80,70,32,38
050,31,041,"Nebraska","Custer County",5,81,65,28,37
050,31,041,"Nebraska","Custer County",5,82,51,24,27
050,31,041,"Nebraska","Custer County",5,83,53,20,33
050,31,041,"Nebraska","Custer County",5,84,46,18,28
050,31,041,"Nebraska","Custer County",5,85,319,105,214
050,31,043,"Nebraska","Dakota County",1,0,362,184,178
050,31,043,"Nebraska","Dakota County",1,1,371,183,188
050,31,043,"Nebraska","Dakota County",1,2,387,191,196
050,31,043,"Nebraska","Dakota County",1,3,390,205,185
050,31,043,"Nebraska","Dakota County",1,4,377,214,163
050,31,043,"Nebraska","Dakota County",1,5,360,189,171
050,31,043,"Nebraska","Dakota County",1,6,356,186,170
050,31,043,"Nebraska","Dakota County",1,7,369,183,186
050,31,043,"Nebraska","Dakota County",1,8,362,181,181
050,31,043,"Nebraska","Dakota County",1,9,324,159,165
050,31,043,"Nebraska","Dakota County",1,10,355,174,181
050,31,043,"Nebraska","Dakota County",1,11,374,194,180
050,31,043,"Nebraska","Dakota County",1,12,367,188,179
050,31,043,"Nebraska","Dakota County",1,13,337,180,157
050,31,043,"Nebraska","Dakota County",1,14,340,182,158
050,31,043,"Nebraska","Dakota County",1,15,317,180,137
050,31,043,"Nebraska","Dakota County",1,16,329,173,156
050,31,043,"Nebraska","Dakota County",1,17,331,163,168
050,31,043,"Nebraska","Dakota County",1,18,306,156,150
050,31,043,"Nebraska","Dakota County",1,19,256,133,123
050,31,043,"Nebraska","Dakota County",1,20,268,136,132
050,31,043,"Nebraska","Dakota County",1,21,288,137,151
050,31,043,"Nebraska","Dakota County",1,22,282,151,131
050,31,043,"Nebraska","Dakota County",1,23,297,160,137
050,31,043,"Nebraska","Dakota County",1,24,305,159,146
050,31,043,"Nebraska","Dakota County",1,25,284,146,138
050,31,043,"Nebraska","Dakota County",1,26,307,148,159
050,31,043,"Nebraska","Dakota County",1,27,303,154,149
050,31,043,"Nebraska","Dakota County",1,28,290,146,144
050,31,043,"Nebraska","Dakota County",1,29,301,137,164
050,31,043,"Nebraska","Dakota County",1,30,310,151,159
050,31,043,"Nebraska","Dakota County",1,31,303,151,152
050,31,043,"Nebraska","Dakota County",1,32,301,151,150
050,31,043,"Nebraska","Dakota County",1,33,291,156,135
050,31,043,"Nebraska","Dakota County",1,34,280,140,140
050,31,043,"Nebraska","Dakota County",1,35,275,140,135
050,31,043,"Nebraska","Dakota County",1,36,289,150,139
050,31,043,"Nebraska","Dakota County",1,37,276,161,115
050,31,043,"Nebraska","Dakota County",1,38,263,151,112
050,31,043,"Nebraska","Dakota County",1,39,273,151,122
050,31,043,"Nebraska","Dakota County",1,40,241,130,111
050,31,043,"Nebraska","Dakota County",1,41,225,114,111
050,31,043,"Nebraska","Dakota County",1,42,238,126,112
050,31,043,"Nebraska","Dakota County",1,43,219,110,109
050,31,043,"Nebraska","Dakota County",1,44,234,108,126
050,31,043,"Nebraska","Dakota County",1,45,235,116,119
050,31,043,"Nebraska","Dakota County",1,46,207,107,100
050,31,043,"Nebraska","Dakota County",1,47,219,118,101
050,31,043,"Nebraska","Dakota County",1,48,223,109,114
050,31,043,"Nebraska","Dakota County",1,49,256,129,127
050,31,043,"Nebraska","Dakota County",1,50,247,126,121
050,31,043,"Nebraska","Dakota County",1,51,236,112,124
050,31,043,"Nebraska","Dakota County",1,52,233,126,107
050,31,043,"Nebraska","Dakota County",1,53,232,124,108
050,31,043,"Nebraska","Dakota County",1,54,248,132,116
050,31,043,"Nebraska","Dakota County",1,55,252,137,115
050,31,043,"Nebraska","Dakota County",1,56,259,143,116
050,31,043,"Nebraska","Dakota County",1,57,259,137,122
050,31,043,"Nebraska","Dakota County",1,58,270,143,127
050,31,043,"Nebraska","Dakota County",1,59,265,131,134
050,31,043,"Nebraska","Dakota County",1,60,250,127,123
050,31,043,"Nebraska","Dakota County",1,61,235,118,117
050,31,043,"Nebraska","Dakota County",1,62,236,118,118
050,31,043,"Nebraska","Dakota County",1,63,226,114,112
050,31,043,"Nebraska","Dakota County",1,64,236,123,113
050,31,043,"Nebraska","Dakota County",1,65,207,107,100
050,31,043,"Nebraska","Dakota County",1,66,203,102,101
050,31,043,"Nebraska","Dakota County",1,67,193,104,89
050,31,043,"Nebraska","Dakota County",1,68,168,80,88
050,31,043,"Nebraska","Dakota County",1,69,170,80,90
050,31,043,"Nebraska","Dakota County",1,70,166,77,89
050,31,043,"Nebraska","Dakota County",1,71,158,80,78
050,31,043,"Nebraska","Dakota County",1,72,163,81,82
050,31,043,"Nebraska","Dakota County",1,73,156,70,86
050,31,043,"Nebraska","Dakota County",1,74,113,54,59
050,31,043,"Nebraska","Dakota County",1,75,110,53,57
050,31,043,"Nebraska","Dakota County",1,76,124,51,73
050,31,043,"Nebraska","Dakota County",1,77,107,55,52
050,31,043,"Nebraska","Dakota County",1,78,91,40,51
050,31,043,"Nebraska","Dakota County",1,79,81,39,42
050,31,043,"Nebraska","Dakota County",1,80,84,31,53
050,31,043,"Nebraska","Dakota County",1,81,72,30,42
050,31,043,"Nebraska","Dakota County",1,82,67,29,38
050,31,043,"Nebraska","Dakota County",1,83,69,33,36
050,31,043,"Nebraska","Dakota County",1,84,66,28,38
050,31,043,"Nebraska","Dakota County",1,85,282,104,178
050,31,043,"Nebraska","Dakota County",2,0,364,185,179
050,31,043,"Nebraska","Dakota County",2,1,365,183,182
050,31,043,"Nebraska","Dakota County",2,2,381,189,192
050,31,043,"Nebraska","Dakota County",2,3,385,200,185
050,31,043,"Nebraska","Dakota County",2,4,381,210,171
050,31,043,"Nebraska","Dakota County",2,5,369,197,172
050,31,043,"Nebraska","Dakota County",2,6,357,185,172
050,31,043,"Nebraska","Dakota County",2,7,366,184,182
050,31,043,"Nebraska","Dakota County",2,8,360,180,180
050,31,043,"Nebraska","Dakota County",2,9,333,164,169
050,31,043,"Nebraska","Dakota County",2,10,349,171,178
050,31,043,"Nebraska","Dakota County",2,11,366,187,179
050,31,043,"Nebraska","Dakota County",2,12,369,189,180
050,31,043,"Nebraska","Dakota County",2,13,346,183,163
050,31,043,"Nebraska","Dakota County",2,14,338,180,158
050,31,043,"Nebraska","Dakota County",2,15,323,182,141
050,31,043,"Nebraska","Dakota County",2,16,325,174,151
050,31,043,"Nebraska","Dakota County",2,17,333,168,165
050,31,043,"Nebraska","Dakota County",2,18,301,152,149
050,31,043,"Nebraska","Dakota County",2,19,258,131,127
050,31,043,"Nebraska","Dakota County",2,20,265,134,131
050,31,043,"Nebraska","Dakota County",2,21,285,138,147
050,31,043,"Nebraska","Dakota County",2,22,285,149,136
050,31,043,"Nebraska","Dakota County",2,23,293,158,135
050,31,043,"Nebraska","Dakota County",2,24,300,158,142
050,31,043,"Nebraska","Dakota County",2,25,285,147,138
050,31,043,"Nebraska","Dakota County",2,26,300,147,153
050,31,043,"Nebraska","Dakota County",2,27,298,149,149
050,31,043,"Nebraska","Dakota County",2,28,297,149,148
050,31,043,"Nebraska","Dakota County",2,29,299,141,158
050,31,043,"Nebraska","Dakota County",2,30,311,149,162
050,31,043,"Nebraska","Dakota County",2,31,302,148,154
050,31,043,"Nebraska","Dakota County",2,32,300,151,149
050,31,043,"Nebraska","Dakota County",2,33,291,154,137
050,31,043,"Nebraska","Dakota County",2,34,286,145,141
050,31,043,"Nebraska","Dakota County",2,35,277,141,136
050,31,043,"Nebraska","Dakota County",2,36,283,147,136
050,31,043,"Nebraska","Dakota County",2,37,279,159,120
050,31,043,"Nebraska","Dakota County",2,38,267,153,114
050,31,043,"Nebraska","Dakota County",2,39,270,152,118
050,31,043,"Nebraska","Dakota County",2,40,247,135,112
050,31,043,"Nebraska","Dakota County",2,41,224,115,109
050,31,043,"Nebraska","Dakota County",2,42,229,121,108
050,31,043,"Nebraska","Dakota County",2,43,225,115,110
050,31,043,"Nebraska","Dakota County",2,44,230,109,121
050,31,043,"Nebraska","Dakota County",2,45,234,114,120
050,31,043,"Nebraska","Dakota County",2,46,215,110,105
050,31,043,"Nebraska","Dakota County",2,47,215,115,100
050,31,043,"Nebraska","Dakota County",2,48,224,112,112
050,31,043,"Nebraska","Dakota County",2,49,252,126,126
050,31,043,"Nebraska","Dakota County",2,50,250,126,124
050,31,043,"Nebraska","Dakota County",2,51,238,115,123
050,31,043,"Nebraska","Dakota County",2,52,232,122,110
050,31,043,"Nebraska","Dakota County",2,53,230,123,107
050,31,043,"Nebraska","Dakota County",2,54,245,131,114
050,31,043,"Nebraska","Dakota County",2,55,249,133,116
050,31,043,"Nebraska","Dakota County",2,56,258,141,117
050,31,043,"Nebraska","Dakota County",2,57,257,135,122
050,31,043,"Nebraska","Dakota County",2,58,266,141,125
050,31,043,"Nebraska","Dakota County",2,59,264,132,132
050,31,043,"Nebraska","Dakota County",2,60,249,126,123
050,31,043,"Nebraska","Dakota County",2,61,238,120,118
050,31,043,"Nebraska","Dakota County",2,62,234,116,118
050,31,043,"Nebraska","Dakota County",2,63,228,114,114
050,31,043,"Nebraska","Dakota County",2,64,229,119,110
050,31,043,"Nebraska","Dakota County",2,65,208,108,100
050,31,043,"Nebraska","Dakota County",2,66,203,104,99
050,31,043,"Nebraska","Dakota County",2,67,194,103,91
050,31,043,"Nebraska","Dakota County",2,68,173,86,87
050,31,043,"Nebraska","Dakota County",2,69,166,77,89
050,31,043,"Nebraska","Dakota County",2,70,166,78,88
050,31,043,"Nebraska","Dakota County",2,71,158,77,81
050,31,043,"Nebraska","Dakota County",2,72,157,78,79
050,31,043,"Nebraska","Dakota County",2,73,165,77,88
050,31,043,"Nebraska","Dakota County",2,74,113,52,61
050,31,043,"Nebraska","Dakota County",2,75,109,53,56
050,31,043,"Nebraska","Dakota County",2,76,120,51,69
050,31,043,"Nebraska","Dakota County",2,77,113,54,59
050,31,043,"Nebraska","Dakota County",2,78,91,42,49
050,31,043,"Nebraska","Dakota County",2,79,79,37,42
050,31,043,"Nebraska","Dakota County",2,80,83,34,49
050,31,043,"Nebraska","Dakota County",2,81,73,29,44
050,31,043,"Nebraska","Dakota County",2,82,68,30,38
050,31,043,"Nebraska","Dakota County",2,83,66,31,35
050,31,043,"Nebraska","Dakota County",2,84,66,29,37
050,31,043,"Nebraska","Dakota County",2,85,279,102,177
050,31,043,"Nebraska","Dakota County",3,0,325,162,163
050,31,043,"Nebraska","Dakota County",3,1,363,168,195
050,31,043,"Nebraska","Dakota County",3,2,351,178,173
050,31,043,"Nebraska","Dakota County",3,3,352,168,184
050,31,043,"Nebraska","Dakota County",3,4,374,195,179
050,31,043,"Nebraska","Dakota County",3,5,369,187,182
050,31,043,"Nebraska","Dakota County",3,6,358,192,166
050,31,043,"Nebraska","Dakota County",3,7,337,176,161
050,31,043,"Nebraska","Dakota County",3,8,358,181,177
050,31,043,"Nebraska","Dakota County",3,9,345,168,177
050,31,043,"Nebraska","Dakota County",3,10,340,167,173
050,31,043,"Nebraska","Dakota County",3,11,346,180,166
050,31,043,"Nebraska","Dakota County",3,12,355,180,175
050,31,043,"Nebraska","Dakota County",3,13,357,181,176
050,31,043,"Nebraska","Dakota County",3,14,344,187,157
050,31,043,"Nebraska","Dakota County",3,15,330,182,148
050,31,043,"Nebraska","Dakota County",3,16,322,181,141
050,31,043,"Nebraska","Dakota County",3,17,325,179,146
050,31,043,"Nebraska","Dakota County",3,18,298,151,147
050,31,043,"Nebraska","Dakota County",3,19,259,132,127
050,31,043,"Nebraska","Dakota County",3,20,258,130,128
050,31,043,"Nebraska","Dakota County",3,21,273,142,131
050,31,043,"Nebraska","Dakota County",3,22,288,144,144
050,31,043,"Nebraska","Dakota County",3,23,280,143,137
050,31,043,"Nebraska","Dakota County",3,24,284,155,129
050,31,043,"Nebraska","Dakota County",3,25,292,155,137
050,31,043,"Nebraska","Dakota County",3,26,273,142,131
050,31,043,"Nebraska","Dakota County",3,27,288,140,148
050,31,043,"Nebraska","Dakota County",3,28,295,151,144
050,31,043,"Nebraska","Dakota County",3,29,270,130,140
050,31,043,"Nebraska","Dakota County",3,30,304,145,159
050,31,043,"Nebraska","Dakota County",3,31,296,140,156
050,31,043,"Nebraska","Dakota County",3,32,297,143,154
050,31,043,"Nebraska","Dakota County",3,33,304,152,152
050,31,043,"Nebraska","Dakota County",3,34,288,152,136
050,31,043,"Nebraska","Dakota County",3,35,274,145,129
050,31,043,"Nebraska","Dakota County",3,36,266,134,132
050,31,043,"Nebraska","Dakota County",3,37,281,151,130
050,31,043,"Nebraska","Dakota County",3,38,267,147,120
050,31,043,"Nebraska","Dakota County",3,39,266,157,109
050,31,043,"Nebraska","Dakota County",3,40,257,149,108
050,31,043,"Nebraska","Dakota County",3,41,240,120,120
050,31,043,"Nebraska","Dakota County",3,42,228,120,108
050,31,043,"Nebraska","Dakota County",3,43,230,125,105
050,31,043,"Nebraska","Dakota County",3,44,224,117,107
050,31,043,"Nebraska","Dakota County",3,45,226,111,115
050,31,043,"Nebraska","Dakota County",3,46,234,114,120
050,31,043,"Nebraska","Dakota County",3,47,219,110,109
050,31,043,"Nebraska","Dakota County",3,48,209,111,98
050,31,043,"Nebraska","Dakota County",3,49,221,114,107
050,31,043,"Nebraska","Dakota County",3,50,236,118,118
050,31,043,"Nebraska","Dakota County",3,51,255,128,127
050,31,043,"Nebraska","Dakota County",3,52,238,114,124
050,31,043,"Nebraska","Dakota County",3,53,231,117,114
050,31,043,"Nebraska","Dakota County",3,54,218,110,108
050,31,043,"Nebraska","Dakota County",3,55,237,129,108
050,31,043,"Nebraska","Dakota County",3,56,242,133,109
050,31,043,"Nebraska","Dakota County",3,57,256,142,114
050,31,043,"Nebraska","Dakota County",3,58,258,137,121
050,31,043,"Nebraska","Dakota County",3,59,273,145,128
050,31,043,"Nebraska","Dakota County",3,60,256,133,123
050,31,043,"Nebraska","Dakota County",3,61,248,124,124
050,31,043,"Nebraska","Dakota County",3,62,241,120,121
050,31,043,"Nebraska","Dakota County",3,63,231,116,115
050,31,043,"Nebraska","Dakota County",3,64,219,109,110
050,31,043,"Nebraska","Dakota County",3,65,222,113,109
050,31,043,"Nebraska","Dakota County",3,66,199,103,96
050,31,043,"Nebraska","Dakota County",3,67,195,98,97
050,31,043,"Nebraska","Dakota County",3,68,186,99,87
050,31,043,"Nebraska","Dakota County",3,69,163,78,85
050,31,043,"Nebraska","Dakota County",3,70,160,72,88
050,31,043,"Nebraska","Dakota County",3,71,168,82,86
050,31,043,"Nebraska","Dakota County",3,72,152,71,81
050,31,043,"Nebraska","Dakota County",3,73,150,73,77
050,31,043,"Nebraska","Dakota County",3,74,156,72,84
050,31,043,"Nebraska","Dakota County",3,75,110,54,56
050,31,043,"Nebraska","Dakota County",3,76,108,50,58
050,31,043,"Nebraska","Dakota County",3,77,119,48,71
050,31,043,"Nebraska","Dakota County",3,78,104,50,54
050,31,043,"Nebraska","Dakota County",3,79,82,36,46
050,31,043,"Nebraska","Dakota County",3,80,77,36,41
050,31,043,"Nebraska","Dakota County",3,81,78,32,46
050,31,043,"Nebraska","Dakota County",3,82,65,27,38
050,31,043,"Nebraska","Dakota County",3,83,65,27,38
050,31,043,"Nebraska","Dakota County",3,84,57,29,28
050,31,043,"Nebraska","Dakota County",3,85,287,110,177
050,31,043,"Nebraska","Dakota County",4,0,331,172,159
050,31,043,"Nebraska","Dakota County",4,1,324,168,156
050,31,043,"Nebraska","Dakota County",4,2,347,168,179
050,31,043,"Nebraska","Dakota County",4,3,344,176,168
050,31,043,"Nebraska","Dakota County",4,4,344,161,183
050,31,043,"Nebraska","Dakota County",4,5,373,194,179
050,31,043,"Nebraska","Dakota County",4,6,372,190,182
050,31,043,"Nebraska","Dakota County",4,7,342,175,167
050,31,043,"Nebraska","Dakota County",4,8,347,172,175
050,31,043,"Nebraska","Dakota County",4,9,345,172,173
050,31,043,"Nebraska","Dakota County",4,10,366,182,184
050,31,043,"Nebraska","Dakota County",4,11,341,180,161
050,31,043,"Nebraska","Dakota County",4,12,343,187,156
050,31,043,"Nebraska","Dakota County",4,13,348,174,174
050,31,043,"Nebraska","Dakota County",4,14,339,165,174
050,31,043,"Nebraska","Dakota County",4,15,339,183,156
050,31,043,"Nebraska","Dakota County",4,16,331,179,152
050,31,043,"Nebraska","Dakota County",4,17,317,179,138
050,31,043,"Nebraska","Dakota County",4,18,293,166,127
050,31,043,"Nebraska","Dakota County",4,19,261,128,133
050,31,043,"Nebraska","Dakota County",4,20,257,136,121
050,31,043,"Nebraska","Dakota County",4,21,271,139,132
050,31,043,"Nebraska","Dakota County",4,22,266,129,137
050,31,043,"Nebraska","Dakota County",4,23,291,142,149
050,31,043,"Nebraska","Dakota County",4,24,277,134,143
050,31,043,"Nebraska","Dakota County",4,25,267,142,125
050,31,043,"Nebraska","Dakota County",4,26,275,135,140
050,31,043,"Nebraska","Dakota County",4,27,247,130,117
050,31,043,"Nebraska","Dakota County",4,28,302,148,154
050,31,043,"Nebraska","Dakota County",4,29,285,142,143
050,31,043,"Nebraska","Dakota County",4,30,266,135,131
050,31,043,"Nebraska","Dakota County",4,31,300,145,155
050,31,043,"Nebraska","Dakota County",4,32,289,135,154
050,31,043,"Nebraska","Dakota County",4,33,287,138,149
050,31,043,"Nebraska","Dakota County",4,34,288,143,145
050,31,043,"Nebraska","Dakota County",4,35,285,154,131
050,31,043,"Nebraska","Dakota County",4,36,262,145,117
050,31,043,"Nebraska","Dakota County",4,37,259,134,125
050,31,043,"Nebraska","Dakota County",4,38,276,143,133
050,31,043,"Nebraska","Dakota County",4,39,277,150,127
050,31,043,"Nebraska","Dakota County",4,40,262,153,109
050,31,043,"Nebraska","Dakota County",4,41,255,145,110
050,31,043,"Nebraska","Dakota County",4,42,233,114,119
050,31,043,"Nebraska","Dakota County",4,43,235,125,110
050,31,043,"Nebraska","Dakota County",4,44,224,120,104
050,31,043,"Nebraska","Dakota County",4,45,224,116,108
050,31,043,"Nebraska","Dakota County",4,46,225,114,111
050,31,043,"Nebraska","Dakota County",4,47,236,111,125
050,31,043,"Nebraska","Dakota County",4,48,199,99,100
050,31,043,"Nebraska","Dakota County",4,49,214,114,100
050,31,043,"Nebraska","Dakota County",4,50,212,105,107
050,31,043,"Nebraska","Dakota County",4,51,245,127,118
050,31,043,"Nebraska","Dakota County",4,52,246,126,120
050,31,043,"Nebraska","Dakota County",4,53,236,117,119
050,31,043,"Nebraska","Dakota County",4,54,231,117,114
050,31,043,"Nebraska","Dakota County",4,55,215,110,105
050,31,043,"Nebraska","Dakota County",4,56,238,128,110
050,31,043,"Nebraska","Dakota County",4,57,233,128,105
050,31,043,"Nebraska","Dakota County",4,58,255,139,116
050,31,043,"Nebraska","Dakota County",4,59,254,135,119
050,31,043,"Nebraska","Dakota County",4,60,266,142,124
050,31,043,"Nebraska","Dakota County",4,61,241,125,116
050,31,043,"Nebraska","Dakota County",4,62,243,122,121
050,31,043,"Nebraska","Dakota County",4,63,233,113,120
050,31,043,"Nebraska","Dakota County",4,64,224,107,117
050,31,043,"Nebraska","Dakota County",4,65,206,100,106
050,31,043,"Nebraska","Dakota County",4,66,220,115,105
050,31,043,"Nebraska","Dakota County",4,67,206,110,96
050,31,043,"Nebraska","Dakota County",4,68,182,93,89
050,31,043,"Nebraska","Dakota County",4,69,180,96,84
050,31,043,"Nebraska","Dakota County",4,70,161,79,82
050,31,043,"Nebraska","Dakota County",4,71,147,70,77
050,31,043,"Nebraska","Dakota County",4,72,161,81,80
050,31,043,"Nebraska","Dakota County",4,73,150,72,78
050,31,043,"Nebraska","Dakota County",4,74,142,71,71
050,31,043,"Nebraska","Dakota County",4,75,148,69,79
050,31,043,"Nebraska","Dakota County",4,76,104,51,53
050,31,043,"Nebraska","Dakota County",4,77,106,45,61
050,31,043,"Nebraska","Dakota County",4,78,109,41,68
050,31,043,"Nebraska","Dakota County",4,79,102,49,53
050,31,043,"Nebraska","Dakota County",4,80,70,28,42
050,31,043,"Nebraska","Dakota County",4,81,75,37,38
050,31,043,"Nebraska","Dakota County",4,82,74,28,46
050,31,043,"Nebraska","Dakota County",4,83,66,25,41
050,31,043,"Nebraska","Dakota County",4,84,59,26,33
050,31,043,"Nebraska","Dakota County",4,85,295,122,173
050,31,043,"Nebraska","Dakota County",5,0,368,193,175
050,31,043,"Nebraska","Dakota County",5,1,324,167,157
050,31,043,"Nebraska","Dakota County",5,2,328,175,153
050,31,043,"Nebraska","Dakota County",5,3,347,174,173
050,31,043,"Nebraska","Dakota County",5,4,337,176,161
050,31,043,"Nebraska","Dakota County",5,5,342,160,182
050,31,043,"Nebraska","Dakota County",5,6,374,194,180
050,31,043,"Nebraska","Dakota County",5,7,361,185,176
050,31,043,"Nebraska","Dakota County",5,8,346,181,165
050,31,043,"Nebraska","Dakota County",5,9,344,178,166
050,31,043,"Nebraska","Dakota County",5,10,389,209,180
050,31,043,"Nebraska","Dakota County",5,11,371,188,183
050,31,043,"Nebraska","Dakota County",5,12,332,175,157
050,31,043,"Nebraska","Dakota County",5,13,346,185,161
050,31,043,"Nebraska","Dakota County",5,14,351,179,172
050,31,043,"Nebraska","Dakota County",5,15,341,167,174
050,31,043,"Nebraska","Dakota County",5,16,327,172,155
050,31,043,"Nebraska","Dakota County",5,17,330,183,147
050,31,043,"Nebraska","Dakota County",5,18,277,163,114
050,31,043,"Nebraska","Dakota County",5,19,242,134,108
050,31,043,"Nebraska","Dakota County",5,20,273,133,140
050,31,043,"Nebraska","Dakota County",5,21,279,147,132
050,31,043,"Nebraska","Dakota County",5,22,264,139,125
050,31,043,"Nebraska","Dakota County",5,23,278,140,138
050,31,043,"Nebraska","Dakota County",5,24,303,145,158
050,31,043,"Nebraska","Dakota County",5,25,272,131,141
050,31,043,"Nebraska","Dakota County",5,26,273,141,132
050,31,043,"Nebraska","Dakota County",5,27,262,129,133
050,31,043,"Nebraska","Dakota County",5,28,265,141,124
050,31,043,"Nebraska","Dakota County",5,29,296,143,153
050,31,043,"Nebraska","Dakota County",5,30,291,146,145
050,31,043,"Nebraska","Dakota County",5,31,273,142,131
050,31,043,"Nebraska","Dakota County",5,32,307,152,155
050,31,043,"Nebraska","Dakota County",5,33,288,136,152
050,31,043,"Nebraska","Dakota County",5,34,288,143,145
050,31,043,"Nebraska","Dakota County",5,35,288,141,147
050,31,043,"Nebraska","Dakota County",5,36,291,166,125
050,31,043,"Nebraska","Dakota County",5,37,263,152,111
050,31,043,"Nebraska","Dakota County",5,38,252,128,124
050,31,043,"Nebraska","Dakota County",5,39,284,148,136
050,31,043,"Nebraska","Dakota County",5,40,276,148,128
050,31,043,"Nebraska","Dakota County",5,41,263,150,113
050,31,043,"Nebraska","Dakota County",5,42,244,141,103
050,31,043,"Nebraska","Dakota County",5,43,235,121,114
050,31,043,"Nebraska","Dakota County",5,44,226,118,108
050,31,043,"Nebraska","Dakota County",5,45,222,121,101
050,31,043,"Nebraska","Dakota County",5,46,216,108,108
050,31,043,"Nebraska","Dakota County",5,47,236,122,114
050,31,043,"Nebraska","Dakota County",5,48,230,107,123
050,31,043,"Nebraska","Dakota County",5,49,208,106,102
050,31,043,"Nebraska","Dakota County",5,50,201,106,95
050,31,043,"Nebraska","Dakota County",5,51,212,105,107
050,31,043,"Nebraska","Dakota County",5,52,248,130,118
050,31,043,"Nebraska","Dakota County",5,53,239,122,117
050,31,043,"Nebraska","Dakota County",5,54,231,117,114
050,31,043,"Nebraska","Dakota County",5,55,236,120,116
050,31,043,"Nebraska","Dakota County",5,56,227,113,114
050,31,043,"Nebraska","Dakota County",5,57,229,121,108
050,31,043,"Nebraska","Dakota County",5,58,233,129,104
050,31,043,"Nebraska","Dakota County",5,59,254,139,115
050,31,043,"Nebraska","Dakota County",5,60,249,134,115
050,31,043,"Nebraska","Dakota County",5,61,263,142,121
050,31,043,"Nebraska","Dakota County",5,62,243,127,116
050,31,043,"Nebraska","Dakota County",5,63,237,119,118
050,31,043,"Nebraska","Dakota County",5,64,242,116,126
050,31,043,"Nebraska","Dakota County",5,65,219,104,115
050,31,043,"Nebraska","Dakota County",5,66,200,94,106
050,31,043,"Nebraska","Dakota County",5,67,213,111,102
050,31,043,"Nebraska","Dakota County",5,68,191,104,87
050,31,043,"Nebraska","Dakota County",5,69,173,90,83
050,31,043,"Nebraska","Dakota County",5,70,174,93,81
050,31,043,"Nebraska","Dakota County",5,71,160,84,76
050,31,043,"Nebraska","Dakota County",5,72,138,68,70
050,31,043,"Nebraska","Dakota County",5,73,157,78,79
050,31,043,"Nebraska","Dakota County",5,74,142,72,70
050,31,043,"Nebraska","Dakota County",5,75,134,67,67
050,31,043,"Nebraska","Dakota County",5,76,141,67,74
050,31,043,"Nebraska","Dakota County",5,77,100,46,54
050,31,043,"Nebraska","Dakota County",5,78,97,38,59
050,31,043,"Nebraska","Dakota County",5,79,100,38,62
050,31,043,"Nebraska","Dakota County",5,80,89,41,48
050,31,043,"Nebraska","Dakota County",5,81,70,27,43
050,31,043,"Nebraska","Dakota County",5,82,72,34,38
050,31,043,"Nebraska","Dakota County",5,83,71,26,45
050,31,043,"Nebraska","Dakota County",5,84,63,25,38
050,31,043,"Nebraska","Dakota County",5,85,297,133,164
050,31,045,"Nebraska","Dawes County",1,0,75,39,36
050,31,045,"Nebraska","Dawes County",1,1,74,38,36
050,31,045,"Nebraska","Dawes County",1,2,63,33,30
050,31,045,"Nebraska","Dawes County",1,3,78,42,36
050,31,045,"Nebraska","Dawes County",1,4,89,44,45
050,31,045,"Nebraska","Dawes County",1,5,79,45,34
050,31,045,"Nebraska","Dawes County",1,6,84,46,38
050,31,045,"Nebraska","Dawes County",1,7,82,41,41
050,31,045,"Nebraska","Dawes County",1,8,89,46,43
050,31,045,"Nebraska","Dawes County",1,9,73,38,35
050,31,045,"Nebraska","Dawes County",1,10,80,41,39
050,31,045,"Nebraska","Dawes County",1,11,84,41,43
050,31,045,"Nebraska","Dawes County",1,12,80,42,38
050,31,045,"Nebraska","Dawes County",1,13,78,38,40
050,31,045,"Nebraska","Dawes County",1,14,91,39,52
050,31,045,"Nebraska","Dawes County",1,15,81,35,46
050,31,045,"Nebraska","Dawes County",1,16,81,41,40
050,31,045,"Nebraska","Dawes County",1,17,81,32,49
050,31,045,"Nebraska","Dawes County",1,18,165,64,101
050,31,045,"Nebraska","Dawes County",1,19,332,157,175
050,31,045,"Nebraska","Dawes County",1,20,301,159,142
050,31,045,"Nebraska","Dawes County",1,21,259,136,123
050,31,045,"Nebraska","Dawes County",1,22,268,110,158
050,31,045,"Nebraska","Dawes County",1,23,154,86,68
050,31,045,"Nebraska","Dawes County",1,24,144,71,73
050,31,045,"Nebraska","Dawes County",1,25,109,58,51
050,31,045,"Nebraska","Dawes County",1,26,87,48,39
050,31,045,"Nebraska","Dawes County",1,27,94,44,50
050,31,045,"Nebraska","Dawes County",1,28,89,40,49
050,31,045,"Nebraska","Dawes County",1,29,75,39,36
050,31,045,"Nebraska","Dawes County",1,30,81,42,39
050,31,045,"Nebraska","Dawes County",1,31,83,43,40
050,31,045,"Nebraska","Dawes County",1,32,74,43,31
050,31,045,"Nebraska","Dawes County",1,33,70,35,35
050,31,045,"Nebraska","Dawes County",1,34,81,40,41
050,31,045,"Nebraska","Dawes County",1,35,80,42,38
050,31,045,"Nebraska","Dawes County",1,36,81,43,38
050,31,045,"Nebraska","Dawes County",1,37,87,45,42
050,31,045,"Nebraska","Dawes County",1,38,92,51,41
050,31,045,"Nebraska","Dawes County",1,39,88,38,50
050,31,045,"Nebraska","Dawes County",1,40,88,42,46
050,31,045,"Nebraska","Dawes County",1,41,87,46,41
050,31,045,"Nebraska","Dawes County",1,42,82,44,38
050,31,045,"Nebraska","Dawes County",1,43,81,43,38
050,31,045,"Nebraska","Dawes County",1,44,67,35,32
050,31,045,"Nebraska","Dawes County",1,45,74,37,37
050,31,045,"Nebraska","Dawes County",1,46,71,37,34
050,31,045,"Nebraska","Dawes County",1,47,70,37,33
050,31,045,"Nebraska","Dawes County",1,48,81,43,38
050,31,045,"Nebraska","Dawes County",1,49,78,43,35
050,31,045,"Nebraska","Dawes County",1,50,77,39,38
050,31,045,"Nebraska","Dawes County",1,51,82,40,42
050,31,045,"Nebraska","Dawes County",1,52,86,45,41
050,31,045,"Nebraska","Dawes County",1,53,79,44,35
050,31,045,"Nebraska","Dawes County",1,54,77,39,38
050,31,045,"Nebraska","Dawes County",1,55,87,36,51
050,31,045,"Nebraska","Dawes County",1,56,86,34,52
050,31,045,"Nebraska","Dawes County",1,57,104,47,57
050,31,045,"Nebraska","Dawes County",1,58,117,50,67
050,31,045,"Nebraska","Dawes County",1,59,113,50,63
050,31,045,"Nebraska","Dawes County",1,60,109,53,56
050,31,045,"Nebraska","Dawes County",1,61,116,57,59
050,31,045,"Nebraska","Dawes County",1,62,115,54,61
050,31,045,"Nebraska","Dawes County",1,63,114,56,58
050,31,045,"Nebraska","Dawes County",1,64,112,59,53
050,31,045,"Nebraska","Dawes County",1,65,95,55,40
050,31,045,"Nebraska","Dawes County",1,66,104,51,53
050,31,045,"Nebraska","Dawes County",1,67,102,53,49
050,31,045,"Nebraska","Dawes County",1,68,96,49,47
050,31,045,"Nebraska","Dawes County",1,69,83,37,46
050,31,045,"Nebraska","Dawes County",1,70,87,42,45
050,31,045,"Nebraska","Dawes County",1,71,81,36,45
050,31,045,"Nebraska","Dawes County",1,72,71,34,37
050,31,045,"Nebraska","Dawes County",1,73,78,39,39
050,31,045,"Nebraska","Dawes County",1,74,55,28,27
050,31,045,"Nebraska","Dawes County",1,75,70,28,42
050,31,045,"Nebraska","Dawes County",1,76,57,26,31
050,31,045,"Nebraska","Dawes County",1,77,62,31,31
050,31,045,"Nebraska","Dawes County",1,78,57,25,32
050,31,045,"Nebraska","Dawes County",1,79,42,16,26
050,31,045,"Nebraska","Dawes County",1,80,51,22,29
050,31,045,"Nebraska","Dawes County",1,81,47,21,26
050,31,045,"Nebraska","Dawes County",1,82,34,15,19
050,31,045,"Nebraska","Dawes County",1,83,38,22,16
050,31,045,"Nebraska","Dawes County",1,84,43,18,25
050,31,045,"Nebraska","Dawes County",1,85,258,94,164
050,31,045,"Nebraska","Dawes County",2,0,82,44,38
050,31,045,"Nebraska","Dawes County",2,1,74,38,36
050,31,045,"Nebraska","Dawes County",2,2,66,34,32
050,31,045,"Nebraska","Dawes County",2,3,73,38,35
050,31,045,"Nebraska","Dawes County",2,4,86,43,43
050,31,045,"Nebraska","Dawes County",2,5,84,46,38
050,31,045,"Nebraska","Dawes County",2,6,84,46,38
050,31,045,"Nebraska","Dawes County",2,7,83,43,40
050,31,045,"Nebraska","Dawes County",2,8,87,45,42
050,31,045,"Nebraska","Dawes County",2,9,76,40,36
050,31,045,"Nebraska","Dawes County",2,10,79,41,38
050,31,045,"Nebraska","Dawes County",2,11,82,41,41
050,31,045,"Nebraska","Dawes County",2,12,81,41,40
050,31,045,"Nebraska","Dawes County",2,13,79,39,40
050,31,045,"Nebraska","Dawes County",2,14,87,38,49
050,31,045,"Nebraska","Dawes County",2,15,83,36,47
050,31,045,"Nebraska","Dawes County",2,16,82,40,42
050,31,045,"Nebraska","Dawes County",2,17,78,32,46
050,31,045,"Nebraska","Dawes County",2,18,166,64,102
050,31,045,"Nebraska","Dawes County",2,19,332,157,175
050,31,045,"Nebraska","Dawes County",2,20,298,156,142
050,31,045,"Nebraska","Dawes County",2,21,258,136,122
050,31,045,"Nebraska","Dawes County",2,22,267,110,157
050,31,045,"Nebraska","Dawes County",2,23,153,85,68
050,31,045,"Nebraska","Dawes County",2,24,139,67,72
050,31,045,"Nebraska","Dawes County",2,25,103,53,50
050,31,045,"Nebraska","Dawes County",2,26,90,48,42
050,31,045,"Nebraska","Dawes County",2,27,89,43,46
050,31,045,"Nebraska","Dawes County",2,28,85,38,47
050,31,045,"Nebraska","Dawes County",2,29,78,40,38
050,31,045,"Nebraska","Dawes County",2,30,79,42,37
050,31,045,"Nebraska","Dawes County",2,31,81,42,39
050,31,045,"Nebraska","Dawes County",2,32,75,41,34
050,31,045,"Nebraska","Dawes County",2,33,72,37,35
050,31,045,"Nebraska","Dawes County",2,34,79,40,39
050,31,045,"Nebraska","Dawes County",2,35,83,44,39
050,31,045,"Nebraska","Dawes County",2,36,79,43,36
050,31,045,"Nebraska","Dawes County",2,37,86,45,41
050,31,045,"Nebraska","Dawes County",2,38,92,50,42
050,31,045,"Nebraska","Dawes County",2,39,88,41,47
050,31,045,"Nebraska","Dawes County",2,40,87,40,47
050,31,045,"Nebraska","Dawes County",2,41,86,45,41
050,31,045,"Nebraska","Dawes County",2,42,83,45,38
050,31,045,"Nebraska","Dawes County",2,43,81,44,37
050,31,045,"Nebraska","Dawes County",2,44,70,37,33
050,31,045,"Nebraska","Dawes County",2,45,73,37,36
050,31,045,"Nebraska","Dawes County",2,46,71,37,34
050,31,045,"Nebraska","Dawes County",2,47,71,37,34
050,31,045,"Nebraska","Dawes County",2,48,79,41,38
050,31,045,"Nebraska","Dawes County",2,49,79,43,36
050,31,045,"Nebraska","Dawes County",2,50,75,39,36
050,31,045,"Nebraska","Dawes County",2,51,81,40,41
050,31,045,"Nebraska","Dawes County",2,52,82,42,40
050,31,045,"Nebraska","Dawes County",2,53,80,44,36
050,31,045,"Nebraska","Dawes County",2,54,77,40,37
050,31,045,"Nebraska","Dawes County",2,55,86,37,49
050,31,045,"Nebraska","Dawes County",2,56,85,34,51
050,31,045,"Nebraska","Dawes County",2,57,100,44,56
050,31,045,"Nebraska","Dawes County",2,58,112,48,64
050,31,045,"Nebraska","Dawes County",2,59,111,48,63
050,31,045,"Nebraska","Dawes County",2,60,109,51,58
050,31,045,"Nebraska","Dawes County",2,61,112,55,57
050,31,045,"Nebraska","Dawes County",2,62,113,54,59
050,31,045,"Nebraska","Dawes County",2,63,115,56,59
050,31,045,"Nebraska","Dawes County",2,64,111,57,54
050,31,045,"Nebraska","Dawes County",2,65,98,54,44
050,31,045,"Nebraska","Dawes County",2,66,103,53,50
050,31,045,"Nebraska","Dawes County",2,67,101,52,49
050,31,045,"Nebraska","Dawes County",2,68,95,49,46
050,31,045,"Nebraska","Dawes County",2,69,85,40,45
050,31,045,"Nebraska","Dawes County",2,70,85,40,45
050,31,045,"Nebraska","Dawes County",2,71,83,37,46
050,31,045,"Nebraska","Dawes County",2,72,74,35,39
050,31,045,"Nebraska","Dawes County",2,73,79,40,39
050,31,045,"Nebraska","Dawes County",2,74,55,28,27
050,31,045,"Nebraska","Dawes County",2,75,67,29,38
050,31,045,"Nebraska","Dawes County",2,76,59,26,33
050,31,045,"Nebraska","Dawes County",2,77,61,29,32
050,31,045,"Nebraska","Dawes County",2,78,57,25,32
050,31,045,"Nebraska","Dawes County",2,79,43,18,25
050,31,045,"Nebraska","Dawes County",2,80,47,21,26
050,31,045,"Nebraska","Dawes County",2,81,47,21,26
050,31,045,"Nebraska","Dawes County",2,82,37,16,21
050,31,045,"Nebraska","Dawes County",2,83,36,20,16
050,31,045,"Nebraska","Dawes County",2,84,42,19,23
050,31,045,"Nebraska","Dawes County",2,85,255,91,164
050,31,045,"Nebraska","Dawes County",3,0,77,36,41
050,31,045,"Nebraska","Dawes County",3,1,91,50,41
050,31,045,"Nebraska","Dawes County",3,2,74,37,37
050,31,045,"Nebraska","Dawes County",3,3,68,37,31
050,31,045,"Nebraska","Dawes County",3,4,77,40,37
050,31,045,"Nebraska","Dawes County",3,5,81,41,40
050,31,045,"Nebraska","Dawes County",3,6,82,45,37
050,31,045,"Nebraska","Dawes County",3,7,88,47,41
050,31,045,"Nebraska","Dawes County",3,8,82,41,41
050,31,045,"Nebraska","Dawes County",3,9,91,44,47
050,31,045,"Nebraska","Dawes County",3,10,74,39,35
050,31,045,"Nebraska","Dawes County",3,11,74,38,36
050,31,045,"Nebraska","Dawes County",3,12,83,41,42
050,31,045,"Nebraska","Dawes County",3,13,80,40,40
050,31,045,"Nebraska","Dawes County",3,14,80,38,42
050,31,045,"Nebraska","Dawes County",3,15,83,37,46
050,31,045,"Nebraska","Dawes County",3,16,81,34,47
050,31,045,"Nebraska","Dawes County",3,17,89,44,45
050,31,045,"Nebraska","Dawes County",3,18,163,59,104
050,31,045,"Nebraska","Dawes County",3,19,329,153,176
050,31,045,"Nebraska","Dawes County",3,20,290,146,144
050,31,045,"Nebraska","Dawes County",3,21,259,139,120
050,31,045,"Nebraska","Dawes County",3,22,259,113,146
050,31,045,"Nebraska","Dawes County",3,23,154,76,78
050,31,045,"Nebraska","Dawes County",3,24,133,63,70
050,31,045,"Nebraska","Dawes County",3,25,95,49,46
050,31,045,"Nebraska","Dawes County",3,26,96,47,49
050,31,045,"Nebraska","Dawes County",3,27,79,42,37
050,31,045,"Nebraska","Dawes County",3,28,87,38,49
050,31,045,"Nebraska","Dawes County",3,29,85,39,46
050,31,045,"Nebraska","Dawes County",3,30,83,44,39
050,31,045,"Nebraska","Dawes County",3,31,79,39,40
050,31,045,"Nebraska","Dawes County",3,32,79,44,35
050,31,045,"Nebraska","Dawes County",3,33,78,40,38
050,31,045,"Nebraska","Dawes County",3,34,71,37,34
050,31,045,"Nebraska","Dawes County",3,35,74,40,34
050,31,045,"Nebraska","Dawes County",3,36,81,42,39
050,31,045,"Nebraska","Dawes County",3,37,84,45,39
050,31,045,"Nebraska","Dawes County",3,38,84,43,41
050,31,045,"Nebraska","Dawes County",3,39,96,51,45
050,31,045,"Nebraska","Dawes County",3,40,85,39,46
050,31,045,"Nebraska","Dawes County",3,41,89,42,47
050,31,045,"Nebraska","Dawes County",3,42,85,42,43
050,31,045,"Nebraska","Dawes County",3,43,84,46,38
050,31,045,"Nebraska","Dawes County",3,44,82,45,37
050,31,045,"Nebraska","Dawes County",3,45,73,40,33
050,31,045,"Nebraska","Dawes County",3,46,70,32,38
050,31,045,"Nebraska","Dawes County",3,47,73,37,36
050,31,045,"Nebraska","Dawes County",3,48,70,37,33
050,31,045,"Nebraska","Dawes County",3,49,76,38,38
050,31,045,"Nebraska","Dawes County",3,50,80,43,37
050,31,045,"Nebraska","Dawes County",3,51,76,38,38
050,31,045,"Nebraska","Dawes County",3,52,82,40,42
050,31,045,"Nebraska","Dawes County",3,53,76,37,39
050,31,045,"Nebraska","Dawes County",3,54,85,47,38
050,31,045,"Nebraska","Dawes County",3,55,80,41,39
050,31,045,"Nebraska","Dawes County",3,56,85,37,48
050,31,045,"Nebraska","Dawes County",3,57,84,36,48
050,31,045,"Nebraska","Dawes County",3,58,93,43,50
050,31,045,"Nebraska","Dawes County",3,59,112,46,66
050,31,045,"Nebraska","Dawes County",3,60,110,47,63
050,31,045,"Nebraska","Dawes County",3,61,109,49,60
050,31,045,"Nebraska","Dawes County",3,62,105,54,51
050,31,045,"Nebraska","Dawes County",3,63,116,56,60
050,31,045,"Nebraska","Dawes County",3,64,112,55,57
050,31,045,"Nebraska","Dawes County",3,65,100,54,46
050,31,045,"Nebraska","Dawes County",3,66,97,53,44
050,31,045,"Nebraska","Dawes County",3,67,105,55,50
050,31,045,"Nebraska","Dawes County",3,68,99,50,49
050,31,045,"Nebraska","Dawes County",3,69,97,49,48
050,31,045,"Nebraska","Dawes County",3,70,85,42,43
050,31,045,"Nebraska","Dawes County",3,71,84,40,44
050,31,045,"Nebraska","Dawes County",3,72,84,37,47
050,31,045,"Nebraska","Dawes County",3,73,74,37,37
050,31,045,"Nebraska","Dawes County",3,74,78,37,41
050,31,045,"Nebraska","Dawes County",3,75,55,27,28
050,31,045,"Nebraska","Dawes County",3,76,67,28,39
050,31,045,"Nebraska","Dawes County",3,77,57,24,33
050,31,045,"Nebraska","Dawes County",3,78,58,27,31
050,31,045,"Nebraska","Dawes County",3,79,55,22,33
050,31,045,"Nebraska","Dawes County",3,80,47,20,27
050,31,045,"Nebraska","Dawes County",3,81,44,20,24
050,31,045,"Nebraska","Dawes County",3,82,46,19,27
050,31,045,"Nebraska","Dawes County",3,83,35,14,21
050,31,045,"Nebraska","Dawes County",3,84,34,17,17
050,31,045,"Nebraska","Dawes County",3,85,263,98,165
050,31,045,"Nebraska","Dawes County",4,0,76,35,41
050,31,045,"Nebraska","Dawes County",4,1,79,41,38
050,31,045,"Nebraska","Dawes County",4,2,92,51,41
050,31,045,"Nebraska","Dawes County",4,3,85,39,46
050,31,045,"Nebraska","Dawes County",4,4,66,35,31
050,31,045,"Nebraska","Dawes County",4,5,78,43,35
050,31,045,"Nebraska","Dawes County",4,6,86,42,44
050,31,045,"Nebraska","Dawes County",4,7,82,43,39
050,31,045,"Nebraska","Dawes County",4,8,91,47,44
050,31,045,"Nebraska","Dawes County",4,9,86,42,44
050,31,045,"Nebraska","Dawes County",4,10,91,45,46
050,31,045,"Nebraska","Dawes County",4,11,82,46,36
050,31,045,"Nebraska","Dawes County",4,12,74,37,37
050,31,045,"Nebraska","Dawes County",4,13,85,44,41
050,31,045,"Nebraska","Dawes County",4,14,89,48,41
050,31,045,"Nebraska","Dawes County",4,15,87,41,46
050,31,045,"Nebraska","Dawes County",4,16,85,40,45
050,31,045,"Nebraska","Dawes County",4,17,81,32,49
050,31,045,"Nebraska","Dawes County",4,18,180,74,106
050,31,045,"Nebraska","Dawes County",4,19,328,154,174
050,31,045,"Nebraska","Dawes County",4,20,301,151,150
050,31,045,"Nebraska","Dawes County",4,21,260,136,124
050,31,045,"Nebraska","Dawes County",4,22,269,116,153
050,31,045,"Nebraska","Dawes County",4,23,148,88,60
050,31,045,"Nebraska","Dawes County",4,24,143,62,81
050,31,045,"Nebraska","Dawes County",4,25,98,48,50
050,31,045,"Nebraska","Dawes County",4,26,89,42,47
050,31,045,"Nebraska","Dawes County",4,27,87,44,43
050,31,045,"Nebraska","Dawes County",4,28,84,46,38
050,31,045,"Nebraska","Dawes County",4,29,85,38,47
050,31,045,"Nebraska","Dawes County",4,30,79,34,45
050,31,045,"Nebraska","Dawes County",4,31,82,43,39
050,31,045,"Nebraska","Dawes County",4,32,83,40,43
050,31,045,"Nebraska","Dawes County",4,33,76,42,34
050,31,045,"Nebraska","Dawes County",4,34,78,39,39
050,31,045,"Nebraska","Dawes County",4,35,79,42,37
050,31,045,"Nebraska","Dawes County",4,36,73,39,34
050,31,045,"Nebraska","Dawes County",4,37,83,41,42
050,31,045,"Nebraska","Dawes County",4,38,90,49,41
050,31,045,"Nebraska","Dawes County",4,39,87,42,45
050,31,045,"Nebraska","Dawes County",4,40,93,52,41
050,31,045,"Nebraska","Dawes County",4,41,92,41,51
050,31,045,"Nebraska","Dawes County",4,42,92,41,51
050,31,045,"Nebraska","Dawes County",4,43,91,48,43
050,31,045,"Nebraska","Dawes County",4,44,85,47,38
050,31,045,"Nebraska","Dawes County",4,45,81,46,35
050,31,045,"Nebraska","Dawes County",4,46,71,38,33
050,31,045,"Nebraska","Dawes County",4,47,75,32,43
050,31,045,"Nebraska","Dawes County",4,48,72,36,36
050,31,045,"Nebraska","Dawes County",4,49,74,39,35
050,31,045,"Nebraska","Dawes County",4,50,76,38,38
050,31,045,"Nebraska","Dawes County",4,51,75,38,37
050,31,045,"Nebraska","Dawes County",4,52,76,36,40
050,31,045,"Nebraska","Dawes County",4,53,87,43,44
050,31,045,"Nebraska","Dawes County",4,54,77,39,38
050,31,045,"Nebraska","Dawes County",4,55,85,46,39
050,31,045,"Nebraska","Dawes County",4,56,79,40,39
050,31,045,"Nebraska","Dawes County",4,57,88,36,52
050,31,045,"Nebraska","Dawes County",4,58,88,38,50
050,31,045,"Nebraska","Dawes County",4,59,97,43,54
050,31,045,"Nebraska","Dawes County",4,60,109,46,63
050,31,045,"Nebraska","Dawes County",4,61,109,43,66
050,31,045,"Nebraska","Dawes County",4,62,103,46,57
050,31,045,"Nebraska","Dawes County",4,63,104,53,51
050,31,045,"Nebraska","Dawes County",4,64,113,56,57
050,31,045,"Nebraska","Dawes County",4,65,104,51,53
050,31,045,"Nebraska","Dawes County",4,66,99,52,47
050,31,045,"Nebraska","Dawes County",4,67,99,57,42
050,31,045,"Nebraska","Dawes County",4,68,103,53,50
050,31,045,"Nebraska","Dawes County",4,69,97,49,48
050,31,045,"Nebraska","Dawes County",4,70,94,48,46
050,31,045,"Nebraska","Dawes County",4,71,78,41,37
050,31,045,"Nebraska","Dawes County",4,72,80,38,42
050,31,045,"Nebraska","Dawes County",4,73,76,35,41
050,31,045,"Nebraska","Dawes County",4,74,74,34,40
050,31,045,"Nebraska","Dawes County",4,75,76,36,40
050,31,045,"Nebraska","Dawes County",4,76,57,27,30
050,31,045,"Nebraska","Dawes County",4,77,65,27,38
050,31,045,"Nebraska","Dawes County",4,78,55,22,33
050,31,045,"Nebraska","Dawes County",4,79,54,26,28
050,31,045,"Nebraska","Dawes County",4,80,54,20,34
050,31,045,"Nebraska","Dawes County",4,81,45,19,26
050,31,045,"Nebraska","Dawes County",4,82,41,17,24
050,31,045,"Nebraska","Dawes County",4,83,43,17,26
050,31,045,"Nebraska","Dawes County",4,84,36,13,23
050,31,045,"Nebraska","Dawes County",4,85,253,95,158
050,31,045,"Nebraska","Dawes County",5,0,80,36,44
050,31,045,"Nebraska","Dawes County",5,1,71,32,39
050,31,045,"Nebraska","Dawes County",5,2,84,44,40
050,31,045,"Nebraska","Dawes County",5,3,93,50,43
050,31,045,"Nebraska","Dawes County",5,4,85,40,45
050,31,045,"Nebraska","Dawes County",5,5,61,35,26
050,31,045,"Nebraska","Dawes County",5,6,79,43,36
050,31,045,"Nebraska","Dawes County",5,7,82,40,42
050,31,045,"Nebraska","Dawes County",5,8,80,39,41
050,31,045,"Nebraska","Dawes County",5,9,83,44,39
050,31,045,"Nebraska","Dawes County",5,10,86,41,45
050,31,045,"Nebraska","Dawes County",5,11,100,51,49
050,31,045,"Nebraska","Dawes County",5,12,80,43,37
050,31,045,"Nebraska","Dawes County",5,13,70,35,35
050,31,045,"Nebraska","Dawes County",5,14,90,46,44
050,31,045,"Nebraska","Dawes County",5,15,81,42,39
050,31,045,"Nebraska","Dawes County",5,16,90,44,46
050,31,045,"Nebraska","Dawes County",5,17,84,41,43
050,31,045,"Nebraska","Dawes County",5,18,163,60,103
050,31,045,"Nebraska","Dawes County",5,19,335,162,173
050,31,045,"Nebraska","Dawes County",5,20,287,145,142
050,31,045,"Nebraska","Dawes County",5,21,270,138,132
050,31,045,"Nebraska","Dawes County",5,22,251,101,150
050,31,045,"Nebraska","Dawes County",5,23,157,90,67
050,31,045,"Nebraska","Dawes County",5,24,117,59,58
050,31,045,"Nebraska","Dawes County",5,25,93,44,49
050,31,045,"Nebraska","Dawes County",5,26,94,49,45
050,31,045,"Nebraska","Dawes County",5,27,79,40,39
050,31,045,"Nebraska","Dawes County",5,28,80,40,40
050,31,045,"Nebraska","Dawes County",5,29,78,39,39
050,31,045,"Nebraska","Dawes County",5,30,86,38,48
050,31,045,"Nebraska","Dawes County",5,31,75,34,41
050,31,045,"Nebraska","Dawes County",5,32,81,39,42
050,31,045,"Nebraska","Dawes County",5,33,90,44,46
050,31,045,"Nebraska","Dawes County",5,34,78,41,37
050,31,045,"Nebraska","Dawes County",5,35,79,39,40
050,31,045,"Nebraska","Dawes County",5,36,79,43,36
050,31,045,"Nebraska","Dawes County",5,37,72,42,30
050,31,045,"Nebraska","Dawes County",5,38,79,40,39
050,31,045,"Nebraska","Dawes County",5,39,91,49,42
050,31,045,"Nebraska","Dawes County",5,40,81,36,45
050,31,045,"Nebraska","Dawes County",5,41,98,53,45
050,31,045,"Nebraska","Dawes County",5,42,89,41,48
050,31,045,"Nebraska","Dawes County",5,43,93,44,49
050,31,045,"Nebraska","Dawes County",5,44,92,45,47
050,31,045,"Nebraska","Dawes County",5,45,83,45,38
050,31,045,"Nebraska","Dawes County",5,46,81,47,34
050,31,045,"Nebraska","Dawes County",5,47,67,34,33
050,31,045,"Nebraska","Dawes County",5,48,77,35,42
050,31,045,"Nebraska","Dawes County",5,49,75,31,44
050,31,045,"Nebraska","Dawes County",5,50,68,37,31
050,31,045,"Nebraska","Dawes County",5,51,75,38,37
050,31,045,"Nebraska","Dawes County",5,52,77,41,36
050,31,045,"Nebraska","Dawes County",5,53,74,36,38
050,31,045,"Nebraska","Dawes County",5,54,88,44,44
050,31,045,"Nebraska","Dawes County",5,55,74,38,36
050,31,045,"Nebraska","Dawes County",5,56,89,50,39
050,31,045,"Nebraska","Dawes County",5,57,76,39,37
050,31,045,"Nebraska","Dawes County",5,58,81,32,49
050,31,045,"Nebraska","Dawes County",5,59,92,39,53
050,31,045,"Nebraska","Dawes County",5,60,100,42,58
050,31,045,"Nebraska","Dawes County",5,61,106,41,65
050,31,045,"Nebraska","Dawes County",5,62,104,40,64
050,31,045,"Nebraska","Dawes County",5,63,97,39,58
050,31,045,"Nebraska","Dawes County",5,64,103,55,48
050,31,045,"Nebraska","Dawes County",5,65,106,53,53
050,31,045,"Nebraska","Dawes County",5,66,103,53,50
050,31,045,"Nebraska","Dawes County",5,67,100,56,44
050,31,045,"Nebraska","Dawes County",5,68,95,54,41
050,31,045,"Nebraska","Dawes County",5,69,98,50,48
050,31,045,"Nebraska","Dawes County",5,70,100,49,51
050,31,045,"Nebraska","Dawes County",5,71,93,47,46
050,31,045,"Nebraska","Dawes County",5,72,75,40,35
050,31,045,"Nebraska","Dawes County",5,73,76,36,40
050,31,045,"Nebraska","Dawes County",5,74,73,33,40
050,31,045,"Nebraska","Dawes County",5,75,74,34,40
050,31,045,"Nebraska","Dawes County",5,76,74,33,41
050,31,045,"Nebraska","Dawes County",5,77,53,26,27
050,31,045,"Nebraska","Dawes County",5,78,63,26,37
050,31,045,"Nebraska","Dawes County",5,79,48,19,29
050,31,045,"Nebraska","Dawes County",5,80,55,26,29
050,31,045,"Nebraska","Dawes County",5,81,54,20,34
050,31,045,"Nebraska","Dawes County",5,82,42,16,26
050,31,045,"Nebraska","Dawes County",5,83,34,15,19
050,31,045,"Nebraska","Dawes County",5,84,41,15,26
050,31,045,"Nebraska","Dawes County",5,85,243,86,157
050,31,047,"Nebraska","Dawson County",1,0,401,208,193
050,31,047,"Nebraska","Dawson County",1,1,398,219,179
050,31,047,"Nebraska","Dawson County",1,2,394,219,175
050,31,047,"Nebraska","Dawson County",1,3,393,198,195
050,31,047,"Nebraska","Dawson County",1,4,388,199,189
050,31,047,"Nebraska","Dawson County",1,5,386,195,191
050,31,047,"Nebraska","Dawson County",1,6,357,192,165
050,31,047,"Nebraska","Dawson County",1,7,338,172,166
050,31,047,"Nebraska","Dawson County",1,8,372,192,180
050,31,047,"Nebraska","Dawson County",1,9,338,161,177
050,31,047,"Nebraska","Dawson County",1,10,351,186,165
050,31,047,"Nebraska","Dawson County",1,11,336,188,148
050,31,047,"Nebraska","Dawson County",1,12,351,200,151
050,31,047,"Nebraska","Dawson County",1,13,386,217,169
050,31,047,"Nebraska","Dawson County",1,14,391,203,188
050,31,047,"Nebraska","Dawson County",1,15,384,187,197
050,31,047,"Nebraska","Dawson County",1,16,370,186,184
050,31,047,"Nebraska","Dawson County",1,17,374,196,178
050,31,047,"Nebraska","Dawson County",1,18,348,186,162
050,31,047,"Nebraska","Dawson County",1,19,288,137,151
050,31,047,"Nebraska","Dawson County",1,20,263,129,134
050,31,047,"Nebraska","Dawson County",1,21,254,122,132
050,31,047,"Nebraska","Dawson County",1,22,261,127,134
050,31,047,"Nebraska","Dawson County",1,23,267,136,131
050,31,047,"Nebraska","Dawson County",1,24,302,154,148
050,31,047,"Nebraska","Dawson County",1,25,310,156,154
050,31,047,"Nebraska","Dawson County",1,26,304,153,151
050,31,047,"Nebraska","Dawson County",1,27,313,181,132
050,31,047,"Nebraska","Dawson County",1,28,326,177,149
050,31,047,"Nebraska","Dawson County",1,29,299,172,127
050,31,047,"Nebraska","Dawson County",1,30,309,178,131
050,31,047,"Nebraska","Dawson County",1,31,293,160,133
050,31,047,"Nebraska","Dawson County",1,32,302,185,117
050,31,047,"Nebraska","Dawson County",1,33,336,208,128
050,31,047,"Nebraska","Dawson County",1,34,304,167,137
050,31,047,"Nebraska","Dawson County",1,35,292,157,135
050,31,047,"Nebraska","Dawson County",1,36,285,157,128
050,31,047,"Nebraska","Dawson County",1,37,307,165,142
050,31,047,"Nebraska","Dawson County",1,38,312,167,145
050,31,047,"Nebraska","Dawson County",1,39,279,142,137
050,31,047,"Nebraska","Dawson County",1,40,316,169,147
050,31,047,"Nebraska","Dawson County",1,41,284,146,138
050,31,047,"Nebraska","Dawson County",1,42,265,149,116
050,31,047,"Nebraska","Dawson County",1,43,256,129,127
050,31,047,"Nebraska","Dawson County",1,44,272,144,128
050,31,047,"Nebraska","Dawson County",1,45,280,147,133
050,31,047,"Nebraska","Dawson County",1,46,250,133,117
050,31,047,"Nebraska","Dawson County",1,47,258,124,134
050,31,047,"Nebraska","Dawson County",1,48,293,147,146
050,31,047,"Nebraska","Dawson County",1,49,299,148,151
050,31,047,"Nebraska","Dawson County",1,50,284,150,134
050,31,047,"Nebraska","Dawson County",1,51,279,158,121
050,31,047,"Nebraska","Dawson County",1,52,265,157,108
050,31,047,"Nebraska","Dawson County",1,53,247,132,115
050,31,047,"Nebraska","Dawson County",1,54,259,151,108
050,31,047,"Nebraska","Dawson County",1,55,258,150,108
050,31,047,"Nebraska","Dawson County",1,56,265,145,120
050,31,047,"Nebraska","Dawson County",1,57,269,151,118
050,31,047,"Nebraska","Dawson County",1,58,305,157,148
050,31,047,"Nebraska","Dawson County",1,59,282,151,131
050,31,047,"Nebraska","Dawson County",1,60,278,145,133
050,31,047,"Nebraska","Dawson County",1,61,286,148,138
050,31,047,"Nebraska","Dawson County",1,62,305,163,142
050,31,047,"Nebraska","Dawson County",1,63,272,156,116
050,31,047,"Nebraska","Dawson County",1,64,281,155,126
050,31,047,"Nebraska","Dawson County",1,65,250,130,120
050,31,047,"Nebraska","Dawson County",1,66,270,133,137
050,31,047,"Nebraska","Dawson County",1,67,265,131,134
050,31,047,"Nebraska","Dawson County",1,68,258,127,131
050,31,047,"Nebraska","Dawson County",1,69,231,108,123
050,31,047,"Nebraska","Dawson County",1,70,211,108,103
050,31,047,"Nebraska","Dawson County",1,71,216,110,106
050,31,047,"Nebraska","Dawson County",1,72,225,116,109
050,31,047,"Nebraska","Dawson County",1,73,205,106,99
050,31,047,"Nebraska","Dawson County",1,74,169,89,80
050,31,047,"Nebraska","Dawson County",1,75,158,74,84
050,31,047,"Nebraska","Dawson County",1,76,152,72,80
050,31,047,"Nebraska","Dawson County",1,77,145,72,73
050,31,047,"Nebraska","Dawson County",1,78,121,58,63
050,31,047,"Nebraska","Dawson County",1,79,109,52,57
050,31,047,"Nebraska","Dawson County",1,80,105,52,53
050,31,047,"Nebraska","Dawson County",1,81,95,37,58
050,31,047,"Nebraska","Dawson County",1,82,84,33,51
050,31,047,"Nebraska","Dawson County",1,83,99,36,63
050,31,047,"Nebraska","Dawson County",1,84,70,33,37
050,31,047,"Nebraska","Dawson County",1,85,501,201,300
050,31,047,"Nebraska","Dawson County",2,0,409,213,196
050,31,047,"Nebraska","Dawson County",2,1,394,214,180
050,31,047,"Nebraska","Dawson County",2,2,393,218,175
050,31,047,"Nebraska","Dawson County",2,3,396,205,191
050,31,047,"Nebraska","Dawson County",2,4,389,199,190
050,31,047,"Nebraska","Dawson County",2,5,385,195,190
050,31,047,"Nebraska","Dawson County",2,6,362,191,171
050,31,047,"Nebraska","Dawson County",2,7,344,177,167
050,31,047,"Nebraska","Dawson County",2,8,361,186,175
050,31,047,"Nebraska","Dawson County",2,9,341,167,174
050,31,047,"Nebraska","Dawson County",2,10,347,179,168
050,31,047,"Nebraska","Dawson County",2,11,340,187,153
050,31,047,"Nebraska","Dawson County",2,12,348,197,151
050,31,047,"Nebraska","Dawson County",2,13,377,213,164
050,31,047,"Nebraska","Dawson County",2,14,389,206,183
050,31,047,"Nebraska","Dawson County",2,15,386,194,192
050,31,047,"Nebraska","Dawson County",2,16,372,185,187
050,31,047,"Nebraska","Dawson County",2,17,374,195,179
050,31,047,"Nebraska","Dawson County",2,18,339,180,159
050,31,047,"Nebraska","Dawson County",2,19,290,142,148
050,31,047,"Nebraska","Dawson County",2,20,271,131,140
050,31,047,"Nebraska","Dawson County",2,21,258,124,134
050,31,047,"Nebraska","Dawson County",2,22,258,125,133
050,31,047,"Nebraska","Dawson County",2,23,269,134,135
050,31,047,"Nebraska","Dawson County",2,24,295,149,146
050,31,047,"Nebraska","Dawson County",2,25,307,154,153
050,31,047,"Nebraska","Dawson County",2,26,304,155,149
050,31,047,"Nebraska","Dawson County",2,27,307,171,136
050,31,047,"Nebraska","Dawson County",2,28,320,176,144
050,31,047,"Nebraska","Dawson County",2,29,304,172,132
050,31,047,"Nebraska","Dawson County",2,30,307,178,129
050,31,047,"Nebraska","Dawson County",2,31,295,164,131
050,31,047,"Nebraska","Dawson County",2,32,301,180,121
050,31,047,"Nebraska","Dawson County",2,33,325,199,126
050,31,047,"Nebraska","Dawson County",2,34,311,176,135
050,31,047,"Nebraska","Dawson County",2,35,296,162,134
050,31,047,"Nebraska","Dawson County",2,36,283,155,128
050,31,047,"Nebraska","Dawson County",2,37,303,163,140
050,31,047,"Nebraska","Dawson County",2,38,309,166,143
050,31,047,"Nebraska","Dawson County",2,39,287,149,138
050,31,047,"Nebraska","Dawson County",2,40,309,161,148
050,31,047,"Nebraska","Dawson County",2,41,290,150,140
050,31,047,"Nebraska","Dawson County",2,42,266,148,118
050,31,047,"Nebraska","Dawson County",2,43,260,134,126
050,31,047,"Nebraska","Dawson County",2,44,264,137,127
050,31,047,"Nebraska","Dawson County",2,45,280,148,132
050,31,047,"Nebraska","Dawson County",2,46,253,134,119
050,31,047,"Nebraska","Dawson County",2,47,256,126,130
050,31,047,"Nebraska","Dawson County",2,48,286,142,144
050,31,047,"Nebraska","Dawson County",2,49,297,147,150
050,31,047,"Nebraska","Dawson County",2,50,288,149,139
050,31,047,"Nebraska","Dawson County",2,51,280,156,124
050,31,047,"Nebraska","Dawson County",2,52,271,160,111
050,31,047,"Nebraska","Dawson County",2,53,251,138,113
050,31,047,"Nebraska","Dawson County",2,54,257,148,109
050,31,047,"Nebraska","Dawson County",2,55,259,151,108
050,31,047,"Nebraska","Dawson County",2,56,261,145,116
050,31,047,"Nebraska","Dawson County",2,57,267,148,119
050,31,047,"Nebraska","Dawson County",2,58,297,156,141
050,31,047,"Nebraska","Dawson County",2,59,290,155,135
050,31,047,"Nebraska","Dawson County",2,60,278,146,132
050,31,047,"Nebraska","Dawson County",2,61,283,146,137
050,31,047,"Nebraska","Dawson County",2,62,299,158,141
050,31,047,"Nebraska","Dawson County",2,63,278,156,122
050,31,047,"Nebraska","Dawson County",2,64,274,153,121
050,31,047,"Nebraska","Dawson County",2,65,256,134,122
050,31,047,"Nebraska","Dawson County",2,66,265,133,132
050,31,047,"Nebraska","Dawson County",2,67,262,130,132
050,31,047,"Nebraska","Dawson County",2,68,254,123,131
050,31,047,"Nebraska","Dawson County",2,69,240,113,127
050,31,047,"Nebraska","Dawson County",2,70,213,107,106
050,31,047,"Nebraska","Dawson County",2,71,215,110,105
050,31,047,"Nebraska","Dawson County",2,72,219,112,107
050,31,047,"Nebraska","Dawson County",2,73,216,112,104
050,31,047,"Nebraska","Dawson County",2,74,166,86,80
050,31,047,"Nebraska","Dawson County",2,75,158,75,83
050,31,047,"Nebraska","Dawson County",2,76,148,70,78
050,31,047,"Nebraska","Dawson County",2,77,148,71,77
050,31,047,"Nebraska","Dawson County",2,78,123,59,64
050,31,047,"Nebraska","Dawson County",2,79,111,53,58
050,31,047,"Nebraska","Dawson County",2,80,103,51,52
050,31,047,"Nebraska","Dawson County",2,81,100,42,58
050,31,047,"Nebraska","Dawson County",2,82,84,33,51
050,31,047,"Nebraska","Dawson County",2,83,92,33,59
050,31,047,"Nebraska","Dawson County",2,84,75,32,43
050,31,047,"Nebraska","Dawson County",2,85,497,202,295
050,31,047,"Nebraska","Dawson County",3,0,347,173,174
050,31,047,"Nebraska","Dawson County",3,1,401,211,190
050,31,047,"Nebraska","Dawson County",3,2,386,214,172
050,31,047,"Nebraska","Dawson County",3,3,395,222,173
050,31,047,"Nebraska","Dawson County",3,4,395,210,185
050,31,047,"Nebraska","Dawson County",3,5,386,201,185
050,31,047,"Nebraska","Dawson County",3,6,376,197,179
050,31,047,"Nebraska","Dawson County",3,7,350,187,163
050,31,047,"Nebraska","Dawson County",3,8,348,173,175
050,31,047,"Nebraska","Dawson County",3,9,347,179,168
050,31,047,"Nebraska","Dawson County",3,10,325,163,162
050,31,047,"Nebraska","Dawson County",3,11,344,181,163
050,31,047,"Nebraska","Dawson County",3,12,339,181,158
050,31,047,"Nebraska","Dawson County",3,13,343,191,152
050,31,047,"Nebraska","Dawson County",3,14,373,213,160
050,31,047,"Nebraska","Dawson County",3,15,387,203,184
050,31,047,"Nebraska","Dawson County",3,16,394,193,201
050,31,047,"Nebraska","Dawson County",3,17,375,188,187
050,31,047,"Nebraska","Dawson County",3,18,327,171,156
050,31,047,"Nebraska","Dawson County",3,19,286,155,131
050,31,047,"Nebraska","Dawson County",3,20,297,148,149
050,31,047,"Nebraska","Dawson County",3,21,264,132,132
050,31,047,"Nebraska","Dawson County",3,22,252,120,132
050,31,047,"Nebraska","Dawson County",3,23,264,126,138
050,31,047,"Nebraska","Dawson County",3,24,260,127,133
050,31,047,"Nebraska","Dawson County",3,25,288,155,133
050,31,047,"Nebraska","Dawson County",3,26,301,148,153
050,31,047,"Nebraska","Dawson County",3,27,301,152,149
050,31,047,"Nebraska","Dawson County",3,28,301,161,140
050,31,047,"Nebraska","Dawson County",3,29,306,174,132
050,31,047,"Nebraska","Dawson County",3,30,301,171,130
050,31,047,"Nebraska","Dawson County",3,31,307,174,133
050,31,047,"Nebraska","Dawson County",3,32,298,163,135
050,31,047,"Nebraska","Dawson County",3,33,304,183,121
050,31,047,"Nebraska","Dawson County",3,34,315,188,127
050,31,047,"Nebraska","Dawson County",3,35,327,191,136
050,31,047,"Nebraska","Dawson County",3,36,293,160,133
050,31,047,"Nebraska","Dawson County",3,37,283,153,130
050,31,047,"Nebraska","Dawson County",3,38,293,159,134
050,31,047,"Nebraska","Dawson County",3,39,312,167,145
050,31,047,"Nebraska","Dawson County",3,40,285,145,140
050,31,047,"Nebraska","Dawson County",3,41,305,157,148
050,31,047,"Nebraska","Dawson County",3,42,281,155,126
050,31,047,"Nebraska","Dawson County",3,43,265,148,117
050,31,047,"Nebraska","Dawson County",3,44,250,127,123
050,31,047,"Nebraska","Dawson County",3,45,268,143,125
050,31,047,"Nebraska","Dawson County",3,46,268,143,125
050,31,047,"Nebraska","Dawson County",3,47,245,128,117
050,31,047,"Nebraska","Dawson County",3,48,262,126,136
050,31,047,"Nebraska","Dawson County",3,49,283,139,144
050,31,047,"Nebraska","Dawson County",3,50,294,146,148
050,31,047,"Nebraska","Dawson County",3,51,291,155,136
050,31,047,"Nebraska","Dawson County",3,52,281,158,123
050,31,047,"Nebraska","Dawson County",3,53,269,163,106
050,31,047,"Nebraska","Dawson County",3,54,251,142,109
050,31,047,"Nebraska","Dawson County",3,55,246,142,104
050,31,047,"Nebraska","Dawson County",3,56,263,156,107
050,31,047,"Nebraska","Dawson County",3,57,259,140,119
050,31,047,"Nebraska","Dawson County",3,58,268,148,120
050,31,047,"Nebraska","Dawson County",3,59,294,159,135
050,31,047,"Nebraska","Dawson County",3,60,295,155,140
050,31,047,"Nebraska","Dawson County",3,61,276,151,125
050,31,047,"Nebraska","Dawson County",3,62,278,140,138
050,31,047,"Nebraska","Dawson County",3,63,294,151,143
050,31,047,"Nebraska","Dawson County",3,64,270,152,118
050,31,047,"Nebraska","Dawson County",3,65,262,148,114
050,31,047,"Nebraska","Dawson County",3,66,262,137,125
050,31,047,"Nebraska","Dawson County",3,67,259,129,130
050,31,047,"Nebraska","Dawson County",3,68,256,128,128
050,31,047,"Nebraska","Dawson County",3,69,244,116,128
050,31,047,"Nebraska","Dawson County",3,70,233,110,123
050,31,047,"Nebraska","Dawson County",3,71,211,106,105
050,31,047,"Nebraska","Dawson County",3,72,210,107,103
050,31,047,"Nebraska","Dawson County",3,73,211,108,103
050,31,047,"Nebraska","Dawson County",3,74,214,113,101
050,31,047,"Nebraska","Dawson County",3,75,163,82,81
050,31,047,"Nebraska","Dawson County",3,76,154,73,81
050,31,047,"Nebraska","Dawson County",3,77,141,67,74
050,31,047,"Nebraska","Dawson County",3,78,141,68,73
050,31,047,"Nebraska","Dawson County",3,79,119,57,62
050,31,047,"Nebraska","Dawson County",3,80,92,44,48
050,31,047,"Nebraska","Dawson County",3,81,104,52,52
050,31,047,"Nebraska","Dawson County",3,82,85,38,47
050,31,047,"Nebraska","Dawson County",3,83,80,30,50
050,31,047,"Nebraska","Dawson County",3,84,80,29,51
050,31,047,"Nebraska","Dawson County",3,85,481,193,288
050,31,047,"Nebraska","Dawson County",4,0,358,191,167
050,31,047,"Nebraska","Dawson County",4,1,348,173,175
050,31,047,"Nebraska","Dawson County",4,2,388,202,186
050,31,047,"Nebraska","Dawson County",4,3,384,211,173
050,31,047,"Nebraska","Dawson County",4,4,386,215,171
050,31,047,"Nebraska","Dawson County",4,5,398,214,184
050,31,047,"Nebraska","Dawson County",4,6,383,200,183
050,31,047,"Nebraska","Dawson County",4,7,395,208,187
050,31,047,"Nebraska","Dawson County",4,8,361,192,169
050,31,047,"Nebraska","Dawson County",4,9,361,176,185
050,31,047,"Nebraska","Dawson County",4,10,353,184,169
050,31,047,"Nebraska","Dawson County",4,11,324,165,159
050,31,047,"Nebraska","Dawson County",4,12,350,185,165
050,31,047,"Nebraska","Dawson County",4,13,345,187,158
050,31,047,"Nebraska","Dawson County",4,14,343,189,154
050,31,047,"Nebraska","Dawson County",4,15,375,213,162
050,31,047,"Nebraska","Dawson County",4,16,385,204,181
050,31,047,"Nebraska","Dawson County",4,17,391,191,200
050,31,047,"Nebraska","Dawson County",4,18,333,171,162
050,31,047,"Nebraska","Dawson County",4,19,279,152,127
050,31,047,"Nebraska","Dawson County",4,20,284,156,128
050,31,047,"Nebraska","Dawson County",4,21,297,150,147
050,31,047,"Nebraska","Dawson County",4,22,271,129,142
050,31,047,"Nebraska","Dawson County",4,23,259,126,133
050,31,047,"Nebraska","Dawson County",4,24,249,121,128
050,31,047,"Nebraska","Dawson County",4,25,263,129,134
050,31,047,"Nebraska","Dawson County",4,26,298,168,130
050,31,047,"Nebraska","Dawson County",4,27,288,146,142
050,31,047,"Nebraska","Dawson County",4,28,308,159,149
050,31,047,"Nebraska","Dawson County",4,29,285,154,131
050,31,047,"Nebraska","Dawson County",4,30,290,165,125
050,31,047,"Nebraska","Dawson County",4,31,302,175,127
050,31,047,"Nebraska","Dawson County",4,32,309,176,133
050,31,047,"Nebraska","Dawson County",4,33,296,161,135
050,31,047,"Nebraska","Dawson County",4,34,297,176,121
050,31,047,"Nebraska","Dawson County",4,35,319,187,132
050,31,047,"Nebraska","Dawson County",4,36,318,187,131
050,31,047,"Nebraska","Dawson County",4,37,298,156,142
050,31,047,"Nebraska","Dawson County",4,38,290,159,131
050,31,047,"Nebraska","Dawson County",4,39,296,165,131
050,31,047,"Nebraska","Dawson County",4,40,299,160,139
050,31,047,"Nebraska","Dawson County",4,41,293,148,145
050,31,047,"Nebraska","Dawson County",4,42,319,169,150
050,31,047,"Nebraska","Dawson County",4,43,273,150,123
050,31,047,"Nebraska","Dawson County",4,44,258,142,116
050,31,047,"Nebraska","Dawson County",4,45,252,128,124
050,31,047,"Nebraska","Dawson County",4,46,262,140,122
050,31,047,"Nebraska","Dawson County",4,47,270,140,130
050,31,047,"Nebraska","Dawson County",4,48,243,125,118
050,31,047,"Nebraska","Dawson County",4,49,260,121,139
050,31,047,"Nebraska","Dawson County",4,50,285,138,147
050,31,047,"Nebraska","Dawson County",4,51,310,168,142
050,31,047,"Nebraska","Dawson County",4,52,296,162,134
050,31,047,"Nebraska","Dawson County",4,53,276,154,122
050,31,047,"Nebraska","Dawson County",4,54,268,165,103
050,31,047,"Nebraska","Dawson County",4,55,248,139,109
050,31,047,"Nebraska","Dawson County",4,56,246,139,107
050,31,047,"Nebraska","Dawson County",4,57,268,156,112
050,31,047,"Nebraska","Dawson County",4,58,256,138,118
050,31,047,"Nebraska","Dawson County",4,59,266,146,120
050,31,047,"Nebraska","Dawson County",4,60,301,158,143
050,31,047,"Nebraska","Dawson County",4,61,275,147,128
050,31,047,"Nebraska","Dawson County",4,62,268,149,119
050,31,047,"Nebraska","Dawson County",4,63,272,137,135
050,31,047,"Nebraska","Dawson County",4,64,288,150,138
050,31,047,"Nebraska","Dawson County",4,65,260,144,116
050,31,047,"Nebraska","Dawson County",4,66,257,145,112
050,31,047,"Nebraska","Dawson County",4,67,252,134,118
050,31,047,"Nebraska","Dawson County",4,68,249,125,124
050,31,047,"Nebraska","Dawson County",4,69,250,124,126
050,31,047,"Nebraska","Dawson County",4,70,236,114,122
050,31,047,"Nebraska","Dawson County",4,71,228,107,121
050,31,047,"Nebraska","Dawson County",4,72,206,107,99
050,31,047,"Nebraska","Dawson County",4,73,199,100,99
050,31,047,"Nebraska","Dawson County",4,74,203,104,99
050,31,047,"Nebraska","Dawson County",4,75,206,112,94
050,31,047,"Nebraska","Dawson County",4,76,154,78,76
050,31,047,"Nebraska","Dawson County",4,77,147,69,78
050,31,047,"Nebraska","Dawson County",4,78,133,65,68
050,31,047,"Nebraska","Dawson County",4,79,133,63,70
050,31,047,"Nebraska","Dawson County",4,80,109,52,57
050,31,047,"Nebraska","Dawson County",4,81,94,45,49
050,31,047,"Nebraska","Dawson County",4,82,87,47,40
050,31,047,"Nebraska","Dawson County",4,83,83,36,47
050,31,047,"Nebraska","Dawson County",4,84,65,23,42
050,31,047,"Nebraska","Dawson County",4,85,445,178,267
050,31,047,"Nebraska","Dawson County",5,0,366,197,169
050,31,047,"Nebraska","Dawson County",5,1,367,183,184
050,31,047,"Nebraska","Dawson County",5,2,348,171,177
050,31,047,"Nebraska","Dawson County",5,3,377,188,189
050,31,047,"Nebraska","Dawson County",5,4,392,210,182
050,31,047,"Nebraska","Dawson County",5,5,399,225,174
050,31,047,"Nebraska","Dawson County",5,6,408,213,195
050,31,047,"Nebraska","Dawson County",5,7,401,215,186
050,31,047,"Nebraska","Dawson County",5,8,410,209,201
050,31,047,"Nebraska","Dawson County",5,9,358,184,174
050,31,047,"Nebraska","Dawson County",5,10,371,185,186
050,31,047,"Nebraska","Dawson County",5,11,352,181,171
050,31,047,"Nebraska","Dawson County",5,12,331,171,160
050,31,047,"Nebraska","Dawson County",5,13,341,177,164
050,31,047,"Nebraska","Dawson County",5,14,348,193,155
050,31,047,"Nebraska","Dawson County",5,15,344,191,153
050,31,047,"Nebraska","Dawson County",5,16,392,225,167
050,31,047,"Nebraska","Dawson County",5,17,385,211,174
050,31,047,"Nebraska","Dawson County",5,18,341,176,165
050,31,047,"Nebraska","Dawson County",5,19,277,147,130
050,31,047,"Nebraska","Dawson County",5,20,277,153,124
050,31,047,"Nebraska","Dawson County",5,21,289,158,131
050,31,047,"Nebraska","Dawson County",5,22,290,144,146
050,31,047,"Nebraska","Dawson County",5,23,295,145,150
050,31,047,"Nebraska","Dawson County",5,24,261,135,126
050,31,047,"Nebraska","Dawson County",5,25,236,118,118
050,31,047,"Nebraska","Dawson County",5,26,270,123,147
050,31,047,"Nebraska","Dawson County",5,27,301,171,130
050,31,047,"Nebraska","Dawson County",5,28,304,166,138
050,31,047,"Nebraska","Dawson County",5,29,286,147,139
050,31,047,"Nebraska","Dawson County",5,30,287,155,132
050,31,047,"Nebraska","Dawson County",5,31,313,188,125
050,31,047,"Nebraska","Dawson County",5,32,314,188,126
050,31,047,"Nebraska","Dawson County",5,33,310,178,132
050,31,047,"Nebraska","Dawson County",5,34,304,165,139
050,31,047,"Nebraska","Dawson County",5,35,313,182,131
050,31,047,"Nebraska","Dawson County",5,36,319,190,129
050,31,047,"Nebraska","Dawson County",5,37,328,187,141
050,31,047,"Nebraska","Dawson County",5,38,310,162,148
050,31,047,"Nebraska","Dawson County",5,39,293,162,131
050,31,047,"Nebraska","Dawson County",5,40,290,163,127
050,31,047,"Nebraska","Dawson County",5,41,298,158,140
050,31,047,"Nebraska","Dawson County",5,42,286,145,141
050,31,047,"Nebraska","Dawson County",5,43,318,165,153
050,31,047,"Nebraska","Dawson County",5,44,261,144,117
050,31,047,"Nebraska","Dawson County",5,45,255,141,114
050,31,047,"Nebraska","Dawson County",5,46,242,122,120
050,31,047,"Nebraska","Dawson County",5,47,274,147,127
050,31,047,"Nebraska","Dawson County",5,48,271,141,130
050,31,047,"Nebraska","Dawson County",5,49,247,130,117
050,31,047,"Nebraska","Dawson County",5,50,260,126,134
050,31,047,"Nebraska","Dawson County",5,51,313,167,146
050,31,047,"Nebraska","Dawson County",5,52,326,183,143
050,31,047,"Nebraska","Dawson County",5,53,296,163,133
050,31,047,"Nebraska","Dawson County",5,54,266,149,117
050,31,047,"Nebraska","Dawson County",5,55,258,161,97
050,31,047,"Nebraska","Dawson County",5,56,248,142,106
050,31,047,"Nebraska","Dawson County",5,57,247,140,107
050,31,047,"Nebraska","Dawson County",5,58,272,154,118
050,31,047,"Nebraska","Dawson County",5,59,246,135,111
050,31,047,"Nebraska","Dawson County",5,60,259,144,115
050,31,047,"Nebraska","Dawson County",5,61,285,151,134
050,31,047,"Nebraska","Dawson County",5,62,274,146,128
050,31,047,"Nebraska","Dawson County",5,63,261,144,117
050,31,047,"Nebraska","Dawson County",5,64,272,136,136
050,31,047,"Nebraska","Dawson County",5,65,276,139,137
050,31,047,"Nebraska","Dawson County",5,66,252,137,115
050,31,047,"Nebraska","Dawson County",5,67,249,140,109
050,31,047,"Nebraska","Dawson County",5,68,246,137,109
050,31,047,"Nebraska","Dawson County",5,69,247,123,124
050,31,047,"Nebraska","Dawson County",5,70,244,123,121
050,31,047,"Nebraska","Dawson County",5,71,232,115,117
050,31,047,"Nebraska","Dawson County",5,72,221,103,118
050,31,047,"Nebraska","Dawson County",5,73,193,97,96
050,31,047,"Nebraska","Dawson County",5,74,195,98,97
050,31,047,"Nebraska","Dawson County",5,75,198,102,96
050,31,047,"Nebraska","Dawson County",5,76,202,111,91
050,31,047,"Nebraska","Dawson County",5,77,145,75,70
050,31,047,"Nebraska","Dawson County",5,78,137,67,70
050,31,047,"Nebraska","Dawson County",5,79,124,59,65
050,31,047,"Nebraska","Dawson County",5,80,118,57,61
050,31,047,"Nebraska","Dawson County",5,81,114,55,59
050,31,047,"Nebraska","Dawson County",5,82,81,41,40
050,31,047,"Nebraska","Dawson County",5,83,81,43,38
050,31,047,"Nebraska","Dawson County",5,84,68,30,38
050,31,047,"Nebraska","Dawson County",5,85,429,167,262
050,31,049,"Nebraska","Deuel County",1,0,18,9,9
050,31,049,"Nebraska","Deuel County",1,1,16,7,9
050,31,049,"Nebraska","Deuel County",1,2,12,6,6
050,31,049,"Nebraska","Deuel County",1,3,14,7,7
050,31,049,"Nebraska","Deuel County",1,4,24,11,13
050,31,049,"Nebraska","Deuel County",1,5,27,13,14
050,31,049,"Nebraska","Deuel County",1,6,20,10,10
050,31,049,"Nebraska","Deuel County",1,7,22,13,9
050,31,049,"Nebraska","Deuel County",1,8,18,11,7
050,31,049,"Nebraska","Deuel County",1,9,22,15,7
050,31,049,"Nebraska","Deuel County",1,10,20,13,7
050,31,049,"Nebraska","Deuel County",1,11,23,11,12
050,31,049,"Nebraska","Deuel County",1,12,26,14,12
050,31,049,"Nebraska","Deuel County",1,13,27,13,14
050,31,049,"Nebraska","Deuel County",1,14,26,14,12
050,31,049,"Nebraska","Deuel County",1,15,27,12,15
050,31,049,"Nebraska","Deuel County",1,16,28,15,13
050,31,049,"Nebraska","Deuel County",1,17,27,14,13
050,31,049,"Nebraska","Deuel County",1,18,12,3,9
050,31,049,"Nebraska","Deuel County",1,19,14,7,7
050,31,049,"Nebraska","Deuel County",1,20,7,4,3
050,31,049,"Nebraska","Deuel County",1,21,11,5,6
050,31,049,"Nebraska","Deuel County",1,22,21,10,11
050,31,049,"Nebraska","Deuel County",1,23,15,4,11
050,31,049,"Nebraska","Deuel County",1,24,14,6,8
050,31,049,"Nebraska","Deuel County",1,25,12,9,3
050,31,049,"Nebraska","Deuel County",1,26,17,10,7
050,31,049,"Nebraska","Deuel County",1,27,18,9,9
050,31,049,"Nebraska","Deuel County",1,28,13,6,7
050,31,049,"Nebraska","Deuel County",1,29,10,6,4
050,31,049,"Nebraska","Deuel County",1,30,15,7,8
050,31,049,"Nebraska","Deuel County",1,31,16,7,9
050,31,049,"Nebraska","Deuel County",1,32,22,9,13
050,31,049,"Nebraska","Deuel County",1,33,25,13,12
050,31,049,"Nebraska","Deuel County",1,34,15,7,8
050,31,049,"Nebraska","Deuel County",1,35,13,9,4
050,31,049,"Nebraska","Deuel County",1,36,12,4,8
050,31,049,"Nebraska","Deuel County",1,37,18,10,8
050,31,049,"Nebraska","Deuel County",1,38,12,3,9
050,31,049,"Nebraska","Deuel County",1,39,12,6,6
050,31,049,"Nebraska","Deuel County",1,40,25,12,13
050,31,049,"Nebraska","Deuel County",1,41,23,13,10
050,31,049,"Nebraska","Deuel County",1,42,16,10,6
050,31,049,"Nebraska","Deuel County",1,43,9,5,4
050,31,049,"Nebraska","Deuel County",1,44,21,12,9
050,31,049,"Nebraska","Deuel County",1,45,31,16,15
050,31,049,"Nebraska","Deuel County",1,46,23,11,12
050,31,049,"Nebraska","Deuel County",1,47,17,10,7
050,31,049,"Nebraska","Deuel County",1,48,18,10,8
050,31,049,"Nebraska","Deuel County",1,49,26,15,11
050,31,049,"Nebraska","Deuel County",1,50,20,12,8
050,31,049,"Nebraska","Deuel County",1,51,22,9,13
050,31,049,"Nebraska","Deuel County",1,52,21,9,12
050,31,049,"Nebraska","Deuel County",1,53,30,15,15
050,31,049,"Nebraska","Deuel County",1,54,20,12,8
050,31,049,"Nebraska","Deuel County",1,55,25,14,11
050,31,049,"Nebraska","Deuel County",1,56,28,14,14
050,31,049,"Nebraska","Deuel County",1,57,36,15,21
050,31,049,"Nebraska","Deuel County",1,58,34,18,16
050,31,049,"Nebraska","Deuel County",1,59,30,15,15
050,31,049,"Nebraska","Deuel County",1,60,32,18,14
050,31,049,"Nebraska","Deuel County",1,61,36,17,19
050,31,049,"Nebraska","Deuel County",1,62,29,16,13
050,31,049,"Nebraska","Deuel County",1,63,37,20,17
050,31,049,"Nebraska","Deuel County",1,64,43,19,24
050,31,049,"Nebraska","Deuel County",1,65,30,17,13
050,31,049,"Nebraska","Deuel County",1,66,28,16,12
050,31,049,"Nebraska","Deuel County",1,67,27,15,12
050,31,049,"Nebraska","Deuel County",1,68,31,16,15
050,31,049,"Nebraska","Deuel County",1,69,34,15,19
050,31,049,"Nebraska","Deuel County",1,70,29,14,15
050,31,049,"Nebraska","Deuel County",1,71,26,12,14
050,31,049,"Nebraska","Deuel County",1,72,27,17,10
050,31,049,"Nebraska","Deuel County",1,73,19,11,8
050,31,049,"Nebraska","Deuel County",1,74,14,4,10
050,31,049,"Nebraska","Deuel County",1,75,16,8,8
050,31,049,"Nebraska","Deuel County",1,76,18,10,8
050,31,049,"Nebraska","Deuel County",1,77,16,8,8
050,31,049,"Nebraska","Deuel County",1,78,17,8,9
050,31,049,"Nebraska","Deuel County",1,79,15,5,10
050,31,049,"Nebraska","Deuel County",1,80,12,5,7
050,31,049,"Nebraska","Deuel County",1,81,18,9,9
050,31,049,"Nebraska","Deuel County",1,82,13,5,8
050,31,049,"Nebraska","Deuel County",1,83,16,5,11
050,31,049,"Nebraska","Deuel County",1,84,9,3,6
050,31,049,"Nebraska","Deuel County",1,85,49,24,25
050,31,049,"Nebraska","Deuel County",2,0,18,9,9
050,31,049,"Nebraska","Deuel County",2,1,16,8,8
050,31,049,"Nebraska","Deuel County",2,2,13,7,6
050,31,049,"Nebraska","Deuel County",2,3,14,7,7
050,31,049,"Nebraska","Deuel County",2,4,22,11,11
050,31,049,"Nebraska","Deuel County",2,5,25,12,13
050,31,049,"Nebraska","Deuel County",2,6,22,11,11
050,31,049,"Nebraska","Deuel County",2,7,21,12,9
050,31,049,"Nebraska","Deuel County",2,8,20,12,8
050,31,049,"Nebraska","Deuel County",2,9,20,14,6
050,31,049,"Nebraska","Deuel County",2,10,20,13,7
050,31,049,"Nebraska","Deuel County",2,11,22,11,11
050,31,049,"Nebraska","Deuel County",2,12,26,13,13
050,31,049,"Nebraska","Deuel County",2,13,28,14,14
050,31,049,"Nebraska","Deuel County",2,14,26,13,13
050,31,049,"Nebraska","Deuel County",2,15,26,12,14
050,31,049,"Nebraska","Deuel County",2,16,27,14,13
050,31,049,"Nebraska","Deuel County",2,17,26,13,13
050,31,049,"Nebraska","Deuel County",2,18,15,5,10
050,31,049,"Nebraska","Deuel County",2,19,13,6,7
050,31,049,"Nebraska","Deuel County",2,20,7,4,3
050,31,049,"Nebraska","Deuel County",2,21,10,5,5
050,31,049,"Nebraska","Deuel County",2,22,18,8,10
050,31,049,"Nebraska","Deuel County",2,23,17,6,11
050,31,049,"Nebraska","Deuel County",2,24,14,6,8
050,31,049,"Nebraska","Deuel County",2,25,13,8,5
050,31,049,"Nebraska","Deuel County",2,26,17,10,7
050,31,049,"Nebraska","Deuel County",2,27,17,9,8
050,31,049,"Nebraska","Deuel County",2,28,14,7,7
050,31,049,"Nebraska","Deuel County",2,29,11,6,5
050,31,049,"Nebraska","Deuel County",2,30,14,7,7
050,31,049,"Nebraska","Deuel County",2,31,16,7,9
050,31,049,"Nebraska","Deuel County",2,32,20,8,12
050,31,049,"Nebraska","Deuel County",2,33,23,11,12
050,31,049,"Nebraska","Deuel County",2,34,16,8,8
050,31,049,"Nebraska","Deuel County",2,35,13,8,5
050,31,049,"Nebraska","Deuel County",2,36,12,5,7
050,31,049,"Nebraska","Deuel County",2,37,15,8,7
050,31,049,"Nebraska","Deuel County",2,38,12,4,8
050,31,049,"Nebraska","Deuel County",2,39,12,5,7
050,31,049,"Nebraska","Deuel County",2,40,22,11,11
050,31,049,"Nebraska","Deuel County",2,41,25,13,12
050,31,049,"Nebraska","Deuel County",2,42,16,10,6
050,31,049,"Nebraska","Deuel County",2,43,12,7,5
050,31,049,"Nebraska","Deuel County",2,44,17,9,8
050,31,049,"Nebraska","Deuel County",2,45,30,16,14
050,31,049,"Nebraska","Deuel County",2,46,26,13,13
050,31,049,"Nebraska","Deuel County",2,47,18,10,8
050,31,049,"Nebraska","Deuel County",2,48,18,10,8
050,31,049,"Nebraska","Deuel County",2,49,25,14,11
050,31,049,"Nebraska","Deuel County",2,50,22,13,9
050,31,049,"Nebraska","Deuel County",2,51,21,9,12
050,31,049,"Nebraska","Deuel County",2,52,22,9,13
050,31,049,"Nebraska","Deuel County",2,53,27,14,13
050,31,049,"Nebraska","Deuel County",2,54,22,13,9
050,31,049,"Nebraska","Deuel County",2,55,23,13,10
050,31,049,"Nebraska","Deuel County",2,56,27,14,13
050,31,049,"Nebraska","Deuel County",2,57,35,15,20
050,31,049,"Nebraska","Deuel County",2,58,34,17,17
050,31,049,"Nebraska","Deuel County",2,59,31,16,15
050,31,049,"Nebraska","Deuel County",2,60,32,17,15
050,31,049,"Nebraska","Deuel County",2,61,36,18,18
050,31,049,"Nebraska","Deuel County",2,62,30,16,14
050,31,049,"Nebraska","Deuel County",2,63,36,19,17
050,31,049,"Nebraska","Deuel County",2,64,41,19,22
050,31,049,"Nebraska","Deuel County",2,65,34,18,16
050,31,049,"Nebraska","Deuel County",2,66,29,17,12
050,31,049,"Nebraska","Deuel County",2,67,26,15,11
050,31,049,"Nebraska","Deuel County",2,68,30,16,14
050,31,049,"Nebraska","Deuel County",2,69,34,16,18
050,31,049,"Nebraska","Deuel County",2,70,30,14,16
050,31,049,"Nebraska","Deuel County",2,71,26,12,14
050,31,049,"Nebraska","Deuel County",2,72,26,15,11
050,31,049,"Nebraska","Deuel County",2,73,22,13,9
050,31,049,"Nebraska","Deuel County",2,74,13,5,8
050,31,049,"Nebraska","Deuel County",2,75,15,7,8
050,31,049,"Nebraska","Deuel County",2,76,17,9,8
050,31,049,"Nebraska","Deuel County",2,77,17,9,8
050,31,049,"Nebraska","Deuel County",2,78,17,8,9
050,31,049,"Nebraska","Deuel County",2,79,16,6,10
050,31,049,"Nebraska","Deuel County",2,80,13,5,8
050,31,049,"Nebraska","Deuel County",2,81,17,8,9
050,31,049,"Nebraska","Deuel County",2,82,14,6,8
050,31,049,"Nebraska","Deuel County",2,83,15,5,10
050,31,049,"Nebraska","Deuel County",2,84,11,4,7
050,31,049,"Nebraska","Deuel County",2,85,50,25,25
050,31,049,"Nebraska","Deuel County",3,0,12,7,5
050,31,049,"Nebraska","Deuel County",3,1,20,10,10
050,31,049,"Nebraska","Deuel County",3,2,20,8,12
050,31,049,"Nebraska","Deuel County",3,3,16,10,6
050,31,049,"Nebraska","Deuel County",3,4,13,6,7
050,31,049,"Nebraska","Deuel County",3,5,25,11,14
050,31,049,"Nebraska","Deuel County",3,6,22,10,12
050,31,049,"Nebraska","Deuel County",3,7,27,13,14
050,31,049,"Nebraska","Deuel County",3,8,24,15,9
050,31,049,"Nebraska","Deuel County",3,9,24,14,10
050,31,049,"Nebraska","Deuel County",3,10,20,13,7
050,31,049,"Nebraska","Deuel County",3,11,17,13,4
050,31,049,"Nebraska","Deuel County",3,12,26,12,14
050,31,049,"Nebraska","Deuel County",3,13,26,13,13
050,31,049,"Nebraska","Deuel County",3,14,29,14,15
050,31,049,"Nebraska","Deuel County",3,15,22,12,10
050,31,049,"Nebraska","Deuel County",3,16,28,14,14
050,31,049,"Nebraska","Deuel County",3,17,29,15,14
050,31,049,"Nebraska","Deuel County",3,18,22,13,9
050,31,049,"Nebraska","Deuel County",3,19,12,5,7
050,31,049,"Nebraska","Deuel County",3,20,14,6,8
050,31,049,"Nebraska","Deuel County",3,21,3,3,0
050,31,049,"Nebraska","Deuel County",3,22,9,4,5
050,31,049,"Nebraska","Deuel County",3,23,13,6,7
050,31,049,"Nebraska","Deuel County",3,24,17,7,10
050,31,049,"Nebraska","Deuel County",3,25,13,5,8
050,31,049,"Nebraska","Deuel County",3,26,14,9,5
050,31,049,"Nebraska","Deuel County",3,27,15,9,6
050,31,049,"Nebraska","Deuel County",3,28,19,9,10
050,31,049,"Nebraska","Deuel County",3,29,16,8,8
050,31,049,"Nebraska","Deuel County",3,30,13,7,6
050,31,049,"Nebraska","Deuel County",3,31,15,7,8
050,31,049,"Nebraska","Deuel County",3,32,16,8,8
050,31,049,"Nebraska","Deuel County",3,33,22,10,12
050,31,049,"Nebraska","Deuel County",3,34,24,11,13
050,31,049,"Nebraska","Deuel County",3,35,17,9,8
050,31,049,"Nebraska","Deuel County",3,36,13,8,5
050,31,049,"Nebraska","Deuel County",3,37,11,5,6
050,31,049,"Nebraska","Deuel County",3,38,14,8,6
050,31,049,"Nebraska","Deuel County",3,39,12,4,8
050,31,049,"Nebraska","Deuel County",3,40,11,4,7
050,31,049,"Nebraska","Deuel County",3,41,20,12,8
050,31,049,"Nebraska","Deuel County",3,42,28,14,14
050,31,049,"Nebraska","Deuel County",3,43,17,11,6
050,31,049,"Nebraska","Deuel County",3,44,14,8,6
050,31,049,"Nebraska","Deuel County",3,45,17,9,8
050,31,049,"Nebraska","Deuel County",3,46,25,15,10
050,31,049,"Nebraska","Deuel County",3,47,27,16,11
050,31,049,"Nebraska","Deuel County",3,48,21,10,11
050,31,049,"Nebraska","Deuel County",3,49,18,10,8
050,31,049,"Nebraska","Deuel County",3,50,26,14,12
050,31,049,"Nebraska","Deuel County",3,51,22,14,8
050,31,049,"Nebraska","Deuel County",3,52,21,9,12
050,31,049,"Nebraska","Deuel County",3,53,22,9,13
050,31,049,"Nebraska","Deuel County",3,54,27,14,13
050,31,049,"Nebraska","Deuel County",3,55,20,11,9
050,31,049,"Nebraska","Deuel County",3,56,20,10,10
050,31,049,"Nebraska","Deuel County",3,57,28,14,14
050,31,049,"Nebraska","Deuel County",3,58,36,15,21
050,31,049,"Nebraska","Deuel County",3,59,37,18,19
050,31,049,"Nebraska","Deuel County",3,60,33,16,17
050,31,049,"Nebraska","Deuel County",3,61,32,18,14
050,31,049,"Nebraska","Deuel County",3,62,36,17,19
050,31,049,"Nebraska","Deuel County",3,63,30,16,14
050,31,049,"Nebraska","Deuel County",3,64,35,23,12
050,31,049,"Nebraska","Deuel County",3,65,43,21,22
050,31,049,"Nebraska","Deuel County",3,66,33,18,15
050,31,049,"Nebraska","Deuel County",3,67,29,17,12
050,31,049,"Nebraska","Deuel County",3,68,28,18,10
050,31,049,"Nebraska","Deuel County",3,69,31,17,14
050,31,049,"Nebraska","Deuel County",3,70,30,14,16
050,31,049,"Nebraska","Deuel County",3,71,30,13,17
050,31,049,"Nebraska","Deuel County",3,72,27,13,14
050,31,049,"Nebraska","Deuel County",3,73,26,15,11
050,31,049,"Nebraska","Deuel County",3,74,23,13,10
050,31,049,"Nebraska","Deuel County",3,75,11,3,8
050,31,049,"Nebraska","Deuel County",3,76,15,6,9
050,31,049,"Nebraska","Deuel County",3,77,17,9,8
050,31,049,"Nebraska","Deuel County",3,78,17,9,8
050,31,049,"Nebraska","Deuel County",3,79,17,8,9
050,31,049,"Nebraska","Deuel County",3,80,13,5,8
050,31,049,"Nebraska","Deuel County",3,81,11,3,8
050,31,049,"Nebraska","Deuel County",3,82,12,7,5
050,31,049,"Nebraska","Deuel County",3,83,12,5,7
050,31,049,"Nebraska","Deuel County",3,84,15,5,10
050,31,049,"Nebraska","Deuel County",3,85,60,28,32
050,31,049,"Nebraska","Deuel County",4,0,18,10,8
050,31,049,"Nebraska","Deuel County",4,1,15,6,9
050,31,049,"Nebraska","Deuel County",4,2,21,12,9
050,31,049,"Nebraska","Deuel County",4,3,20,11,9
050,31,049,"Nebraska","Deuel County",4,4,15,9,6
050,31,049,"Nebraska","Deuel County",4,5,13,6,7
050,31,049,"Nebraska","Deuel County",4,6,26,11,15
050,31,049,"Nebraska","Deuel County",4,7,23,10,13
050,31,049,"Nebraska","Deuel County",4,8,25,11,14
050,31,049,"Nebraska","Deuel County",4,9,22,9,13
050,31,049,"Nebraska","Deuel County",4,10,20,13,7
050,31,049,"Nebraska","Deuel County",4,11,21,14,7
050,31,049,"Nebraska","Deuel County",4,12,20,15,5
050,31,049,"Nebraska","Deuel County",4,13,24,13,11
050,31,049,"Nebraska","Deuel County",4,14,27,13,14
050,31,049,"Nebraska","Deuel County",4,15,33,16,17
050,31,049,"Nebraska","Deuel County",4,16,24,12,12
050,31,049,"Nebraska","Deuel County",4,17,29,15,14
050,31,049,"Nebraska","Deuel County",4,18,23,12,11
050,31,049,"Nebraska","Deuel County",4,19,18,10,8
050,31,049,"Nebraska","Deuel County",4,20,13,6,7
050,31,049,"Nebraska","Deuel County",4,21,11,5,6
050,31,049,"Nebraska","Deuel County",4,22,2,2,0
050,31,049,"Nebraska","Deuel County",4,23,13,7,6
050,31,049,"Nebraska","Deuel County",4,24,15,7,8
050,31,049,"Nebraska","Deuel County",4,25,12,6,6
050,31,049,"Nebraska","Deuel County",4,26,15,5,10
050,31,049,"Nebraska","Deuel County",4,27,13,10,3
050,31,049,"Nebraska","Deuel County",4,28,15,9,6
050,31,049,"Nebraska","Deuel County",4,29,21,9,12
050,31,049,"Nebraska","Deuel County",4,30,19,9,10
050,31,049,"Nebraska","Deuel County",4,31,15,8,7
050,31,049,"Nebraska","Deuel County",4,32,16,7,9
050,31,049,"Nebraska","Deuel County",4,33,15,7,8
050,31,049,"Nebraska","Deuel County",4,34,22,11,11
050,31,049,"Nebraska","Deuel County",4,35,25,11,14
050,31,049,"Nebraska","Deuel County",4,36,18,7,11
050,31,049,"Nebraska","Deuel County",4,37,19,10,9
050,31,049,"Nebraska","Deuel County",4,38,12,5,7
050,31,049,"Nebraska","Deuel County",4,39,15,9,6
050,31,049,"Nebraska","Deuel County",4,40,12,3,9
050,31,049,"Nebraska","Deuel County",4,41,13,6,7
050,31,049,"Nebraska","Deuel County",4,42,20,12,8
050,31,049,"Nebraska","Deuel County",4,43,31,16,15
050,31,049,"Nebraska","Deuel County",4,44,17,11,6
050,31,049,"Nebraska","Deuel County",4,45,17,8,9
050,31,049,"Nebraska","Deuel County",4,46,17,9,8
050,31,049,"Nebraska","Deuel County",4,47,25,15,10
050,31,049,"Nebraska","Deuel County",4,48,28,16,12
050,31,049,"Nebraska","Deuel County",4,49,21,10,11
050,31,049,"Nebraska","Deuel County",4,50,22,13,9
050,31,049,"Nebraska","Deuel County",4,51,28,13,15
050,31,049,"Nebraska","Deuel County",4,52,25,13,12
050,31,049,"Nebraska","Deuel County",4,53,23,11,12
050,31,049,"Nebraska","Deuel County",4,54,22,9,13
050,31,049,"Nebraska","Deuel County",4,55,31,16,15
050,31,049,"Nebraska","Deuel County",4,56,23,13,10
050,31,049,"Nebraska","Deuel County",4,57,24,12,12
050,31,049,"Nebraska","Deuel County",4,58,28,14,14
050,31,049,"Nebraska","Deuel County",4,59,41,17,24
050,31,049,"Nebraska","Deuel County",4,60,39,21,18
050,31,049,"Nebraska","Deuel County",4,61,35,18,17
050,31,049,"Nebraska","Deuel County",4,62,32,18,14
050,31,049,"Nebraska","Deuel County",4,63,35,17,18
050,31,049,"Nebraska","Deuel County",4,64,32,18,14
050,31,049,"Nebraska","Deuel County",4,65,33,22,11
050,31,049,"Nebraska","Deuel County",4,66,45,22,23
050,31,049,"Nebraska","Deuel County",4,67,30,17,13
050,31,049,"Nebraska","Deuel County",4,68,29,17,12
050,31,049,"Nebraska","Deuel County",4,69,25,16,9
050,31,049,"Nebraska","Deuel County",4,70,32,16,16
050,31,049,"Nebraska","Deuel County",4,71,30,15,15
050,31,049,"Nebraska","Deuel County",4,72,32,14,18
050,31,049,"Nebraska","Deuel County",4,73,28,14,14
050,31,049,"Nebraska","Deuel County",4,74,27,16,11
050,31,049,"Nebraska","Deuel County",4,75,21,11,10
050,31,049,"Nebraska","Deuel County",4,76,10,2,8
050,31,049,"Nebraska","Deuel County",4,77,15,7,8
050,31,049,"Nebraska","Deuel County",4,78,17,9,8
050,31,049,"Nebraska","Deuel County",4,79,16,10,6
050,31,049,"Nebraska","Deuel County",4,80,16,8,8
050,31,049,"Nebraska","Deuel County",4,81,10,4,6
050,31,049,"Nebraska","Deuel County",4,82,10,3,7
050,31,049,"Nebraska","Deuel County",4,83,9,5,4
050,31,049,"Nebraska","Deuel County",4,84,11,4,7
050,31,049,"Nebraska","Deuel County",4,85,71,32,39
050,31,049,"Nebraska","Deuel County",5,0,20,11,9
050,31,049,"Nebraska","Deuel County",5,1,20,10,10
050,31,049,"Nebraska","Deuel County",5,2,15,5,10
050,31,049,"Nebraska","Deuel County",5,3,19,11,8
050,31,049,"Nebraska","Deuel County",5,4,17,9,8
050,31,049,"Nebraska","Deuel County",5,5,14,9,5
050,31,049,"Nebraska","Deuel County",5,6,14,6,8
050,31,049,"Nebraska","Deuel County",5,7,25,11,14
050,31,049,"Nebraska","Deuel County",5,8,24,11,13
050,31,049,"Nebraska","Deuel County",5,9,24,9,15
050,31,049,"Nebraska","Deuel County",5,10,17,7,10
050,31,049,"Nebraska","Deuel County",5,11,21,13,8
050,31,049,"Nebraska","Deuel County",5,12,19,14,5
050,31,049,"Nebraska","Deuel County",5,13,20,14,6
050,31,049,"Nebraska","Deuel County",5,14,23,11,12
050,31,049,"Nebraska","Deuel County",5,15,26,12,14
050,31,049,"Nebraska","Deuel County",5,16,34,16,18
050,31,049,"Nebraska","Deuel County",5,17,26,13,13
050,31,049,"Nebraska","Deuel County",5,18,22,11,11
050,31,049,"Nebraska","Deuel County",5,19,17,9,8
050,31,049,"Nebraska","Deuel County",5,20,20,11,9
050,31,049,"Nebraska","Deuel County",5,21,12,5,7
050,31,049,"Nebraska","Deuel County",5,22,10,5,5
050,31,049,"Nebraska","Deuel County",5,23,2,1,1
050,31,049,"Nebraska","Deuel County",5,24,15,6,9
050,31,049,"Nebraska","Deuel County",5,25,12,5,7
050,31,049,"Nebraska","Deuel County",5,26,9,4,5
050,31,049,"Nebraska","Deuel County",5,27,14,5,9
050,31,049,"Nebraska","Deuel County",5,28,12,9,3
050,31,049,"Nebraska","Deuel County",5,29,16,9,7
050,31,049,"Nebraska","Deuel County",5,30,20,10,10
050,31,049,"Nebraska","Deuel County",5,31,21,12,9
050,31,049,"Nebraska","Deuel County",5,32,12,7,5
050,31,049,"Nebraska","Deuel County",5,33,17,7,10
050,31,049,"Nebraska","Deuel County",5,34,13,5,8
050,31,049,"Nebraska","Deuel County",5,35,21,10,11
050,31,049,"Nebraska","Deuel County",5,36,23,10,13
050,31,049,"Nebraska","Deuel County",5,37,17,7,10
050,31,049,"Nebraska","Deuel County",5,38,22,10,12
050,31,049,"Nebraska","Deuel County",5,39,12,5,7
050,31,049,"Nebraska","Deuel County",5,40,14,9,5
050,31,049,"Nebraska","Deuel County",5,41,12,3,9
050,31,049,"Nebraska","Deuel County",5,42,14,7,7
050,31,049,"Nebraska","Deuel County",5,43,20,12,8
050,31,049,"Nebraska","Deuel County",5,44,32,15,17
050,31,049,"Nebraska","Deuel County",5,45,18,12,6
050,31,049,"Nebraska","Deuel County",5,46,16,8,8
050,31,049,"Nebraska","Deuel County",5,47,18,9,9
050,31,049,"Nebraska","Deuel County",5,48,25,15,10
050,31,049,"Nebraska","Deuel County",5,49,26,14,12
050,31,049,"Nebraska","Deuel County",5,50,21,10,11
050,31,049,"Nebraska","Deuel County",5,51,25,15,10
050,31,049,"Nebraska","Deuel County",5,52,29,14,15
050,31,049,"Nebraska","Deuel County",5,53,25,13,12
050,31,049,"Nebraska","Deuel County",5,54,23,11,12
050,31,049,"Nebraska","Deuel County",5,55,22,9,13
050,31,049,"Nebraska","Deuel County",5,56,30,15,15
050,31,049,"Nebraska","Deuel County",5,57,23,13,10
050,31,049,"Nebraska","Deuel County",5,58,25,13,12
050,31,049,"Nebraska","Deuel County",5,59,28,14,14
050,31,049,"Nebraska","Deuel County",5,60,40,17,23
050,31,049,"Nebraska","Deuel County",5,61,36,19,17
050,31,049,"Nebraska","Deuel County",5,62,38,21,17
050,31,049,"Nebraska","Deuel County",5,63,32,18,14
050,31,049,"Nebraska","Deuel County",5,64,35,19,16
050,31,049,"Nebraska","Deuel County",5,65,32,18,14
050,31,049,"Nebraska","Deuel County",5,66,30,21,9
050,31,049,"Nebraska","Deuel County",5,67,46,23,23
050,31,049,"Nebraska","Deuel County",5,68,29,17,12
050,31,049,"Nebraska","Deuel County",5,69,30,17,13
050,31,049,"Nebraska","Deuel County",5,70,24,15,9
050,31,049,"Nebraska","Deuel County",5,71,32,16,16
050,31,049,"Nebraska","Deuel County",5,72,31,15,16
050,31,049,"Nebraska","Deuel County",5,73,30,12,18
050,31,049,"Nebraska","Deuel County",5,74,26,14,12
050,31,049,"Nebraska","Deuel County",5,75,23,13,10
050,31,049,"Nebraska","Deuel County",5,76,21,10,11
050,31,049,"Nebraska","Deuel County",5,77,10,2,8
050,31,049,"Nebraska","Deuel County",5,78,16,7,9
050,31,049,"Nebraska","Deuel County",5,79,15,9,6
050,31,049,"Nebraska","Deuel County",5,80,15,10,5
050,31,049,"Nebraska","Deuel County",5,81,14,7,7
050,31,049,"Nebraska","Deuel County",5,82,8,4,4
050,31,049,"Nebraska","Deuel County",5,83,9,2,7
050,31,049,"Nebraska","Deuel County",5,84,8,4,4
050,31,049,"Nebraska","Deuel County",5,85,78,36,42
050,31,051,"Nebraska","Dixon County",1,0,66,34,32
050,31,051,"Nebraska","Dixon County",1,1,63,33,30
050,31,051,"Nebraska","Dixon County",1,2,85,43,42
050,31,051,"Nebraska","Dixon County",1,3,81,35,46
050,31,051,"Nebraska","Dixon County",1,4,83,36,47
050,31,051,"Nebraska","Dixon County",1,5,92,49,43
050,31,051,"Nebraska","Dixon County",1,6,75,41,34
050,31,051,"Nebraska","Dixon County",1,7,74,41,33
050,31,051,"Nebraska","Dixon County",1,8,76,41,35
050,31,051,"Nebraska","Dixon County",1,9,73,38,35
050,31,051,"Nebraska","Dixon County",1,10,73,39,34
050,31,051,"Nebraska","Dixon County",1,11,84,46,38
050,31,051,"Nebraska","Dixon County",1,12,88,48,40
050,31,051,"Nebraska","Dixon County",1,13,91,51,40
050,31,051,"Nebraska","Dixon County",1,14,80,44,36
050,31,051,"Nebraska","Dixon County",1,15,70,43,27
050,31,051,"Nebraska","Dixon County",1,16,80,42,38
050,31,051,"Nebraska","Dixon County",1,17,86,39,47
050,31,051,"Nebraska","Dixon County",1,18,73,39,34
050,31,051,"Nebraska","Dixon County",1,19,54,26,28
050,31,051,"Nebraska","Dixon County",1,20,55,29,26
050,31,051,"Nebraska","Dixon County",1,21,71,36,35
050,31,051,"Nebraska","Dixon County",1,22,67,29,38
050,31,051,"Nebraska","Dixon County",1,23,64,30,34
050,31,051,"Nebraska","Dixon County",1,24,49,27,22
050,31,051,"Nebraska","Dixon County",1,25,57,32,25
050,31,051,"Nebraska","Dixon County",1,26,54,27,27
050,31,051,"Nebraska","Dixon County",1,27,61,29,32
050,31,051,"Nebraska","Dixon County",1,28,57,31,26
050,31,051,"Nebraska","Dixon County",1,29,48,24,24
050,31,051,"Nebraska","Dixon County",1,30,48,24,24
050,31,051,"Nebraska","Dixon County",1,31,39,22,17
050,31,051,"Nebraska","Dixon County",1,32,54,35,19
050,31,051,"Nebraska","Dixon County",1,33,58,34,24
050,31,051,"Nebraska","Dixon County",1,34,65,28,37
050,31,051,"Nebraska","Dixon County",1,35,68,34,34
050,31,051,"Nebraska","Dixon County",1,36,55,30,25
050,31,051,"Nebraska","Dixon County",1,37,48,26,22
050,31,051,"Nebraska","Dixon County",1,38,67,37,30
050,31,051,"Nebraska","Dixon County",1,39,63,30,33
050,31,051,"Nebraska","Dixon County",1,40,64,28,36
050,31,051,"Nebraska","Dixon County",1,41,67,34,33
050,31,051,"Nebraska","Dixon County",1,42,59,31,28
050,31,051,"Nebraska","Dixon County",1,43,49,23,26
050,31,051,"Nebraska","Dixon County",1,44,64,33,31
050,31,051,"Nebraska","Dixon County",1,45,63,31,32
050,31,051,"Nebraska","Dixon County",1,46,60,34,26
050,31,051,"Nebraska","Dixon County",1,47,62,37,25
050,31,051,"Nebraska","Dixon County",1,48,68,37,31
050,31,051,"Nebraska","Dixon County",1,49,58,28,30
050,31,051,"Nebraska","Dixon County",1,50,61,32,29
050,31,051,"Nebraska","Dixon County",1,51,73,42,31
050,31,051,"Nebraska","Dixon County",1,52,62,35,27
050,31,051,"Nebraska","Dixon County",1,53,71,38,33
050,31,051,"Nebraska","Dixon County",1,54,64,33,31
050,31,051,"Nebraska","Dixon County",1,55,70,39,31
050,31,051,"Nebraska","Dixon County",1,56,75,38,37
050,31,051,"Nebraska","Dixon County",1,57,64,30,34
050,31,051,"Nebraska","Dixon County",1,58,68,32,36
050,31,051,"Nebraska","Dixon County",1,59,79,40,39
050,31,051,"Nebraska","Dixon County",1,60,90,50,40
050,31,051,"Nebraska","Dixon County",1,61,86,45,41
050,31,051,"Nebraska","Dixon County",1,62,86,43,43
050,31,051,"Nebraska","Dixon County",1,63,100,51,49
050,31,051,"Nebraska","Dixon County",1,64,82,48,34
050,31,051,"Nebraska","Dixon County",1,65,76,40,36
050,31,051,"Nebraska","Dixon County",1,66,80,42,38
050,31,051,"Nebraska","Dixon County",1,67,83,44,39
050,31,051,"Nebraska","Dixon County",1,68,79,41,38
050,31,051,"Nebraska","Dixon County",1,69,74,39,35
050,31,051,"Nebraska","Dixon County",1,70,58,35,23
050,31,051,"Nebraska","Dixon County",1,71,57,29,28
050,31,051,"Nebraska","Dixon County",1,72,68,38,30
050,31,051,"Nebraska","Dixon County",1,73,67,31,36
050,31,051,"Nebraska","Dixon County",1,74,50,25,25
050,31,051,"Nebraska","Dixon County",1,75,46,21,25
050,31,051,"Nebraska","Dixon County",1,76,43,21,22
050,31,051,"Nebraska","Dixon County",1,77,37,18,19
050,31,051,"Nebraska","Dixon County",1,78,41,27,14
050,31,051,"Nebraska","Dixon County",1,79,39,17,22
050,31,051,"Nebraska","Dixon County",1,80,32,14,18
050,31,051,"Nebraska","Dixon County",1,81,30,12,18
050,31,051,"Nebraska","Dixon County",1,82,26,10,16
050,31,051,"Nebraska","Dixon County",1,83,23,12,11
050,31,051,"Nebraska","Dixon County",1,84,18,11,7
050,31,051,"Nebraska","Dixon County",1,85,144,39,105
050,31,051,"Nebraska","Dixon County",2,0,70,37,33
050,31,051,"Nebraska","Dixon County",2,1,62,33,29
050,31,051,"Nebraska","Dixon County",2,2,80,41,39
050,31,051,"Nebraska","Dixon County",2,3,81,37,44
050,31,051,"Nebraska","Dixon County",2,4,83,36,47
050,31,051,"Nebraska","Dixon County",2,5,89,45,44
050,31,051,"Nebraska","Dixon County",2,6,78,43,35
050,31,051,"Nebraska","Dixon County",2,7,74,40,34
050,31,051,"Nebraska","Dixon County",2,8,75,40,35
050,31,051,"Nebraska","Dixon County",2,9,74,39,35
050,31,051,"Nebraska","Dixon County",2,10,75,40,35
050,31,051,"Nebraska","Dixon County",2,11,81,44,37
050,31,051,"Nebraska","Dixon County",2,12,85,47,38
050,31,051,"Nebraska","Dixon County",2,13,91,51,40
050,31,051,"Nebraska","Dixon County",2,14,80,44,36
050,31,051,"Nebraska","Dixon County",2,15,72,43,29
050,31,051,"Nebraska","Dixon County",2,16,77,41,36
050,31,051,"Nebraska","Dixon County",2,17,85,40,45
050,31,051,"Nebraska","Dixon County",2,18,73,38,35
050,31,051,"Nebraska","Dixon County",2,19,53,26,27
050,31,051,"Nebraska","Dixon County",2,20,56,29,27
050,31,051,"Nebraska","Dixon County",2,21,69,35,34
050,31,051,"Nebraska","Dixon County",2,22,69,31,38
050,31,051,"Nebraska","Dixon County",2,23,60,28,32
050,31,051,"Nebraska","Dixon County",2,24,53,29,24
050,31,051,"Nebraska","Dixon County",2,25,55,30,25
050,31,051,"Nebraska","Dixon County",2,26,55,28,27
050,31,051,"Nebraska","Dixon County",2,27,60,29,31
050,31,051,"Nebraska","Dixon County",2,28,58,30,28
050,31,051,"Nebraska","Dixon County",2,29,51,26,25
050,31,051,"Nebraska","Dixon County",2,30,45,22,23
050,31,051,"Nebraska","Dixon County",2,31,40,22,18
050,31,051,"Nebraska","Dixon County",2,32,51,32,19
050,31,051,"Nebraska","Dixon County",2,33,58,35,23
050,31,051,"Nebraska","Dixon County",2,34,64,29,35
050,31,051,"Nebraska","Dixon County",2,35,69,34,35
050,31,051,"Nebraska","Dixon County",2,36,57,31,26
050,31,051,"Nebraska","Dixon County",2,37,50,27,23
050,31,051,"Nebraska","Dixon County",2,38,63,34,29
050,31,051,"Nebraska","Dixon County",2,39,65,32,33
050,31,051,"Nebraska","Dixon County",2,40,64,29,35
050,31,051,"Nebraska","Dixon County",2,41,68,34,34
050,31,051,"Nebraska","Dixon County",2,42,61,31,30
050,31,051,"Nebraska","Dixon County",2,43,52,25,27
050,31,051,"Nebraska","Dixon County",2,44,60,31,29
050,31,051,"Nebraska","Dixon County",2,45,63,31,32
050,31,051,"Nebraska","Dixon County",2,46,61,33,28
050,31,051,"Nebraska","Dixon County",2,47,61,36,25
050,31,051,"Nebraska","Dixon County",2,48,67,37,30
050,31,051,"Nebraska","Dixon County",2,49,59,29,30
050,31,051,"Nebraska","Dixon County",2,50,60,31,29
050,31,051,"Nebraska","Dixon County",2,51,72,40,32
050,31,051,"Nebraska","Dixon County",2,52,65,37,28
050,31,051,"Nebraska","Dixon County",2,53,69,37,32
050,31,051,"Nebraska","Dixon County",2,54,65,33,32
050,31,051,"Nebraska","Dixon County",2,55,70,39,31
050,31,051,"Nebraska","Dixon County",2,56,71,37,34
050,31,051,"Nebraska","Dixon County",2,57,66,31,35
050,31,051,"Nebraska","Dixon County",2,58,67,32,35
050,31,051,"Nebraska","Dixon County",2,59,77,39,38
050,31,051,"Nebraska","Dixon County",2,60,87,48,39
050,31,051,"Nebraska","Dixon County",2,61,85,46,39
050,31,051,"Nebraska","Dixon County",2,62,84,43,41
050,31,051,"Nebraska","Dixon County",2,63,97,49,48
050,31,051,"Nebraska","Dixon County",2,64,85,48,37
050,31,051,"Nebraska","Dixon County",2,65,78,42,36
050,31,051,"Nebraska","Dixon County",2,66,79,41,38
050,31,051,"Nebraska","Dixon County",2,67,81,42,39
050,31,051,"Nebraska","Dixon County",2,68,80,42,38
050,31,051,"Nebraska","Dixon County",2,69,74,38,36
050,31,051,"Nebraska","Dixon County",2,70,60,34,26
050,31,051,"Nebraska","Dixon County",2,71,56,29,27
050,31,051,"Nebraska","Dixon County",2,72,63,35,28
050,31,051,"Nebraska","Dixon County",2,73,69,33,36
050,31,051,"Nebraska","Dixon County",2,74,50,25,25
050,31,051,"Nebraska","Dixon County",2,75,46,21,25
050,31,051,"Nebraska","Dixon County",2,76,43,21,22
050,31,051,"Nebraska","Dixon County",2,77,39,19,20
050,31,051,"Nebraska","Dixon County",2,78,39,24,15
050,31,051,"Nebraska","Dixon County",2,79,40,20,20
050,31,051,"Nebraska","Dixon County",2,80,34,15,19
050,31,051,"Nebraska","Dixon County",2,81,30,12,18
050,31,051,"Nebraska","Dixon County",2,82,27,11,16
050,31,051,"Nebraska","Dixon County",2,83,23,11,12
050,31,051,"Nebraska","Dixon County",2,84,19,11,8
050,31,051,"Nebraska","Dixon County",2,85,143,41,102
050,31,051,"Nebraska","Dixon County",3,0,67,38,29
050,31,051,"Nebraska","Dixon County",3,1,65,35,30
050,31,051,"Nebraska","Dixon County",3,2,61,32,29
050,31,051,"Nebraska","Dixon County",3,3,79,38,41
050,31,051,"Nebraska","Dixon County",3,4,84,37,47
050,31,051,"Nebraska","Dixon County",3,5,85,37,48
050,31,051,"Nebraska","Dixon County",3,6,88,44,44
050,31,051,"Nebraska","Dixon County",3,7,82,45,37
050,31,051,"Nebraska","Dixon County",3,8,72,36,36
050,31,051,"Nebraska","Dixon County",3,9,72,39,33
050,31,051,"Nebraska","Dixon County",3,10,80,42,38
050,31,051,"Nebraska","Dixon County",3,11,74,36,38
050,31,051,"Nebraska","Dixon County",3,12,85,50,35
050,31,051,"Nebraska","Dixon County",3,13,92,51,41
050,31,051,"Nebraska","Dixon County",3,14,96,52,44
050,31,051,"Nebraska","Dixon County",3,15,79,42,37
050,31,051,"Nebraska","Dixon County",3,16,76,45,31
050,31,051,"Nebraska","Dixon County",3,17,75,41,34
050,31,051,"Nebraska","Dixon County",3,18,69,32,37
050,31,051,"Nebraska","Dixon County",3,19,61,30,31
050,31,051,"Nebraska","Dixon County",3,20,54,27,27
050,31,051,"Nebraska","Dixon County",3,21,61,33,28
050,31,051,"Nebraska","Dixon County",3,22,68,36,32
050,31,051,"Nebraska","Dixon County",3,23,52,25,27
050,31,051,"Nebraska","Dixon County",3,24,54,25,29
050,31,051,"Nebraska","Dixon County",3,25,49,27,22
050,31,051,"Nebraska","Dixon County",3,26,50,25,25
050,31,051,"Nebraska","Dixon County",3,27,58,29,29
050,31,051,"Nebraska","Dixon County",3,28,60,27,33
050,31,051,"Nebraska","Dixon County",3,29,61,31,30
050,31,051,"Nebraska","Dixon County",3,30,51,24,27
050,31,051,"Nebraska","Dixon County",3,31,53,27,26
050,31,051,"Nebraska","Dixon County",3,32,42,23,19
050,31,051,"Nebraska","Dixon County",3,33,51,32,19
050,31,051,"Nebraska","Dixon County",3,34,56,33,23
050,31,051,"Nebraska","Dixon County",3,35,60,29,31
050,31,051,"Nebraska","Dixon County",3,36,71,34,37
050,31,051,"Nebraska","Dixon County",3,37,57,31,26
050,31,051,"Nebraska","Dixon County",3,38,49,27,22
050,31,051,"Nebraska","Dixon County",3,39,66,38,28
050,31,051,"Nebraska","Dixon County",3,40,63,31,32
050,31,051,"Nebraska","Dixon County",3,41,63,27,36
050,31,051,"Nebraska","Dixon County",3,42,65,32,33
050,31,051,"Nebraska","Dixon County",3,43,59,30,29
050,31,051,"Nebraska","Dixon County",3,44,55,28,27
050,31,051,"Nebraska","Dixon County",3,45,63,30,33
050,31,051,"Nebraska","Dixon County",3,46,66,34,32
050,31,051,"Nebraska","Dixon County",3,47,61,34,27
050,31,051,"Nebraska","Dixon County",3,48,58,38,20
050,31,051,"Nebraska","Dixon County",3,49,70,39,31
050,31,051,"Nebraska","Dixon County",3,50,61,31,30
050,31,051,"Nebraska","Dixon County",3,51,60,31,29
050,31,051,"Nebraska","Dixon County",3,52,68,38,30
050,31,051,"Nebraska","Dixon County",3,53,64,35,29
050,31,051,"Nebraska","Dixon County",3,54,71,40,31
050,31,051,"Nebraska","Dixon County",3,55,70,38,32
050,31,051,"Nebraska","Dixon County",3,56,65,35,30
050,31,051,"Nebraska","Dixon County",3,57,74,39,35
050,31,051,"Nebraska","Dixon County",3,58,64,31,33
050,31,051,"Nebraska","Dixon County",3,59,66,31,35
050,31,051,"Nebraska","Dixon County",3,60,76,38,38
050,31,051,"Nebraska","Dixon County",3,61,84,45,39
050,31,051,"Nebraska","Dixon County",3,62,84,43,41
050,31,051,"Nebraska","Dixon County",3,63,84,40,44
050,31,051,"Nebraska","Dixon County",3,64,92,49,43
050,31,051,"Nebraska","Dixon County",3,65,83,47,36
050,31,051,"Nebraska","Dixon County",3,66,78,42,36
050,31,051,"Nebraska","Dixon County",3,67,80,39,41
050,31,051,"Nebraska","Dixon County",3,68,77,41,36
050,31,051,"Nebraska","Dixon County",3,69,82,42,40
050,31,051,"Nebraska","Dixon County",3,70,69,39,30
050,31,051,"Nebraska","Dixon County",3,71,59,32,27
050,31,051,"Nebraska","Dixon County",3,72,56,29,27
050,31,051,"Nebraska","Dixon County",3,73,64,36,28
050,31,051,"Nebraska","Dixon County",3,74,69,33,36
050,31,051,"Nebraska","Dixon County",3,75,49,23,26
050,31,051,"Nebraska","Dixon County",3,76,46,21,25
050,31,051,"Nebraska","Dixon County",3,77,41,18,23
050,31,051,"Nebraska","Dixon County",3,78,35,18,17
050,31,051,"Nebraska","Dixon County",3,79,41,23,18
050,31,051,"Nebraska","Dixon County",3,80,36,19,17
050,31,051,"Nebraska","Dixon County",3,81,35,16,19
050,31,051,"Nebraska","Dixon County",3,82,27,11,16
050,31,051,"Nebraska","Dixon County",3,83,20,7,13
050,31,051,"Nebraska","Dixon County",3,84,16,8,8
050,31,051,"Nebraska","Dixon County",3,85,136,39,97
050,31,051,"Nebraska","Dixon County",4,0,57,28,29
050,31,051,"Nebraska","Dixon County",4,1,68,40,28
050,31,051,"Nebraska","Dixon County",4,2,66,30,36
050,31,051,"Nebraska","Dixon County",4,3,63,35,28
050,31,051,"Nebraska","Dixon County",4,4,83,42,41
050,31,051,"Nebraska","Dixon County",4,5,80,36,44
050,31,051,"Nebraska","Dixon County",4,6,79,34,45
050,31,051,"Nebraska","Dixon County",4,7,90,42,48
050,31,051,"Nebraska","Dixon County",4,8,80,42,38
050,31,051,"Nebraska","Dixon County",4,9,74,38,36
050,31,051,"Nebraska","Dixon County",4,10,72,36,36
050,31,051,"Nebraska","Dixon County",4,11,78,40,38
050,31,051,"Nebraska","Dixon County",4,12,73,36,37
050,31,051,"Nebraska","Dixon County",4,13,83,48,35
050,31,051,"Nebraska","Dixon County",4,14,90,51,39
050,31,051,"Nebraska","Dixon County",4,15,93,50,43
050,31,051,"Nebraska","Dixon County",4,16,77,42,35
050,31,051,"Nebraska","Dixon County",4,17,75,46,29
050,31,051,"Nebraska","Dixon County",4,18,61,34,27
050,31,051,"Nebraska","Dixon County",4,19,52,23,29
050,31,051,"Nebraska","Dixon County",4,20,60,30,30
050,31,051,"Nebraska","Dixon County",4,21,51,25,26
050,31,051,"Nebraska","Dixon County",4,22,62,33,29
050,31,051,"Nebraska","Dixon County",4,23,60,37,23
050,31,051,"Nebraska","Dixon County",4,24,51,26,25
050,31,051,"Nebraska","Dixon County",4,25,52,26,26
050,31,051,"Nebraska","Dixon County",4,26,50,28,22
050,31,051,"Nebraska","Dixon County",4,27,47,23,24
050,31,051,"Nebraska","Dixon County",4,28,53,26,27
050,31,051,"Nebraska","Dixon County",4,29,61,30,31
050,31,051,"Nebraska","Dixon County",4,30,62,28,34
050,31,051,"Nebraska","Dixon County",4,31,59,30,29
050,31,051,"Nebraska","Dixon County",4,32,65,33,32
050,31,051,"Nebraska","Dixon County",4,33,41,19,22
050,31,051,"Nebraska","Dixon County",4,34,54,32,22
050,31,051,"Nebraska","Dixon County",4,35,62,38,24
050,31,051,"Nebraska","Dixon County",4,36,61,32,29
050,31,051,"Nebraska","Dixon County",4,37,70,32,38
050,31,051,"Nebraska","Dixon County",4,38,57,32,25
050,31,051,"Nebraska","Dixon County",4,39,56,32,24
050,31,051,"Nebraska","Dixon County",4,40,64,36,28
050,31,051,"Nebraska","Dixon County",4,41,63,30,33
050,31,051,"Nebraska","Dixon County",4,42,68,36,32
050,31,051,"Nebraska","Dixon County",4,43,66,31,35
050,31,051,"Nebraska","Dixon County",4,44,56,27,29
050,31,051,"Nebraska","Dixon County",4,45,51,26,25
050,31,051,"Nebraska","Dixon County",4,46,59,28,31
050,31,051,"Nebraska","Dixon County",4,47,65,35,30
050,31,051,"Nebraska","Dixon County",4,48,60,33,27
050,31,051,"Nebraska","Dixon County",4,49,54,35,19
050,31,051,"Nebraska","Dixon County",4,50,65,37,28
050,31,051,"Nebraska","Dixon County",4,51,58,31,27
050,31,051,"Nebraska","Dixon County",4,52,59,31,28
050,31,051,"Nebraska","Dixon County",4,53,68,38,30
050,31,051,"Nebraska","Dixon County",4,54,63,35,28
050,31,051,"Nebraska","Dixon County",4,55,76,41,35
050,31,051,"Nebraska","Dixon County",4,56,65,34,31
050,31,051,"Nebraska","Dixon County",4,57,60,31,29
050,31,051,"Nebraska","Dixon County",4,58,73,40,33
050,31,051,"Nebraska","Dixon County",4,59,62,32,30
050,31,051,"Nebraska","Dixon County",4,60,66,31,35
050,31,051,"Nebraska","Dixon County",4,61,79,42,37
050,31,051,"Nebraska","Dixon County",4,62,79,41,38
050,31,051,"Nebraska","Dixon County",4,63,82,41,41
050,31,051,"Nebraska","Dixon County",4,64,80,39,41
050,31,051,"Nebraska","Dixon County",4,65,91,49,42
050,31,051,"Nebraska","Dixon County",4,66,80,44,36
050,31,051,"Nebraska","Dixon County",4,67,79,42,37
050,31,051,"Nebraska","Dixon County",4,68,78,39,39
050,31,051,"Nebraska","Dixon County",4,69,78,40,38
050,31,051,"Nebraska","Dixon County",4,70,80,42,38
050,31,051,"Nebraska","Dixon County",4,71,70,40,30
050,31,051,"Nebraska","Dixon County",4,72,58,30,28
050,31,051,"Nebraska","Dixon County",4,73,57,31,26
050,31,051,"Nebraska","Dixon County",4,74,62,36,26
050,31,051,"Nebraska","Dixon County",4,75,65,30,35
050,31,051,"Nebraska","Dixon County",4,76,46,21,25
050,31,051,"Nebraska","Dixon County",4,77,45,20,25
050,31,051,"Nebraska","Dixon County",4,78,38,17,21
050,31,051,"Nebraska","Dixon County",4,79,37,18,19
050,31,051,"Nebraska","Dixon County",4,80,38,22,16
050,31,051,"Nebraska","Dixon County",4,81,36,19,17
050,31,051,"Nebraska","Dixon County",4,82,32,14,18
050,31,051,"Nebraska","Dixon County",4,83,29,12,17
050,31,051,"Nebraska","Dixon County",4,84,14,3,11
050,31,051,"Nebraska","Dixon County",4,85,134,38,96
050,31,051,"Nebraska","Dixon County",5,0,60,30,30
050,31,051,"Nebraska","Dixon County",5,1,57,28,29
050,31,051,"Nebraska","Dixon County",5,2,68,39,29
050,31,051,"Nebraska","Dixon County",5,3,69,28,41
050,31,051,"Nebraska","Dixon County",5,4,65,38,27
050,31,051,"Nebraska","Dixon County",5,5,80,38,42
050,31,051,"Nebraska","Dixon County",5,6,84,39,45
050,31,051,"Nebraska","Dixon County",5,7,78,33,45
050,31,051,"Nebraska","Dixon County",5,8,88,42,46
050,31,051,"Nebraska","Dixon County",5,9,83,45,38
050,31,051,"Nebraska","Dixon County",5,10,76,39,37
050,31,051,"Nebraska","Dixon County",5,11,73,36,37
050,31,051,"Nebraska","Dixon County",5,12,80,40,40
050,31,051,"Nebraska","Dixon County",5,13,78,40,38
050,31,051,"Nebraska","Dixon County",5,14,89,53,36
050,31,051,"Nebraska","Dixon County",5,15,90,51,39
050,31,051,"Nebraska","Dixon County",5,16,95,51,44
050,31,051,"Nebraska","Dixon County",5,17,79,43,36
050,31,051,"Nebraska","Dixon County",5,18,63,40,23
050,31,051,"Nebraska","Dixon County",5,19,52,30,22
050,31,051,"Nebraska","Dixon County",5,20,57,24,33
050,31,051,"Nebraska","Dixon County",5,21,65,32,33
050,31,051,"Nebraska","Dixon County",5,22,46,21,25
050,31,051,"Nebraska","Dixon County",5,23,62,30,32
050,31,051,"Nebraska","Dixon County",5,24,56,31,25
050,31,051,"Nebraska","Dixon County",5,25,49,25,24
050,31,051,"Nebraska","Dixon County",5,26,49,22,27
050,31,051,"Nebraska","Dixon County",5,27,47,32,15
050,31,051,"Nebraska","Dixon County",5,28,57,30,27
050,31,051,"Nebraska","Dixon County",5,29,53,26,27
050,31,051,"Nebraska","Dixon County",5,30,63,32,31
050,31,051,"Nebraska","Dixon County",5,31,62,30,32
050,31,051,"Nebraska","Dixon County",5,32,50,24,26
050,31,051,"Nebraska","Dixon County",5,33,67,33,34
050,31,051,"Nebraska","Dixon County",5,34,37,18,19
050,31,051,"Nebraska","Dixon County",5,35,55,32,23
050,31,051,"Nebraska","Dixon County",5,36,62,38,24
050,31,051,"Nebraska","Dixon County",5,37,61,32,29
050,31,051,"Nebraska","Dixon County",5,38,67,28,39
050,31,051,"Nebraska","Dixon County",5,39,57,31,26
050,31,051,"Nebraska","Dixon County",5,40,56,34,22
050,31,051,"Nebraska","Dixon County",5,41,66,36,30
050,31,051,"Nebraska","Dixon County",5,42,62,30,32
050,31,051,"Nebraska","Dixon County",5,43,65,33,32
050,31,051,"Nebraska","Dixon County",5,44,59,26,33
050,31,051,"Nebraska","Dixon County",5,45,54,23,31
050,31,051,"Nebraska","Dixon County",5,46,50,26,24
050,31,051,"Nebraska","Dixon County",5,47,60,29,31
050,31,051,"Nebraska","Dixon County",5,48,66,35,31
050,31,051,"Nebraska","Dixon County",5,49,62,34,28
050,31,051,"Nebraska","Dixon County",5,50,52,32,20
050,31,051,"Nebraska","Dixon County",5,51,66,38,28
050,31,051,"Nebraska","Dixon County",5,52,56,31,25
050,31,051,"Nebraska","Dixon County",5,53,60,31,29
050,31,051,"Nebraska","Dixon County",5,54,63,37,26
050,31,051,"Nebraska","Dixon County",5,55,70,39,31
050,31,051,"Nebraska","Dixon County",5,56,71,36,35
050,31,051,"Nebraska","Dixon County",5,57,62,33,29
050,31,051,"Nebraska","Dixon County",5,58,60,32,28
050,31,051,"Nebraska","Dixon County",5,59,73,41,32
050,31,051,"Nebraska","Dixon County",5,60,62,32,30
050,31,051,"Nebraska","Dixon County",5,61,63,29,34
050,31,051,"Nebraska","Dixon County",5,62,73,38,35
050,31,051,"Nebraska","Dixon County",5,63,80,40,40
050,31,051,"Nebraska","Dixon County",5,64,77,40,37
050,31,051,"Nebraska","Dixon County",5,65,81,41,40
050,31,051,"Nebraska","Dixon County",5,66,91,48,43
050,31,051,"Nebraska","Dixon County",5,67,83,46,37
050,31,051,"Nebraska","Dixon County",5,68,78,43,35
050,31,051,"Nebraska","Dixon County",5,69,75,36,39
050,31,051,"Nebraska","Dixon County",5,70,72,39,33
050,31,051,"Nebraska","Dixon County",5,71,78,41,37
050,31,051,"Nebraska","Dixon County",5,72,68,38,30
050,31,051,"Nebraska","Dixon County",5,73,55,28,27
050,31,051,"Nebraska","Dixon County",5,74,54,31,23
050,31,051,"Nebraska","Dixon County",5,75,62,35,27
050,31,051,"Nebraska","Dixon County",5,76,63,30,33
050,31,051,"Nebraska","Dixon County",5,77,44,20,24
050,31,051,"Nebraska","Dixon County",5,78,42,20,22
050,31,051,"Nebraska","Dixon County",5,79,39,15,24
050,31,051,"Nebraska","Dixon County",5,80,34,17,17
050,31,051,"Nebraska","Dixon County",5,81,39,22,17
050,31,051,"Nebraska","Dixon County",5,82,32,17,15
050,31,051,"Nebraska","Dixon County",5,83,33,15,18
050,31,051,"Nebraska","Dixon County",5,84,24,9,15
050,31,051,"Nebraska","Dixon County",5,85,127,33,94
050,31,053,"Nebraska","Dodge County",1,0,480,249,231
050,31,053,"Nebraska","Dodge County",1,1,471,247,224
050,31,053,"Nebraska","Dodge County",1,2,491,269,222
050,31,053,"Nebraska","Dodge County",1,3,497,238,259
050,31,053,"Nebraska","Dodge County",1,4,546,264,282
050,31,053,"Nebraska","Dodge County",1,5,544,277,267
050,31,053,"Nebraska","Dodge County",1,6,523,274,249
050,31,053,"Nebraska","Dodge County",1,7,487,247,240
050,31,053,"Nebraska","Dodge County",1,8,511,252,259
050,31,053,"Nebraska","Dodge County",1,9,520,273,247
050,31,053,"Nebraska","Dodge County",1,10,508,277,231
050,31,053,"Nebraska","Dodge County",1,11,547,291,256
050,31,053,"Nebraska","Dodge County",1,12,558,283,275
050,31,053,"Nebraska","Dodge County",1,13,529,254,275
050,31,053,"Nebraska","Dodge County",1,14,524,248,276
050,31,053,"Nebraska","Dodge County",1,15,546,285,261
050,31,053,"Nebraska","Dodge County",1,16,535,287,248
050,31,053,"Nebraska","Dodge County",1,17,529,281,248
050,31,053,"Nebraska","Dodge County",1,18,512,280,232
050,31,053,"Nebraska","Dodge County",1,19,497,263,234
050,31,053,"Nebraska","Dodge County",1,20,462,255,207
050,31,053,"Nebraska","Dodge County",1,21,471,243,228
050,31,053,"Nebraska","Dodge County",1,22,474,239,235
050,31,053,"Nebraska","Dodge County",1,23,436,238,198
050,31,053,"Nebraska","Dodge County",1,24,440,226,214
050,31,053,"Nebraska","Dodge County",1,25,429,220,209
050,31,053,"Nebraska","Dodge County",1,26,419,214,205
050,31,053,"Nebraska","Dodge County",1,27,404,202,202
050,31,053,"Nebraska","Dodge County",1,28,434,224,210
050,31,053,"Nebraska","Dodge County",1,29,411,211,200
050,31,053,"Nebraska","Dodge County",1,30,397,211,186
050,31,053,"Nebraska","Dodge County",1,31,409,219,190
050,31,053,"Nebraska","Dodge County",1,32,423,226,197
050,31,053,"Nebraska","Dodge County",1,33,425,225,200
050,31,053,"Nebraska","Dodge County",1,34,413,202,211
050,31,053,"Nebraska","Dodge County",1,35,402,204,198
050,31,053,"Nebraska","Dodge County",1,36,430,220,210
050,31,053,"Nebraska","Dodge County",1,37,458,242,216
050,31,053,"Nebraska","Dodge County",1,38,473,247,226
050,31,053,"Nebraska","Dodge County",1,39,491,264,227
050,31,053,"Nebraska","Dodge County",1,40,448,235,213
050,31,053,"Nebraska","Dodge County",1,41,437,216,221
050,31,053,"Nebraska","Dodge County",1,42,419,220,199
050,31,053,"Nebraska","Dodge County",1,43,398,217,181
050,31,053,"Nebraska","Dodge County",1,44,393,209,184
050,31,053,"Nebraska","Dodge County",1,45,404,214,190
050,31,053,"Nebraska","Dodge County",1,46,368,189,179
050,31,053,"Nebraska","Dodge County",1,47,393,198,195
050,31,053,"Nebraska","Dodge County",1,48,398,188,210
050,31,053,"Nebraska","Dodge County",1,49,436,239,197
050,31,053,"Nebraska","Dodge County",1,50,434,246,188
050,31,053,"Nebraska","Dodge County",1,51,419,222,197
050,31,053,"Nebraska","Dodge County",1,52,414,205,209
050,31,053,"Nebraska","Dodge County",1,53,441,213,228
050,31,053,"Nebraska","Dodge County",1,54,457,222,235
050,31,053,"Nebraska","Dodge County",1,55,463,229,234
050,31,053,"Nebraska","Dodge County",1,56,505,261,244
050,31,053,"Nebraska","Dodge County",1,57,524,267,257
050,31,053,"Nebraska","Dodge County",1,58,537,263,274
050,31,053,"Nebraska","Dodge County",1,59,522,248,274
050,31,053,"Nebraska","Dodge County",1,60,483,233,250
050,31,053,"Nebraska","Dodge County",1,61,499,247,252
050,31,053,"Nebraska","Dodge County",1,62,493,252,241
050,31,053,"Nebraska","Dodge County",1,63,474,248,226
050,31,053,"Nebraska","Dodge County",1,64,471,231,240
050,31,053,"Nebraska","Dodge County",1,65,433,200,233
050,31,053,"Nebraska","Dodge County",1,66,418,200,218
050,31,053,"Nebraska","Dodge County",1,67,440,203,237
050,31,053,"Nebraska","Dodge County",1,68,423,223,200
050,31,053,"Nebraska","Dodge County",1,69,367,191,176
050,31,053,"Nebraska","Dodge County",1,70,365,173,192
050,31,053,"Nebraska","Dodge County",1,71,348,159,189
050,31,053,"Nebraska","Dodge County",1,72,345,160,185
050,31,053,"Nebraska","Dodge County",1,73,359,166,193
050,31,053,"Nebraska","Dodge County",1,74,282,132,150
050,31,053,"Nebraska","Dodge County",1,75,267,128,139
050,31,053,"Nebraska","Dodge County",1,76,254,121,133
050,31,053,"Nebraska","Dodge County",1,77,255,120,135
050,31,053,"Nebraska","Dodge County",1,78,233,101,132
050,31,053,"Nebraska","Dodge County",1,79,218,101,117
050,31,053,"Nebraska","Dodge County",1,80,188,83,105
050,31,053,"Nebraska","Dodge County",1,81,195,84,111
050,31,053,"Nebraska","Dodge County",1,82,185,72,113
050,31,053,"Nebraska","Dodge County",1,83,169,72,97
050,31,053,"Nebraska","Dodge County",1,84,134,49,85
050,31,053,"Nebraska","Dodge County",1,85,1007,369,638
050,31,053,"Nebraska","Dodge County",2,0,468,237,231
050,31,053,"Nebraska","Dodge County",2,1,470,244,226
050,31,053,"Nebraska","Dodge County",2,2,486,263,223
050,31,053,"Nebraska","Dodge County",2,3,491,244,247
050,31,053,"Nebraska","Dodge County",2,4,536,259,277
050,31,053,"Nebraska","Dodge County",2,5,546,276,270
050,31,053,"Nebraska","Dodge County",2,6,532,278,254
050,31,053,"Nebraska","Dodge County",2,7,498,253,245
050,31,053,"Nebraska","Dodge County",2,8,504,249,255
050,31,053,"Nebraska","Dodge County",2,9,516,268,248
050,31,053,"Nebraska","Dodge County",2,10,511,274,237
050,31,053,"Nebraska","Dodge County",2,11,539,289,250
050,31,053,"Nebraska","Dodge County",2,12,560,286,274
050,31,053,"Nebraska","Dodge County",2,13,537,261,276
050,31,053,"Nebraska","Dodge County",2,14,526,250,276
050,31,053,"Nebraska","Dodge County",2,15,543,278,265
050,31,053,"Nebraska","Dodge County",2,16,537,288,249
050,31,053,"Nebraska","Dodge County",2,17,533,284,249
050,31,053,"Nebraska","Dodge County",2,18,507,276,231
050,31,053,"Nebraska","Dodge County",2,19,499,265,234
050,31,053,"Nebraska","Dodge County",2,20,475,261,214
050,31,053,"Nebraska","Dodge County",2,21,464,241,223
050,31,053,"Nebraska","Dodge County",2,22,471,237,234
050,31,053,"Nebraska","Dodge County",2,23,440,240,200
050,31,053,"Nebraska","Dodge County",2,24,433,225,208
050,31,053,"Nebraska","Dodge County",2,25,431,222,209
050,31,053,"Nebraska","Dodge County",2,26,418,213,205
050,31,053,"Nebraska","Dodge County",2,27,403,202,201
050,31,053,"Nebraska","Dodge County",2,28,430,221,209
050,31,053,"Nebraska","Dodge County",2,29,414,215,199
050,31,053,"Nebraska","Dodge County",2,30,402,212,190
050,31,053,"Nebraska","Dodge County",2,31,406,216,190
050,31,053,"Nebraska","Dodge County",2,32,422,224,198
050,31,053,"Nebraska","Dodge County",2,33,422,224,198
050,31,053,"Nebraska","Dodge County",2,34,417,210,207
050,31,053,"Nebraska","Dodge County",2,35,406,205,201
050,31,053,"Nebraska","Dodge County",2,36,421,216,205
050,31,053,"Nebraska","Dodge County",2,37,451,237,214
050,31,053,"Nebraska","Dodge County",2,38,470,245,225
050,31,053,"Nebraska","Dodge County",2,39,484,257,227
050,31,053,"Nebraska","Dodge County",2,40,460,243,217
050,31,053,"Nebraska","Dodge County",2,41,439,220,219
050,31,053,"Nebraska","Dodge County",2,42,420,217,203
050,31,053,"Nebraska","Dodge County",2,43,404,219,185
050,31,053,"Nebraska","Dodge County",2,44,392,211,181
050,31,053,"Nebraska","Dodge County",2,45,406,215,191
050,31,053,"Nebraska","Dodge County",2,46,375,194,181
050,31,053,"Nebraska","Dodge County",2,47,382,191,191
050,31,053,"Nebraska","Dodge County",2,48,393,190,203
050,31,053,"Nebraska","Dodge County",2,49,425,226,199
050,31,053,"Nebraska","Dodge County",2,50,434,242,192
050,31,053,"Nebraska","Dodge County",2,51,420,225,195
050,31,053,"Nebraska","Dodge County",2,52,412,207,205
050,31,053,"Nebraska","Dodge County",2,53,434,212,222
050,31,053,"Nebraska","Dodge County",2,54,451,219,232
050,31,053,"Nebraska","Dodge County",2,55,462,229,233
050,31,053,"Nebraska","Dodge County",2,56,495,254,241
050,31,053,"Nebraska","Dodge County",2,57,517,265,252
050,31,053,"Nebraska","Dodge County",2,58,533,264,269
050,31,053,"Nebraska","Dodge County",2,59,529,253,276
050,31,053,"Nebraska","Dodge County",2,60,489,234,255
050,31,053,"Nebraska","Dodge County",2,61,489,240,249
050,31,053,"Nebraska","Dodge County",2,62,496,253,243
050,31,053,"Nebraska","Dodge County",2,63,478,248,230
050,31,053,"Nebraska","Dodge County",2,64,464,230,234
050,31,053,"Nebraska","Dodge County",2,65,442,208,234
050,31,053,"Nebraska","Dodge County",2,66,420,200,220
050,31,053,"Nebraska","Dodge County",2,67,432,201,231
050,31,053,"Nebraska","Dodge County",2,68,421,215,206
050,31,053,"Nebraska","Dodge County",2,69,381,198,183
050,31,053,"Nebraska","Dodge County",2,70,365,178,187
050,31,053,"Nebraska","Dodge County",2,71,351,162,189
050,31,053,"Nebraska","Dodge County",2,72,337,154,183
050,31,053,"Nebraska","Dodge County",2,73,369,171,198
050,31,053,"Nebraska","Dodge County",2,74,281,132,149
050,31,053,"Nebraska","Dodge County",2,75,270,129,141
050,31,053,"Nebraska","Dodge County",2,76,257,122,135
050,31,053,"Nebraska","Dodge County",2,77,261,123,138
050,31,053,"Nebraska","Dodge County",2,78,232,105,127
050,31,053,"Nebraska","Dodge County",2,79,216,99,117
050,31,053,"Nebraska","Dodge County",2,80,192,86,106
050,31,053,"Nebraska","Dodge County",2,81,192,83,109
050,31,053,"Nebraska","Dodge County",2,82,182,73,109
050,31,053,"Nebraska","Dodge County",2,83,168,71,97
050,31,053,"Nebraska","Dodge County",2,84,137,53,84
050,31,053,"Nebraska","Dodge County",2,85,992,359,633
050,31,053,"Nebraska","Dodge County",3,0,467,226,241
050,31,053,"Nebraska","Dodge County",3,1,474,236,238
050,31,053,"Nebraska","Dodge County",3,2,486,252,234
050,31,053,"Nebraska","Dodge County",3,3,491,269,222
050,31,053,"Nebraska","Dodge County",3,4,508,257,251
050,31,053,"Nebraska","Dodge County",3,5,543,266,277
050,31,053,"Nebraska","Dodge County",3,6,548,277,271
050,31,053,"Nebraska","Dodge County",3,7,536,287,249
050,31,053,"Nebraska","Dodge County",3,8,509,259,250
050,31,053,"Nebraska","Dodge County",3,9,506,249,257
050,31,053,"Nebraska","Dodge County",3,10,518,268,250
050,31,053,"Nebraska","Dodge County",3,11,510,269,241
050,31,053,"Nebraska","Dodge County",3,12,545,292,253
050,31,053,"Nebraska","Dodge County",3,13,557,283,274
050,31,053,"Nebraska","Dodge County",3,14,549,273,276
050,31,053,"Nebraska","Dodge County",3,15,535,262,273
050,31,053,"Nebraska","Dodge County",3,16,553,285,268
050,31,053,"Nebraska","Dodge County",3,17,532,283,249
050,31,053,"Nebraska","Dodge County",3,18,513,272,241
050,31,053,"Nebraska","Dodge County",3,19,504,271,233
050,31,053,"Nebraska","Dodge County",3,20,511,280,231
050,31,053,"Nebraska","Dodge County",3,21,477,248,229
050,31,053,"Nebraska","Dodge County",3,22,468,228,240
050,31,053,"Nebraska","Dodge County",3,23,446,243,203
050,31,053,"Nebraska","Dodge County",3,24,426,221,205
050,31,053,"Nebraska","Dodge County",3,25,426,230,196
050,31,053,"Nebraska","Dodge County",3,26,425,219,206
050,31,053,"Nebraska","Dodge County",3,27,412,215,197
050,31,053,"Nebraska","Dodge County",3,28,426,210,216
050,31,053,"Nebraska","Dodge County",3,29,423,215,208
050,31,053,"Nebraska","Dodge County",3,30,402,207,195
050,31,053,"Nebraska","Dodge County",3,31,400,207,193
050,31,053,"Nebraska","Dodge County",3,32,422,223,199
050,31,053,"Nebraska","Dodge County",3,33,410,216,194
050,31,053,"Nebraska","Dodge County",3,34,426,228,198
050,31,053,"Nebraska","Dodge County",3,35,425,214,211
050,31,053,"Nebraska","Dodge County",3,36,413,210,203
050,31,053,"Nebraska","Dodge County",3,37,416,215,201
050,31,053,"Nebraska","Dodge County",3,38,454,233,221
050,31,053,"Nebraska","Dodge County",3,39,484,253,231
050,31,053,"Nebraska","Dodge County",3,40,498,266,232
050,31,053,"Nebraska","Dodge County",3,41,461,242,219
050,31,053,"Nebraska","Dodge County",3,42,441,225,216
050,31,053,"Nebraska","Dodge County",3,43,415,216,199
050,31,053,"Nebraska","Dodge County",3,44,413,221,192
050,31,053,"Nebraska","Dodge County",3,45,408,221,187
050,31,053,"Nebraska","Dodge County",3,46,397,207,190
050,31,053,"Nebraska","Dodge County",3,47,363,185,178
050,31,053,"Nebraska","Dodge County",3,48,368,180,188
050,31,053,"Nebraska","Dodge County",3,49,404,194,210
050,31,053,"Nebraska","Dodge County",3,50,425,232,193
050,31,053,"Nebraska","Dodge County",3,51,428,238,190
050,31,053,"Nebraska","Dodge County",3,52,425,226,199
050,31,053,"Nebraska","Dodge County",3,53,402,200,202
050,31,053,"Nebraska","Dodge County",3,54,432,211,221
050,31,053,"Nebraska","Dodge County",3,55,445,213,232
050,31,053,"Nebraska","Dodge County",3,56,455,228,227
050,31,053,"Nebraska","Dodge County",3,57,480,249,231
050,31,053,"Nebraska","Dodge County",3,58,520,267,253
050,31,053,"Nebraska","Dodge County",3,59,518,256,262
050,31,053,"Nebraska","Dodge County",3,60,508,242,266
050,31,053,"Nebraska","Dodge County",3,61,483,232,251
050,31,053,"Nebraska","Dodge County",3,62,492,245,247
050,31,053,"Nebraska","Dodge County",3,63,501,256,245
050,31,053,"Nebraska","Dodge County",3,64,473,248,225
050,31,053,"Nebraska","Dodge County",3,65,456,223,233
050,31,053,"Nebraska","Dodge County",3,66,432,203,229
050,31,053,"Nebraska","Dodge County",3,67,412,197,215
050,31,053,"Nebraska","Dodge County",3,68,426,194,232
050,31,053,"Nebraska","Dodge County",3,69,414,205,209
050,31,053,"Nebraska","Dodge County",3,70,380,198,182
050,31,053,"Nebraska","Dodge County",3,71,362,178,184
050,31,053,"Nebraska","Dodge County",3,72,339,154,185
050,31,053,"Nebraska","Dodge County",3,73,321,145,176
050,31,053,"Nebraska","Dodge County",3,74,356,160,196
050,31,053,"Nebraska","Dodge County",3,75,267,124,143
050,31,053,"Nebraska","Dodge County",3,76,262,125,137
050,31,053,"Nebraska","Dodge County",3,77,244,116,128
050,31,053,"Nebraska","Dodge County",3,78,244,115,129
050,31,053,"Nebraska","Dodge County",3,79,215,96,119
050,31,053,"Nebraska","Dodge County",3,80,196,97,99
050,31,053,"Nebraska","Dodge County",3,81,177,76,101
050,31,053,"Nebraska","Dodge County",3,82,178,79,99
050,31,053,"Nebraska","Dodge County",3,83,161,65,96
050,31,053,"Nebraska","Dodge County",3,84,148,57,91
050,31,053,"Nebraska","Dodge County",3,85,907,330,577
050,31,053,"Nebraska","Dodge County",4,0,482,218,264
050,31,053,"Nebraska","Dodge County",4,1,469,214,255
050,31,053,"Nebraska","Dodge County",4,2,467,230,237
050,31,053,"Nebraska","Dodge County",4,3,502,267,235
050,31,053,"Nebraska","Dodge County",4,4,484,259,225
050,31,053,"Nebraska","Dodge County",4,5,492,241,251
050,31,053,"Nebraska","Dodge County",4,6,542,265,277
050,31,053,"Nebraska","Dodge County",4,7,556,281,275
050,31,053,"Nebraska","Dodge County",4,8,551,298,253
050,31,053,"Nebraska","Dodge County",4,9,511,254,257
050,31,053,"Nebraska","Dodge County",4,10,507,249,258
050,31,053,"Nebraska","Dodge County",4,11,533,275,258
050,31,053,"Nebraska","Dodge County",4,12,507,270,237
050,31,053,"Nebraska","Dodge County",4,13,555,293,262
050,31,053,"Nebraska","Dodge County",4,14,558,283,275
050,31,053,"Nebraska","Dodge County",4,15,541,268,273
050,31,053,"Nebraska","Dodge County",4,16,515,245,270
050,31,053,"Nebraska","Dodge County",4,17,545,276,269
050,31,053,"Nebraska","Dodge County",4,18,517,283,234
050,31,053,"Nebraska","Dodge County",4,19,502,262,240
050,31,053,"Nebraska","Dodge County",4,20,512,281,231
050,31,053,"Nebraska","Dodge County",4,21,504,269,235
050,31,053,"Nebraska","Dodge County",4,22,461,225,236
050,31,053,"Nebraska","Dodge County",4,23,419,221,198
050,31,053,"Nebraska","Dodge County",4,24,410,210,200
050,31,053,"Nebraska","Dodge County",4,25,418,216,202
050,31,053,"Nebraska","Dodge County",4,26,429,236,193
050,31,053,"Nebraska","Dodge County",4,27,429,219,210
050,31,053,"Nebraska","Dodge County",4,28,405,208,197
050,31,053,"Nebraska","Dodge County",4,29,404,198,206
050,31,053,"Nebraska","Dodge County",4,30,412,201,211
050,31,053,"Nebraska","Dodge County",4,31,418,210,208
050,31,053,"Nebraska","Dodge County",4,32,405,216,189
050,31,053,"Nebraska","Dodge County",4,33,422,217,205
050,31,053,"Nebraska","Dodge County",4,34,415,223,192
050,31,053,"Nebraska","Dodge County",4,35,421,228,193
050,31,053,"Nebraska","Dodge County",4,36,438,225,213
050,31,053,"Nebraska","Dodge County",4,37,402,215,187
050,31,053,"Nebraska","Dodge County",4,38,421,215,206
050,31,053,"Nebraska","Dodge County",4,39,460,229,231
050,31,053,"Nebraska","Dodge County",4,40,485,259,226
050,31,053,"Nebraska","Dodge County",4,41,504,275,229
050,31,053,"Nebraska","Dodge County",4,42,467,243,224
050,31,053,"Nebraska","Dodge County",4,43,436,225,211
050,31,053,"Nebraska","Dodge County",4,44,416,215,201
050,31,053,"Nebraska","Dodge County",4,45,415,223,192
050,31,053,"Nebraska","Dodge County",4,46,402,217,185
050,31,053,"Nebraska","Dodge County",4,47,397,206,191
050,31,053,"Nebraska","Dodge County",4,48,352,180,172
050,31,053,"Nebraska","Dodge County",4,49,366,182,184
050,31,053,"Nebraska","Dodge County",4,50,393,185,208
050,31,053,"Nebraska","Dodge County",4,51,423,231,192
050,31,053,"Nebraska","Dodge County",4,52,425,233,192
050,31,053,"Nebraska","Dodge County",4,53,433,231,202
050,31,053,"Nebraska","Dodge County",4,54,413,204,209
050,31,053,"Nebraska","Dodge County",4,55,414,204,210
050,31,053,"Nebraska","Dodge County",4,56,457,222,235
050,31,053,"Nebraska","Dodge County",4,57,454,224,230
050,31,053,"Nebraska","Dodge County",4,58,475,249,226
050,31,053,"Nebraska","Dodge County",4,59,522,269,253
050,31,053,"Nebraska","Dodge County",4,60,508,251,257
050,31,053,"Nebraska","Dodge County",4,61,508,238,270
050,31,053,"Nebraska","Dodge County",4,62,475,226,249
050,31,053,"Nebraska","Dodge County",4,63,479,237,242
050,31,053,"Nebraska","Dodge County",4,64,502,260,242
050,31,053,"Nebraska","Dodge County",4,65,458,238,220
050,31,053,"Nebraska","Dodge County",4,66,466,226,240
050,31,053,"Nebraska","Dodge County",4,67,422,197,225
050,31,053,"Nebraska","Dodge County",4,68,398,189,209
050,31,053,"Nebraska","Dodge County",4,69,416,186,230
050,31,053,"Nebraska","Dodge County",4,70,407,202,205
050,31,053,"Nebraska","Dodge County",4,71,385,200,185
050,31,053,"Nebraska","Dodge County",4,72,343,169,174
050,31,053,"Nebraska","Dodge County",4,73,330,145,185
050,31,053,"Nebraska","Dodge County",4,74,312,135,177
050,31,053,"Nebraska","Dodge County",4,75,353,160,193
050,31,053,"Nebraska","Dodge County",4,76,260,119,141
050,31,053,"Nebraska","Dodge County",4,77,250,118,132
050,31,053,"Nebraska","Dodge County",4,78,236,114,122
050,31,053,"Nebraska","Dodge County",4,79,230,106,124
050,31,053,"Nebraska","Dodge County",4,80,193,88,105
050,31,053,"Nebraska","Dodge County",4,81,186,87,99
050,31,053,"Nebraska","Dodge County",4,82,166,72,94
050,31,053,"Nebraska","Dodge County",4,83,164,74,90
050,31,053,"Nebraska","Dodge County",4,84,138,51,87
050,31,053,"Nebraska","Dodge County",4,85,870,327,543
050,31,053,"Nebraska","Dodge County",5,0,482,215,267
050,31,053,"Nebraska","Dodge County",5,1,493,220,273
050,31,053,"Nebraska","Dodge County",5,2,491,228,263
050,31,053,"Nebraska","Dodge County",5,3,474,236,238
050,31,053,"Nebraska","Dodge County",5,4,517,277,240
050,31,053,"Nebraska","Dodge County",5,5,483,249,234
050,31,053,"Nebraska","Dodge County",5,6,503,254,249
050,31,053,"Nebraska","Dodge County",5,7,526,253,273
050,31,053,"Nebraska","Dodge County",5,8,558,280,278
050,31,053,"Nebraska","Dodge County",5,9,550,290,260
050,31,053,"Nebraska","Dodge County",5,10,505,253,252
050,31,053,"Nebraska","Dodge County",5,11,506,251,255
050,31,053,"Nebraska","Dodge County",5,12,511,264,247
050,31,053,"Nebraska","Dodge County",5,13,514,268,246
050,31,053,"Nebraska","Dodge County",5,14,550,286,264
050,31,053,"Nebraska","Dodge County",5,15,549,278,271
050,31,053,"Nebraska","Dodge County",5,16,554,269,285
050,31,053,"Nebraska","Dodge County",5,17,530,257,273
050,31,053,"Nebraska","Dodge County",5,18,511,266,245
050,31,053,"Nebraska","Dodge County",5,19,496,267,229
050,31,053,"Nebraska","Dodge County",5,20,518,281,237
050,31,053,"Nebraska","Dodge County",5,21,547,285,262
050,31,053,"Nebraska","Dodge County",5,22,514,257,257
050,31,053,"Nebraska","Dodge County",5,23,441,223,218
050,31,053,"Nebraska","Dodge County",5,24,429,228,201
050,31,053,"Nebraska","Dodge County",5,25,445,229,216
050,31,053,"Nebraska","Dodge County",5,26,422,220,202
050,31,053,"Nebraska","Dodge County",5,27,432,243,189
050,31,053,"Nebraska","Dodge County",5,28,440,223,217
050,31,053,"Nebraska","Dodge County",5,29,388,204,184
050,31,053,"Nebraska","Dodge County",5,30,402,200,202
050,31,053,"Nebraska","Dodge County",5,31,410,198,212
050,31,053,"Nebraska","Dodge County",5,32,415,211,204
050,31,053,"Nebraska","Dodge County",5,33,416,217,199
050,31,053,"Nebraska","Dodge County",5,34,417,221,196
050,31,053,"Nebraska","Dodge County",5,35,414,219,195
050,31,053,"Nebraska","Dodge County",5,36,414,222,192
050,31,053,"Nebraska","Dodge County",5,37,437,225,212
050,31,053,"Nebraska","Dodge County",5,38,392,203,189
050,31,053,"Nebraska","Dodge County",5,39,418,216,202
050,31,053,"Nebraska","Dodge County",5,40,464,231,233
050,31,053,"Nebraska","Dodge County",5,41,485,269,216
050,31,053,"Nebraska","Dodge County",5,42,504,276,228
050,31,053,"Nebraska","Dodge County",5,43,462,240,222
050,31,053,"Nebraska","Dodge County",5,44,428,214,214
050,31,053,"Nebraska","Dodge County",5,45,414,218,196
050,31,053,"Nebraska","Dodge County",5,46,424,229,195
050,31,053,"Nebraska","Dodge County",5,47,402,211,191
050,31,053,"Nebraska","Dodge County",5,48,384,201,183
050,31,053,"Nebraska","Dodge County",5,49,345,173,172
050,31,053,"Nebraska","Dodge County",5,50,366,190,176
050,31,053,"Nebraska","Dodge County",5,51,397,182,215
050,31,053,"Nebraska","Dodge County",5,52,427,232,195
050,31,053,"Nebraska","Dodge County",5,53,437,235,202
050,31,053,"Nebraska","Dodge County",5,54,431,226,205
050,31,053,"Nebraska","Dodge County",5,55,409,197,212
050,31,053,"Nebraska","Dodge County",5,56,421,212,209
050,31,053,"Nebraska","Dodge County",5,57,453,222,231
050,31,053,"Nebraska","Dodge County",5,58,454,227,227
050,31,053,"Nebraska","Dodge County",5,59,482,250,232
050,31,053,"Nebraska","Dodge County",5,60,516,270,246
050,31,053,"Nebraska","Dodge County",5,61,510,247,263
050,31,053,"Nebraska","Dodge County",5,62,493,236,257
050,31,053,"Nebraska","Dodge County",5,63,474,225,249
050,31,053,"Nebraska","Dodge County",5,64,484,240,244
050,31,053,"Nebraska","Dodge County",5,65,499,253,246
050,31,053,"Nebraska","Dodge County",5,66,455,236,219
050,31,053,"Nebraska","Dodge County",5,67,463,226,237
050,31,053,"Nebraska","Dodge County",5,68,406,190,216
050,31,053,"Nebraska","Dodge County",5,69,394,184,210
050,31,053,"Nebraska","Dodge County",5,70,411,184,227
050,31,053,"Nebraska","Dodge County",5,71,404,202,202
050,31,053,"Nebraska","Dodge County",5,72,377,195,182
050,31,053,"Nebraska","Dodge County",5,73,334,162,172
050,31,053,"Nebraska","Dodge County",5,74,326,143,183
050,31,053,"Nebraska","Dodge County",5,75,299,131,168
050,31,053,"Nebraska","Dodge County",5,76,342,152,190
050,31,053,"Nebraska","Dodge County",5,77,250,114,136
050,31,053,"Nebraska","Dodge County",5,78,240,113,127
050,31,053,"Nebraska","Dodge County",5,79,223,106,117
050,31,053,"Nebraska","Dodge County",5,80,204,92,112
050,31,053,"Nebraska","Dodge County",5,81,184,80,104
050,31,053,"Nebraska","Dodge County",5,82,175,84,91
050,31,053,"Nebraska","Dodge County",5,83,147,64,83
050,31,053,"Nebraska","Dodge County",5,84,148,64,84
050,31,053,"Nebraska","Dodge County",5,85,826,318,508
050,31,055,"Nebraska","Douglas County",1,0,8310,4267,4043
050,31,055,"Nebraska","Douglas County",1,1,8353,4323,4030
050,31,055,"Nebraska","Douglas County",1,2,8356,4218,4138
050,31,055,"Nebraska","Douglas County",1,3,8594,4375,4219
050,31,055,"Nebraska","Douglas County",1,4,8748,4524,4224
050,31,055,"Nebraska","Douglas County",1,5,8792,4529,4263
050,31,055,"Nebraska","Douglas County",1,6,8479,4312,4167
050,31,055,"Nebraska","Douglas County",1,7,8435,4347,4088
050,31,055,"Nebraska","Douglas County",1,8,8257,4175,4082
050,31,055,"Nebraska","Douglas County",1,9,8084,4121,3963
050,31,055,"Nebraska","Douglas County",1,10,8288,4243,4045
050,31,055,"Nebraska","Douglas County",1,11,8445,4320,4125
050,31,055,"Nebraska","Douglas County",1,12,8578,4423,4155
050,31,055,"Nebraska","Douglas County",1,13,8455,4327,4128
050,31,055,"Nebraska","Douglas County",1,14,8322,4187,4135
050,31,055,"Nebraska","Douglas County",1,15,8227,4170,4057
050,31,055,"Nebraska","Douglas County",1,16,8164,4215,3949
050,31,055,"Nebraska","Douglas County",1,17,7999,4091,3908
050,31,055,"Nebraska","Douglas County",1,18,7495,3811,3684
050,31,055,"Nebraska","Douglas County",1,19,7356,3676,3680
050,31,055,"Nebraska","Douglas County",1,20,7082,3549,3533
050,31,055,"Nebraska","Douglas County",1,21,6908,3443,3465
050,31,055,"Nebraska","Douglas County",1,22,7050,3493,3557
050,31,055,"Nebraska","Douglas County",1,23,7705,3810,3895
050,31,055,"Nebraska","Douglas County",1,24,8186,4086,4100
050,31,055,"Nebraska","Douglas County",1,25,8580,4291,4289
050,31,055,"Nebraska","Douglas County",1,26,8724,4299,4425
050,31,055,"Nebraska","Douglas County",1,27,8929,4481,4448
050,31,055,"Nebraska","Douglas County",1,28,9036,4517,4519
050,31,055,"Nebraska","Douglas County",1,29,8765,4396,4369
050,31,055,"Nebraska","Douglas County",1,30,8596,4358,4238
050,31,055,"Nebraska","Douglas County",1,31,8687,4417,4270
050,31,055,"Nebraska","Douglas County",1,32,8937,4531,4406
050,31,055,"Nebraska","Douglas County",1,33,8887,4443,4444
050,31,055,"Nebraska","Douglas County",1,34,8929,4485,4444
050,31,055,"Nebraska","Douglas County",1,35,8888,4537,4351
050,31,055,"Nebraska","Douglas County",1,36,8790,4485,4305
050,31,055,"Nebraska","Douglas County",1,37,8947,4521,4426
050,31,055,"Nebraska","Douglas County",1,38,8758,4448,4310
050,31,055,"Nebraska","Douglas County",1,39,8662,4472,4190
050,31,055,"Nebraska","Douglas County",1,40,8414,4327,4087
050,31,055,"Nebraska","Douglas County",1,41,7567,3813,3754
050,31,055,"Nebraska","Douglas County",1,42,7378,3702,3676
050,31,055,"Nebraska","Douglas County",1,43,6988,3538,3450
050,31,055,"Nebraska","Douglas County",1,44,6861,3466,3395
050,31,055,"Nebraska","Douglas County",1,45,6879,3482,3397
050,31,055,"Nebraska","Douglas County",1,46,6570,3349,3221
050,31,055,"Nebraska","Douglas County",1,47,6507,3241,3266
050,31,055,"Nebraska","Douglas County",1,48,6891,3474,3417
050,31,055,"Nebraska","Douglas County",1,49,7281,3743,3538
050,31,055,"Nebraska","Douglas County",1,50,6944,3565,3379
050,31,055,"Nebraska","Douglas County",1,51,6655,3420,3235
050,31,055,"Nebraska","Douglas County",1,52,6375,3258,3117
050,31,055,"Nebraska","Douglas County",1,53,6374,3218,3156
050,31,055,"Nebraska","Douglas County",1,54,6628,3315,3313
050,31,055,"Nebraska","Douglas County",1,55,7003,3526,3477
050,31,055,"Nebraska","Douglas County",1,56,6962,3502,3460
050,31,055,"Nebraska","Douglas County",1,57,6980,3516,3464
050,31,055,"Nebraska","Douglas County",1,58,7136,3547,3589
050,31,055,"Nebraska","Douglas County",1,59,7053,3451,3602
050,31,055,"Nebraska","Douglas County",1,60,6930,3381,3549
050,31,055,"Nebraska","Douglas County",1,61,6782,3315,3467
050,31,055,"Nebraska","Douglas County",1,62,6643,3197,3446
050,31,055,"Nebraska","Douglas County",1,63,6360,3052,3308
050,31,055,"Nebraska","Douglas County",1,64,6103,2897,3206
050,31,055,"Nebraska","Douglas County",1,65,5934,2788,3146
050,31,055,"Nebraska","Douglas County",1,66,5776,2706,3070
050,31,055,"Nebraska","Douglas County",1,67,5452,2571,2881
050,31,055,"Nebraska","Douglas County",1,68,5345,2494,2851
050,31,055,"Nebraska","Douglas County",1,69,4947,2269,2678
050,31,055,"Nebraska","Douglas County",1,70,4796,2252,2544
050,31,055,"Nebraska","Douglas County",1,71,4544,2114,2430
050,31,055,"Nebraska","Douglas County",1,72,4338,2005,2333
050,31,055,"Nebraska","Douglas County",1,73,4272,1983,2289
050,31,055,"Nebraska","Douglas County",1,74,2881,1306,1575
050,31,055,"Nebraska","Douglas County",1,75,2831,1281,1550
050,31,055,"Nebraska","Douglas County",1,76,2772,1249,1523
050,31,055,"Nebraska","Douglas County",1,77,2718,1206,1512
050,31,055,"Nebraska","Douglas County",1,78,2344,1017,1327
050,31,055,"Nebraska","Douglas County",1,79,2076,863,1213
050,31,055,"Nebraska","Douglas County",1,80,1907,815,1092
050,31,055,"Nebraska","Douglas County",1,81,1778,757,1021
050,31,055,"Nebraska","Douglas County",1,82,1601,647,954
050,31,055,"Nebraska","Douglas County",1,83,1414,586,828
050,31,055,"Nebraska","Douglas County",1,84,1358,546,812
050,31,055,"Nebraska","Douglas County",1,85,8400,2947,5453
050,31,055,"Nebraska","Douglas County",2,0,8215,4229,3986
050,31,055,"Nebraska","Douglas County",2,1,8320,4294,4026
050,31,055,"Nebraska","Douglas County",2,2,8350,4238,4112
050,31,055,"Nebraska","Douglas County",2,3,8486,4320,4166
050,31,055,"Nebraska","Douglas County",2,4,8724,4497,4227
050,31,055,"Nebraska","Douglas County",2,5,8767,4513,4254
050,31,055,"Nebraska","Douglas County",2,6,8574,4378,4196
050,31,055,"Nebraska","Douglas County",2,7,8434,4335,4099
050,31,055,"Nebraska","Douglas County",2,8,8256,4196,4060
050,31,055,"Nebraska","Douglas County",2,9,8110,4127,3983
050,31,055,"Nebraska","Douglas County",2,10,8217,4200,4017
050,31,055,"Nebraska","Douglas County",2,11,8364,4285,4079
050,31,055,"Nebraska","Douglas County",2,12,8564,4405,4159
050,31,055,"Nebraska","Douglas County",2,13,8479,4348,4131
050,31,055,"Nebraska","Douglas County",2,14,8357,4222,4135
050,31,055,"Nebraska","Douglas County",2,15,8256,4177,4079
050,31,055,"Nebraska","Douglas County",2,16,8192,4215,3977
050,31,055,"Nebraska","Douglas County",2,17,8049,4132,3917
050,31,055,"Nebraska","Douglas County",2,18,7514,3810,3704
050,31,055,"Nebraska","Douglas County",2,19,7413,3712,3701
050,31,055,"Nebraska","Douglas County",2,20,7188,3600,3588
050,31,055,"Nebraska","Douglas County",2,21,6960,3475,3485
050,31,055,"Nebraska","Douglas County",2,22,7140,3530,3610
050,31,055,"Nebraska","Douglas County",2,23,7680,3796,3884
050,31,055,"Nebraska","Douglas County",2,24,8150,4074,4076
050,31,055,"Nebraska","Douglas County",2,25,8548,4277,4271
050,31,055,"Nebraska","Douglas County",2,26,8749,4334,4415
050,31,055,"Nebraska","Douglas County",2,27,8893,4447,4446
050,31,055,"Nebraska","Douglas County",2,28,9032,4528,4504
050,31,055,"Nebraska","Douglas County",2,29,8827,4427,4400
050,31,055,"Nebraska","Douglas County",2,30,8666,4375,4291
050,31,055,"Nebraska","Douglas County",2,31,8632,4388,4244
050,31,055,"Nebraska","Douglas County",2,32,8837,4477,4360
050,31,055,"Nebraska","Douglas County",2,33,8872,4454,4418
050,31,055,"Nebraska","Douglas County",2,34,8892,4461,4431
050,31,055,"Nebraska","Douglas County",2,35,8935,4542,4393
050,31,055,"Nebraska","Douglas County",2,36,8757,4464,4293
050,31,055,"Nebraska","Douglas County",2,37,8934,4527,4407
050,31,055,"Nebraska","Douglas County",2,38,8819,4465,4354
050,31,055,"Nebraska","Douglas County",2,39,8660,4450,4210
050,31,055,"Nebraska","Douglas County",2,40,8519,4393,4126
050,31,055,"Nebraska","Douglas County",2,41,7750,3919,3831
050,31,055,"Nebraska","Douglas County",2,42,7384,3712,3672
050,31,055,"Nebraska","Douglas County",2,43,7126,3602,3524
050,31,055,"Nebraska","Douglas County",2,44,6820,3448,3372
050,31,055,"Nebraska","Douglas County",2,45,6893,3486,3407
050,31,055,"Nebraska","Douglas County",2,46,6614,3354,3260
050,31,055,"Nebraska","Douglas County",2,47,6507,3258,3249
050,31,055,"Nebraska","Douglas County",2,48,6801,3420,3381
050,31,055,"Nebraska","Douglas County",2,49,7198,3682,3516
050,31,055,"Nebraska","Douglas County",2,50,7029,3614,3415
050,31,055,"Nebraska","Douglas County",2,51,6704,3447,3257
050,31,055,"Nebraska","Douglas County",2,52,6430,3295,3135
050,31,055,"Nebraska","Douglas County",2,53,6353,3214,3139
050,31,055,"Nebraska","Douglas County",2,54,6529,3279,3250
050,31,055,"Nebraska","Douglas County",2,55,6893,3460,3433
050,31,055,"Nebraska","Douglas County",2,56,6980,3516,3464
050,31,055,"Nebraska","Douglas County",2,57,6971,3513,3458
050,31,055,"Nebraska","Douglas County",2,58,7075,3529,3546
050,31,055,"Nebraska","Douglas County",2,59,7085,3483,3602
050,31,055,"Nebraska","Douglas County",2,60,6911,3378,3533
050,31,055,"Nebraska","Douglas County",2,61,6772,3303,3469
050,31,055,"Nebraska","Douglas County",2,62,6625,3193,3432
050,31,055,"Nebraska","Douglas County",2,63,6454,3098,3356
050,31,055,"Nebraska","Douglas County",2,64,6109,2911,3198
050,31,055,"Nebraska","Douglas County",2,65,5944,2800,3144
050,31,055,"Nebraska","Douglas County",2,66,5795,2710,3085
050,31,055,"Nebraska","Douglas County",2,67,5495,2581,2914
050,31,055,"Nebraska","Douglas County",2,68,5308,2487,2821
050,31,055,"Nebraska","Douglas County",2,69,5067,2331,2736
050,31,055,"Nebraska","Douglas County",2,70,4794,2236,2558
050,31,055,"Nebraska","Douglas County",2,71,4584,2134,2450
050,31,055,"Nebraska","Douglas County",2,72,4304,1993,2311
050,31,055,"Nebraska","Douglas County",2,73,4462,2062,2400
050,31,055,"Nebraska","Douglas County",2,74,3021,1379,1642
050,31,055,"Nebraska","Douglas County",2,75,2829,1279,1550
050,31,055,"Nebraska","Douglas County",2,76,2738,1234,1504
050,31,055,"Nebraska","Douglas County",2,77,2772,1238,1534
050,31,055,"Nebraska","Douglas County",2,78,2364,1026,1338
050,31,055,"Nebraska","Douglas County",2,79,2097,880,1217
050,31,055,"Nebraska","Douglas County",2,80,1929,814,1115
050,31,055,"Nebraska","Douglas County",2,81,1775,759,1016
050,31,055,"Nebraska","Douglas County",2,82,1631,662,969
050,31,055,"Nebraska","Douglas County",2,83,1427,584,843
050,31,055,"Nebraska","Douglas County",2,84,1342,549,793
050,31,055,"Nebraska","Douglas County",2,85,8409,2963,5446
050,31,055,"Nebraska","Douglas County",3,0,7783,3924,3859
050,31,055,"Nebraska","Douglas County",3,1,8070,4164,3906
050,31,055,"Nebraska","Douglas County",3,2,8230,4243,3987
050,31,055,"Nebraska","Douglas County",3,3,8193,4128,4065
050,31,055,"Nebraska","Douglas County",3,4,8391,4254,4137
050,31,055,"Nebraska","Douglas County",3,5,8641,4444,4197
050,31,055,"Nebraska","Douglas County",3,6,8709,4464,4245
050,31,055,"Nebraska","Douglas County",3,7,8444,4315,4129
050,31,055,"Nebraska","Douglas County",3,8,8338,4293,4045
050,31,055,"Nebraska","Douglas County",3,9,8167,4170,3997
050,31,055,"Nebraska","Douglas County",3,10,8058,4109,3949
050,31,055,"Nebraska","Douglas County",3,11,8188,4168,4020
050,31,055,"Nebraska","Douglas County",3,12,8333,4262,4071
050,31,055,"Nebraska","Douglas County",3,13,8541,4386,4155
050,31,055,"Nebraska","Douglas County",3,14,8427,4299,4128
050,31,055,"Nebraska","Douglas County",3,15,8337,4217,4120
050,31,055,"Nebraska","Douglas County",3,16,8279,4202,4077
050,31,055,"Nebraska","Douglas County",3,17,8182,4210,3972
050,31,055,"Nebraska","Douglas County",3,18,7625,3899,3726
050,31,055,"Nebraska","Douglas County",3,19,7211,3644,3567
050,31,055,"Nebraska","Douglas County",3,20,7173,3610,3563
050,31,055,"Nebraska","Douglas County",3,21,7190,3592,3598
050,31,055,"Nebraska","Douglas County",3,22,7258,3599,3659
050,31,055,"Nebraska","Douglas County",3,23,7743,3781,3962
050,31,055,"Nebraska","Douglas County",3,24,8113,4017,4096
050,31,055,"Nebraska","Douglas County",3,25,8414,4237,4177
050,31,055,"Nebraska","Douglas County",3,26,8656,4342,4314
050,31,055,"Nebraska","Douglas County",3,27,8860,4409,4451
050,31,055,"Nebraska","Douglas County",3,28,8842,4441,4401
050,31,055,"Nebraska","Douglas County",3,29,9020,4525,4495
050,31,055,"Nebraska","Douglas County",3,30,8824,4431,4393
050,31,055,"Nebraska","Douglas County",3,31,8573,4333,4240
050,31,055,"Nebraska","Douglas County",3,32,8444,4288,4156
050,31,055,"Nebraska","Douglas County",3,33,8721,4401,4320
050,31,055,"Nebraska","Douglas County",3,34,8753,4413,4340
050,31,055,"Nebraska","Douglas County",3,35,8788,4397,4391
050,31,055,"Nebraska","Douglas County",3,36,8810,4507,4303
050,31,055,"Nebraska","Douglas County",3,37,8625,4395,4230
050,31,055,"Nebraska","Douglas County",3,38,8839,4466,4373
050,31,055,"Nebraska","Douglas County",3,39,8699,4380,4319
050,31,055,"Nebraska","Douglas County",3,40,8561,4406,4155
050,31,055,"Nebraska","Douglas County",3,41,8366,4317,4049
050,31,055,"Nebraska","Douglas County",3,42,7659,3884,3775
050,31,055,"Nebraska","Douglas County",3,43,7344,3675,3669
050,31,055,"Nebraska","Douglas County",3,44,7087,3603,3484
050,31,055,"Nebraska","Douglas County",3,45,6732,3397,3335
050,31,055,"Nebraska","Douglas County",3,46,6819,3435,3384
050,31,055,"Nebraska","Douglas County",3,47,6508,3315,3193
050,31,055,"Nebraska","Douglas County",3,48,6468,3250,3218
050,31,055,"Nebraska","Douglas County",3,49,6695,3365,3330
050,31,055,"Nebraska","Douglas County",3,50,7108,3654,3454
050,31,055,"Nebraska","Douglas County",3,51,6937,3550,3387
050,31,055,"Nebraska","Douglas County",3,52,6669,3421,3248
050,31,055,"Nebraska","Douglas County",3,53,6358,3250,3108
050,31,055,"Nebraska","Douglas County",3,54,6271,3182,3089
050,31,055,"Nebraska","Douglas County",3,55,6446,3241,3205
050,31,055,"Nebraska","Douglas County",3,56,6784,3410,3374
050,31,055,"Nebraska","Douglas County",3,57,6884,3452,3432
050,31,055,"Nebraska","Douglas County",3,58,6891,3474,3417
050,31,055,"Nebraska","Douglas County",3,59,6927,3449,3478
050,31,055,"Nebraska","Douglas County",3,60,6933,3394,3539
050,31,055,"Nebraska","Douglas County",3,61,6809,3318,3491
050,31,055,"Nebraska","Douglas County",3,62,6613,3191,3422
050,31,055,"Nebraska","Douglas County",3,63,6525,3151,3374
050,31,055,"Nebraska","Douglas County",3,64,6276,2996,3280
050,31,055,"Nebraska","Douglas County",3,65,5935,2807,3128
050,31,055,"Nebraska","Douglas County",3,66,5825,2726,3099
050,31,055,"Nebraska","Douglas County",3,67,5672,2636,3036
050,31,055,"Nebraska","Douglas County",3,68,5403,2534,2869
050,31,055,"Nebraska","Douglas County",3,69,5193,2419,2774
050,31,055,"Nebraska","Douglas County",3,70,4991,2286,2705
050,31,055,"Nebraska","Douglas County",3,71,4709,2189,2520
050,31,055,"Nebraska","Douglas County",3,72,4484,2072,2412
050,31,055,"Nebraska","Douglas County",3,73,4155,1912,2243
050,31,055,"Nebraska","Douglas County",3,74,4332,1990,2342
050,31,055,"Nebraska","Douglas County",3,75,2906,1318,1588
050,31,055,"Nebraska","Douglas County",3,76,2723,1224,1499
050,31,055,"Nebraska","Douglas County",3,77,2613,1161,1452
050,31,055,"Nebraska","Douglas County",3,78,2643,1163,1480
050,31,055,"Nebraska","Douglas County",3,79,2250,975,1275
050,31,055,"Nebraska","Douglas County",3,80,1984,834,1150
050,31,055,"Nebraska","Douglas County",3,81,1812,753,1059
050,31,055,"Nebraska","Douglas County",3,82,1679,702,977
050,31,055,"Nebraska","Douglas County",3,83,1465,593,872
050,31,055,"Nebraska","Douglas County",3,84,1311,532,779
050,31,055,"Nebraska","Douglas County",3,85,8205,2911,5294
050,31,055,"Nebraska","Douglas County",4,0,7886,3994,3892
050,31,055,"Nebraska","Douglas County",4,1,7600,3801,3799
050,31,055,"Nebraska","Douglas County",4,2,7904,4090,3814
050,31,055,"Nebraska","Douglas County",4,3,8129,4183,3946
050,31,055,"Nebraska","Douglas County",4,4,8144,4110,4034
050,31,055,"Nebraska","Douglas County",4,5,8287,4194,4093
050,31,055,"Nebraska","Douglas County",4,6,8618,4414,4204
050,31,055,"Nebraska","Douglas County",4,7,8554,4387,4167
050,31,055,"Nebraska","Douglas County",4,8,8407,4271,4136
050,31,055,"Nebraska","Douglas County",4,9,8293,4253,4040
050,31,055,"Nebraska","Douglas County",4,10,8151,4151,4000
050,31,055,"Nebraska","Douglas County",4,11,8055,4082,3973
050,31,055,"Nebraska","Douglas County",4,12,8192,4156,4036
050,31,055,"Nebraska","Douglas County",4,13,8335,4301,4034
050,31,055,"Nebraska","Douglas County",4,14,8482,4383,4099
050,31,055,"Nebraska","Douglas County",4,15,8505,4347,4158
050,31,055,"Nebraska","Douglas County",4,16,8423,4275,4148
050,31,055,"Nebraska","Douglas County",4,17,8269,4190,4079
050,31,055,"Nebraska","Douglas County",4,18,7628,3917,3711
050,31,055,"Nebraska","Douglas County",4,19,7343,3712,3631
050,31,055,"Nebraska","Douglas County",4,20,7152,3627,3525
050,31,055,"Nebraska","Douglas County",4,21,7290,3654,3636
050,31,055,"Nebraska","Douglas County",4,22,7543,3681,3862
050,31,055,"Nebraska","Douglas County",4,23,7965,3994,3971
050,31,055,"Nebraska","Douglas County",4,24,8159,4004,4155
050,31,055,"Nebraska","Douglas County",4,25,8263,4085,4178
050,31,055,"Nebraska","Douglas County",4,26,8462,4284,4178
050,31,055,"Nebraska","Douglas County",4,27,8611,4341,4270
050,31,055,"Nebraska","Douglas County",4,28,8899,4489,4410
050,31,055,"Nebraska","Douglas County",4,29,8702,4375,4327
050,31,055,"Nebraska","Douglas County",4,30,8810,4420,4390
050,31,055,"Nebraska","Douglas County",4,31,8676,4368,4308
050,31,055,"Nebraska","Douglas County",4,32,8369,4241,4128
050,31,055,"Nebraska","Douglas County",4,33,8319,4227,4092
050,31,055,"Nebraska","Douglas County",4,34,8613,4348,4265
050,31,055,"Nebraska","Douglas County",4,35,8673,4373,4300
050,31,055,"Nebraska","Douglas County",4,36,8689,4319,4370
050,31,055,"Nebraska","Douglas County",4,37,8749,4466,4283
050,31,055,"Nebraska","Douglas County",4,38,8527,4339,4188
050,31,055,"Nebraska","Douglas County",4,39,8721,4418,4303
050,31,055,"Nebraska","Douglas County",4,40,8600,4315,4285
050,31,055,"Nebraska","Douglas County",4,41,8411,4300,4111
050,31,055,"Nebraska","Douglas County",4,42,8284,4293,3991
050,31,055,"Nebraska","Douglas County",4,43,7626,3868,3758
050,31,055,"Nebraska","Douglas County",4,44,7308,3674,3634
050,31,055,"Nebraska","Douglas County",4,45,6990,3551,3439
050,31,055,"Nebraska","Douglas County",4,46,6700,3384,3316
050,31,055,"Nebraska","Douglas County",4,47,6782,3410,3372
050,31,055,"Nebraska","Douglas County",4,48,6456,3291,3165
050,31,055,"Nebraska","Douglas County",4,49,6368,3184,3184
050,31,055,"Nebraska","Douglas County",4,50,6643,3342,3301
050,31,055,"Nebraska","Douglas County",4,51,7008,3588,3420
050,31,055,"Nebraska","Douglas County",4,52,6860,3521,3339
050,31,055,"Nebraska","Douglas County",4,53,6579,3373,3206
050,31,055,"Nebraska","Douglas County",4,54,6255,3187,3068
050,31,055,"Nebraska","Douglas County",4,55,6221,3162,3059
050,31,055,"Nebraska","Douglas County",4,56,6363,3184,3179
050,31,055,"Nebraska","Douglas County",4,57,6689,3328,3361
050,31,055,"Nebraska","Douglas County",4,58,6770,3377,3393
050,31,055,"Nebraska","Douglas County",4,59,6790,3401,3389
050,31,055,"Nebraska","Douglas County",4,60,6789,3346,3443
050,31,055,"Nebraska","Douglas County",4,61,6745,3281,3464
050,31,055,"Nebraska","Douglas County",4,62,6698,3239,3459
050,31,055,"Nebraska","Douglas County",4,63,6509,3124,3385
050,31,055,"Nebraska","Douglas County",4,64,6395,3066,3329
050,31,055,"Nebraska","Douglas County",4,65,6100,2903,3197
050,31,055,"Nebraska","Douglas County",4,66,5762,2726,3036
050,31,055,"Nebraska","Douglas County",4,67,5716,2637,3079
050,31,055,"Nebraska","Douglas County",4,68,5536,2587,2949
050,31,055,"Nebraska","Douglas County",4,69,5265,2434,2831
050,31,055,"Nebraska","Douglas County",4,70,5076,2351,2725
050,31,055,"Nebraska","Douglas County",4,71,4880,2207,2673
050,31,055,"Nebraska","Douglas County",4,72,4618,2136,2482
050,31,055,"Nebraska","Douglas County",4,73,4365,2009,2356
050,31,055,"Nebraska","Douglas County",4,74,4059,1864,2195
050,31,055,"Nebraska","Douglas County",4,75,4237,1933,2304
050,31,055,"Nebraska","Douglas County",4,76,2820,1262,1558
050,31,055,"Nebraska","Douglas County",4,77,2616,1154,1462
050,31,055,"Nebraska","Douglas County",4,78,2527,1113,1414
050,31,055,"Nebraska","Douglas County",4,79,2525,1106,1419
050,31,055,"Nebraska","Douglas County",4,80,2131,923,1208
050,31,055,"Nebraska","Douglas County",4,81,1869,769,1100
050,31,055,"Nebraska","Douglas County",4,82,1721,707,1014
050,31,055,"Nebraska","Douglas County",4,83,1544,652,892
050,31,055,"Nebraska","Douglas County",4,84,1362,559,803
050,31,055,"Nebraska","Douglas County",4,85,8141,2901,5240
050,31,055,"Nebraska","Douglas County",5,0,7862,3991,3871
050,31,055,"Nebraska","Douglas County",5,1,7776,3991,3785
050,31,055,"Nebraska","Douglas County",5,2,7575,3807,3768
050,31,055,"Nebraska","Douglas County",5,3,7921,4126,3795
050,31,055,"Nebraska","Douglas County",5,4,8064,4137,3927
050,31,055,"Nebraska","Douglas County",5,5,8063,4081,3982
050,31,055,"Nebraska","Douglas County",5,6,8331,4196,4135
050,31,055,"Nebraska","Douglas County",5,7,8609,4411,4198
050,31,055,"Nebraska","Douglas County",5,8,8526,4359,4167
050,31,055,"Nebraska","Douglas County",5,9,8352,4242,4110
050,31,055,"Nebraska","Douglas County",5,10,8273,4246,4027
050,31,055,"Nebraska","Douglas County",5,11,8212,4179,4033
050,31,055,"Nebraska","Douglas County",5,12,8031,4052,3979
050,31,055,"Nebraska","Douglas County",5,13,8207,4163,4044
050,31,055,"Nebraska","Douglas County",5,14,8377,4307,4070
050,31,055,"Nebraska","Douglas County",5,15,8611,4437,4174
050,31,055,"Nebraska","Douglas County",5,16,8543,4377,4166
050,31,055,"Nebraska","Douglas County",5,17,8418,4277,4141
050,31,055,"Nebraska","Douglas County",5,18,7823,3951,3872
050,31,055,"Nebraska","Douglas County",5,19,7586,3840,3746
050,31,055,"Nebraska","Douglas County",5,20,7368,3749,3619
050,31,055,"Nebraska","Douglas County",5,21,7304,3695,3609
050,31,055,"Nebraska","Douglas County",5,22,7670,3824,3846
050,31,055,"Nebraska","Douglas County",5,23,8116,3943,4173
050,31,055,"Nebraska","Douglas County",5,24,8334,4192,4142
050,31,055,"Nebraska","Douglas County",5,25,8333,4159,4174
050,31,055,"Nebraska","Douglas County",5,26,8471,4241,4230
050,31,055,"Nebraska","Douglas County",5,27,8453,4237,4216
050,31,055,"Nebraska","Douglas County",5,28,8579,4315,4264
050,31,055,"Nebraska","Douglas County",5,29,8817,4441,4376
050,31,055,"Nebraska","Douglas County",5,30,8591,4302,4289
050,31,055,"Nebraska","Douglas County",5,31,8801,4481,4320
050,31,055,"Nebraska","Douglas County",5,32,8676,4414,4262
050,31,055,"Nebraska","Douglas County",5,33,8294,4191,4103
050,31,055,"Nebraska","Douglas County",5,34,8265,4180,4085
050,31,055,"Nebraska","Douglas County",5,35,8582,4310,4272
050,31,055,"Nebraska","Douglas County",5,36,8662,4377,4285
050,31,055,"Nebraska","Douglas County",5,37,8681,4327,4354
050,31,055,"Nebraska","Douglas County",5,38,8686,4433,4253
050,31,055,"Nebraska","Douglas County",5,39,8435,4293,4142
050,31,055,"Nebraska","Douglas County",5,40,8646,4374,4272
050,31,055,"Nebraska","Douglas County",5,41,8572,4268,4304
050,31,055,"Nebraska","Douglas County",5,42,8345,4272,4073
050,31,055,"Nebraska","Douglas County",5,43,8283,4280,4003
050,31,055,"Nebraska","Douglas County",5,44,7530,3784,3746
050,31,055,"Nebraska","Douglas County",5,45,7202,3582,3620
050,31,055,"Nebraska","Douglas County",5,46,6951,3551,3400
050,31,055,"Nebraska","Douglas County",5,47,6614,3346,3268
050,31,055,"Nebraska","Douglas County",5,48,6745,3389,3356
050,31,055,"Nebraska","Douglas County",5,49,6391,3243,3148
050,31,055,"Nebraska","Douglas County",5,50,6329,3166,3163
050,31,055,"Nebraska","Douglas County",5,51,6587,3306,3281
050,31,055,"Nebraska","Douglas County",5,52,6986,3600,3386
050,31,055,"Nebraska","Douglas County",5,53,6773,3468,3305
050,31,055,"Nebraska","Douglas County",5,54,6499,3332,3167
050,31,055,"Nebraska","Douglas County",5,55,6227,3170,3057
050,31,055,"Nebraska","Douglas County",5,56,6170,3121,3049
050,31,055,"Nebraska","Douglas County",5,57,6292,3126,3166
050,31,055,"Nebraska","Douglas County",5,58,6573,3268,3305
050,31,055,"Nebraska","Douglas County",5,59,6678,3337,3341
050,31,055,"Nebraska","Douglas County",5,60,6657,3321,3336
050,31,055,"Nebraska","Douglas County",5,61,6692,3291,3401
050,31,055,"Nebraska","Douglas County",5,62,6629,3202,3427
050,31,055,"Nebraska","Douglas County",5,63,6640,3205,3435
050,31,055,"Nebraska","Douglas County",5,64,6424,3066,3358
050,31,055,"Nebraska","Douglas County",5,65,6294,3021,3273
050,31,055,"Nebraska","Douglas County",5,66,6004,2853,3151
050,31,055,"Nebraska","Douglas County",5,67,5681,2668,3013
050,31,055,"Nebraska","Douglas County",5,68,5669,2609,3060
050,31,055,"Nebraska","Douglas County",5,69,5443,2522,2921
050,31,055,"Nebraska","Douglas County",5,70,5167,2377,2790
050,31,055,"Nebraska","Douglas County",5,71,4974,2294,2680
050,31,055,"Nebraska","Douglas County",5,72,4810,2150,2660
050,31,055,"Nebraska","Douglas County",5,73,4495,2052,2443
050,31,055,"Nebraska","Douglas County",5,74,4265,1960,2305
050,31,055,"Nebraska","Douglas County",5,75,3949,1800,2149
050,31,055,"Nebraska","Douglas County",5,76,4136,1889,2247
050,31,055,"Nebraska","Douglas County",5,77,2690,1190,1500
050,31,055,"Nebraska","Douglas County",5,78,2518,1108,1410
050,31,055,"Nebraska","Douglas County",5,79,2427,1069,1358
050,31,055,"Nebraska","Douglas County",5,80,2415,1056,1359
050,31,055,"Nebraska","Douglas County",5,81,2029,858,1171
050,31,055,"Nebraska","Douglas County",5,82,1765,720,1045
050,31,055,"Nebraska","Douglas County",5,83,1567,643,924
050,31,055,"Nebraska","Douglas County",5,84,1435,615,820
050,31,055,"Nebraska","Douglas County",5,85,8094,2904,5190
050,31,057,"Nebraska","Dundy County",1,0,21,10,11
050,31,057,"Nebraska","Dundy County",1,1,20,10,10
050,31,057,"Nebraska","Dundy County",1,2,11,5,6
050,31,057,"Nebraska","Dundy County",1,3,12,4,8
050,31,057,"Nebraska","Dundy County",1,4,18,11,7
050,31,057,"Nebraska","Dundy County",1,5,12,7,5
050,31,057,"Nebraska","Dundy County",1,6,12,6,6
050,31,057,"Nebraska","Dundy County",1,7,17,8,9
050,31,057,"Nebraska","Dundy County",1,8,11,3,8
050,31,057,"Nebraska","Dundy County",1,9,20,11,9
050,31,057,"Nebraska","Dundy County",1,10,24,12,12
050,31,057,"Nebraska","Dundy County",1,11,26,17,9
050,31,057,"Nebraska","Dundy County",1,12,21,11,10
050,31,057,"Nebraska","Dundy County",1,13,19,11,8
050,31,057,"Nebraska","Dundy County",1,14,19,10,9
050,31,057,"Nebraska","Dundy County",1,15,19,12,7
050,31,057,"Nebraska","Dundy County",1,16,22,16,6
050,31,057,"Nebraska","Dundy County",1,17,20,10,10
050,31,057,"Nebraska","Dundy County",1,18,17,8,9
050,31,057,"Nebraska","Dundy County",1,19,15,9,6
050,31,057,"Nebraska","Dundy County",1,20,14,8,6
050,31,057,"Nebraska","Dundy County",1,21,13,9,4
050,31,057,"Nebraska","Dundy County",1,22,20,7,13
050,31,057,"Nebraska","Dundy County",1,23,22,9,13
050,31,057,"Nebraska","Dundy County",1,24,21,12,9
050,31,057,"Nebraska","Dundy County",1,25,21,9,12
050,31,057,"Nebraska","Dundy County",1,26,14,4,10
050,31,057,"Nebraska","Dundy County",1,27,14,6,8
050,31,057,"Nebraska","Dundy County",1,28,14,6,8
050,31,057,"Nebraska","Dundy County",1,29,10,7,3
050,31,057,"Nebraska","Dundy County",1,30,8,4,4
050,31,057,"Nebraska","Dundy County",1,31,12,4,8
050,31,057,"Nebraska","Dundy County",1,32,16,8,8
050,31,057,"Nebraska","Dundy County",1,33,13,7,6
050,31,057,"Nebraska","Dundy County",1,34,20,9,11
050,31,057,"Nebraska","Dundy County",1,35,13,8,5
050,31,057,"Nebraska","Dundy County",1,36,14,8,6
050,31,057,"Nebraska","Dundy County",1,37,22,11,11
050,31,057,"Nebraska","Dundy County",1,38,20,12,8
050,31,057,"Nebraska","Dundy County",1,39,19,12,7
050,31,057,"Nebraska","Dundy County",1,40,19,11,8
050,31,057,"Nebraska","Dundy County",1,41,15,6,9
050,31,057,"Nebraska","Dundy County",1,42,19,11,8
050,31,057,"Nebraska","Dundy County",1,43,14,10,4
050,31,057,"Nebraska","Dundy County",1,44,13,7,6
050,31,057,"Nebraska","Dundy County",1,45,23,10,13
050,31,057,"Nebraska","Dundy County",1,46,24,10,14
050,31,057,"Nebraska","Dundy County",1,47,26,14,12
050,31,057,"Nebraska","Dundy County",1,48,17,8,9
050,31,057,"Nebraska","Dundy County",1,49,21,9,12
050,31,057,"Nebraska","Dundy County",1,50,20,10,10
050,31,057,"Nebraska","Dundy County",1,51,19,10,9
050,31,057,"Nebraska","Dundy County",1,52,11,4,7
050,31,057,"Nebraska","Dundy County",1,53,18,8,10
050,31,057,"Nebraska","Dundy County",1,54,13,7,6
050,31,057,"Nebraska","Dundy County",1,55,22,12,10
050,31,057,"Nebraska","Dundy County",1,56,24,12,12
050,31,057,"Nebraska","Dundy County",1,57,25,11,14
050,31,057,"Nebraska","Dundy County",1,58,31,17,14
050,31,057,"Nebraska","Dundy County",1,59,30,13,17
050,31,057,"Nebraska","Dundy County",1,60,29,17,12
050,31,057,"Nebraska","Dundy County",1,61,27,14,13
050,31,057,"Nebraska","Dundy County",1,62,31,15,16
050,31,057,"Nebraska","Dundy County",1,63,33,19,14
050,31,057,"Nebraska","Dundy County",1,64,36,22,14
050,31,057,"Nebraska","Dundy County",1,65,27,16,11
050,31,057,"Nebraska","Dundy County",1,66,20,9,11
050,31,057,"Nebraska","Dundy County",1,67,24,13,11
050,31,057,"Nebraska","Dundy County",1,68,24,12,12
050,31,057,"Nebraska","Dundy County",1,69,33,16,17
050,31,057,"Nebraska","Dundy County",1,70,29,16,13
050,31,057,"Nebraska","Dundy County",1,71,22,10,12
050,31,057,"Nebraska","Dundy County",1,72,18,8,10
050,31,057,"Nebraska","Dundy County",1,73,15,7,8
050,31,057,"Nebraska","Dundy County",1,74,15,6,9
050,31,057,"Nebraska","Dundy County",1,75,22,10,12
050,31,057,"Nebraska","Dundy County",1,76,17,9,8
050,31,057,"Nebraska","Dundy County",1,77,11,6,5
050,31,057,"Nebraska","Dundy County",1,78,14,8,6
050,31,057,"Nebraska","Dundy County",1,79,15,7,8
050,31,057,"Nebraska","Dundy County",1,80,17,9,8
050,31,057,"Nebraska","Dundy County",1,81,10,5,5
050,31,057,"Nebraska","Dundy County",1,82,13,4,9
050,31,057,"Nebraska","Dundy County",1,83,11,2,9
050,31,057,"Nebraska","Dundy County",1,84,9,4,5
050,31,057,"Nebraska","Dundy County",1,85,55,19,36
050,31,057,"Nebraska","Dundy County",2,0,18,9,9
050,31,057,"Nebraska","Dundy County",2,1,19,9,10
050,31,057,"Nebraska","Dundy County",2,2,12,5,7
050,31,057,"Nebraska","Dundy County",2,3,12,4,8
050,31,057,"Nebraska","Dundy County",2,4,17,10,7
050,31,057,"Nebraska","Dundy County",2,5,14,8,6
050,31,057,"Nebraska","Dundy County",2,6,12,6,6
050,31,057,"Nebraska","Dundy County",2,7,15,6,9
050,31,057,"Nebraska","Dundy County",2,8,13,4,9
050,31,057,"Nebraska","Dundy County",2,9,18,9,9
050,31,057,"Nebraska","Dundy County",2,10,24,13,11
050,31,057,"Nebraska","Dundy County",2,11,26,16,10
050,31,057,"Nebraska","Dundy County",2,12,23,13,10
050,31,057,"Nebraska","Dundy County",2,13,21,12,9
050,31,057,"Nebraska","Dundy County",2,14,20,11,9
050,31,057,"Nebraska","Dundy County",2,15,19,11,8
050,31,057,"Nebraska","Dundy County",2,16,22,16,6
050,31,057,"Nebraska","Dundy County",2,17,20,11,9
050,31,057,"Nebraska","Dundy County",2,18,16,8,8
050,31,057,"Nebraska","Dundy County",2,19,15,9,6
050,31,057,"Nebraska","Dundy County",2,20,14,8,6
050,31,057,"Nebraska","Dundy County",2,21,14,9,5
050,31,057,"Nebraska","Dundy County",2,22,19,7,12
050,31,057,"Nebraska","Dundy County",2,23,22,9,13
050,31,057,"Nebraska","Dundy County",2,24,21,11,10
050,31,057,"Nebraska","Dundy County",2,25,21,9,12
050,31,057,"Nebraska","Dundy County",2,26,15,5,10
050,31,057,"Nebraska","Dundy County",2,27,13,5,8
050,31,057,"Nebraska","Dundy County",2,28,15,7,8
050,31,057,"Nebraska","Dundy County",2,29,11,7,4
050,31,057,"Nebraska","Dundy County",2,30,9,5,4
050,31,057,"Nebraska","Dundy County",2,31,11,4,7
050,31,057,"Nebraska","Dundy County",2,32,15,7,8
050,31,057,"Nebraska","Dundy County",2,33,15,7,8
050,31,057,"Nebraska","Dundy County",2,34,19,9,10
050,31,057,"Nebraska","Dundy County",2,35,15,9,6
050,31,057,"Nebraska","Dundy County",2,36,13,7,6
050,31,057,"Nebraska","Dundy County",2,37,20,10,10
050,31,057,"Nebraska","Dundy County",2,38,20,11,9
050,31,057,"Nebraska","Dundy County",2,39,20,13,7
050,31,057,"Nebraska","Dundy County",2,40,19,11,8
050,31,057,"Nebraska","Dundy County",2,41,16,7,9
050,31,057,"Nebraska","Dundy County",2,42,18,10,8
050,31,057,"Nebraska","Dundy County",2,43,17,11,6
050,31,057,"Nebraska","Dundy County",2,44,14,8,6
050,31,057,"Nebraska","Dundy County",2,45,21,9,12
050,31,057,"Nebraska","Dundy County",2,46,24,10,14
050,31,057,"Nebraska","Dundy County",2,47,25,13,12
050,31,057,"Nebraska","Dundy County",2,48,18,9,9
050,31,057,"Nebraska","Dundy County",2,49,20,8,12
050,31,057,"Nebraska","Dundy County",2,50,20,10,10
050,31,057,"Nebraska","Dundy County",2,51,18,9,9
050,31,057,"Nebraska","Dundy County",2,52,12,5,7
050,31,057,"Nebraska","Dundy County",2,53,17,7,10
050,31,057,"Nebraska","Dundy County",2,54,15,8,7
050,31,057,"Nebraska","Dundy County",2,55,19,10,9
050,31,057,"Nebraska","Dundy County",2,56,24,12,12
050,31,057,"Nebraska","Dundy County",2,57,24,11,13
050,31,057,"Nebraska","Dundy County",2,58,30,16,14
050,31,057,"Nebraska","Dundy County",2,59,30,14,16
050,31,057,"Nebraska","Dundy County",2,60,29,16,13
050,31,057,"Nebraska","Dundy County",2,61,27,14,13
050,31,057,"Nebraska","Dundy County",2,62,29,14,15
050,31,057,"Nebraska","Dundy County",2,63,32,18,14
050,31,057,"Nebraska","Dundy County",2,64,35,21,14
050,31,057,"Nebraska","Dundy County",2,65,29,18,11
050,31,057,"Nebraska","Dundy County",2,66,21,10,11
050,31,057,"Nebraska","Dundy County",2,67,22,12,10
050,31,057,"Nebraska","Dundy County",2,68,24,12,12
050,31,057,"Nebraska","Dundy County",2,69,31,15,16
050,31,057,"Nebraska","Dundy County",2,70,30,16,14
050,31,057,"Nebraska","Dundy County",2,71,24,12,12
050,31,057,"Nebraska","Dundy County",2,72,19,9,10
050,31,057,"Nebraska","Dundy County",2,73,16,7,9
050,31,057,"Nebraska","Dundy County",2,74,14,6,8
050,31,057,"Nebraska","Dundy County",2,75,22,10,12
050,31,057,"Nebraska","Dundy County",2,76,17,9,8
050,31,057,"Nebraska","Dundy County",2,77,13,7,6
050,31,057,"Nebraska","Dundy County",2,78,12,7,5
050,31,057,"Nebraska","Dundy County",2,79,15,7,8
050,31,057,"Nebraska","Dundy County",2,80,16,8,8
050,31,057,"Nebraska","Dundy County",2,81,12,6,6
050,31,057,"Nebraska","Dundy County",2,82,12,4,8
050,31,057,"Nebraska","Dundy County",2,83,11,3,8
050,31,057,"Nebraska","Dundy County",2,84,9,3,6
050,31,057,"Nebraska","Dundy County",2,85,54,19,35
050,31,057,"Nebraska","Dundy County",3,0,12,4,8
050,31,057,"Nebraska","Dundy County",3,1,22,11,11
050,31,057,"Nebraska","Dundy County",3,2,18,9,9
050,31,057,"Nebraska","Dundy County",3,3,14,7,7
050,31,057,"Nebraska","Dundy County",3,4,14,5,9
050,31,057,"Nebraska","Dundy County",3,5,17,10,7
050,31,057,"Nebraska","Dundy County",3,6,14,8,6
050,31,057,"Nebraska","Dundy County",3,7,11,6,5
050,31,057,"Nebraska","Dundy County",3,8,19,9,10
050,31,057,"Nebraska","Dundy County",3,9,12,5,7
050,31,057,"Nebraska","Dundy County",3,10,18,8,10
050,31,057,"Nebraska","Dundy County",3,11,24,14,10
050,31,057,"Nebraska","Dundy County",3,12,27,15,12
050,31,057,"Nebraska","Dundy County",3,13,21,11,10
050,31,057,"Nebraska","Dundy County",3,14,19,12,7
050,31,057,"Nebraska","Dundy County",3,15,15,9,6
050,31,057,"Nebraska","Dundy County",3,16,21,11,10
050,31,057,"Nebraska","Dundy County",3,17,23,16,7
050,31,057,"Nebraska","Dundy County",3,18,16,8,8
050,31,057,"Nebraska","Dundy County",3,19,12,6,6
050,31,057,"Nebraska","Dundy County",3,20,16,10,6
050,31,057,"Nebraska","Dundy County",3,21,15,7,8
050,31,057,"Nebraska","Dundy County",3,22,13,7,6
050,31,057,"Nebraska","Dundy County",3,23,15,6,9
050,31,057,"Nebraska","Dundy County",3,24,23,10,13
050,31,057,"Nebraska","Dundy County",3,25,24,13,11
050,31,057,"Nebraska","Dundy County",3,26,23,10,13
050,31,057,"Nebraska","Dundy County",3,27,16,6,10
050,31,057,"Nebraska","Dundy County",3,28,13,5,8
050,31,057,"Nebraska","Dundy County",3,29,13,6,7
050,31,057,"Nebraska","Dundy County",3,30,9,3,6
050,31,057,"Nebraska","Dundy County",3,31,12,6,6
050,31,057,"Nebraska","Dundy County",3,32,11,5,6
050,31,057,"Nebraska","Dundy County",3,33,15,8,7
050,31,057,"Nebraska","Dundy County",3,34,16,7,9
050,31,057,"Nebraska","Dundy County",3,35,18,10,8
050,31,057,"Nebraska","Dundy County",3,36,12,7,5
050,31,057,"Nebraska","Dundy County",3,37,11,5,6
050,31,057,"Nebraska","Dundy County",3,38,19,9,10
050,31,057,"Nebraska","Dundy County",3,39,19,10,9
050,31,057,"Nebraska","Dundy County",3,40,19,13,6
050,31,057,"Nebraska","Dundy County",3,41,20,11,9
050,31,057,"Nebraska","Dundy County",3,42,16,7,9
050,31,057,"Nebraska","Dundy County",3,43,17,10,7
050,31,057,"Nebraska","Dundy County",3,44,18,12,6
050,31,057,"Nebraska","Dundy County",3,45,14,8,6
050,31,057,"Nebraska","Dundy County",3,46,20,8,12
050,31,057,"Nebraska","Dundy County",3,47,25,10,15
050,31,057,"Nebraska","Dundy County",3,48,26,14,12
050,31,057,"Nebraska","Dundy County",3,49,17,9,8
050,31,057,"Nebraska","Dundy County",3,50,19,8,11
050,31,057,"Nebraska","Dundy County",3,51,20,10,10
050,31,057,"Nebraska","Dundy County",3,52,17,9,8
050,31,057,"Nebraska","Dundy County",3,53,11,4,7
050,31,057,"Nebraska","Dundy County",3,54,16,6,10
050,31,057,"Nebraska","Dundy County",3,55,14,7,7
050,31,057,"Nebraska","Dundy County",3,56,15,6,9
050,31,057,"Nebraska","Dundy County",3,57,24,12,12
050,31,057,"Nebraska","Dundy County",3,58,24,12,12
050,31,057,"Nebraska","Dundy County",3,59,31,16,15
050,31,057,"Nebraska","Dundy County",3,60,30,14,16
050,31,057,"Nebraska","Dundy County",3,61,29,18,11
050,31,057,"Nebraska","Dundy County",3,62,28,15,13
050,31,057,"Nebraska","Dundy County",3,63,29,14,15
050,31,057,"Nebraska","Dundy County",3,64,35,18,17
050,31,057,"Nebraska","Dundy County",3,65,32,21,11
050,31,057,"Nebraska","Dundy County",3,66,27,17,10
050,31,057,"Nebraska","Dundy County",3,67,23,11,12
050,31,057,"Nebraska","Dundy County",3,68,23,14,9
050,31,057,"Nebraska","Dundy County",3,69,25,13,12
050,31,057,"Nebraska","Dundy County",3,70,31,15,16
050,31,057,"Nebraska","Dundy County",3,71,28,14,14
050,31,057,"Nebraska","Dundy County",3,72,26,13,13
050,31,057,"Nebraska","Dundy County",3,73,20,10,10
050,31,057,"Nebraska","Dundy County",3,74,17,7,10
050,31,057,"Nebraska","Dundy County",3,75,13,6,7
050,31,057,"Nebraska","Dundy County",3,76,20,9,11
050,31,057,"Nebraska","Dundy County",3,77,18,8,10
050,31,057,"Nebraska","Dundy County",3,78,12,7,5
050,31,057,"Nebraska","Dundy County",3,79,10,5,5
050,31,057,"Nebraska","Dundy County",3,80,14,6,8
050,31,057,"Nebraska","Dundy County",3,81,15,7,8
050,31,057,"Nebraska","Dundy County",3,82,12,6,6
050,31,057,"Nebraska","Dundy County",3,83,12,5,7
050,31,057,"Nebraska","Dundy County",3,84,10,3,7
050,31,057,"Nebraska","Dundy County",3,85,49,15,34
050,31,057,"Nebraska","Dundy County",4,0,14,5,9
050,31,057,"Nebraska","Dundy County",4,1,10,2,8
050,31,057,"Nebraska","Dundy County",4,2,20,8,12
050,31,057,"Nebraska","Dundy County",4,3,17,9,8
050,31,057,"Nebraska","Dundy County",4,4,13,7,6
050,31,057,"Nebraska","Dundy County",4,5,9,2,7
050,31,057,"Nebraska","Dundy County",4,6,18,10,8
050,31,057,"Nebraska","Dundy County",4,7,12,7,5
050,31,057,"Nebraska","Dundy County",4,8,12,6,6
050,31,057,"Nebraska","Dundy County",4,9,19,9,10
050,31,057,"Nebraska","Dundy County",4,10,12,6,6
050,31,057,"Nebraska","Dundy County",4,11,20,8,12
050,31,057,"Nebraska","Dundy County",4,12,24,13,11
050,31,057,"Nebraska","Dundy County",4,13,24,14,10
050,31,057,"Nebraska","Dundy County",4,14,20,11,9
050,31,057,"Nebraska","Dundy County",4,15,19,12,7
050,31,057,"Nebraska","Dundy County",4,16,17,10,7
050,31,057,"Nebraska","Dundy County",4,17,18,9,9
050,31,057,"Nebraska","Dundy County",4,18,21,15,6
050,31,057,"Nebraska","Dundy County",4,19,12,7,5
050,31,057,"Nebraska","Dundy County",4,20,14,7,7
050,31,057,"Nebraska","Dundy County",4,21,17,10,7
050,31,057,"Nebraska","Dundy County",4,22,15,7,8
050,31,057,"Nebraska","Dundy County",4,23,13,8,5
050,31,057,"Nebraska","Dundy County",4,24,17,7,10
050,31,057,"Nebraska","Dundy County",4,25,22,9,13
050,31,057,"Nebraska","Dundy County",4,26,21,11,10
050,31,057,"Nebraska","Dundy County",4,27,23,10,13
050,31,057,"Nebraska","Dundy County",4,28,17,7,10
050,31,057,"Nebraska","Dundy County",4,29,14,6,8
050,31,057,"Nebraska","Dundy County",4,30,13,6,7
050,31,057,"Nebraska","Dundy County",4,31,7,2,5
050,31,057,"Nebraska","Dundy County",4,32,13,6,7
050,31,057,"Nebraska","Dundy County",4,33,11,5,6
050,31,057,"Nebraska","Dundy County",4,34,13,8,5
050,31,057,"Nebraska","Dundy County",4,35,16,6,10
050,31,057,"Nebraska","Dundy County",4,36,15,8,7
050,31,057,"Nebraska","Dundy County",4,37,11,7,4
050,31,057,"Nebraska","Dundy County",4,38,11,5,6
050,31,057,"Nebraska","Dundy County",4,39,19,9,10
050,31,057,"Nebraska","Dundy County",4,40,20,11,9
050,31,057,"Nebraska","Dundy County",4,41,18,12,6
050,31,057,"Nebraska","Dundy County",4,42,20,11,9
050,31,057,"Nebraska","Dundy County",4,43,16,7,9
050,31,057,"Nebraska","Dundy County",4,44,16,8,8
050,31,057,"Nebraska","Dundy County",4,45,17,11,6
050,31,057,"Nebraska","Dundy County",4,46,14,8,6
050,31,057,"Nebraska","Dundy County",4,47,20,7,13
050,31,057,"Nebraska","Dundy County",4,48,24,10,14
050,31,057,"Nebraska","Dundy County",4,49,24,13,11
050,31,057,"Nebraska","Dundy County",4,50,18,10,8
050,31,057,"Nebraska","Dundy County",4,51,18,8,10
050,31,057,"Nebraska","Dundy County",4,52,20,10,10
050,31,057,"Nebraska","Dundy County",4,53,15,8,7
050,31,057,"Nebraska","Dundy County",4,54,11,4,7
050,31,057,"Nebraska","Dundy County",4,55,16,6,10
050,31,057,"Nebraska","Dundy County",4,56,14,7,7
050,31,057,"Nebraska","Dundy County",4,57,14,6,8
050,31,057,"Nebraska","Dundy County",4,58,23,11,12
050,31,057,"Nebraska","Dundy County",4,59,25,12,13
050,31,057,"Nebraska","Dundy County",4,60,31,16,15
050,31,057,"Nebraska","Dundy County",4,61,29,13,16
050,31,057,"Nebraska","Dundy County",4,62,26,15,11
050,31,057,"Nebraska","Dundy County",4,63,27,15,12
050,31,057,"Nebraska","Dundy County",4,64,30,14,16
050,31,057,"Nebraska","Dundy County",4,65,32,15,17
050,31,057,"Nebraska","Dundy County",4,66,32,20,12
050,31,057,"Nebraska","Dundy County",4,67,30,17,13
050,31,057,"Nebraska","Dundy County",4,68,23,12,11
050,31,057,"Nebraska","Dundy County",4,69,24,15,9
050,31,057,"Nebraska","Dundy County",4,70,24,13,11
050,31,057,"Nebraska","Dundy County",4,71,27,13,14
050,31,057,"Nebraska","Dundy County",4,72,29,14,15
050,31,057,"Nebraska","Dundy County",4,73,26,13,13
050,31,057,"Nebraska","Dundy County",4,74,20,10,10
050,31,057,"Nebraska","Dundy County",4,75,15,6,9
050,31,057,"Nebraska","Dundy County",4,76,11,5,6
050,31,057,"Nebraska","Dundy County",4,77,19,9,10
050,31,057,"Nebraska","Dundy County",4,78,17,7,10
050,31,057,"Nebraska","Dundy County",4,79,12,7,5
050,31,057,"Nebraska","Dundy County",4,80,9,4,5
050,31,057,"Nebraska","Dundy County",4,81,13,5,8
050,31,057,"Nebraska","Dundy County",4,82,15,7,8
050,31,057,"Nebraska","Dundy County",4,83,12,6,6
050,31,057,"Nebraska","Dundy County",4,84,11,4,7
050,31,057,"Nebraska","Dundy County",4,85,55,15,40
050,31,057,"Nebraska","Dundy County",5,0,17,6,11
050,31,057,"Nebraska","Dundy County",5,1,13,7,6
050,31,057,"Nebraska","Dundy County",5,2,10,2,8
050,31,057,"Nebraska","Dundy County",5,3,15,7,8
050,31,057,"Nebraska","Dundy County",5,4,18,11,7
050,31,057,"Nebraska","Dundy County",5,5,12,5,7
050,31,057,"Nebraska","Dundy County",5,6,7,2,5
050,31,057,"Nebraska","Dundy County",5,7,16,8,8
050,31,057,"Nebraska","Dundy County",5,8,14,7,7
050,31,057,"Nebraska","Dundy County",5,9,12,7,5
050,31,057,"Nebraska","Dundy County",5,10,18,8,10
050,31,057,"Nebraska","Dundy County",5,11,13,7,6
050,31,057,"Nebraska","Dundy County",5,12,19,8,11
050,31,057,"Nebraska","Dundy County",5,13,22,13,9
050,31,057,"Nebraska","Dundy County",5,14,22,14,8
050,31,057,"Nebraska","Dundy County",5,15,21,12,9
050,31,057,"Nebraska","Dundy County",5,16,18,12,6
050,31,057,"Nebraska","Dundy County",5,17,17,9,8
050,31,057,"Nebraska","Dundy County",5,18,14,9,5
050,31,057,"Nebraska","Dundy County",5,19,15,10,5
050,31,057,"Nebraska","Dundy County",5,20,14,7,7
050,31,057,"Nebraska","Dundy County",5,21,11,6,5
050,31,057,"Nebraska","Dundy County",5,22,18,10,8
050,31,057,"Nebraska","Dundy County",5,23,13,6,7
050,31,057,"Nebraska","Dundy County",5,24,9,8,1
050,31,057,"Nebraska","Dundy County",5,25,14,6,8
050,31,057,"Nebraska","Dundy County",5,26,22,10,12
050,31,057,"Nebraska","Dundy County",5,27,26,11,15
050,31,057,"Nebraska","Dundy County",5,28,23,9,14
050,31,057,"Nebraska","Dundy County",5,29,12,6,6
050,31,057,"Nebraska","Dundy County",5,30,12,5,7
050,31,057,"Nebraska","Dundy County",5,31,12,5,7
050,31,057,"Nebraska","Dundy County",5,32,7,2,5
050,31,057,"Nebraska","Dundy County",5,33,10,5,5
050,31,057,"Nebraska","Dundy County",5,34,12,6,6
050,31,057,"Nebraska","Dundy County",5,35,12,7,5
050,31,057,"Nebraska","Dundy County",5,36,14,5,9
050,31,057,"Nebraska","Dundy County",5,37,13,7,6
050,31,057,"Nebraska","Dundy County",5,38,11,7,4
050,31,057,"Nebraska","Dundy County",5,39,12,6,6
050,31,057,"Nebraska","Dundy County",5,40,18,9,9
050,31,057,"Nebraska","Dundy County",5,41,23,12,11
050,31,057,"Nebraska","Dundy County",5,42,21,12,9
050,31,057,"Nebraska","Dundy County",5,43,19,10,9
050,31,057,"Nebraska","Dundy County",5,44,17,7,10
050,31,057,"Nebraska","Dundy County",5,45,15,8,7
050,31,057,"Nebraska","Dundy County",5,46,18,11,7
050,31,057,"Nebraska","Dundy County",5,47,13,8,5
050,31,057,"Nebraska","Dundy County",5,48,18,7,11
050,31,057,"Nebraska","Dundy County",5,49,24,10,14
050,31,057,"Nebraska","Dundy County",5,50,24,13,11
050,31,057,"Nebraska","Dundy County",5,51,18,10,8
050,31,057,"Nebraska","Dundy County",5,52,20,9,11
050,31,057,"Nebraska","Dundy County",5,53,19,9,10
050,31,057,"Nebraska","Dundy County",5,54,15,8,7
050,31,057,"Nebraska","Dundy County",5,55,11,4,7
050,31,057,"Nebraska","Dundy County",5,56,16,6,10
050,31,057,"Nebraska","Dundy County",5,57,14,7,7
050,31,057,"Nebraska","Dundy County",5,58,15,6,9
050,31,057,"Nebraska","Dundy County",5,59,24,11,13
050,31,057,"Nebraska","Dundy County",5,60,25,12,13
050,31,057,"Nebraska","Dundy County",5,61,30,16,14
050,31,057,"Nebraska","Dundy County",5,62,27,11,16
050,31,057,"Nebraska","Dundy County",5,63,27,16,11
050,31,057,"Nebraska","Dundy County",5,64,27,15,12
050,31,057,"Nebraska","Dundy County",5,65,31,15,16
050,31,057,"Nebraska","Dundy County",5,66,32,15,17
050,31,057,"Nebraska","Dundy County",5,67,33,21,12
050,31,057,"Nebraska","Dundy County",5,68,31,18,13
050,31,057,"Nebraska","Dundy County",5,69,23,12,11
050,31,057,"Nebraska","Dundy County",5,70,24,15,9
050,31,057,"Nebraska","Dundy County",5,71,22,11,11
050,31,057,"Nebraska","Dundy County",5,72,28,13,15
050,31,057,"Nebraska","Dundy County",5,73,28,15,13
050,31,057,"Nebraska","Dundy County",5,74,24,13,11
050,31,057,"Nebraska","Dundy County",5,75,19,9,10
050,31,057,"Nebraska","Dundy County",5,76,14,4,10
050,31,057,"Nebraska","Dundy County",5,77,12,5,7
050,31,057,"Nebraska","Dundy County",5,78,18,8,10
050,31,057,"Nebraska","Dundy County",5,79,16,6,10
050,31,057,"Nebraska","Dundy County",5,80,11,6,5
050,31,057,"Nebraska","Dundy County",5,81,7,3,4
050,31,057,"Nebraska","Dundy County",5,82,13,5,8
050,31,057,"Nebraska","Dundy County",5,83,16,9,7
050,31,057,"Nebraska","Dundy County",5,84,11,5,6
050,31,057,"Nebraska","Dundy County",5,85,60,14,46
050,31,059,"Nebraska","Fillmore County",1,0,56,28,28
050,31,059,"Nebraska","Fillmore County",1,1,62,29,33
050,31,059,"Nebraska","Fillmore County",1,2,60,29,31
050,31,059,"Nebraska","Fillmore County",1,3,65,28,37
050,31,059,"Nebraska","Fillmore County",1,4,56,28,28
050,31,059,"Nebraska","Fillmore County",1,5,56,31,25
050,31,059,"Nebraska","Fillmore County",1,6,71,42,29
050,31,059,"Nebraska","Fillmore County",1,7,47,30,17
050,31,059,"Nebraska","Fillmore County",1,8,49,28,21
050,31,059,"Nebraska","Fillmore County",1,9,49,26,23
050,31,059,"Nebraska","Fillmore County",1,10,71,31,40
050,31,059,"Nebraska","Fillmore County",1,11,68,33,35
050,31,059,"Nebraska","Fillmore County",1,12,63,28,35
050,31,059,"Nebraska","Fillmore County",1,13,66,33,33
050,31,059,"Nebraska","Fillmore County",1,14,57,29,28
050,31,059,"Nebraska","Fillmore County",1,15,43,25,18
050,31,059,"Nebraska","Fillmore County",1,16,60,32,28
050,31,059,"Nebraska","Fillmore County",1,17,66,32,34
050,31,059,"Nebraska","Fillmore County",1,18,55,30,25
050,31,059,"Nebraska","Fillmore County",1,19,43,24,19
050,31,059,"Nebraska","Fillmore County",1,20,44,27,17
050,31,059,"Nebraska","Fillmore County",1,21,45,26,19
050,31,059,"Nebraska","Fillmore County",1,22,48,27,21
050,31,059,"Nebraska","Fillmore County",1,23,53,26,27
050,31,059,"Nebraska","Fillmore County",1,24,55,28,27
050,31,059,"Nebraska","Fillmore County",1,25,61,32,29
050,31,059,"Nebraska","Fillmore County",1,26,64,35,29
050,31,059,"Nebraska","Fillmore County",1,27,61,35,26
050,31,059,"Nebraska","Fillmore County",1,28,55,29,26
050,31,059,"Nebraska","Fillmore County",1,29,65,31,34
050,31,059,"Nebraska","Fillmore County",1,30,63,31,32
050,31,059,"Nebraska","Fillmore County",1,31,68,39,29
050,31,059,"Nebraska","Fillmore County",1,32,75,42,33
050,31,059,"Nebraska","Fillmore County",1,33,67,32,35
050,31,059,"Nebraska","Fillmore County",1,34,72,36,36
050,31,059,"Nebraska","Fillmore County",1,35,67,34,33
050,31,059,"Nebraska","Fillmore County",1,36,65,32,33
050,31,059,"Nebraska","Fillmore County",1,37,56,27,29
050,31,059,"Nebraska","Fillmore County",1,38,80,39,41
050,31,059,"Nebraska","Fillmore County",1,39,73,42,31
050,31,059,"Nebraska","Fillmore County",1,40,66,38,28
050,31,059,"Nebraska","Fillmore County",1,41,63,36,27
050,31,059,"Nebraska","Fillmore County",1,42,59,32,27
050,31,059,"Nebraska","Fillmore County",1,43,66,34,32
050,31,059,"Nebraska","Fillmore County",1,44,48,27,21
050,31,059,"Nebraska","Fillmore County",1,45,62,31,31
050,31,059,"Nebraska","Fillmore County",1,46,45,20,25
050,31,059,"Nebraska","Fillmore County",1,47,49,32,17
050,31,059,"Nebraska","Fillmore County",1,48,62,34,28
050,31,059,"Nebraska","Fillmore County",1,49,60,31,29
050,31,059,"Nebraska","Fillmore County",1,50,60,30,30
050,31,059,"Nebraska","Fillmore County",1,51,66,29,37
050,31,059,"Nebraska","Fillmore County",1,52,70,32,38
050,31,059,"Nebraska","Fillmore County",1,53,80,47,33
050,31,059,"Nebraska","Fillmore County",1,54,84,51,33
050,31,059,"Nebraska","Fillmore County",1,55,89,49,40
050,31,059,"Nebraska","Fillmore County",1,56,90,41,49
050,31,059,"Nebraska","Fillmore County",1,57,82,42,40
050,31,059,"Nebraska","Fillmore County",1,58,89,45,44
050,31,059,"Nebraska","Fillmore County",1,59,101,48,53
050,31,059,"Nebraska","Fillmore County",1,60,105,52,53
050,31,059,"Nebraska","Fillmore County",1,61,99,52,47
050,31,059,"Nebraska","Fillmore County",1,62,86,48,38
050,31,059,"Nebraska","Fillmore County",1,63,86,49,37
050,31,059,"Nebraska","Fillmore County",1,64,90,41,49
050,31,059,"Nebraska","Fillmore County",1,65,82,40,42
050,31,059,"Nebraska","Fillmore County",1,66,86,46,40
050,31,059,"Nebraska","Fillmore County",1,67,86,49,37
050,31,059,"Nebraska","Fillmore County",1,68,92,48,44
050,31,059,"Nebraska","Fillmore County",1,69,70,34,36
050,31,059,"Nebraska","Fillmore County",1,70,67,29,38
050,31,059,"Nebraska","Fillmore County",1,71,63,26,37
050,31,059,"Nebraska","Fillmore County",1,72,55,25,30
050,31,059,"Nebraska","Fillmore County",1,73,58,27,31
050,31,059,"Nebraska","Fillmore County",1,74,47,23,24
050,31,059,"Nebraska","Fillmore County",1,75,46,23,23
050,31,059,"Nebraska","Fillmore County",1,76,43,22,21
050,31,059,"Nebraska","Fillmore County",1,77,45,25,20
050,31,059,"Nebraska","Fillmore County",1,78,39,19,20
050,31,059,"Nebraska","Fillmore County",1,79,40,13,27
050,31,059,"Nebraska","Fillmore County",1,80,26,11,15
050,31,059,"Nebraska","Fillmore County",1,81,36,17,19
050,31,059,"Nebraska","Fillmore County",1,82,40,17,23
050,31,059,"Nebraska","Fillmore County",1,83,32,12,20
050,31,059,"Nebraska","Fillmore County",1,84,36,11,25
050,31,059,"Nebraska","Fillmore County",1,85,213,84,129
050,31,059,"Nebraska","Fillmore County",2,0,61,29,32
050,31,059,"Nebraska","Fillmore County",2,1,62,30,32
050,31,059,"Nebraska","Fillmore County",2,2,60,29,31
050,31,059,"Nebraska","Fillmore County",2,3,63,28,35
050,31,059,"Nebraska","Fillmore County",2,4,59,28,31
050,31,059,"Nebraska","Fillmore County",2,5,58,32,26
050,31,059,"Nebraska","Fillmore County",2,6,69,41,28
050,31,059,"Nebraska","Fillmore County",2,7,53,33,20
050,31,059,"Nebraska","Fillmore County",2,8,50,29,21
050,31,059,"Nebraska","Fillmore County",2,9,50,27,23
050,31,059,"Nebraska","Fillmore County",2,10,67,31,36
050,31,059,"Nebraska","Fillmore County",2,11,67,32,35
050,31,059,"Nebraska","Fillmore County",2,12,65,29,36
050,31,059,"Nebraska","Fillmore County",2,13,64,31,33
050,31,059,"Nebraska","Fillmore County",2,14,58,29,29
050,31,059,"Nebraska","Fillmore County",2,15,47,26,21
050,31,059,"Nebraska","Fillmore County",2,16,57,31,26
050,31,059,"Nebraska","Fillmore County",2,17,66,32,34
050,31,059,"Nebraska","Fillmore County",2,18,54,29,25
050,31,059,"Nebraska","Fillmore County",2,19,44,25,19
050,31,059,"Nebraska","Fillmore County",2,20,45,27,18
050,31,059,"Nebraska","Fillmore County",2,21,46,26,20
050,31,059,"Nebraska","Fillmore County",2,22,49,27,22
050,31,059,"Nebraska","Fillmore County",2,23,54,27,27
050,31,059,"Nebraska","Fillmore County",2,24,55,28,27
050,31,059,"Nebraska","Fillmore County",2,25,58,31,27
050,31,059,"Nebraska","Fillmore County",2,26,63,34,29
050,31,059,"Nebraska","Fillmore County",2,27,61,35,26
050,31,059,"Nebraska","Fillmore County",2,28,56,30,26
050,31,059,"Nebraska","Fillmore County",2,29,63,31,32
050,31,059,"Nebraska","Fillmore County",2,30,64,31,33
050,31,059,"Nebraska","Fillmore County",2,31,68,39,29
050,31,059,"Nebraska","Fillmore County",2,32,73,40,33
050,31,059,"Nebraska","Fillmore County",2,33,70,34,36
050,31,059,"Nebraska","Fillmore County",2,34,72,36,36
050,31,059,"Nebraska","Fillmore County",2,35,68,34,34
050,31,059,"Nebraska","Fillmore County",2,36,66,32,34
050,31,059,"Nebraska","Fillmore County",2,37,59,29,30
050,31,059,"Nebraska","Fillmore County",2,38,74,36,38
050,31,059,"Nebraska","Fillmore County",2,39,75,41,34
050,31,059,"Nebraska","Fillmore County",2,40,69,40,29
050,31,059,"Nebraska","Fillmore County",2,41,64,37,27
050,31,059,"Nebraska","Fillmore County",2,42,60,33,27
050,31,059,"Nebraska","Fillmore County",2,43,64,34,30
050,31,059,"Nebraska","Fillmore County",2,44,53,29,24
050,31,059,"Nebraska","Fillmore County",2,45,59,30,29
050,31,059,"Nebraska","Fillmore County",2,46,48,22,26
050,31,059,"Nebraska","Fillmore County",2,47,49,30,19
050,31,059,"Nebraska","Fillmore County",2,48,60,34,26
050,31,059,"Nebraska","Fillmore County",2,49,62,33,29
050,31,059,"Nebraska","Fillmore County",2,50,61,31,30
050,31,059,"Nebraska","Fillmore County",2,51,63,28,35
050,31,059,"Nebraska","Fillmore County",2,52,70,32,38
050,31,059,"Nebraska","Fillmore County",2,53,77,43,34
050,31,059,"Nebraska","Fillmore County",2,54,83,50,33
050,31,059,"Nebraska","Fillmore County",2,55,89,50,39
050,31,059,"Nebraska","Fillmore County",2,56,89,42,47
050,31,059,"Nebraska","Fillmore County",2,57,83,41,42
050,31,059,"Nebraska","Fillmore County",2,58,88,45,43
050,31,059,"Nebraska","Fillmore County",2,59,99,48,51
050,31,059,"Nebraska","Fillmore County",2,60,104,51,53
050,31,059,"Nebraska","Fillmore County",2,61,101,52,49
050,31,059,"Nebraska","Fillmore County",2,62,89,49,40
050,31,059,"Nebraska","Fillmore County",2,63,86,49,37
050,31,059,"Nebraska","Fillmore County",2,64,88,42,46
050,31,059,"Nebraska","Fillmore County",2,65,83,39,44
050,31,059,"Nebraska","Fillmore County",2,66,85,44,41
050,31,059,"Nebraska","Fillmore County",2,67,85,47,38
050,31,059,"Nebraska","Fillmore County",2,68,88,46,42
050,31,059,"Nebraska","Fillmore County",2,69,76,38,38
050,31,059,"Nebraska","Fillmore County",2,70,67,30,37
050,31,059,"Nebraska","Fillmore County",2,71,64,27,37
050,31,059,"Nebraska","Fillmore County",2,72,54,24,30
050,31,059,"Nebraska","Fillmore County",2,73,61,28,33
050,31,059,"Nebraska","Fillmore County",2,74,46,22,24
050,31,059,"Nebraska","Fillmore County",2,75,44,21,23
050,31,059,"Nebraska","Fillmore County",2,76,43,22,21
050,31,059,"Nebraska","Fillmore County",2,77,45,25,20
050,31,059,"Nebraska","Fillmore County",2,78,40,20,20
050,31,059,"Nebraska","Fillmore County",2,79,40,14,26
050,31,059,"Nebraska","Fillmore County",2,80,27,10,17
050,31,059,"Nebraska","Fillmore County",2,81,34,16,18
050,31,059,"Nebraska","Fillmore County",2,82,39,17,22
050,31,059,"Nebraska","Fillmore County",2,83,33,13,20
050,31,059,"Nebraska","Fillmore County",2,84,35,11,24
050,31,059,"Nebraska","Fillmore County",2,85,214,85,129
050,31,059,"Nebraska","Fillmore County",3,0,73,39,34
050,31,059,"Nebraska","Fillmore County",3,1,61,26,35
050,31,059,"Nebraska","Fillmore County",3,2,62,33,29
050,31,059,"Nebraska","Fillmore County",3,3,58,30,28
050,31,059,"Nebraska","Fillmore County",3,4,67,30,37
050,31,059,"Nebraska","Fillmore County",3,5,58,27,31
050,31,059,"Nebraska","Fillmore County",3,6,61,34,27
050,31,059,"Nebraska","Fillmore County",3,7,68,38,30
050,31,059,"Nebraska","Fillmore County",3,8,56,33,23
050,31,059,"Nebraska","Fillmore County",3,9,53,34,19
050,31,059,"Nebraska","Fillmore County",3,10,45,23,22
050,31,059,"Nebraska","Fillmore County",3,11,64,30,34
050,31,059,"Nebraska","Fillmore County",3,12,63,33,30
050,31,059,"Nebraska","Fillmore County",3,13,65,28,37
050,31,059,"Nebraska","Fillmore County",3,14,62,29,33
050,31,059,"Nebraska","Fillmore County",3,15,58,30,28
050,31,059,"Nebraska","Fillmore County",3,16,50,25,25
050,31,059,"Nebraska","Fillmore County",3,17,62,33,29
050,31,059,"Nebraska","Fillmore County",3,18,52,29,23
050,31,059,"Nebraska","Fillmore County",3,19,44,23,21
050,31,059,"Nebraska","Fillmore County",3,20,47,27,20
050,31,059,"Nebraska","Fillmore County",3,21,45,27,18
050,31,059,"Nebraska","Fillmore County",3,22,55,32,23
050,31,059,"Nebraska","Fillmore County",3,23,44,24,20
050,31,059,"Nebraska","Fillmore County",3,24,51,23,28
050,31,059,"Nebraska","Fillmore County",3,25,50,25,25
050,31,059,"Nebraska","Fillmore County",3,26,64,38,26
050,31,059,"Nebraska","Fillmore County",3,27,63,31,32
050,31,059,"Nebraska","Fillmore County",3,28,61,29,32
050,31,059,"Nebraska","Fillmore County",3,29,60,32,28
050,31,059,"Nebraska","Fillmore County",3,30,67,33,34
050,31,059,"Nebraska","Fillmore County",3,31,67,33,34
050,31,059,"Nebraska","Fillmore County",3,32,73,38,35
050,31,059,"Nebraska","Fillmore County",3,33,78,39,39
050,31,059,"Nebraska","Fillmore County",3,34,72,33,39
050,31,059,"Nebraska","Fillmore County",3,35,67,34,33
050,31,059,"Nebraska","Fillmore County",3,36,69,34,35
050,31,059,"Nebraska","Fillmore County",3,37,65,33,32
050,31,059,"Nebraska","Fillmore County",3,38,62,28,34
050,31,059,"Nebraska","Fillmore County",3,39,76,38,38
050,31,059,"Nebraska","Fillmore County",3,40,78,42,36
050,31,059,"Nebraska","Fillmore County",3,41,67,39,28
050,31,059,"Nebraska","Fillmore County",3,42,63,36,27
050,31,059,"Nebraska","Fillmore County",3,43,59,32,27
050,31,059,"Nebraska","Fillmore County",3,44,64,35,29
050,31,059,"Nebraska","Fillmore County",3,45,56,32,24
050,31,059,"Nebraska","Fillmore County",3,46,65,33,32
050,31,059,"Nebraska","Fillmore County",3,47,50,26,24
050,31,059,"Nebraska","Fillmore County",3,48,49,30,19
050,31,059,"Nebraska","Fillmore County",3,49,59,33,26
050,31,059,"Nebraska","Fillmore County",3,50,63,35,28
050,31,059,"Nebraska","Fillmore County",3,51,60,29,31
050,31,059,"Nebraska","Fillmore County",3,52,63,27,36
050,31,059,"Nebraska","Fillmore County",3,53,70,31,39
050,31,059,"Nebraska","Fillmore County",3,54,79,43,36
050,31,059,"Nebraska","Fillmore County",3,55,82,48,34
050,31,059,"Nebraska","Fillmore County",3,56,94,52,42
050,31,059,"Nebraska","Fillmore County",3,57,87,40,47
050,31,059,"Nebraska","Fillmore County",3,58,83,41,42
050,31,059,"Nebraska","Fillmore County",3,59,89,46,43
050,31,059,"Nebraska","Fillmore County",3,60,97,46,51
050,31,059,"Nebraska","Fillmore County",3,61,104,51,53
050,31,059,"Nebraska","Fillmore County",3,62,96,50,46
050,31,059,"Nebraska","Fillmore County",3,63,86,47,39
050,31,059,"Nebraska","Fillmore County",3,64,80,47,33
050,31,059,"Nebraska","Fillmore County",3,65,86,41,45
050,31,059,"Nebraska","Fillmore County",3,66,81,40,41
050,31,059,"Nebraska","Fillmore County",3,67,80,40,40
050,31,059,"Nebraska","Fillmore County",3,68,81,44,37
050,31,059,"Nebraska","Fillmore County",3,69,82,43,39
050,31,059,"Nebraska","Fillmore County",3,70,73,37,36
050,31,059,"Nebraska","Fillmore County",3,71,65,29,36
050,31,059,"Nebraska","Fillmore County",3,72,60,26,34
050,31,059,"Nebraska","Fillmore County",3,73,55,23,32
050,31,059,"Nebraska","Fillmore County",3,74,56,28,28
050,31,059,"Nebraska","Fillmore County",3,75,45,21,24
050,31,059,"Nebraska","Fillmore County",3,76,42,20,22
050,31,059,"Nebraska","Fillmore County",3,77,41,21,20
050,31,059,"Nebraska","Fillmore County",3,78,43,24,19
050,31,059,"Nebraska","Fillmore County",3,79,39,16,23
050,31,059,"Nebraska","Fillmore County",3,80,34,12,22
050,31,059,"Nebraska","Fillmore County",3,81,26,10,16
050,31,059,"Nebraska","Fillmore County",3,82,34,16,18
050,31,059,"Nebraska","Fillmore County",3,83,36,16,20
050,31,059,"Nebraska","Fillmore County",3,84,34,12,22
050,31,059,"Nebraska","Fillmore County",3,85,205,82,123
050,31,059,"Nebraska","Fillmore County",4,0,58,34,24
050,31,059,"Nebraska","Fillmore County",4,1,66,38,28
050,31,059,"Nebraska","Fillmore County",4,2,59,24,35
050,31,059,"Nebraska","Fillmore County",4,3,71,38,33
050,31,059,"Nebraska","Fillmore County",4,4,58,28,30
050,31,059,"Nebraska","Fillmore County",4,5,62,28,34
050,31,059,"Nebraska","Fillmore County",4,6,60,27,33
050,31,059,"Nebraska","Fillmore County",4,7,58,31,27
050,31,059,"Nebraska","Fillmore County",4,8,68,40,28
050,31,059,"Nebraska","Fillmore County",4,9,52,31,21
050,31,059,"Nebraska","Fillmore County",4,10,56,38,18
050,31,059,"Nebraska","Fillmore County",4,11,46,25,21
050,31,059,"Nebraska","Fillmore County",4,12,64,29,35
050,31,059,"Nebraska","Fillmore County",4,13,61,30,31
050,31,059,"Nebraska","Fillmore County",4,14,69,30,39
050,31,059,"Nebraska","Fillmore County",4,15,63,30,33
050,31,059,"Nebraska","Fillmore County",4,16,58,29,29
050,31,059,"Nebraska","Fillmore County",4,17,52,22,30
050,31,059,"Nebraska","Fillmore County",4,18,48,27,21
050,31,059,"Nebraska","Fillmore County",4,19,45,24,21
050,31,059,"Nebraska","Fillmore County",4,20,46,26,20
050,31,059,"Nebraska","Fillmore County",4,21,45,22,23
050,31,059,"Nebraska","Fillmore County",4,22,52,28,24
050,31,059,"Nebraska","Fillmore County",4,23,51,30,21
050,31,059,"Nebraska","Fillmore County",4,24,36,21,15
050,31,059,"Nebraska","Fillmore County",4,25,54,25,29
050,31,059,"Nebraska","Fillmore County",4,26,46,25,21
050,31,059,"Nebraska","Fillmore County",4,27,63,35,28
050,31,059,"Nebraska","Fillmore County",4,28,61,31,30
050,31,059,"Nebraska","Fillmore County",4,29,59,30,29
050,31,059,"Nebraska","Fillmore County",4,30,58,29,29
050,31,059,"Nebraska","Fillmore County",4,31,63,31,32
050,31,059,"Nebraska","Fillmore County",4,32,64,31,33
050,31,059,"Nebraska","Fillmore County",4,33,70,36,34
050,31,059,"Nebraska","Fillmore County",4,34,77,39,38
050,31,059,"Nebraska","Fillmore County",4,35,81,39,42
050,31,059,"Nebraska","Fillmore County",4,36,66,34,32
050,31,059,"Nebraska","Fillmore County",4,37,70,34,36
050,31,059,"Nebraska","Fillmore County",4,38,61,32,29
050,31,059,"Nebraska","Fillmore County",4,39,65,29,36
050,31,059,"Nebraska","Fillmore County",4,40,80,41,39
050,31,059,"Nebraska","Fillmore County",4,41,75,42,33
050,31,059,"Nebraska","Fillmore County",4,42,68,39,29
050,31,059,"Nebraska","Fillmore County",4,43,62,36,26
050,31,059,"Nebraska","Fillmore County",4,44,61,33,28
050,31,059,"Nebraska","Fillmore County",4,45,64,35,29
050,31,059,"Nebraska","Fillmore County",4,46,60,32,28
050,31,059,"Nebraska","Fillmore County",4,47,63,32,31
050,31,059,"Nebraska","Fillmore County",4,48,46,25,21
050,31,059,"Nebraska","Fillmore County",4,49,49,30,19
050,31,059,"Nebraska","Fillmore County",4,50,56,32,24
050,31,059,"Nebraska","Fillmore County",4,51,63,36,27
050,31,059,"Nebraska","Fillmore County",4,52,65,30,35
050,31,059,"Nebraska","Fillmore County",4,53,60,24,36
050,31,059,"Nebraska","Fillmore County",4,54,71,31,40
050,31,059,"Nebraska","Fillmore County",4,55,77,42,35
050,31,059,"Nebraska","Fillmore County",4,56,81,44,37
050,31,059,"Nebraska","Fillmore County",4,57,94,52,42
050,31,059,"Nebraska","Fillmore County",4,58,87,40,47
050,31,059,"Nebraska","Fillmore County",4,59,89,44,45
050,31,059,"Nebraska","Fillmore County",4,60,83,43,40
050,31,059,"Nebraska","Fillmore County",4,61,97,45,52
050,31,059,"Nebraska","Fillmore County",4,62,104,51,53
050,31,059,"Nebraska","Fillmore County",4,63,94,49,45
050,31,059,"Nebraska","Fillmore County",4,64,82,45,37
050,31,059,"Nebraska","Fillmore County",4,65,78,46,32
050,31,059,"Nebraska","Fillmore County",4,66,85,43,42
050,31,059,"Nebraska","Fillmore County",4,67,81,38,43
050,31,059,"Nebraska","Fillmore County",4,68,82,40,42
050,31,059,"Nebraska","Fillmore County",4,69,77,41,36
050,31,059,"Nebraska","Fillmore County",4,70,81,43,38
050,31,059,"Nebraska","Fillmore County",4,71,70,35,35
050,31,059,"Nebraska","Fillmore County",4,72,62,29,33
050,31,059,"Nebraska","Fillmore County",4,73,60,26,34
050,31,059,"Nebraska","Fillmore County",4,74,54,23,31
050,31,059,"Nebraska","Fillmore County",4,75,53,26,27
050,31,059,"Nebraska","Fillmore County",4,76,47,22,25
050,31,059,"Nebraska","Fillmore County",4,77,41,19,22
050,31,059,"Nebraska","Fillmore County",4,78,41,20,21
050,31,059,"Nebraska","Fillmore County",4,79,44,21,23
050,31,059,"Nebraska","Fillmore County",4,80,33,14,19
050,31,059,"Nebraska","Fillmore County",4,81,35,12,23
050,31,059,"Nebraska","Fillmore County",4,82,27,9,18
050,31,059,"Nebraska","Fillmore County",4,83,29,12,17
050,31,059,"Nebraska","Fillmore County",4,84,39,16,23
050,31,059,"Nebraska","Fillmore County",4,85,229,91,138
050,31,059,"Nebraska","Fillmore County",5,0,60,35,25
050,31,059,"Nebraska","Fillmore County",5,1,53,30,23
050,31,059,"Nebraska","Fillmore County",5,2,65,36,29
050,31,059,"Nebraska","Fillmore County",5,3,66,30,36
050,31,059,"Nebraska","Fillmore County",5,4,72,37,35
050,31,059,"Nebraska","Fillmore County",5,5,56,25,31
050,31,059,"Nebraska","Fillmore County",5,6,66,28,38
050,31,059,"Nebraska","Fillmore County",5,7,58,27,31
050,31,059,"Nebraska","Fillmore County",5,8,57,30,27
050,31,059,"Nebraska","Fillmore County",5,9,69,38,31
050,31,059,"Nebraska","Fillmore County",5,10,60,36,24
050,31,059,"Nebraska","Fillmore County",5,11,54,35,19
050,31,059,"Nebraska","Fillmore County",5,12,51,26,25
050,31,059,"Nebraska","Fillmore County",5,13,67,33,34
050,31,059,"Nebraska","Fillmore County",5,14,62,30,32
050,31,059,"Nebraska","Fillmore County",5,15,70,31,39
050,31,059,"Nebraska","Fillmore County",5,16,66,31,35
050,31,059,"Nebraska","Fillmore County",5,17,61,28,33
050,31,059,"Nebraska","Fillmore County",5,18,42,22,20
050,31,059,"Nebraska","Fillmore County",5,19,34,21,13
050,31,059,"Nebraska","Fillmore County",5,20,49,23,26
050,31,059,"Nebraska","Fillmore County",5,21,48,26,22
050,31,059,"Nebraska","Fillmore County",5,22,50,25,25
050,31,059,"Nebraska","Fillmore County",5,23,45,22,23
050,31,059,"Nebraska","Fillmore County",5,24,61,34,27
050,31,059,"Nebraska","Fillmore County",5,25,36,20,16
050,31,059,"Nebraska","Fillmore County",5,26,54,26,28
050,31,059,"Nebraska","Fillmore County",5,27,46,24,22
050,31,059,"Nebraska","Fillmore County",5,28,60,34,26
050,31,059,"Nebraska","Fillmore County",5,29,64,34,30
050,31,059,"Nebraska","Fillmore County",5,30,63,33,30
050,31,059,"Nebraska","Fillmore County",5,31,59,31,28
050,31,059,"Nebraska","Fillmore County",5,32,67,32,35
050,31,059,"Nebraska","Fillmore County",5,33,69,33,36
050,31,059,"Nebraska","Fillmore County",5,34,67,34,33
050,31,059,"Nebraska","Fillmore County",5,35,82,42,40
050,31,059,"Nebraska","Fillmore County",5,36,75,37,38
050,31,059,"Nebraska","Fillmore County",5,37,69,35,34
050,31,059,"Nebraska","Fillmore County",5,38,67,32,35
050,31,059,"Nebraska","Fillmore County",5,39,61,32,29
050,31,059,"Nebraska","Fillmore County",5,40,71,34,37
050,31,059,"Nebraska","Fillmore County",5,41,81,40,41
050,31,059,"Nebraska","Fillmore County",5,42,72,38,34
050,31,059,"Nebraska","Fillmore County",5,43,70,41,29
050,31,059,"Nebraska","Fillmore County",5,44,63,36,27
050,31,059,"Nebraska","Fillmore County",5,45,67,37,30
050,31,059,"Nebraska","Fillmore County",5,46,62,33,29
050,31,059,"Nebraska","Fillmore County",5,47,60,34,26
050,31,059,"Nebraska","Fillmore County",5,48,59,29,30
050,31,059,"Nebraska","Fillmore County",5,49,45,23,22
050,31,059,"Nebraska","Fillmore County",5,50,52,31,21
050,31,059,"Nebraska","Fillmore County",5,51,55,31,24
050,31,059,"Nebraska","Fillmore County",5,52,66,38,28
050,31,059,"Nebraska","Fillmore County",5,53,65,29,36
050,31,059,"Nebraska","Fillmore County",5,54,63,25,38
050,31,059,"Nebraska","Fillmore County",5,55,71,31,40
050,31,059,"Nebraska","Fillmore County",5,56,78,43,35
050,31,059,"Nebraska","Fillmore County",5,57,85,44,41
050,31,059,"Nebraska","Fillmore County",5,58,94,51,43
050,31,059,"Nebraska","Fillmore County",5,59,89,41,48
050,31,059,"Nebraska","Fillmore County",5,60,86,41,45
050,31,059,"Nebraska","Fillmore County",5,61,81,41,40
050,31,059,"Nebraska","Fillmore County",5,62,95,43,52
050,31,059,"Nebraska","Fillmore County",5,63,104,51,53
050,31,059,"Nebraska","Fillmore County",5,64,93,50,43
050,31,059,"Nebraska","Fillmore County",5,65,80,43,37
050,31,059,"Nebraska","Fillmore County",5,66,82,48,34
050,31,059,"Nebraska","Fillmore County",5,67,83,41,42
050,31,059,"Nebraska","Fillmore County",5,68,82,38,44
050,31,059,"Nebraska","Fillmore County",5,69,79,39,40
050,31,059,"Nebraska","Fillmore County",5,70,76,41,35
050,31,059,"Nebraska","Fillmore County",5,71,78,41,37
050,31,059,"Nebraska","Fillmore County",5,72,67,33,34
050,31,059,"Nebraska","Fillmore County",5,73,63,29,34
050,31,059,"Nebraska","Fillmore County",5,74,58,26,32
050,31,059,"Nebraska","Fillmore County",5,75,49,21,28
050,31,059,"Nebraska","Fillmore County",5,76,53,27,26
050,31,059,"Nebraska","Fillmore County",5,77,46,22,24
050,31,059,"Nebraska","Fillmore County",5,78,40,19,21
050,31,059,"Nebraska","Fillmore County",5,79,40,17,23
050,31,059,"Nebraska","Fillmore County",5,80,37,20,17
050,31,059,"Nebraska","Fillmore County",5,81,33,14,19
050,31,059,"Nebraska","Fillmore County",5,82,33,10,23
050,31,059,"Nebraska","Fillmore County",5,83,19,5,14
050,31,059,"Nebraska","Fillmore County",5,84,27,9,18
050,31,059,"Nebraska","Fillmore County",5,85,215,89,126
050,31,061,"Nebraska","Franklin County",1,0,35,18,17
050,31,061,"Nebraska","Franklin County",1,1,39,21,18
050,31,061,"Nebraska","Franklin County",1,2,34,18,16
050,31,061,"Nebraska","Franklin County",1,3,35,17,18
050,31,061,"Nebraska","Franklin County",1,4,29,12,17
050,31,061,"Nebraska","Franklin County",1,5,30,14,16
050,31,061,"Nebraska","Franklin County",1,6,29,16,13
050,31,061,"Nebraska","Franklin County",1,7,31,18,13
050,31,061,"Nebraska","Franklin County",1,8,28,12,16
050,31,061,"Nebraska","Franklin County",1,9,33,19,14
050,31,061,"Nebraska","Franklin County",1,10,38,24,14
050,31,061,"Nebraska","Franklin County",1,11,40,24,16
050,31,061,"Nebraska","Franklin County",1,12,40,23,17
050,31,061,"Nebraska","Franklin County",1,13,34,18,16
050,31,061,"Nebraska","Franklin County",1,14,33,17,16
050,31,061,"Nebraska","Franklin County",1,15,31,17,14
050,31,061,"Nebraska","Franklin County",1,16,34,17,17
050,31,061,"Nebraska","Franklin County",1,17,35,18,17
050,31,061,"Nebraska","Franklin County",1,18,26,12,14
050,31,061,"Nebraska","Franklin County",1,19,25,12,13
050,31,061,"Nebraska","Franklin County",1,20,26,11,15
050,31,061,"Nebraska","Franklin County",1,21,17,8,9
050,31,061,"Nebraska","Franklin County",1,22,30,14,16
050,31,061,"Nebraska","Franklin County",1,23,30,12,18
050,31,061,"Nebraska","Franklin County",1,24,24,9,15
050,31,061,"Nebraska","Franklin County",1,25,24,11,13
050,31,061,"Nebraska","Franklin County",1,26,23,12,11
050,31,061,"Nebraska","Franklin County",1,27,25,14,11
050,31,061,"Nebraska","Franklin County",1,28,31,14,17
050,31,061,"Nebraska","Franklin County",1,29,26,12,14
050,31,061,"Nebraska","Franklin County",1,30,27,12,15
050,31,061,"Nebraska","Franklin County",1,31,25,14,11
050,31,061,"Nebraska","Franklin County",1,32,28,17,11
050,31,061,"Nebraska","Franklin County",1,33,25,11,14
050,31,061,"Nebraska","Franklin County",1,34,32,16,16
050,31,061,"Nebraska","Franklin County",1,35,39,20,19
050,31,061,"Nebraska","Franklin County",1,36,28,14,14
050,31,061,"Nebraska","Franklin County",1,37,29,15,14
050,31,061,"Nebraska","Franklin County",1,38,26,15,11
050,31,061,"Nebraska","Franklin County",1,39,25,13,12
050,31,061,"Nebraska","Franklin County",1,40,29,10,19
050,31,061,"Nebraska","Franklin County",1,41,36,15,21
050,31,061,"Nebraska","Franklin County",1,42,37,17,20
050,31,061,"Nebraska","Franklin County",1,43,29,15,14
050,31,061,"Nebraska","Franklin County",1,44,29,14,15
050,31,061,"Nebraska","Franklin County",1,45,25,14,11
050,31,061,"Nebraska","Franklin County",1,46,24,12,12
050,31,061,"Nebraska","Franklin County",1,47,25,14,11
050,31,061,"Nebraska","Franklin County",1,48,28,14,14
050,31,061,"Nebraska","Franklin County",1,49,34,16,18
050,31,061,"Nebraska","Franklin County",1,50,31,15,16
050,31,061,"Nebraska","Franklin County",1,51,26,11,15
050,31,061,"Nebraska","Franklin County",1,52,28,12,16
050,31,061,"Nebraska","Franklin County",1,53,30,15,15
050,31,061,"Nebraska","Franklin County",1,54,33,18,15
050,31,061,"Nebraska","Franklin County",1,55,35,21,14
050,31,061,"Nebraska","Franklin County",1,56,41,24,17
050,31,061,"Nebraska","Franklin County",1,57,37,17,20
050,31,061,"Nebraska","Franklin County",1,58,45,22,23
050,31,061,"Nebraska","Franklin County",1,59,57,31,26
050,31,061,"Nebraska","Franklin County",1,60,54,30,24
050,31,061,"Nebraska","Franklin County",1,61,52,25,27
050,31,061,"Nebraska","Franklin County",1,62,53,25,28
050,31,061,"Nebraska","Franklin County",1,63,43,23,20
050,31,061,"Nebraska","Franklin County",1,64,47,26,21
050,31,061,"Nebraska","Franklin County",1,65,51,28,23
050,31,061,"Nebraska","Franklin County",1,66,45,27,18
050,31,061,"Nebraska","Franklin County",1,67,54,32,22
050,31,061,"Nebraska","Franklin County",1,68,48,27,21
050,31,061,"Nebraska","Franklin County",1,69,43,23,20
050,31,061,"Nebraska","Franklin County",1,70,45,18,27
050,31,061,"Nebraska","Franklin County",1,71,35,15,20
050,31,061,"Nebraska","Franklin County",1,72,38,20,18
050,31,061,"Nebraska","Franklin County",1,73,38,19,19
050,31,061,"Nebraska","Franklin County",1,74,23,11,12
050,31,061,"Nebraska","Franklin County",1,75,21,10,11
050,31,061,"Nebraska","Franklin County",1,76,29,13,16
050,31,061,"Nebraska","Franklin County",1,77,30,12,18
050,31,061,"Nebraska","Franklin County",1,78,28,12,16
050,31,061,"Nebraska","Franklin County",1,79,24,8,16
050,31,061,"Nebraska","Franklin County",1,80,26,13,13
050,31,061,"Nebraska","Franklin County",1,81,24,11,13
050,31,061,"Nebraska","Franklin County",1,82,20,8,12
050,31,061,"Nebraska","Franklin County",1,83,19,9,10
050,31,061,"Nebraska","Franklin County",1,84,23,14,9
050,31,061,"Nebraska","Franklin County",1,85,118,49,69
050,31,061,"Nebraska","Franklin County",2,0,39,19,20
050,31,061,"Nebraska","Franklin County",2,1,37,19,18
050,31,061,"Nebraska","Franklin County",2,2,35,19,16
050,31,061,"Nebraska","Franklin County",2,3,33,16,17
050,31,061,"Nebraska","Franklin County",2,4,30,13,17
050,31,061,"Nebraska","Franklin County",2,5,29,13,16
050,31,061,"Nebraska","Franklin County",2,6,29,17,12
050,31,061,"Nebraska","Franklin County",2,7,31,18,13
050,31,061,"Nebraska","Franklin County",2,8,28,13,15
050,31,061,"Nebraska","Franklin County",2,9,33,18,15
050,31,061,"Nebraska","Franklin County",2,10,37,23,14
050,31,061,"Nebraska","Franklin County",2,11,40,24,16
050,31,061,"Nebraska","Franklin County",2,12,41,24,17
050,31,061,"Nebraska","Franklin County",2,13,35,19,16
050,31,061,"Nebraska","Franklin County",2,14,34,18,16
050,31,061,"Nebraska","Franklin County",2,15,32,18,14
050,31,061,"Nebraska","Franklin County",2,16,34,17,17
050,31,061,"Nebraska","Franklin County",2,17,34,18,16
050,31,061,"Nebraska","Franklin County",2,18,26,12,14
050,31,061,"Nebraska","Franklin County",2,19,24,11,13
050,31,061,"Nebraska","Franklin County",2,20,25,11,14
050,31,061,"Nebraska","Franklin County",2,21,21,10,11
050,31,061,"Nebraska","Franklin County",2,22,28,13,15
050,31,061,"Nebraska","Franklin County",2,23,30,12,18
050,31,061,"Nebraska","Franklin County",2,24,25,10,15
050,31,061,"Nebraska","Franklin County",2,25,23,10,13
050,31,061,"Nebraska","Franklin County",2,26,23,12,11
050,31,061,"Nebraska","Franklin County",2,27,24,13,11
050,31,061,"Nebraska","Franklin County",2,28,30,14,16
050,31,061,"Nebraska","Franklin County",2,29,28,13,15
050,31,061,"Nebraska","Franklin County",2,30,26,11,15
050,31,061,"Nebraska","Franklin County",2,31,25,14,11
050,31,061,"Nebraska","Franklin County",2,32,27,16,11
050,31,061,"Nebraska","Franklin County",2,33,26,13,13
050,31,061,"Nebraska","Franklin County",2,34,31,15,16
050,31,061,"Nebraska","Franklin County",2,35,37,19,18
050,31,061,"Nebraska","Franklin County",2,36,31,16,15
050,31,061,"Nebraska","Franklin County",2,37,29,15,14
050,31,061,"Nebraska","Franklin County",2,38,28,16,12
050,31,061,"Nebraska","Franklin County",2,39,25,13,12
050,31,061,"Nebraska","Franklin County",2,40,29,11,18
050,31,061,"Nebraska","Franklin County",2,41,35,15,20
050,31,061,"Nebraska","Franklin County",2,42,38,17,21
050,31,061,"Nebraska","Franklin County",2,43,31,16,15
050,31,061,"Nebraska","Franklin County",2,44,27,13,14
050,31,061,"Nebraska","Franklin County",2,45,26,14,12
050,31,061,"Nebraska","Franklin County",2,46,24,12,12
050,31,061,"Nebraska","Franklin County",2,47,25,14,11
050,31,061,"Nebraska","Franklin County",2,48,28,14,14
050,31,061,"Nebraska","Franklin County",2,49,33,16,17
050,31,061,"Nebraska","Franklin County",2,50,33,16,17
050,31,061,"Nebraska","Franklin County",2,51,27,12,15
050,31,061,"Nebraska","Franklin County",2,52,28,12,16
050,31,061,"Nebraska","Franklin County",2,53,29,14,15
050,31,061,"Nebraska","Franklin County",2,54,32,17,15
050,31,061,"Nebraska","Franklin County",2,55,34,20,14
050,31,061,"Nebraska","Franklin County",2,56,39,23,16
050,31,061,"Nebraska","Franklin County",2,57,37,18,19
050,31,061,"Nebraska","Franklin County",2,58,43,21,22
050,31,061,"Nebraska","Franklin County",2,59,55,29,26
050,31,061,"Nebraska","Franklin County",2,60,54,30,24
050,31,061,"Nebraska","Franklin County",2,61,52,26,26
050,31,061,"Nebraska","Franklin County",2,62,53,25,28
050,31,061,"Nebraska","Franklin County",2,63,45,23,22
050,31,061,"Nebraska","Franklin County",2,64,45,24,21
050,31,061,"Nebraska","Franklin County",2,65,50,28,22
050,31,061,"Nebraska","Franklin County",2,66,46,27,19
050,31,061,"Nebraska","Franklin County",2,67,52,31,21
050,31,061,"Nebraska","Franklin County",2,68,49,28,21
050,31,061,"Nebraska","Franklin County",2,69,44,24,20
050,31,061,"Nebraska","Franklin County",2,70,44,19,25
050,31,061,"Nebraska","Franklin County",2,71,37,16,21
050,31,061,"Nebraska","Franklin County",2,72,37,19,18
050,31,061,"Nebraska","Franklin County",2,73,39,19,20
050,31,061,"Nebraska","Franklin County",2,74,24,12,12
050,31,061,"Nebraska","Franklin County",2,75,21,9,12
050,31,061,"Nebraska","Franklin County",2,76,27,12,15
050,31,061,"Nebraska","Franklin County",2,77,31,13,18
050,31,061,"Nebraska","Franklin County",2,78,28,12,16
050,31,061,"Nebraska","Franklin County",2,79,24,8,16
050,31,061,"Nebraska","Franklin County",2,80,26,12,14
050,31,061,"Nebraska","Franklin County",2,81,23,11,12
050,31,061,"Nebraska","Franklin County",2,82,20,8,12
050,31,061,"Nebraska","Franklin County",2,83,19,9,10
050,31,061,"Nebraska","Franklin County",2,84,22,13,9
050,31,061,"Nebraska","Franklin County",2,85,121,52,69
050,31,061,"Nebraska","Franklin County",3,0,23,11,12
050,31,061,"Nebraska","Franklin County",3,1,41,20,21
050,31,061,"Nebraska","Franklin County",3,2,33,18,15
050,31,061,"Nebraska","Franklin County",3,3,40,22,18
050,31,061,"Nebraska","Franklin County",3,4,38,20,18
050,31,061,"Nebraska","Franklin County",3,5,27,13,14
050,31,061,"Nebraska","Franklin County",3,6,32,14,18
050,31,061,"Nebraska","Franklin County",3,7,28,17,11
050,31,061,"Nebraska","Franklin County",3,8,34,20,14
050,31,061,"Nebraska","Franklin County",3,9,31,13,18
050,31,061,"Nebraska","Franklin County",3,10,35,19,16
050,31,061,"Nebraska","Franklin County",3,11,39,24,15
050,31,061,"Nebraska","Franklin County",3,12,42,24,18
050,31,061,"Nebraska","Franklin County",3,13,38,24,14
050,31,061,"Nebraska","Franklin County",3,14,34,19,15
050,31,061,"Nebraska","Franklin County",3,15,32,19,13
050,31,061,"Nebraska","Franklin County",3,16,31,17,14
050,31,061,"Nebraska","Franklin County",3,17,33,16,17
050,31,061,"Nebraska","Franklin County",3,18,30,19,11
050,31,061,"Nebraska","Franklin County",3,19,20,9,11
050,31,061,"Nebraska","Franklin County",3,20,23,12,11
050,31,061,"Nebraska","Franklin County",3,21,26,12,14
050,31,061,"Nebraska","Franklin County",3,22,18,8,10
050,31,061,"Nebraska","Franklin County",3,23,33,14,19
050,31,061,"Nebraska","Franklin County",3,24,27,10,17
050,31,061,"Nebraska","Franklin County",3,25,19,7,12
050,31,061,"Nebraska","Franklin County",3,26,26,12,14
050,31,061,"Nebraska","Franklin County",3,27,19,9,10
050,31,061,"Nebraska","Franklin County",3,28,30,18,12
050,31,061,"Nebraska","Franklin County",3,29,28,12,16
050,31,061,"Nebraska","Franklin County",3,30,30,15,15
050,31,061,"Nebraska","Franklin County",3,31,26,9,17
050,31,061,"Nebraska","Franklin County",3,32,29,17,12
050,31,061,"Nebraska","Franklin County",3,33,26,15,11
050,31,061,"Nebraska","Franklin County",3,34,25,13,12
050,31,061,"Nebraska","Franklin County",3,35,29,14,15
050,31,061,"Nebraska","Franklin County",3,36,36,19,17
050,31,061,"Nebraska","Franklin County",3,37,37,20,17
050,31,061,"Nebraska","Franklin County",3,38,28,15,13
050,31,061,"Nebraska","Franklin County",3,39,29,15,14
050,31,061,"Nebraska","Franklin County",3,40,25,13,12
050,31,061,"Nebraska","Franklin County",3,41,35,15,20
050,31,061,"Nebraska","Franklin County",3,42,35,15,20
050,31,061,"Nebraska","Franklin County",3,43,41,17,24
050,31,061,"Nebraska","Franklin County",3,44,30,15,15
050,31,061,"Nebraska","Franklin County",3,45,27,13,14
050,31,061,"Nebraska","Franklin County",3,46,25,14,11
050,31,061,"Nebraska","Franklin County",3,47,23,12,11
050,31,061,"Nebraska","Franklin County",3,48,25,13,12
050,31,061,"Nebraska","Franklin County",3,49,29,14,15
050,31,061,"Nebraska","Franklin County",3,50,32,17,15
050,31,061,"Nebraska","Franklin County",3,51,33,16,17
050,31,061,"Nebraska","Franklin County",3,52,26,12,14
050,31,061,"Nebraska","Franklin County",3,53,28,12,16
050,31,061,"Nebraska","Franklin County",3,54,27,13,14
050,31,061,"Nebraska","Franklin County",3,55,29,15,14
050,31,061,"Nebraska","Franklin County",3,56,35,21,14
050,31,061,"Nebraska","Franklin County",3,57,38,22,16
050,31,061,"Nebraska","Franklin County",3,58,34,17,17
050,31,061,"Nebraska","Franklin County",3,59,42,20,22
050,31,061,"Nebraska","Franklin County",3,60,55,30,25
050,31,061,"Nebraska","Franklin County",3,61,55,30,25
050,31,061,"Nebraska","Franklin County",3,62,56,26,30
050,31,061,"Nebraska","Franklin County",3,63,53,25,28
050,31,061,"Nebraska","Franklin County",3,64,44,23,21
050,31,061,"Nebraska","Franklin County",3,65,46,25,21
050,31,061,"Nebraska","Franklin County",3,66,50,28,22
050,31,061,"Nebraska","Franklin County",3,67,45,26,19
050,31,061,"Nebraska","Franklin County",3,68,51,30,21
050,31,061,"Nebraska","Franklin County",3,69,49,27,22
050,31,061,"Nebraska","Franklin County",3,70,43,24,19
050,31,061,"Nebraska","Franklin County",3,71,43,19,24
050,31,061,"Nebraska","Franklin County",3,72,36,16,20
050,31,061,"Nebraska","Franklin County",3,73,38,19,19
050,31,061,"Nebraska","Franklin County",3,74,35,16,19
050,31,061,"Nebraska","Franklin County",3,75,22,10,12
050,31,061,"Nebraska","Franklin County",3,76,23,10,13
050,31,061,"Nebraska","Franklin County",3,77,25,10,15
050,31,061,"Nebraska","Franklin County",3,78,31,13,18
050,31,061,"Nebraska","Franklin County",3,79,24,12,12
050,31,061,"Nebraska","Franklin County",3,80,22,8,14
050,31,061,"Nebraska","Franklin County",3,81,24,13,11
050,31,061,"Nebraska","Franklin County",3,82,21,9,12
050,31,061,"Nebraska","Franklin County",3,83,19,8,11
050,31,061,"Nebraska","Franklin County",3,84,19,9,10
050,31,061,"Nebraska","Franklin County",3,85,125,56,69
050,31,061,"Nebraska","Franklin County",4,0,28,14,14
050,31,061,"Nebraska","Franklin County",4,1,22,7,15
050,31,061,"Nebraska","Franklin County",4,2,48,25,23
050,31,061,"Nebraska","Franklin County",4,3,34,19,15
050,31,061,"Nebraska","Franklin County",4,4,36,22,14
050,31,061,"Nebraska","Franklin County",4,5,40,20,20
050,31,061,"Nebraska","Franklin County",4,6,24,10,14
050,31,061,"Nebraska","Franklin County",4,7,36,18,18
050,31,061,"Nebraska","Franklin County",4,8,33,19,14
050,31,061,"Nebraska","Franklin County",4,9,31,18,13
050,31,061,"Nebraska","Franklin County",4,10,26,11,15
050,31,061,"Nebraska","Franklin County",4,11,35,21,14
050,31,061,"Nebraska","Franklin County",4,12,42,26,16
050,31,061,"Nebraska","Franklin County",4,13,40,25,15
050,31,061,"Nebraska","Franklin County",4,14,37,23,14
050,31,061,"Nebraska","Franklin County",4,15,35,19,16
050,31,061,"Nebraska","Franklin County",4,16,31,18,13
050,31,061,"Nebraska","Franklin County",4,17,36,18,18
050,31,061,"Nebraska","Franklin County",4,18,27,13,14
050,31,061,"Nebraska","Franklin County",4,19,21,15,6
050,31,061,"Nebraska","Franklin County",4,20,18,7,11
050,31,061,"Nebraska","Franklin County",4,21,24,11,13
050,31,061,"Nebraska","Franklin County",4,22,28,12,16
050,31,061,"Nebraska","Franklin County",4,23,17,8,9
050,31,061,"Nebraska","Franklin County",4,24,31,16,15
050,31,061,"Nebraska","Franklin County",4,25,32,13,19
050,31,061,"Nebraska","Franklin County",4,26,16,7,9
050,31,061,"Nebraska","Franklin County",4,27,27,14,13
050,31,061,"Nebraska","Franklin County",4,28,21,10,11
050,31,061,"Nebraska","Franklin County",4,29,28,18,10
050,31,061,"Nebraska","Franklin County",4,30,31,14,17
050,31,061,"Nebraska","Franklin County",4,31,32,15,17
050,31,061,"Nebraska","Franklin County",4,32,29,11,18
050,31,061,"Nebraska","Franklin County",4,33,28,17,11
050,31,061,"Nebraska","Franklin County",4,34,30,17,13
050,31,061,"Nebraska","Franklin County",4,35,21,10,11
050,31,061,"Nebraska","Franklin County",4,36,30,16,14
050,31,061,"Nebraska","Franklin County",4,37,36,19,17
050,31,061,"Nebraska","Franklin County",4,38,36,20,16
050,31,061,"Nebraska","Franklin County",4,39,28,15,13
050,31,061,"Nebraska","Franklin County",4,40,26,13,13
050,31,061,"Nebraska","Franklin County",4,41,22,10,12
050,31,061,"Nebraska","Franklin County",4,42,35,15,20
050,31,061,"Nebraska","Franklin County",4,43,33,15,18
050,31,061,"Nebraska","Franklin County",4,44,39,18,21
050,31,061,"Nebraska","Franklin County",4,45,29,14,15
050,31,061,"Nebraska","Franklin County",4,46,28,13,15
050,31,061,"Nebraska","Franklin County",4,47,28,17,11
050,31,061,"Nebraska","Franklin County",4,48,24,12,12
050,31,061,"Nebraska","Franklin County",4,49,28,15,13
050,31,061,"Nebraska","Franklin County",4,50,28,14,14
050,31,061,"Nebraska","Franklin County",4,51,33,17,16
050,31,061,"Nebraska","Franklin County",4,52,31,15,16
050,31,061,"Nebraska","Franklin County",4,53,28,13,15
050,31,061,"Nebraska","Franklin County",4,54,27,11,16
050,31,061,"Nebraska","Franklin County",4,55,28,13,15
050,31,061,"Nebraska","Franklin County",4,56,31,15,16
050,31,061,"Nebraska","Franklin County",4,57,36,22,14
050,31,061,"Nebraska","Franklin County",4,58,38,22,16
050,31,061,"Nebraska","Franklin County",4,59,35,18,17
050,31,061,"Nebraska","Franklin County",4,60,40,20,20
050,31,061,"Nebraska","Franklin County",4,61,52,29,23
050,31,061,"Nebraska","Franklin County",4,62,53,30,23
050,31,061,"Nebraska","Franklin County",4,63,55,25,30
050,31,061,"Nebraska","Franklin County",4,64,53,25,28
050,31,061,"Nebraska","Franklin County",4,65,42,23,19
050,31,061,"Nebraska","Franklin County",4,66,43,23,20
050,31,061,"Nebraska","Franklin County",4,67,50,27,23
050,31,061,"Nebraska","Franklin County",4,68,43,24,19
050,31,061,"Nebraska","Franklin County",4,69,54,30,24
050,31,061,"Nebraska","Franklin County",4,70,48,26,22
050,31,061,"Nebraska","Franklin County",4,71,42,24,18
050,31,061,"Nebraska","Franklin County",4,72,41,19,22
050,31,061,"Nebraska","Franklin County",4,73,33,14,19
050,31,061,"Nebraska","Franklin County",4,74,35,17,18
050,31,061,"Nebraska","Franklin County",4,75,32,13,19
050,31,061,"Nebraska","Franklin County",4,76,24,11,13
050,31,061,"Nebraska","Franklin County",4,77,22,9,13
050,31,061,"Nebraska","Franklin County",4,78,22,8,14
050,31,061,"Nebraska","Franklin County",4,79,28,12,16
050,31,061,"Nebraska","Franklin County",4,80,22,12,10
050,31,061,"Nebraska","Franklin County",4,81,22,8,14
050,31,061,"Nebraska","Franklin County",4,82,23,12,11
050,31,061,"Nebraska","Franklin County",4,83,18,9,9
050,31,061,"Nebraska","Franklin County",4,84,17,6,11
050,31,061,"Nebraska","Franklin County",4,85,124,58,66
050,31,061,"Nebraska","Franklin County",5,0,24,11,13
050,31,061,"Nebraska","Franklin County",5,1,29,13,16
050,31,061,"Nebraska","Franklin County",5,2,25,8,17
050,31,061,"Nebraska","Franklin County",5,3,41,21,20
050,31,061,"Nebraska","Franklin County",5,4,34,20,14
050,31,061,"Nebraska","Franklin County",5,5,33,20,13
050,31,061,"Nebraska","Franklin County",5,6,40,22,18
050,31,061,"Nebraska","Franklin County",5,7,27,13,14
050,31,061,"Nebraska","Franklin County",5,8,34,17,17
050,31,061,"Nebraska","Franklin County",5,9,32,19,13
050,31,061,"Nebraska","Franklin County",5,10,33,19,14
050,31,061,"Nebraska","Franklin County",5,11,27,13,14
050,31,061,"Nebraska","Franklin County",5,12,35,22,13
050,31,061,"Nebraska","Franklin County",5,13,39,25,14
050,31,061,"Nebraska","Franklin County",5,14,45,26,19
050,31,061,"Nebraska","Franklin County",5,15,39,23,16
050,31,061,"Nebraska","Franklin County",5,16,36,20,16
050,31,061,"Nebraska","Franklin County",5,17,29,16,13
050,31,061,"Nebraska","Franklin County",5,18,27,14,13
050,31,061,"Nebraska","Franklin County",5,19,20,10,10
050,31,061,"Nebraska","Franklin County",5,20,22,14,8
050,31,061,"Nebraska","Franklin County",5,21,19,6,13
050,31,061,"Nebraska","Franklin County",5,22,24,12,12
050,31,061,"Nebraska","Franklin County",5,23,26,13,13
050,31,061,"Nebraska","Franklin County",5,24,24,11,13
050,31,061,"Nebraska","Franklin County",5,25,30,17,13
050,31,061,"Nebraska","Franklin County",5,26,37,19,18
050,31,061,"Nebraska","Franklin County",5,27,18,8,10
050,31,061,"Nebraska","Franklin County",5,28,26,14,12
050,31,061,"Nebraska","Franklin County",5,29,21,9,12
050,31,061,"Nebraska","Franklin County",5,30,28,17,11
050,31,061,"Nebraska","Franklin County",5,31,28,13,15
050,31,061,"Nebraska","Franklin County",5,32,30,14,16
050,31,061,"Nebraska","Franklin County",5,33,31,14,17
050,31,061,"Nebraska","Franklin County",5,34,29,16,13
050,31,061,"Nebraska","Franklin County",5,35,33,18,15
050,31,061,"Nebraska","Franklin County",5,36,25,11,14
050,31,061,"Nebraska","Franklin County",5,37,30,16,14
050,31,061,"Nebraska","Franklin County",5,38,37,21,16
050,31,061,"Nebraska","Franklin County",5,39,36,20,16
050,31,061,"Nebraska","Franklin County",5,40,27,14,13
050,31,061,"Nebraska","Franklin County",5,41,27,13,14
050,31,061,"Nebraska","Franklin County",5,42,22,10,12
050,31,061,"Nebraska","Franklin County",5,43,36,17,19
050,31,061,"Nebraska","Franklin County",5,44,35,18,17
050,31,061,"Nebraska","Franklin County",5,45,37,16,21
050,31,061,"Nebraska","Franklin County",5,46,34,15,19
050,31,061,"Nebraska","Franklin County",5,47,28,13,15
050,31,061,"Nebraska","Franklin County",5,48,27,16,11
050,31,061,"Nebraska","Franklin County",5,49,29,12,17
050,31,061,"Nebraska","Franklin County",5,50,29,16,13
050,31,061,"Nebraska","Franklin County",5,51,29,15,14
050,31,061,"Nebraska","Franklin County",5,52,33,17,16
050,31,061,"Nebraska","Franklin County",5,53,30,13,17
050,31,061,"Nebraska","Franklin County",5,54,26,12,14
050,31,061,"Nebraska","Franklin County",5,55,25,11,14
050,31,061,"Nebraska","Franklin County",5,56,26,12,14
050,31,061,"Nebraska","Franklin County",5,57,29,14,15
050,31,061,"Nebraska","Franklin County",5,58,36,21,15
050,31,061,"Nebraska","Franklin County",5,59,41,24,17
050,31,061,"Nebraska","Franklin County",5,60,32,16,16
050,31,061,"Nebraska","Franklin County",5,61,39,22,17
050,31,061,"Nebraska","Franklin County",5,62,55,31,24
050,31,061,"Nebraska","Franklin County",5,63,52,29,23
050,31,061,"Nebraska","Franklin County",5,64,54,25,29
050,31,061,"Nebraska","Franklin County",5,65,54,27,27
050,31,061,"Nebraska","Franklin County",5,66,41,22,19
050,31,061,"Nebraska","Franklin County",5,67,43,22,21
050,31,061,"Nebraska","Franklin County",5,68,47,26,21
050,31,061,"Nebraska","Franklin County",5,69,38,19,19
050,31,061,"Nebraska","Franklin County",5,70,51,29,22
050,31,061,"Nebraska","Franklin County",5,71,48,25,23
050,31,061,"Nebraska","Franklin County",5,72,43,26,17
050,31,061,"Nebraska","Franklin County",5,73,40,18,22
050,31,061,"Nebraska","Franklin County",5,74,30,12,18
050,31,061,"Nebraska","Franklin County",5,75,31,15,16
050,31,061,"Nebraska","Franklin County",5,76,32,14,18
050,31,061,"Nebraska","Franklin County",5,77,23,9,14
050,31,061,"Nebraska","Franklin County",5,78,17,7,10
050,31,061,"Nebraska","Franklin County",5,79,19,6,13
050,31,061,"Nebraska","Franklin County",5,80,26,12,14
050,31,061,"Nebraska","Franklin County",5,81,24,13,11
050,31,061,"Nebraska","Franklin County",5,82,21,7,14
050,31,061,"Nebraska","Franklin County",5,83,22,13,9
050,31,061,"Nebraska","Franklin County",5,84,15,7,8
050,31,061,"Nebraska","Franklin County",5,85,119,54,65
050,31,063,"Nebraska","Frontier County",1,0,25,13,12
050,31,063,"Nebraska","Frontier County",1,1,23,13,10
050,31,063,"Nebraska","Frontier County",1,2,25,14,11
050,31,063,"Nebraska","Frontier County",1,3,24,12,12
050,31,063,"Nebraska","Frontier County",1,4,29,14,15
050,31,063,"Nebraska","Frontier County",1,5,30,15,15
050,31,063,"Nebraska","Frontier County",1,6,29,15,14
050,31,063,"Nebraska","Frontier County",1,7,29,12,17
050,31,063,"Nebraska","Frontier County",1,8,24,17,7
050,31,063,"Nebraska","Frontier County",1,9,25,20,5
050,31,063,"Nebraska","Frontier County",1,10,19,12,7
050,31,063,"Nebraska","Frontier County",1,11,36,21,15
050,31,063,"Nebraska","Frontier County",1,12,29,16,13
050,31,063,"Nebraska","Frontier County",1,13,31,16,15
050,31,063,"Nebraska","Frontier County",1,14,31,16,15
050,31,063,"Nebraska","Frontier County",1,15,32,20,12
050,31,063,"Nebraska","Frontier County",1,16,22,15,7
050,31,063,"Nebraska","Frontier County",1,17,20,12,8
050,31,063,"Nebraska","Frontier County",1,18,43,23,20
050,31,063,"Nebraska","Frontier County",1,19,77,41,36
050,31,063,"Nebraska","Frontier County",1,20,40,17,23
050,31,063,"Nebraska","Frontier County",1,21,24,13,11
050,31,063,"Nebraska","Frontier County",1,22,28,16,12
050,31,063,"Nebraska","Frontier County",1,23,22,14,8
050,31,063,"Nebraska","Frontier County",1,24,32,17,15
050,31,063,"Nebraska","Frontier County",1,25,33,19,14
050,31,063,"Nebraska","Frontier County",1,26,17,9,8
050,31,063,"Nebraska","Frontier County",1,27,17,8,9
050,31,063,"Nebraska","Frontier County",1,28,18,10,8
050,31,063,"Nebraska","Frontier County",1,29,24,11,13
050,31,063,"Nebraska","Frontier County",1,30,32,17,15
050,31,063,"Nebraska","Frontier County",1,31,23,10,13
050,31,063,"Nebraska","Frontier County",1,32,25,10,15
050,31,063,"Nebraska","Frontier County",1,33,26,12,14
050,31,063,"Nebraska","Frontier County",1,34,21,10,11
050,31,063,"Nebraska","Frontier County",1,35,24,12,12
050,31,063,"Nebraska","Frontier County",1,36,27,11,16
050,31,063,"Nebraska","Frontier County",1,37,25,12,13
050,31,063,"Nebraska","Frontier County",1,38,26,14,12
050,31,063,"Nebraska","Frontier County",1,39,28,15,13
050,31,063,"Nebraska","Frontier County",1,40,27,12,15
050,31,063,"Nebraska","Frontier County",1,41,25,16,9
050,31,063,"Nebraska","Frontier County",1,42,22,10,12
050,31,063,"Nebraska","Frontier County",1,43,21,12,9
050,31,063,"Nebraska","Frontier County",1,44,25,14,11
050,31,063,"Nebraska","Frontier County",1,45,28,15,13
050,31,063,"Nebraska","Frontier County",1,46,27,14,13
050,31,063,"Nebraska","Frontier County",1,47,28,12,16
050,31,063,"Nebraska","Frontier County",1,48,33,14,19
050,31,063,"Nebraska","Frontier County",1,49,30,12,18
050,31,063,"Nebraska","Frontier County",1,50,29,15,14
050,31,063,"Nebraska","Frontier County",1,51,28,14,14
050,31,063,"Nebraska","Frontier County",1,52,28,14,14
050,31,063,"Nebraska","Frontier County",1,53,21,9,12
050,31,063,"Nebraska","Frontier County",1,54,25,11,14
050,31,063,"Nebraska","Frontier County",1,55,26,12,14
050,31,063,"Nebraska","Frontier County",1,56,31,15,16
050,31,063,"Nebraska","Frontier County",1,57,32,19,13
050,31,063,"Nebraska","Frontier County",1,58,36,17,19
050,31,063,"Nebraska","Frontier County",1,59,39,20,19
050,31,063,"Nebraska","Frontier County",1,60,42,24,18
050,31,063,"Nebraska","Frontier County",1,61,38,20,18
050,31,063,"Nebraska","Frontier County",1,62,39,26,13
050,31,063,"Nebraska","Frontier County",1,63,58,34,24
050,31,063,"Nebraska","Frontier County",1,64,39,22,17
050,31,063,"Nebraska","Frontier County",1,65,36,19,17
050,31,063,"Nebraska","Frontier County",1,66,40,21,19
050,31,063,"Nebraska","Frontier County",1,67,31,14,17
050,31,063,"Nebraska","Frontier County",1,68,37,17,20
050,31,063,"Nebraska","Frontier County",1,69,35,15,20
050,31,063,"Nebraska","Frontier County",1,70,29,10,19
050,31,063,"Nebraska","Frontier County",1,71,35,20,15
050,31,063,"Nebraska","Frontier County",1,72,33,20,13
050,31,063,"Nebraska","Frontier County",1,73,33,19,14
050,31,063,"Nebraska","Frontier County",1,74,21,11,10
050,31,063,"Nebraska","Frontier County",1,75,26,14,12
050,31,063,"Nebraska","Frontier County",1,76,23,11,12
050,31,063,"Nebraska","Frontier County",1,77,22,8,14
050,31,063,"Nebraska","Frontier County",1,78,15,9,6
050,31,063,"Nebraska","Frontier County",1,79,17,7,10
050,31,063,"Nebraska","Frontier County",1,80,17,10,7
050,31,063,"Nebraska","Frontier County",1,81,23,11,12
050,31,063,"Nebraska","Frontier County",1,82,12,5,7
050,31,063,"Nebraska","Frontier County",1,83,14,7,7
050,31,063,"Nebraska","Frontier County",1,84,22,11,11
050,31,063,"Nebraska","Frontier County",1,85,102,35,67
050,31,063,"Nebraska","Frontier County",2,0,25,13,12
050,31,063,"Nebraska","Frontier County",2,1,23,13,10
050,31,063,"Nebraska","Frontier County",2,2,24,14,10
050,31,063,"Nebraska","Frontier County",2,3,24,12,12
050,31,063,"Nebraska","Frontier County",2,4,28,14,14
050,31,063,"Nebraska","Frontier County",2,5,29,15,14
050,31,063,"Nebraska","Frontier County",2,6,29,15,14
050,31,063,"Nebraska","Frontier County",2,7,29,13,16
050,31,063,"Nebraska","Frontier County",2,8,25,16,9
050,31,063,"Nebraska","Frontier County",2,9,24,19,5
050,31,063,"Nebraska","Frontier County",2,10,21,14,7
050,31,063,"Nebraska","Frontier County",2,11,32,19,13
050,31,063,"Nebraska","Frontier County",2,12,30,17,13
050,31,063,"Nebraska","Frontier County",2,13,31,16,15
050,31,063,"Nebraska","Frontier County",2,14,30,16,14
050,31,063,"Nebraska","Frontier County",2,15,33,20,13
050,31,063,"Nebraska","Frontier County",2,16,24,16,8
050,31,063,"Nebraska","Frontier County",2,17,20,12,8
050,31,063,"Nebraska","Frontier County",2,18,41,22,19
050,31,063,"Nebraska","Frontier County",2,19,76,41,35
050,31,063,"Nebraska","Frontier County",2,20,40,17,23
050,31,063,"Nebraska","Frontier County",2,21,25,13,12
050,31,063,"Nebraska","Frontier County",2,22,26,16,10
050,31,063,"Nebraska","Frontier County",2,23,23,14,9
050,31,063,"Nebraska","Frontier County",2,24,29,16,13
050,31,063,"Nebraska","Frontier County",2,25,32,19,13
050,31,063,"Nebraska","Frontier County",2,26,20,11,9
050,31,063,"Nebraska","Frontier County",2,27,17,8,9
050,31,063,"Nebraska","Frontier County",2,28,17,9,8
050,31,063,"Nebraska","Frontier County",2,29,23,11,12
050,31,063,"Nebraska","Frontier County",2,30,31,16,15
050,31,063,"Nebraska","Frontier County",2,31,25,11,14
050,31,063,"Nebraska","Frontier County",2,32,24,10,14
050,31,063,"Nebraska","Frontier County",2,33,27,13,14
050,31,063,"Nebraska","Frontier County",2,34,21,10,11
050,31,063,"Nebraska","Frontier County",2,35,24,12,12
050,31,063,"Nebraska","Frontier County",2,36,25,10,15
050,31,063,"Nebraska","Frontier County",2,37,25,12,13
050,31,063,"Nebraska","Frontier County",2,38,27,14,13
050,31,063,"Nebraska","Frontier County",2,39,27,15,12
050,31,063,"Nebraska","Frontier County",2,40,28,13,15
050,31,063,"Nebraska","Frontier County",2,41,26,15,11
050,31,063,"Nebraska","Frontier County",2,42,22,11,11
050,31,063,"Nebraska","Frontier County",2,43,22,12,10
050,31,063,"Nebraska","Frontier County",2,44,24,14,10
050,31,063,"Nebraska","Frontier County",2,45,28,15,13
050,31,063,"Nebraska","Frontier County",2,46,27,14,13
050,31,063,"Nebraska","Frontier County",2,47,27,12,15
050,31,063,"Nebraska","Frontier County",2,48,32,13,19
050,31,063,"Nebraska","Frontier County",2,49,31,13,18
050,31,063,"Nebraska","Frontier County",2,50,29,15,14
050,31,063,"Nebraska","Frontier County",2,51,27,14,13
050,31,063,"Nebraska","Frontier County",2,52,27,14,13
050,31,063,"Nebraska","Frontier County",2,53,22,10,12
050,31,063,"Nebraska","Frontier County",2,54,23,10,13
050,31,063,"Nebraska","Frontier County",2,55,26,12,14
050,31,063,"Nebraska","Frontier County",2,56,30,14,16
050,31,063,"Nebraska","Frontier County",2,57,32,18,14
050,31,063,"Nebraska","Frontier County",2,58,36,18,18
050,31,063,"Nebraska","Frontier County",2,59,39,20,19
050,31,063,"Nebraska","Frontier County",2,60,40,23,17
050,31,063,"Nebraska","Frontier County",2,61,38,21,17
050,31,063,"Nebraska","Frontier County",2,62,38,24,14
050,31,063,"Nebraska","Frontier County",2,63,54,33,21
050,31,063,"Nebraska","Frontier County",2,64,43,25,18
050,31,063,"Nebraska","Frontier County",2,65,38,20,18
050,31,063,"Nebraska","Frontier County",2,66,40,21,19
050,31,063,"Nebraska","Frontier County",2,67,32,15,17
050,31,063,"Nebraska","Frontier County",2,68,35,16,19
050,31,063,"Nebraska","Frontier County",2,69,36,16,20
050,31,063,"Nebraska","Frontier County",2,70,30,11,19
050,31,063,"Nebraska","Frontier County",2,71,33,18,15
050,31,063,"Nebraska","Frontier County",2,72,33,19,14
050,31,063,"Nebraska","Frontier County",2,73,35,21,14
050,31,063,"Nebraska","Frontier County",2,74,22,12,10
050,31,063,"Nebraska","Frontier County",2,75,25,13,12
050,31,063,"Nebraska","Frontier County",2,76,23,11,12
050,31,063,"Nebraska","Frontier County",2,77,23,9,14
050,31,063,"Nebraska","Frontier County",2,78,17,9,8
050,31,063,"Nebraska","Frontier County",2,79,15,6,9
050,31,063,"Nebraska","Frontier County",2,80,17,9,8
050,31,063,"Nebraska","Frontier County",2,81,22,11,11
050,31,063,"Nebraska","Frontier County",2,82,15,7,8
050,31,063,"Nebraska","Frontier County",2,83,13,7,6
050,31,063,"Nebraska","Frontier County",2,84,18,9,9
050,31,063,"Nebraska","Frontier County",2,85,102,36,66
050,31,063,"Nebraska","Frontier County",3,0,21,11,10
050,31,063,"Nebraska","Frontier County",3,1,22,11,11
050,31,063,"Nebraska","Frontier County",3,2,25,11,14
050,31,063,"Nebraska","Frontier County",3,3,23,12,11
050,31,063,"Nebraska","Frontier County",3,4,25,11,14
050,31,063,"Nebraska","Frontier County",3,5,27,13,14
050,31,063,"Nebraska","Frontier County",3,6,28,12,16
050,31,063,"Nebraska","Frontier County",3,7,29,13,16
050,31,063,"Nebraska","Frontier County",3,8,29,13,16
050,31,063,"Nebraska","Frontier County",3,9,26,17,9
050,31,063,"Nebraska","Frontier County",3,10,22,16,6
050,31,063,"Nebraska","Frontier County",3,11,26,14,12
050,31,063,"Nebraska","Frontier County",3,12,35,22,13
050,31,063,"Nebraska","Frontier County",3,13,33,19,14
050,31,063,"Nebraska","Frontier County",3,14,32,15,17
050,31,063,"Nebraska","Frontier County",3,15,33,17,16
050,31,063,"Nebraska","Frontier County",3,16,33,22,11
050,31,063,"Nebraska","Frontier County",3,17,21,14,7
050,31,063,"Nebraska","Frontier County",3,18,35,20,15
050,31,063,"Nebraska","Frontier County",3,19,79,43,36
050,31,063,"Nebraska","Frontier County",3,20,47,21,26
050,31,063,"Nebraska","Frontier County",3,21,33,17,16
050,31,063,"Nebraska","Frontier County",3,22,30,18,12
050,31,063,"Nebraska","Frontier County",3,23,26,15,11
050,31,063,"Nebraska","Frontier County",3,24,22,12,10
050,31,063,"Nebraska","Frontier County",3,25,26,16,10
050,31,063,"Nebraska","Frontier County",3,26,25,14,11
050,31,063,"Nebraska","Frontier County",3,27,22,11,11
050,31,063,"Nebraska","Frontier County",3,28,21,12,9
050,31,063,"Nebraska","Frontier County",3,29,22,8,14
050,31,063,"Nebraska","Frontier County",3,30,24,12,12
050,31,063,"Nebraska","Frontier County",3,31,29,16,13
050,31,063,"Nebraska","Frontier County",3,32,26,12,14
050,31,063,"Nebraska","Frontier County",3,33,25,13,12
050,31,063,"Nebraska","Frontier County",3,34,26,12,14
050,31,063,"Nebraska","Frontier County",3,35,21,10,11
050,31,063,"Nebraska","Frontier County",3,36,23,11,12
050,31,063,"Nebraska","Frontier County",3,37,27,11,16
050,31,063,"Nebraska","Frontier County",3,38,26,12,14
050,31,063,"Nebraska","Frontier County",3,39,27,13,14
050,31,063,"Nebraska","Frontier County",3,40,29,17,12
050,31,063,"Nebraska","Frontier County",3,41,26,13,13
050,31,063,"Nebraska","Frontier County",3,42,26,14,12
050,31,063,"Nebraska","Frontier County",3,43,22,12,10
050,31,063,"Nebraska","Frontier County",3,44,22,12,10
050,31,063,"Nebraska","Frontier County",3,45,24,14,10
050,31,063,"Nebraska","Frontier County",3,46,30,15,15
050,31,063,"Nebraska","Frontier County",3,47,29,16,13
050,31,063,"Nebraska","Frontier County",3,48,28,12,16
050,31,063,"Nebraska","Frontier County",3,49,32,13,19
050,31,063,"Nebraska","Frontier County",3,50,32,13,19
050,31,063,"Nebraska","Frontier County",3,51,30,18,12
050,31,063,"Nebraska","Frontier County",3,52,28,14,14
050,31,063,"Nebraska","Frontier County",3,53,30,17,13
050,31,063,"Nebraska","Frontier County",3,54,23,11,12
050,31,063,"Nebraska","Frontier County",3,55,24,10,14
050,31,063,"Nebraska","Frontier County",3,56,29,15,14
050,31,063,"Nebraska","Frontier County",3,57,30,13,17
050,31,063,"Nebraska","Frontier County",3,58,32,18,14
050,31,063,"Nebraska","Frontier County",3,59,34,17,17
050,31,063,"Nebraska","Frontier County",3,60,39,20,19
050,31,063,"Nebraska","Frontier County",3,61,43,26,17
050,31,063,"Nebraska","Frontier County",3,62,38,21,17
050,31,063,"Nebraska","Frontier County",3,63,38,24,14
050,31,063,"Nebraska","Frontier County",3,64,56,35,21
050,31,063,"Nebraska","Frontier County",3,65,45,26,19
050,31,063,"Nebraska","Frontier County",3,66,38,20,18
050,31,063,"Nebraska","Frontier County",3,67,38,19,19
050,31,063,"Nebraska","Frontier County",3,68,31,14,17
050,31,063,"Nebraska","Frontier County",3,69,35,16,19
050,31,063,"Nebraska","Frontier County",3,70,36,16,20
050,31,063,"Nebraska","Frontier County",3,71,27,9,18
050,31,063,"Nebraska","Frontier County",3,72,33,18,15
050,31,063,"Nebraska","Frontier County",3,73,34,19,15
050,31,063,"Nebraska","Frontier County",3,74,36,22,14
050,31,063,"Nebraska","Frontier County",3,75,21,11,10
050,31,063,"Nebraska","Frontier County",3,76,21,11,10
050,31,063,"Nebraska","Frontier County",3,77,24,11,13
050,31,063,"Nebraska","Frontier County",3,78,19,6,13
050,31,063,"Nebraska","Frontier County",3,79,18,9,9
050,31,063,"Nebraska","Frontier County",3,80,14,6,8
050,31,063,"Nebraska","Frontier County",3,81,16,9,7
050,31,063,"Nebraska","Frontier County",3,82,22,11,11
050,31,063,"Nebraska","Frontier County",3,83,14,8,6
050,31,063,"Nebraska","Frontier County",3,84,13,7,6
050,31,063,"Nebraska","Frontier County",3,85,103,34,69
050,31,063,"Nebraska","Frontier County",4,0,20,13,7
050,31,063,"Nebraska","Frontier County",4,1,27,15,12
050,31,063,"Nebraska","Frontier County",4,2,24,11,13
050,31,063,"Nebraska","Frontier County",4,3,31,14,17
050,31,063,"Nebraska","Frontier County",4,4,29,16,13
050,31,063,"Nebraska","Frontier County",4,5,26,11,15
050,31,063,"Nebraska","Frontier County",4,6,36,20,16
050,31,063,"Nebraska","Frontier County",4,7,31,15,16
050,31,063,"Nebraska","Frontier County",4,8,30,11,19
050,31,063,"Nebraska","Frontier County",4,9,33,18,15
050,31,063,"Nebraska","Frontier County",4,10,28,17,11
050,31,063,"Nebraska","Frontier County",4,11,22,17,5
050,31,063,"Nebraska","Frontier County",4,12,24,14,10
050,31,063,"Nebraska","Frontier County",4,13,35,20,15
050,31,063,"Nebraska","Frontier County",4,14,36,22,14
050,31,063,"Nebraska","Frontier County",4,15,33,15,18
050,31,063,"Nebraska","Frontier County",4,16,36,21,15
050,31,063,"Nebraska","Frontier County",4,17,35,22,13
050,31,063,"Nebraska","Frontier County",4,18,37,20,17
050,31,063,"Nebraska","Frontier County",4,19,73,39,34
050,31,063,"Nebraska","Frontier County",4,20,42,19,23
050,31,063,"Nebraska","Frontier County",4,21,29,16,13
050,31,063,"Nebraska","Frontier County",4,22,34,19,15
050,31,063,"Nebraska","Frontier County",4,23,30,16,14
050,31,063,"Nebraska","Frontier County",4,24,26,12,14
050,31,063,"Nebraska","Frontier County",4,25,17,10,7
050,31,063,"Nebraska","Frontier County",4,26,28,17,11
050,31,063,"Nebraska","Frontier County",4,27,29,15,14
050,31,063,"Nebraska","Frontier County",4,28,21,9,12
050,31,063,"Nebraska","Frontier County",4,29,28,15,13
050,31,063,"Nebraska","Frontier County",4,30,22,8,14
050,31,063,"Nebraska","Frontier County",4,31,26,13,13
050,31,063,"Nebraska","Frontier County",4,32,27,15,12
050,31,063,"Nebraska","Frontier County",4,33,28,12,16
050,31,063,"Nebraska","Frontier County",4,34,21,9,12
050,31,063,"Nebraska","Frontier County",4,35,32,16,16
050,31,063,"Nebraska","Frontier County",4,36,25,14,11
050,31,063,"Nebraska","Frontier County",4,37,26,12,14
050,31,063,"Nebraska","Frontier County",4,38,26,12,14
050,31,063,"Nebraska","Frontier County",4,39,27,12,15
050,31,063,"Nebraska","Frontier County",4,40,29,14,15
050,31,063,"Nebraska","Frontier County",4,41,30,18,12
050,31,063,"Nebraska","Frontier County",4,42,25,12,13
050,31,063,"Nebraska","Frontier County",4,43,27,14,13
050,31,063,"Nebraska","Frontier County",4,44,23,12,11
050,31,063,"Nebraska","Frontier County",4,45,23,12,11
050,31,063,"Nebraska","Frontier County",4,46,23,13,10
050,31,063,"Nebraska","Frontier County",4,47,28,15,13
050,31,063,"Nebraska","Frontier County",4,48,29,16,13
050,31,063,"Nebraska","Frontier County",4,49,28,12,16
050,31,063,"Nebraska","Frontier County",4,50,35,16,19
050,31,063,"Nebraska","Frontier County",4,51,32,13,19
050,31,063,"Nebraska","Frontier County",4,52,31,18,13
050,31,063,"Nebraska","Frontier County",4,53,26,12,14
050,31,063,"Nebraska","Frontier County",4,54,30,17,13
050,31,063,"Nebraska","Frontier County",4,55,19,8,11
050,31,063,"Nebraska","Frontier County",4,56,24,10,14
050,31,063,"Nebraska","Frontier County",4,57,30,15,15
050,31,063,"Nebraska","Frontier County",4,58,30,13,17
050,31,063,"Nebraska","Frontier County",4,59,31,17,14
050,31,063,"Nebraska","Frontier County",4,60,34,17,17
050,31,063,"Nebraska","Frontier County",4,61,39,21,18
050,31,063,"Nebraska","Frontier County",4,62,41,24,17
050,31,063,"Nebraska","Frontier County",4,63,38,21,17
050,31,063,"Nebraska","Frontier County",4,64,38,24,14
050,31,063,"Nebraska","Frontier County",4,65,57,34,23
050,31,063,"Nebraska","Frontier County",4,66,44,25,19
050,31,063,"Nebraska","Frontier County",4,67,37,19,18
050,31,063,"Nebraska","Frontier County",4,68,37,20,17
050,31,063,"Nebraska","Frontier County",4,69,32,15,17
050,31,063,"Nebraska","Frontier County",4,70,34,16,18
050,31,063,"Nebraska","Frontier County",4,71,35,16,19
050,31,063,"Nebraska","Frontier County",4,72,26,9,17
050,31,063,"Nebraska","Frontier County",4,73,34,18,16
050,31,063,"Nebraska","Frontier County",4,74,35,19,16
050,31,063,"Nebraska","Frontier County",4,75,36,23,13
050,31,063,"Nebraska","Frontier County",4,76,20,10,10
050,31,063,"Nebraska","Frontier County",4,77,23,13,10
050,31,063,"Nebraska","Frontier County",4,78,22,11,11
050,31,063,"Nebraska","Frontier County",4,79,20,7,13
050,31,063,"Nebraska","Frontier County",4,80,17,9,8
050,31,063,"Nebraska","Frontier County",4,81,14,6,8
050,31,063,"Nebraska","Frontier County",4,82,17,9,8
050,31,063,"Nebraska","Frontier County",4,83,21,12,9
050,31,063,"Nebraska","Frontier County",4,84,15,8,7
050,31,063,"Nebraska","Frontier County",4,85,102,31,71
050,31,063,"Nebraska","Frontier County",5,0,19,13,6
050,31,063,"Nebraska","Frontier County",5,1,19,12,7
050,31,063,"Nebraska","Frontier County",5,2,26,15,11
050,31,063,"Nebraska","Frontier County",5,3,24,12,12
050,31,063,"Nebraska","Frontier County",5,4,29,12,17
050,31,063,"Nebraska","Frontier County",5,5,30,19,11
050,31,063,"Nebraska","Frontier County",5,6,26,12,14
050,31,063,"Nebraska","Frontier County",5,7,28,15,13
050,31,063,"Nebraska","Frontier County",5,8,30,15,15
050,31,063,"Nebraska","Frontier County",5,9,31,14,17
050,31,063,"Nebraska","Frontier County",5,10,29,17,12
050,31,063,"Nebraska","Frontier County",5,11,29,18,11
050,31,063,"Nebraska","Frontier County",5,12,24,18,6
050,31,063,"Nebraska","Frontier County",5,13,29,17,12
050,31,063,"Nebraska","Frontier County",5,14,40,24,16
050,31,063,"Nebraska","Frontier County",5,15,37,22,15
050,31,063,"Nebraska","Frontier County",5,16,34,16,18
050,31,063,"Nebraska","Frontier County",5,17,41,22,19
050,31,063,"Nebraska","Frontier County",5,18,48,28,20
050,31,063,"Nebraska","Frontier County",5,19,73,41,32
050,31,063,"Nebraska","Frontier County",5,20,34,17,17
050,31,063,"Nebraska","Frontier County",5,21,31,18,13
050,31,063,"Nebraska","Frontier County",5,22,29,15,14
050,31,063,"Nebraska","Frontier County",5,23,32,18,14
050,31,063,"Nebraska","Frontier County",5,24,35,17,18
050,31,063,"Nebraska","Frontier County",5,25,27,16,11
050,31,063,"Nebraska","Frontier County",5,26,18,11,7
050,31,063,"Nebraska","Frontier County",5,27,26,16,10
050,31,063,"Nebraska","Frontier County",5,28,29,15,14
050,31,063,"Nebraska","Frontier County",5,29,18,7,11
050,31,063,"Nebraska","Frontier County",5,30,26,15,11
050,31,063,"Nebraska","Frontier County",5,31,21,8,13
050,31,063,"Nebraska","Frontier County",5,32,25,12,13
050,31,063,"Nebraska","Frontier County",5,33,24,11,13
050,31,063,"Nebraska","Frontier County",5,34,29,13,16
050,31,063,"Nebraska","Frontier County",5,35,21,9,12
050,31,063,"Nebraska","Frontier County",5,36,38,19,19
050,31,063,"Nebraska","Frontier County",5,37,27,16,11
050,31,063,"Nebraska","Frontier County",5,38,26,13,13
050,31,063,"Nebraska","Frontier County",5,39,31,13,18
050,31,063,"Nebraska","Frontier County",5,40,24,11,13
050,31,063,"Nebraska","Frontier County",5,41,29,14,15
050,31,063,"Nebraska","Frontier County",5,42,28,16,12
050,31,063,"Nebraska","Frontier County",5,43,26,13,13
050,31,063,"Nebraska","Frontier County",5,44,21,12,9
050,31,063,"Nebraska","Frontier County",5,45,23,12,11
050,31,063,"Nebraska","Frontier County",5,46,23,11,12
050,31,063,"Nebraska","Frontier County",5,47,24,14,10
050,31,063,"Nebraska","Frontier County",5,48,23,12,11
050,31,063,"Nebraska","Frontier County",5,49,27,16,11
050,31,063,"Nebraska","Frontier County",5,50,30,13,17
050,31,063,"Nebraska","Frontier County",5,51,36,14,22
050,31,063,"Nebraska","Frontier County",5,52,34,15,19
050,31,063,"Nebraska","Frontier County",5,53,31,17,14
050,31,063,"Nebraska","Frontier County",5,54,27,12,15
050,31,063,"Nebraska","Frontier County",5,55,28,17,11
050,31,063,"Nebraska","Frontier County",5,56,19,8,11
050,31,063,"Nebraska","Frontier County",5,57,25,10,15
050,31,063,"Nebraska","Frontier County",5,58,28,15,13
050,31,063,"Nebraska","Frontier County",5,59,28,12,16
050,31,063,"Nebraska","Frontier County",5,60,27,15,12
050,31,063,"Nebraska","Frontier County",5,61,29,13,16
050,31,063,"Nebraska","Frontier County",5,62,40,22,18
050,31,063,"Nebraska","Frontier County",5,63,43,26,17
050,31,063,"Nebraska","Frontier County",5,64,36,21,15
050,31,063,"Nebraska","Frontier County",5,65,38,22,16
050,31,063,"Nebraska","Frontier County",5,66,58,33,25
050,31,063,"Nebraska","Frontier County",5,67,44,24,20
050,31,063,"Nebraska","Frontier County",5,68,36,19,17
050,31,063,"Nebraska","Frontier County",5,69,37,20,17
050,31,063,"Nebraska","Frontier County",5,70,32,15,17
050,31,063,"Nebraska","Frontier County",5,71,35,18,17
050,31,063,"Nebraska","Frontier County",5,72,34,16,18
050,31,063,"Nebraska","Frontier County",5,73,27,10,17
050,31,063,"Nebraska","Frontier County",5,74,34,17,17
050,31,063,"Nebraska","Frontier County",5,75,32,19,13
050,31,063,"Nebraska","Frontier County",5,76,34,22,12
050,31,063,"Nebraska","Frontier County",5,77,20,9,11
050,31,063,"Nebraska","Frontier County",5,78,21,13,8
050,31,063,"Nebraska","Frontier County",5,79,22,10,12
050,31,063,"Nebraska","Frontier County",5,80,16,5,11
050,31,063,"Nebraska","Frontier County",5,81,17,9,8
050,31,063,"Nebraska","Frontier County",5,82,13,5,8
050,31,063,"Nebraska","Frontier County",5,83,16,10,6
050,31,063,"Nebraska","Frontier County",5,84,22,12,10
050,31,063,"Nebraska","Frontier County",5,85,95,29,66
050,31,065,"Nebraska","Furnas County",1,0,62,32,30
050,31,065,"Nebraska","Furnas County",1,1,62,37,25
050,31,065,"Nebraska","Furnas County",1,2,54,32,22
050,31,065,"Nebraska","Furnas County",1,3,58,32,26
050,31,065,"Nebraska","Furnas County",1,4,48,24,24
050,31,065,"Nebraska","Furnas County",1,5,52,25,27
050,31,065,"Nebraska","Furnas County",1,6,59,28,31
050,31,065,"Nebraska","Furnas County",1,7,53,29,24
050,31,065,"Nebraska","Furnas County",1,8,44,21,23
050,31,065,"Nebraska","Furnas County",1,9,46,23,23
050,31,065,"Nebraska","Furnas County",1,10,57,31,26
050,31,065,"Nebraska","Furnas County",1,11,61,35,26
050,31,065,"Nebraska","Furnas County",1,12,64,36,28
050,31,065,"Nebraska","Furnas County",1,13,54,23,31
050,31,065,"Nebraska","Furnas County",1,14,59,28,31
050,31,065,"Nebraska","Furnas County",1,15,72,37,35
050,31,065,"Nebraska","Furnas County",1,16,77,39,38
050,31,065,"Nebraska","Furnas County",1,17,65,37,28
050,31,065,"Nebraska","Furnas County",1,18,59,27,32
050,31,065,"Nebraska","Furnas County",1,19,47,21,26
050,31,065,"Nebraska","Furnas County",1,20,44,25,19
050,31,065,"Nebraska","Furnas County",1,21,40,24,16
050,31,065,"Nebraska","Furnas County",1,22,44,23,21
050,31,065,"Nebraska","Furnas County",1,23,47,26,21
050,31,065,"Nebraska","Furnas County",1,24,39,20,19
050,31,065,"Nebraska","Furnas County",1,25,33,16,17
050,31,065,"Nebraska","Furnas County",1,26,52,26,26
050,31,065,"Nebraska","Furnas County",1,27,53,24,29
050,31,065,"Nebraska","Furnas County",1,28,49,30,19
050,31,065,"Nebraska","Furnas County",1,29,44,22,22
050,31,065,"Nebraska","Furnas County",1,30,51,25,26
050,31,065,"Nebraska","Furnas County",1,31,41,26,15
050,31,065,"Nebraska","Furnas County",1,32,31,17,14
050,31,065,"Nebraska","Furnas County",1,33,35,18,17
050,31,065,"Nebraska","Furnas County",1,34,44,24,20
050,31,065,"Nebraska","Furnas County",1,35,46,23,23
050,31,065,"Nebraska","Furnas County",1,36,56,30,26
050,31,065,"Nebraska","Furnas County",1,37,52,24,28
050,31,065,"Nebraska","Furnas County",1,38,43,22,21
050,31,065,"Nebraska","Furnas County",1,39,39,22,17
050,31,065,"Nebraska","Furnas County",1,40,51,28,23
050,31,065,"Nebraska","Furnas County",1,41,51,28,23
050,31,065,"Nebraska","Furnas County",1,42,53,28,25
050,31,065,"Nebraska","Furnas County",1,43,46,23,23
050,31,065,"Nebraska","Furnas County",1,44,46,19,27
050,31,065,"Nebraska","Furnas County",1,45,46,16,30
050,31,065,"Nebraska","Furnas County",1,46,52,23,29
050,31,065,"Nebraska","Furnas County",1,47,49,23,26
050,31,065,"Nebraska","Furnas County",1,48,52,30,22
050,31,065,"Nebraska","Furnas County",1,49,59,38,21
050,31,065,"Nebraska","Furnas County",1,50,62,40,22
050,31,065,"Nebraska","Furnas County",1,51,49,23,26
050,31,065,"Nebraska","Furnas County",1,52,54,27,27
050,31,065,"Nebraska","Furnas County",1,53,47,23,24
050,31,065,"Nebraska","Furnas County",1,54,48,22,26
050,31,065,"Nebraska","Furnas County",1,55,56,31,25
050,31,065,"Nebraska","Furnas County",1,56,62,37,25
050,31,065,"Nebraska","Furnas County",1,57,62,31,31
050,31,065,"Nebraska","Furnas County",1,58,59,28,31
050,31,065,"Nebraska","Furnas County",1,59,61,32,29
050,31,065,"Nebraska","Furnas County",1,60,82,44,38
050,31,065,"Nebraska","Furnas County",1,61,76,40,36
050,31,065,"Nebraska","Furnas County",1,62,75,35,40
050,31,065,"Nebraska","Furnas County",1,63,66,32,34
050,31,065,"Nebraska","Furnas County",1,64,73,40,33
050,31,065,"Nebraska","Furnas County",1,65,76,40,36
050,31,065,"Nebraska","Furnas County",1,66,79,39,40
050,31,065,"Nebraska","Furnas County",1,67,66,31,35
050,31,065,"Nebraska","Furnas County",1,68,58,30,28
050,31,065,"Nebraska","Furnas County",1,69,70,30,40
050,31,065,"Nebraska","Furnas County",1,70,66,25,41
050,31,065,"Nebraska","Furnas County",1,71,57,30,27
050,31,065,"Nebraska","Furnas County",1,72,57,31,26
050,31,065,"Nebraska","Furnas County",1,73,76,37,39
050,31,065,"Nebraska","Furnas County",1,74,44,19,25
050,31,065,"Nebraska","Furnas County",1,75,46,19,27
050,31,065,"Nebraska","Furnas County",1,76,52,23,29
050,31,065,"Nebraska","Furnas County",1,77,39,14,25
050,31,065,"Nebraska","Furnas County",1,78,37,19,18
050,31,065,"Nebraska","Furnas County",1,79,31,15,16
050,31,065,"Nebraska","Furnas County",1,80,31,13,18
050,31,065,"Nebraska","Furnas County",1,81,36,13,23
050,31,065,"Nebraska","Furnas County",1,82,31,14,17
050,31,065,"Nebraska","Furnas County",1,83,30,14,16
050,31,065,"Nebraska","Furnas County",1,84,25,12,13
050,31,065,"Nebraska","Furnas County",1,85,152,52,100
050,31,065,"Nebraska","Furnas County",2,0,62,34,28
050,31,065,"Nebraska","Furnas County",2,1,61,37,24
050,31,065,"Nebraska","Furnas County",2,2,56,33,23
050,31,065,"Nebraska","Furnas County",2,3,56,31,25
050,31,065,"Nebraska","Furnas County",2,4,50,26,24
050,31,065,"Nebraska","Furnas County",2,5,51,25,26
050,31,065,"Nebraska","Furnas County",2,6,56,26,30
050,31,065,"Nebraska","Furnas County",2,7,54,30,24
050,31,065,"Nebraska","Furnas County",2,8,45,22,23
050,31,065,"Nebraska","Furnas County",2,9,46,23,23
050,31,065,"Nebraska","Furnas County",2,10,56,31,25
050,31,065,"Nebraska","Furnas County",2,11,60,34,26
050,31,065,"Nebraska","Furnas County",2,12,63,35,28
050,31,065,"Nebraska","Furnas County",2,13,55,26,29
050,31,065,"Nebraska","Furnas County",2,14,59,28,31
050,31,065,"Nebraska","Furnas County",2,15,70,35,35
050,31,065,"Nebraska","Furnas County",2,16,74,38,36
050,31,065,"Nebraska","Furnas County",2,17,69,38,31
050,31,065,"Nebraska","Furnas County",2,18,57,28,29
050,31,065,"Nebraska","Furnas County",2,19,46,21,25
050,31,065,"Nebraska","Furnas County",2,20,46,25,21
050,31,065,"Nebraska","Furnas County",2,21,42,24,18
050,31,065,"Nebraska","Furnas County",2,22,44,23,21
050,31,065,"Nebraska","Furnas County",2,23,46,25,21
050,31,065,"Nebraska","Furnas County",2,24,41,22,19
050,31,065,"Nebraska","Furnas County",2,25,34,17,17
050,31,065,"Nebraska","Furnas County",2,26,48,24,24
050,31,065,"Nebraska","Furnas County",2,27,54,26,28
050,31,065,"Nebraska","Furnas County",2,28,50,28,22
050,31,065,"Nebraska","Furnas County",2,29,47,25,22
050,31,065,"Nebraska","Furnas County",2,30,48,24,24
050,31,065,"Nebraska","Furnas County",2,31,43,25,18
050,31,065,"Nebraska","Furnas County",2,32,34,19,15
050,31,065,"Nebraska","Furnas County",2,33,35,18,17
050,31,065,"Nebraska","Furnas County",2,34,42,22,20
050,31,065,"Nebraska","Furnas County",2,35,46,24,22
050,31,065,"Nebraska","Furnas County",2,36,54,29,25
050,31,065,"Nebraska","Furnas County",2,37,52,25,27
050,31,065,"Nebraska","Furnas County",2,38,45,22,23
050,31,065,"Nebraska","Furnas County",2,39,40,23,17
050,31,065,"Nebraska","Furnas County",2,40,48,26,22
050,31,065,"Nebraska","Furnas County",2,41,50,28,22
050,31,065,"Nebraska","Furnas County",2,42,52,28,24
050,31,065,"Nebraska","Furnas County",2,43,48,24,24
050,31,065,"Nebraska","Furnas County",2,44,45,19,26
050,31,065,"Nebraska","Furnas County",2,45,45,16,29
050,31,065,"Nebraska","Furnas County",2,46,52,22,30
050,31,065,"Nebraska","Furnas County",2,47,51,24,27
050,31,065,"Nebraska","Furnas County",2,48,52,29,23
050,31,065,"Nebraska","Furnas County",2,49,57,36,21
050,31,065,"Nebraska","Furnas County",2,50,60,38,22
050,31,065,"Nebraska","Furnas County",2,51,50,25,25
050,31,065,"Nebraska","Furnas County",2,52,51,25,26
050,31,065,"Nebraska","Furnas County",2,53,48,23,25
050,31,065,"Nebraska","Furnas County",2,54,49,23,26
050,31,065,"Nebraska","Furnas County",2,55,54,29,25
050,31,065,"Nebraska","Furnas County",2,56,61,35,26
050,31,065,"Nebraska","Furnas County",2,57,62,32,30
050,31,065,"Nebraska","Furnas County",2,58,60,29,31
050,31,065,"Nebraska","Furnas County",2,59,60,31,29
050,31,065,"Nebraska","Furnas County",2,60,77,41,36
050,31,065,"Nebraska","Furnas County",2,61,75,39,36
050,31,065,"Nebraska","Furnas County",2,62,76,36,40
050,31,065,"Nebraska","Furnas County",2,63,69,33,36
050,31,065,"Nebraska","Furnas County",2,64,72,39,33
050,31,065,"Nebraska","Furnas County",2,65,75,39,36
050,31,065,"Nebraska","Furnas County",2,66,78,39,39
050,31,065,"Nebraska","Furnas County",2,67,70,33,37
050,31,065,"Nebraska","Furnas County",2,68,59,30,29
050,31,065,"Nebraska","Furnas County",2,69,66,29,37
050,31,065,"Nebraska","Furnas County",2,70,66,26,40
050,31,065,"Nebraska","Furnas County",2,71,60,29,31
050,31,065,"Nebraska","Furnas County",2,72,55,30,25
050,31,065,"Nebraska","Furnas County",2,73,73,37,36
050,31,065,"Nebraska","Furnas County",2,74,48,22,26
050,31,065,"Nebraska","Furnas County",2,75,45,19,26
050,31,065,"Nebraska","Furnas County",2,76,50,21,29
050,31,065,"Nebraska","Furnas County",2,77,44,17,27
050,31,065,"Nebraska","Furnas County",2,78,37,18,19
050,31,065,"Nebraska","Furnas County",2,79,31,15,16
050,31,065,"Nebraska","Furnas County",2,80,31,13,18
050,31,065,"Nebraska","Furnas County",2,81,35,13,22
050,31,065,"Nebraska","Furnas County",2,82,32,14,18
050,31,065,"Nebraska","Furnas County",2,83,29,13,16
050,31,065,"Nebraska","Furnas County",2,84,26,12,14
050,31,065,"Nebraska","Furnas County",2,85,155,54,101
050,31,065,"Nebraska","Furnas County",3,0,49,22,27
050,31,065,"Nebraska","Furnas County",3,1,64,36,28
050,31,065,"Nebraska","Furnas County",3,2,62,36,26
050,31,065,"Nebraska","Furnas County",3,3,52,29,23
050,31,065,"Nebraska","Furnas County",3,4,54,27,27
050,31,065,"Nebraska","Furnas County",3,5,46,27,19
050,31,065,"Nebraska","Furnas County",3,6,51,26,25
050,31,065,"Nebraska","Furnas County",3,7,56,24,32
050,31,065,"Nebraska","Furnas County",3,8,52,28,24
050,31,065,"Nebraska","Furnas County",3,9,44,22,22
050,31,065,"Nebraska","Furnas County",3,10,49,25,24
050,31,065,"Nebraska","Furnas County",3,11,50,27,23
050,31,065,"Nebraska","Furnas County",3,12,63,34,29
050,31,065,"Nebraska","Furnas County",3,13,55,32,23
050,31,065,"Nebraska","Furnas County",3,14,62,30,32
050,31,065,"Nebraska","Furnas County",3,15,55,29,26
050,31,065,"Nebraska","Furnas County",3,16,68,31,37
050,31,065,"Nebraska","Furnas County",3,17,82,42,40
050,31,065,"Nebraska","Furnas County",3,18,61,37,24
050,31,065,"Nebraska","Furnas County",3,19,44,22,22
050,31,065,"Nebraska","Furnas County",3,20,43,17,26
050,31,065,"Nebraska","Furnas County",3,21,49,25,24
050,31,065,"Nebraska","Furnas County",3,22,45,28,17
050,31,065,"Nebraska","Furnas County",3,23,47,24,23
050,31,065,"Nebraska","Furnas County",3,24,48,28,20
050,31,065,"Nebraska","Furnas County",3,25,44,24,20
050,31,065,"Nebraska","Furnas County",3,26,41,19,22
050,31,065,"Nebraska","Furnas County",3,27,52,27,25
050,31,065,"Nebraska","Furnas County",3,28,51,25,26
050,31,065,"Nebraska","Furnas County",3,29,48,28,20
050,31,065,"Nebraska","Furnas County",3,30,44,26,18
050,31,065,"Nebraska","Furnas County",3,31,46,24,22
050,31,065,"Nebraska","Furnas County",3,32,41,25,16
050,31,065,"Nebraska","Furnas County",3,33,33,17,16
050,31,065,"Nebraska","Furnas County",3,34,34,16,18
050,31,065,"Nebraska","Furnas County",3,35,43,23,20
050,31,065,"Nebraska","Furnas County",3,36,46,21,25
050,31,065,"Nebraska","Furnas County",3,37,53,28,25
050,31,065,"Nebraska","Furnas County",3,38,46,22,24
050,31,065,"Nebraska","Furnas County",3,39,49,23,26
050,31,065,"Nebraska","Furnas County",3,40,41,26,15
050,31,065,"Nebraska","Furnas County",3,41,48,26,22
050,31,065,"Nebraska","Furnas County",3,42,51,28,23
050,31,065,"Nebraska","Furnas County",3,43,54,28,26
050,31,065,"Nebraska","Furnas County",3,44,49,24,25
050,31,065,"Nebraska","Furnas County",3,45,45,19,26
050,31,065,"Nebraska","Furnas County",3,46,48,17,31
050,31,065,"Nebraska","Furnas County",3,47,53,25,28
050,31,065,"Nebraska","Furnas County",3,48,51,23,28
050,31,065,"Nebraska","Furnas County",3,49,54,30,24
050,31,065,"Nebraska","Furnas County",3,50,54,31,23
050,31,065,"Nebraska","Furnas County",3,51,56,33,23
050,31,065,"Nebraska","Furnas County",3,52,53,28,25
050,31,065,"Nebraska","Furnas County",3,53,50,24,26
050,31,065,"Nebraska","Furnas County",3,54,48,21,27
050,31,065,"Nebraska","Furnas County",3,55,48,22,26
050,31,065,"Nebraska","Furnas County",3,56,53,28,25
050,31,065,"Nebraska","Furnas County",3,57,62,38,24
050,31,065,"Nebraska","Furnas County",3,58,65,36,29
050,31,065,"Nebraska","Furnas County",3,59,59,26,33
050,31,065,"Nebraska","Furnas County",3,60,63,34,29
050,31,065,"Nebraska","Furnas County",3,61,80,43,37
050,31,065,"Nebraska","Furnas County",3,62,74,39,35
050,31,065,"Nebraska","Furnas County",3,63,70,34,36
050,31,065,"Nebraska","Furnas County",3,64,71,33,38
050,31,065,"Nebraska","Furnas County",3,65,70,35,35
050,31,065,"Nebraska","Furnas County",3,66,72,38,34
050,31,065,"Nebraska","Furnas County",3,67,79,39,40
050,31,065,"Nebraska","Furnas County",3,68,73,36,37
050,31,065,"Nebraska","Furnas County",3,69,59,29,30
050,31,065,"Nebraska","Furnas County",3,70,68,30,38
050,31,065,"Nebraska","Furnas County",3,71,65,27,38
050,31,065,"Nebraska","Furnas County",3,72,58,28,30
050,31,065,"Nebraska","Furnas County",3,73,54,31,23
050,31,065,"Nebraska","Furnas County",3,74,70,37,33
050,31,065,"Nebraska","Furnas County",3,75,46,22,24
050,31,065,"Nebraska","Furnas County",3,76,42,19,23
050,31,065,"Nebraska","Furnas County",3,77,48,20,28
050,31,065,"Nebraska","Furnas County",3,78,45,17,28
050,31,065,"Nebraska","Furnas County",3,79,35,17,18
050,31,065,"Nebraska","Furnas County",3,80,30,13,17
050,31,065,"Nebraska","Furnas County",3,81,33,14,19
050,31,065,"Nebraska","Furnas County",3,82,31,12,19
050,31,065,"Nebraska","Furnas County",3,83,32,14,18
050,31,065,"Nebraska","Furnas County",3,84,24,11,13
050,31,065,"Nebraska","Furnas County",3,85,151,55,96
050,31,065,"Nebraska","Furnas County",4,0,55,29,26
050,31,065,"Nebraska","Furnas County",4,1,43,20,23
050,31,065,"Nebraska","Furnas County",4,2,59,33,26
050,31,065,"Nebraska","Furnas County",4,3,60,33,27
050,31,065,"Nebraska","Furnas County",4,4,55,31,24
050,31,065,"Nebraska","Furnas County",4,5,54,28,26
050,31,065,"Nebraska","Furnas County",4,6,46,23,23
050,31,065,"Nebraska","Furnas County",4,7,51,27,24
050,31,065,"Nebraska","Furnas County",4,8,53,26,27
050,31,065,"Nebraska","Furnas County",4,9,58,32,26
050,31,065,"Nebraska","Furnas County",4,10,45,22,23
050,31,065,"Nebraska","Furnas County",4,11,50,25,25
050,31,065,"Nebraska","Furnas County",4,12,58,33,25
050,31,065,"Nebraska","Furnas County",4,13,61,35,26
050,31,065,"Nebraska","Furnas County",4,14,60,35,25
050,31,065,"Nebraska","Furnas County",4,15,64,34,30
050,31,065,"Nebraska","Furnas County",4,16,55,28,27
050,31,065,"Nebraska","Furnas County",4,17,71,34,37
050,31,065,"Nebraska","Furnas County",4,18,61,33,28
050,31,065,"Nebraska","Furnas County",4,19,43,27,16
050,31,065,"Nebraska","Furnas County",4,20,42,18,24
050,31,065,"Nebraska","Furnas County",4,21,48,21,27
050,31,065,"Nebraska","Furnas County",4,22,53,29,24
050,31,065,"Nebraska","Furnas County",4,23,44,28,16
050,31,065,"Nebraska","Furnas County",4,24,49,27,22
050,31,065,"Nebraska","Furnas County",4,25,49,24,25
050,31,065,"Nebraska","Furnas County",4,26,40,24,16
050,31,065,"Nebraska","Furnas County",4,27,49,21,28
050,31,065,"Nebraska","Furnas County",4,28,48,24,24
050,31,065,"Nebraska","Furnas County",4,29,50,27,23
050,31,065,"Nebraska","Furnas County",4,30,54,32,22
050,31,065,"Nebraska","Furnas County",4,31,42,24,18
050,31,065,"Nebraska","Furnas County",4,32,49,25,24
050,31,065,"Nebraska","Furnas County",4,33,40,25,15
050,31,065,"Nebraska","Furnas County",4,34,36,17,19
050,31,065,"Nebraska","Furnas County",4,35,33,15,18
050,31,065,"Nebraska","Furnas County",4,36,42,22,20
050,31,065,"Nebraska","Furnas County",4,37,44,21,23
050,31,065,"Nebraska","Furnas County",4,38,55,28,27
050,31,065,"Nebraska","Furnas County",4,39,46,22,24
050,31,065,"Nebraska","Furnas County",4,40,47,19,28
050,31,065,"Nebraska","Furnas County",4,41,40,25,15
050,31,065,"Nebraska","Furnas County",4,42,48,25,23
050,31,065,"Nebraska","Furnas County",4,43,58,30,28
050,31,065,"Nebraska","Furnas County",4,44,50,28,22
050,31,065,"Nebraska","Furnas County",4,45,48,25,23
050,31,065,"Nebraska","Furnas County",4,46,46,20,26
050,31,065,"Nebraska","Furnas County",4,47,53,21,32
050,31,065,"Nebraska","Furnas County",4,48,55,25,30
050,31,065,"Nebraska","Furnas County",4,49,54,27,27
050,31,065,"Nebraska","Furnas County",4,50,56,29,27
050,31,065,"Nebraska","Furnas County",4,51,57,34,23
050,31,065,"Nebraska","Furnas County",4,52,61,37,24
050,31,065,"Nebraska","Furnas County",4,53,55,29,26
050,31,065,"Nebraska","Furnas County",4,54,50,25,25
050,31,065,"Nebraska","Furnas County",4,55,49,21,28
050,31,065,"Nebraska","Furnas County",4,56,46,21,25
050,31,065,"Nebraska","Furnas County",4,57,57,32,25
050,31,065,"Nebraska","Furnas County",4,58,60,35,25
050,31,065,"Nebraska","Furnas County",4,59,66,38,28
050,31,065,"Nebraska","Furnas County",4,60,58,26,32
050,31,065,"Nebraska","Furnas County",4,61,66,37,29
050,31,065,"Nebraska","Furnas County",4,62,74,40,34
050,31,065,"Nebraska","Furnas County",4,63,70,36,34
050,31,065,"Nebraska","Furnas County",4,64,73,34,39
050,31,065,"Nebraska","Furnas County",4,65,66,29,37
050,31,065,"Nebraska","Furnas County",4,66,70,36,34
050,31,065,"Nebraska","Furnas County",4,67,73,38,35
050,31,065,"Nebraska","Furnas County",4,68,74,36,38
050,31,065,"Nebraska","Furnas County",4,69,74,36,38
050,31,065,"Nebraska","Furnas County",4,70,57,28,29
050,31,065,"Nebraska","Furnas County",4,71,67,30,37
050,31,065,"Nebraska","Furnas County",4,72,63,26,37
050,31,065,"Nebraska","Furnas County",4,73,57,28,29
050,31,065,"Nebraska","Furnas County",4,74,52,31,21
050,31,065,"Nebraska","Furnas County",4,75,61,32,29
050,31,065,"Nebraska","Furnas County",4,76,42,19,23
050,31,065,"Nebraska","Furnas County",4,77,37,17,20
050,31,065,"Nebraska","Furnas County",4,78,43,19,24
050,31,065,"Nebraska","Furnas County",4,79,42,15,27
050,31,065,"Nebraska","Furnas County",4,80,34,16,18
050,31,065,"Nebraska","Furnas County",4,81,27,12,15
050,31,065,"Nebraska","Furnas County",4,82,29,13,16
050,31,065,"Nebraska","Furnas County",4,83,27,10,17
050,31,065,"Nebraska","Furnas County",4,84,29,13,16
050,31,065,"Nebraska","Furnas County",4,85,134,54,80
050,31,065,"Nebraska","Furnas County",5,0,54,28,26
050,31,065,"Nebraska","Furnas County",5,1,55,29,26
050,31,065,"Nebraska","Furnas County",5,2,34,18,16
050,31,065,"Nebraska","Furnas County",5,3,56,29,27
050,31,065,"Nebraska","Furnas County",5,4,58,33,25
050,31,065,"Nebraska","Furnas County",5,5,52,32,20
050,31,065,"Nebraska","Furnas County",5,6,57,28,29
050,31,065,"Nebraska","Furnas County",5,7,49,25,24
050,31,065,"Nebraska","Furnas County",5,8,49,25,24
050,31,065,"Nebraska","Furnas County",5,9,50,23,27
050,31,065,"Nebraska","Furnas County",5,10,57,31,26
050,31,065,"Nebraska","Furnas County",5,11,44,21,23
050,31,065,"Nebraska","Furnas County",5,12,52,26,26
050,31,065,"Nebraska","Furnas County",5,13,58,30,28
050,31,065,"Nebraska","Furnas County",5,14,65,38,27
050,31,065,"Nebraska","Furnas County",5,15,64,39,25
050,31,065,"Nebraska","Furnas County",5,16,65,34,31
050,31,065,"Nebraska","Furnas County",5,17,54,28,26
050,31,065,"Nebraska","Furnas County",5,18,60,33,27
050,31,065,"Nebraska","Furnas County",5,19,47,26,21
050,31,065,"Nebraska","Furnas County",5,20,47,31,16
050,31,065,"Nebraska","Furnas County",5,21,37,18,19
050,31,065,"Nebraska","Furnas County",5,22,43,17,26
050,31,065,"Nebraska","Furnas County",5,23,51,28,23
050,31,065,"Nebraska","Furnas County",5,24,42,24,18
050,31,065,"Nebraska","Furnas County",5,25,43,23,20
050,31,065,"Nebraska","Furnas County",5,26,50,28,22
050,31,065,"Nebraska","Furnas County",5,27,40,23,17
050,31,065,"Nebraska","Furnas County",5,28,49,21,28
050,31,065,"Nebraska","Furnas County",5,29,44,22,22
050,31,065,"Nebraska","Furnas County",5,30,51,28,23
050,31,065,"Nebraska","Furnas County",5,31,56,35,21
050,31,065,"Nebraska","Furnas County",5,32,44,26,18
050,31,065,"Nebraska","Furnas County",5,33,48,26,22
050,31,065,"Nebraska","Furnas County",5,34,43,26,17
050,31,065,"Nebraska","Furnas County",5,35,37,18,19
050,31,065,"Nebraska","Furnas County",5,36,32,14,18
050,31,065,"Nebraska","Furnas County",5,37,40,21,19
050,31,065,"Nebraska","Furnas County",5,38,48,25,23
050,31,065,"Nebraska","Furnas County",5,39,53,28,25
050,31,065,"Nebraska","Furnas County",5,40,48,22,26
050,31,065,"Nebraska","Furnas County",5,41,48,19,29
050,31,065,"Nebraska","Furnas County",5,42,39,23,16
050,31,065,"Nebraska","Furnas County",5,43,55,28,27
050,31,065,"Nebraska","Furnas County",5,44,58,30,28
050,31,065,"Nebraska","Furnas County",5,45,49,28,21
050,31,065,"Nebraska","Furnas County",5,46,51,28,23
050,31,065,"Nebraska","Furnas County",5,47,47,21,26
050,31,065,"Nebraska","Furnas County",5,48,52,20,32
050,31,065,"Nebraska","Furnas County",5,49,56,26,30
050,31,065,"Nebraska","Furnas County",5,50,55,27,28
050,31,065,"Nebraska","Furnas County",5,51,54,29,25
050,31,065,"Nebraska","Furnas County",5,52,58,35,23
050,31,065,"Nebraska","Furnas County",5,53,58,34,24
050,31,065,"Nebraska","Furnas County",5,54,57,31,26
050,31,065,"Nebraska","Furnas County",5,55,51,26,25
050,31,065,"Nebraska","Furnas County",5,56,46,18,28
050,31,065,"Nebraska","Furnas County",5,57,48,21,27
050,31,065,"Nebraska","Furnas County",5,58,58,34,24
050,31,065,"Nebraska","Furnas County",5,59,56,30,26
050,31,065,"Nebraska","Furnas County",5,60,68,39,29
050,31,065,"Nebraska","Furnas County",5,61,60,27,33
050,31,065,"Nebraska","Furnas County",5,62,71,43,28
050,31,065,"Nebraska","Furnas County",5,63,69,36,33
050,31,065,"Nebraska","Furnas County",5,64,69,35,34
050,31,065,"Nebraska","Furnas County",5,65,73,33,40
050,31,065,"Nebraska","Furnas County",5,66,63,28,35
050,31,065,"Nebraska","Furnas County",5,67,70,35,35
050,31,065,"Nebraska","Furnas County",5,68,72,38,34
050,31,065,"Nebraska","Furnas County",5,69,74,36,38
050,31,065,"Nebraska","Furnas County",5,70,74,34,40
050,31,065,"Nebraska","Furnas County",5,71,53,26,27
050,31,065,"Nebraska","Furnas County",5,72,64,29,35
050,31,065,"Nebraska","Furnas County",5,73,66,26,40
050,31,065,"Nebraska","Furnas County",5,74,60,28,32
050,31,065,"Nebraska","Furnas County",5,75,50,30,20
050,31,065,"Nebraska","Furnas County",5,76,56,28,28
050,31,065,"Nebraska","Furnas County",5,77,37,18,19
050,31,065,"Nebraska","Furnas County",5,78,39,16,23
050,31,065,"Nebraska","Furnas County",5,79,42,17,25
050,31,065,"Nebraska","Furnas County",5,80,44,15,29
050,31,065,"Nebraska","Furnas County",5,81,35,17,18
050,31,065,"Nebraska","Furnas County",5,82,27,13,14
050,31,065,"Nebraska","Furnas County",5,83,30,14,16
050,31,065,"Nebraska","Furnas County",5,84,26,11,15
050,31,065,"Nebraska","Furnas County",5,85,142,60,82
050,31,067,"Nebraska","Gage County",1,0,209,107,102
050,31,067,"Nebraska","Gage County",1,1,245,124,121
050,31,067,"Nebraska","Gage County",1,2,250,126,124
050,31,067,"Nebraska","Gage County",1,3,259,130,129
050,31,067,"Nebraska","Gage County",1,4,254,136,118
050,31,067,"Nebraska","Gage County",1,5,279,145,134
050,31,067,"Nebraska","Gage County",1,6,298,157,141
050,31,067,"Nebraska","Gage County",1,7,301,164,137
050,31,067,"Nebraska","Gage County",1,8,260,134,126
050,31,067,"Nebraska","Gage County",1,9,270,147,123
050,31,067,"Nebraska","Gage County",1,10,274,141,133
050,31,067,"Nebraska","Gage County",1,11,320,172,148
050,31,067,"Nebraska","Gage County",1,12,323,164,159
050,31,067,"Nebraska","Gage County",1,13,297,144,153
050,31,067,"Nebraska","Gage County",1,14,293,153,140
050,31,067,"Nebraska","Gage County",1,15,283,143,140
050,31,067,"Nebraska","Gage County",1,16,286,156,130
050,31,067,"Nebraska","Gage County",1,17,288,142,146
050,31,067,"Nebraska","Gage County",1,18,226,122,104
050,31,067,"Nebraska","Gage County",1,19,179,97,82
050,31,067,"Nebraska","Gage County",1,20,223,126,97
050,31,067,"Nebraska","Gage County",1,21,237,139,98
050,31,067,"Nebraska","Gage County",1,22,207,107,100
050,31,067,"Nebraska","Gage County",1,23,205,112,93
050,31,067,"Nebraska","Gage County",1,24,213,114,99
050,31,067,"Nebraska","Gage County",1,25,207,103,104
050,31,067,"Nebraska","Gage County",1,26,209,112,97
050,31,067,"Nebraska","Gage County",1,27,239,116,123
050,31,067,"Nebraska","Gage County",1,28,218,104,114
050,31,067,"Nebraska","Gage County",1,29,212,110,102
050,31,067,"Nebraska","Gage County",1,30,219,111,108
050,31,067,"Nebraska","Gage County",1,31,226,112,114
050,31,067,"Nebraska","Gage County",1,32,242,117,125
050,31,067,"Nebraska","Gage County",1,33,260,130,130
050,31,067,"Nebraska","Gage County",1,34,249,133,116
050,31,067,"Nebraska","Gage County",1,35,230,124,106
050,31,067,"Nebraska","Gage County",1,36,244,116,128
050,31,067,"Nebraska","Gage County",1,37,260,137,123
050,31,067,"Nebraska","Gage County",1,38,295,150,145
050,31,067,"Nebraska","Gage County",1,39,266,146,120
050,31,067,"Nebraska","Gage County",1,40,252,125,127
050,31,067,"Nebraska","Gage County",1,41,256,124,132
050,31,067,"Nebraska","Gage County",1,42,267,132,135
050,31,067,"Nebraska","Gage County",1,43,266,141,125
050,31,067,"Nebraska","Gage County",1,44,245,124,121
050,31,067,"Nebraska","Gage County",1,45,213,110,103
050,31,067,"Nebraska","Gage County",1,46,250,128,122
050,31,067,"Nebraska","Gage County",1,47,231,121,110
050,31,067,"Nebraska","Gage County",1,48,251,117,134
050,31,067,"Nebraska","Gage County",1,49,271,137,134
050,31,067,"Nebraska","Gage County",1,50,243,126,117
050,31,067,"Nebraska","Gage County",1,51,250,137,113
050,31,067,"Nebraska","Gage County",1,52,254,143,111
050,31,067,"Nebraska","Gage County",1,53,256,121,135
050,31,067,"Nebraska","Gage County",1,54,275,132,143
050,31,067,"Nebraska","Gage County",1,55,303,143,160
050,31,067,"Nebraska","Gage County",1,56,305,147,158
050,31,067,"Nebraska","Gage County",1,57,316,159,157
050,31,067,"Nebraska","Gage County",1,58,365,175,190
050,31,067,"Nebraska","Gage County",1,59,351,187,164
050,31,067,"Nebraska","Gage County",1,60,353,185,168
050,31,067,"Nebraska","Gage County",1,61,335,158,177
050,31,067,"Nebraska","Gage County",1,62,339,167,172
050,31,067,"Nebraska","Gage County",1,63,332,167,165
050,31,067,"Nebraska","Gage County",1,64,327,165,162
050,31,067,"Nebraska","Gage County",1,65,317,158,159
050,31,067,"Nebraska","Gage County",1,66,299,155,144
050,31,067,"Nebraska","Gage County",1,67,284,140,144
050,31,067,"Nebraska","Gage County",1,68,278,135,143
050,31,067,"Nebraska","Gage County",1,69,249,126,123
050,31,067,"Nebraska","Gage County",1,70,228,111,117
050,31,067,"Nebraska","Gage County",1,71,214,109,105
050,31,067,"Nebraska","Gage County",1,72,218,106,112
050,31,067,"Nebraska","Gage County",1,73,221,105,116
050,31,067,"Nebraska","Gage County",1,74,161,82,79
050,31,067,"Nebraska","Gage County",1,75,173,76,97
050,31,067,"Nebraska","Gage County",1,76,165,77,88
050,31,067,"Nebraska","Gage County",1,77,158,72,86
050,31,067,"Nebraska","Gage County",1,78,154,69,85
050,31,067,"Nebraska","Gage County",1,79,127,53,74
050,31,067,"Nebraska","Gage County",1,80,133,56,77
050,31,067,"Nebraska","Gage County",1,81,130,55,75
050,31,067,"Nebraska","Gage County",1,82,118,53,65
050,31,067,"Nebraska","Gage County",1,83,109,49,60
050,31,067,"Nebraska","Gage County",1,84,99,40,59
050,31,067,"Nebraska","Gage County",1,85,711,289,422
050,31,067,"Nebraska","Gage County",2,0,198,102,96
050,31,067,"Nebraska","Gage County",2,1,238,121,117
050,31,067,"Nebraska","Gage County",2,2,249,126,123
050,31,067,"Nebraska","Gage County",2,3,258,129,129
050,31,067,"Nebraska","Gage County",2,4,257,136,121
050,31,067,"Nebraska","Gage County",2,5,273,143,130
050,31,067,"Nebraska","Gage County",2,6,296,156,140
050,31,067,"Nebraska","Gage County",2,7,297,161,136
050,31,067,"Nebraska","Gage County",2,8,270,142,128
050,31,067,"Nebraska","Gage County",2,9,267,141,126
050,31,067,"Nebraska","Gage County",2,10,273,144,129
050,31,067,"Nebraska","Gage County",2,11,306,164,142
050,31,067,"Nebraska","Gage County",2,12,319,165,154
050,31,067,"Nebraska","Gage County",2,13,302,148,154
050,31,067,"Nebraska","Gage County",2,14,292,149,143
050,31,067,"Nebraska","Gage County",2,15,284,145,139
050,31,067,"Nebraska","Gage County",2,16,284,152,132
050,31,067,"Nebraska","Gage County",2,17,286,144,142
050,31,067,"Nebraska","Gage County",2,18,226,120,106
050,31,067,"Nebraska","Gage County",2,19,180,96,84
050,31,067,"Nebraska","Gage County",2,20,223,125,98
050,31,067,"Nebraska","Gage County",2,21,233,135,98
050,31,067,"Nebraska","Gage County",2,22,215,115,100
050,31,067,"Nebraska","Gage County",2,23,206,111,95
050,31,067,"Nebraska","Gage County",2,24,210,113,97
050,31,067,"Nebraska","Gage County",2,25,209,105,104
050,31,067,"Nebraska","Gage County",2,26,211,109,102
050,31,067,"Nebraska","Gage County",2,27,230,114,116
050,31,067,"Nebraska","Gage County",2,28,222,107,115
050,31,067,"Nebraska","Gage County",2,29,212,106,106
050,31,067,"Nebraska","Gage County",2,30,221,114,107
050,31,067,"Nebraska","Gage County",2,31,229,117,112
050,31,067,"Nebraska","Gage County",2,32,239,116,123
050,31,067,"Nebraska","Gage County",2,33,256,127,129
050,31,067,"Nebraska","Gage County",2,34,249,131,118
050,31,067,"Nebraska","Gage County",2,35,236,125,111
050,31,067,"Nebraska","Gage County",2,36,241,119,122
050,31,067,"Nebraska","Gage County",2,37,258,134,124
050,31,067,"Nebraska","Gage County",2,38,288,148,140
050,31,067,"Nebraska","Gage County",2,39,272,146,126
050,31,067,"Nebraska","Gage County",2,40,255,129,126
050,31,067,"Nebraska","Gage County",2,41,253,122,131
050,31,067,"Nebraska","Gage County",2,42,264,130,134
050,31,067,"Nebraska","Gage County",2,43,269,140,129
050,31,067,"Nebraska","Gage County",2,44,246,128,118
050,31,067,"Nebraska","Gage County",2,45,223,115,108
050,31,067,"Nebraska","Gage County",2,46,243,124,119
050,31,067,"Nebraska","Gage County",2,47,235,123,112
050,31,067,"Nebraska","Gage County",2,48,246,118,128
050,31,067,"Nebraska","Gage County",2,49,269,134,135
050,31,067,"Nebraska","Gage County",2,50,249,128,121
050,31,067,"Nebraska","Gage County",2,51,247,133,114
050,31,067,"Nebraska","Gage County",2,52,254,142,112
050,31,067,"Nebraska","Gage County",2,53,256,126,130
050,31,067,"Nebraska","Gage County",2,54,267,127,140
050,31,067,"Nebraska","Gage County",2,55,294,139,155
050,31,067,"Nebraska","Gage County",2,56,305,147,158
050,31,067,"Nebraska","Gage County",2,57,312,154,158
050,31,067,"Nebraska","Gage County",2,58,353,171,182
050,31,067,"Nebraska","Gage County",2,59,353,184,169
050,31,067,"Nebraska","Gage County",2,60,347,182,165
050,31,067,"Nebraska","Gage County",2,61,338,164,174
050,31,067,"Nebraska","Gage County",2,62,336,163,173
050,31,067,"Nebraska","Gage County",2,63,337,168,169
050,31,067,"Nebraska","Gage County",2,64,326,165,161
050,31,067,"Nebraska","Gage County",2,65,320,160,160
050,31,067,"Nebraska","Gage County",2,66,306,158,148
050,31,067,"Nebraska","Gage County",2,67,288,144,144
050,31,067,"Nebraska","Gage County",2,68,276,137,139
050,31,067,"Nebraska","Gage County",2,69,255,128,127
050,31,067,"Nebraska","Gage County",2,70,233,114,119
050,31,067,"Nebraska","Gage County",2,71,218,109,109
050,31,067,"Nebraska","Gage County",2,72,212,105,107
050,31,067,"Nebraska","Gage County",2,73,232,111,121
050,31,067,"Nebraska","Gage County",2,74,165,83,82
050,31,067,"Nebraska","Gage County",2,75,168,74,94
050,31,067,"Nebraska","Gage County",2,76,160,76,84
050,31,067,"Nebraska","Gage County",2,77,162,73,89
050,31,067,"Nebraska","Gage County",2,78,151,69,82
050,31,067,"Nebraska","Gage County",2,79,130,55,75
050,31,067,"Nebraska","Gage County",2,80,129,53,76
050,31,067,"Nebraska","Gage County",2,81,126,54,72
050,31,067,"Nebraska","Gage County",2,82,119,52,67
050,31,067,"Nebraska","Gage County",2,83,109,49,60
050,31,067,"Nebraska","Gage County",2,84,99,41,58
050,31,067,"Nebraska","Gage County",2,85,706,288,418
050,31,067,"Nebraska","Gage County",3,0,218,99,119
050,31,067,"Nebraska","Gage County",3,1,203,105,98
050,31,067,"Nebraska","Gage County",3,2,239,119,120
050,31,067,"Nebraska","Gage County",3,3,247,122,125
050,31,067,"Nebraska","Gage County",3,4,252,128,124
050,31,067,"Nebraska","Gage County",3,5,263,144,119
050,31,067,"Nebraska","Gage County",3,6,282,151,131
050,31,067,"Nebraska","Gage County",3,7,303,156,147
050,31,067,"Nebraska","Gage County",3,8,298,167,131
050,31,067,"Nebraska","Gage County",3,9,270,135,135
050,31,067,"Nebraska","Gage County",3,10,268,136,132
050,31,067,"Nebraska","Gage County",3,11,287,150,137
050,31,067,"Nebraska","Gage County",3,12,307,162,145
050,31,067,"Nebraska","Gage County",3,13,314,158,156
050,31,067,"Nebraska","Gage County",3,14,299,149,150
050,31,067,"Nebraska","Gage County",3,15,292,151,141
050,31,067,"Nebraska","Gage County",3,16,278,146,132
050,31,067,"Nebraska","Gage County",3,17,295,153,142
050,31,067,"Nebraska","Gage County",3,18,249,133,116
050,31,067,"Nebraska","Gage County",3,19,191,102,89
050,31,067,"Nebraska","Gage County",3,20,220,130,90
050,31,067,"Nebraska","Gage County",3,21,227,129,98
050,31,067,"Nebraska","Gage County",3,22,224,116,108
050,31,067,"Nebraska","Gage County",3,23,214,110,104
050,31,067,"Nebraska","Gage County",3,24,190,101,89
050,31,067,"Nebraska","Gage County",3,25,207,108,99
050,31,067,"Nebraska","Gage County",3,26,201,103,98
050,31,067,"Nebraska","Gage County",3,27,210,110,100
050,31,067,"Nebraska","Gage County",3,28,229,114,115
050,31,067,"Nebraska","Gage County",3,29,220,106,114
050,31,067,"Nebraska","Gage County",3,30,216,108,108
050,31,067,"Nebraska","Gage County",3,31,243,123,120
050,31,067,"Nebraska","Gage County",3,32,235,123,112
050,31,067,"Nebraska","Gage County",3,33,248,117,131
050,31,067,"Nebraska","Gage County",3,34,260,127,133
050,31,067,"Nebraska","Gage County",3,35,251,129,122
050,31,067,"Nebraska","Gage County",3,36,239,125,114
050,31,067,"Nebraska","Gage County",3,37,242,124,118
050,31,067,"Nebraska","Gage County",3,38,261,134,127
050,31,067,"Nebraska","Gage County",3,39,293,149,144
050,31,067,"Nebraska","Gage County",3,40,265,145,120
050,31,067,"Nebraska","Gage County",3,41,262,138,124
050,31,067,"Nebraska","Gage County",3,42,260,128,132
050,31,067,"Nebraska","Gage County",3,43,261,126,135
050,31,067,"Nebraska","Gage County",3,44,262,140,122
050,31,067,"Nebraska","Gage County",3,45,238,125,113
050,31,067,"Nebraska","Gage County",3,46,217,107,110
050,31,067,"Nebraska","Gage County",3,47,239,122,117
050,31,067,"Nebraska","Gage County",3,48,228,119,109
050,31,067,"Nebraska","Gage County",3,49,253,123,130
050,31,067,"Nebraska","Gage County",3,50,259,124,135
050,31,067,"Nebraska","Gage County",3,51,248,126,122
050,31,067,"Nebraska","Gage County",3,52,243,132,111
050,31,067,"Nebraska","Gage County",3,53,241,130,111
050,31,067,"Nebraska","Gage County",3,54,262,130,132
050,31,067,"Nebraska","Gage County",3,55,266,130,136
050,31,067,"Nebraska","Gage County",3,56,294,136,158
050,31,067,"Nebraska","Gage County",3,57,299,145,154
050,31,067,"Nebraska","Gage County",3,58,319,156,163
050,31,067,"Nebraska","Gage County",3,59,344,170,174
050,31,067,"Nebraska","Gage County",3,60,351,186,165
050,31,067,"Nebraska","Gage County",3,61,346,177,169
050,31,067,"Nebraska","Gage County",3,62,326,154,172
050,31,067,"Nebraska","Gage County",3,63,329,156,173
050,31,067,"Nebraska","Gage County",3,64,337,167,170
050,31,067,"Nebraska","Gage County",3,65,330,171,159
050,31,067,"Nebraska","Gage County",3,66,318,153,165
050,31,067,"Nebraska","Gage County",3,67,302,154,148
050,31,067,"Nebraska","Gage County",3,68,284,142,142
050,31,067,"Nebraska","Gage County",3,69,269,134,135
050,31,067,"Nebraska","Gage County",3,70,249,128,121
050,31,067,"Nebraska","Gage County",3,71,227,112,115
050,31,067,"Nebraska","Gage County",3,72,220,113,107
050,31,067,"Nebraska","Gage County",3,73,214,105,109
050,31,067,"Nebraska","Gage County",3,74,232,115,117
050,31,067,"Nebraska","Gage County",3,75,156,78,78
050,31,067,"Nebraska","Gage County",3,76,160,72,88
050,31,067,"Nebraska","Gage County",3,77,162,71,91
050,31,067,"Nebraska","Gage County",3,78,161,76,85
050,31,067,"Nebraska","Gage County",3,79,142,62,80
050,31,067,"Nebraska","Gage County",3,80,126,52,74
050,31,067,"Nebraska","Gage County",3,81,118,50,68
050,31,067,"Nebraska","Gage County",3,82,131,54,77
050,31,067,"Nebraska","Gage County",3,83,116,51,65
050,31,067,"Nebraska","Gage County",3,84,90,39,51
050,31,067,"Nebraska","Gage County",3,85,692,287,405
050,31,067,"Nebraska","Gage County",4,0,209,96,113
050,31,067,"Nebraska","Gage County",4,1,225,100,125
050,31,067,"Nebraska","Gage County",4,2,222,117,105
050,31,067,"Nebraska","Gage County",4,3,242,127,115
050,31,067,"Nebraska","Gage County",4,4,250,124,126
050,31,067,"Nebraska","Gage County",4,5,259,129,130
050,31,067,"Nebraska","Gage County",4,6,265,147,118
050,31,067,"Nebraska","Gage County",4,7,277,146,131
050,31,067,"Nebraska","Gage County",4,8,304,157,147
050,31,067,"Nebraska","Gage County",4,9,296,165,131
050,31,067,"Nebraska","Gage County",4,10,267,136,131
050,31,067,"Nebraska","Gage County",4,11,270,137,133
050,31,067,"Nebraska","Gage County",4,12,280,144,136
050,31,067,"Nebraska","Gage County",4,13,310,168,142
050,31,067,"Nebraska","Gage County",4,14,308,157,151
050,31,067,"Nebraska","Gage County",4,15,294,145,149
050,31,067,"Nebraska","Gage County",4,16,293,150,143
050,31,067,"Nebraska","Gage County",4,17,273,145,128
050,31,067,"Nebraska","Gage County",4,18,240,131,109
050,31,067,"Nebraska","Gage County",4,19,192,104,88
050,31,067,"Nebraska","Gage County",4,20,217,130,87
050,31,067,"Nebraska","Gage County",4,21,228,132,96
050,31,067,"Nebraska","Gage County",4,22,204,105,99
050,31,067,"Nebraska","Gage County",4,23,239,120,119
050,31,067,"Nebraska","Gage County",4,24,206,108,98
050,31,067,"Nebraska","Gage County",4,25,181,100,81
050,31,067,"Nebraska","Gage County",4,26,197,100,97
050,31,067,"Nebraska","Gage County",4,27,215,114,101
050,31,067,"Nebraska","Gage County",4,28,215,105,110
050,31,067,"Nebraska","Gage County",4,29,232,118,114
050,31,067,"Nebraska","Gage County",4,30,232,114,118
050,31,067,"Nebraska","Gage County",4,31,215,109,106
050,31,067,"Nebraska","Gage County",4,32,249,123,126
050,31,067,"Nebraska","Gage County",4,33,237,127,110
050,31,067,"Nebraska","Gage County",4,34,251,115,136
050,31,067,"Nebraska","Gage County",4,35,250,121,129
050,31,067,"Nebraska","Gage County",4,36,251,129,122
050,31,067,"Nebraska","Gage County",4,37,249,125,124
050,31,067,"Nebraska","Gage County",4,38,244,130,114
050,31,067,"Nebraska","Gage County",4,39,263,139,124
050,31,067,"Nebraska","Gage County",4,40,300,152,148
050,31,067,"Nebraska","Gage County",4,41,266,146,120
050,31,067,"Nebraska","Gage County",4,42,276,141,135
050,31,067,"Nebraska","Gage County",4,43,259,125,134
050,31,067,"Nebraska","Gage County",4,44,261,126,135
050,31,067,"Nebraska","Gage County",4,45,266,138,128
050,31,067,"Nebraska","Gage County",4,46,245,126,119
050,31,067,"Nebraska","Gage County",4,47,225,111,114
050,31,067,"Nebraska","Gage County",4,48,243,124,119
050,31,067,"Nebraska","Gage County",4,49,235,127,108
050,31,067,"Nebraska","Gage County",4,50,257,119,138
050,31,067,"Nebraska","Gage County",4,51,261,127,134
050,31,067,"Nebraska","Gage County",4,52,253,127,126
050,31,067,"Nebraska","Gage County",4,53,244,131,113
050,31,067,"Nebraska","Gage County",4,54,239,129,110
050,31,067,"Nebraska","Gage County",4,55,258,126,132
050,31,067,"Nebraska","Gage County",4,56,256,125,131
050,31,067,"Nebraska","Gage County",4,57,286,133,153
050,31,067,"Nebraska","Gage County",4,58,296,140,156
050,31,067,"Nebraska","Gage County",4,59,316,158,158
050,31,067,"Nebraska","Gage County",4,60,340,166,174
050,31,067,"Nebraska","Gage County",4,61,352,184,168
050,31,067,"Nebraska","Gage County",4,62,349,186,163
050,31,067,"Nebraska","Gage County",4,63,326,152,174
050,31,067,"Nebraska","Gage County",4,64,324,149,175
050,31,067,"Nebraska","Gage County",4,65,345,172,173
050,31,067,"Nebraska","Gage County",4,66,325,170,155
050,31,067,"Nebraska","Gage County",4,67,313,150,163
050,31,067,"Nebraska","Gage County",4,68,302,160,142
050,31,067,"Nebraska","Gage County",4,69,273,138,135
050,31,067,"Nebraska","Gage County",4,70,261,127,134
050,31,067,"Nebraska","Gage County",4,71,240,120,120
050,31,067,"Nebraska","Gage County",4,72,216,102,114
050,31,067,"Nebraska","Gage County",4,73,221,115,106
050,31,067,"Nebraska","Gage County",4,74,209,106,103
050,31,067,"Nebraska","Gage County",4,75,223,106,117
050,31,067,"Nebraska","Gage County",4,76,141,68,73
050,31,067,"Nebraska","Gage County",4,77,157,68,89
050,31,067,"Nebraska","Gage County",4,78,158,73,85
050,31,067,"Nebraska","Gage County",4,79,151,69,82
050,31,067,"Nebraska","Gage County",4,80,135,58,77
050,31,067,"Nebraska","Gage County",4,81,113,47,66
050,31,067,"Nebraska","Gage County",4,82,117,48,69
050,31,067,"Nebraska","Gage County",4,83,121,54,67
050,31,067,"Nebraska","Gage County",4,84,101,41,60
050,31,067,"Nebraska","Gage County",4,85,658,278,380
050,31,067,"Nebraska","Gage County",5,0,205,95,110
050,31,067,"Nebraska","Gage County",5,1,217,98,119
050,31,067,"Nebraska","Gage County",5,2,226,100,126
050,31,067,"Nebraska","Gage County",5,3,214,113,101
050,31,067,"Nebraska","Gage County",5,4,247,126,121
050,31,067,"Nebraska","Gage County",5,5,260,130,130
050,31,067,"Nebraska","Gage County",5,6,263,129,134
050,31,067,"Nebraska","Gage County",5,7,285,158,127
050,31,067,"Nebraska","Gage County",5,8,277,150,127
050,31,067,"Nebraska","Gage County",5,9,320,168,152
050,31,067,"Nebraska","Gage County",5,10,314,176,138
050,31,067,"Nebraska","Gage County",5,11,288,140,148
050,31,067,"Nebraska","Gage County",5,12,280,144,136
050,31,067,"Nebraska","Gage County",5,13,283,147,136
050,31,067,"Nebraska","Gage County",5,14,300,166,134
050,31,067,"Nebraska","Gage County",5,15,313,162,151
050,31,067,"Nebraska","Gage County",5,16,295,146,149
050,31,067,"Nebraska","Gage County",5,17,292,150,142
050,31,067,"Nebraska","Gage County",5,18,226,123,103
050,31,067,"Nebraska","Gage County",5,19,188,102,86
050,31,067,"Nebraska","Gage County",5,20,223,133,90
050,31,067,"Nebraska","Gage County",5,21,226,130,96
050,31,067,"Nebraska","Gage County",5,22,205,113,92
050,31,067,"Nebraska","Gage County",5,23,200,107,93
050,31,067,"Nebraska","Gage County",5,24,259,136,123
050,31,067,"Nebraska","Gage County",5,25,201,105,96
050,31,067,"Nebraska","Gage County",5,26,172,99,73
050,31,067,"Nebraska","Gage County",5,27,199,102,97
050,31,067,"Nebraska","Gage County",5,28,211,114,97
050,31,067,"Nebraska","Gage County",5,29,214,109,105
050,31,067,"Nebraska","Gage County",5,30,239,124,115
050,31,067,"Nebraska","Gage County",5,31,234,108,126
050,31,067,"Nebraska","Gage County",5,32,221,109,112
050,31,067,"Nebraska","Gage County",5,33,251,125,126
050,31,067,"Nebraska","Gage County",5,34,244,132,112
050,31,067,"Nebraska","Gage County",5,35,249,117,132
050,31,067,"Nebraska","Gage County",5,36,276,136,140
050,31,067,"Nebraska","Gage County",5,37,244,129,115
050,31,067,"Nebraska","Gage County",5,38,267,130,137
050,31,067,"Nebraska","Gage County",5,39,259,135,124
050,31,067,"Nebraska","Gage County",5,40,265,140,125
050,31,067,"Nebraska","Gage County",5,41,301,154,147
050,31,067,"Nebraska","Gage County",5,42,274,147,127
050,31,067,"Nebraska","Gage County",5,43,264,134,130
050,31,067,"Nebraska","Gage County",5,44,264,129,135
050,31,067,"Nebraska","Gage County",5,45,271,131,140
050,31,067,"Nebraska","Gage County",5,46,276,144,132
050,31,067,"Nebraska","Gage County",5,47,247,126,121
050,31,067,"Nebraska","Gage County",5,48,224,111,113
050,31,067,"Nebraska","Gage County",5,49,242,127,115
050,31,067,"Nebraska","Gage County",5,50,236,127,109
050,31,067,"Nebraska","Gage County",5,51,256,122,134
050,31,067,"Nebraska","Gage County",5,52,261,124,137
050,31,067,"Nebraska","Gage County",5,53,246,123,123
050,31,067,"Nebraska","Gage County",5,54,239,131,108
050,31,067,"Nebraska","Gage County",5,55,240,130,110
050,31,067,"Nebraska","Gage County",5,56,253,123,130
050,31,067,"Nebraska","Gage County",5,57,254,121,133
050,31,067,"Nebraska","Gage County",5,58,282,129,153
050,31,067,"Nebraska","Gage County",5,59,295,142,153
050,31,067,"Nebraska","Gage County",5,60,314,155,159
050,31,067,"Nebraska","Gage County",5,61,348,164,184
050,31,067,"Nebraska","Gage County",5,62,351,185,166
050,31,067,"Nebraska","Gage County",5,63,343,183,160
050,31,067,"Nebraska","Gage County",5,64,324,150,174
050,31,067,"Nebraska","Gage County",5,65,322,150,172
050,31,067,"Nebraska","Gage County",5,66,334,162,172
050,31,067,"Nebraska","Gage County",5,67,328,168,160
050,31,067,"Nebraska","Gage County",5,68,314,154,160
050,31,067,"Nebraska","Gage County",5,69,296,155,141
050,31,067,"Nebraska","Gage County",5,70,268,136,132
050,31,067,"Nebraska","Gage County",5,71,251,123,128
050,31,067,"Nebraska","Gage County",5,72,228,112,116
050,31,067,"Nebraska","Gage County",5,73,220,104,116
050,31,067,"Nebraska","Gage County",5,74,220,113,107
050,31,067,"Nebraska","Gage County",5,75,202,98,104
050,31,067,"Nebraska","Gage County",5,76,217,101,116
050,31,067,"Nebraska","Gage County",5,77,140,64,76
050,31,067,"Nebraska","Gage County",5,78,157,70,87
050,31,067,"Nebraska","Gage County",5,79,143,65,78
050,31,067,"Nebraska","Gage County",5,80,146,65,81
050,31,067,"Nebraska","Gage County",5,81,122,53,69
050,31,067,"Nebraska","Gage County",5,82,113,46,67
050,31,067,"Nebraska","Gage County",5,83,110,48,62
050,31,067,"Nebraska","Gage County",5,84,101,42,59
050,31,067,"Nebraska","Gage County",5,85,645,271,374
050,31,069,"Nebraska","Garden County",1,0,11,6,5
050,31,069,"Nebraska","Garden County",1,1,13,5,8
050,31,069,"Nebraska","Garden County",1,2,22,9,13
050,31,069,"Nebraska","Garden County",1,3,16,11,5
050,31,069,"Nebraska","Garden County",1,4,15,8,7
050,31,069,"Nebraska","Garden County",1,5,17,8,9
050,31,069,"Nebraska","Garden County",1,6,20,8,12
050,31,069,"Nebraska","Garden County",1,7,20,9,11
050,31,069,"Nebraska","Garden County",1,8,19,7,12
050,31,069,"Nebraska","Garden County",1,9,32,22,10
050,31,069,"Nebraska","Garden County",1,10,16,6,10
050,31,069,"Nebraska","Garden County",1,11,20,14,6
050,31,069,"Nebraska","Garden County",1,12,23,18,5
050,31,069,"Nebraska","Garden County",1,13,19,14,5
050,31,069,"Nebraska","Garden County",1,14,23,16,7
050,31,069,"Nebraska","Garden County",1,15,30,18,12
050,31,069,"Nebraska","Garden County",1,16,27,15,12
050,31,069,"Nebraska","Garden County",1,17,25,19,6
050,31,069,"Nebraska","Garden County",1,18,16,10,6
050,31,069,"Nebraska","Garden County",1,19,16,12,4
050,31,069,"Nebraska","Garden County",1,20,12,6,6
050,31,069,"Nebraska","Garden County",1,21,8,3,5
050,31,069,"Nebraska","Garden County",1,22,13,5,8
050,31,069,"Nebraska","Garden County",1,23,14,5,9
050,31,069,"Nebraska","Garden County",1,24,16,10,6
050,31,069,"Nebraska","Garden County",1,25,11,6,5
050,31,069,"Nebraska","Garden County",1,26,14,9,5
050,31,069,"Nebraska","Garden County",1,27,15,9,6
050,31,069,"Nebraska","Garden County",1,28,17,11,6
050,31,069,"Nebraska","Garden County",1,29,16,9,7
050,31,069,"Nebraska","Garden County",1,30,16,10,6
050,31,069,"Nebraska","Garden County",1,31,27,14,13
050,31,069,"Nebraska","Garden County",1,32,21,9,12
050,31,069,"Nebraska","Garden County",1,33,26,12,14
050,31,069,"Nebraska","Garden County",1,34,21,10,11
050,31,069,"Nebraska","Garden County",1,35,21,10,11
050,31,069,"Nebraska","Garden County",1,36,20,11,9
050,31,069,"Nebraska","Garden County",1,37,20,12,8
050,31,069,"Nebraska","Garden County",1,38,18,11,7
050,31,069,"Nebraska","Garden County",1,39,17,11,6
050,31,069,"Nebraska","Garden County",1,40,15,7,8
050,31,069,"Nebraska","Garden County",1,41,15,4,11
050,31,069,"Nebraska","Garden County",1,42,17,8,9
050,31,069,"Nebraska","Garden County",1,43,14,6,8
050,31,069,"Nebraska","Garden County",1,44,13,6,7
050,31,069,"Nebraska","Garden County",1,45,15,9,6
050,31,069,"Nebraska","Garden County",1,46,14,9,5
050,31,069,"Nebraska","Garden County",1,47,18,9,9
050,31,069,"Nebraska","Garden County",1,48,22,12,10
050,31,069,"Nebraska","Garden County",1,49,27,17,10
050,31,069,"Nebraska","Garden County",1,50,22,11,11
050,31,069,"Nebraska","Garden County",1,51,22,10,12
050,31,069,"Nebraska","Garden County",1,52,23,10,13
050,31,069,"Nebraska","Garden County",1,53,17,6,11
050,31,069,"Nebraska","Garden County",1,54,26,12,14
050,31,069,"Nebraska","Garden County",1,55,26,16,10
050,31,069,"Nebraska","Garden County",1,56,17,9,8
050,31,069,"Nebraska","Garden County",1,57,23,11,12
050,31,069,"Nebraska","Garden County",1,58,32,17,15
050,31,069,"Nebraska","Garden County",1,59,54,29,25
050,31,069,"Nebraska","Garden County",1,60,38,18,20
050,31,069,"Nebraska","Garden County",1,61,37,20,17
050,31,069,"Nebraska","Garden County",1,62,32,20,12
050,31,069,"Nebraska","Garden County",1,63,34,20,14
050,31,069,"Nebraska","Garden County",1,64,33,21,12
050,31,069,"Nebraska","Garden County",1,65,26,16,10
050,31,069,"Nebraska","Garden County",1,66,34,20,14
050,31,069,"Nebraska","Garden County",1,67,30,17,13
050,31,069,"Nebraska","Garden County",1,68,29,14,15
050,31,069,"Nebraska","Garden County",1,69,26,11,15
050,31,069,"Nebraska","Garden County",1,70,29,11,18
050,31,069,"Nebraska","Garden County",1,71,17,5,12
050,31,069,"Nebraska","Garden County",1,72,20,8,12
050,31,069,"Nebraska","Garden County",1,73,24,14,10
050,31,069,"Nebraska","Garden County",1,74,14,7,7
050,31,069,"Nebraska","Garden County",1,75,24,11,13
050,31,069,"Nebraska","Garden County",1,76,27,15,12
050,31,069,"Nebraska","Garden County",1,77,24,12,12
050,31,069,"Nebraska","Garden County",1,78,20,10,10
050,31,069,"Nebraska","Garden County",1,79,23,11,12
050,31,069,"Nebraska","Garden County",1,80,18,9,9
050,31,069,"Nebraska","Garden County",1,81,14,6,8
050,31,069,"Nebraska","Garden County",1,82,24,11,13
050,31,069,"Nebraska","Garden County",1,83,17,7,10
050,31,069,"Nebraska","Garden County",1,84,20,10,10
050,31,069,"Nebraska","Garden County",1,85,64,27,37
050,31,069,"Nebraska","Garden County",2,0,19,12,7
050,31,069,"Nebraska","Garden County",2,1,12,5,7
050,31,069,"Nebraska","Garden County",2,2,21,9,12
050,31,069,"Nebraska","Garden County",2,3,18,11,7
050,31,069,"Nebraska","Garden County",2,4,16,9,7
050,31,069,"Nebraska","Garden County",2,5,17,8,9
050,31,069,"Nebraska","Garden County",2,6,19,8,11
050,31,069,"Nebraska","Garden County",2,7,19,8,11
050,31,069,"Nebraska","Garden County",2,8,19,7,12
050,31,069,"Nebraska","Garden County",2,9,29,19,10
050,31,069,"Nebraska","Garden County",2,10,21,11,10
050,31,069,"Nebraska","Garden County",2,11,20,12,8
050,31,069,"Nebraska","Garden County",2,12,22,17,5
050,31,069,"Nebraska","Garden County",2,13,20,15,5
050,31,069,"Nebraska","Garden County",2,14,24,16,8
050,31,069,"Nebraska","Garden County",2,15,29,18,11
050,31,069,"Nebraska","Garden County",2,16,29,17,12
050,31,069,"Nebraska","Garden County",2,17,27,19,8
050,31,069,"Nebraska","Garden County",2,18,19,12,7
050,31,069,"Nebraska","Garden County",2,19,15,11,4
050,31,069,"Nebraska","Garden County",2,20,13,7,6
050,31,069,"Nebraska","Garden County",2,21,9,4,5
050,31,069,"Nebraska","Garden County",2,22,11,4,7
050,31,069,"Nebraska","Garden County",2,23,14,5,9
050,31,069,"Nebraska","Garden County",2,24,16,9,7
050,31,069,"Nebraska","Garden County",2,25,11,6,5
050,31,069,"Nebraska","Garden County",2,26,14,9,5
050,31,069,"Nebraska","Garden County",2,27,14,8,6
050,31,069,"Nebraska","Garden County",2,28,17,11,6
050,31,069,"Nebraska","Garden County",2,29,16,9,7
050,31,069,"Nebraska","Garden County",2,30,16,10,6
050,31,069,"Nebraska","Garden County",2,31,24,13,11
050,31,069,"Nebraska","Garden County",2,32,22,10,12
050,31,069,"Nebraska","Garden County",2,33,24,11,13
050,31,069,"Nebraska","Garden County",2,34,23,11,12
050,31,069,"Nebraska","Garden County",2,35,22,11,11
050,31,069,"Nebraska","Garden County",2,36,21,11,10
050,31,069,"Nebraska","Garden County",2,37,20,12,8
050,31,069,"Nebraska","Garden County",2,38,20,12,8
050,31,069,"Nebraska","Garden County",2,39,17,11,6
050,31,069,"Nebraska","Garden County",2,40,16,8,8
050,31,069,"Nebraska","Garden County",2,41,15,5,10
050,31,069,"Nebraska","Garden County",2,42,17,7,10
050,31,069,"Nebraska","Garden County",2,43,16,7,9
050,31,069,"Nebraska","Garden County",2,44,14,6,8
050,31,069,"Nebraska","Garden County",2,45,15,9,6
050,31,069,"Nebraska","Garden County",2,46,15,9,6
050,31,069,"Nebraska","Garden County",2,47,17,9,8
050,31,069,"Nebraska","Garden County",2,48,21,11,10
050,31,069,"Nebraska","Garden County",2,49,26,16,10
050,31,069,"Nebraska","Garden County",2,50,22,12,10
050,31,069,"Nebraska","Garden County",2,51,22,11,11
050,31,069,"Nebraska","Garden County",2,52,22,10,12
050,31,069,"Nebraska","Garden County",2,53,19,7,12
050,31,069,"Nebraska","Garden County",2,54,24,11,13
050,31,069,"Nebraska","Garden County",2,55,26,15,11
050,31,069,"Nebraska","Garden County",2,56,20,11,9
050,31,069,"Nebraska","Garden County",2,57,22,11,11
050,31,069,"Nebraska","Garden County",2,58,29,15,14
050,31,069,"Nebraska","Garden County",2,59,50,27,23
050,31,069,"Nebraska","Garden County",2,60,42,21,21
050,31,069,"Nebraska","Garden County",2,61,37,20,17
050,31,069,"Nebraska","Garden County",2,62,33,20,13
050,31,069,"Nebraska","Garden County",2,63,32,18,14
050,31,069,"Nebraska","Garden County",2,64,33,21,12
050,31,069,"Nebraska","Garden County",2,65,28,18,10
050,31,069,"Nebraska","Garden County",2,66,32,19,13
050,31,069,"Nebraska","Garden County",2,67,31,17,14
050,31,069,"Nebraska","Garden County",2,68,29,15,14
050,31,069,"Nebraska","Garden County",2,69,27,12,15
050,31,069,"Nebraska","Garden County",2,70,29,11,18
050,31,069,"Nebraska","Garden County",2,71,20,6,14
050,31,069,"Nebraska","Garden County",2,72,17,7,10
050,31,069,"Nebraska","Garden County",2,73,24,13,11
050,31,069,"Nebraska","Garden County",2,74,15,8,7
050,31,069,"Nebraska","Garden County",2,75,22,10,12
050,31,069,"Nebraska","Garden County",2,76,26,14,12
050,31,069,"Nebraska","Garden County",2,77,25,13,12
050,31,069,"Nebraska","Garden County",2,78,20,10,10
050,31,069,"Nebraska","Garden County",2,79,20,9,11
050,31,069,"Nebraska","Garden County",2,80,18,9,9
050,31,069,"Nebraska","Garden County",2,81,15,7,8
050,31,069,"Nebraska","Garden County",2,82,19,9,10
050,31,069,"Nebraska","Garden County",2,83,19,8,11
050,31,069,"Nebraska","Garden County",2,84,19,9,10
050,31,069,"Nebraska","Garden County",2,85,67,28,39
050,31,069,"Nebraska","Garden County",3,0,14,4,10
050,31,069,"Nebraska","Garden County",3,1,21,14,7
050,31,069,"Nebraska","Garden County",3,2,11,4,7
050,31,069,"Nebraska","Garden County",3,3,23,10,13
050,31,069,"Nebraska","Garden County",3,4,17,12,5
050,31,069,"Nebraska","Garden County",3,5,20,9,11
050,31,069,"Nebraska","Garden County",3,6,13,7,6
050,31,069,"Nebraska","Garden County",3,7,20,8,12
050,31,069,"Nebraska","Garden County",3,8,22,10,12
050,31,069,"Nebraska","Garden County",3,9,21,7,14
050,31,069,"Nebraska","Garden County",3,10,27,18,9
050,31,069,"Nebraska","Garden County",3,11,22,12,10
050,31,069,"Nebraska","Garden County",3,12,19,11,8
050,31,069,"Nebraska","Garden County",3,13,19,15,4
050,31,069,"Nebraska","Garden County",3,14,18,16,2
050,31,069,"Nebraska","Garden County",3,15,16,12,4
050,31,069,"Nebraska","Garden County",3,16,23,14,9
050,31,069,"Nebraska","Garden County",3,17,27,15,12
050,31,069,"Nebraska","Garden County",3,18,20,14,6
050,31,069,"Nebraska","Garden County",3,19,15,9,6
050,31,069,"Nebraska","Garden County",3,20,12,8,4
050,31,069,"Nebraska","Garden County",3,21,10,3,7
050,31,069,"Nebraska","Garden County",3,22,11,5,6
050,31,069,"Nebraska","Garden County",3,23,13,4,9
050,31,069,"Nebraska","Garden County",3,24,14,4,10
050,31,069,"Nebraska","Garden County",3,25,19,13,6
050,31,069,"Nebraska","Garden County",3,26,14,8,6
050,31,069,"Nebraska","Garden County",3,27,13,8,5
050,31,069,"Nebraska","Garden County",3,28,14,8,6
050,31,069,"Nebraska","Garden County",3,29,14,10,4
050,31,069,"Nebraska","Garden County",3,30,16,8,8
050,31,069,"Nebraska","Garden County",3,31,16,8,8
050,31,069,"Nebraska","Garden County",3,32,26,15,11
050,31,069,"Nebraska","Garden County",3,33,19,4,15
050,31,069,"Nebraska","Garden County",3,34,24,12,12
050,31,069,"Nebraska","Garden County",3,35,27,14,13
050,31,069,"Nebraska","Garden County",3,36,20,8,12
050,31,069,"Nebraska","Garden County",3,37,20,12,8
050,31,069,"Nebraska","Garden County",3,38,20,12,8
050,31,069,"Nebraska","Garden County",3,39,21,12,9
050,31,069,"Nebraska","Garden County",3,40,16,10,6
050,31,069,"Nebraska","Garden County",3,41,15,6,9
050,31,069,"Nebraska","Garden County",3,42,15,5,10
050,31,069,"Nebraska","Garden County",3,43,14,5,9
050,31,069,"Nebraska","Garden County",3,44,16,8,8
050,31,069,"Nebraska","Garden County",3,45,14,6,8
050,31,069,"Nebraska","Garden County",3,46,12,8,4
050,31,069,"Nebraska","Garden County",3,47,12,6,6
050,31,069,"Nebraska","Garden County",3,48,18,9,9
050,31,069,"Nebraska","Garden County",3,49,22,11,11
050,31,069,"Nebraska","Garden County",3,50,23,13,10
050,31,069,"Nebraska","Garden County",3,51,23,13,10
050,31,069,"Nebraska","Garden County",3,52,20,9,11
050,31,069,"Nebraska","Garden County",3,53,23,10,13
050,31,069,"Nebraska","Garden County",3,54,20,8,12
050,31,069,"Nebraska","Garden County",3,55,24,11,13
050,31,069,"Nebraska","Garden County",3,56,26,15,11
050,31,069,"Nebraska","Garden County",3,57,22,13,9
050,31,069,"Nebraska","Garden County",3,58,22,11,11
050,31,069,"Nebraska","Garden County",3,59,31,17,14
050,31,069,"Nebraska","Garden County",3,60,48,27,21
050,31,069,"Nebraska","Garden County",3,61,40,20,20
050,31,069,"Nebraska","Garden County",3,62,35,20,15
050,31,069,"Nebraska","Garden County",3,63,31,19,12
050,31,069,"Nebraska","Garden County",3,64,29,15,14
050,31,069,"Nebraska","Garden County",3,65,32,21,11
050,31,069,"Nebraska","Garden County",3,66,28,18,10
050,31,069,"Nebraska","Garden County",3,67,32,17,15
050,31,069,"Nebraska","Garden County",3,68,34,18,16
050,31,069,"Nebraska","Garden County",3,69,29,17,12
050,31,069,"Nebraska","Garden County",3,70,27,11,16
050,31,069,"Nebraska","Garden County",3,71,30,11,19
050,31,069,"Nebraska","Garden County",3,72,19,5,14
050,31,069,"Nebraska","Garden County",3,73,16,6,10
050,31,069,"Nebraska","Garden County",3,74,23,13,10
050,31,069,"Nebraska","Garden County",3,75,14,7,7
050,31,069,"Nebraska","Garden County",3,76,21,8,13
050,31,069,"Nebraska","Garden County",3,77,25,13,12
050,31,069,"Nebraska","Garden County",3,78,21,10,11
050,31,069,"Nebraska","Garden County",3,79,21,10,11
050,31,069,"Nebraska","Garden County",3,80,17,8,9
050,31,069,"Nebraska","Garden County",3,81,20,10,10
050,31,069,"Nebraska","Garden County",3,82,16,7,9
050,31,069,"Nebraska","Garden County",3,83,18,9,9
050,31,069,"Nebraska","Garden County",3,84,17,8,9
050,31,069,"Nebraska","Garden County",3,85,76,35,41
050,31,069,"Nebraska","Garden County",4,0,16,5,11
050,31,069,"Nebraska","Garden County",4,1,16,4,12
050,31,069,"Nebraska","Garden County",4,2,21,14,7
050,31,069,"Nebraska","Garden County",4,3,16,8,8
050,31,069,"Nebraska","Garden County",4,4,22,10,12
050,31,069,"Nebraska","Garden County",4,5,18,11,7
050,31,069,"Nebraska","Garden County",4,6,19,8,11
050,31,069,"Nebraska","Garden County",4,7,17,9,8
050,31,069,"Nebraska","Garden County",4,8,19,9,10
050,31,069,"Nebraska","Garden County",4,9,17,8,9
050,31,069,"Nebraska","Garden County",4,10,21,7,14
050,31,069,"Nebraska","Garden County",4,11,26,16,10
050,31,069,"Nebraska","Garden County",4,12,21,10,11
050,31,069,"Nebraska","Garden County",4,13,20,12,8
050,31,069,"Nebraska","Garden County",4,14,19,15,4
050,31,069,"Nebraska","Garden County",4,15,17,14,3
050,31,069,"Nebraska","Garden County",4,16,15,11,4
050,31,069,"Nebraska","Garden County",4,17,24,15,9
050,31,069,"Nebraska","Garden County",4,18,22,12,10
050,31,069,"Nebraska","Garden County",4,19,14,10,4
050,31,069,"Nebraska","Garden County",4,20,12,5,7
050,31,069,"Nebraska","Garden County",4,21,14,8,6
050,31,069,"Nebraska","Garden County",4,22,9,3,6
050,31,069,"Nebraska","Garden County",4,23,11,4,7
050,31,069,"Nebraska","Garden County",4,24,12,2,10
050,31,069,"Nebraska","Garden County",4,25,13,5,8
050,31,069,"Nebraska","Garden County",4,26,20,14,6
050,31,069,"Nebraska","Garden County",4,27,16,8,8
050,31,069,"Nebraska","Garden County",4,28,12,8,4
050,31,069,"Nebraska","Garden County",4,29,14,8,6
050,31,069,"Nebraska","Garden County",4,30,14,10,4
050,31,069,"Nebraska","Garden County",4,31,14,6,8
050,31,069,"Nebraska","Garden County",4,32,15,7,8
050,31,069,"Nebraska","Garden County",4,33,26,15,11
050,31,069,"Nebraska","Garden County",4,34,17,5,12
050,31,069,"Nebraska","Garden County",4,35,23,13,10
050,31,069,"Nebraska","Garden County",4,36,27,11,16
050,31,069,"Nebraska","Garden County",4,37,22,9,13
050,31,069,"Nebraska","Garden County",4,38,24,15,9
050,31,069,"Nebraska","Garden County",4,39,21,13,8
050,31,069,"Nebraska","Garden County",4,40,19,8,11
050,31,069,"Nebraska","Garden County",4,41,19,12,7
050,31,069,"Nebraska","Garden County",4,42,13,4,9
050,31,069,"Nebraska","Garden County",4,43,16,5,11
050,31,069,"Nebraska","Garden County",4,44,16,6,10
050,31,069,"Nebraska","Garden County",4,45,16,8,8
050,31,069,"Nebraska","Garden County",4,46,14,6,8
050,31,069,"Nebraska","Garden County",4,47,13,7,6
050,31,069,"Nebraska","Garden County",4,48,12,6,6
050,31,069,"Nebraska","Garden County",4,49,18,9,9
050,31,069,"Nebraska","Garden County",4,50,22,11,11
050,31,069,"Nebraska","Garden County",4,51,23,13,10
050,31,069,"Nebraska","Garden County",4,52,23,13,10
050,31,069,"Nebraska","Garden County",4,53,21,9,12
050,31,069,"Nebraska","Garden County",4,54,24,11,13
050,31,069,"Nebraska","Garden County",4,55,21,8,13
050,31,069,"Nebraska","Garden County",4,56,28,11,17
050,31,069,"Nebraska","Garden County",4,57,30,18,12
050,31,069,"Nebraska","Garden County",4,58,25,15,10
050,31,069,"Nebraska","Garden County",4,59,23,12,11
050,31,069,"Nebraska","Garden County",4,60,32,18,14
050,31,069,"Nebraska","Garden County",4,61,51,27,24
050,31,069,"Nebraska","Garden County",4,62,36,15,21
050,31,069,"Nebraska","Garden County",4,63,34,20,14
050,31,069,"Nebraska","Garden County",4,64,29,17,12
050,31,069,"Nebraska","Garden County",4,65,29,15,14
050,31,069,"Nebraska","Garden County",4,66,30,20,10
050,31,069,"Nebraska","Garden County",4,67,29,18,11
050,31,069,"Nebraska","Garden County",4,68,32,18,14
050,31,069,"Nebraska","Garden County",4,69,35,18,17
050,31,069,"Nebraska","Garden County",4,70,29,18,11
050,31,069,"Nebraska","Garden County",4,71,28,12,16
050,31,069,"Nebraska","Garden County",4,72,32,14,18
050,31,069,"Nebraska","Garden County",4,73,17,4,13
050,31,069,"Nebraska","Garden County",4,74,16,6,10
050,31,069,"Nebraska","Garden County",4,75,23,12,11
050,31,069,"Nebraska","Garden County",4,76,13,6,7
050,31,069,"Nebraska","Garden County",4,77,20,7,13
050,31,069,"Nebraska","Garden County",4,78,23,12,11
050,31,069,"Nebraska","Garden County",4,79,19,10,9
050,31,069,"Nebraska","Garden County",4,80,19,10,9
050,31,069,"Nebraska","Garden County",4,81,20,10,10
050,31,069,"Nebraska","Garden County",4,82,18,8,10
050,31,069,"Nebraska","Garden County",4,83,17,7,10
050,31,069,"Nebraska","Garden County",4,84,15,7,8
050,31,069,"Nebraska","Garden County",4,85,77,38,39
050,31,069,"Nebraska","Garden County",5,0,17,6,11
050,31,069,"Nebraska","Garden County",5,1,20,9,11
050,31,069,"Nebraska","Garden County",5,2,18,6,12
050,31,069,"Nebraska","Garden County",5,3,19,12,7
050,31,069,"Nebraska","Garden County",5,4,16,7,9
050,31,069,"Nebraska","Garden County",5,5,25,12,13
050,31,069,"Nebraska","Garden County",5,6,15,10,5
050,31,069,"Nebraska","Garden County",5,7,14,6,8
050,31,069,"Nebraska","Garden County",5,8,17,10,7
050,31,069,"Nebraska","Garden County",5,9,18,10,8
050,31,069,"Nebraska","Garden County",5,10,14,8,6
050,31,069,"Nebraska","Garden County",5,11,19,7,12
050,31,069,"Nebraska","Garden County",5,12,24,13,11
050,31,069,"Nebraska","Garden County",5,13,20,9,11
050,31,069,"Nebraska","Garden County",5,14,19,9,10
050,31,069,"Nebraska","Garden County",5,15,20,16,4
050,31,069,"Nebraska","Garden County",5,16,17,14,3
050,31,069,"Nebraska","Garden County",5,17,14,8,6
050,31,069,"Nebraska","Garden County",5,18,18,12,6
050,31,069,"Nebraska","Garden County",5,19,17,10,7
050,31,069,"Nebraska","Garden County",5,20,13,8,5
050,31,069,"Nebraska","Garden County",5,21,11,5,6
050,31,069,"Nebraska","Garden County",5,22,13,8,5
050,31,069,"Nebraska","Garden County",5,23,8,1,7
050,31,069,"Nebraska","Garden County",5,24,14,4,10
050,31,069,"Nebraska","Garden County",5,25,9,2,7
050,31,069,"Nebraska","Garden County",5,26,14,5,9
050,31,069,"Nebraska","Garden County",5,27,15,11,4
050,31,069,"Nebraska","Garden County",5,28,15,8,7
050,31,069,"Nebraska","Garden County",5,29,11,6,5
050,31,069,"Nebraska","Garden County",5,30,13,8,5
050,31,069,"Nebraska","Garden County",5,31,13,9,4
050,31,069,"Nebraska","Garden County",5,32,17,6,11
050,31,069,"Nebraska","Garden County",5,33,15,7,8
050,31,069,"Nebraska","Garden County",5,34,27,16,11
050,31,069,"Nebraska","Garden County",5,35,20,6,14
050,31,069,"Nebraska","Garden County",5,36,21,12,9
050,31,069,"Nebraska","Garden County",5,37,25,14,11
050,31,069,"Nebraska","Garden County",5,38,20,8,12
050,31,069,"Nebraska","Garden County",5,39,23,13,10
050,31,069,"Nebraska","Garden County",5,40,22,13,9
050,31,069,"Nebraska","Garden County",5,41,20,9,11
050,31,069,"Nebraska","Garden County",5,42,18,10,8
050,31,069,"Nebraska","Garden County",5,43,12,5,7
050,31,069,"Nebraska","Garden County",5,44,15,6,9
050,31,069,"Nebraska","Garden County",5,45,17,6,11
050,31,069,"Nebraska","Garden County",5,46,15,7,8
050,31,069,"Nebraska","Garden County",5,47,13,5,8
050,31,069,"Nebraska","Garden County",5,48,13,7,6
050,31,069,"Nebraska","Garden County",5,49,16,7,9
050,31,069,"Nebraska","Garden County",5,50,18,9,9
050,31,069,"Nebraska","Garden County",5,51,23,11,12
050,31,069,"Nebraska","Garden County",5,52,27,14,13
050,31,069,"Nebraska","Garden County",5,53,24,15,9
050,31,069,"Nebraska","Garden County",5,54,23,11,12
050,31,069,"Nebraska","Garden County",5,55,24,11,13
050,31,069,"Nebraska","Garden County",5,56,22,8,14
050,31,069,"Nebraska","Garden County",5,57,27,11,16
050,31,069,"Nebraska","Garden County",5,58,29,17,12
050,31,069,"Nebraska","Garden County",5,59,26,14,12
050,31,069,"Nebraska","Garden County",5,60,22,11,11
050,31,069,"Nebraska","Garden County",5,61,33,17,16
050,31,069,"Nebraska","Garden County",5,62,49,25,24
050,31,069,"Nebraska","Garden County",5,63,38,17,21
050,31,069,"Nebraska","Garden County",5,64,37,23,14
050,31,069,"Nebraska","Garden County",5,65,28,16,12
050,31,069,"Nebraska","Garden County",5,66,29,15,14
050,31,069,"Nebraska","Garden County",5,67,29,19,10
050,31,069,"Nebraska","Garden County",5,68,28,17,11
050,31,069,"Nebraska","Garden County",5,69,32,17,15
050,31,069,"Nebraska","Garden County",5,70,32,16,16
050,31,069,"Nebraska","Garden County",5,71,29,17,12
050,31,069,"Nebraska","Garden County",5,72,27,12,15
050,31,069,"Nebraska","Garden County",5,73,30,13,17
050,31,069,"Nebraska","Garden County",5,74,16,4,12
050,31,069,"Nebraska","Garden County",5,75,14,4,10
050,31,069,"Nebraska","Garden County",5,76,22,11,11
050,31,069,"Nebraska","Garden County",5,77,12,5,7
050,31,069,"Nebraska","Garden County",5,78,18,6,12
050,31,069,"Nebraska","Garden County",5,79,21,11,10
050,31,069,"Nebraska","Garden County",5,80,17,9,8
050,31,069,"Nebraska","Garden County",5,81,19,10,9
050,31,069,"Nebraska","Garden County",5,82,20,10,10
050,31,069,"Nebraska","Garden County",5,83,17,8,9
050,31,069,"Nebraska","Garden County",5,84,14,5,9
050,31,069,"Nebraska","Garden County",5,85,79,38,41
050,31,071,"Nebraska","Garfield County",1,0,20,10,10
050,31,071,"Nebraska","Garfield County",1,1,21,8,13
050,31,071,"Nebraska","Garfield County",1,2,23,13,10
050,31,071,"Nebraska","Garfield County",1,3,21,13,8
050,31,071,"Nebraska","Garfield County",1,4,14,8,6
050,31,071,"Nebraska","Garfield County",1,5,17,7,10
050,31,071,"Nebraska","Garfield County",1,6,14,8,6
050,31,071,"Nebraska","Garfield County",1,7,12,6,6
050,31,071,"Nebraska","Garfield County",1,8,19,10,9
050,31,071,"Nebraska","Garfield County",1,9,17,11,6
050,31,071,"Nebraska","Garfield County",1,10,14,6,8
050,31,071,"Nebraska","Garfield County",1,11,17,10,7
050,31,071,"Nebraska","Garfield County",1,12,18,7,11
050,31,071,"Nebraska","Garfield County",1,13,18,7,11
050,31,071,"Nebraska","Garfield County",1,14,21,9,12
050,31,071,"Nebraska","Garfield County",1,15,21,11,10
050,31,071,"Nebraska","Garfield County",1,16,22,11,11
050,31,071,"Nebraska","Garfield County",1,17,24,10,14
050,31,071,"Nebraska","Garfield County",1,18,17,8,9
050,31,071,"Nebraska","Garfield County",1,19,15,8,7
050,31,071,"Nebraska","Garfield County",1,20,20,10,10
050,31,071,"Nebraska","Garfield County",1,21,18,8,10
050,31,071,"Nebraska","Garfield County",1,22,20,11,9
050,31,071,"Nebraska","Garfield County",1,23,16,6,10
050,31,071,"Nebraska","Garfield County",1,24,18,8,10
050,31,071,"Nebraska","Garfield County",1,25,27,16,11
050,31,071,"Nebraska","Garfield County",1,26,22,13,9
050,31,071,"Nebraska","Garfield County",1,27,15,10,5
050,31,071,"Nebraska","Garfield County",1,28,13,6,7
050,31,071,"Nebraska","Garfield County",1,29,12,5,7
050,31,071,"Nebraska","Garfield County",1,30,20,8,12
050,31,071,"Nebraska","Garfield County",1,31,16,9,7
050,31,071,"Nebraska","Garfield County",1,32,13,7,6
050,31,071,"Nebraska","Garfield County",1,33,12,7,5
050,31,071,"Nebraska","Garfield County",1,34,21,13,8
050,31,071,"Nebraska","Garfield County",1,35,24,13,11
050,31,071,"Nebraska","Garfield County",1,36,20,12,8
050,31,071,"Nebraska","Garfield County",1,37,17,7,10
050,31,071,"Nebraska","Garfield County",1,38,15,10,5
050,31,071,"Nebraska","Garfield County",1,39,16,10,6
050,31,071,"Nebraska","Garfield County",1,40,10,6,4
050,31,071,"Nebraska","Garfield County",1,41,16,7,9
050,31,071,"Nebraska","Garfield County",1,42,19,10,9
050,31,071,"Nebraska","Garfield County",1,43,15,10,5
050,31,071,"Nebraska","Garfield County",1,44,18,10,8
050,31,071,"Nebraska","Garfield County",1,45,20,10,10
050,31,071,"Nebraska","Garfield County",1,46,20,6,14
050,31,071,"Nebraska","Garfield County",1,47,13,6,7
050,31,071,"Nebraska","Garfield County",1,48,11,4,7
050,31,071,"Nebraska","Garfield County",1,49,14,7,7
050,31,071,"Nebraska","Garfield County",1,50,17,7,10
050,31,071,"Nebraska","Garfield County",1,51,22,12,10
050,31,071,"Nebraska","Garfield County",1,52,17,11,6
050,31,071,"Nebraska","Garfield County",1,53,17,10,7
050,31,071,"Nebraska","Garfield County",1,54,21,11,10
050,31,071,"Nebraska","Garfield County",1,55,19,8,11
050,31,071,"Nebraska","Garfield County",1,56,26,10,16
050,31,071,"Nebraska","Garfield County",1,57,30,13,17
050,31,071,"Nebraska","Garfield County",1,58,34,17,17
050,31,071,"Nebraska","Garfield County",1,59,35,17,18
050,31,071,"Nebraska","Garfield County",1,60,31,17,14
050,31,071,"Nebraska","Garfield County",1,61,27,15,12
050,31,071,"Nebraska","Garfield County",1,62,36,18,18
050,31,071,"Nebraska","Garfield County",1,63,30,16,14
050,31,071,"Nebraska","Garfield County",1,64,30,18,12
050,31,071,"Nebraska","Garfield County",1,65,37,23,14
050,31,071,"Nebraska","Garfield County",1,66,37,22,15
050,31,071,"Nebraska","Garfield County",1,67,28,15,13
050,31,071,"Nebraska","Garfield County",1,68,27,14,13
050,31,071,"Nebraska","Garfield County",1,69,22,12,10
050,31,071,"Nebraska","Garfield County",1,70,24,15,9
050,31,071,"Nebraska","Garfield County",1,71,29,17,12
050,31,071,"Nebraska","Garfield County",1,72,21,10,11
050,31,071,"Nebraska","Garfield County",1,73,23,9,14
050,31,071,"Nebraska","Garfield County",1,74,18,9,9
050,31,071,"Nebraska","Garfield County",1,75,27,13,14
050,31,071,"Nebraska","Garfield County",1,76,25,12,13
050,31,071,"Nebraska","Garfield County",1,77,21,9,12
050,31,071,"Nebraska","Garfield County",1,78,12,4,8
050,31,071,"Nebraska","Garfield County",1,79,16,4,12
050,31,071,"Nebraska","Garfield County",1,80,15,9,6
050,31,071,"Nebraska","Garfield County",1,81,14,9,5
050,31,071,"Nebraska","Garfield County",1,82,18,7,11
050,31,071,"Nebraska","Garfield County",1,83,18,9,9
050,31,071,"Nebraska","Garfield County",1,84,26,10,16
050,31,071,"Nebraska","Garfield County",1,85,89,25,64
050,31,071,"Nebraska","Garfield County",2,0,22,10,12
050,31,071,"Nebraska","Garfield County",2,1,20,8,12
050,31,071,"Nebraska","Garfield County",2,2,23,12,11
050,31,071,"Nebraska","Garfield County",2,3,22,13,9
050,31,071,"Nebraska","Garfield County",2,4,15,9,6
050,31,071,"Nebraska","Garfield County",2,5,16,7,9
050,31,071,"Nebraska","Garfield County",2,6,15,8,7
050,31,071,"Nebraska","Garfield County",2,7,13,7,6
050,31,071,"Nebraska","Garfield County",2,8,17,9,8
050,31,071,"Nebraska","Garfield County",2,9,18,11,7
050,31,071,"Nebraska","Garfield County",2,10,14,7,7
050,31,071,"Nebraska","Garfield County",2,11,16,9,7
050,31,071,"Nebraska","Garfield County",2,12,18,8,10
050,31,071,"Nebraska","Garfield County",2,13,18,7,11
050,31,071,"Nebraska","Garfield County",2,14,19,8,11
050,31,071,"Nebraska","Garfield County",2,15,21,11,10
050,31,071,"Nebraska","Garfield County",2,16,21,11,10
050,31,071,"Nebraska","Garfield County",2,17,23,10,13
050,31,071,"Nebraska","Garfield County",2,18,18,8,10
050,31,071,"Nebraska","Garfield County",2,19,14,7,7
050,31,071,"Nebraska","Garfield County",2,20,20,10,10
050,31,071,"Nebraska","Garfield County",2,21,19,9,10
050,31,071,"Nebraska","Garfield County",2,22,19,10,9
050,31,071,"Nebraska","Garfield County",2,23,17,7,10
050,31,071,"Nebraska","Garfield County",2,24,19,8,11
050,31,071,"Nebraska","Garfield County",2,25,26,15,11
050,31,071,"Nebraska","Garfield County",2,26,23,13,10
050,31,071,"Nebraska","Garfield County",2,27,17,11,6
050,31,071,"Nebraska","Garfield County",2,28,14,7,7
050,31,071,"Nebraska","Garfield County",2,29,13,5,8
050,31,071,"Nebraska","Garfield County",2,30,19,8,11
050,31,071,"Nebraska","Garfield County",2,31,16,8,8
050,31,071,"Nebraska","Garfield County",2,32,14,8,6
050,31,071,"Nebraska","Garfield County",2,33,12,7,5
050,31,071,"Nebraska","Garfield County",2,34,18,11,7
050,31,071,"Nebraska","Garfield County",2,35,23,13,10
050,31,071,"Nebraska","Garfield County",2,36,21,12,9
050,31,071,"Nebraska","Garfield County",2,37,18,8,10
050,31,071,"Nebraska","Garfield County",2,38,15,9,6
050,31,071,"Nebraska","Garfield County",2,39,16,10,6
050,31,071,"Nebraska","Garfield County",2,40,12,7,5
050,31,071,"Nebraska","Garfield County",2,41,15,7,8
050,31,071,"Nebraska","Garfield County",2,42,18,9,9
050,31,071,"Nebraska","Garfield County",2,43,16,10,6
050,31,071,"Nebraska","Garfield County",2,44,17,10,7
050,31,071,"Nebraska","Garfield County",2,45,19,10,9
050,31,071,"Nebraska","Garfield County",2,46,20,7,13
050,31,071,"Nebraska","Garfield County",2,47,14,6,8
050,31,071,"Nebraska","Garfield County",2,48,11,4,7
050,31,071,"Nebraska","Garfield County",2,49,13,6,7
050,31,071,"Nebraska","Garfield County",2,50,16,7,9
050,31,071,"Nebraska","Garfield County",2,51,22,11,11
050,31,071,"Nebraska","Garfield County",2,52,17,11,6
050,31,071,"Nebraska","Garfield County",2,53,17,10,7
050,31,071,"Nebraska","Garfield County",2,54,20,10,10
050,31,071,"Nebraska","Garfield County",2,55,18,8,10
050,31,071,"Nebraska","Garfield County",2,56,23,9,14
050,31,071,"Nebraska","Garfield County",2,57,30,12,18
050,31,071,"Nebraska","Garfield County",2,58,32,16,16
050,31,071,"Nebraska","Garfield County",2,59,35,17,18
050,31,071,"Nebraska","Garfield County",2,60,31,16,15
050,31,071,"Nebraska","Garfield County",2,61,28,16,12
050,31,071,"Nebraska","Garfield County",2,62,34,17,17
050,31,071,"Nebraska","Garfield County",2,63,33,17,16
050,31,071,"Nebraska","Garfield County",2,64,30,18,12
050,31,071,"Nebraska","Garfield County",2,65,35,22,13
050,31,071,"Nebraska","Garfield County",2,66,37,23,14
050,31,071,"Nebraska","Garfield County",2,67,30,17,13
050,31,071,"Nebraska","Garfield County",2,68,28,15,13
050,31,071,"Nebraska","Garfield County",2,69,22,11,11
050,31,071,"Nebraska","Garfield County",2,70,21,13,8
050,31,071,"Nebraska","Garfield County",2,71,29,17,12
050,31,071,"Nebraska","Garfield County",2,72,21,11,10
050,31,071,"Nebraska","Garfield County",2,73,24,10,14
050,31,071,"Nebraska","Garfield County",2,74,18,8,10
050,31,071,"Nebraska","Garfield County",2,75,25,12,13
050,31,071,"Nebraska","Garfield County",2,76,25,12,13
050,31,071,"Nebraska","Garfield County",2,77,23,10,13
050,31,071,"Nebraska","Garfield County",2,78,14,5,9
050,31,071,"Nebraska","Garfield County",2,79,15,4,11
050,31,071,"Nebraska","Garfield County",2,80,15,8,7
050,31,071,"Nebraska","Garfield County",2,81,14,9,5
050,31,071,"Nebraska","Garfield County",2,82,17,7,10
050,31,071,"Nebraska","Garfield County",2,83,15,6,9
050,31,071,"Nebraska","Garfield County",2,84,26,9,17
050,31,071,"Nebraska","Garfield County",2,85,90,26,64
050,31,071,"Nebraska","Garfield County",3,0,25,14,11
050,31,071,"Nebraska","Garfield County",3,1,20,8,12
050,31,071,"Nebraska","Garfield County",3,2,23,11,12
050,31,071,"Nebraska","Garfield County",3,3,23,11,12
050,31,071,"Nebraska","Garfield County",3,4,22,13,9
050,31,071,"Nebraska","Garfield County",3,5,14,10,4
050,31,071,"Nebraska","Garfield County",3,6,18,8,10
050,31,071,"Nebraska","Garfield County",3,7,15,7,8
050,31,071,"Nebraska","Garfield County",3,8,15,9,6
050,31,071,"Nebraska","Garfield County",3,9,17,10,7
050,31,071,"Nebraska","Garfield County",3,10,18,11,7
050,31,071,"Nebraska","Garfield County",3,11,12,7,5
050,31,071,"Nebraska","Garfield County",3,12,17,10,7
050,31,071,"Nebraska","Garfield County",3,13,15,7,8
050,31,071,"Nebraska","Garfield County",3,14,15,6,9
050,31,071,"Nebraska","Garfield County",3,15,22,11,11
050,31,071,"Nebraska","Garfield County",3,16,21,10,11
050,31,071,"Nebraska","Garfield County",3,17,22,11,11
050,31,071,"Nebraska","Garfield County",3,18,20,7,13
050,31,071,"Nebraska","Garfield County",3,19,15,7,8
050,31,071,"Nebraska","Garfield County",3,20,14,8,6
050,31,071,"Nebraska","Garfield County",3,21,23,12,11
050,31,071,"Nebraska","Garfield County",3,22,22,12,10
050,31,071,"Nebraska","Garfield County",3,23,17,6,11
050,31,071,"Nebraska","Garfield County",3,24,14,8,6
050,31,071,"Nebraska","Garfield County",3,25,18,6,12
050,31,071,"Nebraska","Garfield County",3,26,29,16,13
050,31,071,"Nebraska","Garfield County",3,27,24,14,10
050,31,071,"Nebraska","Garfield County",3,28,19,13,6
050,31,071,"Nebraska","Garfield County",3,29,17,8,9
050,31,071,"Nebraska","Garfield County",3,30,11,5,6
050,31,071,"Nebraska","Garfield County",3,31,25,11,14
050,31,071,"Nebraska","Garfield County",3,32,14,7,7
050,31,071,"Nebraska","Garfield County",3,33,15,10,5
050,31,071,"Nebraska","Garfield County",3,34,11,6,5
050,31,071,"Nebraska","Garfield County",3,35,22,15,7
050,31,071,"Nebraska","Garfield County",3,36,22,12,10
050,31,071,"Nebraska","Garfield County",3,37,21,14,7
050,31,071,"Nebraska","Garfield County",3,38,17,8,9
050,31,071,"Nebraska","Garfield County",3,39,13,8,5
050,31,071,"Nebraska","Garfield County",3,40,17,10,7
050,31,071,"Nebraska","Garfield County",3,41,14,8,6
050,31,071,"Nebraska","Garfield County",3,42,15,7,8
050,31,071,"Nebraska","Garfield County",3,43,17,9,8
050,31,071,"Nebraska","Garfield County",3,44,16,10,6
050,31,071,"Nebraska","Garfield County",3,45,17,10,7
050,31,071,"Nebraska","Garfield County",3,46,19,10,9
050,31,071,"Nebraska","Garfield County",3,47,22,8,14
050,31,071,"Nebraska","Garfield County",3,48,16,7,9
050,31,071,"Nebraska","Garfield County",3,49,11,4,7
050,31,071,"Nebraska","Garfield County",3,50,19,9,10
050,31,071,"Nebraska","Garfield County",3,51,19,7,12
050,31,071,"Nebraska","Garfield County",3,52,19,11,8
050,31,071,"Nebraska","Garfield County",3,53,19,12,7
050,31,071,"Nebraska","Garfield County",3,54,20,11,9
050,31,071,"Nebraska","Garfield County",3,55,18,8,10
050,31,071,"Nebraska","Garfield County",3,56,18,8,10
050,31,071,"Nebraska","Garfield County",3,57,33,12,21
050,31,071,"Nebraska","Garfield County",3,58,30,15,15
050,31,071,"Nebraska","Garfield County",3,59,32,15,17
050,31,071,"Nebraska","Garfield County",3,60,36,17,19
050,31,071,"Nebraska","Garfield County",3,61,33,15,18
050,31,071,"Nebraska","Garfield County",3,62,29,17,12
050,31,071,"Nebraska","Garfield County",3,63,34,17,17
050,31,071,"Nebraska","Garfield County",3,64,33,17,16
050,31,071,"Nebraska","Garfield County",3,65,31,18,13
050,31,071,"Nebraska","Garfield County",3,66,36,23,13
050,31,071,"Nebraska","Garfield County",3,67,36,22,14
050,31,071,"Nebraska","Garfield County",3,68,28,15,13
050,31,071,"Nebraska","Garfield County",3,69,29,13,16
050,31,071,"Nebraska","Garfield County",3,70,16,9,7
050,31,071,"Nebraska","Garfield County",3,71,25,14,11
050,31,071,"Nebraska","Garfield County",3,72,23,17,6
050,31,071,"Nebraska","Garfield County",3,73,20,10,10
050,31,071,"Nebraska","Garfield County",3,74,24,10,14
050,31,071,"Nebraska","Garfield County",3,75,18,7,11
050,31,071,"Nebraska","Garfield County",3,76,25,12,13
050,31,071,"Nebraska","Garfield County",3,77,23,12,11
050,31,071,"Nebraska","Garfield County",3,78,22,10,12
050,31,071,"Nebraska","Garfield County",3,79,14,5,9
050,31,071,"Nebraska","Garfield County",3,80,16,6,10
050,31,071,"Nebraska","Garfield County",3,81,12,7,5
050,31,071,"Nebraska","Garfield County",3,82,13,6,7
050,31,071,"Nebraska","Garfield County",3,83,16,9,7
050,31,071,"Nebraska","Garfield County",3,84,25,6,19
050,31,071,"Nebraska","Garfield County",3,85,88,26,62
050,31,071,"Nebraska","Garfield County",4,0,23,14,9
050,31,071,"Nebraska","Garfield County",4,1,23,12,11
050,31,071,"Nebraska","Garfield County",4,2,17,7,10
050,31,071,"Nebraska","Garfield County",4,3,22,10,12
050,31,071,"Nebraska","Garfield County",4,4,21,11,10
050,31,071,"Nebraska","Garfield County",4,5,21,13,8
050,31,071,"Nebraska","Garfield County",4,6,15,11,4
050,31,071,"Nebraska","Garfield County",4,7,17,8,9
050,31,071,"Nebraska","Garfield County",4,8,16,9,7
050,31,071,"Nebraska","Garfield County",4,9,17,11,6
050,31,071,"Nebraska","Garfield County",4,10,13,7,6
050,31,071,"Nebraska","Garfield County",4,11,23,13,10
050,31,071,"Nebraska","Garfield County",4,12,11,7,4
050,31,071,"Nebraska","Garfield County",4,13,14,8,6
050,31,071,"Nebraska","Garfield County",4,14,15,6,9
050,31,071,"Nebraska","Garfield County",4,15,16,6,10
050,31,071,"Nebraska","Garfield County",4,16,21,10,11
050,31,071,"Nebraska","Garfield County",4,17,18,10,8
050,31,071,"Nebraska","Garfield County",4,18,15,9,6
050,31,071,"Nebraska","Garfield County",4,19,14,5,9
050,31,071,"Nebraska","Garfield County",4,20,19,8,11
050,31,071,"Nebraska","Garfield County",4,21,15,8,7
050,31,071,"Nebraska","Garfield County",4,22,23,13,10
050,31,071,"Nebraska","Garfield County",4,23,23,14,9
050,31,071,"Nebraska","Garfield County",4,24,21,8,13
050,31,071,"Nebraska","Garfield County",4,25,14,7,7
050,31,071,"Nebraska","Garfield County",4,26,19,6,13
050,31,071,"Nebraska","Garfield County",4,27,29,14,15
050,31,071,"Nebraska","Garfield County",4,28,19,11,8
050,31,071,"Nebraska","Garfield County",4,29,16,11,5
050,31,071,"Nebraska","Garfield County",4,30,18,9,9
050,31,071,"Nebraska","Garfield County",4,31,17,7,10
050,31,071,"Nebraska","Garfield County",4,32,23,9,14
050,31,071,"Nebraska","Garfield County",4,33,11,5,6
050,31,071,"Nebraska","Garfield County",4,34,15,9,6
050,31,071,"Nebraska","Garfield County",4,35,11,6,5
050,31,071,"Nebraska","Garfield County",4,36,18,11,7
050,31,071,"Nebraska","Garfield County",4,37,23,12,11
050,31,071,"Nebraska","Garfield County",4,38,20,14,6
050,31,071,"Nebraska","Garfield County",4,39,14,8,6
050,31,071,"Nebraska","Garfield County",4,40,13,8,5
050,31,071,"Nebraska","Garfield County",4,41,18,11,7
050,31,071,"Nebraska","Garfield County",4,42,15,9,6
050,31,071,"Nebraska","Garfield County",4,43,15,7,8
050,31,071,"Nebraska","Garfield County",4,44,18,9,9
050,31,071,"Nebraska","Garfield County",4,45,12,10,2
050,31,071,"Nebraska","Garfield County",4,46,17,10,7
050,31,071,"Nebraska","Garfield County",4,47,19,10,9
050,31,071,"Nebraska","Garfield County",4,48,25,11,14
050,31,071,"Nebraska","Garfield County",4,49,14,5,9
050,31,071,"Nebraska","Garfield County",4,50,11,4,7
050,31,071,"Nebraska","Garfield County",4,51,20,7,13
050,31,071,"Nebraska","Garfield County",4,52,15,6,9
050,31,071,"Nebraska","Garfield County",4,53,18,10,8
050,31,071,"Nebraska","Garfield County",4,54,16,9,7
050,31,071,"Nebraska","Garfield County",4,55,22,13,9
050,31,071,"Nebraska","Garfield County",4,56,18,8,10
050,31,071,"Nebraska","Garfield County",4,57,22,8,14
050,31,071,"Nebraska","Garfield County",4,58,31,14,17
050,31,071,"Nebraska","Garfield County",4,59,28,14,14
050,31,071,"Nebraska","Garfield County",4,60,35,17,18
050,31,071,"Nebraska","Garfield County",4,61,36,17,19
050,31,071,"Nebraska","Garfield County",4,62,34,17,17
050,31,071,"Nebraska","Garfield County",4,63,27,16,11
050,31,071,"Nebraska","Garfield County",4,64,34,17,17
050,31,071,"Nebraska","Garfield County",4,65,33,16,17
050,31,071,"Nebraska","Garfield County",4,66,30,16,14
050,31,071,"Nebraska","Garfield County",4,67,39,26,13
050,31,071,"Nebraska","Garfield County",4,68,34,21,13
050,31,071,"Nebraska","Garfield County",4,69,30,15,15
050,31,071,"Nebraska","Garfield County",4,70,25,13,12
050,31,071,"Nebraska","Garfield County",4,71,19,9,10
050,31,071,"Nebraska","Garfield County",4,72,19,13,6
050,31,071,"Nebraska","Garfield County",4,73,20,15,5
050,31,071,"Nebraska","Garfield County",4,74,20,10,10
050,31,071,"Nebraska","Garfield County",4,75,23,10,13
050,31,071,"Nebraska","Garfield County",4,76,18,7,11
050,31,071,"Nebraska","Garfield County",4,77,23,11,12
050,31,071,"Nebraska","Garfield County",4,78,21,10,11
050,31,071,"Nebraska","Garfield County",4,79,21,9,12
050,31,071,"Nebraska","Garfield County",4,80,17,8,9
050,31,071,"Nebraska","Garfield County",4,81,14,6,8
050,31,071,"Nebraska","Garfield County",4,82,10,3,7
050,31,071,"Nebraska","Garfield County",4,83,10,7,3
050,31,071,"Nebraska","Garfield County",4,84,23,8,15
050,31,071,"Nebraska","Garfield County",4,85,85,20,65
050,31,071,"Nebraska","Garfield County",5,0,22,13,9
050,31,071,"Nebraska","Garfield County",5,1,24,16,8
050,31,071,"Nebraska","Garfield County",5,2,23,11,12
050,31,071,"Nebraska","Garfield County",5,3,17,7,10
050,31,071,"Nebraska","Garfield County",5,4,21,8,13
050,31,071,"Nebraska","Garfield County",5,5,23,13,10
050,31,071,"Nebraska","Garfield County",5,6,24,14,10
050,31,071,"Nebraska","Garfield County",5,7,18,14,4
050,31,071,"Nebraska","Garfield County",5,8,16,7,9
050,31,071,"Nebraska","Garfield County",5,9,16,10,6
050,31,071,"Nebraska","Garfield County",5,10,17,11,6
050,31,071,"Nebraska","Garfield County",5,11,14,7,7
050,31,071,"Nebraska","Garfield County",5,12,21,12,9
050,31,071,"Nebraska","Garfield County",5,13,12,8,4
050,31,071,"Nebraska","Garfield County",5,14,15,8,7
050,31,071,"Nebraska","Garfield County",5,15,16,7,9
050,31,071,"Nebraska","Garfield County",5,16,20,9,11
050,31,071,"Nebraska","Garfield County",5,17,22,11,11
050,31,071,"Nebraska","Garfield County",5,18,17,9,8
050,31,071,"Nebraska","Garfield County",5,19,11,6,5
050,31,071,"Nebraska","Garfield County",5,20,17,6,11
050,31,071,"Nebraska","Garfield County",5,21,18,7,11
050,31,071,"Nebraska","Garfield County",5,22,16,8,8
050,31,071,"Nebraska","Garfield County",5,23,24,13,11
050,31,071,"Nebraska","Garfield County",5,24,19,10,9
050,31,071,"Nebraska","Garfield County",5,25,23,9,14
050,31,071,"Nebraska","Garfield County",5,26,10,6,4
050,31,071,"Nebraska","Garfield County",5,27,20,9,11
050,31,071,"Nebraska","Garfield County",5,28,23,11,12
050,31,071,"Nebraska","Garfield County",5,29,18,11,7
050,31,071,"Nebraska","Garfield County",5,30,19,12,7
050,31,071,"Nebraska","Garfield County",5,31,19,10,9
050,31,071,"Nebraska","Garfield County",5,32,15,5,10
050,31,071,"Nebraska","Garfield County",5,33,25,12,13
050,31,071,"Nebraska","Garfield County",5,34,12,5,7
050,31,071,"Nebraska","Garfield County",5,35,17,11,6
050,31,071,"Nebraska","Garfield County",5,36,10,5,5
050,31,071,"Nebraska","Garfield County",5,37,18,12,6
050,31,071,"Nebraska","Garfield County",5,38,24,12,12
050,31,071,"Nebraska","Garfield County",5,39,19,13,6
050,31,071,"Nebraska","Garfield County",5,40,13,8,5
050,31,071,"Nebraska","Garfield County",5,41,14,9,5
050,31,071,"Nebraska","Garfield County",5,42,18,11,7
050,31,071,"Nebraska","Garfield County",5,43,14,8,6
050,31,071,"Nebraska","Garfield County",5,44,17,8,9
050,31,071,"Nebraska","Garfield County",5,45,19,9,10
050,31,071,"Nebraska","Garfield County",5,46,12,10,2
050,31,071,"Nebraska","Garfield County",5,47,17,10,7
050,31,071,"Nebraska","Garfield County",5,48,19,10,9
050,31,071,"Nebraska","Garfield County",5,49,25,11,14
050,31,071,"Nebraska","Garfield County",5,50,15,5,10
050,31,071,"Nebraska","Garfield County",5,51,13,4,9
050,31,071,"Nebraska","Garfield County",5,52,20,10,10
050,31,071,"Nebraska","Garfield County",5,53,14,5,9
050,31,071,"Nebraska","Garfield County",5,54,16,10,6
050,31,071,"Nebraska","Garfield County",5,55,12,5,7
050,31,071,"Nebraska","Garfield County",5,56,22,13,9
050,31,071,"Nebraska","Garfield County",5,57,22,8,14
050,31,071,"Nebraska","Garfield County",5,58,15,8,7
050,31,071,"Nebraska","Garfield County",5,59,29,12,17
050,31,071,"Nebraska","Garfield County",5,60,27,14,13
050,31,071,"Nebraska","Garfield County",5,61,35,18,17
050,31,071,"Nebraska","Garfield County",5,62,35,17,18
050,31,071,"Nebraska","Garfield County",5,63,32,16,16
050,31,071,"Nebraska","Garfield County",5,64,23,12,11
050,31,071,"Nebraska","Garfield County",5,65,32,16,16
050,31,071,"Nebraska","Garfield County",5,66,35,16,19
050,31,071,"Nebraska","Garfield County",5,67,28,16,12
050,31,071,"Nebraska","Garfield County",5,68,38,25,13
050,31,071,"Nebraska","Garfield County",5,69,36,20,16
050,31,071,"Nebraska","Garfield County",5,70,23,13,10
050,31,071,"Nebraska","Garfield County",5,71,28,13,15
050,31,071,"Nebraska","Garfield County",5,72,16,10,6
050,31,071,"Nebraska","Garfield County",5,73,20,13,7
050,31,071,"Nebraska","Garfield County",5,74,20,16,4
050,31,071,"Nebraska","Garfield County",5,75,17,10,7
050,31,071,"Nebraska","Garfield County",5,76,22,10,12
050,31,071,"Nebraska","Garfield County",5,77,16,6,10
050,31,071,"Nebraska","Garfield County",5,78,20,10,10
050,31,071,"Nebraska","Garfield County",5,79,21,10,11
050,31,071,"Nebraska","Garfield County",5,80,23,11,12
050,31,071,"Nebraska","Garfield County",5,81,15,8,7
050,31,071,"Nebraska","Garfield County",5,82,13,3,10
050,31,071,"Nebraska","Garfield County",5,83,8,4,4
050,31,071,"Nebraska","Garfield County",5,84,18,6,12
050,31,071,"Nebraska","Garfield County",5,85,81,20,61
050,31,073,"Nebraska","Gosper County",1,0,21,11,10
050,31,073,"Nebraska","Gosper County",1,1,17,8,9
050,31,073,"Nebraska","Gosper County",1,2,21,11,10
050,31,073,"Nebraska","Gosper County",1,3,26,13,13
050,31,073,"Nebraska","Gosper County",1,4,19,9,10
050,31,073,"Nebraska","Gosper County",1,5,23,14,9
050,31,073,"Nebraska","Gosper County",1,6,23,14,9
050,31,073,"Nebraska","Gosper County",1,7,20,11,9
050,31,073,"Nebraska","Gosper County",1,8,23,10,13
050,31,073,"Nebraska","Gosper County",1,9,26,11,15
050,31,073,"Nebraska","Gosper County",1,10,24,13,11
050,31,073,"Nebraska","Gosper County",1,11,22,13,9
050,31,073,"Nebraska","Gosper County",1,12,17,10,7
050,31,073,"Nebraska","Gosper County",1,13,21,12,9
050,31,073,"Nebraska","Gosper County",1,14,30,22,8
050,31,073,"Nebraska","Gosper County",1,15,22,14,8
050,31,073,"Nebraska","Gosper County",1,16,25,10,15
050,31,073,"Nebraska","Gosper County",1,17,30,18,12
050,31,073,"Nebraska","Gosper County",1,18,20,11,9
050,31,073,"Nebraska","Gosper County",1,19,20,9,11
050,31,073,"Nebraska","Gosper County",1,20,14,7,7
050,31,073,"Nebraska","Gosper County",1,21,17,9,8
050,31,073,"Nebraska","Gosper County",1,22,18,11,7
050,31,073,"Nebraska","Gosper County",1,23,16,8,8
050,31,073,"Nebraska","Gosper County",1,24,16,7,9
050,31,073,"Nebraska","Gosper County",1,25,17,5,12
050,31,073,"Nebraska","Gosper County",1,26,17,7,10
050,31,073,"Nebraska","Gosper County",1,27,16,6,10
050,31,073,"Nebraska","Gosper County",1,28,21,10,11
050,31,073,"Nebraska","Gosper County",1,29,18,8,10
050,31,073,"Nebraska","Gosper County",1,30,14,7,7
050,31,073,"Nebraska","Gosper County",1,31,20,8,12
050,31,073,"Nebraska","Gosper County",1,32,18,9,9
050,31,073,"Nebraska","Gosper County",1,33,22,14,8
050,31,073,"Nebraska","Gosper County",1,34,22,15,7
050,31,073,"Nebraska","Gosper County",1,35,21,13,8
050,31,073,"Nebraska","Gosper County",1,36,26,13,13
050,31,073,"Nebraska","Gosper County",1,37,20,8,12
050,31,073,"Nebraska","Gosper County",1,38,21,8,13
050,31,073,"Nebraska","Gosper County",1,39,24,8,16
050,31,073,"Nebraska","Gosper County",1,40,25,11,14
050,31,073,"Nebraska","Gosper County",1,41,18,11,7
050,31,073,"Nebraska","Gosper County",1,42,22,17,5
050,31,073,"Nebraska","Gosper County",1,43,22,9,13
050,31,073,"Nebraska","Gosper County",1,44,17,7,10
050,31,073,"Nebraska","Gosper County",1,45,16,10,6
050,31,073,"Nebraska","Gosper County",1,46,13,7,6
050,31,073,"Nebraska","Gosper County",1,47,19,12,7
050,31,073,"Nebraska","Gosper County",1,48,25,13,12
050,31,073,"Nebraska","Gosper County",1,49,29,16,13
050,31,073,"Nebraska","Gosper County",1,50,24,13,11
050,31,073,"Nebraska","Gosper County",1,51,21,11,10
050,31,073,"Nebraska","Gosper County",1,52,16,9,7
050,31,073,"Nebraska","Gosper County",1,53,14,9,5
050,31,073,"Nebraska","Gosper County",1,54,25,15,10
050,31,073,"Nebraska","Gosper County",1,55,33,14,19
050,31,073,"Nebraska","Gosper County",1,56,28,11,17
050,31,073,"Nebraska","Gosper County",1,57,36,22,14
050,31,073,"Nebraska","Gosper County",1,58,31,16,15
050,31,073,"Nebraska","Gosper County",1,59,35,17,18
050,31,073,"Nebraska","Gosper County",1,60,30,14,16
050,31,073,"Nebraska","Gosper County",1,61,28,12,16
050,31,073,"Nebraska","Gosper County",1,62,32,15,17
050,31,073,"Nebraska","Gosper County",1,63,36,16,20
050,31,073,"Nebraska","Gosper County",1,64,36,19,17
050,31,073,"Nebraska","Gosper County",1,65,30,19,11
050,31,073,"Nebraska","Gosper County",1,66,27,17,10
050,31,073,"Nebraska","Gosper County",1,67,29,14,15
050,31,073,"Nebraska","Gosper County",1,68,22,12,10
050,31,073,"Nebraska","Gosper County",1,69,15,8,7
050,31,073,"Nebraska","Gosper County",1,70,26,13,13
050,31,073,"Nebraska","Gosper County",1,71,28,12,16
050,31,073,"Nebraska","Gosper County",1,72,25,14,11
050,31,073,"Nebraska","Gosper County",1,73,19,12,7
050,31,073,"Nebraska","Gosper County",1,74,19,12,7
050,31,073,"Nebraska","Gosper County",1,75,20,10,10
050,31,073,"Nebraska","Gosper County",1,76,17,7,10
050,31,073,"Nebraska","Gosper County",1,77,16,9,7
050,31,073,"Nebraska","Gosper County",1,78,10,6,4
050,31,073,"Nebraska","Gosper County",1,79,8,3,5
050,31,073,"Nebraska","Gosper County",1,80,14,6,8
050,31,073,"Nebraska","Gosper County",1,81,12,8,4
050,31,073,"Nebraska","Gosper County",1,82,13,9,4
050,31,073,"Nebraska","Gosper County",1,83,11,6,5
050,31,073,"Nebraska","Gosper County",1,84,11,7,4
050,31,073,"Nebraska","Gosper County",1,85,64,24,40
050,31,073,"Nebraska","Gosper County",2,0,21,12,9
050,31,073,"Nebraska","Gosper County",2,1,18,9,9
050,31,073,"Nebraska","Gosper County",2,2,21,10,11
050,31,073,"Nebraska","Gosper County",2,3,24,12,12
050,31,073,"Nebraska","Gosper County",2,4,22,11,11
050,31,073,"Nebraska","Gosper County",2,5,23,14,9
050,31,073,"Nebraska","Gosper County",2,6,24,14,10
050,31,073,"Nebraska","Gosper County",2,7,21,11,10
050,31,073,"Nebraska","Gosper County",2,8,23,10,13
050,31,073,"Nebraska","Gosper County",2,9,25,10,15
050,31,073,"Nebraska","Gosper County",2,10,25,13,12
050,31,073,"Nebraska","Gosper County",2,11,22,13,9
050,31,073,"Nebraska","Gosper County",2,12,17,10,7
050,31,073,"Nebraska","Gosper County",2,13,21,12,9
050,31,073,"Nebraska","Gosper County",2,14,27,20,7
050,31,073,"Nebraska","Gosper County",2,15,23,16,7
050,31,073,"Nebraska","Gosper County",2,16,23,10,13
050,31,073,"Nebraska","Gosper County",2,17,26,15,11
050,31,073,"Nebraska","Gosper County",2,18,21,12,9
050,31,073,"Nebraska","Gosper County",2,19,20,9,11
050,31,073,"Nebraska","Gosper County",2,20,16,7,9
050,31,073,"Nebraska","Gosper County",2,21,17,9,8
050,31,073,"Nebraska","Gosper County",2,22,18,10,8
050,31,073,"Nebraska","Gosper County",2,23,15,8,7
050,31,073,"Nebraska","Gosper County",2,24,15,6,9
050,31,073,"Nebraska","Gosper County",2,25,16,6,10
050,31,073,"Nebraska","Gosper County",2,26,18,7,11
050,31,073,"Nebraska","Gosper County",2,27,17,7,10
050,31,073,"Nebraska","Gosper County",2,28,21,10,11
050,31,073,"Nebraska","Gosper County",2,29,20,9,11
050,31,073,"Nebraska","Gosper County",2,30,14,7,7
050,31,073,"Nebraska","Gosper County",2,31,19,8,11
050,31,073,"Nebraska","Gosper County",2,32,19,10,9
050,31,073,"Nebraska","Gosper County",2,33,21,13,8
050,31,073,"Nebraska","Gosper County",2,34,22,15,7
050,31,073,"Nebraska","Gosper County",2,35,22,14,8
050,31,073,"Nebraska","Gosper County",2,36,25,13,12
050,31,073,"Nebraska","Gosper County",2,37,20,8,12
050,31,073,"Nebraska","Gosper County",2,38,21,8,13
050,31,073,"Nebraska","Gosper County",2,39,24,8,16
050,31,073,"Nebraska","Gosper County",2,40,25,11,14
050,31,073,"Nebraska","Gosper County",2,41,20,12,8
050,31,073,"Nebraska","Gosper County",2,42,21,15,6
050,31,073,"Nebraska","Gosper County",2,43,23,11,12
050,31,073,"Nebraska","Gosper County",2,44,19,8,11
050,31,073,"Nebraska","Gosper County",2,45,17,10,7
050,31,073,"Nebraska","Gosper County",2,46,14,8,6
050,31,073,"Nebraska","Gosper County",2,47,17,11,6
050,31,073,"Nebraska","Gosper County",2,48,23,13,10
050,31,073,"Nebraska","Gosper County",2,49,29,16,13
050,31,073,"Nebraska","Gosper County",2,50,26,14,12
050,31,073,"Nebraska","Gosper County",2,51,21,11,10
050,31,073,"Nebraska","Gosper County",2,52,16,9,7
050,31,073,"Nebraska","Gosper County",2,53,15,9,6
050,31,073,"Nebraska","Gosper County",2,54,23,14,9
050,31,073,"Nebraska","Gosper County",2,55,31,14,17
050,31,073,"Nebraska","Gosper County",2,56,29,12,17
050,31,073,"Nebraska","Gosper County",2,57,33,19,14
050,31,073,"Nebraska","Gosper County",2,58,32,17,15
050,31,073,"Nebraska","Gosper County",2,59,34,17,17
050,31,073,"Nebraska","Gosper County",2,60,32,15,17
050,31,073,"Nebraska","Gosper County",2,61,28,12,16
050,31,073,"Nebraska","Gosper County",2,62,31,14,17
050,31,073,"Nebraska","Gosper County",2,63,36,16,20
050,31,073,"Nebraska","Gosper County",2,64,37,19,18
050,31,073,"Nebraska","Gosper County",2,65,32,19,13
050,31,073,"Nebraska","Gosper County",2,66,28,18,10
050,31,073,"Nebraska","Gosper County",2,67,29,15,14
050,31,073,"Nebraska","Gosper County",2,68,23,12,11
050,31,073,"Nebraska","Gosper County",2,69,17,9,8
050,31,073,"Nebraska","Gosper County",2,70,24,12,12
050,31,073,"Nebraska","Gosper County",2,71,27,12,15
050,31,073,"Nebraska","Gosper County",2,72,24,13,11
050,31,073,"Nebraska","Gosper County",2,73,20,12,8
050,31,073,"Nebraska","Gosper County",2,74,18,11,7
050,31,073,"Nebraska","Gosper County",2,75,18,9,9
050,31,073,"Nebraska","Gosper County",2,76,17,8,9
050,31,073,"Nebraska","Gosper County",2,77,16,8,8
050,31,073,"Nebraska","Gosper County",2,78,10,6,4
050,31,073,"Nebraska","Gosper County",2,79,9,4,5
050,31,073,"Nebraska","Gosper County",2,80,13,6,7
050,31,073,"Nebraska","Gosper County",2,81,12,7,5
050,31,073,"Nebraska","Gosper County",2,82,12,9,3
050,31,073,"Nebraska","Gosper County",2,83,12,7,5
050,31,073,"Nebraska","Gosper County",2,84,11,7,4
050,31,073,"Nebraska","Gosper County",2,85,65,25,40
050,31,073,"Nebraska","Gosper County",3,0,16,9,7
050,31,073,"Nebraska","Gosper County",3,1,21,12,9
050,31,073,"Nebraska","Gosper County",3,2,16,9,7
050,31,073,"Nebraska","Gosper County",3,3,22,12,10
050,31,073,"Nebraska","Gosper County",3,4,25,13,12
050,31,073,"Nebraska","Gosper County",3,5,23,10,13
050,31,073,"Nebraska","Gosper County",3,6,19,9,10
050,31,073,"Nebraska","Gosper County",3,7,24,14,10
050,31,073,"Nebraska","Gosper County",3,8,18,9,9
050,31,073,"Nebraska","Gosper County",3,9,17,9,8
050,31,073,"Nebraska","Gosper County",3,10,27,11,16
050,31,073,"Nebraska","Gosper County",3,11,24,11,13
050,31,073,"Nebraska","Gosper County",3,12,20,12,8
050,31,073,"Nebraska","Gosper County",3,13,16,12,4
050,31,073,"Nebraska","Gosper County",3,14,23,13,10
050,31,073,"Nebraska","Gosper County",3,15,27,20,7
050,31,073,"Nebraska","Gosper County",3,16,21,16,5
050,31,073,"Nebraska","Gosper County",3,17,24,11,13
050,31,073,"Nebraska","Gosper County",3,18,22,14,8
050,31,073,"Nebraska","Gosper County",3,19,16,11,5
050,31,073,"Nebraska","Gosper County",3,20,17,7,10
050,31,073,"Nebraska","Gosper County",3,21,13,6,7
050,31,073,"Nebraska","Gosper County",3,22,14,7,7
050,31,073,"Nebraska","Gosper County",3,23,15,9,6
050,31,073,"Nebraska","Gosper County",3,24,13,6,7
050,31,073,"Nebraska","Gosper County",3,25,15,6,9
050,31,073,"Nebraska","Gosper County",3,26,17,7,10
050,31,073,"Nebraska","Gosper County",3,27,16,8,8
050,31,073,"Nebraska","Gosper County",3,28,15,5,10
050,31,073,"Nebraska","Gosper County",3,29,21,10,11
050,31,073,"Nebraska","Gosper County",3,30,22,11,11
050,31,073,"Nebraska","Gosper County",3,31,14,6,8
050,31,073,"Nebraska","Gosper County",3,32,13,6,7
050,31,073,"Nebraska","Gosper County",3,33,19,10,9
050,31,073,"Nebraska","Gosper County",3,34,23,15,8
050,31,073,"Nebraska","Gosper County",3,35,22,15,7
050,31,073,"Nebraska","Gosper County",3,36,19,12,7
050,31,073,"Nebraska","Gosper County",3,37,26,14,12
050,31,073,"Nebraska","Gosper County",3,38,20,7,13
050,31,073,"Nebraska","Gosper County",3,39,21,9,12
050,31,073,"Nebraska","Gosper County",3,40,23,8,15
050,31,073,"Nebraska","Gosper County",3,41,25,12,13
050,31,073,"Nebraska","Gosper County",3,42,20,12,8
050,31,073,"Nebraska","Gosper County",3,43,20,14,6
050,31,073,"Nebraska","Gosper County",3,44,23,11,12
050,31,073,"Nebraska","Gosper County",3,45,16,6,10
050,31,073,"Nebraska","Gosper County",3,46,16,10,6
050,31,073,"Nebraska","Gosper County",3,47,13,8,5
050,31,073,"Nebraska","Gosper County",3,48,18,11,7
050,31,073,"Nebraska","Gosper County",3,49,28,17,11
050,31,073,"Nebraska","Gosper County",3,50,31,16,15
050,31,073,"Nebraska","Gosper County",3,51,24,14,10
050,31,073,"Nebraska","Gosper County",3,52,20,7,13
050,31,073,"Nebraska","Gosper County",3,53,14,8,6
050,31,073,"Nebraska","Gosper County",3,54,15,9,6
050,31,073,"Nebraska","Gosper County",3,55,24,14,10
050,31,073,"Nebraska","Gosper County",3,56,30,14,16
050,31,073,"Nebraska","Gosper County",3,57,26,12,14
050,31,073,"Nebraska","Gosper County",3,58,31,19,12
050,31,073,"Nebraska","Gosper County",3,59,31,15,16
050,31,073,"Nebraska","Gosper County",3,60,33,16,17
050,31,073,"Nebraska","Gosper County",3,61,35,18,17
050,31,073,"Nebraska","Gosper County",3,62,31,11,20
050,31,073,"Nebraska","Gosper County",3,63,29,14,15
050,31,073,"Nebraska","Gosper County",3,64,35,16,19
050,31,073,"Nebraska","Gosper County",3,65,35,17,18
050,31,073,"Nebraska","Gosper County",3,66,29,17,12
050,31,073,"Nebraska","Gosper County",3,67,29,19,10
050,31,073,"Nebraska","Gosper County",3,68,29,16,13
050,31,073,"Nebraska","Gosper County",3,69,23,12,11
050,31,073,"Nebraska","Gosper County",3,70,18,8,10
050,31,073,"Nebraska","Gosper County",3,71,23,12,11
050,31,073,"Nebraska","Gosper County",3,72,24,11,13
050,31,073,"Nebraska","Gosper County",3,73,22,13,9
050,31,073,"Nebraska","Gosper County",3,74,19,11,8
050,31,073,"Nebraska","Gosper County",3,75,19,10,9
050,31,073,"Nebraska","Gosper County",3,76,15,7,8
050,31,073,"Nebraska","Gosper County",3,77,16,8,8
050,31,073,"Nebraska","Gosper County",3,78,14,7,7
050,31,073,"Nebraska","Gosper County",3,79,10,7,3
050,31,073,"Nebraska","Gosper County",3,80,10,4,6
050,31,073,"Nebraska","Gosper County",3,81,12,6,6
050,31,073,"Nebraska","Gosper County",3,82,14,8,6
050,31,073,"Nebraska","Gosper County",3,83,13,10,3
050,31,073,"Nebraska","Gosper County",3,84,6,6,0
050,31,073,"Nebraska","Gosper County",3,85,62,26,36
050,31,073,"Nebraska","Gosper County",4,0,16,5,11
050,31,073,"Nebraska","Gosper County",4,1,12,9,3
050,31,073,"Nebraska","Gosper County",4,2,23,12,11
050,31,073,"Nebraska","Gosper County",4,3,16,8,8
050,31,073,"Nebraska","Gosper County",4,4,23,13,10
050,31,073,"Nebraska","Gosper County",4,5,27,13,14
050,31,073,"Nebraska","Gosper County",4,6,23,9,14
050,31,073,"Nebraska","Gosper County",4,7,18,11,7
050,31,073,"Nebraska","Gosper County",4,8,28,13,15
050,31,073,"Nebraska","Gosper County",4,9,19,9,10
050,31,073,"Nebraska","Gosper County",4,10,20,13,7
050,31,073,"Nebraska","Gosper County",4,11,27,12,15
050,31,073,"Nebraska","Gosper County",4,12,32,17,15
050,31,073,"Nebraska","Gosper County",4,13,20,12,8
050,31,073,"Nebraska","Gosper County",4,14,17,12,5
050,31,073,"Nebraska","Gosper County",4,15,25,14,11
050,31,073,"Nebraska","Gosper County",4,16,26,19,7
050,31,073,"Nebraska","Gosper County",4,17,20,16,4
050,31,073,"Nebraska","Gosper County",4,18,19,8,11
050,31,073,"Nebraska","Gosper County",4,19,19,11,8
050,31,073,"Nebraska","Gosper County",4,20,14,10,4
050,31,073,"Nebraska","Gosper County",4,21,18,8,10
050,31,073,"Nebraska","Gosper County",4,22,11,7,4
050,31,073,"Nebraska","Gosper County",4,23,10,4,6
050,31,073,"Nebraska","Gosper County",4,24,18,10,8
050,31,073,"Nebraska","Gosper County",4,25,16,7,9
050,31,073,"Nebraska","Gosper County",4,26,13,5,8
050,31,073,"Nebraska","Gosper County",4,27,13,8,5
050,31,073,"Nebraska","Gosper County",4,28,19,9,10
050,31,073,"Nebraska","Gosper County",4,29,15,6,9
050,31,073,"Nebraska","Gosper County",4,30,22,10,12
050,31,073,"Nebraska","Gosper County",4,31,21,10,11
050,31,073,"Nebraska","Gosper County",4,32,14,6,8
050,31,073,"Nebraska","Gosper County",4,33,16,5,11
050,31,073,"Nebraska","Gosper County",4,34,21,13,8
050,31,073,"Nebraska","Gosper County",4,35,23,14,9
050,31,073,"Nebraska","Gosper County",4,36,24,16,8
050,31,073,"Nebraska","Gosper County",4,37,22,13,9
050,31,073,"Nebraska","Gosper County",4,38,25,14,11
050,31,073,"Nebraska","Gosper County",4,39,19,7,12
050,31,073,"Nebraska","Gosper County",4,40,21,10,11
050,31,073,"Nebraska","Gosper County",4,41,23,8,15
050,31,073,"Nebraska","Gosper County",4,42,28,14,14
050,31,073,"Nebraska","Gosper County",4,43,18,10,8
050,31,073,"Nebraska","Gosper County",4,44,21,14,7
050,31,073,"Nebraska","Gosper County",4,45,22,11,11
050,31,073,"Nebraska","Gosper County",4,46,17,6,11
050,31,073,"Nebraska","Gosper County",4,47,21,14,7
050,31,073,"Nebraska","Gosper County",4,48,13,7,6
050,31,073,"Nebraska","Gosper County",4,49,18,13,5
050,31,073,"Nebraska","Gosper County",4,50,29,17,12
050,31,073,"Nebraska","Gosper County",4,51,30,15,15
050,31,073,"Nebraska","Gosper County",4,52,24,14,10
050,31,073,"Nebraska","Gosper County",4,53,20,7,13
050,31,073,"Nebraska","Gosper County",4,54,15,8,7
050,31,073,"Nebraska","Gosper County",4,55,15,9,6
050,31,073,"Nebraska","Gosper County",4,56,24,15,9
050,31,073,"Nebraska","Gosper County",4,57,30,14,16
050,31,073,"Nebraska","Gosper County",4,58,29,12,17
050,31,073,"Nebraska","Gosper County",4,59,28,17,11
050,31,073,"Nebraska","Gosper County",4,60,29,15,14
050,31,073,"Nebraska","Gosper County",4,61,38,20,18
050,31,073,"Nebraska","Gosper County",4,62,36,18,18
050,31,073,"Nebraska","Gosper County",4,63,29,11,18
050,31,073,"Nebraska","Gosper County",4,64,28,14,14
050,31,073,"Nebraska","Gosper County",4,65,35,16,19
050,31,073,"Nebraska","Gosper County",4,66,33,16,17
050,31,073,"Nebraska","Gosper County",4,67,26,16,10
050,31,073,"Nebraska","Gosper County",4,68,28,18,10
050,31,073,"Nebraska","Gosper County",4,69,26,16,10
050,31,073,"Nebraska","Gosper County",4,70,23,12,11
050,31,073,"Nebraska","Gosper County",4,71,15,8,7
050,31,073,"Nebraska","Gosper County",4,72,22,12,10
050,31,073,"Nebraska","Gosper County",4,73,22,11,11
050,31,073,"Nebraska","Gosper County",4,74,23,13,10
050,31,073,"Nebraska","Gosper County",4,75,20,11,9
050,31,073,"Nebraska","Gosper County",4,76,18,10,8
050,31,073,"Nebraska","Gosper County",4,77,14,7,7
050,31,073,"Nebraska","Gosper County",4,78,13,8,5
050,31,073,"Nebraska","Gosper County",4,79,13,7,6
050,31,073,"Nebraska","Gosper County",4,80,10,6,4
050,31,073,"Nebraska","Gosper County",4,81,8,4,4
050,31,073,"Nebraska","Gosper County",4,82,16,8,8
050,31,073,"Nebraska","Gosper County",4,83,15,9,6
050,31,073,"Nebraska","Gosper County",4,84,10,8,2
050,31,073,"Nebraska","Gosper County",4,85,55,27,28
050,31,073,"Nebraska","Gosper County",5,0,17,6,11
050,31,073,"Nebraska","Gosper County",5,1,20,9,11
050,31,073,"Nebraska","Gosper County",5,2,13,10,3
050,31,073,"Nebraska","Gosper County",5,3,27,13,14
050,31,073,"Nebraska","Gosper County",5,4,12,5,7
050,31,073,"Nebraska","Gosper County",5,5,23,13,10
050,31,073,"Nebraska","Gosper County",5,6,25,11,14
050,31,073,"Nebraska","Gosper County",5,7,21,10,11
050,31,073,"Nebraska","Gosper County",5,8,20,12,8
050,31,073,"Nebraska","Gosper County",5,9,29,14,15
050,31,073,"Nebraska","Gosper County",5,10,19,11,8
050,31,073,"Nebraska","Gosper County",5,11,23,14,9
050,31,073,"Nebraska","Gosper County",5,12,25,12,13
050,31,073,"Nebraska","Gosper County",5,13,30,15,15
050,31,073,"Nebraska","Gosper County",5,14,20,13,7
050,31,073,"Nebraska","Gosper County",5,15,16,11,5
050,31,073,"Nebraska","Gosper County",5,16,26,15,11
050,31,073,"Nebraska","Gosper County",5,17,27,20,7
050,31,073,"Nebraska","Gosper County",5,18,18,14,4
050,31,073,"Nebraska","Gosper County",5,19,15,6,9
050,31,073,"Nebraska","Gosper County",5,20,19,11,8
050,31,073,"Nebraska","Gosper County",5,21,16,9,7
050,31,073,"Nebraska","Gosper County",5,22,19,8,11
050,31,073,"Nebraska","Gosper County",5,23,13,7,6
050,31,073,"Nebraska","Gosper County",5,24,12,5,7
050,31,073,"Nebraska","Gosper County",5,25,18,8,10
050,31,073,"Nebraska","Gosper County",5,26,14,7,7
050,31,073,"Nebraska","Gosper County",5,27,17,7,10
050,31,073,"Nebraska","Gosper County",5,28,13,5,8
050,31,073,"Nebraska","Gosper County",5,29,19,10,9
050,31,073,"Nebraska","Gosper County",5,30,16,5,11
050,31,073,"Nebraska","Gosper County",5,31,24,10,14
050,31,073,"Nebraska","Gosper County",5,32,19,10,9
050,31,073,"Nebraska","Gosper County",5,33,12,6,6
050,31,073,"Nebraska","Gosper County",5,34,15,5,10
050,31,073,"Nebraska","Gosper County",5,35,17,9,8
050,31,073,"Nebraska","Gosper County",5,36,23,16,7
050,31,073,"Nebraska","Gosper County",5,37,20,12,8
050,31,073,"Nebraska","Gosper County",5,38,19,13,6
050,31,073,"Nebraska","Gosper County",5,39,26,14,12
050,31,073,"Nebraska","Gosper County",5,40,18,7,11
050,31,073,"Nebraska","Gosper County",5,41,21,11,10
050,31,073,"Nebraska","Gosper County",5,42,24,9,15
050,31,073,"Nebraska","Gosper County",5,43,29,14,15
050,31,073,"Nebraska","Gosper County",5,44,19,10,9
050,31,073,"Nebraska","Gosper County",5,45,21,14,7
050,31,073,"Nebraska","Gosper County",5,46,24,12,12
050,31,073,"Nebraska","Gosper County",5,47,17,6,11
050,31,073,"Nebraska","Gosper County",5,48,23,14,9
050,31,073,"Nebraska","Gosper County",5,49,12,6,6
050,31,073,"Nebraska","Gosper County",5,50,20,14,6
050,31,073,"Nebraska","Gosper County",5,51,29,17,12
050,31,073,"Nebraska","Gosper County",5,52,31,15,16
050,31,073,"Nebraska","Gosper County",5,53,24,14,10
050,31,073,"Nebraska","Gosper County",5,54,23,10,13
050,31,073,"Nebraska","Gosper County",5,55,15,8,7
050,31,073,"Nebraska","Gosper County",5,56,16,10,6
050,31,073,"Nebraska","Gosper County",5,57,28,17,11
050,31,073,"Nebraska","Gosper County",5,58,34,17,17
050,31,073,"Nebraska","Gosper County",5,59,29,12,17
050,31,073,"Nebraska","Gosper County",5,60,31,17,14
050,31,073,"Nebraska","Gosper County",5,61,30,16,14
050,31,073,"Nebraska","Gosper County",5,62,38,20,18
050,31,073,"Nebraska","Gosper County",5,63,35,18,17
050,31,073,"Nebraska","Gosper County",5,64,27,11,16
050,31,073,"Nebraska","Gosper County",5,65,28,12,16
050,31,073,"Nebraska","Gosper County",5,66,34,17,17
050,31,073,"Nebraska","Gosper County",5,67,32,16,16
050,31,073,"Nebraska","Gosper County",5,68,27,16,11
050,31,073,"Nebraska","Gosper County",5,69,26,17,9
050,31,073,"Nebraska","Gosper County",5,70,25,15,10
050,31,073,"Nebraska","Gosper County",5,71,22,12,10
050,31,073,"Nebraska","Gosper County",5,72,14,8,6
050,31,073,"Nebraska","Gosper County",5,73,23,13,10
050,31,073,"Nebraska","Gosper County",5,74,23,11,12
050,31,073,"Nebraska","Gosper County",5,75,25,14,11
050,31,073,"Nebraska","Gosper County",5,76,19,10,9
050,31,073,"Nebraska","Gosper County",5,77,18,10,8
050,31,073,"Nebraska","Gosper County",5,78,13,7,6
050,31,073,"Nebraska","Gosper County",5,79,10,6,4
050,31,073,"Nebraska","Gosper County",5,80,13,6,7
050,31,073,"Nebraska","Gosper County",5,81,6,6,0
050,31,073,"Nebraska","Gosper County",5,82,10,5,5
050,31,073,"Nebraska","Gosper County",5,83,17,9,8
050,31,073,"Nebraska","Gosper County",5,84,11,6,5
050,31,073,"Nebraska","Gosper County",5,85,56,29,27
050,31,075,"Nebraska","Grant County",1,0,6,3,3
050,31,075,"Nebraska","Grant County",1,1,7,3,4
050,31,075,"Nebraska","Grant County",1,2,14,6,8
050,31,075,"Nebraska","Grant County",1,3,11,5,6
050,31,075,"Nebraska","Grant County",1,4,10,4,6
050,31,075,"Nebraska","Grant County",1,5,9,5,4
050,31,075,"Nebraska","Grant County",1,6,8,3,5
050,31,075,"Nebraska","Grant County",1,7,7,6,1
050,31,075,"Nebraska","Grant County",1,8,8,3,5
050,31,075,"Nebraska","Grant County",1,9,10,5,5
050,31,075,"Nebraska","Grant County",1,10,9,5,4
050,31,075,"Nebraska","Grant County",1,11,9,6,3
050,31,075,"Nebraska","Grant County",1,12,7,5,2
050,31,075,"Nebraska","Grant County",1,13,13,11,2
050,31,075,"Nebraska","Grant County",1,14,7,5,2
050,31,075,"Nebraska","Grant County",1,15,8,3,5
050,31,075,"Nebraska","Grant County",1,16,8,3,5
050,31,075,"Nebraska","Grant County",1,17,8,4,4
050,31,075,"Nebraska","Grant County",1,18,5,2,3
050,31,075,"Nebraska","Grant County",1,19,5,1,4
050,31,075,"Nebraska","Grant County",1,20,3,1,2
050,31,075,"Nebraska","Grant County",1,21,4,3,1
050,31,075,"Nebraska","Grant County",1,22,4,3,1
050,31,075,"Nebraska","Grant County",1,23,3,1,2
050,31,075,"Nebraska","Grant County",1,24,3,1,2
050,31,075,"Nebraska","Grant County",1,25,4,3,1
050,31,075,"Nebraska","Grant County",1,26,6,3,3
050,31,075,"Nebraska","Grant County",1,27,5,2,3
050,31,075,"Nebraska","Grant County",1,28,4,2,2
050,31,075,"Nebraska","Grant County",1,29,7,4,3
050,31,075,"Nebraska","Grant County",1,30,7,5,2
050,31,075,"Nebraska","Grant County",1,31,4,2,2
050,31,075,"Nebraska","Grant County",1,32,3,2,1
050,31,075,"Nebraska","Grant County",1,33,11,5,6
050,31,075,"Nebraska","Grant County",1,34,15,9,6
050,31,075,"Nebraska","Grant County",1,35,4,2,2
050,31,075,"Nebraska","Grant County",1,36,4,2,2
050,31,075,"Nebraska","Grant County",1,37,8,6,2
050,31,075,"Nebraska","Grant County",1,38,10,7,3
050,31,075,"Nebraska","Grant County",1,39,8,3,5
050,31,075,"Nebraska","Grant County",1,40,6,3,3
050,31,075,"Nebraska","Grant County",1,41,9,4,5
050,31,075,"Nebraska","Grant County",1,42,6,3,3
050,31,075,"Nebraska","Grant County",1,43,8,4,4
050,31,075,"Nebraska","Grant County",1,44,7,3,4
050,31,075,"Nebraska","Grant County",1,45,5,4,1
050,31,075,"Nebraska","Grant County",1,46,6,4,2
050,31,075,"Nebraska","Grant County",1,47,6,5,1
050,31,075,"Nebraska","Grant County",1,48,3,1,2
050,31,075,"Nebraska","Grant County",1,49,6,3,3
050,31,075,"Nebraska","Grant County",1,50,5,3,2
050,31,075,"Nebraska","Grant County",1,51,1,1,0
050,31,075,"Nebraska","Grant County",1,52,4,3,1
050,31,075,"Nebraska","Grant County",1,53,5,2,3
050,31,075,"Nebraska","Grant County",1,54,3,0,3
050,31,075,"Nebraska","Grant County",1,55,8,3,5
050,31,075,"Nebraska","Grant County",1,56,9,4,5
050,31,075,"Nebraska","Grant County",1,57,11,4,7
050,31,075,"Nebraska","Grant County",1,58,17,8,9
050,31,075,"Nebraska","Grant County",1,59,11,7,4
050,31,075,"Nebraska","Grant County",1,60,9,4,5
050,31,075,"Nebraska","Grant County",1,61,7,5,2
050,31,075,"Nebraska","Grant County",1,62,9,5,4
050,31,075,"Nebraska","Grant County",1,63,10,6,4
050,31,075,"Nebraska","Grant County",1,64,13,7,6
050,31,075,"Nebraska","Grant County",1,65,8,4,4
050,31,075,"Nebraska","Grant County",1,66,8,4,4
050,31,075,"Nebraska","Grant County",1,67,13,8,5
050,31,075,"Nebraska","Grant County",1,68,14,8,6
050,31,075,"Nebraska","Grant County",1,69,10,5,5
050,31,075,"Nebraska","Grant County",1,70,8,4,4
050,31,075,"Nebraska","Grant County",1,71,7,3,4
050,31,075,"Nebraska","Grant County",1,72,7,4,3
050,31,075,"Nebraska","Grant County",1,73,7,3,4
050,31,075,"Nebraska","Grant County",1,74,6,3,3
050,31,075,"Nebraska","Grant County",1,75,4,2,2
050,31,075,"Nebraska","Grant County",1,76,7,3,4
050,31,075,"Nebraska","Grant County",1,77,3,1,2
050,31,075,"Nebraska","Grant County",1,78,5,3,2
050,31,075,"Nebraska","Grant County",1,79,5,3,2
050,31,075,"Nebraska","Grant County",1,80,4,2,2
050,31,075,"Nebraska","Grant County",1,81,5,3,2
050,31,075,"Nebraska","Grant County",1,82,5,3,2
050,31,075,"Nebraska","Grant County",1,83,4,2,2
050,31,075,"Nebraska","Grant County",1,84,3,2,1
050,31,075,"Nebraska","Grant County",1,85,8,3,5
050,31,075,"Nebraska","Grant County",2,0,6,3,3
050,31,075,"Nebraska","Grant County",2,1,7,3,4
050,31,075,"Nebraska","Grant County",2,2,13,6,7
050,31,075,"Nebraska","Grant County",2,3,13,6,7
050,31,075,"Nebraska","Grant County",2,4,10,4,6
050,31,075,"Nebraska","Grant County",2,5,9,5,4
050,31,075,"Nebraska","Grant County",2,6,9,4,5
050,31,075,"Nebraska","Grant County",2,7,7,5,2
050,31,075,"Nebraska","Grant County",2,8,8,4,4
050,31,075,"Nebraska","Grant County",2,9,9,4,5
050,31,075,"Nebraska","Grant County",2,10,10,6,4
050,31,075,"Nebraska","Grant County",2,11,9,6,3
050,31,075,"Nebraska","Grant County",2,12,8,5,3
050,31,075,"Nebraska","Grant County",2,13,12,10,2
050,31,075,"Nebraska","Grant County",2,14,8,6,2
050,31,075,"Nebraska","Grant County",2,15,8,4,4
050,31,075,"Nebraska","Grant County",2,16,8,3,5
050,31,075,"Nebraska","Grant County",2,17,8,4,4
050,31,075,"Nebraska","Grant County",2,18,5,2,3
050,31,075,"Nebraska","Grant County",2,19,5,1,4
050,31,075,"Nebraska","Grant County",2,20,3,1,2
050,31,075,"Nebraska","Grant County",2,21,4,3,1
050,31,075,"Nebraska","Grant County",2,22,4,3,1
050,31,075,"Nebraska","Grant County",2,23,4,2,2
050,31,075,"Nebraska","Grant County",2,24,3,1,2
050,31,075,"Nebraska","Grant County",2,25,4,3,1
050,31,075,"Nebraska","Grant County",2,26,6,3,3
050,31,075,"Nebraska","Grant County",2,27,5,2,3
050,31,075,"Nebraska","Grant County",2,28,4,2,2
050,31,075,"Nebraska","Grant County",2,29,7,4,3
050,31,075,"Nebraska","Grant County",2,30,7,5,2
050,31,075,"Nebraska","Grant County",2,31,5,3,2
050,31,075,"Nebraska","Grant County",2,32,3,2,1
050,31,075,"Nebraska","Grant County",2,33,10,5,5
050,31,075,"Nebraska","Grant County",2,34,14,8,6
050,31,075,"Nebraska","Grant County",2,35,7,4,3
050,31,075,"Nebraska","Grant County",2,36,4,2,2
050,31,075,"Nebraska","Grant County",2,37,7,5,2
050,31,075,"Nebraska","Grant County",2,38,9,7,2
050,31,075,"Nebraska","Grant County",2,39,8,4,4
050,31,075,"Nebraska","Grant County",2,40,7,3,4
050,31,075,"Nebraska","Grant County",2,41,9,4,5
050,31,075,"Nebraska","Grant County",2,42,6,3,3
050,31,075,"Nebraska","Grant County",2,43,8,4,4
050,31,075,"Nebraska","Grant County",2,44,7,3,4
050,31,075,"Nebraska","Grant County",2,45,6,4,2
050,31,075,"Nebraska","Grant County",2,46,6,4,2
050,31,075,"Nebraska","Grant County",2,47,6,5,1
050,31,075,"Nebraska","Grant County",2,48,4,2,2
050,31,075,"Nebraska","Grant County",2,49,6,3,3
050,31,075,"Nebraska","Grant County",2,50,5,3,2
050,31,075,"Nebraska","Grant County",2,51,1,1,0
050,31,075,"Nebraska","Grant County",2,52,3,2,1
050,31,075,"Nebraska","Grant County",2,53,4,2,2
050,31,075,"Nebraska","Grant County",2,54,4,1,3
050,31,075,"Nebraska","Grant County",2,55,6,2,4
050,31,075,"Nebraska","Grant County",2,56,9,4,5
050,31,075,"Nebraska","Grant County",2,57,10,4,6
050,31,075,"Nebraska","Grant County",2,58,15,7,8
050,31,075,"Nebraska","Grant County",2,59,12,7,5
050,31,075,"Nebraska","Grant County",2,60,9,4,5
050,31,075,"Nebraska","Grant County",2,61,8,5,3
050,31,075,"Nebraska","Grant County",2,62,8,5,3
050,31,075,"Nebraska","Grant County",2,63,9,5,4
050,31,075,"Nebraska","Grant County",2,64,12,6,6
050,31,075,"Nebraska","Grant County",2,65,9,5,4
050,31,075,"Nebraska","Grant County",2,66,8,4,4
050,31,075,"Nebraska","Grant County",2,67,12,7,5
050,31,075,"Nebraska","Grant County",2,68,14,8,6
050,31,075,"Nebraska","Grant County",2,69,11,6,5
050,31,075,"Nebraska","Grant County",2,70,8,4,4
050,31,075,"Nebraska","Grant County",2,71,7,3,4
050,31,075,"Nebraska","Grant County",2,72,7,4,3
050,31,075,"Nebraska","Grant County",2,73,7,3,4
050,31,075,"Nebraska","Grant County",2,74,6,3,3
050,31,075,"Nebraska","Grant County",2,75,4,2,2
050,31,075,"Nebraska","Grant County",2,76,7,3,4
050,31,075,"Nebraska","Grant County",2,77,4,2,2
050,31,075,"Nebraska","Grant County",2,78,4,2,2
050,31,075,"Nebraska","Grant County",2,79,4,2,2
050,31,075,"Nebraska","Grant County",2,80,4,2,2
050,31,075,"Nebraska","Grant County",2,81,5,3,2
050,31,075,"Nebraska","Grant County",2,82,5,3,2
050,31,075,"Nebraska","Grant County",2,83,4,2,2
050,31,075,"Nebraska","Grant County",2,84,3,2,1
050,31,075,"Nebraska","Grant County",2,85,10,4,6
050,31,075,"Nebraska","Grant County",3,0,7,2,5
050,31,075,"Nebraska","Grant County",3,1,6,3,3
050,31,075,"Nebraska","Grant County",3,2,6,2,4
050,31,075,"Nebraska","Grant County",3,3,10,4,6
050,31,075,"Nebraska","Grant County",3,4,11,6,5
050,31,075,"Nebraska","Grant County",3,5,7,3,4
050,31,075,"Nebraska","Grant County",3,6,8,5,3
050,31,075,"Nebraska","Grant County",3,7,5,2,3
050,31,075,"Nebraska","Grant County",3,8,7,4,3
050,31,075,"Nebraska","Grant County",3,9,6,2,4
050,31,075,"Nebraska","Grant County",3,10,9,4,5
050,31,075,"Nebraska","Grant County",3,11,9,6,3
050,31,075,"Nebraska","Grant County",3,12,8,5,3
050,31,075,"Nebraska","Grant County",3,13,7,4,3
050,31,075,"Nebraska","Grant County",3,14,12,10,2
050,31,075,"Nebraska","Grant County",3,15,8,6,2
050,31,075,"Nebraska","Grant County",3,16,8,4,4
050,31,075,"Nebraska","Grant County",3,17,8,3,5
050,31,075,"Nebraska","Grant County",3,18,6,3,3
050,31,075,"Nebraska","Grant County",3,19,4,1,3
050,31,075,"Nebraska","Grant County",3,20,3,1,2
050,31,075,"Nebraska","Grant County",3,21,4,1,3
050,31,075,"Nebraska","Grant County",3,22,6,4,2
050,31,075,"Nebraska","Grant County",3,23,3,2,1
050,31,075,"Nebraska","Grant County",3,24,4,2,2
050,31,075,"Nebraska","Grant County",3,25,6,4,2
050,31,075,"Nebraska","Grant County",3,26,4,3,1
050,31,075,"Nebraska","Grant County",3,27,7,3,4
050,31,075,"Nebraska","Grant County",3,28,5,3,2
050,31,075,"Nebraska","Grant County",3,29,3,2,1
050,31,075,"Nebraska","Grant County",3,30,8,5,3
050,31,075,"Nebraska","Grant County",3,31,5,3,2
050,31,075,"Nebraska","Grant County",3,32,4,3,1
050,31,075,"Nebraska","Grant County",3,33,3,2,1
050,31,075,"Nebraska","Grant County",3,34,10,5,5
050,31,075,"Nebraska","Grant County",3,35,11,5,6
050,31,075,"Nebraska","Grant County",3,36,6,4,2
050,31,075,"Nebraska","Grant County",3,37,3,2,1
050,31,075,"Nebraska","Grant County",3,38,7,4,3
050,31,075,"Nebraska","Grant County",3,39,9,7,2
050,31,075,"Nebraska","Grant County",3,40,7,4,3
050,31,075,"Nebraska","Grant County",3,41,8,3,5
050,31,075,"Nebraska","Grant County",3,42,9,5,4
050,31,075,"Nebraska","Grant County",3,43,6,3,3
050,31,075,"Nebraska","Grant County",3,44,9,4,5
050,31,075,"Nebraska","Grant County",3,45,6,3,3
050,31,075,"Nebraska","Grant County",3,46,6,4,2
050,31,075,"Nebraska","Grant County",3,47,6,4,2
050,31,075,"Nebraska","Grant County",3,48,5,4,1
050,31,075,"Nebraska","Grant County",3,49,5,3,2
050,31,075,"Nebraska","Grant County",3,50,5,2,3
050,31,075,"Nebraska","Grant County",3,51,4,2,2
050,31,075,"Nebraska","Grant County",3,52,2,2,0
050,31,075,"Nebraska","Grant County",3,53,3,2,1
050,31,075,"Nebraska","Grant County",3,54,4,2,2
050,31,075,"Nebraska","Grant County",3,55,4,1,3
050,31,075,"Nebraska","Grant County",3,56,5,1,4
050,31,075,"Nebraska","Grant County",3,57,8,4,4
050,31,075,"Nebraska","Grant County",3,58,10,4,6
050,31,075,"Nebraska","Grant County",3,59,15,7,8
050,31,075,"Nebraska","Grant County",3,60,12,7,5
050,31,075,"Nebraska","Grant County",3,61,9,4,5
050,31,075,"Nebraska","Grant County",3,62,7,4,3
050,31,075,"Nebraska","Grant County",3,63,7,5,2
050,31,075,"Nebraska","Grant County",3,64,9,5,4
050,31,075,"Nebraska","Grant County",3,65,12,6,6
050,31,075,"Nebraska","Grant County",3,66,9,5,4
050,31,075,"Nebraska","Grant County",3,67,8,4,4
050,31,075,"Nebraska","Grant County",3,68,11,6,5
050,31,075,"Nebraska","Grant County",3,69,14,8,6
050,31,075,"Nebraska","Grant County",3,70,11,6,5
050,31,075,"Nebraska","Grant County",3,71,8,4,4
050,31,075,"Nebraska","Grant County",3,72,7,3,4
050,31,075,"Nebraska","Grant County",3,73,5,2,3
050,31,075,"Nebraska","Grant County",3,74,6,2,4
050,31,075,"Nebraska","Grant County",3,75,5,3,2
050,31,075,"Nebraska","Grant County",3,76,3,1,2
050,31,075,"Nebraska","Grant County",3,77,6,2,4
050,31,075,"Nebraska","Grant County",3,78,4,2,2
050,31,075,"Nebraska","Grant County",3,79,4,2,2
050,31,075,"Nebraska","Grant County",3,80,4,2,2
050,31,075,"Nebraska","Grant County",3,81,3,2,1
050,31,075,"Nebraska","Grant County",3,82,4,3,1
050,31,075,"Nebraska","Grant County",3,83,5,3,2
050,31,075,"Nebraska","Grant County",3,84,4,2,2
050,31,075,"Nebraska","Grant County",3,85,10,3,7
050,31,075,"Nebraska","Grant County",4,0,10,3,7
050,31,075,"Nebraska","Grant County",4,1,7,2,5
050,31,075,"Nebraska","Grant County",4,2,6,3,3
050,31,075,"Nebraska","Grant County",4,3,6,2,4
050,31,075,"Nebraska","Grant County",4,4,10,4,6
050,31,075,"Nebraska","Grant County",4,5,12,7,5
050,31,075,"Nebraska","Grant County",4,6,6,3,3
050,31,075,"Nebraska","Grant County",4,7,9,5,4
050,31,075,"Nebraska","Grant County",4,8,6,2,4
050,31,075,"Nebraska","Grant County",4,9,6,3,3
050,31,075,"Nebraska","Grant County",4,10,5,2,3
050,31,075,"Nebraska","Grant County",4,11,9,4,5
050,31,075,"Nebraska","Grant County",4,12,9,6,3
050,31,075,"Nebraska","Grant County",4,13,8,5,3
050,31,075,"Nebraska","Grant County",4,14,7,4,3
050,31,075,"Nebraska","Grant County",4,15,12,11,1
050,31,075,"Nebraska","Grant County",4,16,8,6,2
050,31,075,"Nebraska","Grant County",4,17,7,4,3
050,31,075,"Nebraska","Grant County",4,18,7,3,4
050,31,075,"Nebraska","Grant County",4,19,4,2,2
050,31,075,"Nebraska","Grant County",4,20,2,1,1
050,31,075,"Nebraska","Grant County",4,21,4,2,2
050,31,075,"Nebraska","Grant County",4,22,5,1,4
050,31,075,"Nebraska","Grant County",4,23,9,4,5
050,31,075,"Nebraska","Grant County",4,24,4,3,1
050,31,075,"Nebraska","Grant County",4,25,5,3,2
050,31,075,"Nebraska","Grant County",4,26,6,5,1
050,31,075,"Nebraska","Grant County",4,27,5,4,1
050,31,075,"Nebraska","Grant County",4,28,7,3,4
050,31,075,"Nebraska","Grant County",4,29,7,3,4
050,31,075,"Nebraska","Grant County",4,30,3,2,1
050,31,075,"Nebraska","Grant County",4,31,9,6,3
050,31,075,"Nebraska","Grant County",4,32,7,3,4
050,31,075,"Nebraska","Grant County",4,33,6,5,1
050,31,075,"Nebraska","Grant County",4,34,3,2,1
050,31,075,"Nebraska","Grant County",4,35,10,5,5
050,31,075,"Nebraska","Grant County",4,36,12,6,6
050,31,075,"Nebraska","Grant County",4,37,5,3,2
050,31,075,"Nebraska","Grant County",4,38,4,2,2
050,31,075,"Nebraska","Grant County",4,39,6,4,2
050,31,075,"Nebraska","Grant County",4,40,8,6,2
050,31,075,"Nebraska","Grant County",4,41,7,4,3
050,31,075,"Nebraska","Grant County",4,42,8,3,5
050,31,075,"Nebraska","Grant County",4,43,10,5,5
050,31,075,"Nebraska","Grant County",4,44,6,3,3
050,31,075,"Nebraska","Grant County",4,45,8,3,5
050,31,075,"Nebraska","Grant County",4,46,6,3,3
050,31,075,"Nebraska","Grant County",4,47,5,3,2
050,31,075,"Nebraska","Grant County",4,48,5,3,2
050,31,075,"Nebraska","Grant County",4,49,6,5,1
050,31,075,"Nebraska","Grant County",4,50,4,2,2
050,31,075,"Nebraska","Grant County",4,51,5,2,3
050,31,075,"Nebraska","Grant County",4,52,4,2,2
050,31,075,"Nebraska","Grant County",4,53,2,2,0
050,31,075,"Nebraska","Grant County",4,54,3,2,1
050,31,075,"Nebraska","Grant County",4,55,4,2,2
050,31,075,"Nebraska","Grant County",4,56,4,1,3
050,31,075,"Nebraska","Grant County",4,57,4,1,3
050,31,075,"Nebraska","Grant County",4,58,8,4,4
050,31,075,"Nebraska","Grant County",4,59,11,4,7
050,31,075,"Nebraska","Grant County",4,60,15,7,8
050,31,075,"Nebraska","Grant County",4,61,13,7,6
050,31,075,"Nebraska","Grant County",4,62,9,4,5
050,31,075,"Nebraska","Grant County",4,63,7,4,3
050,31,075,"Nebraska","Grant County",4,64,7,5,2
050,31,075,"Nebraska","Grant County",4,65,9,5,4
050,31,075,"Nebraska","Grant County",4,66,11,5,6
050,31,075,"Nebraska","Grant County",4,67,9,5,4
050,31,075,"Nebraska","Grant County",4,68,8,4,4
050,31,075,"Nebraska","Grant County",4,69,11,6,5
050,31,075,"Nebraska","Grant County",4,70,14,8,6
050,31,075,"Nebraska","Grant County",4,71,11,6,5
050,31,075,"Nebraska","Grant County",4,72,7,3,4
050,31,075,"Nebraska","Grant County",4,73,7,3,4
050,31,075,"Nebraska","Grant County",4,74,3,1,2
050,31,075,"Nebraska","Grant County",4,75,6,2,4
050,31,075,"Nebraska","Grant County",4,76,4,2,2
050,31,075,"Nebraska","Grant County",4,77,2,1,1
050,31,075,"Nebraska","Grant County",4,78,6,2,4
050,31,075,"Nebraska","Grant County",4,79,4,2,2
050,31,075,"Nebraska","Grant County",4,80,4,2,2
050,31,075,"Nebraska","Grant County",4,81,4,2,2
050,31,075,"Nebraska","Grant County",4,82,3,2,1
050,31,075,"Nebraska","Grant County",4,83,3,3,0
050,31,075,"Nebraska","Grant County",4,84,5,3,2
050,31,075,"Nebraska","Grant County",4,85,11,3,8
050,31,075,"Nebraska","Grant County",5,0,8,2,6
050,31,075,"Nebraska","Grant County",5,1,10,3,7
050,31,075,"Nebraska","Grant County",5,2,6,2,4
050,31,075,"Nebraska","Grant County",5,3,6,3,3
050,31,075,"Nebraska","Grant County",5,4,6,2,4
050,31,075,"Nebraska","Grant County",5,5,8,4,4
050,31,075,"Nebraska","Grant County",5,6,11,7,4
050,31,075,"Nebraska","Grant County",5,7,5,2,3
050,31,075,"Nebraska","Grant County",5,8,7,5,2
050,31,075,"Nebraska","Grant County",5,9,7,2,5
050,31,075,"Nebraska","Grant County",5,10,7,3,4
050,31,075,"Nebraska","Grant County",5,11,5,2,3
050,31,075,"Nebraska","Grant County",5,12,9,4,5
050,31,075,"Nebraska","Grant County",5,13,9,6,3
050,31,075,"Nebraska","Grant County",5,14,7,5,2
050,31,075,"Nebraska","Grant County",5,15,7,4,3
050,31,075,"Nebraska","Grant County",5,16,12,11,1
050,31,075,"Nebraska","Grant County",5,17,8,6,2
050,31,075,"Nebraska","Grant County",5,18,5,3,2
050,31,075,"Nebraska","Grant County",5,19,4,1,3
050,31,075,"Nebraska","Grant County",5,20,3,2,1
050,31,075,"Nebraska","Grant County",5,21,1,1,0
050,31,075,"Nebraska","Grant County",5,22,6,2,4
050,31,075,"Nebraska","Grant County",5,23,6,1,5
050,31,075,"Nebraska","Grant County",5,24,9,5,4
050,31,075,"Nebraska","Grant County",5,25,1,1,0
050,31,075,"Nebraska","Grant County",5,26,5,3,2
050,31,075,"Nebraska","Grant County",5,27,6,4,2
050,31,075,"Nebraska","Grant County",5,28,3,2,1
050,31,075,"Nebraska","Grant County",5,29,6,2,4
050,31,075,"Nebraska","Grant County",5,30,7,4,3
050,31,075,"Nebraska","Grant County",5,31,4,2,2
050,31,075,"Nebraska","Grant County",5,32,8,5,3
050,31,075,"Nebraska","Grant County",5,33,6,3,3
050,31,075,"Nebraska","Grant County",5,34,6,5,1
050,31,075,"Nebraska","Grant County",5,35,3,2,1
050,31,075,"Nebraska","Grant County",5,36,11,6,5
050,31,075,"Nebraska","Grant County",5,37,11,5,6
050,31,075,"Nebraska","Grant County",5,38,5,3,2
050,31,075,"Nebraska","Grant County",5,39,5,2,3
050,31,075,"Nebraska","Grant County",5,40,7,5,2
050,31,075,"Nebraska","Grant County",5,41,6,6,0
050,31,075,"Nebraska","Grant County",5,42,7,4,3
050,31,075,"Nebraska","Grant County",5,43,8,3,5
050,31,075,"Nebraska","Grant County",5,44,10,5,5
050,31,075,"Nebraska","Grant County",5,45,6,3,3
050,31,075,"Nebraska","Grant County",5,46,8,3,5
050,31,075,"Nebraska","Grant County",5,47,7,4,3
050,31,075,"Nebraska","Grant County",5,48,4,2,2
050,31,075,"Nebraska","Grant County",5,49,6,4,2
050,31,075,"Nebraska","Grant County",5,50,5,4,1
050,31,075,"Nebraska","Grant County",5,51,4,2,2
050,31,075,"Nebraska","Grant County",5,52,5,2,3
050,31,075,"Nebraska","Grant County",5,53,4,2,2
050,31,075,"Nebraska","Grant County",5,54,0,0,0
050,31,075,"Nebraska","Grant County",5,55,3,2,1
050,31,075,"Nebraska","Grant County",5,56,4,2,2
050,31,075,"Nebraska","Grant County",5,57,4,1,3
050,31,075,"Nebraska","Grant County",5,58,4,1,3
050,31,075,"Nebraska","Grant County",5,59,8,4,4
050,31,075,"Nebraska","Grant County",5,60,11,4,7
050,31,075,"Nebraska","Grant County",5,61,15,7,8
050,31,075,"Nebraska","Grant County",5,62,13,7,6
050,31,075,"Nebraska","Grant County",5,63,9,4,5
050,31,075,"Nebraska","Grant County",5,64,7,4,3
050,31,075,"Nebraska","Grant County",5,65,6,4,2
050,31,075,"Nebraska","Grant County",5,66,8,5,3
050,31,075,"Nebraska","Grant County",5,67,9,4,5
050,31,075,"Nebraska","Grant County",5,68,10,5,5
050,31,075,"Nebraska","Grant County",5,69,9,4,5
050,31,075,"Nebraska","Grant County",5,70,10,6,4
050,31,075,"Nebraska","Grant County",5,71,13,7,6
050,31,075,"Nebraska","Grant County",5,72,10,6,4
050,31,075,"Nebraska","Grant County",5,73,7,3,4
050,31,075,"Nebraska","Grant County",5,74,6,2,4
050,31,075,"Nebraska","Grant County",5,75,4,2,2
050,31,075,"Nebraska","Grant County",5,76,6,2,4
050,31,075,"Nebraska","Grant County",5,77,4,2,2
050,31,075,"Nebraska","Grant County",5,78,2,1,1
050,31,075,"Nebraska","Grant County",5,79,6,2,4
050,31,075,"Nebraska","Grant County",5,80,3,2,1
050,31,075,"Nebraska","Grant County",5,81,3,2,1
050,31,075,"Nebraska","Grant County",5,82,4,2,2
050,31,075,"Nebraska","Grant County",5,83,3,2,1
050,31,075,"Nebraska","Grant County",5,84,3,3,0
050,31,075,"Nebraska","Grant County",5,85,15,5,10
050,31,077,"Nebraska","Greeley County",1,0,24,13,11
050,31,077,"Nebraska","Greeley County",1,1,27,17,10
050,31,077,"Nebraska","Greeley County",1,2,25,12,13
050,31,077,"Nebraska","Greeley County",1,3,28,10,18
050,31,077,"Nebraska","Greeley County",1,4,25,14,11
050,31,077,"Nebraska","Greeley County",1,5,31,15,16
050,31,077,"Nebraska","Greeley County",1,6,27,13,14
050,31,077,"Nebraska","Greeley County",1,7,23,11,12
050,31,077,"Nebraska","Greeley County",1,8,28,15,13
050,31,077,"Nebraska","Greeley County",1,9,29,15,14
050,31,077,"Nebraska","Greeley County",1,10,28,13,15
050,31,077,"Nebraska","Greeley County",1,11,31,17,14
050,31,077,"Nebraska","Greeley County",1,12,32,18,14
050,31,077,"Nebraska","Greeley County",1,13,32,14,18
050,31,077,"Nebraska","Greeley County",1,14,30,17,13
050,31,077,"Nebraska","Greeley County",1,15,31,15,16
050,31,077,"Nebraska","Greeley County",1,16,31,15,16
050,31,077,"Nebraska","Greeley County",1,17,24,12,12
050,31,077,"Nebraska","Greeley County",1,18,23,15,8
050,31,077,"Nebraska","Greeley County",1,19,19,10,9
050,31,077,"Nebraska","Greeley County",1,20,25,16,9
050,31,077,"Nebraska","Greeley County",1,21,24,12,12
050,31,077,"Nebraska","Greeley County",1,22,26,13,13
050,31,077,"Nebraska","Greeley County",1,23,21,10,11
050,31,077,"Nebraska","Greeley County",1,24,23,8,15
050,31,077,"Nebraska","Greeley County",1,25,19,10,9
050,31,077,"Nebraska","Greeley County",1,26,20,12,8
050,31,077,"Nebraska","Greeley County",1,27,16,9,7
050,31,077,"Nebraska","Greeley County",1,28,21,10,11
050,31,077,"Nebraska","Greeley County",1,29,15,8,7
050,31,077,"Nebraska","Greeley County",1,30,19,8,11
050,31,077,"Nebraska","Greeley County",1,31,27,10,17
050,31,077,"Nebraska","Greeley County",1,32,25,15,10
050,31,077,"Nebraska","Greeley County",1,33,21,10,11
050,31,077,"Nebraska","Greeley County",1,34,27,14,13
050,31,077,"Nebraska","Greeley County",1,35,25,12,13
050,31,077,"Nebraska","Greeley County",1,36,20,11,9
050,31,077,"Nebraska","Greeley County",1,37,28,11,17
050,31,077,"Nebraska","Greeley County",1,38,23,12,11
050,31,077,"Nebraska","Greeley County",1,39,19,10,9
050,31,077,"Nebraska","Greeley County",1,40,17,10,7
050,31,077,"Nebraska","Greeley County",1,41,23,11,12
050,31,077,"Nebraska","Greeley County",1,42,24,12,12
050,31,077,"Nebraska","Greeley County",1,43,25,13,12
050,31,077,"Nebraska","Greeley County",1,44,28,16,12
050,31,077,"Nebraska","Greeley County",1,45,26,16,10
050,31,077,"Nebraska","Greeley County",1,46,27,14,13
050,31,077,"Nebraska","Greeley County",1,47,14,7,7
050,31,077,"Nebraska","Greeley County",1,48,10,5,5
050,31,077,"Nebraska","Greeley County",1,49,19,12,7
050,31,077,"Nebraska","Greeley County",1,50,21,13,8
050,31,077,"Nebraska","Greeley County",1,51,16,7,9
050,31,077,"Nebraska","Greeley County",1,52,23,11,12
050,31,077,"Nebraska","Greeley County",1,53,21,9,12
050,31,077,"Nebraska","Greeley County",1,54,28,10,18
050,31,077,"Nebraska","Greeley County",1,55,30,14,16
050,31,077,"Nebraska","Greeley County",1,56,33,18,15
050,31,077,"Nebraska","Greeley County",1,57,38,17,21
050,31,077,"Nebraska","Greeley County",1,58,38,18,20
050,31,077,"Nebraska","Greeley County",1,59,35,17,18
050,31,077,"Nebraska","Greeley County",1,60,35,21,14
050,31,077,"Nebraska","Greeley County",1,61,35,23,12
050,31,077,"Nebraska","Greeley County",1,62,26,17,9
050,31,077,"Nebraska","Greeley County",1,63,35,17,18
050,31,077,"Nebraska","Greeley County",1,64,34,15,19
050,31,077,"Nebraska","Greeley County",1,65,34,14,20
050,31,077,"Nebraska","Greeley County",1,66,29,15,14
050,31,077,"Nebraska","Greeley County",1,67,29,16,13
050,31,077,"Nebraska","Greeley County",1,68,42,25,17
050,31,077,"Nebraska","Greeley County",1,69,34,16,18
050,31,077,"Nebraska","Greeley County",1,70,25,12,13
050,31,077,"Nebraska","Greeley County",1,71,23,11,12
050,31,077,"Nebraska","Greeley County",1,72,21,13,8
050,31,077,"Nebraska","Greeley County",1,73,25,17,8
050,31,077,"Nebraska","Greeley County",1,74,15,11,4
050,31,077,"Nebraska","Greeley County",1,75,19,14,5
050,31,077,"Nebraska","Greeley County",1,76,19,7,12
050,31,077,"Nebraska","Greeley County",1,77,24,9,15
050,31,077,"Nebraska","Greeley County",1,78,13,5,8
050,31,077,"Nebraska","Greeley County",1,79,16,9,7
050,31,077,"Nebraska","Greeley County",1,80,16,10,6
050,31,077,"Nebraska","Greeley County",1,81,20,13,7
050,31,077,"Nebraska","Greeley County",1,82,13,7,6
050,31,077,"Nebraska","Greeley County",1,83,14,4,10
050,31,077,"Nebraska","Greeley County",1,84,13,6,7
050,31,077,"Nebraska","Greeley County",1,85,92,29,63
050,31,077,"Nebraska","Greeley County",2,0,24,14,10
050,31,077,"Nebraska","Greeley County",2,1,26,16,10
050,31,077,"Nebraska","Greeley County",2,2,24,12,12
050,31,077,"Nebraska","Greeley County",2,3,26,10,16
050,31,077,"Nebraska","Greeley County",2,4,25,12,13
050,31,077,"Nebraska","Greeley County",2,5,30,15,15
050,31,077,"Nebraska","Greeley County",2,6,27,13,14
050,31,077,"Nebraska","Greeley County",2,7,23,11,12
050,31,077,"Nebraska","Greeley County",2,8,28,15,13
050,31,077,"Nebraska","Greeley County",2,9,29,15,14
050,31,077,"Nebraska","Greeley County",2,10,29,14,15
050,31,077,"Nebraska","Greeley County",2,11,31,16,15
050,31,077,"Nebraska","Greeley County",2,12,31,18,13
050,31,077,"Nebraska","Greeley County",2,13,32,15,17
050,31,077,"Nebraska","Greeley County",2,14,29,16,13
050,31,077,"Nebraska","Greeley County",2,15,31,16,15
050,31,077,"Nebraska","Greeley County",2,16,32,16,16
050,31,077,"Nebraska","Greeley County",2,17,25,13,12
050,31,077,"Nebraska","Greeley County",2,18,23,14,9
050,31,077,"Nebraska","Greeley County",2,19,19,11,8
050,31,077,"Nebraska","Greeley County",2,20,24,15,9
050,31,077,"Nebraska","Greeley County",2,21,23,12,11
050,31,077,"Nebraska","Greeley County",2,22,25,13,12
050,31,077,"Nebraska","Greeley County",2,23,23,11,12
050,31,077,"Nebraska","Greeley County",2,24,22,9,13
050,31,077,"Nebraska","Greeley County",2,25,21,10,11
050,31,077,"Nebraska","Greeley County",2,26,20,12,8
050,31,077,"Nebraska","Greeley County",2,27,17,10,7
050,31,077,"Nebraska","Greeley County",2,28,19,9,10
050,31,077,"Nebraska","Greeley County",2,29,16,8,8
050,31,077,"Nebraska","Greeley County",2,30,18,8,10
050,31,077,"Nebraska","Greeley County",2,31,25,10,15
050,31,077,"Nebraska","Greeley County",2,32,25,14,11
050,31,077,"Nebraska","Greeley County",2,33,22,11,11
050,31,077,"Nebraska","Greeley County",2,34,25,13,12
050,31,077,"Nebraska","Greeley County",2,35,24,12,12
050,31,077,"Nebraska","Greeley County",2,36,21,11,10
050,31,077,"Nebraska","Greeley County",2,37,26,11,15
050,31,077,"Nebraska","Greeley County",2,38,25,12,13
050,31,077,"Nebraska","Greeley County",2,39,19,10,9
050,31,077,"Nebraska","Greeley County",2,40,18,10,8
050,31,077,"Nebraska","Greeley County",2,41,21,10,11
050,31,077,"Nebraska","Greeley County",2,42,24,12,12
050,31,077,"Nebraska","Greeley County",2,43,25,13,12
050,31,077,"Nebraska","Greeley County",2,44,26,15,11
050,31,077,"Nebraska","Greeley County",2,45,27,16,11
050,31,077,"Nebraska","Greeley County",2,46,27,15,12
050,31,077,"Nebraska","Greeley County",2,47,16,8,8
050,31,077,"Nebraska","Greeley County",2,48,11,6,5
050,31,077,"Nebraska","Greeley County",2,49,17,11,6
050,31,077,"Nebraska","Greeley County",2,50,21,13,8
050,31,077,"Nebraska","Greeley County",2,51,17,8,9
050,31,077,"Nebraska","Greeley County",2,52,21,10,11
050,31,077,"Nebraska","Greeley County",2,53,21,9,12
050,31,077,"Nebraska","Greeley County",2,54,27,10,17
050,31,077,"Nebraska","Greeley County",2,55,30,13,17
050,31,077,"Nebraska","Greeley County",2,56,32,17,15
050,31,077,"Nebraska","Greeley County",2,57,37,17,20
050,31,077,"Nebraska","Greeley County",2,58,37,18,19
050,31,077,"Nebraska","Greeley County",2,59,36,17,19
050,31,077,"Nebraska","Greeley County",2,60,36,21,15
050,31,077,"Nebraska","Greeley County",2,61,35,22,13
050,31,077,"Nebraska","Greeley County",2,62,28,19,9
050,31,077,"Nebraska","Greeley County",2,63,33,17,16
050,31,077,"Nebraska","Greeley County",2,64,34,15,19
050,31,077,"Nebraska","Greeley County",2,65,35,15,20
050,31,077,"Nebraska","Greeley County",2,66,30,15,15
050,31,077,"Nebraska","Greeley County",2,67,29,16,13
050,31,077,"Nebraska","Greeley County",2,68,37,21,16
050,31,077,"Nebraska","Greeley County",2,69,36,18,18
050,31,077,"Nebraska","Greeley County",2,70,27,13,14
050,31,077,"Nebraska","Greeley County",2,71,24,11,13
050,31,077,"Nebraska","Greeley County",2,72,21,12,9
050,31,077,"Nebraska","Greeley County",2,73,25,17,8
050,31,077,"Nebraska","Greeley County",2,74,17,12,5
050,31,077,"Nebraska","Greeley County",2,75,18,13,5
050,31,077,"Nebraska","Greeley County",2,76,19,9,10
050,31,077,"Nebraska","Greeley County",2,77,24,9,15
050,31,077,"Nebraska","Greeley County",2,78,15,6,9
050,31,077,"Nebraska","Greeley County",2,79,15,8,7
050,31,077,"Nebraska","Greeley County",2,80,16,10,6
050,31,077,"Nebraska","Greeley County",2,81,19,12,7
050,31,077,"Nebraska","Greeley County",2,82,15,9,6
050,31,077,"Nebraska","Greeley County",2,83,14,5,9
050,31,077,"Nebraska","Greeley County",2,84,12,5,7
050,31,077,"Nebraska","Greeley County",2,85,90,28,62
050,31,077,"Nebraska","Greeley County",3,0,21,14,7
050,31,077,"Nebraska","Greeley County",3,1,24,14,10
050,31,077,"Nebraska","Greeley County",3,2,27,17,10
050,31,077,"Nebraska","Greeley County",3,3,25,14,11
050,31,077,"Nebraska","Greeley County",3,4,25,10,15
050,31,077,"Nebraska","Greeley County",3,5,22,11,11
050,31,077,"Nebraska","Greeley County",3,6,28,14,14
050,31,077,"Nebraska","Greeley County",3,7,28,14,14
050,31,077,"Nebraska","Greeley County",3,8,26,12,14
050,31,077,"Nebraska","Greeley County",3,9,31,18,13
050,31,077,"Nebraska","Greeley County",3,10,28,13,15
050,31,077,"Nebraska","Greeley County",3,11,31,15,16
050,31,077,"Nebraska","Greeley County",3,12,36,17,19
050,31,077,"Nebraska","Greeley County",3,13,27,17,10
050,31,077,"Nebraska","Greeley County",3,14,31,15,16
050,31,077,"Nebraska","Greeley County",3,15,29,15,14
050,31,077,"Nebraska","Greeley County",3,16,28,13,15
050,31,077,"Nebraska","Greeley County",3,17,34,15,19
050,31,077,"Nebraska","Greeley County",3,18,21,10,11
050,31,077,"Nebraska","Greeley County",3,19,20,12,8
050,31,077,"Nebraska","Greeley County",3,20,19,12,7
050,31,077,"Nebraska","Greeley County",3,21,23,13,10
050,31,077,"Nebraska","Greeley County",3,22,24,12,12
050,31,077,"Nebraska","Greeley County",3,23,24,13,11
050,31,077,"Nebraska","Greeley County",3,24,25,12,13
050,31,077,"Nebraska","Greeley County",3,25,23,11,12
050,31,077,"Nebraska","Greeley County",3,26,24,12,12
050,31,077,"Nebraska","Greeley County",3,27,22,12,10
050,31,077,"Nebraska","Greeley County",3,28,19,10,9
050,31,077,"Nebraska","Greeley County",3,29,17,8,9
050,31,077,"Nebraska","Greeley County",3,30,16,8,8
050,31,077,"Nebraska","Greeley County",3,31,16,7,9
050,31,077,"Nebraska","Greeley County",3,32,26,12,14
050,31,077,"Nebraska","Greeley County",3,33,25,14,11
050,31,077,"Nebraska","Greeley County",3,34,24,11,13
050,31,077,"Nebraska","Greeley County",3,35,25,13,12
050,31,077,"Nebraska","Greeley County",3,36,23,10,13
050,31,077,"Nebraska","Greeley County",3,37,21,11,10
050,31,077,"Nebraska","Greeley County",3,38,26,11,15
050,31,077,"Nebraska","Greeley County",3,39,23,12,11
050,31,077,"Nebraska","Greeley County",3,40,19,9,10
050,31,077,"Nebraska","Greeley County",3,41,17,10,7
050,31,077,"Nebraska","Greeley County",3,42,23,10,13
050,31,077,"Nebraska","Greeley County",3,43,23,10,13
050,31,077,"Nebraska","Greeley County",3,44,27,14,13
050,31,077,"Nebraska","Greeley County",3,45,28,16,12
050,31,077,"Nebraska","Greeley County",3,46,28,16,12
050,31,077,"Nebraska","Greeley County",3,47,29,16,13
050,31,077,"Nebraska","Greeley County",3,48,17,9,8
050,31,077,"Nebraska","Greeley County",3,49,11,6,5
050,31,077,"Nebraska","Greeley County",3,50,19,12,7
050,31,077,"Nebraska","Greeley County",3,51,19,12,7
050,31,077,"Nebraska","Greeley County",3,52,18,8,10
050,31,077,"Nebraska","Greeley County",3,53,21,10,11
050,31,077,"Nebraska","Greeley County",3,54,21,8,13
050,31,077,"Nebraska","Greeley County",3,55,26,10,16
050,31,077,"Nebraska","Greeley County",3,56,27,10,17
050,31,077,"Nebraska","Greeley County",3,57,33,17,16
050,31,077,"Nebraska","Greeley County",3,58,34,16,18
050,31,077,"Nebraska","Greeley County",3,59,35,17,18
050,31,077,"Nebraska","Greeley County",3,60,33,17,16
050,31,077,"Nebraska","Greeley County",3,61,33,18,15
050,31,077,"Nebraska","Greeley County",3,62,36,22,14
050,31,077,"Nebraska","Greeley County",3,63,28,19,9
050,31,077,"Nebraska","Greeley County",3,64,39,20,19
050,31,077,"Nebraska","Greeley County",3,65,33,16,17
050,31,077,"Nebraska","Greeley County",3,66,34,14,20
050,31,077,"Nebraska","Greeley County",3,67,32,16,16
050,31,077,"Nebraska","Greeley County",3,68,30,16,14
050,31,077,"Nebraska","Greeley County",3,69,37,21,16
050,31,077,"Nebraska","Greeley County",3,70,35,18,17
050,31,077,"Nebraska","Greeley County",3,71,26,12,14
050,31,077,"Nebraska","Greeley County",3,72,24,12,12
050,31,077,"Nebraska","Greeley County",3,73,22,13,9
050,31,077,"Nebraska","Greeley County",3,74,25,17,8
050,31,077,"Nebraska","Greeley County",3,75,17,12,5
050,31,077,"Nebraska","Greeley County",3,76,17,12,5
050,31,077,"Nebraska","Greeley County",3,77,18,8,10
050,31,077,"Nebraska","Greeley County",3,78,22,8,14
050,31,077,"Nebraska","Greeley County",3,79,14,5,9
050,31,077,"Nebraska","Greeley County",3,80,16,9,7
050,31,077,"Nebraska","Greeley County",3,81,15,8,7
050,31,077,"Nebraska","Greeley County",3,82,16,10,6
050,31,077,"Nebraska","Greeley County",3,83,16,8,8
050,31,077,"Nebraska","Greeley County",3,84,14,5,9
050,31,077,"Nebraska","Greeley County",3,85,87,26,61
050,31,077,"Nebraska","Greeley County",4,0,31,15,16
050,31,077,"Nebraska","Greeley County",4,1,19,12,7
050,31,077,"Nebraska","Greeley County",4,2,25,15,10
050,31,077,"Nebraska","Greeley County",4,3,29,15,14
050,31,077,"Nebraska","Greeley County",4,4,25,15,10
050,31,077,"Nebraska","Greeley County",4,5,27,10,17
050,31,077,"Nebraska","Greeley County",4,6,22,12,10
050,31,077,"Nebraska","Greeley County",4,7,29,14,15
050,31,077,"Nebraska","Greeley County",4,8,32,16,16
050,31,077,"Nebraska","Greeley County",4,9,30,13,17
050,31,077,"Nebraska","Greeley County",4,10,31,17,14
050,31,077,"Nebraska","Greeley County",4,11,30,13,17
050,31,077,"Nebraska","Greeley County",4,12,37,17,20
050,31,077,"Nebraska","Greeley County",4,13,40,21,19
050,31,077,"Nebraska","Greeley County",4,14,34,18,16
050,31,077,"Nebraska","Greeley County",4,15,36,19,17
050,31,077,"Nebraska","Greeley County",4,16,30,17,13
050,31,077,"Nebraska","Greeley County",4,17,32,17,15
050,31,077,"Nebraska","Greeley County",4,18,30,15,15
050,31,077,"Nebraska","Greeley County",4,19,14,8,6
050,31,077,"Nebraska","Greeley County",4,20,22,12,10
050,31,077,"Nebraska","Greeley County",4,21,20,13,7
050,31,077,"Nebraska","Greeley County",4,22,21,11,10
050,31,077,"Nebraska","Greeley County",4,23,23,13,10
050,31,077,"Nebraska","Greeley County",4,24,23,12,11
050,31,077,"Nebraska","Greeley County",4,25,22,11,11
050,31,077,"Nebraska","Greeley County",4,26,22,11,11
050,31,077,"Nebraska","Greeley County",4,27,27,13,14
050,31,077,"Nebraska","Greeley County",4,28,21,13,8
050,31,077,"Nebraska","Greeley County",4,29,20,10,10
050,31,077,"Nebraska","Greeley County",4,30,18,8,10
050,31,077,"Nebraska","Greeley County",4,31,18,10,8
050,31,077,"Nebraska","Greeley County",4,32,16,6,10
050,31,077,"Nebraska","Greeley County",4,33,29,14,15
050,31,077,"Nebraska","Greeley County",4,34,27,15,12
050,31,077,"Nebraska","Greeley County",4,35,24,11,13
050,31,077,"Nebraska","Greeley County",4,36,28,16,12
050,31,077,"Nebraska","Greeley County",4,37,22,10,12
050,31,077,"Nebraska","Greeley County",4,38,20,9,11
050,31,077,"Nebraska","Greeley County",4,39,27,12,15
050,31,077,"Nebraska","Greeley County",4,40,23,12,11
050,31,077,"Nebraska","Greeley County",4,41,19,9,10
050,31,077,"Nebraska","Greeley County",4,42,17,10,7
050,31,077,"Nebraska","Greeley County",4,43,24,9,15
050,31,077,"Nebraska","Greeley County",4,44,23,10,13
050,31,077,"Nebraska","Greeley County",4,45,28,15,13
050,31,077,"Nebraska","Greeley County",4,46,32,18,14
050,31,077,"Nebraska","Greeley County",4,47,28,17,11
050,31,077,"Nebraska","Greeley County",4,48,28,15,13
050,31,077,"Nebraska","Greeley County",4,49,17,9,8
050,31,077,"Nebraska","Greeley County",4,50,13,6,7
050,31,077,"Nebraska","Greeley County",4,51,22,12,10
050,31,077,"Nebraska","Greeley County",4,52,19,12,7
050,31,077,"Nebraska","Greeley County",4,53,17,8,9
050,31,077,"Nebraska","Greeley County",4,54,21,10,11
050,31,077,"Nebraska","Greeley County",4,55,21,8,13
050,31,077,"Nebraska","Greeley County",4,56,27,10,17
050,31,077,"Nebraska","Greeley County",4,57,29,11,18
050,31,077,"Nebraska","Greeley County",4,58,34,18,16
050,31,077,"Nebraska","Greeley County",4,59,34,16,18
050,31,077,"Nebraska","Greeley County",4,60,35,17,18
050,31,077,"Nebraska","Greeley County",4,61,33,17,16
050,31,077,"Nebraska","Greeley County",4,62,32,18,14
050,31,077,"Nebraska","Greeley County",4,63,37,23,14
050,31,077,"Nebraska","Greeley County",4,64,28,19,9
050,31,077,"Nebraska","Greeley County",4,65,39,20,19
050,31,077,"Nebraska","Greeley County",4,66,31,14,17
050,31,077,"Nebraska","Greeley County",4,67,35,14,21
050,31,077,"Nebraska","Greeley County",4,68,32,16,16
050,31,077,"Nebraska","Greeley County",4,69,34,18,16
050,31,077,"Nebraska","Greeley County",4,70,36,21,15
050,31,077,"Nebraska","Greeley County",4,71,36,18,18
050,31,077,"Nebraska","Greeley County",4,72,23,10,13
050,31,077,"Nebraska","Greeley County",4,73,22,9,13
050,31,077,"Nebraska","Greeley County",4,74,22,13,9
050,31,077,"Nebraska","Greeley County",4,75,26,18,8
050,31,077,"Nebraska","Greeley County",4,76,17,12,5
050,31,077,"Nebraska","Greeley County",4,77,14,9,5
050,31,077,"Nebraska","Greeley County",4,78,16,8,8
050,31,077,"Nebraska","Greeley County",4,79,19,7,12
050,31,077,"Nebraska","Greeley County",4,80,14,6,8
050,31,077,"Nebraska","Greeley County",4,81,17,8,9
050,31,077,"Nebraska","Greeley County",4,82,8,5,3
050,31,077,"Nebraska","Greeley County",4,83,16,9,7
050,31,077,"Nebraska","Greeley County",4,84,16,8,8
050,31,077,"Nebraska","Greeley County",4,85,88,28,60
050,31,077,"Nebraska","Greeley County",5,0,26,14,12
050,31,077,"Nebraska","Greeley County",5,1,31,16,15
050,31,077,"Nebraska","Greeley County",5,2,19,12,7
050,31,077,"Nebraska","Greeley County",5,3,26,15,11
050,31,077,"Nebraska","Greeley County",5,4,27,14,13
050,31,077,"Nebraska","Greeley County",5,5,31,20,11
050,31,077,"Nebraska","Greeley County",5,6,28,11,17
050,31,077,"Nebraska","Greeley County",5,7,23,12,11
050,31,077,"Nebraska","Greeley County",5,8,28,13,15
050,31,077,"Nebraska","Greeley County",5,9,31,15,16
050,31,077,"Nebraska","Greeley County",5,10,28,12,16
050,31,077,"Nebraska","Greeley County",5,11,32,17,15
050,31,077,"Nebraska","Greeley County",5,12,29,13,16
050,31,077,"Nebraska","Greeley County",5,13,36,17,19
050,31,077,"Nebraska","Greeley County",5,14,37,20,17
050,31,077,"Nebraska","Greeley County",5,15,27,16,11
050,31,077,"Nebraska","Greeley County",5,16,36,19,17
050,31,077,"Nebraska","Greeley County",5,17,30,17,13
050,31,077,"Nebraska","Greeley County",5,18,28,16,12
050,31,077,"Nebraska","Greeley County",5,19,24,12,12
050,31,077,"Nebraska","Greeley County",5,20,16,8,8
050,31,077,"Nebraska","Greeley County",5,21,21,10,11
050,31,077,"Nebraska","Greeley County",5,22,21,13,8
050,31,077,"Nebraska","Greeley County",5,23,23,12,11
050,31,077,"Nebraska","Greeley County",5,24,21,12,9
050,31,077,"Nebraska","Greeley County",5,25,25,13,12
050,31,077,"Nebraska","Greeley County",5,26,20,9,11
050,31,077,"Nebraska","Greeley County",5,27,20,11,9
050,31,077,"Nebraska","Greeley County",5,28,27,13,14
050,31,077,"Nebraska","Greeley County",5,29,21,12,9
050,31,077,"Nebraska","Greeley County",5,30,20,9,11
050,31,077,"Nebraska","Greeley County",5,31,18,9,9
050,31,077,"Nebraska","Greeley County",5,32,19,11,8
050,31,077,"Nebraska","Greeley County",5,33,17,8,9
050,31,077,"Nebraska","Greeley County",5,34,31,18,13
050,31,077,"Nebraska","Greeley County",5,35,28,16,12
050,31,077,"Nebraska","Greeley County",5,36,23,10,13
050,31,077,"Nebraska","Greeley County",5,37,28,15,13
050,31,077,"Nebraska","Greeley County",5,38,22,10,12
050,31,077,"Nebraska","Greeley County",5,39,17,9,8
050,31,077,"Nebraska","Greeley County",5,40,30,14,16
050,31,077,"Nebraska","Greeley County",5,41,24,13,11
050,31,077,"Nebraska","Greeley County",5,42,18,9,9
050,31,077,"Nebraska","Greeley County",5,43,17,10,7
050,31,077,"Nebraska","Greeley County",5,44,25,10,15
050,31,077,"Nebraska","Greeley County",5,45,24,10,14
050,31,077,"Nebraska","Greeley County",5,46,27,16,11
050,31,077,"Nebraska","Greeley County",5,47,32,18,14
050,31,077,"Nebraska","Greeley County",5,48,27,16,11
050,31,077,"Nebraska","Greeley County",5,49,26,14,12
050,31,077,"Nebraska","Greeley County",5,50,21,12,9
050,31,077,"Nebraska","Greeley County",5,51,12,6,6
050,31,077,"Nebraska","Greeley County",5,52,23,12,11
050,31,077,"Nebraska","Greeley County",5,53,20,13,7
050,31,077,"Nebraska","Greeley County",5,54,17,7,10
050,31,077,"Nebraska","Greeley County",5,55,19,10,9
050,31,077,"Nebraska","Greeley County",5,56,21,8,13
050,31,077,"Nebraska","Greeley County",5,57,28,10,18
050,31,077,"Nebraska","Greeley County",5,58,29,11,18
050,31,077,"Nebraska","Greeley County",5,59,35,19,16
050,31,077,"Nebraska","Greeley County",5,60,34,17,17
050,31,077,"Nebraska","Greeley County",5,61,35,17,18
050,31,077,"Nebraska","Greeley County",5,62,34,18,16
050,31,077,"Nebraska","Greeley County",5,63,33,18,15
050,31,077,"Nebraska","Greeley County",5,64,40,26,14
050,31,077,"Nebraska","Greeley County",5,65,28,19,9
050,31,077,"Nebraska","Greeley County",5,66,37,19,18
050,31,077,"Nebraska","Greeley County",5,67,32,15,17
050,31,077,"Nebraska","Greeley County",5,68,35,14,21
050,31,077,"Nebraska","Greeley County",5,69,32,15,17
050,31,077,"Nebraska","Greeley County",5,70,28,16,12
050,31,077,"Nebraska","Greeley County",5,71,37,21,16
050,31,077,"Nebraska","Greeley County",5,72,35,18,17
050,31,077,"Nebraska","Greeley County",5,73,22,9,13
050,31,077,"Nebraska","Greeley County",5,74,22,9,13
050,31,077,"Nebraska","Greeley County",5,75,22,13,9
050,31,077,"Nebraska","Greeley County",5,76,26,18,8
050,31,077,"Nebraska","Greeley County",5,77,17,12,5
050,31,077,"Nebraska","Greeley County",5,78,12,8,4
050,31,077,"Nebraska","Greeley County",5,79,12,4,8
050,31,077,"Nebraska","Greeley County",5,80,19,8,11
050,31,077,"Nebraska","Greeley County",5,81,14,5,9
050,31,077,"Nebraska","Greeley County",5,82,12,6,6
050,31,077,"Nebraska","Greeley County",5,83,8,4,4
050,31,077,"Nebraska","Greeley County",5,84,16,9,7
050,31,077,"Nebraska","Greeley County",5,85,87,32,55
050,31,079,"Nebraska","Hall County",1,0,941,481,460
050,31,079,"Nebraska","Hall County",1,1,944,501,443
050,31,079,"Nebraska","Hall County",1,2,986,506,480
050,31,079,"Nebraska","Hall County",1,3,982,497,485
050,31,079,"Nebraska","Hall County",1,4,1001,525,476
050,31,079,"Nebraska","Hall County",1,5,1027,539,488
050,31,079,"Nebraska","Hall County",1,6,992,521,471
050,31,079,"Nebraska","Hall County",1,7,896,464,432
050,31,079,"Nebraska","Hall County",1,8,878,443,435
050,31,079,"Nebraska","Hall County",1,9,941,491,450
050,31,079,"Nebraska","Hall County",1,10,1001,524,477
050,31,079,"Nebraska","Hall County",1,11,998,514,484
050,31,079,"Nebraska","Hall County",1,12,1019,524,495
050,31,079,"Nebraska","Hall County",1,13,1016,519,497
050,31,079,"Nebraska","Hall County",1,14,1003,498,505
050,31,079,"Nebraska","Hall County",1,15,971,502,469
050,31,079,"Nebraska","Hall County",1,16,984,501,483
050,31,079,"Nebraska","Hall County",1,17,955,505,450
050,31,079,"Nebraska","Hall County",1,18,830,450,380
050,31,079,"Nebraska","Hall County",1,19,644,349,295
050,31,079,"Nebraska","Hall County",1,20,690,358,332
050,31,079,"Nebraska","Hall County",1,21,711,371,340
050,31,079,"Nebraska","Hall County",1,22,715,343,372
050,31,079,"Nebraska","Hall County",1,23,746,370,376
050,31,079,"Nebraska","Hall County",1,24,744,387,357
050,31,079,"Nebraska","Hall County",1,25,786,427,359
050,31,079,"Nebraska","Hall County",1,26,814,422,392
050,31,079,"Nebraska","Hall County",1,27,812,422,390
050,31,079,"Nebraska","Hall County",1,28,828,423,405
050,31,079,"Nebraska","Hall County",1,29,794,422,372
050,31,079,"Nebraska","Hall County",1,30,803,424,379
050,31,079,"Nebraska","Hall County",1,31,761,421,340
050,31,079,"Nebraska","Hall County",1,32,772,399,373
050,31,079,"Nebraska","Hall County",1,33,813,411,402
050,31,079,"Nebraska","Hall County",1,34,832,423,409
050,31,079,"Nebraska","Hall County",1,35,893,472,421
050,31,079,"Nebraska","Hall County",1,36,854,428,426
050,31,079,"Nebraska","Hall County",1,37,856,443,413
050,31,079,"Nebraska","Hall County",1,38,817,422,395
050,31,079,"Nebraska","Hall County",1,39,815,407,408
050,31,079,"Nebraska","Hall County",1,40,774,399,375
050,31,079,"Nebraska","Hall County",1,41,762,403,359
050,31,079,"Nebraska","Hall County",1,42,756,393,363
050,31,079,"Nebraska","Hall County",1,43,730,374,356
050,31,079,"Nebraska","Hall County",1,44,702,352,350
050,31,079,"Nebraska","Hall County",1,45,739,379,360
050,31,079,"Nebraska","Hall County",1,46,682,356,326
050,31,079,"Nebraska","Hall County",1,47,707,371,336
050,31,079,"Nebraska","Hall County",1,48,731,376,355
050,31,079,"Nebraska","Hall County",1,49,759,408,351
050,31,079,"Nebraska","Hall County",1,50,754,410,344
050,31,079,"Nebraska","Hall County",1,51,701,357,344
050,31,079,"Nebraska","Hall County",1,52,688,343,345
050,31,079,"Nebraska","Hall County",1,53,711,372,339
050,31,079,"Nebraska","Hall County",1,54,730,400,330
050,31,079,"Nebraska","Hall County",1,55,737,371,366
050,31,079,"Nebraska","Hall County",1,56,817,407,410
050,31,079,"Nebraska","Hall County",1,57,844,441,403
050,31,079,"Nebraska","Hall County",1,58,843,431,412
050,31,079,"Nebraska","Hall County",1,59,782,401,381
050,31,079,"Nebraska","Hall County",1,60,757,387,370
050,31,079,"Nebraska","Hall County",1,61,737,382,355
050,31,079,"Nebraska","Hall County",1,62,748,372,376
050,31,079,"Nebraska","Hall County",1,63,732,364,368
050,31,079,"Nebraska","Hall County",1,64,746,363,383
050,31,079,"Nebraska","Hall County",1,65,675,329,346
050,31,079,"Nebraska","Hall County",1,66,596,289,307
050,31,079,"Nebraska","Hall County",1,67,589,273,316
050,31,079,"Nebraska","Hall County",1,68,583,271,312
050,31,079,"Nebraska","Hall County",1,69,545,259,286
050,31,079,"Nebraska","Hall County",1,70,525,247,278
050,31,079,"Nebraska","Hall County",1,71,517,240,277
050,31,079,"Nebraska","Hall County",1,72,504,251,253
050,31,079,"Nebraska","Hall County",1,73,494,245,249
050,31,079,"Nebraska","Hall County",1,74,372,179,193
050,31,079,"Nebraska","Hall County",1,75,370,177,193
050,31,079,"Nebraska","Hall County",1,76,385,178,207
050,31,079,"Nebraska","Hall County",1,77,360,172,188
050,31,079,"Nebraska","Hall County",1,78,294,144,150
050,31,079,"Nebraska","Hall County",1,79,268,124,144
050,31,079,"Nebraska","Hall County",1,80,251,104,147
050,31,079,"Nebraska","Hall County",1,81,250,97,153
050,31,079,"Nebraska","Hall County",1,82,213,91,122
050,31,079,"Nebraska","Hall County",1,83,216,100,116
050,31,079,"Nebraska","Hall County",1,84,180,86,94
050,31,079,"Nebraska","Hall County",1,85,1172,431,741
050,31,079,"Nebraska","Hall County",2,0,903,472,431
050,31,079,"Nebraska","Hall County",2,1,939,492,447
050,31,079,"Nebraska","Hall County",2,2,976,503,473
050,31,079,"Nebraska","Hall County",2,3,979,499,480
050,31,079,"Nebraska","Hall County",2,4,998,518,480
050,31,079,"Nebraska","Hall County",2,5,1016,529,487
050,31,079,"Nebraska","Hall County",2,6,997,524,473
050,31,079,"Nebraska","Hall County",2,7,913,475,438
050,31,079,"Nebraska","Hall County",2,8,880,447,433
050,31,079,"Nebraska","Hall County",2,9,924,480,444
050,31,079,"Nebraska","Hall County",2,10,979,513,466
050,31,079,"Nebraska","Hall County",2,11,991,512,479
050,31,079,"Nebraska","Hall County",2,12,1015,521,494
050,31,079,"Nebraska","Hall County",2,13,1015,522,493
050,31,079,"Nebraska","Hall County",2,14,1007,505,502
050,31,079,"Nebraska","Hall County",2,15,978,500,478
050,31,079,"Nebraska","Hall County",2,16,981,502,479
050,31,079,"Nebraska","Hall County",2,17,964,504,460
050,31,079,"Nebraska","Hall County",2,18,826,447,379
050,31,079,"Nebraska","Hall County",2,19,668,362,306
050,31,079,"Nebraska","Hall County",2,20,692,360,332
050,31,079,"Nebraska","Hall County",2,21,708,367,341
050,31,079,"Nebraska","Hall County",2,22,723,353,370
050,31,079,"Nebraska","Hall County",2,23,741,362,379
050,31,079,"Nebraska","Hall County",2,24,741,382,359
050,31,079,"Nebraska","Hall County",2,25,780,423,357
050,31,079,"Nebraska","Hall County",2,26,802,421,381
050,31,079,"Nebraska","Hall County",2,27,808,421,387
050,31,079,"Nebraska","Hall County",2,28,816,422,394
050,31,079,"Nebraska","Hall County",2,29,804,421,383
050,31,079,"Nebraska","Hall County",2,30,807,426,381
050,31,079,"Nebraska","Hall County",2,31,757,417,340
050,31,079,"Nebraska","Hall County",2,32,768,402,366
050,31,079,"Nebraska","Hall County",2,33,803,408,395
050,31,079,"Nebraska","Hall County",2,34,822,419,403
050,31,079,"Nebraska","Hall County",2,35,881,460,421
050,31,079,"Nebraska","Hall County",2,36,851,428,423
050,31,079,"Nebraska","Hall County",2,37,859,441,418
050,31,079,"Nebraska","Hall County",2,38,824,426,398
050,31,079,"Nebraska","Hall County",2,39,811,410,401
050,31,079,"Nebraska","Hall County",2,40,785,404,381
050,31,079,"Nebraska","Hall County",2,41,757,399,358
050,31,079,"Nebraska","Hall County",2,42,749,392,357
050,31,079,"Nebraska","Hall County",2,43,735,379,356
050,31,079,"Nebraska","Hall County",2,44,706,357,349
050,31,079,"Nebraska","Hall County",2,45,729,372,357
050,31,079,"Nebraska","Hall County",2,46,686,356,330
050,31,079,"Nebraska","Hall County",2,47,702,366,336
050,31,079,"Nebraska","Hall County",2,48,723,373,350
050,31,079,"Nebraska","Hall County",2,49,754,406,348
050,31,079,"Nebraska","Hall County",2,50,760,413,347
050,31,079,"Nebraska","Hall County",2,51,706,363,343
050,31,079,"Nebraska","Hall County",2,52,685,342,343
050,31,079,"Nebraska","Hall County",2,53,703,364,339
050,31,079,"Nebraska","Hall County",2,54,725,392,333
050,31,079,"Nebraska","Hall County",2,55,734,378,356
050,31,079,"Nebraska","Hall County",2,56,796,399,397
050,31,079,"Nebraska","Hall County",2,57,838,432,406
050,31,079,"Nebraska","Hall County",2,58,840,430,410
050,31,079,"Nebraska","Hall County",2,59,797,407,390
050,31,079,"Nebraska","Hall County",2,60,756,389,367
050,31,079,"Nebraska","Hall County",2,61,736,379,357
050,31,079,"Nebraska","Hall County",2,62,739,371,368
050,31,079,"Nebraska","Hall County",2,63,736,365,371
050,31,079,"Nebraska","Hall County",2,64,734,360,374
050,31,079,"Nebraska","Hall County",2,65,686,333,353
050,31,079,"Nebraska","Hall County",2,66,611,297,314
050,31,079,"Nebraska","Hall County",2,67,580,270,310
050,31,079,"Nebraska","Hall County",2,68,583,269,314
050,31,079,"Nebraska","Hall County",2,69,553,260,293
050,31,079,"Nebraska","Hall County",2,70,523,248,275
050,31,079,"Nebraska","Hall County",2,71,516,241,275
050,31,079,"Nebraska","Hall County",2,72,496,244,252
050,31,079,"Nebraska","Hall County",2,73,514,256,258
050,31,079,"Nebraska","Hall County",2,74,378,184,194
050,31,079,"Nebraska","Hall County",2,75,366,174,192
050,31,079,"Nebraska","Hall County",2,76,375,175,200
050,31,079,"Nebraska","Hall County",2,77,367,172,195
050,31,079,"Nebraska","Hall County",2,78,302,146,156
050,31,079,"Nebraska","Hall County",2,79,269,127,142
050,31,079,"Nebraska","Hall County",2,80,256,110,146
050,31,079,"Nebraska","Hall County",2,81,243,94,149
050,31,079,"Nebraska","Hall County",2,82,216,90,126
050,31,079,"Nebraska","Hall County",2,83,213,97,116
050,31,079,"Nebraska","Hall County",2,84,185,90,95
050,31,079,"Nebraska","Hall County",2,85,1174,437,737
050,31,079,"Nebraska","Hall County",3,0,883,482,401
050,31,079,"Nebraska","Hall County",3,1,869,461,408
050,31,079,"Nebraska","Hall County",3,2,917,476,441
050,31,079,"Nebraska","Hall County",3,3,975,508,467
050,31,079,"Nebraska","Hall County",3,4,952,490,462
050,31,079,"Nebraska","Hall County",3,5,995,518,477
050,31,079,"Nebraska","Hall County",3,6,983,525,458
050,31,079,"Nebraska","Hall County",3,7,984,513,471
050,31,079,"Nebraska","Hall County",3,8,874,454,420
050,31,079,"Nebraska","Hall County",3,9,887,457,430
050,31,079,"Nebraska","Hall County",3,10,899,481,418
050,31,079,"Nebraska","Hall County",3,11,945,493,452
050,31,079,"Nebraska","Hall County",3,12,996,523,473
050,31,079,"Nebraska","Hall County",3,13,1027,525,502
050,31,079,"Nebraska","Hall County",3,14,1008,517,491
050,31,079,"Nebraska","Hall County",3,15,987,503,484
050,31,079,"Nebraska","Hall County",3,16,971,499,472
050,31,079,"Nebraska","Hall County",3,17,955,500,455
050,31,079,"Nebraska","Hall County",3,18,840,446,394
050,31,079,"Nebraska","Hall County",3,19,702,390,312
050,31,079,"Nebraska","Hall County",3,20,684,365,319
050,31,079,"Nebraska","Hall County",3,21,712,361,351
050,31,079,"Nebraska","Hall County",3,22,730,375,355
050,31,079,"Nebraska","Hall County",3,23,722,348,374
050,31,079,"Nebraska","Hall County",3,24,718,353,365
050,31,079,"Nebraska","Hall County",3,25,743,390,353
050,31,079,"Nebraska","Hall County",3,26,734,391,343
050,31,079,"Nebraska","Hall County",3,27,813,427,386
050,31,079,"Nebraska","Hall County",3,28,758,393,365
050,31,079,"Nebraska","Hall County",3,29,804,422,382
050,31,079,"Nebraska","Hall County",3,30,806,417,389
050,31,079,"Nebraska","Hall County",3,31,780,411,369
050,31,079,"Nebraska","Hall County",3,32,766,418,348
050,31,079,"Nebraska","Hall County",3,33,762,397,365
050,31,079,"Nebraska","Hall County",3,34,807,422,385
050,31,079,"Nebraska","Hall County",3,35,819,418,401
050,31,079,"Nebraska","Hall County",3,36,852,453,399
050,31,079,"Nebraska","Hall County",3,37,837,420,417
050,31,079,"Nebraska","Hall County",3,38,860,437,423
050,31,079,"Nebraska","Hall County",3,39,792,407,385
050,31,079,"Nebraska","Hall County",3,40,813,409,404
050,31,079,"Nebraska","Hall County",3,41,771,400,371
050,31,079,"Nebraska","Hall County",3,42,750,394,356
050,31,079,"Nebraska","Hall County",3,43,764,389,375
050,31,079,"Nebraska","Hall County",3,44,717,368,349
050,31,079,"Nebraska","Hall County",3,45,693,353,340
050,31,079,"Nebraska","Hall County",3,46,715,363,352
050,31,079,"Nebraska","Hall County",3,47,694,359,335
050,31,079,"Nebraska","Hall County",3,48,682,356,326
050,31,079,"Nebraska","Hall County",3,49,710,379,331
050,31,079,"Nebraska","Hall County",3,50,733,397,336
050,31,079,"Nebraska","Hall County",3,51,725,386,339
050,31,079,"Nebraska","Hall County",3,52,693,355,338
050,31,079,"Nebraska","Hall County",3,53,674,337,337
050,31,079,"Nebraska","Hall County",3,54,718,369,349
050,31,079,"Nebraska","Hall County",3,55,704,375,329
050,31,079,"Nebraska","Hall County",3,56,728,376,352
050,31,079,"Nebraska","Hall County",3,57,790,393,397
050,31,079,"Nebraska","Hall County",3,58,828,428,400
050,31,079,"Nebraska","Hall County",3,59,827,425,402
050,31,079,"Nebraska","Hall County",3,60,772,399,373
050,31,079,"Nebraska","Hall County",3,61,746,380,366
050,31,079,"Nebraska","Hall County",3,62,718,368,350
050,31,079,"Nebraska","Hall County",3,63,704,350,354
050,31,079,"Nebraska","Hall County",3,64,722,356,366
050,31,079,"Nebraska","Hall County",3,65,723,354,369
050,31,079,"Nebraska","Hall County",3,66,669,320,349
050,31,079,"Nebraska","Hall County",3,67,577,276,301
050,31,079,"Nebraska","Hall County",3,68,569,263,306
050,31,079,"Nebraska","Hall County",3,69,554,254,300
050,31,079,"Nebraska","Hall County",3,70,539,255,284
050,31,079,"Nebraska","Hall County",3,71,496,231,265
050,31,079,"Nebraska","Hall County",3,72,491,224,267
050,31,079,"Nebraska","Hall County",3,73,472,228,244
050,31,079,"Nebraska","Hall County",3,74,503,249,254
050,31,079,"Nebraska","Hall County",3,75,352,174,178
050,31,079,"Nebraska","Hall County",3,76,352,173,179
050,31,079,"Nebraska","Hall County",3,77,354,159,195
050,31,079,"Nebraska","Hall County",3,78,350,164,186
050,31,079,"Nebraska","Hall County",3,79,286,141,145
050,31,079,"Nebraska","Hall County",3,80,262,122,140
050,31,079,"Nebraska","Hall County",3,81,243,94,149
050,31,079,"Nebraska","Hall County",3,82,216,87,129
050,31,079,"Nebraska","Hall County",3,83,206,83,123
050,31,079,"Nebraska","Hall County",3,84,191,87,104
050,31,079,"Nebraska","Hall County",3,85,1131,428,703
050,31,079,"Nebraska","Hall County",4,0,921,497,424
050,31,079,"Nebraska","Hall County",4,1,881,482,399
050,31,079,"Nebraska","Hall County",4,2,872,464,408
050,31,079,"Nebraska","Hall County",4,3,931,498,433
050,31,079,"Nebraska","Hall County",4,4,964,495,469
050,31,079,"Nebraska","Hall County",4,5,921,484,437
050,31,079,"Nebraska","Hall County",4,6,990,505,485
050,31,079,"Nebraska","Hall County",4,7,988,532,456
050,31,079,"Nebraska","Hall County",4,8,949,495,454
050,31,079,"Nebraska","Hall County",4,9,886,463,423
050,31,079,"Nebraska","Hall County",4,10,864,437,427
050,31,079,"Nebraska","Hall County",4,11,901,471,430
050,31,079,"Nebraska","Hall County",4,12,965,498,467
050,31,079,"Nebraska","Hall County",4,13,984,513,471
050,31,079,"Nebraska","Hall County",4,14,1033,533,500
050,31,079,"Nebraska","Hall County",4,15,998,511,487
050,31,079,"Nebraska","Hall County",4,16,1009,519,490
050,31,079,"Nebraska","Hall County",4,17,958,494,464
050,31,079,"Nebraska","Hall County",4,18,833,445,388
050,31,079,"Nebraska","Hall County",4,19,726,386,340
050,31,079,"Nebraska","Hall County",4,20,733,388,345
050,31,079,"Nebraska","Hall County",4,21,708,361,347
050,31,079,"Nebraska","Hall County",4,22,736,368,368
050,31,079,"Nebraska","Hall County",4,23,738,389,349
050,31,079,"Nebraska","Hall County",4,24,734,356,378
050,31,079,"Nebraska","Hall County",4,25,745,366,379
050,31,079,"Nebraska","Hall County",4,26,741,394,347
050,31,079,"Nebraska","Hall County",4,27,738,390,348
050,31,079,"Nebraska","Hall County",4,28,792,429,363
050,31,079,"Nebraska","Hall County",4,29,756,378,378
050,31,079,"Nebraska","Hall County",4,30,822,424,398
050,31,079,"Nebraska","Hall County",4,31,793,401,392
050,31,079,"Nebraska","Hall County",4,32,817,437,380
050,31,079,"Nebraska","Hall County",4,33,777,423,354
050,31,079,"Nebraska","Hall County",4,34,771,410,361
050,31,079,"Nebraska","Hall County",4,35,804,408,396
050,31,079,"Nebraska","Hall County",4,36,780,404,376
050,31,079,"Nebraska","Hall County",4,37,860,454,406
050,31,079,"Nebraska","Hall County",4,38,830,420,410
050,31,079,"Nebraska","Hall County",4,39,846,425,421
050,31,079,"Nebraska","Hall County",4,40,788,414,374
050,31,079,"Nebraska","Hall County",4,41,807,408,399
050,31,079,"Nebraska","Hall County",4,42,775,388,387
050,31,079,"Nebraska","Hall County",4,43,748,389,359
050,31,079,"Nebraska","Hall County",4,44,763,389,374
050,31,079,"Nebraska","Hall County",4,45,706,359,347
050,31,079,"Nebraska","Hall County",4,46,680,346,334
050,31,079,"Nebraska","Hall County",4,47,715,362,353
050,31,079,"Nebraska","Hall County",4,48,680,356,324
050,31,079,"Nebraska","Hall County",4,49,684,362,322
050,31,079,"Nebraska","Hall County",4,50,724,388,336
050,31,079,"Nebraska","Hall County",4,51,705,377,328
050,31,079,"Nebraska","Hall County",4,52,717,381,336
050,31,079,"Nebraska","Hall County",4,53,699,356,343
050,31,079,"Nebraska","Hall County",4,54,676,342,334
050,31,079,"Nebraska","Hall County",4,55,712,369,343
050,31,079,"Nebraska","Hall County",4,56,684,366,318
050,31,079,"Nebraska","Hall County",4,57,715,368,347
050,31,079,"Nebraska","Hall County",4,58,772,383,389
050,31,079,"Nebraska","Hall County",4,59,812,421,391
050,31,079,"Nebraska","Hall County",4,60,828,436,392
050,31,079,"Nebraska","Hall County",4,61,755,380,375
050,31,079,"Nebraska","Hall County",4,62,717,369,348
050,31,079,"Nebraska","Hall County",4,63,695,359,336
050,31,079,"Nebraska","Hall County",4,64,680,332,348
050,31,079,"Nebraska","Hall County",4,65,713,350,363
050,31,079,"Nebraska","Hall County",4,66,700,341,359
050,31,079,"Nebraska","Hall County",4,67,645,311,334
050,31,079,"Nebraska","Hall County",4,68,582,276,306
050,31,079,"Nebraska","Hall County",4,69,536,245,291
050,31,079,"Nebraska","Hall County",4,70,544,251,293
050,31,079,"Nebraska","Hall County",4,71,516,245,271
050,31,079,"Nebraska","Hall County",4,72,478,219,259
050,31,079,"Nebraska","Hall County",4,73,471,209,262
050,31,079,"Nebraska","Hall County",4,74,474,229,245
050,31,079,"Nebraska","Hall County",4,75,489,242,247
050,31,079,"Nebraska","Hall County",4,76,333,169,164
050,31,079,"Nebraska","Hall County",4,77,328,162,166
050,31,079,"Nebraska","Hall County",4,78,343,154,189
050,31,079,"Nebraska","Hall County",4,79,340,156,184
050,31,079,"Nebraska","Hall County",4,80,269,132,137
050,31,079,"Nebraska","Hall County",4,81,247,108,139
050,31,079,"Nebraska","Hall County",4,82,216,90,126
050,31,079,"Nebraska","Hall County",4,83,210,85,125
050,31,079,"Nebraska","Hall County",4,84,182,78,104
050,31,079,"Nebraska","Hall County",4,85,1148,439,709
050,31,079,"Nebraska","Hall County",5,0,924,498,426
050,31,079,"Nebraska","Hall County",5,1,905,485,420
050,31,079,"Nebraska","Hall County",5,2,893,500,393
050,31,079,"Nebraska","Hall County",5,3,896,498,398
050,31,079,"Nebraska","Hall County",5,4,921,497,424
050,31,079,"Nebraska","Hall County",5,5,977,497,480
050,31,079,"Nebraska","Hall County",5,6,947,495,452
050,31,079,"Nebraska","Hall County",5,7,990,512,478
050,31,079,"Nebraska","Hall County",5,8,970,522,448
050,31,079,"Nebraska","Hall County",5,9,947,496,451
050,31,079,"Nebraska","Hall County",5,10,854,454,400
050,31,079,"Nebraska","Hall County",5,11,872,446,426
050,31,079,"Nebraska","Hall County",5,12,896,463,433
050,31,079,"Nebraska","Hall County",5,13,962,499,463
050,31,079,"Nebraska","Hall County",5,14,987,518,469
050,31,079,"Nebraska","Hall County",5,15,1037,533,504
050,31,079,"Nebraska","Hall County",5,16,1001,506,495
050,31,079,"Nebraska","Hall County",5,17,1013,516,497
050,31,079,"Nebraska","Hall County",5,18,830,435,395
050,31,079,"Nebraska","Hall County",5,19,742,417,325
050,31,079,"Nebraska","Hall County",5,20,767,408,359
050,31,079,"Nebraska","Hall County",5,21,788,400,388
050,31,079,"Nebraska","Hall County",5,22,733,368,365
050,31,079,"Nebraska","Hall County",5,23,759,387,372
050,31,079,"Nebraska","Hall County",5,24,733,389,344
050,31,079,"Nebraska","Hall County",5,25,745,364,381
050,31,079,"Nebraska","Hall County",5,26,725,366,359
050,31,079,"Nebraska","Hall County",5,27,736,391,345
050,31,079,"Nebraska","Hall County",5,28,731,389,342
050,31,079,"Nebraska","Hall County",5,29,773,414,359
050,31,079,"Nebraska","Hall County",5,30,793,394,399
050,31,079,"Nebraska","Hall County",5,31,784,408,376
050,31,079,"Nebraska","Hall County",5,32,809,423,386
050,31,079,"Nebraska","Hall County",5,33,829,447,382
050,31,079,"Nebraska","Hall County",5,34,780,436,344
050,31,079,"Nebraska","Hall County",5,35,762,403,359
050,31,079,"Nebraska","Hall County",5,36,774,397,377
050,31,079,"Nebraska","Hall County",5,37,807,415,392
050,31,079,"Nebraska","Hall County",5,38,855,449,406
050,31,079,"Nebraska","Hall County",5,39,813,407,406
050,31,079,"Nebraska","Hall County",5,40,851,430,421
050,31,079,"Nebraska","Hall County",5,41,765,409,356
050,31,079,"Nebraska","Hall County",5,42,816,395,421
050,31,079,"Nebraska","Hall County",5,43,773,393,380
050,31,079,"Nebraska","Hall County",5,44,768,403,365
050,31,079,"Nebraska","Hall County",5,45,742,382,360
050,31,079,"Nebraska","Hall County",5,46,707,350,357
050,31,079,"Nebraska","Hall County",5,47,677,350,327
050,31,079,"Nebraska","Hall County",5,48,707,358,349
050,31,079,"Nebraska","Hall County",5,49,691,377,314
050,31,079,"Nebraska","Hall County",5,50,684,370,314
050,31,079,"Nebraska","Hall County",5,51,702,358,344
050,31,079,"Nebraska","Hall County",5,52,694,368,326
050,31,079,"Nebraska","Hall County",5,53,704,374,330
050,31,079,"Nebraska","Hall County",5,54,690,361,329
050,31,079,"Nebraska","Hall County",5,55,666,334,332
050,31,079,"Nebraska","Hall County",5,56,688,351,337
050,31,079,"Nebraska","Hall County",5,57,688,373,315
050,31,079,"Nebraska","Hall County",5,58,701,367,334
050,31,079,"Nebraska","Hall County",5,59,774,386,388
050,31,079,"Nebraska","Hall County",5,60,790,411,379
050,31,079,"Nebraska","Hall County",5,61,816,426,390
050,31,079,"Nebraska","Hall County",5,62,734,369,365
050,31,079,"Nebraska","Hall County",5,63,698,360,338
050,31,079,"Nebraska","Hall County",5,64,676,345,331
050,31,079,"Nebraska","Hall County",5,65,665,324,341
050,31,079,"Nebraska","Hall County",5,66,697,335,362
050,31,079,"Nebraska","Hall County",5,67,670,324,346
050,31,079,"Nebraska","Hall County",5,68,632,296,336
050,31,079,"Nebraska","Hall County",5,69,556,261,295
050,31,079,"Nebraska","Hall County",5,70,533,249,284
050,31,079,"Nebraska","Hall County",5,71,535,247,288
050,31,079,"Nebraska","Hall County",5,72,492,228,264
050,31,079,"Nebraska","Hall County",5,73,459,208,251
050,31,079,"Nebraska","Hall County",5,74,474,213,261
050,31,079,"Nebraska","Hall County",5,75,449,217,232
050,31,079,"Nebraska","Hall County",5,76,466,236,230
050,31,079,"Nebraska","Hall County",5,77,310,159,151
050,31,079,"Nebraska","Hall County",5,78,319,157,162
050,31,079,"Nebraska","Hall County",5,79,329,151,178
050,31,079,"Nebraska","Hall County",5,80,321,148,173
050,31,079,"Nebraska","Hall County",5,81,255,117,138
050,31,079,"Nebraska","Hall County",5,82,221,104,117
050,31,079,"Nebraska","Hall County",5,83,208,87,121
050,31,079,"Nebraska","Hall County",5,84,189,80,109
050,31,079,"Nebraska","Hall County",5,85,1155,439,716
050,31,081,"Nebraska","Hamilton County",1,0,106,54,52
050,31,081,"Nebraska","Hamilton County",1,1,110,65,45
050,31,081,"Nebraska","Hamilton County",1,2,135,76,59
050,31,081,"Nebraska","Hamilton County",1,3,138,84,54
050,31,081,"Nebraska","Hamilton County",1,4,121,61,60
050,31,081,"Nebraska","Hamilton County",1,5,113,56,57
050,31,081,"Nebraska","Hamilton County",1,6,115,55,60
050,31,081,"Nebraska","Hamilton County",1,7,131,77,54
050,31,081,"Nebraska","Hamilton County",1,8,124,65,59
050,31,081,"Nebraska","Hamilton County",1,9,124,68,56
050,31,081,"Nebraska","Hamilton County",1,10,126,75,51
050,31,081,"Nebraska","Hamilton County",1,11,127,70,57
050,31,081,"Nebraska","Hamilton County",1,12,136,72,64
050,31,081,"Nebraska","Hamilton County",1,13,129,68,61
050,31,081,"Nebraska","Hamilton County",1,14,136,83,53
050,31,081,"Nebraska","Hamilton County",1,15,132,76,56
050,31,081,"Nebraska","Hamilton County",1,16,144,79,65
050,31,081,"Nebraska","Hamilton County",1,17,148,73,75
050,31,081,"Nebraska","Hamilton County",1,18,120,63,57
050,31,081,"Nebraska","Hamilton County",1,19,88,47,41
050,31,081,"Nebraska","Hamilton County",1,20,98,48,50
050,31,081,"Nebraska","Hamilton County",1,21,101,51,50
050,31,081,"Nebraska","Hamilton County",1,22,102,54,48
050,31,081,"Nebraska","Hamilton County",1,23,93,49,44
050,31,081,"Nebraska","Hamilton County",1,24,89,40,49
050,31,081,"Nebraska","Hamilton County",1,25,100,47,53
050,31,081,"Nebraska","Hamilton County",1,26,90,48,42
050,31,081,"Nebraska","Hamilton County",1,27,107,50,57
050,31,081,"Nebraska","Hamilton County",1,28,105,49,56
050,31,081,"Nebraska","Hamilton County",1,29,105,53,52
050,31,081,"Nebraska","Hamilton County",1,30,99,55,44
050,31,081,"Nebraska","Hamilton County",1,31,102,53,49
050,31,081,"Nebraska","Hamilton County",1,32,91,43,48
050,31,081,"Nebraska","Hamilton County",1,33,97,53,44
050,31,081,"Nebraska","Hamilton County",1,34,112,64,48
050,31,081,"Nebraska","Hamilton County",1,35,114,62,52
050,31,081,"Nebraska","Hamilton County",1,36,113,54,59
050,31,081,"Nebraska","Hamilton County",1,37,112,52,60
050,31,081,"Nebraska","Hamilton County",1,38,122,62,60
050,31,081,"Nebraska","Hamilton County",1,39,122,63,59
050,31,081,"Nebraska","Hamilton County",1,40,108,52,56
050,31,081,"Nebraska","Hamilton County",1,41,103,54,49
050,31,081,"Nebraska","Hamilton County",1,42,95,55,40
050,31,081,"Nebraska","Hamilton County",1,43,104,48,56
050,31,081,"Nebraska","Hamilton County",1,44,109,55,54
050,31,081,"Nebraska","Hamilton County",1,45,98,51,47
050,31,081,"Nebraska","Hamilton County",1,46,99,50,49
050,31,081,"Nebraska","Hamilton County",1,47,104,54,50
050,31,081,"Nebraska","Hamilton County",1,48,108,51,57
050,31,081,"Nebraska","Hamilton County",1,49,116,56,60
050,31,081,"Nebraska","Hamilton County",1,50,127,65,62
050,31,081,"Nebraska","Hamilton County",1,51,120,59,61
050,31,081,"Nebraska","Hamilton County",1,52,100,49,51
050,31,081,"Nebraska","Hamilton County",1,53,117,54,63
050,31,081,"Nebraska","Hamilton County",1,54,118,59,59
050,31,081,"Nebraska","Hamilton County",1,55,125,66,59
050,31,081,"Nebraska","Hamilton County",1,56,131,73,58
050,31,081,"Nebraska","Hamilton County",1,57,125,65,60
050,31,081,"Nebraska","Hamilton County",1,58,141,68,73
050,31,081,"Nebraska","Hamilton County",1,59,144,75,69
050,31,081,"Nebraska","Hamilton County",1,60,132,71,61
050,31,081,"Nebraska","Hamilton County",1,61,136,64,72
050,31,081,"Nebraska","Hamilton County",1,62,135,64,71
050,31,081,"Nebraska","Hamilton County",1,63,134,65,69
050,31,081,"Nebraska","Hamilton County",1,64,133,64,69
050,31,081,"Nebraska","Hamilton County",1,65,132,61,71
050,31,081,"Nebraska","Hamilton County",1,66,122,55,67
050,31,081,"Nebraska","Hamilton County",1,67,124,70,54
050,31,081,"Nebraska","Hamilton County",1,68,113,62,51
050,31,081,"Nebraska","Hamilton County",1,69,88,45,43
050,31,081,"Nebraska","Hamilton County",1,70,98,45,53
050,31,081,"Nebraska","Hamilton County",1,71,102,51,51
050,31,081,"Nebraska","Hamilton County",1,72,95,49,46
050,31,081,"Nebraska","Hamilton County",1,73,105,54,51
050,31,081,"Nebraska","Hamilton County",1,74,71,35,36
050,31,081,"Nebraska","Hamilton County",1,75,69,29,40
050,31,081,"Nebraska","Hamilton County",1,76,82,40,42
050,31,081,"Nebraska","Hamilton County",1,77,70,33,37
050,31,081,"Nebraska","Hamilton County",1,78,54,27,27
050,31,081,"Nebraska","Hamilton County",1,79,53,27,26
050,31,081,"Nebraska","Hamilton County",1,80,55,24,31
050,31,081,"Nebraska","Hamilton County",1,81,47,28,19
050,31,081,"Nebraska","Hamilton County",1,82,48,23,25
050,31,081,"Nebraska","Hamilton County",1,83,38,16,22
050,31,081,"Nebraska","Hamilton County",1,84,47,20,27
050,31,081,"Nebraska","Hamilton County",1,85,272,95,177
050,31,081,"Nebraska","Hamilton County",2,0,106,56,50
050,31,081,"Nebraska","Hamilton County",2,1,107,61,46
050,31,081,"Nebraska","Hamilton County",2,2,129,73,56
050,31,081,"Nebraska","Hamilton County",2,3,136,82,54
050,31,081,"Nebraska","Hamilton County",2,4,125,66,59
050,31,081,"Nebraska","Hamilton County",2,5,115,57,58
050,31,081,"Nebraska","Hamilton County",2,6,116,56,60
050,31,081,"Nebraska","Hamilton County",2,7,127,71,56
050,31,081,"Nebraska","Hamilton County",2,8,125,67,58
050,31,081,"Nebraska","Hamilton County",2,9,122,67,55
050,31,081,"Nebraska","Hamilton County",2,10,127,74,53
050,31,081,"Nebraska","Hamilton County",2,11,125,71,54
050,31,081,"Nebraska","Hamilton County",2,12,135,72,63
050,31,081,"Nebraska","Hamilton County",2,13,131,70,61
050,31,081,"Nebraska","Hamilton County",2,14,135,79,56
050,31,081,"Nebraska","Hamilton County",2,15,134,78,56
050,31,081,"Nebraska","Hamilton County",2,16,142,79,63
050,31,081,"Nebraska","Hamilton County",2,17,146,75,71
050,31,081,"Nebraska","Hamilton County",2,18,120,63,57
050,31,081,"Nebraska","Hamilton County",2,19,89,47,42
050,31,081,"Nebraska","Hamilton County",2,20,98,48,50
050,31,081,"Nebraska","Hamilton County",2,21,99,49,50
050,31,081,"Nebraska","Hamilton County",2,22,100,52,48
050,31,081,"Nebraska","Hamilton County",2,23,95,50,45
050,31,081,"Nebraska","Hamilton County",2,24,89,42,47
050,31,081,"Nebraska","Hamilton County",2,25,93,43,50
050,31,081,"Nebraska","Hamilton County",2,26,93,48,45
050,31,081,"Nebraska","Hamilton County",2,27,102,48,54
050,31,081,"Nebraska","Hamilton County",2,28,107,50,57
050,31,081,"Nebraska","Hamilton County",2,29,106,53,53
050,31,081,"Nebraska","Hamilton County",2,30,101,54,47
050,31,081,"Nebraska","Hamilton County",2,31,100,53,47
050,31,081,"Nebraska","Hamilton County",2,32,93,45,48
050,31,081,"Nebraska","Hamilton County",2,33,97,52,45
050,31,081,"Nebraska","Hamilton County",2,34,108,61,47
050,31,081,"Nebraska","Hamilton County",2,35,116,64,52
050,31,081,"Nebraska","Hamilton County",2,36,113,56,57
050,31,081,"Nebraska","Hamilton County",2,37,113,53,60
050,31,081,"Nebraska","Hamilton County",2,38,121,61,60
050,31,081,"Nebraska","Hamilton County",2,39,122,63,59
050,31,081,"Nebraska","Hamilton County",2,40,113,55,58
050,31,081,"Nebraska","Hamilton County",2,41,106,55,51
050,31,081,"Nebraska","Hamilton County",2,42,96,54,42
050,31,081,"Nebraska","Hamilton County",2,43,103,50,53
050,31,081,"Nebraska","Hamilton County",2,44,108,54,54
050,31,081,"Nebraska","Hamilton County",2,45,101,53,48
050,31,081,"Nebraska","Hamilton County",2,46,100,51,49
050,31,081,"Nebraska","Hamilton County",2,47,102,52,50
050,31,081,"Nebraska","Hamilton County",2,48,105,51,54
050,31,081,"Nebraska","Hamilton County",2,49,113,54,59
050,31,081,"Nebraska","Hamilton County",2,50,124,63,61
050,31,081,"Nebraska","Hamilton County",2,51,121,60,61
050,31,081,"Nebraska","Hamilton County",2,52,102,50,52
050,31,081,"Nebraska","Hamilton County",2,53,114,53,61
050,31,081,"Nebraska","Hamilton County",2,54,117,57,60
050,31,081,"Nebraska","Hamilton County",2,55,124,64,60
050,31,081,"Nebraska","Hamilton County",2,56,130,71,59
050,31,081,"Nebraska","Hamilton County",2,57,126,67,59
050,31,081,"Nebraska","Hamilton County",2,58,139,68,71
050,31,081,"Nebraska","Hamilton County",2,59,145,75,70
050,31,081,"Nebraska","Hamilton County",2,60,134,71,63
050,31,081,"Nebraska","Hamilton County",2,61,135,66,69
050,31,081,"Nebraska","Hamilton County",2,62,135,64,71
050,31,081,"Nebraska","Hamilton County",2,63,132,64,68
050,31,081,"Nebraska","Hamilton County",2,64,131,63,68
050,31,081,"Nebraska","Hamilton County",2,65,131,61,70
050,31,081,"Nebraska","Hamilton County",2,66,123,55,68
050,31,081,"Nebraska","Hamilton County",2,67,124,67,57
050,31,081,"Nebraska","Hamilton County",2,68,115,64,51
050,31,081,"Nebraska","Hamilton County",2,69,93,48,45
050,31,081,"Nebraska","Hamilton County",2,70,93,43,50
050,31,081,"Nebraska","Hamilton County",2,71,101,49,52
050,31,081,"Nebraska","Hamilton County",2,72,95,49,46
050,31,081,"Nebraska","Hamilton County",2,73,108,56,52
050,31,081,"Nebraska","Hamilton County",2,74,74,37,37
050,31,081,"Nebraska","Hamilton County",2,75,69,31,38
050,31,081,"Nebraska","Hamilton County",2,76,78,38,40
050,31,081,"Nebraska","Hamilton County",2,77,73,35,38
050,31,081,"Nebraska","Hamilton County",2,78,56,28,28
050,31,081,"Nebraska","Hamilton County",2,79,51,27,24
050,31,081,"Nebraska","Hamilton County",2,80,53,24,29
050,31,081,"Nebraska","Hamilton County",2,81,49,27,22
050,31,081,"Nebraska","Hamilton County",2,82,49,25,24
050,31,081,"Nebraska","Hamilton County",2,83,38,17,21
050,31,081,"Nebraska","Hamilton County",2,84,44,18,26
050,31,081,"Nebraska","Hamilton County",2,85,269,95,174
050,31,081,"Nebraska","Hamilton County",3,0,99,50,49
050,31,081,"Nebraska","Hamilton County",3,1,122,54,68
050,31,081,"Nebraska","Hamilton County",3,2,103,59,44
050,31,081,"Nebraska","Hamilton County",3,3,132,81,51
050,31,081,"Nebraska","Hamilton County",3,4,140,82,58
050,31,081,"Nebraska","Hamilton County",3,5,126,66,60
050,31,081,"Nebraska","Hamilton County",3,6,126,55,71
050,31,081,"Nebraska","Hamilton County",3,7,115,58,57
050,31,081,"Nebraska","Hamilton County",3,8,133,70,63
050,31,081,"Nebraska","Hamilton County",3,9,136,76,60
050,31,081,"Nebraska","Hamilton County",3,10,129,67,62
050,31,081,"Nebraska","Hamilton County",3,11,133,76,57
050,31,081,"Nebraska","Hamilton County",3,12,131,74,57
050,31,081,"Nebraska","Hamilton County",3,13,125,67,58
050,31,081,"Nebraska","Hamilton County",3,14,129,68,61
050,31,081,"Nebraska","Hamilton County",3,15,127,77,50
050,31,081,"Nebraska","Hamilton County",3,16,123,73,50
050,31,081,"Nebraska","Hamilton County",3,17,140,78,62
050,31,081,"Nebraska","Hamilton County",3,18,120,64,56
050,31,081,"Nebraska","Hamilton County",3,19,91,43,48
050,31,081,"Nebraska","Hamilton County",3,20,94,47,47
050,31,081,"Nebraska","Hamilton County",3,21,95,46,49
050,31,081,"Nebraska","Hamilton County",3,22,96,50,46
050,31,081,"Nebraska","Hamilton County",3,23,104,55,49
050,31,081,"Nebraska","Hamilton County",3,24,93,45,48
050,31,081,"Nebraska","Hamilton County",3,25,96,47,49
050,31,081,"Nebraska","Hamilton County",3,26,91,44,47
050,31,081,"Nebraska","Hamilton County",3,27,101,52,49
050,31,081,"Nebraska","Hamilton County",3,28,113,52,61
050,31,081,"Nebraska","Hamilton County",3,29,111,52,59
050,31,081,"Nebraska","Hamilton County",3,30,108,50,58
050,31,081,"Nebraska","Hamilton County",3,31,105,53,52
050,31,081,"Nebraska","Hamilton County",3,32,100,55,45
050,31,081,"Nebraska","Hamilton County",3,33,95,47,48
050,31,081,"Nebraska","Hamilton County",3,34,100,54,46
050,31,081,"Nebraska","Hamilton County",3,35,111,62,49
050,31,081,"Nebraska","Hamilton County",3,36,111,64,47
050,31,081,"Nebraska","Hamilton County",3,37,113,56,57
050,31,081,"Nebraska","Hamilton County",3,38,119,58,61
050,31,081,"Nebraska","Hamilton County",3,39,118,60,58
050,31,081,"Nebraska","Hamilton County",3,40,122,64,58
050,31,081,"Nebraska","Hamilton County",3,41,118,59,59
050,31,081,"Nebraska","Hamilton County",3,42,109,55,54
050,31,081,"Nebraska","Hamilton County",3,43,97,59,38
050,31,081,"Nebraska","Hamilton County",3,44,106,51,55
050,31,081,"Nebraska","Hamilton County",3,45,105,52,53
050,31,081,"Nebraska","Hamilton County",3,46,100,53,47
050,31,081,"Nebraska","Hamilton County",3,47,90,46,44
050,31,081,"Nebraska","Hamilton County",3,48,97,49,48
050,31,081,"Nebraska","Hamilton County",3,49,106,51,55
050,31,081,"Nebraska","Hamilton County",3,50,114,54,60
050,31,081,"Nebraska","Hamilton County",3,51,121,59,62
050,31,081,"Nebraska","Hamilton County",3,52,128,64,64
050,31,081,"Nebraska","Hamilton County",3,53,98,47,51
050,31,081,"Nebraska","Hamilton County",3,54,115,55,60
050,31,081,"Nebraska","Hamilton County",3,55,111,56,55
050,31,081,"Nebraska","Hamilton County",3,56,119,64,55
050,31,081,"Nebraska","Hamilton County",3,57,132,70,62
050,31,081,"Nebraska","Hamilton County",3,58,128,64,64
050,31,081,"Nebraska","Hamilton County",3,59,131,65,66
050,31,081,"Nebraska","Hamilton County",3,60,139,70,69
050,31,081,"Nebraska","Hamilton County",3,61,136,71,65
050,31,081,"Nebraska","Hamilton County",3,62,130,63,67
050,31,081,"Nebraska","Hamilton County",3,63,134,63,71
050,31,081,"Nebraska","Hamilton County",3,64,128,64,64
050,31,081,"Nebraska","Hamilton County",3,65,124,56,68
050,31,081,"Nebraska","Hamilton County",3,66,133,60,73
050,31,081,"Nebraska","Hamilton County",3,67,119,52,67
050,31,081,"Nebraska","Hamilton County",3,68,123,66,57
050,31,081,"Nebraska","Hamilton County",3,69,110,60,50
050,31,081,"Nebraska","Hamilton County",3,70,94,48,46
050,31,081,"Nebraska","Hamilton County",3,71,86,38,48
050,31,081,"Nebraska","Hamilton County",3,72,101,49,52
050,31,081,"Nebraska","Hamilton County",3,73,95,49,46
050,31,081,"Nebraska","Hamilton County",3,74,107,56,51
050,31,081,"Nebraska","Hamilton County",3,75,71,38,33
050,31,081,"Nebraska","Hamilton County",3,76,70,32,38
050,31,081,"Nebraska","Hamilton County",3,77,71,32,39
050,31,081,"Nebraska","Hamilton County",3,78,70,35,35
050,31,081,"Nebraska","Hamilton County",3,79,56,29,27
050,31,081,"Nebraska","Hamilton County",3,80,45,22,23
050,31,081,"Nebraska","Hamilton County",3,81,47,21,26
050,31,081,"Nebraska","Hamilton County",3,82,46,25,21
050,31,081,"Nebraska","Hamilton County",3,83,43,22,21
050,31,081,"Nebraska","Hamilton County",3,84,37,15,22
050,31,081,"Nebraska","Hamilton County",3,85,268,99,169
050,31,081,"Nebraska","Hamilton County",4,0,108,60,48
050,31,081,"Nebraska","Hamilton County",4,1,104,56,48
050,31,081,"Nebraska","Hamilton County",4,2,119,54,65
050,31,081,"Nebraska","Hamilton County",4,3,105,62,43
050,31,081,"Nebraska","Hamilton County",4,4,130,77,53
050,31,081,"Nebraska","Hamilton County",4,5,139,79,60
050,31,081,"Nebraska","Hamilton County",4,6,129,66,63
050,31,081,"Nebraska","Hamilton County",4,7,129,61,68
050,31,081,"Nebraska","Hamilton County",4,8,117,57,60
050,31,081,"Nebraska","Hamilton County",4,9,132,73,59
050,31,081,"Nebraska","Hamilton County",4,10,152,87,65
050,31,081,"Nebraska","Hamilton County",4,11,137,75,62
050,31,081,"Nebraska","Hamilton County",4,12,130,73,57
050,31,081,"Nebraska","Hamilton County",4,13,136,71,65
050,31,081,"Nebraska","Hamilton County",4,14,132,69,63
050,31,081,"Nebraska","Hamilton County",4,15,136,73,63
050,31,081,"Nebraska","Hamilton County",4,16,124,71,53
050,31,081,"Nebraska","Hamilton County",4,17,136,80,56
050,31,081,"Nebraska","Hamilton County",4,18,123,66,57
050,31,081,"Nebraska","Hamilton County",4,19,87,48,39
050,31,081,"Nebraska","Hamilton County",4,20,103,51,52
050,31,081,"Nebraska","Hamilton County",4,21,88,49,39
050,31,081,"Nebraska","Hamilton County",4,22,100,45,55
050,31,081,"Nebraska","Hamilton County",4,23,89,52,37
050,31,081,"Nebraska","Hamilton County",4,24,89,47,42
050,31,081,"Nebraska","Hamilton County",4,25,96,44,52
050,31,081,"Nebraska","Hamilton County",4,26,97,45,52
050,31,081,"Nebraska","Hamilton County",4,27,94,47,47
050,31,081,"Nebraska","Hamilton County",4,28,107,52,55
050,31,081,"Nebraska","Hamilton County",4,29,109,55,54
050,31,081,"Nebraska","Hamilton County",4,30,116,59,57
050,31,081,"Nebraska","Hamilton County",4,31,116,53,63
050,31,081,"Nebraska","Hamilton County",4,32,110,60,50
050,31,081,"Nebraska","Hamilton County",4,33,109,61,48
050,31,081,"Nebraska","Hamilton County",4,34,105,55,50
050,31,081,"Nebraska","Hamilton County",4,35,104,55,49
050,31,081,"Nebraska","Hamilton County",4,36,114,62,52
050,31,081,"Nebraska","Hamilton County",4,37,114,66,48
050,31,081,"Nebraska","Hamilton County",4,38,115,59,56
050,31,081,"Nebraska","Hamilton County",4,39,120,59,61
050,31,081,"Nebraska","Hamilton County",4,40,127,64,63
050,31,081,"Nebraska","Hamilton County",4,41,122,62,60
050,31,081,"Nebraska","Hamilton County",4,42,117,55,62
050,31,081,"Nebraska","Hamilton County",4,43,113,61,52
050,31,081,"Nebraska","Hamilton County",4,44,102,64,38
050,31,081,"Nebraska","Hamilton County",4,45,101,46,55
050,31,081,"Nebraska","Hamilton County",4,46,110,56,54
050,31,081,"Nebraska","Hamilton County",4,47,105,58,47
050,31,081,"Nebraska","Hamilton County",4,48,89,46,43
050,31,081,"Nebraska","Hamilton County",4,49,96,44,52
050,31,081,"Nebraska","Hamilton County",4,50,103,53,50
050,31,081,"Nebraska","Hamilton County",4,51,108,47,61
050,31,081,"Nebraska","Hamilton County",4,52,120,58,62
050,31,081,"Nebraska","Hamilton County",4,53,119,57,62
050,31,081,"Nebraska","Hamilton County",4,54,99,48,51
050,31,081,"Nebraska","Hamilton County",4,55,103,46,57
050,31,081,"Nebraska","Hamilton County",4,56,107,56,51
050,31,081,"Nebraska","Hamilton County",4,57,115,61,54
050,31,081,"Nebraska","Hamilton County",4,58,131,69,62
050,31,081,"Nebraska","Hamilton County",4,59,127,66,61
050,31,081,"Nebraska","Hamilton County",4,60,130,64,66
050,31,081,"Nebraska","Hamilton County",4,61,142,69,73
050,31,081,"Nebraska","Hamilton County",4,62,138,69,69
050,31,081,"Nebraska","Hamilton County",4,63,129,64,65
050,31,081,"Nebraska","Hamilton County",4,64,139,66,73
050,31,081,"Nebraska","Hamilton County",4,65,126,63,63
050,31,081,"Nebraska","Hamilton County",4,66,123,54,69
050,31,081,"Nebraska","Hamilton County",4,67,130,59,71
050,31,081,"Nebraska","Hamilton County",4,68,117,50,67
050,31,081,"Nebraska","Hamilton County",4,69,126,68,58
050,31,081,"Nebraska","Hamilton County",4,70,112,61,51
050,31,081,"Nebraska","Hamilton County",4,71,89,45,44
050,31,081,"Nebraska","Hamilton County",4,72,83,36,47
050,31,081,"Nebraska","Hamilton County",4,73,98,47,51
050,31,081,"Nebraska","Hamilton County",4,74,93,46,47
050,31,081,"Nebraska","Hamilton County",4,75,101,54,47
050,31,081,"Nebraska","Hamilton County",4,76,73,38,35
050,31,081,"Nebraska","Hamilton County",4,77,63,27,36
050,31,081,"Nebraska","Hamilton County",4,78,70,32,38
050,31,081,"Nebraska","Hamilton County",4,79,66,36,30
050,31,081,"Nebraska","Hamilton County",4,80,50,24,26
050,31,081,"Nebraska","Hamilton County",4,81,41,19,22
050,31,081,"Nebraska","Hamilton County",4,82,46,21,25
050,31,081,"Nebraska","Hamilton County",4,83,43,25,18
050,31,081,"Nebraska","Hamilton County",4,84,38,18,20
050,31,081,"Nebraska","Hamilton County",4,85,259,94,165
050,31,081,"Nebraska","Hamilton County",5,0,108,58,50
050,31,081,"Nebraska","Hamilton County",5,1,109,62,47
050,31,081,"Nebraska","Hamilton County",5,2,108,49,59
050,31,081,"Nebraska","Hamilton County",5,3,115,57,58
050,31,081,"Nebraska","Hamilton County",5,4,114,63,51
050,31,081,"Nebraska","Hamilton County",5,5,131,78,53
050,31,081,"Nebraska","Hamilton County",5,6,146,84,62
050,31,081,"Nebraska","Hamilton County",5,7,127,63,64
050,31,081,"Nebraska","Hamilton County",5,8,130,60,70
050,31,081,"Nebraska","Hamilton County",5,9,124,61,63
050,31,081,"Nebraska","Hamilton County",5,10,143,76,67
050,31,081,"Nebraska","Hamilton County",5,11,148,86,62
050,31,081,"Nebraska","Hamilton County",5,12,144,77,67
050,31,081,"Nebraska","Hamilton County",5,13,130,70,60
050,31,081,"Nebraska","Hamilton County",5,14,139,74,65
050,31,081,"Nebraska","Hamilton County",5,15,130,66,64
050,31,081,"Nebraska","Hamilton County",5,16,133,73,60
050,31,081,"Nebraska","Hamilton County",5,17,132,77,55
050,31,081,"Nebraska","Hamilton County",5,18,115,71,44
050,31,081,"Nebraska","Hamilton County",5,19,90,48,42
050,31,081,"Nebraska","Hamilton County",5,20,97,53,44
050,31,081,"Nebraska","Hamilton County",5,21,105,53,52
050,31,081,"Nebraska","Hamilton County",5,22,91,51,40
050,31,081,"Nebraska","Hamilton County",5,23,106,47,59
050,31,081,"Nebraska","Hamilton County",5,24,82,44,38
050,31,081,"Nebraska","Hamilton County",5,25,97,56,41
050,31,081,"Nebraska","Hamilton County",5,26,98,45,53
050,31,081,"Nebraska","Hamilton County",5,27,96,46,50
050,31,081,"Nebraska","Hamilton County",5,28,107,50,57
050,31,081,"Nebraska","Hamilton County",5,29,108,53,55
050,31,081,"Nebraska","Hamilton County",5,30,106,53,53
050,31,081,"Nebraska","Hamilton County",5,31,118,61,57
050,31,081,"Nebraska","Hamilton County",5,32,119,59,60
050,31,081,"Nebraska","Hamilton County",5,33,111,60,51
050,31,081,"Nebraska","Hamilton County",5,34,116,66,50
050,31,081,"Nebraska","Hamilton County",5,35,106,53,53
050,31,081,"Nebraska","Hamilton County",5,36,102,51,51
050,31,081,"Nebraska","Hamilton County",5,37,117,64,53
050,31,081,"Nebraska","Hamilton County",5,38,114,66,48
050,31,081,"Nebraska","Hamilton County",5,39,122,63,59
050,31,081,"Nebraska","Hamilton County",5,40,127,63,64
050,31,081,"Nebraska","Hamilton County",5,41,130,65,65
050,31,081,"Nebraska","Hamilton County",5,42,124,61,63
050,31,081,"Nebraska","Hamilton County",5,43,116,57,59
050,31,081,"Nebraska","Hamilton County",5,44,111,56,55
050,31,081,"Nebraska","Hamilton County",5,45,103,61,42
050,31,081,"Nebraska","Hamilton County",5,46,103,48,55
050,31,081,"Nebraska","Hamilton County",5,47,113,59,54
050,31,081,"Nebraska","Hamilton County",5,48,109,62,47
050,31,081,"Nebraska","Hamilton County",5,49,100,52,48
050,31,081,"Nebraska","Hamilton County",5,50,101,45,56
050,31,081,"Nebraska","Hamilton County",5,51,99,51,48
050,31,081,"Nebraska","Hamilton County",5,52,107,48,59
050,31,081,"Nebraska","Hamilton County",5,53,123,61,62
050,31,081,"Nebraska","Hamilton County",5,54,124,57,67
050,31,081,"Nebraska","Hamilton County",5,55,98,48,50
050,31,081,"Nebraska","Hamilton County",5,56,100,45,55
050,31,081,"Nebraska","Hamilton County",5,57,106,57,49
050,31,081,"Nebraska","Hamilton County",5,58,116,63,53
050,31,081,"Nebraska","Hamilton County",5,59,133,72,61
050,31,081,"Nebraska","Hamilton County",5,60,121,63,58
050,31,081,"Nebraska","Hamilton County",5,61,135,69,66
050,31,081,"Nebraska","Hamilton County",5,62,140,66,74
050,31,081,"Nebraska","Hamilton County",5,63,140,68,72
050,31,081,"Nebraska","Hamilton County",5,64,120,60,60
050,31,081,"Nebraska","Hamilton County",5,65,130,59,71
050,31,081,"Nebraska","Hamilton County",5,66,128,66,62
050,31,081,"Nebraska","Hamilton County",5,67,120,53,67
050,31,081,"Nebraska","Hamilton County",5,68,129,59,70
050,31,081,"Nebraska","Hamilton County",5,69,113,47,66
050,31,081,"Nebraska","Hamilton County",5,70,127,68,59
050,31,081,"Nebraska","Hamilton County",5,71,112,60,52
050,31,081,"Nebraska","Hamilton County",5,72,86,44,42
050,31,081,"Nebraska","Hamilton County",5,73,83,36,47
050,31,081,"Nebraska","Hamilton County",5,74,94,44,50
050,31,081,"Nebraska","Hamilton County",5,75,85,44,41
050,31,081,"Nebraska","Hamilton County",5,76,106,57,49
050,31,081,"Nebraska","Hamilton County",5,77,66,33,33
050,31,081,"Nebraska","Hamilton County",5,78,61,26,35
050,31,081,"Nebraska","Hamilton County",5,79,69,33,36
050,31,081,"Nebraska","Hamilton County",5,80,63,32,31
050,31,081,"Nebraska","Hamilton County",5,81,47,22,25
050,31,081,"Nebraska","Hamilton County",5,82,40,19,21
050,31,081,"Nebraska","Hamilton County",5,83,44,22,22
050,31,081,"Nebraska","Hamilton County",5,84,38,21,17
050,31,081,"Nebraska","Hamilton County",5,85,263,99,164
050,31,083,"Nebraska","Harlan County",1,0,32,17,15
050,31,083,"Nebraska","Harlan County",1,1,26,15,11
050,31,083,"Nebraska","Harlan County",1,2,31,13,18
050,31,083,"Nebraska","Harlan County",1,3,37,16,21
050,31,083,"Nebraska","Harlan County",1,4,31,12,19
050,31,083,"Nebraska","Harlan County",1,5,35,18,17
050,31,083,"Nebraska","Harlan County",1,6,35,25,10
050,31,083,"Nebraska","Harlan County",1,7,32,19,13
050,31,083,"Nebraska","Harlan County",1,8,40,21,19
050,31,083,"Nebraska","Harlan County",1,9,38,20,18
050,31,083,"Nebraska","Harlan County",1,10,48,24,24
050,31,083,"Nebraska","Harlan County",1,11,39,18,21
050,31,083,"Nebraska","Harlan County",1,12,36,20,16
050,31,083,"Nebraska","Harlan County",1,13,36,20,16
050,31,083,"Nebraska","Harlan County",1,14,41,23,18
050,31,083,"Nebraska","Harlan County",1,15,46,27,19
050,31,083,"Nebraska","Harlan County",1,16,30,17,13
050,31,083,"Nebraska","Harlan County",1,17,35,20,15
050,31,083,"Nebraska","Harlan County",1,18,37,21,16
050,31,083,"Nebraska","Harlan County",1,19,26,13,13
050,31,083,"Nebraska","Harlan County",1,20,27,12,15
050,31,083,"Nebraska","Harlan County",1,21,29,18,11
050,31,083,"Nebraska","Harlan County",1,22,25,14,11
050,31,083,"Nebraska","Harlan County",1,23,21,11,10
050,31,083,"Nebraska","Harlan County",1,24,23,15,8
050,31,083,"Nebraska","Harlan County",1,25,27,12,15
050,31,083,"Nebraska","Harlan County",1,26,30,15,15
050,31,083,"Nebraska","Harlan County",1,27,29,13,16
050,31,083,"Nebraska","Harlan County",1,28,25,13,12
050,31,083,"Nebraska","Harlan County",1,29,28,11,17
050,31,083,"Nebraska","Harlan County",1,30,25,11,14
050,31,083,"Nebraska","Harlan County",1,31,28,14,14
050,31,083,"Nebraska","Harlan County",1,32,19,13,6
050,31,083,"Nebraska","Harlan County",1,33,16,9,7
050,31,083,"Nebraska","Harlan County",1,34,26,15,11
050,31,083,"Nebraska","Harlan County",1,35,22,11,11
050,31,083,"Nebraska","Harlan County",1,36,29,13,16
050,31,083,"Nebraska","Harlan County",1,37,32,11,21
050,31,083,"Nebraska","Harlan County",1,38,38,19,19
050,31,083,"Nebraska","Harlan County",1,39,26,13,13
050,31,083,"Nebraska","Harlan County",1,40,29,14,15
050,31,083,"Nebraska","Harlan County",1,41,27,17,10
050,31,083,"Nebraska","Harlan County",1,42,28,14,14
050,31,083,"Nebraska","Harlan County",1,43,34,17,17
050,31,083,"Nebraska","Harlan County",1,44,28,15,13
050,31,083,"Nebraska","Harlan County",1,45,32,18,14
050,31,083,"Nebraska","Harlan County",1,46,33,19,14
050,31,083,"Nebraska","Harlan County",1,47,29,16,13
050,31,083,"Nebraska","Harlan County",1,48,39,19,20
050,31,083,"Nebraska","Harlan County",1,49,43,23,20
050,31,083,"Nebraska","Harlan County",1,50,38,18,20
050,31,083,"Nebraska","Harlan County",1,51,36,21,15
050,31,083,"Nebraska","Harlan County",1,52,33,21,12
050,31,083,"Nebraska","Harlan County",1,53,31,12,19
050,31,083,"Nebraska","Harlan County",1,54,33,15,18
050,31,083,"Nebraska","Harlan County",1,55,48,26,22
050,31,083,"Nebraska","Harlan County",1,56,45,28,17
050,31,083,"Nebraska","Harlan County",1,57,45,26,19
050,31,083,"Nebraska","Harlan County",1,58,53,26,27
050,31,083,"Nebraska","Harlan County",1,59,65,31,34
050,31,083,"Nebraska","Harlan County",1,60,59,31,28
050,31,083,"Nebraska","Harlan County",1,61,50,21,29
050,31,083,"Nebraska","Harlan County",1,62,49,24,25
050,31,083,"Nebraska","Harlan County",1,63,48,29,19
050,31,083,"Nebraska","Harlan County",1,64,49,26,23
050,31,083,"Nebraska","Harlan County",1,65,60,31,29
050,31,083,"Nebraska","Harlan County",1,66,60,29,31
050,31,083,"Nebraska","Harlan County",1,67,43,25,18
050,31,083,"Nebraska","Harlan County",1,68,49,33,16
050,31,083,"Nebraska","Harlan County",1,69,44,25,19
050,31,083,"Nebraska","Harlan County",1,70,46,22,24
050,31,083,"Nebraska","Harlan County",1,71,47,19,28
050,31,083,"Nebraska","Harlan County",1,72,44,23,21
050,31,083,"Nebraska","Harlan County",1,73,43,23,20
050,31,083,"Nebraska","Harlan County",1,74,32,16,16
050,31,083,"Nebraska","Harlan County",1,75,31,19,12
050,31,083,"Nebraska","Harlan County",1,76,36,20,16
050,31,083,"Nebraska","Harlan County",1,77,33,15,18
050,31,083,"Nebraska","Harlan County",1,78,32,12,20
050,31,083,"Nebraska","Harlan County",1,79,24,14,10
050,31,083,"Nebraska","Harlan County",1,80,24,12,12
050,31,083,"Nebraska","Harlan County",1,81,20,12,8
050,31,083,"Nebraska","Harlan County",1,82,25,12,13
050,31,083,"Nebraska","Harlan County",1,83,18,11,7
050,31,083,"Nebraska","Harlan County",1,84,18,8,10
050,31,083,"Nebraska","Harlan County",1,85,107,43,64
050,31,083,"Nebraska","Harlan County",2,0,31,16,15
050,31,083,"Nebraska","Harlan County",2,1,27,15,12
050,31,083,"Nebraska","Harlan County",2,2,29,13,16
050,31,083,"Nebraska","Harlan County",2,3,37,15,22
050,31,083,"Nebraska","Harlan County",2,4,33,13,20
050,31,083,"Nebraska","Harlan County",2,5,34,17,17
050,31,083,"Nebraska","Harlan County",2,6,35,24,11
050,31,083,"Nebraska","Harlan County",2,7,33,20,13
050,31,083,"Nebraska","Harlan County",2,8,39,21,18
050,31,083,"Nebraska","Harlan County",2,9,39,21,18
050,31,083,"Nebraska","Harlan County",2,10,43,22,21
050,31,083,"Nebraska","Harlan County",2,11,40,20,20
050,31,083,"Nebraska","Harlan County",2,12,37,20,17
050,31,083,"Nebraska","Harlan County",2,13,34,19,15
050,31,083,"Nebraska","Harlan County",2,14,39,22,17
050,31,083,"Nebraska","Harlan County",2,15,43,25,18
050,31,083,"Nebraska","Harlan County",2,16,34,19,15
050,31,083,"Nebraska","Harlan County",2,17,33,18,15
050,31,083,"Nebraska","Harlan County",2,18,34,20,14
050,31,083,"Nebraska","Harlan County",2,19,27,15,12
050,31,083,"Nebraska","Harlan County",2,20,28,13,15
050,31,083,"Nebraska","Harlan County",2,21,29,17,12
050,31,083,"Nebraska","Harlan County",2,22,26,15,11
050,31,083,"Nebraska","Harlan County",2,23,21,11,10
050,31,083,"Nebraska","Harlan County",2,24,24,15,9
050,31,083,"Nebraska","Harlan County",2,25,25,12,13
050,31,083,"Nebraska","Harlan County",2,26,29,14,15
050,31,083,"Nebraska","Harlan County",2,27,28,13,15
050,31,083,"Nebraska","Harlan County",2,28,26,13,13
050,31,083,"Nebraska","Harlan County",2,29,27,11,16
050,31,083,"Nebraska","Harlan County",2,30,26,11,15
050,31,083,"Nebraska","Harlan County",2,31,27,14,13
050,31,083,"Nebraska","Harlan County",2,32,22,14,8
050,31,083,"Nebraska","Harlan County",2,33,17,10,7
050,31,083,"Nebraska","Harlan County",2,34,23,13,10
050,31,083,"Nebraska","Harlan County",2,35,23,12,11
050,31,083,"Nebraska","Harlan County",2,36,27,12,15
050,31,083,"Nebraska","Harlan County",2,37,30,11,19
050,31,083,"Nebraska","Harlan County",2,38,36,17,19
050,31,083,"Nebraska","Harlan County",2,39,30,15,15
050,31,083,"Nebraska","Harlan County",2,40,28,13,15
050,31,083,"Nebraska","Harlan County",2,41,26,16,10
050,31,083,"Nebraska","Harlan County",2,42,27,14,13
050,31,083,"Nebraska","Harlan County",2,43,33,17,16
050,31,083,"Nebraska","Harlan County",2,44,29,15,14
050,31,083,"Nebraska","Harlan County",2,45,32,18,14
050,31,083,"Nebraska","Harlan County",2,46,34,19,15
050,31,083,"Nebraska","Harlan County",2,47,32,17,15
050,31,083,"Nebraska","Harlan County",2,48,37,19,18
050,31,083,"Nebraska","Harlan County",2,49,41,22,19
050,31,083,"Nebraska","Harlan County",2,50,39,19,20
050,31,083,"Nebraska","Harlan County",2,51,36,21,15
050,31,083,"Nebraska","Harlan County",2,52,34,21,13
050,31,083,"Nebraska","Harlan County",2,53,31,14,17
050,31,083,"Nebraska","Harlan County",2,54,32,14,18
050,31,083,"Nebraska","Harlan County",2,55,43,22,21
050,31,083,"Nebraska","Harlan County",2,56,47,28,19
050,31,083,"Nebraska","Harlan County",2,57,45,26,19
050,31,083,"Nebraska","Harlan County",2,58,51,26,25
050,31,083,"Nebraska","Harlan County",2,59,62,30,32
050,31,083,"Nebraska","Harlan County",2,60,60,31,29
050,31,083,"Nebraska","Harlan County",2,61,51,22,29
050,31,083,"Nebraska","Harlan County",2,62,50,24,26
050,31,083,"Nebraska","Harlan County",2,63,49,29,20
050,31,083,"Nebraska","Harlan County",2,64,47,26,21
050,31,083,"Nebraska","Harlan County",2,65,58,30,28
050,31,083,"Nebraska","Harlan County",2,66,60,29,31
050,31,083,"Nebraska","Harlan County",2,67,47,26,21
050,31,083,"Nebraska","Harlan County",2,68,46,30,16
050,31,083,"Nebraska","Harlan County",2,69,45,27,18
050,31,083,"Nebraska","Harlan County",2,70,45,23,22
050,31,083,"Nebraska","Harlan County",2,71,46,19,27
050,31,083,"Nebraska","Harlan County",2,72,43,21,22
050,31,083,"Nebraska","Harlan County",2,73,46,24,22
050,31,083,"Nebraska","Harlan County",2,74,32,16,16
050,31,083,"Nebraska","Harlan County",2,75,31,18,13
050,31,083,"Nebraska","Harlan County",2,76,34,19,15
050,31,083,"Nebraska","Harlan County",2,77,35,17,18
050,31,083,"Nebraska","Harlan County",2,78,30,11,19
050,31,083,"Nebraska","Harlan County",2,79,25,13,12
050,31,083,"Nebraska","Harlan County",2,80,24,13,11
050,31,083,"Nebraska","Harlan County",2,81,22,12,10
050,31,083,"Nebraska","Harlan County",2,82,24,12,12
050,31,083,"Nebraska","Harlan County",2,83,18,10,8
050,31,083,"Nebraska","Harlan County",2,84,17,8,9
050,31,083,"Nebraska","Harlan County",2,85,108,42,66
050,31,083,"Nebraska","Harlan County",3,0,34,19,15
050,31,083,"Nebraska","Harlan County",3,1,30,17,13
050,31,083,"Nebraska","Harlan County",3,2,29,16,13
050,31,083,"Nebraska","Harlan County",3,3,27,13,14
050,31,083,"Nebraska","Harlan County",3,4,38,15,23
050,31,083,"Nebraska","Harlan County",3,5,37,16,21
050,31,083,"Nebraska","Harlan County",3,6,38,17,21
050,31,083,"Nebraska","Harlan County",3,7,37,26,11
050,31,083,"Nebraska","Harlan County",3,8,33,17,16
050,31,083,"Nebraska","Harlan County",3,9,42,24,18
050,31,083,"Nebraska","Harlan County",3,10,37,20,17
050,31,083,"Nebraska","Harlan County",3,11,45,24,21
050,31,083,"Nebraska","Harlan County",3,12,45,20,25
050,31,083,"Nebraska","Harlan County",3,13,39,21,18
050,31,083,"Nebraska","Harlan County",3,14,36,20,16
050,31,083,"Nebraska","Harlan County",3,15,42,23,19
050,31,083,"Nebraska","Harlan County",3,16,43,24,19
050,31,083,"Nebraska","Harlan County",3,17,34,19,15
050,31,083,"Nebraska","Harlan County",3,18,27,15,12
050,31,083,"Nebraska","Harlan County",3,19,28,16,12
050,31,083,"Nebraska","Harlan County",3,20,28,13,15
050,31,083,"Nebraska","Harlan County",3,21,31,14,17
050,31,083,"Nebraska","Harlan County",3,22,24,13,11
050,31,083,"Nebraska","Harlan County",3,23,28,19,9
050,31,083,"Nebraska","Harlan County",3,24,23,13,10
050,31,083,"Nebraska","Harlan County",3,25,24,14,10
050,31,083,"Nebraska","Harlan County",3,26,27,14,13
050,31,083,"Nebraska","Harlan County",3,27,32,16,16
050,31,083,"Nebraska","Harlan County",3,28,32,13,19
050,31,083,"Nebraska","Harlan County",3,29,28,13,15
050,31,083,"Nebraska","Harlan County",3,30,26,11,15
050,31,083,"Nebraska","Harlan County",3,31,26,10,16
050,31,083,"Nebraska","Harlan County",3,32,31,15,16
050,31,083,"Nebraska","Harlan County",3,33,19,13,6
050,31,083,"Nebraska","Harlan County",3,34,21,13,8
050,31,083,"Nebraska","Harlan County",3,35,25,14,11
050,31,083,"Nebraska","Harlan County",3,36,24,14,10
050,31,083,"Nebraska","Harlan County",3,37,25,11,14
050,31,083,"Nebraska","Harlan County",3,38,28,10,18
050,31,083,"Nebraska","Harlan County",3,39,33,16,17
050,31,083,"Nebraska","Harlan County",3,40,33,17,16
050,31,083,"Nebraska","Harlan County",3,41,31,14,17
050,31,083,"Nebraska","Harlan County",3,42,29,15,14
050,31,083,"Nebraska","Harlan County",3,43,33,18,15
050,31,083,"Nebraska","Harlan County",3,44,34,17,17
050,31,083,"Nebraska","Harlan County",3,45,27,16,11
050,31,083,"Nebraska","Harlan County",3,46,31,17,14
050,31,083,"Nebraska","Harlan County",3,47,33,18,15
050,31,083,"Nebraska","Harlan County",3,48,33,18,15
050,31,083,"Nebraska","Harlan County",3,49,38,19,19
050,31,083,"Nebraska","Harlan County",3,50,43,24,19
050,31,083,"Nebraska","Harlan County",3,51,42,18,24
050,31,083,"Nebraska","Harlan County",3,52,38,22,16
050,31,083,"Nebraska","Harlan County",3,53,30,19,11
050,31,083,"Nebraska","Harlan County",3,54,31,15,16
050,31,083,"Nebraska","Harlan County",3,55,36,15,21
050,31,083,"Nebraska","Harlan County",3,56,42,22,20
050,31,083,"Nebraska","Harlan County",3,57,47,27,20
050,31,083,"Nebraska","Harlan County",3,58,44,24,20
050,31,083,"Nebraska","Harlan County",3,59,50,26,24
050,31,083,"Nebraska","Harlan County",3,60,61,30,31
050,31,083,"Nebraska","Harlan County",3,61,60,31,29
050,31,083,"Nebraska","Harlan County",3,62,52,23,29
050,31,083,"Nebraska","Harlan County",3,63,48,23,25
050,31,083,"Nebraska","Harlan County",3,64,51,30,21
050,31,083,"Nebraska","Harlan County",3,65,45,24,21
050,31,083,"Nebraska","Harlan County",3,66,57,30,27
050,31,083,"Nebraska","Harlan County",3,67,60,28,32
050,31,083,"Nebraska","Harlan County",3,68,48,28,20
050,31,083,"Nebraska","Harlan County",3,69,45,27,18
050,31,083,"Nebraska","Harlan County",3,70,44,28,16
050,31,083,"Nebraska","Harlan County",3,71,48,25,23
050,31,083,"Nebraska","Harlan County",3,72,44,18,26
050,31,083,"Nebraska","Harlan County",3,73,42,20,22
050,31,083,"Nebraska","Harlan County",3,74,49,22,27
050,31,083,"Nebraska","Harlan County",3,75,29,16,13
050,31,083,"Nebraska","Harlan County",3,76,30,16,14
050,31,083,"Nebraska","Harlan County",3,77,35,21,14
050,31,083,"Nebraska","Harlan County",3,78,33,15,18
050,31,083,"Nebraska","Harlan County",3,79,30,10,20
050,31,083,"Nebraska","Harlan County",3,80,19,11,8
050,31,083,"Nebraska","Harlan County",3,81,25,14,11
050,31,083,"Nebraska","Harlan County",3,82,20,11,9
050,31,083,"Nebraska","Harlan County",3,83,22,12,10
050,31,083,"Nebraska","Harlan County",3,84,11,5,6
050,31,083,"Nebraska","Harlan County",3,85,108,43,65
050,31,083,"Nebraska","Harlan County",4,0,31,15,16
050,31,083,"Nebraska","Harlan County",4,1,38,21,17
050,31,083,"Nebraska","Harlan County",4,2,29,17,12
050,31,083,"Nebraska","Harlan County",4,3,30,19,11
050,31,083,"Nebraska","Harlan County",4,4,29,14,15
050,31,083,"Nebraska","Harlan County",4,5,38,16,22
050,31,083,"Nebraska","Harlan County",4,6,32,12,20
050,31,083,"Nebraska","Harlan County",4,7,38,18,20
050,31,083,"Nebraska","Harlan County",4,8,37,27,10
050,31,083,"Nebraska","Harlan County",4,9,28,16,12
050,31,083,"Nebraska","Harlan County",4,10,41,23,18
050,31,083,"Nebraska","Harlan County",4,11,40,22,18
050,31,083,"Nebraska","Harlan County",4,12,47,25,22
050,31,083,"Nebraska","Harlan County",4,13,45,21,24
050,31,083,"Nebraska","Harlan County",4,14,37,19,18
050,31,083,"Nebraska","Harlan County",4,15,33,20,13
050,31,083,"Nebraska","Harlan County",4,16,39,23,16
050,31,083,"Nebraska","Harlan County",4,17,39,23,16
050,31,083,"Nebraska","Harlan County",4,18,28,16,12
050,31,083,"Nebraska","Harlan County",4,19,20,12,8
050,31,083,"Nebraska","Harlan County",4,20,29,15,14
050,31,083,"Nebraska","Harlan County",4,21,29,14,15
050,31,083,"Nebraska","Harlan County",4,22,26,11,15
050,31,083,"Nebraska","Harlan County",4,23,24,12,12
050,31,083,"Nebraska","Harlan County",4,24,28,16,12
050,31,083,"Nebraska","Harlan County",4,25,20,13,7
050,31,083,"Nebraska","Harlan County",4,26,24,14,10
050,31,083,"Nebraska","Harlan County",4,27,28,13,15
050,31,083,"Nebraska","Harlan County",4,28,30,14,16
050,31,083,"Nebraska","Harlan County",4,29,32,14,18
050,31,083,"Nebraska","Harlan County",4,30,30,15,15
050,31,083,"Nebraska","Harlan County",4,31,25,11,14
050,31,083,"Nebraska","Harlan County",4,32,24,9,15
050,31,083,"Nebraska","Harlan County",4,33,34,15,19
050,31,083,"Nebraska","Harlan County",4,34,21,14,7
050,31,083,"Nebraska","Harlan County",4,35,21,13,8
050,31,083,"Nebraska","Harlan County",4,36,29,17,12
050,31,083,"Nebraska","Harlan County",4,37,24,12,12
050,31,083,"Nebraska","Harlan County",4,38,26,11,15
050,31,083,"Nebraska","Harlan County",4,39,29,10,19
050,31,083,"Nebraska","Harlan County",4,40,37,19,18
050,31,083,"Nebraska","Harlan County",4,41,31,15,16
050,31,083,"Nebraska","Harlan County",4,42,31,15,16
050,31,083,"Nebraska","Harlan County",4,43,29,16,13
050,31,083,"Nebraska","Harlan County",4,44,33,18,15
050,31,083,"Nebraska","Harlan County",4,45,36,20,16
050,31,083,"Nebraska","Harlan County",4,46,22,13,9
050,31,083,"Nebraska","Harlan County",4,47,28,15,13
050,31,083,"Nebraska","Harlan County",4,48,33,18,15
050,31,083,"Nebraska","Harlan County",4,49,32,18,14
050,31,083,"Nebraska","Harlan County",4,50,38,18,20
050,31,083,"Nebraska","Harlan County",4,51,42,23,19
050,31,083,"Nebraska","Harlan County",4,52,39,19,20
050,31,083,"Nebraska","Harlan County",4,53,35,19,16
050,31,083,"Nebraska","Harlan County",4,54,30,20,10
050,31,083,"Nebraska","Harlan County",4,55,30,14,16
050,31,083,"Nebraska","Harlan County",4,56,34,15,19
050,31,083,"Nebraska","Harlan County",4,57,41,21,20
050,31,083,"Nebraska","Harlan County",4,58,53,28,25
050,31,083,"Nebraska","Harlan County",4,59,47,25,22
050,31,083,"Nebraska","Harlan County",4,60,48,23,25
050,31,083,"Nebraska","Harlan County",4,61,67,33,34
050,31,083,"Nebraska","Harlan County",4,62,60,31,29
050,31,083,"Nebraska","Harlan County",4,63,50,24,26
050,31,083,"Nebraska","Harlan County",4,64,46,22,24
050,31,083,"Nebraska","Harlan County",4,65,50,29,21
050,31,083,"Nebraska","Harlan County",4,66,45,24,21
050,31,083,"Nebraska","Harlan County",4,67,57,31,26
050,31,083,"Nebraska","Harlan County",4,68,62,30,32
050,31,083,"Nebraska","Harlan County",4,69,47,26,21
050,31,083,"Nebraska","Harlan County",4,70,43,26,17
050,31,083,"Nebraska","Harlan County",4,71,46,29,17
050,31,083,"Nebraska","Harlan County",4,72,46,25,21
050,31,083,"Nebraska","Harlan County",4,73,40,17,23
050,31,083,"Nebraska","Harlan County",4,74,40,18,22
050,31,083,"Nebraska","Harlan County",4,75,42,20,22
050,31,083,"Nebraska","Harlan County",4,76,27,14,13
050,31,083,"Nebraska","Harlan County",4,77,30,18,12
050,31,083,"Nebraska","Harlan County",4,78,34,19,15
050,31,083,"Nebraska","Harlan County",4,79,32,14,18
050,31,083,"Nebraska","Harlan County",4,80,26,8,18
050,31,083,"Nebraska","Harlan County",4,81,19,11,8
050,31,083,"Nebraska","Harlan County",4,82,23,12,11
050,31,083,"Nebraska","Harlan County",4,83,18,11,7
050,31,083,"Nebraska","Harlan County",4,84,13,8,5
050,31,083,"Nebraska","Harlan County",4,85,88,38,50
050,31,083,"Nebraska","Harlan County",5,0,31,15,16
050,31,083,"Nebraska","Harlan County",5,1,29,15,14
050,31,083,"Nebraska","Harlan County",5,2,38,20,18
050,31,083,"Nebraska","Harlan County",5,3,33,20,13
050,31,083,"Nebraska","Harlan County",5,4,26,15,11
050,31,083,"Nebraska","Harlan County",5,5,30,14,16
050,31,083,"Nebraska","Harlan County",5,6,37,16,21
050,31,083,"Nebraska","Harlan County",5,7,38,14,24
050,31,083,"Nebraska","Harlan County",5,8,40,20,20
050,31,083,"Nebraska","Harlan County",5,9,43,28,15
050,31,083,"Nebraska","Harlan County",5,10,32,16,16
050,31,083,"Nebraska","Harlan County",5,11,42,26,16
050,31,083,"Nebraska","Harlan County",5,12,42,25,17
050,31,083,"Nebraska","Harlan County",5,13,49,26,23
050,31,083,"Nebraska","Harlan County",5,14,45,21,24
050,31,083,"Nebraska","Harlan County",5,15,39,21,18
050,31,083,"Nebraska","Harlan County",5,16,36,19,17
050,31,083,"Nebraska","Harlan County",5,17,40,21,19
050,31,083,"Nebraska","Harlan County",5,18,34,20,14
050,31,083,"Nebraska","Harlan County",5,19,24,15,9
050,31,083,"Nebraska","Harlan County",5,20,18,11,7
050,31,083,"Nebraska","Harlan County",5,21,29,15,14
050,31,083,"Nebraska","Harlan County",5,22,27,12,15
050,31,083,"Nebraska","Harlan County",5,23,26,10,16
050,31,083,"Nebraska","Harlan County",5,24,24,12,12
050,31,083,"Nebraska","Harlan County",5,25,22,10,12
050,31,083,"Nebraska","Harlan County",5,26,20,13,7
050,31,083,"Nebraska","Harlan County",5,27,28,18,10
050,31,083,"Nebraska","Harlan County",5,28,27,12,15
050,31,083,"Nebraska","Harlan County",5,29,29,13,16
050,31,083,"Nebraska","Harlan County",5,30,35,17,18
050,31,083,"Nebraska","Harlan County",5,31,33,17,16
050,31,083,"Nebraska","Harlan County",5,32,27,12,15
050,31,083,"Nebraska","Harlan County",5,33,27,10,17
050,31,083,"Nebraska","Harlan County",5,34,32,15,17
050,31,083,"Nebraska","Harlan County",5,35,18,12,6
050,31,083,"Nebraska","Harlan County",5,36,23,13,10
050,31,083,"Nebraska","Harlan County",5,37,31,18,13
050,31,083,"Nebraska","Harlan County",5,38,24,11,13
050,31,083,"Nebraska","Harlan County",5,39,30,11,19
050,31,083,"Nebraska","Harlan County",5,40,28,12,16
050,31,083,"Nebraska","Harlan County",5,41,37,19,18
050,31,083,"Nebraska","Harlan County",5,42,27,12,15
050,31,083,"Nebraska","Harlan County",5,43,33,15,18
050,31,083,"Nebraska","Harlan County",5,44,31,17,14
050,31,083,"Nebraska","Harlan County",5,45,34,21,13
050,31,083,"Nebraska","Harlan County",5,46,33,18,15
050,31,083,"Nebraska","Harlan County",5,47,25,14,11
050,31,083,"Nebraska","Harlan County",5,48,30,15,15
050,31,083,"Nebraska","Harlan County",5,49,33,18,15
050,31,083,"Nebraska","Harlan County",5,50,33,19,14
050,31,083,"Nebraska","Harlan County",5,51,38,18,20
050,31,083,"Nebraska","Harlan County",5,52,46,27,19
050,31,083,"Nebraska","Harlan County",5,53,40,18,22
050,31,083,"Nebraska","Harlan County",5,54,34,18,16
050,31,083,"Nebraska","Harlan County",5,55,31,20,11
050,31,083,"Nebraska","Harlan County",5,56,35,15,20
050,31,083,"Nebraska","Harlan County",5,57,33,14,19
050,31,083,"Nebraska","Harlan County",5,58,43,22,21
050,31,083,"Nebraska","Harlan County",5,59,48,26,22
050,31,083,"Nebraska","Harlan County",5,60,47,24,23
050,31,083,"Nebraska","Harlan County",5,61,50,24,26
050,31,083,"Nebraska","Harlan County",5,62,69,35,34
050,31,083,"Nebraska","Harlan County",5,63,59,31,28
050,31,083,"Nebraska","Harlan County",5,64,52,27,25
050,31,083,"Nebraska","Harlan County",5,65,46,21,25
050,31,083,"Nebraska","Harlan County",5,66,50,30,20
050,31,083,"Nebraska","Harlan County",5,67,44,23,21
050,31,083,"Nebraska","Harlan County",5,68,58,31,27
050,31,083,"Nebraska","Harlan County",5,69,60,30,30
050,31,083,"Nebraska","Harlan County",5,70,42,23,19
050,31,083,"Nebraska","Harlan County",5,71,44,28,16
050,31,083,"Nebraska","Harlan County",5,72,41,27,14
050,31,083,"Nebraska","Harlan County",5,73,45,23,22
050,31,083,"Nebraska","Harlan County",5,74,40,15,25
050,31,083,"Nebraska","Harlan County",5,75,38,18,20
050,31,083,"Nebraska","Harlan County",5,76,43,19,24
050,31,083,"Nebraska","Harlan County",5,77,26,14,12
050,31,083,"Nebraska","Harlan County",5,78,26,16,10
050,31,083,"Nebraska","Harlan County",5,79,33,18,15
050,31,083,"Nebraska","Harlan County",5,80,28,12,16
050,31,083,"Nebraska","Harlan County",5,81,26,8,18
050,31,083,"Nebraska","Harlan County",5,82,17,9,8
050,31,083,"Nebraska","Harlan County",5,83,23,12,11
050,31,083,"Nebraska","Harlan County",5,84,11,7,4
050,31,083,"Nebraska","Harlan County",5,85,77,37,40
050,31,085,"Nebraska","Hayes County",1,0,11,6,5
050,31,085,"Nebraska","Hayes County",1,1,14,7,7
050,31,085,"Nebraska","Hayes County",1,2,13,4,9
050,31,085,"Nebraska","Hayes County",1,3,13,5,8
050,31,085,"Nebraska","Hayes County",1,4,18,8,10
050,31,085,"Nebraska","Hayes County",1,5,9,5,4
050,31,085,"Nebraska","Hayes County",1,6,10,5,5
050,31,085,"Nebraska","Hayes County",1,7,10,3,7
050,31,085,"Nebraska","Hayes County",1,8,8,3,5
050,31,085,"Nebraska","Hayes County",1,9,15,5,10
050,31,085,"Nebraska","Hayes County",1,10,11,5,6
050,31,085,"Nebraska","Hayes County",1,11,15,10,5
050,31,085,"Nebraska","Hayes County",1,12,10,6,4
050,31,085,"Nebraska","Hayes County",1,13,12,5,7
050,31,085,"Nebraska","Hayes County",1,14,10,5,5
050,31,085,"Nebraska","Hayes County",1,15,9,5,4
050,31,085,"Nebraska","Hayes County",1,16,9,5,4
050,31,085,"Nebraska","Hayes County",1,17,11,5,6
050,31,085,"Nebraska","Hayes County",1,18,8,3,5
050,31,085,"Nebraska","Hayes County",1,19,5,3,2
050,31,085,"Nebraska","Hayes County",1,20,4,2,2
050,31,085,"Nebraska","Hayes County",1,21,6,3,3
050,31,085,"Nebraska","Hayes County",1,22,8,5,3
050,31,085,"Nebraska","Hayes County",1,23,9,5,4
050,31,085,"Nebraska","Hayes County",1,24,11,6,5
050,31,085,"Nebraska","Hayes County",1,25,11,6,5
050,31,085,"Nebraska","Hayes County",1,26,8,3,5
050,31,085,"Nebraska","Hayes County",1,27,5,1,4
050,31,085,"Nebraska","Hayes County",1,28,9,4,5
050,31,085,"Nebraska","Hayes County",1,29,9,5,4
050,31,085,"Nebraska","Hayes County",1,30,9,5,4
050,31,085,"Nebraska","Hayes County",1,31,8,4,4
050,31,085,"Nebraska","Hayes County",1,32,7,5,2
050,31,085,"Nebraska","Hayes County",1,33,9,7,2
050,31,085,"Nebraska","Hayes County",1,34,8,3,5
050,31,085,"Nebraska","Hayes County",1,35,9,4,5
050,31,085,"Nebraska","Hayes County",1,36,6,5,1
050,31,085,"Nebraska","Hayes County",1,37,12,8,4
050,31,085,"Nebraska","Hayes County",1,38,11,5,6
050,31,085,"Nebraska","Hayes County",1,39,8,3,5
050,31,085,"Nebraska","Hayes County",1,40,13,5,8
050,31,085,"Nebraska","Hayes County",1,41,10,5,5
050,31,085,"Nebraska","Hayes County",1,42,7,3,4
050,31,085,"Nebraska","Hayes County",1,43,7,5,2
050,31,085,"Nebraska","Hayes County",1,44,6,3,3
050,31,085,"Nebraska","Hayes County",1,45,7,3,4
050,31,085,"Nebraska","Hayes County",1,46,5,1,4
050,31,085,"Nebraska","Hayes County",1,47,7,2,5
050,31,085,"Nebraska","Hayes County",1,48,6,2,4
050,31,085,"Nebraska","Hayes County",1,49,6,4,2
050,31,085,"Nebraska","Hayes County",1,50,3,2,1
050,31,085,"Nebraska","Hayes County",1,51,3,1,2
050,31,085,"Nebraska","Hayes County",1,52,3,2,1
050,31,085,"Nebraska","Hayes County",1,53,6,4,2
050,31,085,"Nebraska","Hayes County",1,54,8,4,4
050,31,085,"Nebraska","Hayes County",1,55,12,6,6
050,31,085,"Nebraska","Hayes County",1,56,10,7,3
050,31,085,"Nebraska","Hayes County",1,57,17,9,8
050,31,085,"Nebraska","Hayes County",1,58,12,4,8
050,31,085,"Nebraska","Hayes County",1,59,15,8,7
050,31,085,"Nebraska","Hayes County",1,60,17,9,8
050,31,085,"Nebraska","Hayes County",1,61,19,11,8
050,31,085,"Nebraska","Hayes County",1,62,22,11,11
050,31,085,"Nebraska","Hayes County",1,63,13,7,6
050,31,085,"Nebraska","Hayes County",1,64,11,5,6
050,31,085,"Nebraska","Hayes County",1,65,16,10,6
050,31,085,"Nebraska","Hayes County",1,66,13,8,5
050,31,085,"Nebraska","Hayes County",1,67,13,7,6
050,31,085,"Nebraska","Hayes County",1,68,17,7,10
050,31,085,"Nebraska","Hayes County",1,69,11,5,6
050,31,085,"Nebraska","Hayes County",1,70,7,5,2
050,31,085,"Nebraska","Hayes County",1,71,11,7,4
050,31,085,"Nebraska","Hayes County",1,72,14,10,4
050,31,085,"Nebraska","Hayes County",1,73,8,5,3
050,31,085,"Nebraska","Hayes County",1,74,8,4,4
050,31,085,"Nebraska","Hayes County",1,75,9,5,4
050,31,085,"Nebraska","Hayes County",1,76,8,4,4
050,31,085,"Nebraska","Hayes County",1,77,8,4,4
050,31,085,"Nebraska","Hayes County",1,78,9,5,4
050,31,085,"Nebraska","Hayes County",1,79,5,2,3
050,31,085,"Nebraska","Hayes County",1,80,4,1,3
050,31,085,"Nebraska","Hayes County",1,81,4,1,3
050,31,085,"Nebraska","Hayes County",1,82,6,3,3
050,31,085,"Nebraska","Hayes County",1,83,10,5,5
050,31,085,"Nebraska","Hayes County",1,84,7,4,3
050,31,085,"Nebraska","Hayes County",1,85,38,19,19
050,31,085,"Nebraska","Hayes County",2,0,9,5,4
050,31,085,"Nebraska","Hayes County",2,1,13,7,6
050,31,085,"Nebraska","Hayes County",2,2,14,5,9
050,31,085,"Nebraska","Hayes County",2,3,13,5,8
050,31,085,"Nebraska","Hayes County",2,4,18,8,10
050,31,085,"Nebraska","Hayes County",2,5,11,5,6
050,31,085,"Nebraska","Hayes County",2,6,9,5,4
050,31,085,"Nebraska","Hayes County",2,7,9,3,6
050,31,085,"Nebraska","Hayes County",2,8,9,3,6
050,31,085,"Nebraska","Hayes County",2,9,13,4,9
050,31,085,"Nebraska","Hayes County",2,10,12,5,7
050,31,085,"Nebraska","Hayes County",2,11,14,9,5
050,31,085,"Nebraska","Hayes County",2,12,11,7,4
050,31,085,"Nebraska","Hayes County",2,13,12,5,7
050,31,085,"Nebraska","Hayes County",2,14,11,5,6
050,31,085,"Nebraska","Hayes County",2,15,8,4,4
050,31,085,"Nebraska","Hayes County",2,16,9,5,4
050,31,085,"Nebraska","Hayes County",2,17,10,5,5
050,31,085,"Nebraska","Hayes County",2,18,8,3,5
050,31,085,"Nebraska","Hayes County",2,19,6,3,3
050,31,085,"Nebraska","Hayes County",2,20,4,2,2
050,31,085,"Nebraska","Hayes County",2,21,6,3,3
050,31,085,"Nebraska","Hayes County",2,22,8,5,3
050,31,085,"Nebraska","Hayes County",2,23,9,5,4
050,31,085,"Nebraska","Hayes County",2,24,11,6,5
050,31,085,"Nebraska","Hayes County",2,25,11,7,4
050,31,085,"Nebraska","Hayes County",2,26,8,3,5
050,31,085,"Nebraska","Hayes County",2,27,6,2,4
050,31,085,"Nebraska","Hayes County",2,28,9,4,5
050,31,085,"Nebraska","Hayes County",2,29,9,5,4
050,31,085,"Nebraska","Hayes County",2,30,9,5,4
050,31,085,"Nebraska","Hayes County",2,31,8,4,4
050,31,085,"Nebraska","Hayes County",2,32,7,5,2
050,31,085,"Nebraska","Hayes County",2,33,8,6,2
050,31,085,"Nebraska","Hayes County",2,34,8,4,4
050,31,085,"Nebraska","Hayes County",2,35,9,4,5
050,31,085,"Nebraska","Hayes County",2,36,7,5,2
050,31,085,"Nebraska","Hayes County",2,37,11,8,3
050,31,085,"Nebraska","Hayes County",2,38,10,5,5
050,31,085,"Nebraska","Hayes County",2,39,9,4,5
050,31,085,"Nebraska","Hayes County",2,40,12,5,7
050,31,085,"Nebraska","Hayes County",2,41,11,5,6
050,31,085,"Nebraska","Hayes County",2,42,7,3,4
050,31,085,"Nebraska","Hayes County",2,43,7,5,2
050,31,085,"Nebraska","Hayes County",2,44,6,3,3
050,31,085,"Nebraska","Hayes County",2,45,7,3,4
050,31,085,"Nebraska","Hayes County",2,46,5,1,4
050,31,085,"Nebraska","Hayes County",2,47,6,2,4
050,31,085,"Nebraska","Hayes County",2,48,6,2,4
050,31,085,"Nebraska","Hayes County",2,49,6,4,2
050,31,085,"Nebraska","Hayes County",2,50,3,2,1
050,31,085,"Nebraska","Hayes County",2,51,3,1,2
050,31,085,"Nebraska","Hayes County",2,52,3,2,1
050,31,085,"Nebraska","Hayes County",2,53,5,3,2
050,31,085,"Nebraska","Hayes County",2,54,8,4,4
050,31,085,"Nebraska","Hayes County",2,55,12,6,6
050,31,085,"Nebraska","Hayes County",2,56,11,7,4
050,31,085,"Nebraska","Hayes County",2,57,16,9,7
050,31,085,"Nebraska","Hayes County",2,58,13,5,8
050,31,085,"Nebraska","Hayes County",2,59,14,7,7
050,31,085,"Nebraska","Hayes County",2,60,17,9,8
050,31,085,"Nebraska","Hayes County",2,61,18,10,8
050,31,085,"Nebraska","Hayes County",2,62,21,10,11
050,31,085,"Nebraska","Hayes County",2,63,15,8,7
050,31,085,"Nebraska","Hayes County",2,64,12,6,6
050,31,085,"Nebraska","Hayes County",2,65,14,8,6
050,31,085,"Nebraska","Hayes County",2,66,14,9,5
050,31,085,"Nebraska","Hayes County",2,67,13,7,6
050,31,085,"Nebraska","Hayes County",2,68,16,7,9
050,31,085,"Nebraska","Hayes County",2,69,13,6,7
050,31,085,"Nebraska","Hayes County",2,70,8,5,3
050,31,085,"Nebraska","Hayes County",2,71,11,7,4
050,31,085,"Nebraska","Hayes County",2,72,13,9,4
050,31,085,"Nebraska","Hayes County",2,73,10,7,3
050,31,085,"Nebraska","Hayes County",2,74,8,4,4
050,31,085,"Nebraska","Hayes County",2,75,9,5,4
050,31,085,"Nebraska","Hayes County",2,76,8,4,4
050,31,085,"Nebraska","Hayes County",2,77,8,4,4
050,31,085,"Nebraska","Hayes County",2,78,9,5,4
050,31,085,"Nebraska","Hayes County",2,79,5,2,3
050,31,085,"Nebraska","Hayes County",2,80,4,1,3
050,31,085,"Nebraska","Hayes County",2,81,4,1,3
050,31,085,"Nebraska","Hayes County",2,82,6,3,3
050,31,085,"Nebraska","Hayes County",2,83,7,4,3
050,31,085,"Nebraska","Hayes County",2,84,7,4,3
050,31,085,"Nebraska","Hayes County",2,85,39,19,20
050,31,085,"Nebraska","Hayes County",3,0,14,4,10
050,31,085,"Nebraska","Hayes County",3,1,10,5,5
050,31,085,"Nebraska","Hayes County",3,2,14,8,6
050,31,085,"Nebraska","Hayes County",3,3,12,6,6
050,31,085,"Nebraska","Hayes County",3,4,11,5,6
050,31,085,"Nebraska","Hayes County",3,5,19,9,10
050,31,085,"Nebraska","Hayes County",3,6,11,5,6
050,31,085,"Nebraska","Hayes County",3,7,9,5,4
050,31,085,"Nebraska","Hayes County",3,8,6,2,4
050,31,085,"Nebraska","Hayes County",3,9,9,3,6
050,31,085,"Nebraska","Hayes County",3,10,10,3,7
050,31,085,"Nebraska","Hayes County",3,11,12,5,7
050,31,085,"Nebraska","Hayes County",3,12,13,8,5
050,31,085,"Nebraska","Hayes County",3,13,12,7,5
050,31,085,"Nebraska","Hayes County",3,14,12,5,7
050,31,085,"Nebraska","Hayes County",3,15,9,6,3
050,31,085,"Nebraska","Hayes County",3,16,11,6,5
050,31,085,"Nebraska","Hayes County",3,17,11,5,6
050,31,085,"Nebraska","Hayes County",3,18,9,6,3
050,31,085,"Nebraska","Hayes County",3,19,6,2,4
050,31,085,"Nebraska","Hayes County",3,20,5,2,3
050,31,085,"Nebraska","Hayes County",3,21,4,2,2
050,31,085,"Nebraska","Hayes County",3,22,3,3,0
050,31,085,"Nebraska","Hayes County",3,23,6,4,2
050,31,085,"Nebraska","Hayes County",3,24,6,5,1
050,31,085,"Nebraska","Hayes County",3,25,9,4,5
050,31,085,"Nebraska","Hayes County",3,26,9,6,3
050,31,085,"Nebraska","Hayes County",3,27,8,3,5
050,31,085,"Nebraska","Hayes County",3,28,5,1,4
050,31,085,"Nebraska","Hayes County",3,29,9,4,5
050,31,085,"Nebraska","Hayes County",3,30,8,5,3
050,31,085,"Nebraska","Hayes County",3,31,9,5,4
050,31,085,"Nebraska","Hayes County",3,32,10,4,6
050,31,085,"Nebraska","Hayes County",3,33,8,6,2
050,31,085,"Nebraska","Hayes County",3,34,9,7,2
050,31,085,"Nebraska","Hayes County",3,35,9,4,5
050,31,085,"Nebraska","Hayes County",3,36,10,5,5
050,31,085,"Nebraska","Hayes County",3,37,7,5,2
050,31,085,"Nebraska","Hayes County",3,38,12,9,3
050,31,085,"Nebraska","Hayes County",3,39,11,5,6
050,31,085,"Nebraska","Hayes County",3,40,9,4,5
050,31,085,"Nebraska","Hayes County",3,41,11,5,6
050,31,085,"Nebraska","Hayes County",3,42,12,5,7
050,31,085,"Nebraska","Hayes County",3,43,4,3,1
050,31,085,"Nebraska","Hayes County",3,44,6,4,2
050,31,085,"Nebraska","Hayes County",3,45,8,5,3
050,31,085,"Nebraska","Hayes County",3,46,7,3,4
050,31,085,"Nebraska","Hayes County",3,47,5,1,4
050,31,085,"Nebraska","Hayes County",3,48,6,2,4
050,31,085,"Nebraska","Hayes County",3,49,6,2,4
050,31,085,"Nebraska","Hayes County",3,50,6,4,2
050,31,085,"Nebraska","Hayes County",3,51,3,2,1
050,31,085,"Nebraska","Hayes County",3,52,3,1,2
050,31,085,"Nebraska","Hayes County",3,53,3,2,1
050,31,085,"Nebraska","Hayes County",3,54,5,3,2
050,31,085,"Nebraska","Hayes County",3,55,9,4,5
050,31,085,"Nebraska","Hayes County",3,56,12,6,6
050,31,085,"Nebraska","Hayes County",3,57,11,7,4
050,31,085,"Nebraska","Hayes County",3,58,17,9,8
050,31,085,"Nebraska","Hayes County",3,59,14,6,8
050,31,085,"Nebraska","Hayes County",3,60,14,7,7
050,31,085,"Nebraska","Hayes County",3,61,17,9,8
050,31,085,"Nebraska","Hayes County",3,62,18,10,8
050,31,085,"Nebraska","Hayes County",3,63,21,10,11
050,31,085,"Nebraska","Hayes County",3,64,15,8,7
050,31,085,"Nebraska","Hayes County",3,65,12,6,6
050,31,085,"Nebraska","Hayes County",3,66,14,8,6
050,31,085,"Nebraska","Hayes County",3,67,14,9,5
050,31,085,"Nebraska","Hayes County",3,68,13,7,6
050,31,085,"Nebraska","Hayes County",3,69,16,7,9
050,31,085,"Nebraska","Hayes County",3,70,13,6,7
050,31,085,"Nebraska","Hayes County",3,71,8,5,3
050,31,085,"Nebraska","Hayes County",3,72,11,7,4
050,31,085,"Nebraska","Hayes County",3,73,13,9,4
050,31,085,"Nebraska","Hayes County",3,74,10,7,3
050,31,085,"Nebraska","Hayes County",3,75,8,4,4
050,31,085,"Nebraska","Hayes County",3,76,9,5,4
050,31,085,"Nebraska","Hayes County",3,77,7,4,3
050,31,085,"Nebraska","Hayes County",3,78,8,4,4
050,31,085,"Nebraska","Hayes County",3,79,9,5,4
050,31,085,"Nebraska","Hayes County",3,80,4,2,2
050,31,085,"Nebraska","Hayes County",3,81,4,1,3
050,31,085,"Nebraska","Hayes County",3,82,3,1,2
050,31,085,"Nebraska","Hayes County",3,83,5,2,3
050,31,085,"Nebraska","Hayes County",3,84,6,3,3
050,31,085,"Nebraska","Hayes County",3,85,44,22,22
050,31,085,"Nebraska","Hayes County",4,0,11,4,7
050,31,085,"Nebraska","Hayes County",4,1,14,4,10
050,31,085,"Nebraska","Hayes County",4,2,14,7,7
050,31,085,"Nebraska","Hayes County",4,3,14,8,6
050,31,085,"Nebraska","Hayes County",4,4,11,5,6
050,31,085,"Nebraska","Hayes County",4,5,13,5,8
050,31,085,"Nebraska","Hayes County",4,6,20,9,11
050,31,085,"Nebraska","Hayes County",4,7,11,5,6
050,31,085,"Nebraska","Hayes County",4,8,13,8,5
050,31,085,"Nebraska","Hayes County",4,9,8,2,6
050,31,085,"Nebraska","Hayes County",4,10,10,4,6
050,31,085,"Nebraska","Hayes County",4,11,12,3,9
050,31,085,"Nebraska","Hayes County",4,12,13,5,8
050,31,085,"Nebraska","Hayes County",4,13,14,9,5
050,31,085,"Nebraska","Hayes County",4,14,12,7,5
050,31,085,"Nebraska","Hayes County",4,15,13,5,8
050,31,085,"Nebraska","Hayes County",4,16,11,7,4
050,31,085,"Nebraska","Hayes County",4,17,8,4,4
050,31,085,"Nebraska","Hayes County",4,18,7,3,4
050,31,085,"Nebraska","Hayes County",4,19,8,5,3
050,31,085,"Nebraska","Hayes County",4,20,7,2,5
050,31,085,"Nebraska","Hayes County",4,21,3,1,2
050,31,085,"Nebraska","Hayes County",4,22,3,2,1
050,31,085,"Nebraska","Hayes County",4,23,5,4,1
050,31,085,"Nebraska","Hayes County",4,24,7,4,3
050,31,085,"Nebraska","Hayes County",4,25,7,5,2
050,31,085,"Nebraska","Hayes County",4,26,13,6,7
050,31,085,"Nebraska","Hayes County",4,27,8,6,2
050,31,085,"Nebraska","Hayes County",4,28,4,2,2
050,31,085,"Nebraska","Hayes County",4,29,7,2,5
050,31,085,"Nebraska","Hayes County",4,30,9,4,5
050,31,085,"Nebraska","Hayes County",4,31,8,5,3
050,31,085,"Nebraska","Hayes County",4,32,11,5,6
050,31,085,"Nebraska","Hayes County",4,33,9,4,5
050,31,085,"Nebraska","Hayes County",4,34,10,7,3
050,31,085,"Nebraska","Hayes County",4,35,7,5,2
050,31,085,"Nebraska","Hayes County",4,36,9,5,4
050,31,085,"Nebraska","Hayes County",4,37,9,4,5
050,31,085,"Nebraska","Hayes County",4,38,7,5,2
050,31,085,"Nebraska","Hayes County",4,39,13,9,4
050,31,085,"Nebraska","Hayes County",4,40,13,5,8
050,31,085,"Nebraska","Hayes County",4,41,9,4,5
050,31,085,"Nebraska","Hayes County",4,42,10,5,5
050,31,085,"Nebraska","Hayes County",4,43,11,5,6
050,31,085,"Nebraska","Hayes County",4,44,4,3,1
050,31,085,"Nebraska","Hayes County",4,45,7,4,3
050,31,085,"Nebraska","Hayes County",4,46,8,5,3
050,31,085,"Nebraska","Hayes County",4,47,6,3,3
050,31,085,"Nebraska","Hayes County",4,48,5,1,4
050,31,085,"Nebraska","Hayes County",4,49,6,2,4
050,31,085,"Nebraska","Hayes County",4,50,6,2,4
050,31,085,"Nebraska","Hayes County",4,51,7,5,2
050,31,085,"Nebraska","Hayes County",4,52,3,3,0
050,31,085,"Nebraska","Hayes County",4,53,6,4,2
050,31,085,"Nebraska","Hayes County",4,54,3,2,1
050,31,085,"Nebraska","Hayes County",4,55,5,3,2
050,31,085,"Nebraska","Hayes County",4,56,9,4,5
050,31,085,"Nebraska","Hayes County",4,57,10,4,6
050,31,085,"Nebraska","Hayes County",4,58,10,6,4
050,31,085,"Nebraska","Hayes County",4,59,16,8,8
050,31,085,"Nebraska","Hayes County",4,60,14,6,8
050,31,085,"Nebraska","Hayes County",4,61,14,7,7
050,31,085,"Nebraska","Hayes County",4,62,17,9,8
050,31,085,"Nebraska","Hayes County",4,63,18,10,8
050,31,085,"Nebraska","Hayes County",4,64,21,10,11
050,31,085,"Nebraska","Hayes County",4,65,14,8,6
050,31,085,"Nebraska","Hayes County",4,66,13,6,7
050,31,085,"Nebraska","Hayes County",4,67,11,6,5
050,31,085,"Nebraska","Hayes County",4,68,15,9,6
050,31,085,"Nebraska","Hayes County",4,69,13,7,6
050,31,085,"Nebraska","Hayes County",4,70,15,6,9
050,31,085,"Nebraska","Hayes County",4,71,13,6,7
050,31,085,"Nebraska","Hayes County",4,72,8,5,3
050,31,085,"Nebraska","Hayes County",4,73,11,7,4
050,31,085,"Nebraska","Hayes County",4,74,12,8,4
050,31,085,"Nebraska","Hayes County",4,75,9,6,3
050,31,085,"Nebraska","Hayes County",4,76,8,4,4
050,31,085,"Nebraska","Hayes County",4,77,8,5,3
050,31,085,"Nebraska","Hayes County",4,78,6,4,2
050,31,085,"Nebraska","Hayes County",4,79,7,3,4
050,31,085,"Nebraska","Hayes County",4,80,7,3,4
050,31,085,"Nebraska","Hayes County",4,81,4,2,2
050,31,085,"Nebraska","Hayes County",4,82,3,0,3
050,31,085,"Nebraska","Hayes County",4,83,3,1,2
050,31,085,"Nebraska","Hayes County",4,84,5,2,3
050,31,085,"Nebraska","Hayes County",4,85,48,23,25
050,31,085,"Nebraska","Hayes County",5,0,10,3,7
050,31,085,"Nebraska","Hayes County",5,1,13,6,7
050,31,085,"Nebraska","Hayes County",5,2,16,6,10
050,31,085,"Nebraska","Hayes County",5,3,11,5,6
050,31,085,"Nebraska","Hayes County",5,4,13,7,6
050,31,085,"Nebraska","Hayes County",5,5,10,3,7
050,31,085,"Nebraska","Hayes County",5,6,16,8,8
050,31,085,"Nebraska","Hayes County",5,7,18,8,10
050,31,085,"Nebraska","Hayes County",5,8,17,10,7
050,31,085,"Nebraska","Hayes County",5,9,13,8,5
050,31,085,"Nebraska","Hayes County",5,10,7,2,5
050,31,085,"Nebraska","Hayes County",5,11,6,2,4
050,31,085,"Nebraska","Hayes County",5,12,11,3,8
050,31,085,"Nebraska","Hayes County",5,13,13,5,8
050,31,085,"Nebraska","Hayes County",5,14,12,7,5
050,31,085,"Nebraska","Hayes County",5,15,12,7,5
050,31,085,"Nebraska","Hayes County",5,16,11,6,5
050,31,085,"Nebraska","Hayes County",5,17,8,7,1
050,31,085,"Nebraska","Hayes County",5,18,6,3,3
050,31,085,"Nebraska","Hayes County",5,19,4,1,3
050,31,085,"Nebraska","Hayes County",5,20,8,5,3
050,31,085,"Nebraska","Hayes County",5,21,6,2,4
050,31,085,"Nebraska","Hayes County",5,22,4,1,3
050,31,085,"Nebraska","Hayes County",5,23,6,3,3
050,31,085,"Nebraska","Hayes County",5,24,5,4,1
050,31,085,"Nebraska","Hayes County",5,25,7,5,2
050,31,085,"Nebraska","Hayes County",5,26,10,6,4
050,31,085,"Nebraska","Hayes County",5,27,10,3,7
050,31,085,"Nebraska","Hayes County",5,28,9,7,2
050,31,085,"Nebraska","Hayes County",5,29,6,3,3
050,31,085,"Nebraska","Hayes County",5,30,4,1,3
050,31,085,"Nebraska","Hayes County",5,31,9,4,5
050,31,085,"Nebraska","Hayes County",5,32,9,5,4
050,31,085,"Nebraska","Hayes County",5,33,10,4,6
050,31,085,"Nebraska","Hayes County",5,34,7,3,4
050,31,085,"Nebraska","Hayes County",5,35,12,9,3
050,31,085,"Nebraska","Hayes County",5,36,7,5,2
050,31,085,"Nebraska","Hayes County",5,37,9,6,3
050,31,085,"Nebraska","Hayes County",5,38,8,3,5
050,31,085,"Nebraska","Hayes County",5,39,8,6,2
050,31,085,"Nebraska","Hayes County",5,40,12,8,4
050,31,085,"Nebraska","Hayes County",5,41,10,3,7
050,31,085,"Nebraska","Hayes County",5,42,9,4,5
050,31,085,"Nebraska","Hayes County",5,43,10,5,5
050,31,085,"Nebraska","Hayes County",5,44,9,4,5
050,31,085,"Nebraska","Hayes County",5,45,6,3,3
050,31,085,"Nebraska","Hayes County",5,46,7,4,3
050,31,085,"Nebraska","Hayes County",5,47,6,3,3
050,31,085,"Nebraska","Hayes County",5,48,6,3,3
050,31,085,"Nebraska","Hayes County",5,49,5,1,4
050,31,085,"Nebraska","Hayes County",5,50,6,2,4
050,31,085,"Nebraska","Hayes County",5,51,6,2,4
050,31,085,"Nebraska","Hayes County",5,52,6,4,2
050,31,085,"Nebraska","Hayes County",5,53,3,3,0
050,31,085,"Nebraska","Hayes County",5,54,6,4,2
050,31,085,"Nebraska","Hayes County",5,55,3,2,1
050,31,085,"Nebraska","Hayes County",5,56,6,3,3
050,31,085,"Nebraska","Hayes County",5,57,9,4,5
050,31,085,"Nebraska","Hayes County",5,58,10,4,6
050,31,085,"Nebraska","Hayes County",5,59,10,6,4
050,31,085,"Nebraska","Hayes County",5,60,15,7,8
050,31,085,"Nebraska","Hayes County",5,61,14,6,8
050,31,085,"Nebraska","Hayes County",5,62,14,7,7
050,31,085,"Nebraska","Hayes County",5,63,17,9,8
050,31,085,"Nebraska","Hayes County",5,64,18,10,8
050,31,085,"Nebraska","Hayes County",5,65,21,10,11
050,31,085,"Nebraska","Hayes County",5,66,14,8,6
050,31,085,"Nebraska","Hayes County",5,67,12,5,7
050,31,085,"Nebraska","Hayes County",5,68,12,6,6
050,31,085,"Nebraska","Hayes County",5,69,15,9,6
050,31,085,"Nebraska","Hayes County",5,70,13,7,6
050,31,085,"Nebraska","Hayes County",5,71,13,5,8
050,31,085,"Nebraska","Hayes County",5,72,13,6,7
050,31,085,"Nebraska","Hayes County",5,73,8,5,3
050,31,085,"Nebraska","Hayes County",5,74,11,7,4
050,31,085,"Nebraska","Hayes County",5,75,10,6,4
050,31,085,"Nebraska","Hayes County",5,76,9,6,3
050,31,085,"Nebraska","Hayes County",5,77,6,4,2
050,31,085,"Nebraska","Hayes County",5,78,6,5,1
050,31,085,"Nebraska","Hayes County",5,79,6,4,2
050,31,085,"Nebraska","Hayes County",5,80,7,3,4
050,31,085,"Nebraska","Hayes County",5,81,6,3,3
050,31,085,"Nebraska","Hayes County",5,82,3,1,2
050,31,085,"Nebraska","Hayes County",5,83,3,0,3
050,31,085,"Nebraska","Hayes County",5,84,3,1,2
050,31,085,"Nebraska","Hayes County",5,85,51,23,28
050,31,087,"Nebraska","Hitchcock County",1,0,21,11,10
050,31,087,"Nebraska","Hitchcock County",1,1,22,11,11
050,31,087,"Nebraska","Hitchcock County",1,2,28,15,13
050,31,087,"Nebraska","Hitchcock County",1,3,37,25,12
050,31,087,"Nebraska","Hitchcock County",1,4,29,18,11
050,31,087,"Nebraska","Hitchcock County",1,5,41,21,20
050,31,087,"Nebraska","Hitchcock County",1,6,30,12,18
050,31,087,"Nebraska","Hitchcock County",1,7,32,14,18
050,31,087,"Nebraska","Hitchcock County",1,8,36,16,20
050,31,087,"Nebraska","Hitchcock County",1,9,30,13,17
050,31,087,"Nebraska","Hitchcock County",1,10,26,16,10
050,31,087,"Nebraska","Hitchcock County",1,11,38,23,15
050,31,087,"Nebraska","Hitchcock County",1,12,52,31,21
050,31,087,"Nebraska","Hitchcock County",1,13,32,17,15
050,31,087,"Nebraska","Hitchcock County",1,14,36,20,16
050,31,087,"Nebraska","Hitchcock County",1,15,45,23,22
050,31,087,"Nebraska","Hitchcock County",1,16,42,24,18
050,31,087,"Nebraska","Hitchcock County",1,17,37,23,14
050,31,087,"Nebraska","Hitchcock County",1,18,29,16,13
050,31,087,"Nebraska","Hitchcock County",1,19,23,10,13
050,31,087,"Nebraska","Hitchcock County",1,20,21,11,10
050,31,087,"Nebraska","Hitchcock County",1,21,20,9,11
050,31,087,"Nebraska","Hitchcock County",1,22,15,8,7
050,31,087,"Nebraska","Hitchcock County",1,23,16,9,7
050,31,087,"Nebraska","Hitchcock County",1,24,17,10,7
050,31,087,"Nebraska","Hitchcock County",1,25,18,6,12
050,31,087,"Nebraska","Hitchcock County",1,26,23,10,13
050,31,087,"Nebraska","Hitchcock County",1,27,25,15,10
050,31,087,"Nebraska","Hitchcock County",1,28,20,7,13
050,31,087,"Nebraska","Hitchcock County",1,29,24,10,14
050,31,087,"Nebraska","Hitchcock County",1,30,20,10,10
050,31,087,"Nebraska","Hitchcock County",1,31,23,13,10
050,31,087,"Nebraska","Hitchcock County",1,32,24,12,12
050,31,087,"Nebraska","Hitchcock County",1,33,20,11,9
050,31,087,"Nebraska","Hitchcock County",1,34,27,14,13
050,31,087,"Nebraska","Hitchcock County",1,35,30,14,16
050,31,087,"Nebraska","Hitchcock County",1,36,27,13,14
050,31,087,"Nebraska","Hitchcock County",1,37,37,22,15
050,31,087,"Nebraska","Hitchcock County",1,38,34,17,17
050,31,087,"Nebraska","Hitchcock County",1,39,34,14,20
050,31,087,"Nebraska","Hitchcock County",1,40,41,21,20
050,31,087,"Nebraska","Hitchcock County",1,41,36,22,14
050,31,087,"Nebraska","Hitchcock County",1,42,25,17,8
050,31,087,"Nebraska","Hitchcock County",1,43,23,13,10
050,31,087,"Nebraska","Hitchcock County",1,44,23,8,15
050,31,087,"Nebraska","Hitchcock County",1,45,24,10,14
050,31,087,"Nebraska","Hitchcock County",1,46,23,12,11
050,31,087,"Nebraska","Hitchcock County",1,47,27,13,14
050,31,087,"Nebraska","Hitchcock County",1,48,26,15,11
050,31,087,"Nebraska","Hitchcock County",1,49,30,18,12
050,31,087,"Nebraska","Hitchcock County",1,50,30,16,14
050,31,087,"Nebraska","Hitchcock County",1,51,29,11,18
050,31,087,"Nebraska","Hitchcock County",1,52,24,10,14
050,31,087,"Nebraska","Hitchcock County",1,53,21,10,11
050,31,087,"Nebraska","Hitchcock County",1,54,25,13,12
050,31,087,"Nebraska","Hitchcock County",1,55,33,18,15
050,31,087,"Nebraska","Hitchcock County",1,56,30,15,15
050,31,087,"Nebraska","Hitchcock County",1,57,37,18,19
050,31,087,"Nebraska","Hitchcock County",1,58,47,23,24
050,31,087,"Nebraska","Hitchcock County",1,59,48,25,23
050,31,087,"Nebraska","Hitchcock County",1,60,41,23,18
050,31,087,"Nebraska","Hitchcock County",1,61,39,20,19
050,31,087,"Nebraska","Hitchcock County",1,62,38,16,22
050,31,087,"Nebraska","Hitchcock County",1,63,34,17,17
050,31,087,"Nebraska","Hitchcock County",1,64,34,20,14
050,31,087,"Nebraska","Hitchcock County",1,65,37,21,16
050,31,087,"Nebraska","Hitchcock County",1,66,47,27,20
050,31,087,"Nebraska","Hitchcock County",1,67,40,19,21
050,31,087,"Nebraska","Hitchcock County",1,68,45,23,22
050,31,087,"Nebraska","Hitchcock County",1,69,45,21,24
050,31,087,"Nebraska","Hitchcock County",1,70,42,19,23
050,31,087,"Nebraska","Hitchcock County",1,71,44,25,19
050,31,087,"Nebraska","Hitchcock County",1,72,32,19,13
050,31,087,"Nebraska","Hitchcock County",1,73,37,17,20
050,31,087,"Nebraska","Hitchcock County",1,74,23,8,15
050,31,087,"Nebraska","Hitchcock County",1,75,20,9,11
050,31,087,"Nebraska","Hitchcock County",1,76,20,12,8
050,31,087,"Nebraska","Hitchcock County",1,77,25,11,14
050,31,087,"Nebraska","Hitchcock County",1,78,22,11,11
050,31,087,"Nebraska","Hitchcock County",1,79,20,9,11
050,31,087,"Nebraska","Hitchcock County",1,80,19,10,9
050,31,087,"Nebraska","Hitchcock County",1,81,21,8,13
050,31,087,"Nebraska","Hitchcock County",1,82,23,10,13
050,31,087,"Nebraska","Hitchcock County",1,83,19,8,11
050,31,087,"Nebraska","Hitchcock County",1,84,12,2,10
050,31,087,"Nebraska","Hitchcock County",1,85,90,28,62
050,31,087,"Nebraska","Hitchcock County",2,0,25,11,14
050,31,087,"Nebraska","Hitchcock County",2,1,23,12,11
050,31,087,"Nebraska","Hitchcock County",2,2,27,15,12
050,31,087,"Nebraska","Hitchcock County",2,3,36,23,13
050,31,087,"Nebraska","Hitchcock County",2,4,30,19,11
050,31,087,"Nebraska","Hitchcock County",2,5,38,20,18
050,31,087,"Nebraska","Hitchcock County",2,6,33,15,18
050,31,087,"Nebraska","Hitchcock County",2,7,31,13,18
050,31,087,"Nebraska","Hitchcock County",2,8,35,15,20
050,31,087,"Nebraska","Hitchcock County",2,9,30,14,16
050,31,087,"Nebraska","Hitchcock County",2,10,27,16,11
050,31,087,"Nebraska","Hitchcock County",2,11,36,22,14
050,31,087,"Nebraska","Hitchcock County",2,12,49,29,20
050,31,087,"Nebraska","Hitchcock County",2,13,37,20,17
050,31,087,"Nebraska","Hitchcock County",2,14,37,20,17
050,31,087,"Nebraska","Hitchcock County",2,15,43,23,20
050,31,087,"Nebraska","Hitchcock County",2,16,44,24,20
050,31,087,"Nebraska","Hitchcock County",2,17,38,23,15
050,31,087,"Nebraska","Hitchcock County",2,18,31,18,13
050,31,087,"Nebraska","Hitchcock County",2,19,23,10,13
050,31,087,"Nebraska","Hitchcock County",2,20,22,11,11
050,31,087,"Nebraska","Hitchcock County",2,21,21,10,11
050,31,087,"Nebraska","Hitchcock County",2,22,15,8,7
050,31,087,"Nebraska","Hitchcock County",2,23,15,9,6
050,31,087,"Nebraska","Hitchcock County",2,24,18,10,8
050,31,087,"Nebraska","Hitchcock County",2,25,18,7,11
050,31,087,"Nebraska","Hitchcock County",2,26,23,9,14
050,31,087,"Nebraska","Hitchcock County",2,27,25,14,11
050,31,087,"Nebraska","Hitchcock County",2,28,21,8,13
050,31,087,"Nebraska","Hitchcock County",2,29,22,9,13
050,31,087,"Nebraska","Hitchcock County",2,30,21,10,11
050,31,087,"Nebraska","Hitchcock County",2,31,22,12,10
050,31,087,"Nebraska","Hitchcock County",2,32,23,12,11
050,31,087,"Nebraska","Hitchcock County",2,33,22,12,10
050,31,087,"Nebraska","Hitchcock County",2,34,25,13,12
050,31,087,"Nebraska","Hitchcock County",2,35,28,13,15
050,31,087,"Nebraska","Hitchcock County",2,36,27,13,14
050,31,087,"Nebraska","Hitchcock County",2,37,34,19,15
050,31,087,"Nebraska","Hitchcock County",2,38,35,19,16
050,31,087,"Nebraska","Hitchcock County",2,39,34,14,20
050,31,087,"Nebraska","Hitchcock County",2,40,39,19,20
050,31,087,"Nebraska","Hitchcock County",2,41,37,21,16
050,31,087,"Nebraska","Hitchcock County",2,42,28,18,10
050,31,087,"Nebraska","Hitchcock County",2,43,25,15,10
050,31,087,"Nebraska","Hitchcock County",2,44,23,9,14
050,31,087,"Nebraska","Hitchcock County",2,45,24,10,14
050,31,087,"Nebraska","Hitchcock County",2,46,23,11,12
050,31,087,"Nebraska","Hitchcock County",2,47,26,13,13
050,31,087,"Nebraska","Hitchcock County",2,48,26,15,11
050,31,087,"Nebraska","Hitchcock County",2,49,30,18,12
050,31,087,"Nebraska","Hitchcock County",2,50,30,16,14
050,31,087,"Nebraska","Hitchcock County",2,51,30,12,18
050,31,087,"Nebraska","Hitchcock County",2,52,25,10,15
050,31,087,"Nebraska","Hitchcock County",2,53,22,10,12
050,31,087,"Nebraska","Hitchcock County",2,54,24,12,12
050,31,087,"Nebraska","Hitchcock County",2,55,32,17,15
050,31,087,"Nebraska","Hitchcock County",2,56,31,16,15
050,31,087,"Nebraska","Hitchcock County",2,57,35,17,18
050,31,087,"Nebraska","Hitchcock County",2,58,45,22,23
050,31,087,"Nebraska","Hitchcock County",2,59,48,25,23
050,31,087,"Nebraska","Hitchcock County",2,60,42,23,19
050,31,087,"Nebraska","Hitchcock County",2,61,40,21,19
050,31,087,"Nebraska","Hitchcock County",2,62,38,17,21
050,31,087,"Nebraska","Hitchcock County",2,63,35,17,18
050,31,087,"Nebraska","Hitchcock County",2,64,34,19,15
050,31,087,"Nebraska","Hitchcock County",2,65,37,21,16
050,31,087,"Nebraska","Hitchcock County",2,66,44,26,18
050,31,087,"Nebraska","Hitchcock County",2,67,42,21,21
050,31,087,"Nebraska","Hitchcock County",2,68,42,22,20
050,31,087,"Nebraska","Hitchcock County",2,69,45,22,23
050,31,087,"Nebraska","Hitchcock County",2,70,42,19,23
050,31,087,"Nebraska","Hitchcock County",2,71,43,23,20
050,31,087,"Nebraska","Hitchcock County",2,72,34,20,14
050,31,087,"Nebraska","Hitchcock County",2,73,39,19,20
050,31,087,"Nebraska","Hitchcock County",2,74,24,9,15
050,31,087,"Nebraska","Hitchcock County",2,75,20,8,12
050,31,087,"Nebraska","Hitchcock County",2,76,19,11,8
050,31,087,"Nebraska","Hitchcock County",2,77,25,12,13
050,31,087,"Nebraska","Hitchcock County",2,78,22,11,11
050,31,087,"Nebraska","Hitchcock County",2,79,20,9,11
050,31,087,"Nebraska","Hitchcock County",2,80,19,10,9
050,31,087,"Nebraska","Hitchcock County",2,81,20,8,12
050,31,087,"Nebraska","Hitchcock County",2,82,23,10,13
050,31,087,"Nebraska","Hitchcock County",2,83,19,8,11
050,31,087,"Nebraska","Hitchcock County",2,84,14,4,10
050,31,087,"Nebraska","Hitchcock County",2,85,89,27,62
050,31,087,"Nebraska","Hitchcock County",3,0,31,24,7
050,31,087,"Nebraska","Hitchcock County",3,1,24,11,13
050,31,087,"Nebraska","Hitchcock County",3,2,28,17,11
050,31,087,"Nebraska","Hitchcock County",3,3,31,15,16
050,31,087,"Nebraska","Hitchcock County",3,4,34,23,11
050,31,087,"Nebraska","Hitchcock County",3,5,27,18,9
050,31,087,"Nebraska","Hitchcock County",3,6,36,19,17
050,31,087,"Nebraska","Hitchcock County",3,7,35,17,18
050,31,087,"Nebraska","Hitchcock County",3,8,29,11,18
050,31,087,"Nebraska","Hitchcock County",3,9,40,16,24
050,31,087,"Nebraska","Hitchcock County",3,10,31,14,17
050,31,087,"Nebraska","Hitchcock County",3,11,26,14,12
050,31,087,"Nebraska","Hitchcock County",3,12,36,23,13
050,31,087,"Nebraska","Hitchcock County",3,13,50,31,19
050,31,087,"Nebraska","Hitchcock County",3,14,37,20,17
050,31,087,"Nebraska","Hitchcock County",3,15,33,19,14
050,31,087,"Nebraska","Hitchcock County",3,16,43,22,21
050,31,087,"Nebraska","Hitchcock County",3,17,44,24,20
050,31,087,"Nebraska","Hitchcock County",3,18,30,19,11
050,31,087,"Nebraska","Hitchcock County",3,19,22,14,8
050,31,087,"Nebraska","Hitchcock County",3,20,23,10,13
050,31,087,"Nebraska","Hitchcock County",3,21,22,11,11
050,31,087,"Nebraska","Hitchcock County",3,22,23,13,10
050,31,087,"Nebraska","Hitchcock County",3,23,16,10,6
050,31,087,"Nebraska","Hitchcock County",3,24,17,8,9
050,31,087,"Nebraska","Hitchcock County",3,25,18,9,9
050,31,087,"Nebraska","Hitchcock County",3,26,23,14,9
050,31,087,"Nebraska","Hitchcock County",3,27,24,9,15
050,31,087,"Nebraska","Hitchcock County",3,28,27,16,11
050,31,087,"Nebraska","Hitchcock County",3,29,20,9,11
050,31,087,"Nebraska","Hitchcock County",3,30,22,10,12
050,31,087,"Nebraska","Hitchcock County",3,31,24,13,11
050,31,087,"Nebraska","Hitchcock County",3,32,22,12,10
050,31,087,"Nebraska","Hitchcock County",3,33,23,12,11
050,31,087,"Nebraska","Hitchcock County",3,34,22,12,10
050,31,087,"Nebraska","Hitchcock County",3,35,28,17,11
050,31,087,"Nebraska","Hitchcock County",3,36,30,16,14
050,31,087,"Nebraska","Hitchcock County",3,37,26,11,15
050,31,087,"Nebraska","Hitchcock County",3,38,33,20,13
050,31,087,"Nebraska","Hitchcock County",3,39,32,18,14
050,31,087,"Nebraska","Hitchcock County",3,40,34,14,20
050,31,087,"Nebraska","Hitchcock County",3,41,38,20,18
050,31,087,"Nebraska","Hitchcock County",3,42,36,21,15
050,31,087,"Nebraska","Hitchcock County",3,43,27,17,10
050,31,087,"Nebraska","Hitchcock County",3,44,24,14,10
050,31,087,"Nebraska","Hitchcock County",3,45,21,7,14
050,31,087,"Nebraska","Hitchcock County",3,46,25,10,15
050,31,087,"Nebraska","Hitchcock County",3,47,23,11,12
050,31,087,"Nebraska","Hitchcock County",3,48,25,13,12
050,31,087,"Nebraska","Hitchcock County",3,49,27,15,12
050,31,087,"Nebraska","Hitchcock County",3,50,31,18,13
050,31,087,"Nebraska","Hitchcock County",3,51,28,15,13
050,31,087,"Nebraska","Hitchcock County",3,52,27,10,17
050,31,087,"Nebraska","Hitchcock County",3,53,27,12,15
050,31,087,"Nebraska","Hitchcock County",3,54,22,10,12
050,31,087,"Nebraska","Hitchcock County",3,55,25,12,13
050,31,087,"Nebraska","Hitchcock County",3,56,32,17,15
050,31,087,"Nebraska","Hitchcock County",3,57,29,16,13
050,31,087,"Nebraska","Hitchcock County",3,58,35,17,18
050,31,087,"Nebraska","Hitchcock County",3,59,47,23,24
050,31,087,"Nebraska","Hitchcock County",3,60,47,24,23
050,31,087,"Nebraska","Hitchcock County",3,61,38,19,19
050,31,087,"Nebraska","Hitchcock County",3,62,42,21,21
050,31,087,"Nebraska","Hitchcock County",3,63,37,16,21
050,31,087,"Nebraska","Hitchcock County",3,64,36,18,18
050,31,087,"Nebraska","Hitchcock County",3,65,33,17,16
050,31,087,"Nebraska","Hitchcock County",3,66,37,20,17
050,31,087,"Nebraska","Hitchcock County",3,67,44,27,17
050,31,087,"Nebraska","Hitchcock County",3,68,38,18,20
050,31,087,"Nebraska","Hitchcock County",3,69,40,22,18
050,31,087,"Nebraska","Hitchcock County",3,70,46,22,24
050,31,087,"Nebraska","Hitchcock County",3,71,40,17,23
050,31,087,"Nebraska","Hitchcock County",3,72,39,22,17
050,31,087,"Nebraska","Hitchcock County",3,73,33,20,13
050,31,087,"Nebraska","Hitchcock County",3,74,40,19,21
050,31,087,"Nebraska","Hitchcock County",3,75,25,9,16
050,31,087,"Nebraska","Hitchcock County",3,76,19,7,12
050,31,087,"Nebraska","Hitchcock County",3,77,15,8,7
050,31,087,"Nebraska","Hitchcock County",3,78,21,6,15
050,31,087,"Nebraska","Hitchcock County",3,79,23,13,10
050,31,087,"Nebraska","Hitchcock County",3,80,18,8,10
050,31,087,"Nebraska","Hitchcock County",3,81,20,11,9
050,31,087,"Nebraska","Hitchcock County",3,82,19,7,12
050,31,087,"Nebraska","Hitchcock County",3,83,22,10,12
050,31,087,"Nebraska","Hitchcock County",3,84,17,6,11
050,31,087,"Nebraska","Hitchcock County",3,85,85,25,60
050,31,087,"Nebraska","Hitchcock County",4,0,30,19,11
050,31,087,"Nebraska","Hitchcock County",4,1,33,26,7
050,31,087,"Nebraska","Hitchcock County",4,2,29,14,15
050,31,087,"Nebraska","Hitchcock County",4,3,26,15,11
050,31,087,"Nebraska","Hitchcock County",4,4,36,20,16
050,31,087,"Nebraska","Hitchcock County",4,5,41,26,15
050,31,087,"Nebraska","Hitchcock County",4,6,29,17,12
050,31,087,"Nebraska","Hitchcock County",4,7,36,19,17
050,31,087,"Nebraska","Hitchcock County",4,8,33,16,17
050,31,087,"Nebraska","Hitchcock County",4,9,31,12,19
050,31,087,"Nebraska","Hitchcock County",4,10,44,21,23
050,31,087,"Nebraska","Hitchcock County",4,11,31,15,16
050,31,087,"Nebraska","Hitchcock County",4,12,27,15,12
050,31,087,"Nebraska","Hitchcock County",4,13,37,23,14
050,31,087,"Nebraska","Hitchcock County",4,14,51,29,22
050,31,087,"Nebraska","Hitchcock County",4,15,35,18,17
050,31,087,"Nebraska","Hitchcock County",4,16,35,18,17
050,31,087,"Nebraska","Hitchcock County",4,17,41,20,21
050,31,087,"Nebraska","Hitchcock County",4,18,39,22,17
050,31,087,"Nebraska","Hitchcock County",4,19,23,14,9
050,31,087,"Nebraska","Hitchcock County",4,20,19,14,5
050,31,087,"Nebraska","Hitchcock County",4,21,24,10,14
050,31,087,"Nebraska","Hitchcock County",4,22,24,11,13
050,31,087,"Nebraska","Hitchcock County",4,23,24,12,12
050,31,087,"Nebraska","Hitchcock County",4,24,20,11,9
050,31,087,"Nebraska","Hitchcock County",4,25,18,10,8
050,31,087,"Nebraska","Hitchcock County",4,26,16,7,9
050,31,087,"Nebraska","Hitchcock County",4,27,24,15,9
050,31,087,"Nebraska","Hitchcock County",4,28,28,13,15
050,31,087,"Nebraska","Hitchcock County",4,29,29,15,14
050,31,087,"Nebraska","Hitchcock County",4,30,29,12,17
050,31,087,"Nebraska","Hitchcock County",4,31,24,11,13
050,31,087,"Nebraska","Hitchcock County",4,32,25,14,11
050,31,087,"Nebraska","Hitchcock County",4,33,24,14,10
050,31,087,"Nebraska","Hitchcock County",4,34,22,13,9
050,31,087,"Nebraska","Hitchcock County",4,35,23,12,11
050,31,087,"Nebraska","Hitchcock County",4,36,29,17,12
050,31,087,"Nebraska","Hitchcock County",4,37,28,15,13
050,31,087,"Nebraska","Hitchcock County",4,38,26,12,14
050,31,087,"Nebraska","Hitchcock County",4,39,33,20,13
050,31,087,"Nebraska","Hitchcock County",4,40,26,14,12
050,31,087,"Nebraska","Hitchcock County",4,41,31,13,18
050,31,087,"Nebraska","Hitchcock County",4,42,35,18,17
050,31,087,"Nebraska","Hitchcock County",4,43,36,21,15
050,31,087,"Nebraska","Hitchcock County",4,44,28,17,11
050,31,087,"Nebraska","Hitchcock County",4,45,27,17,10
050,31,087,"Nebraska","Hitchcock County",4,46,20,7,13
050,31,087,"Nebraska","Hitchcock County",4,47,26,10,16
050,31,087,"Nebraska","Hitchcock County",4,48,22,11,11
050,31,087,"Nebraska","Hitchcock County",4,49,25,13,12
050,31,087,"Nebraska","Hitchcock County",4,50,31,18,13
050,31,087,"Nebraska","Hitchcock County",4,51,31,19,12
050,31,087,"Nebraska","Hitchcock County",4,52,31,15,16
050,31,087,"Nebraska","Hitchcock County",4,53,27,11,16
050,31,087,"Nebraska","Hitchcock County",4,54,29,15,14
050,31,087,"Nebraska","Hitchcock County",4,55,22,10,12
050,31,087,"Nebraska","Hitchcock County",4,56,25,12,13
050,31,087,"Nebraska","Hitchcock County",4,57,34,19,15
050,31,087,"Nebraska","Hitchcock County",4,58,29,16,13
050,31,087,"Nebraska","Hitchcock County",4,59,30,14,16
050,31,087,"Nebraska","Hitchcock County",4,60,48,24,24
050,31,087,"Nebraska","Hitchcock County",4,61,47,24,23
050,31,087,"Nebraska","Hitchcock County",4,62,38,19,19
050,31,087,"Nebraska","Hitchcock County",4,63,40,21,19
050,31,087,"Nebraska","Hitchcock County",4,64,32,12,20
050,31,087,"Nebraska","Hitchcock County",4,65,32,15,17
050,31,087,"Nebraska","Hitchcock County",4,66,34,18,16
050,31,087,"Nebraska","Hitchcock County",4,67,37,20,17
050,31,087,"Nebraska","Hitchcock County",4,68,38,22,16
050,31,087,"Nebraska","Hitchcock County",4,69,35,16,19
050,31,087,"Nebraska","Hitchcock County",4,70,41,22,19
050,31,087,"Nebraska","Hitchcock County",4,71,42,22,20
050,31,087,"Nebraska","Hitchcock County",4,72,38,16,22
050,31,087,"Nebraska","Hitchcock County",4,73,39,23,16
050,31,087,"Nebraska","Hitchcock County",4,74,34,20,14
050,31,087,"Nebraska","Hitchcock County",4,75,40,19,21
050,31,087,"Nebraska","Hitchcock County",4,76,24,8,16
050,31,087,"Nebraska","Hitchcock County",4,77,18,7,11
050,31,087,"Nebraska","Hitchcock County",4,78,14,7,7
050,31,087,"Nebraska","Hitchcock County",4,79,22,7,15
050,31,087,"Nebraska","Hitchcock County",4,80,17,9,8
050,31,087,"Nebraska","Hitchcock County",4,81,19,9,10
050,31,087,"Nebraska","Hitchcock County",4,82,19,10,9
050,31,087,"Nebraska","Hitchcock County",4,83,15,6,9
050,31,087,"Nebraska","Hitchcock County",4,84,19,8,11
050,31,087,"Nebraska","Hitchcock County",4,85,91,29,62
050,31,087,"Nebraska","Hitchcock County",5,0,29,19,10
050,31,087,"Nebraska","Hitchcock County",5,1,26,16,10
050,31,087,"Nebraska","Hitchcock County",5,2,32,25,7
050,31,087,"Nebraska","Hitchcock County",5,3,27,14,13
050,31,087,"Nebraska","Hitchcock County",5,4,24,14,10
050,31,087,"Nebraska","Hitchcock County",5,5,30,17,13
050,31,087,"Nebraska","Hitchcock County",5,6,41,25,16
050,31,087,"Nebraska","Hitchcock County",5,7,26,17,9
050,31,087,"Nebraska","Hitchcock County",5,8,35,18,17
050,31,087,"Nebraska","Hitchcock County",5,9,37,18,19
050,31,087,"Nebraska","Hitchcock County",5,10,31,11,20
050,31,087,"Nebraska","Hitchcock County",5,11,42,18,24
050,31,087,"Nebraska","Hitchcock County",5,12,31,14,17
050,31,087,"Nebraska","Hitchcock County",5,13,26,14,12
050,31,087,"Nebraska","Hitchcock County",5,14,35,23,12
050,31,087,"Nebraska","Hitchcock County",5,15,47,26,21
050,31,087,"Nebraska","Hitchcock County",5,16,33,15,18
050,31,087,"Nebraska","Hitchcock County",5,17,36,18,18
050,31,087,"Nebraska","Hitchcock County",5,18,33,16,17
050,31,087,"Nebraska","Hitchcock County",5,19,30,17,13
050,31,087,"Nebraska","Hitchcock County",5,20,24,15,9
050,31,087,"Nebraska","Hitchcock County",5,21,21,12,9
050,31,087,"Nebraska","Hitchcock County",5,22,22,12,10
050,31,087,"Nebraska","Hitchcock County",5,23,24,11,13
050,31,087,"Nebraska","Hitchcock County",5,24,23,10,13
050,31,087,"Nebraska","Hitchcock County",5,25,18,9,9
050,31,087,"Nebraska","Hitchcock County",5,26,15,10,5
050,31,087,"Nebraska","Hitchcock County",5,27,15,7,8
050,31,087,"Nebraska","Hitchcock County",5,28,18,10,8
050,31,087,"Nebraska","Hitchcock County",5,29,26,12,14
050,31,087,"Nebraska","Hitchcock County",5,30,30,14,16
050,31,087,"Nebraska","Hitchcock County",5,31,27,11,16
050,31,087,"Nebraska","Hitchcock County",5,32,24,10,14
050,31,087,"Nebraska","Hitchcock County",5,33,25,12,13
050,31,087,"Nebraska","Hitchcock County",5,34,30,20,10
050,31,087,"Nebraska","Hitchcock County",5,35,22,14,8
050,31,087,"Nebraska","Hitchcock County",5,36,20,9,11
050,31,087,"Nebraska","Hitchcock County",5,37,26,13,13
050,31,087,"Nebraska","Hitchcock County",5,38,30,16,14
050,31,087,"Nebraska","Hitchcock County",5,39,30,15,15
050,31,087,"Nebraska","Hitchcock County",5,40,34,21,13
050,31,087,"Nebraska","Hitchcock County",5,41,27,15,12
050,31,087,"Nebraska","Hitchcock County",5,42,31,13,18
050,31,087,"Nebraska","Hitchcock County",5,43,36,20,16
050,31,087,"Nebraska","Hitchcock County",5,44,34,21,13
050,31,087,"Nebraska","Hitchcock County",5,45,26,16,10
050,31,087,"Nebraska","Hitchcock County",5,46,26,16,10
050,31,087,"Nebraska","Hitchcock County",5,47,21,7,14
050,31,087,"Nebraska","Hitchcock County",5,48,25,10,15
050,31,087,"Nebraska","Hitchcock County",5,49,20,11,9
050,31,087,"Nebraska","Hitchcock County",5,50,25,13,12
050,31,087,"Nebraska","Hitchcock County",5,51,31,18,13
050,31,087,"Nebraska","Hitchcock County",5,52,32,21,11
050,31,087,"Nebraska","Hitchcock County",5,53,31,15,16
050,31,087,"Nebraska","Hitchcock County",5,54,24,10,14
050,31,087,"Nebraska","Hitchcock County",5,55,30,15,15
050,31,087,"Nebraska","Hitchcock County",5,56,22,9,13
050,31,087,"Nebraska","Hitchcock County",5,57,26,12,14
050,31,087,"Nebraska","Hitchcock County",5,58,34,19,15
050,31,087,"Nebraska","Hitchcock County",5,59,32,19,13
050,31,087,"Nebraska","Hitchcock County",5,60,29,13,16
050,31,087,"Nebraska","Hitchcock County",5,61,48,24,24
050,31,087,"Nebraska","Hitchcock County",5,62,45,24,21
050,31,087,"Nebraska","Hitchcock County",5,63,38,18,20
050,31,087,"Nebraska","Hitchcock County",5,64,36,18,18
050,31,087,"Nebraska","Hitchcock County",5,65,27,9,18
050,31,087,"Nebraska","Hitchcock County",5,66,35,17,18
050,31,087,"Nebraska","Hitchcock County",5,67,34,18,16
050,31,087,"Nebraska","Hitchcock County",5,68,36,18,18
050,31,087,"Nebraska","Hitchcock County",5,69,39,24,15
050,31,087,"Nebraska","Hitchcock County",5,70,36,16,20
050,31,087,"Nebraska","Hitchcock County",5,71,41,22,19
050,31,087,"Nebraska","Hitchcock County",5,72,39,21,18
050,31,087,"Nebraska","Hitchcock County",5,73,37,16,21
050,31,087,"Nebraska","Hitchcock County",5,74,40,23,17
050,31,087,"Nebraska","Hitchcock County",5,75,31,19,12
050,31,087,"Nebraska","Hitchcock County",5,76,39,18,21
050,31,087,"Nebraska","Hitchcock County",5,77,24,8,16
050,31,087,"Nebraska","Hitchcock County",5,78,14,4,10
050,31,087,"Nebraska","Hitchcock County",5,79,15,8,7
050,31,087,"Nebraska","Hitchcock County",5,80,18,5,13
050,31,087,"Nebraska","Hitchcock County",5,81,17,10,7
050,31,087,"Nebraska","Hitchcock County",5,82,17,7,10
050,31,087,"Nebraska","Hitchcock County",5,83,17,9,8
050,31,087,"Nebraska","Hitchcock County",5,84,15,6,9
050,31,087,"Nebraska","Hitchcock County",5,85,97,33,64
050,31,089,"Nebraska","Holt County",1,0,127,66,61
050,31,089,"Nebraska","Holt County",1,1,125,70,55
050,31,089,"Nebraska","Holt County",1,2,137,72,65
050,31,089,"Nebraska","Holt County",1,3,146,79,67
050,31,089,"Nebraska","Holt County",1,4,150,88,62
050,31,089,"Nebraska","Holt County",1,5,147,72,75
050,31,089,"Nebraska","Holt County",1,6,140,72,68
050,31,089,"Nebraska","Holt County",1,7,145,74,71
050,31,089,"Nebraska","Holt County",1,8,145,77,68
050,31,089,"Nebraska","Holt County",1,9,155,82,73
050,31,089,"Nebraska","Holt County",1,10,148,80,68
050,31,089,"Nebraska","Holt County",1,11,156,83,73
050,31,089,"Nebraska","Holt County",1,12,148,73,75
050,31,089,"Nebraska","Holt County",1,13,158,83,75
050,31,089,"Nebraska","Holt County",1,14,148,76,72
050,31,089,"Nebraska","Holt County",1,15,150,78,72
050,31,089,"Nebraska","Holt County",1,16,138,73,65
050,31,089,"Nebraska","Holt County",1,17,126,60,66
050,31,089,"Nebraska","Holt County",1,18,104,45,59
050,31,089,"Nebraska","Holt County",1,19,81,43,38
050,31,089,"Nebraska","Holt County",1,20,92,47,45
050,31,089,"Nebraska","Holt County",1,21,98,53,45
050,31,089,"Nebraska","Holt County",1,22,95,47,48
050,31,089,"Nebraska","Holt County",1,23,103,52,51
050,31,089,"Nebraska","Holt County",1,24,106,57,49
050,31,089,"Nebraska","Holt County",1,25,110,50,60
050,31,089,"Nebraska","Holt County",1,26,93,45,48
050,31,089,"Nebraska","Holt County",1,27,105,52,53
050,31,089,"Nebraska","Holt County",1,28,85,45,40
050,31,089,"Nebraska","Holt County",1,29,79,42,37
050,31,089,"Nebraska","Holt County",1,30,91,47,44
050,31,089,"Nebraska","Holt County",1,31,93,50,43
050,31,089,"Nebraska","Holt County",1,32,94,52,42
050,31,089,"Nebraska","Holt County",1,33,104,55,49
050,31,089,"Nebraska","Holt County",1,34,100,51,49
050,31,089,"Nebraska","Holt County",1,35,116,60,56
050,31,089,"Nebraska","Holt County",1,36,111,58,53
050,31,089,"Nebraska","Holt County",1,37,120,62,58
050,31,089,"Nebraska","Holt County",1,38,104,50,54
050,31,089,"Nebraska","Holt County",1,39,109,46,63
050,31,089,"Nebraska","Holt County",1,40,115,56,59
050,31,089,"Nebraska","Holt County",1,41,103,55,48
050,31,089,"Nebraska","Holt County",1,42,106,56,50
050,31,089,"Nebraska","Holt County",1,43,98,54,44
050,31,089,"Nebraska","Holt County",1,44,96,55,41
050,31,089,"Nebraska","Holt County",1,45,100,58,42
050,31,089,"Nebraska","Holt County",1,46,92,44,48
050,31,089,"Nebraska","Holt County",1,47,100,50,50
050,31,089,"Nebraska","Holt County",1,48,100,51,49
050,31,089,"Nebraska","Holt County",1,49,86,48,38
050,31,089,"Nebraska","Holt County",1,50,90,52,38
050,31,089,"Nebraska","Holt County",1,51,101,47,54
050,31,089,"Nebraska","Holt County",1,52,105,48,57
050,31,089,"Nebraska","Holt County",1,53,102,49,53
050,31,089,"Nebraska","Holt County",1,54,112,60,52
050,31,089,"Nebraska","Holt County",1,55,124,67,57
050,31,089,"Nebraska","Holt County",1,56,136,69,67
050,31,089,"Nebraska","Holt County",1,57,156,77,79
050,31,089,"Nebraska","Holt County",1,58,180,92,88
050,31,089,"Nebraska","Holt County",1,59,181,93,88
050,31,089,"Nebraska","Holt County",1,60,164,87,77
050,31,089,"Nebraska","Holt County",1,61,172,86,86
050,31,089,"Nebraska","Holt County",1,62,160,80,80
050,31,089,"Nebraska","Holt County",1,63,170,89,81
050,31,089,"Nebraska","Holt County",1,64,159,85,74
050,31,089,"Nebraska","Holt County",1,65,151,76,75
050,31,089,"Nebraska","Holt County",1,66,148,78,70
050,31,089,"Nebraska","Holt County",1,67,142,75,67
050,31,089,"Nebraska","Holt County",1,68,126,63,63
050,31,089,"Nebraska","Holt County",1,69,125,66,59
050,31,089,"Nebraska","Holt County",1,70,125,61,64
050,31,089,"Nebraska","Holt County",1,71,125,69,56
050,31,089,"Nebraska","Holt County",1,72,108,55,53
050,31,089,"Nebraska","Holt County",1,73,114,54,60
050,31,089,"Nebraska","Holt County",1,74,73,35,38
050,31,089,"Nebraska","Holt County",1,75,76,34,42
050,31,089,"Nebraska","Holt County",1,76,98,46,52
050,31,089,"Nebraska","Holt County",1,77,84,37,47
050,31,089,"Nebraska","Holt County",1,78,72,32,40
050,31,089,"Nebraska","Holt County",1,79,64,28,36
050,31,089,"Nebraska","Holt County",1,80,58,29,29
050,31,089,"Nebraska","Holt County",1,81,68,33,35
050,31,089,"Nebraska","Holt County",1,82,57,23,34
050,31,089,"Nebraska","Holt County",1,83,45,16,29
050,31,089,"Nebraska","Holt County",1,84,46,16,30
050,31,089,"Nebraska","Holt County",1,85,325,131,194
050,31,089,"Nebraska","Holt County",2,0,130,67,63
050,31,089,"Nebraska","Holt County",2,1,125,69,56
050,31,089,"Nebraska","Holt County",2,2,135,73,62
050,31,089,"Nebraska","Holt County",2,3,145,78,67
050,31,089,"Nebraska","Holt County",2,4,150,87,63
050,31,089,"Nebraska","Holt County",2,5,147,74,73
050,31,089,"Nebraska","Holt County",2,6,143,72,71
050,31,089,"Nebraska","Holt County",2,7,144,73,71
050,31,089,"Nebraska","Holt County",2,8,145,78,67
050,31,089,"Nebraska","Holt County",2,9,153,82,71
050,31,089,"Nebraska","Holt County",2,10,147,80,67
050,31,089,"Nebraska","Holt County",2,11,153,81,72
050,31,089,"Nebraska","Holt County",2,12,149,74,75
050,31,089,"Nebraska","Holt County",2,13,156,81,75
050,31,089,"Nebraska","Holt County",2,14,149,77,72
050,31,089,"Nebraska","Holt County",2,15,149,77,72
050,31,089,"Nebraska","Holt County",2,16,140,75,65
050,31,089,"Nebraska","Holt County",2,17,128,62,66
050,31,089,"Nebraska","Holt County",2,18,104,47,57
050,31,089,"Nebraska","Holt County",2,19,81,41,40
050,31,089,"Nebraska","Holt County",2,20,90,46,44
050,31,089,"Nebraska","Holt County",2,21,97,51,46
050,31,089,"Nebraska","Holt County",2,22,97,50,47
050,31,089,"Nebraska","Holt County",2,23,100,52,48
050,31,089,"Nebraska","Holt County",2,24,104,54,50
050,31,089,"Nebraska","Holt County",2,25,108,51,57
050,31,089,"Nebraska","Holt County",2,26,97,46,51
050,31,089,"Nebraska","Holt County",2,27,100,49,51
050,31,089,"Nebraska","Holt County",2,28,89,47,42
050,31,089,"Nebraska","Holt County",2,29,81,43,38
050,31,089,"Nebraska","Holt County",2,30,88,46,42
050,31,089,"Nebraska","Holt County",2,31,92,48,44
050,31,089,"Nebraska","Holt County",2,32,94,51,43
050,31,089,"Nebraska","Holt County",2,33,101,54,47
050,31,089,"Nebraska","Holt County",2,34,98,50,48
050,31,089,"Nebraska","Holt County",2,35,111,57,54
050,31,089,"Nebraska","Holt County",2,36,112,58,54
050,31,089,"Nebraska","Holt County",2,37,116,60,56
050,31,089,"Nebraska","Holt County",2,38,108,52,56
050,31,089,"Nebraska","Holt County",2,39,107,47,60
050,31,089,"Nebraska","Holt County",2,40,115,55,60
050,31,089,"Nebraska","Holt County",2,41,105,55,50
050,31,089,"Nebraska","Holt County",2,42,104,56,48
050,31,089,"Nebraska","Holt County",2,43,101,55,46
050,31,089,"Nebraska","Holt County",2,44,94,54,40
050,31,089,"Nebraska","Holt County",2,45,101,58,43
050,31,089,"Nebraska","Holt County",2,46,93,47,46
050,31,089,"Nebraska","Holt County",2,47,98,49,49
050,31,089,"Nebraska","Holt County",2,48,99,51,48
050,31,089,"Nebraska","Holt County",2,49,89,48,41
050,31,089,"Nebraska","Holt County",2,50,89,50,39
050,31,089,"Nebraska","Holt County",2,51,97,48,49
050,31,089,"Nebraska","Holt County",2,52,104,49,55
050,31,089,"Nebraska","Holt County",2,53,103,48,55
050,31,089,"Nebraska","Holt County",2,54,109,58,51
050,31,089,"Nebraska","Holt County",2,55,121,65,56
050,31,089,"Nebraska","Holt County",2,56,133,68,65
050,31,089,"Nebraska","Holt County",2,57,150,74,76
050,31,089,"Nebraska","Holt County",2,58,175,89,86
050,31,089,"Nebraska","Holt County",2,59,182,94,88
050,31,089,"Nebraska","Holt County",2,60,168,88,80
050,31,089,"Nebraska","Holt County",2,61,168,84,84
050,31,089,"Nebraska","Holt County",2,62,162,81,81
050,31,089,"Nebraska","Holt County",2,63,169,89,80
050,31,089,"Nebraska","Holt County",2,64,160,85,75
050,31,089,"Nebraska","Holt County",2,65,152,77,75
050,31,089,"Nebraska","Holt County",2,66,148,78,70
050,31,089,"Nebraska","Holt County",2,67,141,74,67
050,31,089,"Nebraska","Holt County",2,68,128,65,63
050,31,089,"Nebraska","Holt County",2,69,128,67,61
050,31,089,"Nebraska","Holt County",2,70,123,61,62
050,31,089,"Nebraska","Holt County",2,71,126,67,59
050,31,089,"Nebraska","Holt County",2,72,111,58,53
050,31,089,"Nebraska","Holt County",2,73,119,57,62
050,31,089,"Nebraska","Holt County",2,74,76,36,40
050,31,089,"Nebraska","Holt County",2,75,77,35,42
050,31,089,"Nebraska","Holt County",2,76,91,42,49
050,31,089,"Nebraska","Holt County",2,77,87,40,47
050,31,089,"Nebraska","Holt County",2,78,71,31,40
050,31,089,"Nebraska","Holt County",2,79,66,29,37
050,31,089,"Nebraska","Holt County",2,80,58,28,30
050,31,089,"Nebraska","Holt County",2,81,67,33,34
050,31,089,"Nebraska","Holt County",2,82,58,23,35
050,31,089,"Nebraska","Holt County",2,83,46,17,29
050,31,089,"Nebraska","Holt County",2,84,47,16,31
050,31,089,"Nebraska","Holt County",2,85,324,128,196
050,31,089,"Nebraska","Holt County",3,0,117,69,48
050,31,089,"Nebraska","Holt County",3,1,129,65,64
050,31,089,"Nebraska","Holt County",3,2,125,70,55
050,31,089,"Nebraska","Holt County",3,3,136,71,65
050,31,089,"Nebraska","Holt County",3,4,143,77,66
050,31,089,"Nebraska","Holt County",3,5,146,84,62
050,31,089,"Nebraska","Holt County",3,6,148,74,74
050,31,089,"Nebraska","Holt County",3,7,142,72,70
050,31,089,"Nebraska","Holt County",3,8,138,66,72
050,31,089,"Nebraska","Holt County",3,9,147,77,70
050,31,089,"Nebraska","Holt County",3,10,156,83,73
050,31,089,"Nebraska","Holt County",3,11,151,82,69
050,31,089,"Nebraska","Holt County",3,12,160,86,74
050,31,089,"Nebraska","Holt County",3,13,153,78,75
050,31,089,"Nebraska","Holt County",3,14,152,79,73
050,31,089,"Nebraska","Holt County",3,15,153,80,73
050,31,089,"Nebraska","Holt County",3,16,143,72,71
050,31,089,"Nebraska","Holt County",3,17,143,75,68
050,31,089,"Nebraska","Holt County",3,18,113,56,57
050,31,089,"Nebraska","Holt County",3,19,82,37,45
050,31,089,"Nebraska","Holt County",3,20,89,46,43
050,31,089,"Nebraska","Holt County",3,21,90,48,42
050,31,089,"Nebraska","Holt County",3,22,99,51,48
050,31,089,"Nebraska","Holt County",3,23,94,49,45
050,31,089,"Nebraska","Holt County",3,24,108,56,52
050,31,089,"Nebraska","Holt County",3,25,99,47,52
050,31,089,"Nebraska","Holt County",3,26,93,44,49
050,31,089,"Nebraska","Holt County",3,27,101,51,50
050,31,089,"Nebraska","Holt County",3,28,97,44,53
050,31,089,"Nebraska","Holt County",3,29,89,51,38
050,31,089,"Nebraska","Holt County",3,30,86,49,37
050,31,089,"Nebraska","Holt County",3,31,88,47,41
050,31,089,"Nebraska","Holt County",3,32,88,47,41
050,31,089,"Nebraska","Holt County",3,33,93,49,44
050,31,089,"Nebraska","Holt County",3,34,108,58,50
050,31,089,"Nebraska","Holt County",3,35,99,49,50
050,31,089,"Nebraska","Holt County",3,36,109,61,48
050,31,089,"Nebraska","Holt County",3,37,108,55,53
050,31,089,"Nebraska","Holt County",3,38,118,61,57
050,31,089,"Nebraska","Holt County",3,39,113,54,59
050,31,089,"Nebraska","Holt County",3,40,107,49,58
050,31,089,"Nebraska","Holt County",3,41,112,52,60
050,31,089,"Nebraska","Holt County",3,42,101,51,50
050,31,089,"Nebraska","Holt County",3,43,103,53,50
050,31,089,"Nebraska","Holt County",3,44,102,54,48
050,31,089,"Nebraska","Holt County",3,45,96,55,41
050,31,089,"Nebraska","Holt County",3,46,100,58,42
050,31,089,"Nebraska","Holt County",3,47,98,50,48
050,31,089,"Nebraska","Holt County",3,48,101,51,50
050,31,089,"Nebraska","Holt County",3,49,98,50,48
050,31,089,"Nebraska","Holt County",3,50,93,50,43
050,31,089,"Nebraska","Holt County",3,51,90,50,40
050,31,089,"Nebraska","Holt County",3,52,98,51,47
050,31,089,"Nebraska","Holt County",3,53,102,48,54
050,31,089,"Nebraska","Holt County",3,54,106,50,56
050,31,089,"Nebraska","Holt County",3,55,110,58,52
050,31,089,"Nebraska","Holt County",3,56,116,63,53
050,31,089,"Nebraska","Holt County",3,57,129,65,64
050,31,089,"Nebraska","Holt County",3,58,147,71,76
050,31,089,"Nebraska","Holt County",3,59,174,89,85
050,31,089,"Nebraska","Holt County",3,60,178,91,87
050,31,089,"Nebraska","Holt County",3,61,161,84,77
050,31,089,"Nebraska","Holt County",3,62,166,84,82
050,31,089,"Nebraska","Holt County",3,63,160,81,79
050,31,089,"Nebraska","Holt County",3,64,165,87,78
050,31,089,"Nebraska","Holt County",3,65,159,84,75
050,31,089,"Nebraska","Holt County",3,66,148,72,76
050,31,089,"Nebraska","Holt County",3,67,148,78,70
050,31,089,"Nebraska","Holt County",3,68,141,73,68
050,31,089,"Nebraska","Holt County",3,69,130,67,63
050,31,089,"Nebraska","Holt County",3,70,127,65,62
050,31,089,"Nebraska","Holt County",3,71,118,58,60
050,31,089,"Nebraska","Holt County",3,72,124,64,60
050,31,089,"Nebraska","Holt County",3,73,111,59,52
050,31,089,"Nebraska","Holt County",3,74,114,55,59
050,31,089,"Nebraska","Holt County",3,75,74,33,41
050,31,089,"Nebraska","Holt County",3,76,76,31,45
050,31,089,"Nebraska","Holt County",3,77,83,36,47
050,31,089,"Nebraska","Holt County",3,78,78,37,41
050,31,089,"Nebraska","Holt County",3,79,72,31,41
050,31,089,"Nebraska","Holt County",3,80,63,28,35
050,31,089,"Nebraska","Holt County",3,81,59,30,29
050,31,089,"Nebraska","Holt County",3,82,62,28,34
050,31,089,"Nebraska","Holt County",3,83,51,22,29
050,31,089,"Nebraska","Holt County",3,84,47,16,31
050,31,089,"Nebraska","Holt County",3,85,308,120,188
050,31,089,"Nebraska","Holt County",4,0,118,63,55
050,31,089,"Nebraska","Holt County",4,1,123,71,52
050,31,089,"Nebraska","Holt County",4,2,131,65,66
050,31,089,"Nebraska","Holt County",4,3,125,67,58
050,31,089,"Nebraska","Holt County",4,4,135,70,65
050,31,089,"Nebraska","Holt County",4,5,138,74,64
050,31,089,"Nebraska","Holt County",4,6,154,88,66
050,31,089,"Nebraska","Holt County",4,7,148,76,72
050,31,089,"Nebraska","Holt County",4,8,148,76,72
050,31,089,"Nebraska","Holt County",4,9,139,69,70
050,31,089,"Nebraska","Holt County",4,10,154,82,72
050,31,089,"Nebraska","Holt County",4,11,159,82,77
050,31,089,"Nebraska","Holt County",4,12,147,84,63
050,31,089,"Nebraska","Holt County",4,13,157,85,72
050,31,089,"Nebraska","Holt County",4,14,155,78,77
050,31,089,"Nebraska","Holt County",4,15,154,77,77
050,31,089,"Nebraska","Holt County",4,16,151,81,70
050,31,089,"Nebraska","Holt County",4,17,140,70,70
050,31,089,"Nebraska","Holt County",4,18,126,71,55
050,31,089,"Nebraska","Holt County",4,19,80,38,42
050,31,089,"Nebraska","Holt County",4,20,82,33,49
050,31,089,"Nebraska","Holt County",4,21,88,44,44
050,31,089,"Nebraska","Holt County",4,22,92,46,46
050,31,089,"Nebraska","Holt County",4,23,104,46,58
050,31,089,"Nebraska","Holt County",4,24,86,43,43
050,31,089,"Nebraska","Holt County",4,25,106,54,52
050,31,089,"Nebraska","Holt County",4,26,105,48,57
050,31,089,"Nebraska","Holt County",4,27,96,47,49
050,31,089,"Nebraska","Holt County",4,28,100,49,51
050,31,089,"Nebraska","Holt County",4,29,95,46,49
050,31,089,"Nebraska","Holt County",4,30,92,56,36
050,31,089,"Nebraska","Holt County",4,31,93,56,37
050,31,089,"Nebraska","Holt County",4,32,94,51,43
050,31,089,"Nebraska","Holt County",4,33,88,46,42
050,31,089,"Nebraska","Holt County",4,34,101,55,46
050,31,089,"Nebraska","Holt County",4,35,110,60,50
050,31,089,"Nebraska","Holt County",4,36,96,44,52
050,31,089,"Nebraska","Holt County",4,37,120,69,51
050,31,089,"Nebraska","Holt County",4,38,107,55,52
050,31,089,"Nebraska","Holt County",4,39,118,58,60
050,31,089,"Nebraska","Holt County",4,40,110,53,57
050,31,089,"Nebraska","Holt County",4,41,103,46,57
050,31,089,"Nebraska","Holt County",4,42,114,52,62
050,31,089,"Nebraska","Holt County",4,43,98,46,52
050,31,089,"Nebraska","Holt County",4,44,104,53,51
050,31,089,"Nebraska","Holt County",4,45,99,52,47
050,31,089,"Nebraska","Holt County",4,46,94,57,37
050,31,089,"Nebraska","Holt County",4,47,95,58,37
050,31,089,"Nebraska","Holt County",4,48,101,51,50
050,31,089,"Nebraska","Holt County",4,49,100,48,52
050,31,089,"Nebraska","Holt County",4,50,96,47,49
050,31,089,"Nebraska","Holt County",4,51,94,47,47
050,31,089,"Nebraska","Holt County",4,52,94,55,39
050,31,089,"Nebraska","Holt County",4,53,95,51,44
050,31,089,"Nebraska","Holt County",4,54,103,48,55
050,31,089,"Nebraska","Holt County",4,55,106,49,57
050,31,089,"Nebraska","Holt County",4,56,108,56,52
050,31,089,"Nebraska","Holt County",4,57,113,60,53
050,31,089,"Nebraska","Holt County",4,58,125,63,62
050,31,089,"Nebraska","Holt County",4,59,147,72,75
050,31,089,"Nebraska","Holt County",4,60,170,86,84
050,31,089,"Nebraska","Holt County",4,61,172,86,86
050,31,089,"Nebraska","Holt County",4,62,160,86,74
050,31,089,"Nebraska","Holt County",4,63,169,85,84
050,31,089,"Nebraska","Holt County",4,64,156,80,76
050,31,089,"Nebraska","Holt County",4,65,163,83,80
050,31,089,"Nebraska","Holt County",4,66,156,81,75
050,31,089,"Nebraska","Holt County",4,67,143,74,69
050,31,089,"Nebraska","Holt County",4,68,144,79,65
050,31,089,"Nebraska","Holt County",4,69,134,71,63
050,31,089,"Nebraska","Holt County",4,70,126,64,62
050,31,089,"Nebraska","Holt County",4,71,124,62,62
050,31,089,"Nebraska","Holt County",4,72,117,57,60
050,31,089,"Nebraska","Holt County",4,73,124,63,61
050,31,089,"Nebraska","Holt County",4,74,104,57,47
050,31,089,"Nebraska","Holt County",4,75,109,52,57
050,31,089,"Nebraska","Holt County",4,76,76,33,43
050,31,089,"Nebraska","Holt County",4,77,68,27,41
050,31,089,"Nebraska","Holt County",4,78,76,34,42
050,31,089,"Nebraska","Holt County",4,79,75,34,41
050,31,089,"Nebraska","Holt County",4,80,66,29,37
050,31,089,"Nebraska","Holt County",4,81,61,31,30
050,31,089,"Nebraska","Holt County",4,82,55,24,31
050,31,089,"Nebraska","Holt County",4,83,61,29,32
050,31,089,"Nebraska","Holt County",4,84,49,20,29
050,31,089,"Nebraska","Holt County",4,85,301,120,181
050,31,089,"Nebraska","Holt County",5,0,127,68,59
050,31,089,"Nebraska","Holt County",5,1,122,66,56
050,31,089,"Nebraska","Holt County",5,2,124,71,53
050,31,089,"Nebraska","Holt County",5,3,132,65,67
050,31,089,"Nebraska","Holt County",5,4,124,65,59
050,31,089,"Nebraska","Holt County",5,5,136,72,64
050,31,089,"Nebraska","Holt County",5,6,138,75,63
050,31,089,"Nebraska","Holt County",5,7,155,87,68
050,31,089,"Nebraska","Holt County",5,8,145,73,72
050,31,089,"Nebraska","Holt County",5,9,153,79,74
050,31,089,"Nebraska","Holt County",5,10,145,70,75
050,31,089,"Nebraska","Holt County",5,11,150,83,67
050,31,089,"Nebraska","Holt County",5,12,163,84,79
050,31,089,"Nebraska","Holt County",5,13,154,85,69
050,31,089,"Nebraska","Holt County",5,14,161,88,73
050,31,089,"Nebraska","Holt County",5,15,153,75,78
050,31,089,"Nebraska","Holt County",5,16,161,77,84
050,31,089,"Nebraska","Holt County",5,17,157,86,71
050,31,089,"Nebraska","Holt County",5,18,121,64,57
050,31,089,"Nebraska","Holt County",5,19,91,52,39
050,31,089,"Nebraska","Holt County",5,20,89,43,46
050,31,089,"Nebraska","Holt County",5,21,82,30,52
050,31,089,"Nebraska","Holt County",5,22,93,45,48
050,31,089,"Nebraska","Holt County",5,23,94,47,47
050,31,089,"Nebraska","Holt County",5,24,90,44,46
050,31,089,"Nebraska","Holt County",5,25,90,47,43
050,31,089,"Nebraska","Holt County",5,26,114,52,62
050,31,089,"Nebraska","Holt County",5,27,109,50,59
050,31,089,"Nebraska","Holt County",5,28,113,58,55
050,31,089,"Nebraska","Holt County",5,29,99,47,52
050,31,089,"Nebraska","Holt County",5,30,95,47,48
050,31,089,"Nebraska","Holt County",5,31,94,55,39
050,31,089,"Nebraska","Holt County",5,32,96,60,36
050,31,089,"Nebraska","Holt County",5,33,97,55,42
050,31,089,"Nebraska","Holt County",5,34,94,46,48
050,31,089,"Nebraska","Holt County",5,35,100,53,47
050,31,089,"Nebraska","Holt County",5,36,110,59,51
050,31,089,"Nebraska","Holt County",5,37,99,43,56
050,31,089,"Nebraska","Holt County",5,38,118,63,55
050,31,089,"Nebraska","Holt County",5,39,103,54,49
050,31,089,"Nebraska","Holt County",5,40,120,61,59
050,31,089,"Nebraska","Holt County",5,41,112,53,59
050,31,089,"Nebraska","Holt County",5,42,103,46,57
050,31,089,"Nebraska","Holt County",5,43,115,52,63
050,31,089,"Nebraska","Holt County",5,44,97,45,52
050,31,089,"Nebraska","Holt County",5,45,111,58,53
050,31,089,"Nebraska","Holt County",5,46,100,50,50
050,31,089,"Nebraska","Holt County",5,47,90,53,37
050,31,089,"Nebraska","Holt County",5,48,98,60,38
050,31,089,"Nebraska","Holt County",5,49,97,48,49
050,31,089,"Nebraska","Holt County",5,50,107,51,56
050,31,089,"Nebraska","Holt County",5,51,96,47,49
050,31,089,"Nebraska","Holt County",5,52,98,49,49
050,31,089,"Nebraska","Holt County",5,53,99,58,41
050,31,089,"Nebraska","Holt County",5,54,96,51,45
050,31,089,"Nebraska","Holt County",5,55,106,48,58
050,31,089,"Nebraska","Holt County",5,56,108,50,58
050,31,089,"Nebraska","Holt County",5,57,108,55,53
050,31,089,"Nebraska","Holt County",5,58,110,59,51
050,31,089,"Nebraska","Holt County",5,59,124,63,61
050,31,089,"Nebraska","Holt County",5,60,150,74,76
050,31,089,"Nebraska","Holt County",5,61,168,82,86
050,31,089,"Nebraska","Holt County",5,62,172,87,85
050,31,089,"Nebraska","Holt County",5,63,159,86,73
050,31,089,"Nebraska","Holt County",5,64,163,80,83
050,31,089,"Nebraska","Holt County",5,65,150,75,75
050,31,089,"Nebraska","Holt County",5,66,162,83,79
050,31,089,"Nebraska","Holt County",5,67,152,78,74
050,31,089,"Nebraska","Holt County",5,68,147,76,71
050,31,089,"Nebraska","Holt County",5,69,146,80,66
050,31,089,"Nebraska","Holt County",5,70,129,67,62
050,31,089,"Nebraska","Holt County",5,71,121,61,60
050,31,089,"Nebraska","Holt County",5,72,123,61,62
050,31,089,"Nebraska","Holt County",5,73,122,58,64
050,31,089,"Nebraska","Holt County",5,74,119,62,57
050,31,089,"Nebraska","Holt County",5,75,101,55,46
050,31,089,"Nebraska","Holt County",5,76,107,50,57
050,31,089,"Nebraska","Holt County",5,77,69,29,40
050,31,089,"Nebraska","Holt County",5,78,62,25,37
050,31,089,"Nebraska","Holt County",5,79,76,33,43
050,31,089,"Nebraska","Holt County",5,80,69,31,38
050,31,089,"Nebraska","Holt County",5,81,68,31,37
050,31,089,"Nebraska","Holt County",5,82,57,26,31
050,31,089,"Nebraska","Holt County",5,83,50,23,27
050,31,089,"Nebraska","Holt County",5,84,65,29,36
050,31,089,"Nebraska","Holt County",5,85,300,122,178
050,31,091,"Nebraska","Hooker County",1,0,5,3,2
050,31,091,"Nebraska","Hooker County",1,1,6,3,3
050,31,091,"Nebraska","Hooker County",1,2,7,4,3
050,31,091,"Nebraska","Hooker County",1,3,5,3,2
050,31,091,"Nebraska","Hooker County",1,4,10,4,6
050,31,091,"Nebraska","Hooker County",1,5,6,4,2
050,31,091,"Nebraska","Hooker County",1,6,9,5,4
050,31,091,"Nebraska","Hooker County",1,7,7,6,1
050,31,091,"Nebraska","Hooker County",1,8,4,1,3
050,31,091,"Nebraska","Hooker County",1,9,11,5,6
050,31,091,"Nebraska","Hooker County",1,10,9,3,6
050,31,091,"Nebraska","Hooker County",1,11,8,4,4
050,31,091,"Nebraska","Hooker County",1,12,11,5,6
050,31,091,"Nebraska","Hooker County",1,13,14,7,7
050,31,091,"Nebraska","Hooker County",1,14,12,6,6
050,31,091,"Nebraska","Hooker County",1,15,7,6,1
050,31,091,"Nebraska","Hooker County",1,16,12,9,3
050,31,091,"Nebraska","Hooker County",1,17,7,2,5
050,31,091,"Nebraska","Hooker County",1,18,9,4,5
050,31,091,"Nebraska","Hooker County",1,19,8,5,3
050,31,091,"Nebraska","Hooker County",1,20,4,2,2
050,31,091,"Nebraska","Hooker County",1,21,7,4,3
050,31,091,"Nebraska","Hooker County",1,22,4,0,4
050,31,091,"Nebraska","Hooker County",1,23,9,3,6
050,31,091,"Nebraska","Hooker County",1,24,5,2,3
050,31,091,"Nebraska","Hooker County",1,25,3,2,1
050,31,091,"Nebraska","Hooker County",1,26,5,2,3
050,31,091,"Nebraska","Hooker County",1,27,6,4,2
050,31,091,"Nebraska","Hooker County",1,28,6,4,2
050,31,091,"Nebraska","Hooker County",1,29,6,4,2
050,31,091,"Nebraska","Hooker County",1,30,8,4,4
050,31,091,"Nebraska","Hooker County",1,31,5,3,2
050,31,091,"Nebraska","Hooker County",1,32,5,3,2
050,31,091,"Nebraska","Hooker County",1,33,8,2,6
050,31,091,"Nebraska","Hooker County",1,34,4,2,2
050,31,091,"Nebraska","Hooker County",1,35,2,0,2
050,31,091,"Nebraska","Hooker County",1,36,2,1,1
050,31,091,"Nebraska","Hooker County",1,37,7,2,5
050,31,091,"Nebraska","Hooker County",1,38,9,2,7
050,31,091,"Nebraska","Hooker County",1,39,11,5,6
050,31,091,"Nebraska","Hooker County",1,40,9,4,5
050,31,091,"Nebraska","Hooker County",1,41,12,8,4
050,31,091,"Nebraska","Hooker County",1,42,15,9,6
050,31,091,"Nebraska","Hooker County",1,43,11,8,3
050,31,091,"Nebraska","Hooker County",1,44,7,4,3
050,31,091,"Nebraska","Hooker County",1,45,7,6,1
050,31,091,"Nebraska","Hooker County",1,46,6,3,3
050,31,091,"Nebraska","Hooker County",1,47,9,3,6
050,31,091,"Nebraska","Hooker County",1,48,8,2,6
050,31,091,"Nebraska","Hooker County",1,49,7,5,2
050,31,091,"Nebraska","Hooker County",1,50,9,6,3
050,31,091,"Nebraska","Hooker County",1,51,6,1,5
050,31,091,"Nebraska","Hooker County",1,52,4,2,2
050,31,091,"Nebraska","Hooker County",1,53,5,5,0
050,31,091,"Nebraska","Hooker County",1,54,4,2,2
050,31,091,"Nebraska","Hooker County",1,55,10,4,6
050,31,091,"Nebraska","Hooker County",1,56,7,3,4
050,31,091,"Nebraska","Hooker County",1,57,7,1,6
050,31,091,"Nebraska","Hooker County",1,58,5,4,1
050,31,091,"Nebraska","Hooker County",1,59,10,6,4
050,31,091,"Nebraska","Hooker County",1,60,10,6,4
050,31,091,"Nebraska","Hooker County",1,61,8,5,3
050,31,091,"Nebraska","Hooker County",1,62,16,8,8
050,31,091,"Nebraska","Hooker County",1,63,17,8,9
050,31,091,"Nebraska","Hooker County",1,64,12,3,9
050,31,091,"Nebraska","Hooker County",1,65,9,4,5
050,31,091,"Nebraska","Hooker County",1,66,12,7,5
050,31,091,"Nebraska","Hooker County",1,67,13,6,7
050,31,091,"Nebraska","Hooker County",1,68,14,8,6
050,31,091,"Nebraska","Hooker County",1,69,11,7,4
050,31,091,"Nebraska","Hooker County",1,70,9,5,4
050,31,091,"Nebraska","Hooker County",1,71,5,2,3
050,31,091,"Nebraska","Hooker County",1,72,5,1,4
050,31,091,"Nebraska","Hooker County",1,73,11,5,6
050,31,091,"Nebraska","Hooker County",1,74,8,3,5
050,31,091,"Nebraska","Hooker County",1,75,4,2,2
050,31,091,"Nebraska","Hooker County",1,76,10,7,3
050,31,091,"Nebraska","Hooker County",1,77,9,3,6
050,31,091,"Nebraska","Hooker County",1,78,9,5,4
050,31,091,"Nebraska","Hooker County",1,79,6,3,3
050,31,091,"Nebraska","Hooker County",1,80,8,4,4
050,31,091,"Nebraska","Hooker County",1,81,7,3,4
050,31,091,"Nebraska","Hooker County",1,82,5,2,3
050,31,091,"Nebraska","Hooker County",1,83,7,2,5
050,31,091,"Nebraska","Hooker County",1,84,6,2,4
050,31,091,"Nebraska","Hooker County",1,85,37,12,25
050,31,091,"Nebraska","Hooker County",2,0,5,2,3
050,31,091,"Nebraska","Hooker County",2,1,6,3,3
050,31,091,"Nebraska","Hooker County",2,2,7,4,3
050,31,091,"Nebraska","Hooker County",2,3,5,3,2
050,31,091,"Nebraska","Hooker County",2,4,9,4,5
050,31,091,"Nebraska","Hooker County",2,5,7,4,3
050,31,091,"Nebraska","Hooker County",2,6,9,5,4
050,31,091,"Nebraska","Hooker County",2,7,5,4,1
050,31,091,"Nebraska","Hooker County",2,8,5,2,3
050,31,091,"Nebraska","Hooker County",2,9,8,3,5
050,31,091,"Nebraska","Hooker County",2,10,9,3,6
050,31,091,"Nebraska","Hooker County",2,11,9,4,5
050,31,091,"Nebraska","Hooker County",2,12,10,5,5
050,31,091,"Nebraska","Hooker County",2,13,14,7,7
050,31,091,"Nebraska","Hooker County",2,14,11,6,5
050,31,091,"Nebraska","Hooker County",2,15,8,6,2
050,31,091,"Nebraska","Hooker County",2,16,11,9,2
050,31,091,"Nebraska","Hooker County",2,17,9,4,5
050,31,091,"Nebraska","Hooker County",2,18,9,4,5
050,31,091,"Nebraska","Hooker County",2,19,7,4,3
050,31,091,"Nebraska","Hooker County",2,20,5,3,2
050,31,091,"Nebraska","Hooker County",2,21,7,4,3
050,31,091,"Nebraska","Hooker County",2,22,5,1,4
050,31,091,"Nebraska","Hooker County",2,23,8,2,6
050,31,091,"Nebraska","Hooker County",2,24,6,2,4
050,31,091,"Nebraska","Hooker County",2,25,3,2,1
050,31,091,"Nebraska","Hooker County",2,26,4,2,2
050,31,091,"Nebraska","Hooker County",2,27,6,4,2
050,31,091,"Nebraska","Hooker County",2,28,5,3,2
050,31,091,"Nebraska","Hooker County",2,29,6,4,2
050,31,091,"Nebraska","Hooker County",2,30,8,4,4
050,31,091,"Nebraska","Hooker County",2,31,5,3,2
050,31,091,"Nebraska","Hooker County",2,32,5,3,2
050,31,091,"Nebraska","Hooker County",2,33,7,2,5
050,31,091,"Nebraska","Hooker County",2,34,5,2,3
050,31,091,"Nebraska","Hooker County",2,35,2,0,2
050,31,091,"Nebraska","Hooker County",2,36,2,1,1
050,31,091,"Nebraska","Hooker County",2,37,6,2,4
050,31,091,"Nebraska","Hooker County",2,38,9,2,7
050,31,091,"Nebraska","Hooker County",2,39,10,4,6
050,31,091,"Nebraska","Hooker County",2,40,9,4,5
050,31,091,"Nebraska","Hooker County",2,41,12,7,5
050,31,091,"Nebraska","Hooker County",2,42,13,8,5
050,31,091,"Nebraska","Hooker County",2,43,13,9,4
050,31,091,"Nebraska","Hooker County",2,44,8,5,3
050,31,091,"Nebraska","Hooker County",2,45,7,5,2
050,31,091,"Nebraska","Hooker County",2,46,7,4,3
050,31,091,"Nebraska","Hooker County",2,47,8,3,5
050,31,091,"Nebraska","Hooker County",2,48,8,2,6
050,31,091,"Nebraska","Hooker County",2,49,8,5,3
050,31,091,"Nebraska","Hooker County",2,50,9,6,3
050,31,091,"Nebraska","Hooker County",2,51,6,2,4
050,31,091,"Nebraska","Hooker County",2,52,4,2,2
050,31,091,"Nebraska","Hooker County",2,53,4,4,0
050,31,091,"Nebraska","Hooker County",2,54,4,3,1
050,31,091,"Nebraska","Hooker County",2,55,9,4,5
050,31,091,"Nebraska","Hooker County",2,56,8,3,5
050,31,091,"Nebraska","Hooker County",2,57,8,2,6
050,31,091,"Nebraska","Hooker County",2,58,6,4,2
050,31,091,"Nebraska","Hooker County",2,59,9,5,4
050,31,091,"Nebraska","Hooker County",2,60,9,6,3
050,31,091,"Nebraska","Hooker County",2,61,8,5,3
050,31,091,"Nebraska","Hooker County",2,62,14,7,7
050,31,091,"Nebraska","Hooker County",2,63,17,8,9
050,31,091,"Nebraska","Hooker County",2,64,13,4,9
050,31,091,"Nebraska","Hooker County",2,65,10,4,6
050,31,091,"Nebraska","Hooker County",2,66,11,6,5
050,31,091,"Nebraska","Hooker County",2,67,12,6,6
050,31,091,"Nebraska","Hooker County",2,68,14,8,6
050,31,091,"Nebraska","Hooker County",2,69,12,7,5
050,31,091,"Nebraska","Hooker County",2,70,9,5,4
050,31,091,"Nebraska","Hooker County",2,71,6,3,3
050,31,091,"Nebraska","Hooker County",2,72,5,1,4
050,31,091,"Nebraska","Hooker County",2,73,10,4,6
050,31,091,"Nebraska","Hooker County",2,74,8,3,5
050,31,091,"Nebraska","Hooker County",2,75,5,2,3
050,31,091,"Nebraska","Hooker County",2,76,8,5,3
050,31,091,"Nebraska","Hooker County",2,77,9,4,5
050,31,091,"Nebraska","Hooker County",2,78,9,4,5
050,31,091,"Nebraska","Hooker County",2,79,7,4,3
050,31,091,"Nebraska","Hooker County",2,80,8,4,4
050,31,091,"Nebraska","Hooker County",2,81,8,4,4
050,31,091,"Nebraska","Hooker County",2,82,5,2,3
050,31,091,"Nebraska","Hooker County",2,83,7,2,5
050,31,091,"Nebraska","Hooker County",2,84,6,2,4
050,31,091,"Nebraska","Hooker County",2,85,38,12,26
050,31,091,"Nebraska","Hooker County",3,0,7,5,2
050,31,091,"Nebraska","Hooker County",3,1,5,2,3
050,31,091,"Nebraska","Hooker County",3,2,6,3,3
050,31,091,"Nebraska","Hooker County",3,3,7,4,3
050,31,091,"Nebraska","Hooker County",3,4,7,3,4
050,31,091,"Nebraska","Hooker County",3,5,11,4,7
050,31,091,"Nebraska","Hooker County",3,6,7,3,4
050,31,091,"Nebraska","Hooker County",3,7,10,5,5
050,31,091,"Nebraska","Hooker County",3,8,6,4,2
050,31,091,"Nebraska","Hooker County",3,9,7,3,4
050,31,091,"Nebraska","Hooker County",3,10,9,3,6
050,31,091,"Nebraska","Hooker County",3,11,9,3,6
050,31,091,"Nebraska","Hooker County",3,12,11,5,6
050,31,091,"Nebraska","Hooker County",3,13,10,4,6
050,31,091,"Nebraska","Hooker County",3,14,12,3,9
050,31,091,"Nebraska","Hooker County",3,15,13,7,6
050,31,091,"Nebraska","Hooker County",3,16,9,7,2
050,31,091,"Nebraska","Hooker County",3,17,13,10,3
050,31,091,"Nebraska","Hooker County",3,18,8,4,4
050,31,091,"Nebraska","Hooker County",3,19,5,2,3
050,31,091,"Nebraska","Hooker County",3,20,7,4,3
050,31,091,"Nebraska","Hooker County",3,21,5,3,2
050,31,091,"Nebraska","Hooker County",3,22,6,2,4
050,31,091,"Nebraska","Hooker County",3,23,6,2,4
050,31,091,"Nebraska","Hooker County",3,24,5,1,4
050,31,091,"Nebraska","Hooker County",3,25,5,2,3
050,31,091,"Nebraska","Hooker County",3,26,1,0,1
050,31,091,"Nebraska","Hooker County",3,27,4,2,2
050,31,091,"Nebraska","Hooker County",3,28,7,3,4
050,31,091,"Nebraska","Hooker County",3,29,6,4,2
050,31,091,"Nebraska","Hooker County",3,30,9,5,4
050,31,091,"Nebraska","Hooker County",3,31,10,6,4
050,31,091,"Nebraska","Hooker County",3,32,5,3,2
050,31,091,"Nebraska","Hooker County",3,33,6,4,2
050,31,091,"Nebraska","Hooker County",3,34,7,2,5
050,31,091,"Nebraska","Hooker County",3,35,5,2,3
050,31,091,"Nebraska","Hooker County",3,36,4,1,3
050,31,091,"Nebraska","Hooker County",3,37,3,1,2
050,31,091,"Nebraska","Hooker County",3,38,9,5,4
050,31,091,"Nebraska","Hooker County",3,39,10,2,8
050,31,091,"Nebraska","Hooker County",3,40,10,4,6
050,31,091,"Nebraska","Hooker County",3,41,8,4,4
050,31,091,"Nebraska","Hooker County",3,42,14,8,6
050,31,091,"Nebraska","Hooker County",3,43,13,8,5
050,31,091,"Nebraska","Hooker County",3,44,15,11,4
050,31,091,"Nebraska","Hooker County",3,45,9,6,3
050,31,091,"Nebraska","Hooker County",3,46,8,5,3
050,31,091,"Nebraska","Hooker County",3,47,9,6,3
050,31,091,"Nebraska","Hooker County",3,48,7,2,5
050,31,091,"Nebraska","Hooker County",3,49,8,3,5
050,31,091,"Nebraska","Hooker County",3,50,6,3,3
050,31,091,"Nebraska","Hooker County",3,51,8,5,3
050,31,091,"Nebraska","Hooker County",3,52,7,3,4
050,31,091,"Nebraska","Hooker County",3,53,4,2,2
050,31,091,"Nebraska","Hooker County",3,54,4,4,0
050,31,091,"Nebraska","Hooker County",3,55,4,3,1
050,31,091,"Nebraska","Hooker County",3,56,9,4,5
050,31,091,"Nebraska","Hooker County",3,57,8,3,5
050,31,091,"Nebraska","Hooker County",3,58,11,4,7
050,31,091,"Nebraska","Hooker County",3,59,7,4,3
050,31,091,"Nebraska","Hooker County",3,60,8,5,3
050,31,091,"Nebraska","Hooker County",3,61,9,6,3
050,31,091,"Nebraska","Hooker County",3,62,8,5,3
050,31,091,"Nebraska","Hooker County",3,63,15,8,7
050,31,091,"Nebraska","Hooker County",3,64,18,8,10
050,31,091,"Nebraska","Hooker County",3,65,13,4,9
050,31,091,"Nebraska","Hooker County",3,66,11,5,6
050,31,091,"Nebraska","Hooker County",3,67,11,6,5
050,31,091,"Nebraska","Hooker County",3,68,12,6,6
050,31,091,"Nebraska","Hooker County",3,69,14,8,6
050,31,091,"Nebraska","Hooker County",3,70,12,7,5
050,31,091,"Nebraska","Hooker County",3,71,9,5,4
050,31,091,"Nebraska","Hooker County",3,72,6,3,3
050,31,091,"Nebraska","Hooker County",3,73,5,1,4
050,31,091,"Nebraska","Hooker County",3,74,8,2,6
050,31,091,"Nebraska","Hooker County",3,75,8,3,5
050,31,091,"Nebraska","Hooker County",3,76,5,1,4
050,31,091,"Nebraska","Hooker County",3,77,7,4,3
050,31,091,"Nebraska","Hooker County",3,78,9,4,5
050,31,091,"Nebraska","Hooker County",3,79,9,4,5
050,31,091,"Nebraska","Hooker County",3,80,6,4,2
050,31,091,"Nebraska","Hooker County",3,81,9,5,4
050,31,091,"Nebraska","Hooker County",3,82,7,3,4
050,31,091,"Nebraska","Hooker County",3,83,5,3,2
050,31,091,"Nebraska","Hooker County",3,84,8,2,6
050,31,091,"Nebraska","Hooker County",3,85,39,12,27
050,31,091,"Nebraska","Hooker County",4,0,7,4,3
050,31,091,"Nebraska","Hooker County",4,1,6,5,1
050,31,091,"Nebraska","Hooker County",4,2,3,2,1
050,31,091,"Nebraska","Hooker County",4,3,6,3,3
050,31,091,"Nebraska","Hooker County",4,4,7,4,3
050,31,091,"Nebraska","Hooker County",4,5,7,3,4
050,31,091,"Nebraska","Hooker County",4,6,10,4,6
050,31,091,"Nebraska","Hooker County",4,7,5,2,3
050,31,091,"Nebraska","Hooker County",4,8,9,5,4
050,31,091,"Nebraska","Hooker County",4,9,6,4,2
050,31,091,"Nebraska","Hooker County",4,10,7,3,4
050,31,091,"Nebraska","Hooker County",4,11,9,3,6
050,31,091,"Nebraska","Hooker County",4,12,8,2,6
050,31,091,"Nebraska","Hooker County",4,13,11,5,6
050,31,091,"Nebraska","Hooker County",4,14,11,5,6
050,31,091,"Nebraska","Hooker County",4,15,13,3,10
050,31,091,"Nebraska","Hooker County",4,16,15,8,7
050,31,091,"Nebraska","Hooker County",4,17,8,5,3
050,31,091,"Nebraska","Hooker County",4,18,12,8,4
050,31,091,"Nebraska","Hooker County",4,19,8,3,5
050,31,091,"Nebraska","Hooker County",4,20,6,2,4
050,31,091,"Nebraska","Hooker County",4,21,8,4,4
050,31,091,"Nebraska","Hooker County",4,22,5,3,2
050,31,091,"Nebraska","Hooker County",4,23,2,1,1
050,31,091,"Nebraska","Hooker County",4,24,5,1,4
050,31,091,"Nebraska","Hooker County",4,25,3,1,2
050,31,091,"Nebraska","Hooker County",4,26,6,3,3
050,31,091,"Nebraska","Hooker County",4,27,1,0,1
050,31,091,"Nebraska","Hooker County",4,28,6,4,2
050,31,091,"Nebraska","Hooker County",4,29,7,2,5
050,31,091,"Nebraska","Hooker County",4,30,5,3,2
050,31,091,"Nebraska","Hooker County",4,31,6,4,2
050,31,091,"Nebraska","Hooker County",4,32,9,5,4
050,31,091,"Nebraska","Hooker County",4,33,4,2,2
050,31,091,"Nebraska","Hooker County",4,34,4,3,1
050,31,091,"Nebraska","Hooker County",4,35,6,2,4
050,31,091,"Nebraska","Hooker County",4,36,5,2,3
050,31,091,"Nebraska","Hooker County",4,37,4,1,3
050,31,091,"Nebraska","Hooker County",4,38,4,1,3
050,31,091,"Nebraska","Hooker County",4,39,9,5,4
050,31,091,"Nebraska","Hooker County",4,40,10,2,8
050,31,091,"Nebraska","Hooker County",4,41,11,4,7
050,31,091,"Nebraska","Hooker County",4,42,8,4,4
050,31,091,"Nebraska","Hooker County",4,43,15,8,7
050,31,091,"Nebraska","Hooker County",4,44,13,8,5
050,31,091,"Nebraska","Hooker County",4,45,15,11,4
050,31,091,"Nebraska","Hooker County",4,46,8,5,3
050,31,091,"Nebraska","Hooker County",4,47,10,6,4
050,31,091,"Nebraska","Hooker County",4,48,8,5,3
050,31,091,"Nebraska","Hooker County",4,49,7,3,4
050,31,091,"Nebraska","Hooker County",4,50,6,2,4
050,31,091,"Nebraska","Hooker County",4,51,3,0,3
050,31,091,"Nebraska","Hooker County",4,52,8,5,3
050,31,091,"Nebraska","Hooker County",4,53,7,3,4
050,31,091,"Nebraska","Hooker County",4,54,4,2,2
050,31,091,"Nebraska","Hooker County",4,55,5,5,0
050,31,091,"Nebraska","Hooker County",4,56,3,2,1
050,31,091,"Nebraska","Hooker County",4,57,8,3,5
050,31,091,"Nebraska","Hooker County",4,58,8,3,5
050,31,091,"Nebraska","Hooker County",4,59,11,4,7
050,31,091,"Nebraska","Hooker County",4,60,7,4,3
050,31,091,"Nebraska","Hooker County",4,61,8,5,3
050,31,091,"Nebraska","Hooker County",4,62,8,6,2
050,31,091,"Nebraska","Hooker County",4,63,8,5,3
050,31,091,"Nebraska","Hooker County",4,64,15,8,7
050,31,091,"Nebraska","Hooker County",4,65,17,8,9
050,31,091,"Nebraska","Hooker County",4,66,13,4,9
050,31,091,"Nebraska","Hooker County",4,67,11,5,6
050,31,091,"Nebraska","Hooker County",4,68,12,6,6
050,31,091,"Nebraska","Hooker County",4,69,11,6,5
050,31,091,"Nebraska","Hooker County",4,70,15,8,7
050,31,091,"Nebraska","Hooker County",4,71,10,5,5
050,31,091,"Nebraska","Hooker County",4,72,9,5,4
050,31,091,"Nebraska","Hooker County",4,73,7,3,4
050,31,091,"Nebraska","Hooker County",4,74,4,0,4
050,31,091,"Nebraska","Hooker County",4,75,8,2,6
050,31,091,"Nebraska","Hooker County",4,76,6,2,4
050,31,091,"Nebraska","Hooker County",4,77,4,1,3
050,31,091,"Nebraska","Hooker County",4,78,6,4,2
050,31,091,"Nebraska","Hooker County",4,79,8,4,4
050,31,091,"Nebraska","Hooker County",4,80,8,4,4
050,31,091,"Nebraska","Hooker County",4,81,5,4,1
050,31,091,"Nebraska","Hooker County",4,82,5,4,1
050,31,091,"Nebraska","Hooker County",4,83,6,3,3
050,31,091,"Nebraska","Hooker County",4,84,3,2,1
050,31,091,"Nebraska","Hooker County",4,85,27,7,20
050,31,091,"Nebraska","Hooker County",5,0,6,3,3
050,31,091,"Nebraska","Hooker County",5,1,7,4,3
050,31,091,"Nebraska","Hooker County",5,2,5,4,1
050,31,091,"Nebraska","Hooker County",5,3,3,2,1
050,31,091,"Nebraska","Hooker County",5,4,6,3,3
050,31,091,"Nebraska","Hooker County",5,5,10,4,6
050,31,091,"Nebraska","Hooker County",5,6,5,3,2
050,31,091,"Nebraska","Hooker County",5,7,9,4,5
050,31,091,"Nebraska","Hooker County",5,8,7,3,4
050,31,091,"Nebraska","Hooker County",5,9,9,5,4
050,31,091,"Nebraska","Hooker County",5,10,6,4,2
050,31,091,"Nebraska","Hooker County",5,11,9,4,5
050,31,091,"Nebraska","Hooker County",5,12,10,3,7
050,31,091,"Nebraska","Hooker County",5,13,9,3,6
050,31,091,"Nebraska","Hooker County",5,14,13,7,6
050,31,091,"Nebraska","Hooker County",5,15,10,4,6
050,31,091,"Nebraska","Hooker County",5,16,13,3,10
050,31,091,"Nebraska","Hooker County",5,17,13,8,5
050,31,091,"Nebraska","Hooker County",5,18,6,4,2
050,31,091,"Nebraska","Hooker County",5,19,10,7,3
050,31,091,"Nebraska","Hooker County",5,20,9,3,6
050,31,091,"Nebraska","Hooker County",5,21,6,1,5
050,31,091,"Nebraska","Hooker County",5,22,9,4,5
050,31,091,"Nebraska","Hooker County",5,23,5,3,2
050,31,091,"Nebraska","Hooker County",5,24,3,2,1
050,31,091,"Nebraska","Hooker County",5,25,2,0,2
050,31,091,"Nebraska","Hooker County",5,26,4,1,3
050,31,091,"Nebraska","Hooker County",5,27,6,3,3
050,31,091,"Nebraska","Hooker County",5,28,3,1,2
050,31,091,"Nebraska","Hooker County",5,29,5,3,2
050,31,091,"Nebraska","Hooker County",5,30,5,2,3
050,31,091,"Nebraska","Hooker County",5,31,5,3,2
050,31,091,"Nebraska","Hooker County",5,32,6,4,2
050,31,091,"Nebraska","Hooker County",5,33,9,4,5
050,31,091,"Nebraska","Hooker County",5,34,5,3,2
050,31,091,"Nebraska","Hooker County",5,35,5,4,1
050,31,091,"Nebraska","Hooker County",5,36,9,2,7
050,31,091,"Nebraska","Hooker County",5,37,6,3,3
050,31,091,"Nebraska","Hooker County",5,38,6,2,4
050,31,091,"Nebraska","Hooker County",5,39,3,1,2
050,31,091,"Nebraska","Hooker County",5,40,9,5,4
050,31,091,"Nebraska","Hooker County",5,41,10,2,8
050,31,091,"Nebraska","Hooker County",5,42,11,4,7
050,31,091,"Nebraska","Hooker County",5,43,9,5,4
050,31,091,"Nebraska","Hooker County",5,44,13,7,6
050,31,091,"Nebraska","Hooker County",5,45,12,7,5
050,31,091,"Nebraska","Hooker County",5,46,14,10,4
050,31,091,"Nebraska","Hooker County",5,47,8,6,2
050,31,091,"Nebraska","Hooker County",5,48,9,5,4
050,31,091,"Nebraska","Hooker County",5,49,11,8,3
050,31,091,"Nebraska","Hooker County",5,50,6,2,4
050,31,091,"Nebraska","Hooker County",5,51,5,1,4
050,31,091,"Nebraska","Hooker County",5,52,3,0,3
050,31,091,"Nebraska","Hooker County",5,53,8,5,3
050,31,091,"Nebraska","Hooker County",5,54,9,5,4
050,31,091,"Nebraska","Hooker County",5,55,5,3,2
050,31,091,"Nebraska","Hooker County",5,56,4,4,0
050,31,091,"Nebraska","Hooker County",5,57,3,2,1
050,31,091,"Nebraska","Hooker County",5,58,8,3,5
050,31,091,"Nebraska","Hooker County",5,59,6,3,3
050,31,091,"Nebraska","Hooker County",5,60,11,4,7
050,31,091,"Nebraska","Hooker County",5,61,7,4,3
050,31,091,"Nebraska","Hooker County",5,62,8,5,3
050,31,091,"Nebraska","Hooker County",5,63,7,5,2
050,31,091,"Nebraska","Hooker County",5,64,8,5,3
050,31,091,"Nebraska","Hooker County",5,65,15,8,7
050,31,091,"Nebraska","Hooker County",5,66,17,8,9
050,31,091,"Nebraska","Hooker County",5,67,13,4,9
050,31,091,"Nebraska","Hooker County",5,68,10,4,6
050,31,091,"Nebraska","Hooker County",5,69,10,6,4
050,31,091,"Nebraska","Hooker County",5,70,11,6,5
050,31,091,"Nebraska","Hooker County",5,71,14,7,7
050,31,091,"Nebraska","Hooker County",5,72,10,5,5
050,31,091,"Nebraska","Hooker County",5,73,9,5,4
050,31,091,"Nebraska","Hooker County",5,74,6,2,4
050,31,091,"Nebraska","Hooker County",5,75,4,0,4
050,31,091,"Nebraska","Hooker County",5,76,7,1,6
050,31,091,"Nebraska","Hooker County",5,77,6,2,4
050,31,091,"Nebraska","Hooker County",5,78,5,1,4
050,31,091,"Nebraska","Hooker County",5,79,6,4,2
050,31,091,"Nebraska","Hooker County",5,80,7,3,4
050,31,091,"Nebraska","Hooker County",5,81,8,4,4
050,31,091,"Nebraska","Hooker County",5,82,4,4,0
050,31,091,"Nebraska","Hooker County",5,83,4,3,1
050,31,091,"Nebraska","Hooker County",5,84,6,3,3
050,31,091,"Nebraska","Hooker County",5,85,26,6,20
050,31,093,"Nebraska","Howard County",1,0,75,38,37
050,31,093,"Nebraska","Howard County",1,1,76,39,37
050,31,093,"Nebraska","Howard County",1,2,78,42,36
050,31,093,"Nebraska","Howard County",1,3,91,47,44
050,31,093,"Nebraska","Howard County",1,4,93,48,45
050,31,093,"Nebraska","Howard County",1,5,81,46,35
050,31,093,"Nebraska","Howard County",1,6,84,39,45
050,31,093,"Nebraska","Howard County",1,7,105,50,55
050,31,093,"Nebraska","Howard County",1,8,88,44,44
050,31,093,"Nebraska","Howard County",1,9,70,29,41
050,31,093,"Nebraska","Howard County",1,10,86,49,37
050,31,093,"Nebraska","Howard County",1,11,98,55,43
050,31,093,"Nebraska","Howard County",1,12,102,53,49
050,31,093,"Nebraska","Howard County",1,13,95,51,44
050,31,093,"Nebraska","Howard County",1,14,84,43,41
050,31,093,"Nebraska","Howard County",1,15,97,53,44
050,31,093,"Nebraska","Howard County",1,16,97,56,41
050,31,093,"Nebraska","Howard County",1,17,98,57,41
050,31,093,"Nebraska","Howard County",1,18,58,35,23
050,31,093,"Nebraska","Howard County",1,19,51,24,27
050,31,093,"Nebraska","Howard County",1,20,57,31,26
050,31,093,"Nebraska","Howard County",1,21,51,27,24
050,31,093,"Nebraska","Howard County",1,22,54,31,23
050,31,093,"Nebraska","Howard County",1,23,52,24,28
050,31,093,"Nebraska","Howard County",1,24,50,20,30
050,31,093,"Nebraska","Howard County",1,25,63,30,33
050,31,093,"Nebraska","Howard County",1,26,57,31,26
050,31,093,"Nebraska","Howard County",1,27,68,33,35
050,31,093,"Nebraska","Howard County",1,28,74,33,41
050,31,093,"Nebraska","Howard County",1,29,69,40,29
050,31,093,"Nebraska","Howard County",1,30,82,43,39
050,31,093,"Nebraska","Howard County",1,31,76,39,37
050,31,093,"Nebraska","Howard County",1,32,66,28,38
050,31,093,"Nebraska","Howard County",1,33,71,33,38
050,31,093,"Nebraska","Howard County",1,34,78,43,35
050,31,093,"Nebraska","Howard County",1,35,73,36,37
050,31,093,"Nebraska","Howard County",1,36,67,35,32
050,31,093,"Nebraska","Howard County",1,37,65,33,32
050,31,093,"Nebraska","Howard County",1,38,68,32,36
050,31,093,"Nebraska","Howard County",1,39,85,48,37
050,31,093,"Nebraska","Howard County",1,40,78,43,35
050,31,093,"Nebraska","Howard County",1,41,73,39,34
050,31,093,"Nebraska","Howard County",1,42,73,33,40
050,31,093,"Nebraska","Howard County",1,43,71,38,33
050,31,093,"Nebraska","Howard County",1,44,74,40,34
050,31,093,"Nebraska","Howard County",1,45,71,33,38
050,31,093,"Nebraska","Howard County",1,46,72,42,30
050,31,093,"Nebraska","Howard County",1,47,74,42,32
050,31,093,"Nebraska","Howard County",1,48,76,39,37
050,31,093,"Nebraska","Howard County",1,49,78,41,37
050,31,093,"Nebraska","Howard County",1,50,70,39,31
050,31,093,"Nebraska","Howard County",1,51,76,39,37
050,31,093,"Nebraska","Howard County",1,52,65,33,32
050,31,093,"Nebraska","Howard County",1,53,78,39,39
050,31,093,"Nebraska","Howard County",1,54,99,46,53
050,31,093,"Nebraska","Howard County",1,55,94,46,48
050,31,093,"Nebraska","Howard County",1,56,99,48,51
050,31,093,"Nebraska","Howard County",1,57,94,45,49
050,31,093,"Nebraska","Howard County",1,58,91,43,48
050,31,093,"Nebraska","Howard County",1,59,90,49,41
050,31,093,"Nebraska","Howard County",1,60,95,54,41
050,31,093,"Nebraska","Howard County",1,61,84,49,35
050,31,093,"Nebraska","Howard County",1,62,101,51,50
050,31,093,"Nebraska","Howard County",1,63,92,44,48
050,31,093,"Nebraska","Howard County",1,64,90,48,42
050,31,093,"Nebraska","Howard County",1,65,81,42,39
050,31,093,"Nebraska","Howard County",1,66,87,45,42
050,31,093,"Nebraska","Howard County",1,67,75,40,35
050,31,093,"Nebraska","Howard County",1,68,82,40,42
050,31,093,"Nebraska","Howard County",1,69,61,28,33
050,31,093,"Nebraska","Howard County",1,70,68,27,41
050,31,093,"Nebraska","Howard County",1,71,82,40,42
050,31,093,"Nebraska","Howard County",1,72,86,42,44
050,31,093,"Nebraska","Howard County",1,73,85,39,46
050,31,093,"Nebraska","Howard County",1,74,51,25,26
050,31,093,"Nebraska","Howard County",1,75,61,33,28
050,31,093,"Nebraska","Howard County",1,76,54,28,26
050,31,093,"Nebraska","Howard County",1,77,47,25,22
050,31,093,"Nebraska","Howard County",1,78,40,20,20
050,31,093,"Nebraska","Howard County",1,79,38,22,16
050,31,093,"Nebraska","Howard County",1,80,38,15,23
050,31,093,"Nebraska","Howard County",1,81,39,14,25
050,31,093,"Nebraska","Howard County",1,82,43,21,22
050,31,093,"Nebraska","Howard County",1,83,42,24,18
050,31,093,"Nebraska","Howard County",1,84,28,11,17
050,31,093,"Nebraska","Howard County",1,85,191,80,111
050,31,093,"Nebraska","Howard County",2,0,75,38,37
050,31,093,"Nebraska","Howard County",2,1,75,38,37
050,31,093,"Nebraska","Howard County",2,2,78,41,37
050,31,093,"Nebraska","Howard County",2,3,89,45,44
050,31,093,"Nebraska","Howard County",2,4,93,48,45
050,31,093,"Nebraska","Howard County",2,5,83,46,37
050,31,093,"Nebraska","Howard County",2,6,86,42,44
050,31,093,"Nebraska","Howard County",2,7,101,48,53
050,31,093,"Nebraska","Howard County",2,8,92,45,47
050,31,093,"Nebraska","Howard County",2,9,76,33,43
050,31,093,"Nebraska","Howard County",2,10,84,46,38
050,31,093,"Nebraska","Howard County",2,11,95,53,42
050,31,093,"Nebraska","Howard County",2,12,102,54,48
050,31,093,"Nebraska","Howard County",2,13,96,51,45
050,31,093,"Nebraska","Howard County",2,14,85,44,41
050,31,093,"Nebraska","Howard County",2,15,94,51,43
050,31,093,"Nebraska","Howard County",2,16,98,56,42
050,31,093,"Nebraska","Howard County",2,17,98,57,41
050,31,093,"Nebraska","Howard County",2,18,65,39,26
050,31,093,"Nebraska","Howard County",2,19,51,26,25
050,31,093,"Nebraska","Howard County",2,20,55,29,26
050,31,093,"Nebraska","Howard County",2,21,54,28,26
050,31,093,"Nebraska","Howard County",2,22,54,30,24
050,31,093,"Nebraska","Howard County",2,23,52,25,27
050,31,093,"Nebraska","Howard County",2,24,49,20,29
050,31,093,"Nebraska","Howard County",2,25,60,28,32
050,31,093,"Nebraska","Howard County",2,26,59,31,28
050,31,093,"Nebraska","Howard County",2,27,67,33,34
050,31,093,"Nebraska","Howard County",2,28,74,34,40
050,31,093,"Nebraska","Howard County",2,29,72,39,33
050,31,093,"Nebraska","Howard County",2,30,81,44,37
050,31,093,"Nebraska","Howard County",2,31,78,40,38
050,31,093,"Nebraska","Howard County",2,32,68,30,38
050,31,093,"Nebraska","Howard County",2,33,69,32,37
050,31,093,"Nebraska","Howard County",2,34,77,40,37
050,31,093,"Nebraska","Howard County",2,35,76,38,38
050,31,093,"Nebraska","Howard County",2,36,67,35,32
050,31,093,"Nebraska","Howard County",2,37,66,34,32
050,31,093,"Nebraska","Howard County",2,38,69,34,35
050,31,093,"Nebraska","Howard County",2,39,81,44,37
050,31,093,"Nebraska","Howard County",2,40,81,45,36
050,31,093,"Nebraska","Howard County",2,41,73,40,33
050,31,093,"Nebraska","Howard County",2,42,73,35,38
050,31,093,"Nebraska","Howard County",2,43,73,37,36
050,31,093,"Nebraska","Howard County",2,44,73,38,35
050,31,093,"Nebraska","Howard County",2,45,73,35,38
050,31,093,"Nebraska","Howard County",2,46,72,40,32
050,31,093,"Nebraska","Howard County",2,47,74,43,31
050,31,093,"Nebraska","Howard County",2,48,77,40,37
050,31,093,"Nebraska","Howard County",2,49,79,42,37
050,31,093,"Nebraska","Howard County",2,50,73,40,33
050,31,093,"Nebraska","Howard County",2,51,73,38,35
050,31,093,"Nebraska","Howard County",2,52,67,34,33
050,31,093,"Nebraska","Howard County",2,53,76,38,38
050,31,093,"Nebraska","Howard County",2,54,91,42,49
050,31,093,"Nebraska","Howard County",2,55,96,46,50
050,31,093,"Nebraska","Howard County",2,56,98,48,50
050,31,093,"Nebraska","Howard County",2,57,96,46,50
050,31,093,"Nebraska","Howard County",2,58,90,43,47
050,31,093,"Nebraska","Howard County",2,59,91,48,43
050,31,093,"Nebraska","Howard County",2,60,95,54,41
050,31,093,"Nebraska","Howard County",2,61,85,48,37
050,31,093,"Nebraska","Howard County",2,62,96,50,46
050,31,093,"Nebraska","Howard County",2,63,96,47,49
050,31,093,"Nebraska","Howard County",2,64,89,46,43
050,31,093,"Nebraska","Howard County",2,65,85,44,41
050,31,093,"Nebraska","Howard County",2,66,86,45,41
050,31,093,"Nebraska","Howard County",2,67,77,41,36
050,31,093,"Nebraska","Howard County",2,68,80,40,40
050,31,093,"Nebraska","Howard County",2,69,66,31,35
050,31,093,"Nebraska","Howard County",2,70,67,27,40
050,31,093,"Nebraska","Howard County",2,71,77,37,40
050,31,093,"Nebraska","Howard County",2,72,82,39,43
050,31,093,"Nebraska","Howard County",2,73,89,42,47
050,31,093,"Nebraska","Howard County",2,74,55,27,28
050,31,093,"Nebraska","Howard County",2,75,57,31,26
050,31,093,"Nebraska","Howard County",2,76,55,28,27
050,31,093,"Nebraska","Howard County",2,77,51,27,24
050,31,093,"Nebraska","Howard County",2,78,40,20,20
050,31,093,"Nebraska","Howard County",2,79,38,22,16
050,31,093,"Nebraska","Howard County",2,80,37,15,22
050,31,093,"Nebraska","Howard County",2,81,38,14,24
050,31,093,"Nebraska","Howard County",2,82,42,20,22
050,31,093,"Nebraska","Howard County",2,83,39,22,17
050,31,093,"Nebraska","Howard County",2,84,30,13,17
050,31,093,"Nebraska","Howard County",2,85,188,79,109
050,31,093,"Nebraska","Howard County",3,0,78,36,42
050,31,093,"Nebraska","Howard County",3,1,78,36,42
050,31,093,"Nebraska","Howard County",3,2,77,41,36
050,31,093,"Nebraska","Howard County",3,3,77,41,36
050,31,093,"Nebraska","Howard County",3,4,87,44,43
050,31,093,"Nebraska","Howard County",3,5,100,54,46
050,31,093,"Nebraska","Howard County",3,6,84,44,40
050,31,093,"Nebraska","Howard County",3,7,88,41,47
050,31,093,"Nebraska","Howard County",3,8,109,54,55
050,31,093,"Nebraska","Howard County",3,9,89,44,45
050,31,093,"Nebraska","Howard County",3,10,74,32,42
050,31,093,"Nebraska","Howard County",3,11,81,44,37
050,31,093,"Nebraska","Howard County",3,12,94,50,44
050,31,093,"Nebraska","Howard County",3,13,104,59,45
050,31,093,"Nebraska","Howard County",3,14,99,53,46
050,31,093,"Nebraska","Howard County",3,15,87,45,42
050,31,093,"Nebraska","Howard County",3,16,97,52,45
050,31,093,"Nebraska","Howard County",3,17,104,57,47
050,31,093,"Nebraska","Howard County",3,18,90,49,41
050,31,093,"Nebraska","Howard County",3,19,56,35,21
050,31,093,"Nebraska","Howard County",3,20,54,27,27
050,31,093,"Nebraska","Howard County",3,21,51,30,21
050,31,093,"Nebraska","Howard County",3,22,57,31,26
050,31,093,"Nebraska","Howard County",3,23,47,24,23
050,31,093,"Nebraska","Howard County",3,24,46,22,24
050,31,093,"Nebraska","Howard County",3,25,46,20,26
050,31,093,"Nebraska","Howard County",3,26,61,28,33
050,31,093,"Nebraska","Howard County",3,27,58,31,27
050,31,093,"Nebraska","Howard County",3,28,72,37,35
050,31,093,"Nebraska","Howard County",3,29,70,33,37
050,31,093,"Nebraska","Howard County",3,30,76,43,33
050,31,093,"Nebraska","Howard County",3,31,81,45,36
050,31,093,"Nebraska","Howard County",3,32,79,39,40
050,31,093,"Nebraska","Howard County",3,33,68,30,38
050,31,093,"Nebraska","Howard County",3,34,75,38,37
050,31,093,"Nebraska","Howard County",3,35,82,40,42
050,31,093,"Nebraska","Howard County",3,36,76,37,39
050,31,093,"Nebraska","Howard County",3,37,70,37,33
050,31,093,"Nebraska","Howard County",3,38,70,38,32
050,31,093,"Nebraska","Howard County",3,39,73,36,37
050,31,093,"Nebraska","Howard County",3,40,77,44,33
050,31,093,"Nebraska","Howard County",3,41,84,47,37
050,31,093,"Nebraska","Howard County",3,42,79,39,40
050,31,093,"Nebraska","Howard County",3,43,72,32,40
050,31,093,"Nebraska","Howard County",3,44,73,37,36
050,31,093,"Nebraska","Howard County",3,45,72,34,38
050,31,093,"Nebraska","Howard County",3,46,77,40,37
050,31,093,"Nebraska","Howard County",3,47,77,46,31
050,31,093,"Nebraska","Howard County",3,48,72,40,32
050,31,093,"Nebraska","Howard County",3,49,77,40,37
050,31,093,"Nebraska","Howard County",3,50,79,42,37
050,31,093,"Nebraska","Howard County",3,51,73,40,33
050,31,093,"Nebraska","Howard County",3,52,69,36,33
050,31,093,"Nebraska","Howard County",3,53,68,33,35
050,31,093,"Nebraska","Howard County",3,54,72,36,36
050,31,093,"Nebraska","Howard County",3,55,89,41,48
050,31,093,"Nebraska","Howard County",3,56,100,50,50
050,31,093,"Nebraska","Howard County",3,57,97,46,51
050,31,093,"Nebraska","Howard County",3,58,84,41,43
050,31,093,"Nebraska","Howard County",3,59,90,42,48
050,31,093,"Nebraska","Howard County",3,60,96,51,45
050,31,093,"Nebraska","Howard County",3,61,92,49,43
050,31,093,"Nebraska","Howard County",3,62,83,45,38
050,31,093,"Nebraska","Howard County",3,63,96,51,45
050,31,093,"Nebraska","Howard County",3,64,96,48,48
050,31,093,"Nebraska","Howard County",3,65,86,43,43
050,31,093,"Nebraska","Howard County",3,66,87,45,42
050,31,093,"Nebraska","Howard County",3,67,91,47,44
050,31,093,"Nebraska","Howard County",3,68,75,40,35
050,31,093,"Nebraska","Howard County",3,69,78,37,41
050,31,093,"Nebraska","Howard County",3,70,68,30,38
050,31,093,"Nebraska","Howard County",3,71,65,27,38
050,31,093,"Nebraska","Howard County",3,72,79,35,44
050,31,093,"Nebraska","Howard County",3,73,81,37,44
050,31,093,"Nebraska","Howard County",3,74,86,45,41
050,31,093,"Nebraska","Howard County",3,75,56,28,28
050,31,093,"Nebraska","Howard County",3,76,56,26,30
050,31,093,"Nebraska","Howard County",3,77,52,28,24
050,31,093,"Nebraska","Howard County",3,78,47,24,23
050,31,093,"Nebraska","Howard County",3,79,40,23,17
050,31,093,"Nebraska","Howard County",3,80,37,17,20
050,31,093,"Nebraska","Howard County",3,81,35,14,21
050,31,093,"Nebraska","Howard County",3,82,37,15,22
050,31,093,"Nebraska","Howard County",3,83,40,19,21
050,31,093,"Nebraska","Howard County",3,84,32,16,16
050,31,093,"Nebraska","Howard County",3,85,184,80,104
050,31,093,"Nebraska","Howard County",4,0,78,41,37
050,31,093,"Nebraska","Howard County",4,1,77,38,39
050,31,093,"Nebraska","Howard County",4,2,79,43,36
050,31,093,"Nebraska","Howard County",4,3,88,46,42
050,31,093,"Nebraska","Howard County",4,4,70,39,31
050,31,093,"Nebraska","Howard County",4,5,85,44,41
050,31,093,"Nebraska","Howard County",4,6,93,46,47
050,31,093,"Nebraska","Howard County",4,7,87,49,38
050,31,093,"Nebraska","Howard County",4,8,85,40,45
050,31,093,"Nebraska","Howard County",4,9,111,60,51
050,31,093,"Nebraska","Howard County",4,10,87,40,47
050,31,093,"Nebraska","Howard County",4,11,76,32,44
050,31,093,"Nebraska","Howard County",4,12,79,42,37
050,31,093,"Nebraska","Howard County",4,13,93,49,44
050,31,093,"Nebraska","Howard County",4,14,105,61,44
050,31,093,"Nebraska","Howard County",4,15,96,55,41
050,31,093,"Nebraska","Howard County",4,16,88,44,44
050,31,093,"Nebraska","Howard County",4,17,99,53,46
050,31,093,"Nebraska","Howard County",4,18,78,47,31
050,31,093,"Nebraska","Howard County",4,19,65,37,28
050,31,093,"Nebraska","Howard County",4,20,59,37,22
050,31,093,"Nebraska","Howard County",4,21,49,23,26
050,31,093,"Nebraska","Howard County",4,22,56,32,24
050,31,093,"Nebraska","Howard County",4,23,57,32,25
050,31,093,"Nebraska","Howard County",4,24,47,26,21
050,31,093,"Nebraska","Howard County",4,25,48,26,22
050,31,093,"Nebraska","Howard County",4,26,43,16,27
050,31,093,"Nebraska","Howard County",4,27,59,25,34
050,31,093,"Nebraska","Howard County",4,28,60,29,31
050,31,093,"Nebraska","Howard County",4,29,78,38,40
050,31,093,"Nebraska","Howard County",4,30,69,32,37
050,31,093,"Nebraska","Howard County",4,31,81,46,35
050,31,093,"Nebraska","Howard County",4,32,85,45,40
050,31,093,"Nebraska","Howard County",4,33,76,36,40
050,31,093,"Nebraska","Howard County",4,34,75,36,39
050,31,093,"Nebraska","Howard County",4,35,74,37,37
050,31,093,"Nebraska","Howard County",4,36,87,41,46
050,31,093,"Nebraska","Howard County",4,37,76,37,39
050,31,093,"Nebraska","Howard County",4,38,70,38,32
050,31,093,"Nebraska","Howard County",4,39,69,37,32
050,31,093,"Nebraska","Howard County",4,40,72,37,35
050,31,093,"Nebraska","Howard County",4,41,85,48,37
050,31,093,"Nebraska","Howard County",4,42,83,47,36
050,31,093,"Nebraska","Howard County",4,43,79,41,38
050,31,093,"Nebraska","Howard County",4,44,71,32,39
050,31,093,"Nebraska","Howard County",4,45,72,37,35
050,31,093,"Nebraska","Howard County",4,46,73,34,39
050,31,093,"Nebraska","Howard County",4,47,74,38,36
050,31,093,"Nebraska","Howard County",4,48,76,48,28
050,31,093,"Nebraska","Howard County",4,49,71,40,31
050,31,093,"Nebraska","Howard County",4,50,77,40,37
050,31,093,"Nebraska","Howard County",4,51,78,43,35
050,31,093,"Nebraska","Howard County",4,52,73,40,33
050,31,093,"Nebraska","Howard County",4,53,69,35,34
050,31,093,"Nebraska","Howard County",4,54,68,33,35
050,31,093,"Nebraska","Howard County",4,55,71,31,40
050,31,093,"Nebraska","Howard County",4,56,89,42,47
050,31,093,"Nebraska","Howard County",4,57,98,47,51
050,31,093,"Nebraska","Howard County",4,58,94,46,48
050,31,093,"Nebraska","Howard County",4,59,86,40,46
050,31,093,"Nebraska","Howard County",4,60,91,45,46
050,31,093,"Nebraska","Howard County",4,61,93,49,44
050,31,093,"Nebraska","Howard County",4,62,93,49,44
050,31,093,"Nebraska","Howard County",4,63,88,48,40
050,31,093,"Nebraska","Howard County",4,64,93,48,45
050,31,093,"Nebraska","Howard County",4,65,92,46,46
050,31,093,"Nebraska","Howard County",4,66,83,42,41
050,31,093,"Nebraska","Howard County",4,67,82,42,40
050,31,093,"Nebraska","Howard County",4,68,89,46,43
050,31,093,"Nebraska","Howard County",4,69,73,38,35
050,31,093,"Nebraska","Howard County",4,70,82,37,45
050,31,093,"Nebraska","Howard County",4,71,68,30,38
050,31,093,"Nebraska","Howard County",4,72,68,28,40
050,31,093,"Nebraska","Howard County",4,73,76,33,43
050,31,093,"Nebraska","Howard County",4,74,81,42,39
050,31,093,"Nebraska","Howard County",4,75,87,44,43
050,31,093,"Nebraska","Howard County",4,76,55,23,32
050,31,093,"Nebraska","Howard County",4,77,52,27,25
050,31,093,"Nebraska","Howard County",4,78,52,29,23
050,31,093,"Nebraska","Howard County",4,79,45,27,18
050,31,093,"Nebraska","Howard County",4,80,40,18,22
050,31,093,"Nebraska","Howard County",4,81,37,15,22
050,31,093,"Nebraska","Howard County",4,82,39,19,20
050,31,093,"Nebraska","Howard County",4,83,35,15,20
050,31,093,"Nebraska","Howard County",4,84,31,12,19
050,31,093,"Nebraska","Howard County",4,85,188,83,105
050,31,093,"Nebraska","Howard County",5,0,78,42,36
050,31,093,"Nebraska","Howard County",5,1,82,42,40
050,31,093,"Nebraska","Howard County",5,2,83,41,42
050,31,093,"Nebraska","Howard County",5,3,79,41,38
050,31,093,"Nebraska","Howard County",5,4,86,47,39
050,31,093,"Nebraska","Howard County",5,5,72,41,31
050,31,093,"Nebraska","Howard County",5,6,93,51,42
050,31,093,"Nebraska","Howard County",5,7,94,49,45
050,31,093,"Nebraska","Howard County",5,8,84,47,37
050,31,093,"Nebraska","Howard County",5,9,87,40,47
050,31,093,"Nebraska","Howard County",5,10,110,53,57
050,31,093,"Nebraska","Howard County",5,11,85,38,47
050,31,093,"Nebraska","Howard County",5,12,77,33,44
050,31,093,"Nebraska","Howard County",5,13,73,38,35
050,31,093,"Nebraska","Howard County",5,14,86,44,42
050,31,093,"Nebraska","Howard County",5,15,105,66,39
050,31,093,"Nebraska","Howard County",5,16,91,50,41
050,31,093,"Nebraska","Howard County",5,17,84,41,43
050,31,093,"Nebraska","Howard County",5,18,84,45,39
050,31,093,"Nebraska","Howard County",5,19,62,38,24
050,31,093,"Nebraska","Howard County",5,20,75,40,35
050,31,093,"Nebraska","Howard County",5,21,59,37,22
050,31,093,"Nebraska","Howard County",5,22,57,23,34
050,31,093,"Nebraska","Howard County",5,23,58,33,25
050,31,093,"Nebraska","Howard County",5,24,68,35,33
050,31,093,"Nebraska","Howard County",5,25,47,28,19
050,31,093,"Nebraska","Howard County",5,26,53,30,23
050,31,093,"Nebraska","Howard County",5,27,49,18,31
050,31,093,"Nebraska","Howard County",5,28,65,26,39
050,31,093,"Nebraska","Howard County",5,29,61,31,30
050,31,093,"Nebraska","Howard County",5,30,71,40,31
050,31,093,"Nebraska","Howard County",5,31,71,31,40
050,31,093,"Nebraska","Howard County",5,32,94,53,41
050,31,093,"Nebraska","Howard County",5,33,82,42,40
050,31,093,"Nebraska","Howard County",5,34,72,34,38
050,31,093,"Nebraska","Howard County",5,35,71,36,35
050,31,093,"Nebraska","Howard County",5,36,73,37,36
050,31,093,"Nebraska","Howard County",5,37,80,39,41
050,31,093,"Nebraska","Howard County",5,38,78,37,41
050,31,093,"Nebraska","Howard County",5,39,69,35,34
050,31,093,"Nebraska","Howard County",5,40,70,40,30
050,31,093,"Nebraska","Howard County",5,41,71,36,35
050,31,093,"Nebraska","Howard County",5,42,88,53,35
050,31,093,"Nebraska","Howard County",5,43,84,49,35
050,31,093,"Nebraska","Howard County",5,44,75,37,38
050,31,093,"Nebraska","Howard County",5,45,64,28,36
050,31,093,"Nebraska","Howard County",5,46,71,37,34
050,31,093,"Nebraska","Howard County",5,47,70,34,36
050,31,093,"Nebraska","Howard County",5,48,77,39,38
050,31,093,"Nebraska","Howard County",5,49,73,45,28
050,31,093,"Nebraska","Howard County",5,50,73,39,34
050,31,093,"Nebraska","Howard County",5,51,79,42,37
050,31,093,"Nebraska","Howard County",5,52,78,44,34
050,31,093,"Nebraska","Howard County",5,53,72,36,36
050,31,093,"Nebraska","Howard County",5,54,72,36,36
050,31,093,"Nebraska","Howard County",5,55,71,33,38
050,31,093,"Nebraska","Howard County",5,56,70,31,39
050,31,093,"Nebraska","Howard County",5,57,94,43,51
050,31,093,"Nebraska","Howard County",5,58,94,47,47
050,31,093,"Nebraska","Howard County",5,59,94,44,50
050,31,093,"Nebraska","Howard County",5,60,91,46,45
050,31,093,"Nebraska","Howard County",5,61,86,40,46
050,31,093,"Nebraska","Howard County",5,62,93,50,43
050,31,093,"Nebraska","Howard County",5,63,92,49,43
050,31,093,"Nebraska","Howard County",5,64,91,48,43
050,31,093,"Nebraska","Howard County",5,65,90,46,44
050,31,093,"Nebraska","Howard County",5,66,93,47,46
050,31,093,"Nebraska","Howard County",5,67,83,42,41
050,31,093,"Nebraska","Howard County",5,68,81,41,40
050,31,093,"Nebraska","Howard County",5,69,85,43,42
050,31,093,"Nebraska","Howard County",5,70,77,38,39
050,31,093,"Nebraska","Howard County",5,71,76,37,39
050,31,093,"Nebraska","Howard County",5,72,71,31,40
050,31,093,"Nebraska","Howard County",5,73,66,26,40
050,31,093,"Nebraska","Howard County",5,74,73,36,37
050,31,093,"Nebraska","Howard County",5,75,83,42,41
050,31,093,"Nebraska","Howard County",5,76,83,37,46
050,31,093,"Nebraska","Howard County",5,77,49,21,28
050,31,093,"Nebraska","Howard County",5,78,51,27,24
050,31,093,"Nebraska","Howard County",5,79,51,32,19
050,31,093,"Nebraska","Howard County",5,80,42,21,21
050,31,093,"Nebraska","Howard County",5,81,39,16,23
050,31,093,"Nebraska","Howard County",5,82,35,17,18
050,31,093,"Nebraska","Howard County",5,83,39,20,19
050,31,093,"Nebraska","Howard County",5,84,27,8,19
050,31,093,"Nebraska","Howard County",5,85,192,83,109
050,31,095,"Nebraska","Jefferson County",1,0,89,48,41
050,31,095,"Nebraska","Jefferson County",1,1,98,54,44
050,31,095,"Nebraska","Jefferson County",1,2,74,35,39
050,31,095,"Nebraska","Jefferson County",1,3,88,39,49
050,31,095,"Nebraska","Jefferson County",1,4,80,37,43
050,31,095,"Nebraska","Jefferson County",1,5,77,45,32
050,31,095,"Nebraska","Jefferson County",1,6,99,51,48
050,31,095,"Nebraska","Jefferson County",1,7,94,48,46
050,31,095,"Nebraska","Jefferson County",1,8,84,38,46
050,31,095,"Nebraska","Jefferson County",1,9,88,42,46
050,31,095,"Nebraska","Jefferson County",1,10,81,37,44
050,31,095,"Nebraska","Jefferson County",1,11,89,52,37
050,31,095,"Nebraska","Jefferson County",1,12,110,63,47
050,31,095,"Nebraska","Jefferson County",1,13,94,44,50
050,31,095,"Nebraska","Jefferson County",1,14,100,49,51
050,31,095,"Nebraska","Jefferson County",1,15,101,55,46
050,31,095,"Nebraska","Jefferson County",1,16,86,39,47
050,31,095,"Nebraska","Jefferson County",1,17,96,39,57
050,31,095,"Nebraska","Jefferson County",1,18,76,33,43
050,31,095,"Nebraska","Jefferson County",1,19,68,35,33
050,31,095,"Nebraska","Jefferson County",1,20,64,29,35
050,31,095,"Nebraska","Jefferson County",1,21,53,29,24
050,31,095,"Nebraska","Jefferson County",1,22,70,34,36
050,31,095,"Nebraska","Jefferson County",1,23,67,33,34
050,31,095,"Nebraska","Jefferson County",1,24,51,24,27
050,31,095,"Nebraska","Jefferson County",1,25,69,33,36
050,31,095,"Nebraska","Jefferson County",1,26,52,27,25
050,31,095,"Nebraska","Jefferson County",1,27,68,34,34
050,31,095,"Nebraska","Jefferson County",1,28,76,41,35
050,31,095,"Nebraska","Jefferson County",1,29,79,42,37
050,31,095,"Nebraska","Jefferson County",1,30,71,37,34
050,31,095,"Nebraska","Jefferson County",1,31,67,29,38
050,31,095,"Nebraska","Jefferson County",1,32,81,39,42
050,31,095,"Nebraska","Jefferson County",1,33,79,45,34
050,31,095,"Nebraska","Jefferson County",1,34,83,46,37
050,31,095,"Nebraska","Jefferson County",1,35,80,41,39
050,31,095,"Nebraska","Jefferson County",1,36,79,36,43
050,31,095,"Nebraska","Jefferson County",1,37,86,38,48
050,31,095,"Nebraska","Jefferson County",1,38,75,42,33
050,31,095,"Nebraska","Jefferson County",1,39,85,46,39
050,31,095,"Nebraska","Jefferson County",1,40,80,35,45
050,31,095,"Nebraska","Jefferson County",1,41,74,32,42
050,31,095,"Nebraska","Jefferson County",1,42,85,41,44
050,31,095,"Nebraska","Jefferson County",1,43,72,43,29
050,31,095,"Nebraska","Jefferson County",1,44,80,50,30
050,31,095,"Nebraska","Jefferson County",1,45,79,44,35
050,31,095,"Nebraska","Jefferson County",1,46,67,31,36
050,31,095,"Nebraska","Jefferson County",1,47,83,41,42
050,31,095,"Nebraska","Jefferson County",1,48,80,39,41
050,31,095,"Nebraska","Jefferson County",1,49,81,47,34
050,31,095,"Nebraska","Jefferson County",1,50,90,44,46
050,31,095,"Nebraska","Jefferson County",1,51,69,33,36
050,31,095,"Nebraska","Jefferson County",1,52,71,31,40
050,31,095,"Nebraska","Jefferson County",1,53,78,32,46
050,31,095,"Nebraska","Jefferson County",1,54,103,47,56
050,31,095,"Nebraska","Jefferson County",1,55,82,45,37
050,31,095,"Nebraska","Jefferson County",1,56,96,51,45
050,31,095,"Nebraska","Jefferson County",1,57,102,53,49
050,31,095,"Nebraska","Jefferson County",1,58,110,58,52
050,31,095,"Nebraska","Jefferson County",1,59,112,57,55
050,31,095,"Nebraska","Jefferson County",1,60,109,55,54
050,31,095,"Nebraska","Jefferson County",1,61,135,67,68
050,31,095,"Nebraska","Jefferson County",1,62,131,70,61
050,31,095,"Nebraska","Jefferson County",1,63,116,60,56
050,31,095,"Nebraska","Jefferson County",1,64,119,62,57
050,31,095,"Nebraska","Jefferson County",1,65,108,61,47
050,31,095,"Nebraska","Jefferson County",1,66,116,62,54
050,31,095,"Nebraska","Jefferson County",1,67,101,57,44
050,31,095,"Nebraska","Jefferson County",1,68,101,52,49
050,31,095,"Nebraska","Jefferson County",1,69,107,53,54
050,31,095,"Nebraska","Jefferson County",1,70,100,43,57
050,31,095,"Nebraska","Jefferson County",1,71,92,39,53
050,31,095,"Nebraska","Jefferson County",1,72,91,48,43
050,31,095,"Nebraska","Jefferson County",1,73,95,52,43
050,31,095,"Nebraska","Jefferson County",1,74,58,27,31
050,31,095,"Nebraska","Jefferson County",1,75,58,27,31
050,31,095,"Nebraska","Jefferson County",1,76,65,31,34
050,31,095,"Nebraska","Jefferson County",1,77,66,28,38
050,31,095,"Nebraska","Jefferson County",1,78,51,23,28
050,31,095,"Nebraska","Jefferson County",1,79,52,27,25
050,31,095,"Nebraska","Jefferson County",1,80,46,25,21
050,31,095,"Nebraska","Jefferson County",1,81,49,22,27
050,31,095,"Nebraska","Jefferson County",1,82,38,19,19
050,31,095,"Nebraska","Jefferson County",1,83,41,19,22
050,31,095,"Nebraska","Jefferson County",1,84,38,13,25
050,31,095,"Nebraska","Jefferson County",1,85,256,88,168
050,31,095,"Nebraska","Jefferson County",2,0,96,46,50
050,31,095,"Nebraska","Jefferson County",2,1,97,53,44
050,31,095,"Nebraska","Jefferson County",2,2,78,39,39
050,31,095,"Nebraska","Jefferson County",2,3,85,38,47
050,31,095,"Nebraska","Jefferson County",2,4,83,39,44
050,31,095,"Nebraska","Jefferson County",2,5,79,44,35
050,31,095,"Nebraska","Jefferson County",2,6,94,51,43
050,31,095,"Nebraska","Jefferson County",2,7,95,48,47
050,31,095,"Nebraska","Jefferson County",2,8,88,40,48
050,31,095,"Nebraska","Jefferson County",2,9,87,41,46
050,31,095,"Nebraska","Jefferson County",2,10,82,38,44
050,31,095,"Nebraska","Jefferson County",2,11,87,48,39
050,31,095,"Nebraska","Jefferson County",2,12,108,62,46
050,31,095,"Nebraska","Jefferson County",2,13,100,51,49
050,31,095,"Nebraska","Jefferson County",2,14,100,49,51
050,31,095,"Nebraska","Jefferson County",2,15,103,54,49
050,31,095,"Nebraska","Jefferson County",2,16,90,43,47
050,31,095,"Nebraska","Jefferson County",2,17,93,39,54
050,31,095,"Nebraska","Jefferson County",2,18,76,33,43
050,31,095,"Nebraska","Jefferson County",2,19,67,33,34
050,31,095,"Nebraska","Jefferson County",2,20,66,30,36
050,31,095,"Nebraska","Jefferson County",2,21,57,30,27
050,31,095,"Nebraska","Jefferson County",2,22,67,33,34
050,31,095,"Nebraska","Jefferson County",2,23,67,33,34
050,31,095,"Nebraska","Jefferson County",2,24,55,27,28
050,31,095,"Nebraska","Jefferson County",2,25,65,32,33
050,31,095,"Nebraska","Jefferson County",2,26,56,29,27
050,31,095,"Nebraska","Jefferson County",2,27,65,34,31
050,31,095,"Nebraska","Jefferson County",2,28,75,40,35
050,31,095,"Nebraska","Jefferson County",2,29,79,42,37
050,31,095,"Nebraska","Jefferson County",2,30,73,38,35
050,31,095,"Nebraska","Jefferson County",2,31,69,32,37
050,31,095,"Nebraska","Jefferson County",2,32,78,37,41
050,31,095,"Nebraska","Jefferson County",2,33,80,44,36
050,31,095,"Nebraska","Jefferson County",2,34,84,47,37
050,31,095,"Nebraska","Jefferson County",2,35,81,42,39
050,31,095,"Nebraska","Jefferson County",2,36,80,37,43
050,31,095,"Nebraska","Jefferson County",2,37,85,38,47
050,31,095,"Nebraska","Jefferson County",2,38,78,41,37
050,31,095,"Nebraska","Jefferson County",2,39,84,45,39
050,31,095,"Nebraska","Jefferson County",2,40,83,39,44
050,31,095,"Nebraska","Jefferson County",2,41,76,33,43
050,31,095,"Nebraska","Jefferson County",2,42,83,39,44
050,31,095,"Nebraska","Jefferson County",2,43,75,42,33
050,31,095,"Nebraska","Jefferson County",2,44,79,49,30
050,31,095,"Nebraska","Jefferson County",2,45,79,45,34
050,31,095,"Nebraska","Jefferson County",2,46,71,34,37
050,31,095,"Nebraska","Jefferson County",2,47,80,39,41
050,31,095,"Nebraska","Jefferson County",2,48,79,39,40
050,31,095,"Nebraska","Jefferson County",2,49,82,46,36
050,31,095,"Nebraska","Jefferson County",2,50,87,45,42
050,31,095,"Nebraska","Jefferson County",2,51,74,36,38
050,31,095,"Nebraska","Jefferson County",2,52,70,31,39
050,31,095,"Nebraska","Jefferson County",2,53,76,32,44
050,31,095,"Nebraska","Jefferson County",2,54,97,44,53
050,31,095,"Nebraska","Jefferson County",2,55,87,46,41
050,31,095,"Nebraska","Jefferson County",2,56,93,50,43
050,31,095,"Nebraska","Jefferson County",2,57,101,52,49
050,31,095,"Nebraska","Jefferson County",2,58,106,55,51
050,31,095,"Nebraska","Jefferson County",2,59,112,58,54
050,31,095,"Nebraska","Jefferson County",2,60,110,56,54
050,31,095,"Nebraska","Jefferson County",2,61,128,64,64
050,31,095,"Nebraska","Jefferson County",2,62,130,68,62
050,31,095,"Nebraska","Jefferson County",2,63,122,64,58
050,31,095,"Nebraska","Jefferson County",2,64,116,62,54
050,31,095,"Nebraska","Jefferson County",2,65,109,61,48
050,31,095,"Nebraska","Jefferson County",2,66,114,62,52
050,31,095,"Nebraska","Jefferson County",2,67,104,58,46
050,31,095,"Nebraska","Jefferson County",2,68,101,53,48
050,31,095,"Nebraska","Jefferson County",2,69,108,54,54
050,31,095,"Nebraska","Jefferson County",2,70,99,43,56
050,31,095,"Nebraska","Jefferson County",2,71,93,39,54
050,31,095,"Nebraska","Jefferson County",2,72,88,45,43
050,31,095,"Nebraska","Jefferson County",2,73,97,52,45
050,31,095,"Nebraska","Jefferson County",2,74,63,31,32
050,31,095,"Nebraska","Jefferson County",2,75,57,28,29
050,31,095,"Nebraska","Jefferson County",2,76,63,30,33
050,31,095,"Nebraska","Jefferson County",2,77,67,28,39
050,31,095,"Nebraska","Jefferson County",2,78,53,24,29
050,31,095,"Nebraska","Jefferson County",2,79,50,25,25
050,31,095,"Nebraska","Jefferson County",2,80,48,26,22
050,31,095,"Nebraska","Jefferson County",2,81,49,23,26
050,31,095,"Nebraska","Jefferson County",2,82,37,17,20
050,31,095,"Nebraska","Jefferson County",2,83,40,18,22
050,31,095,"Nebraska","Jefferson County",2,84,39,14,25
050,31,095,"Nebraska","Jefferson County",2,85,252,87,165
050,31,095,"Nebraska","Jefferson County",3,0,75,32,43
050,31,095,"Nebraska","Jefferson County",3,1,93,48,45
050,31,095,"Nebraska","Jefferson County",3,2,93,49,44
050,31,095,"Nebraska","Jefferson County",3,3,80,41,39
050,31,095,"Nebraska","Jefferson County",3,4,82,37,45
050,31,095,"Nebraska","Jefferson County",3,5,77,37,40
050,31,095,"Nebraska","Jefferson County",3,6,79,41,38
050,31,095,"Nebraska","Jefferson County",3,7,101,56,45
050,31,095,"Nebraska","Jefferson County",3,8,92,45,47
050,31,095,"Nebraska","Jefferson County",3,9,89,41,48
050,31,095,"Nebraska","Jefferson County",3,10,86,44,42
050,31,095,"Nebraska","Jefferson County",3,11,78,39,39
050,31,095,"Nebraska","Jefferson County",3,12,95,55,40
050,31,095,"Nebraska","Jefferson County",3,13,106,63,43
050,31,095,"Nebraska","Jefferson County",3,14,100,51,49
050,31,095,"Nebraska","Jefferson County",3,15,103,49,54
050,31,095,"Nebraska","Jefferson County",3,16,102,56,46
050,31,095,"Nebraska","Jefferson County",3,17,92,44,48
050,31,095,"Nebraska","Jefferson County",3,18,82,37,45
050,31,095,"Nebraska","Jefferson County",3,19,58,25,33
050,31,095,"Nebraska","Jefferson County",3,20,72,36,36
050,31,095,"Nebraska","Jefferson County",3,21,67,31,36
050,31,095,"Nebraska","Jefferson County",3,22,59,29,30
050,31,095,"Nebraska","Jefferson County",3,23,68,34,34
050,31,095,"Nebraska","Jefferson County",3,24,61,32,29
050,31,095,"Nebraska","Jefferson County",3,25,52,24,28
050,31,095,"Nebraska","Jefferson County",3,26,65,28,37
050,31,095,"Nebraska","Jefferson County",3,27,55,26,29
050,31,095,"Nebraska","Jefferson County",3,28,62,31,31
050,31,095,"Nebraska","Jefferson County",3,29,75,42,33
050,31,095,"Nebraska","Jefferson County",3,30,73,40,33
050,31,095,"Nebraska","Jefferson County",3,31,73,40,33
050,31,095,"Nebraska","Jefferson County",3,32,68,28,40
050,31,095,"Nebraska","Jefferson County",3,33,80,39,41
050,31,095,"Nebraska","Jefferson County",3,34,78,44,34
050,31,095,"Nebraska","Jefferson County",3,35,86,48,38
050,31,095,"Nebraska","Jefferson County",3,36,79,40,39
050,31,095,"Nebraska","Jefferson County",3,37,83,37,46
050,31,095,"Nebraska","Jefferson County",3,38,90,39,51
050,31,095,"Nebraska","Jefferson County",3,39,79,43,36
050,31,095,"Nebraska","Jefferson County",3,40,86,46,40
050,31,095,"Nebraska","Jefferson County",3,41,83,37,46
050,31,095,"Nebraska","Jefferson County",3,42,75,32,43
050,31,095,"Nebraska","Jefferson County",3,43,77,38,39
050,31,095,"Nebraska","Jefferson County",3,44,75,42,33
050,31,095,"Nebraska","Jefferson County",3,45,85,51,34
050,31,095,"Nebraska","Jefferson County",3,46,84,49,35
050,31,095,"Nebraska","Jefferson County",3,47,71,33,38
050,31,095,"Nebraska","Jefferson County",3,48,79,39,40
050,31,095,"Nebraska","Jefferson County",3,49,76,38,38
050,31,095,"Nebraska","Jefferson County",3,50,81,45,36
050,31,095,"Nebraska","Jefferson County",3,51,85,42,43
050,31,095,"Nebraska","Jefferson County",3,52,77,38,39
050,31,095,"Nebraska","Jefferson County",3,53,66,29,37
050,31,095,"Nebraska","Jefferson County",3,54,74,33,41
050,31,095,"Nebraska","Jefferson County",3,55,92,43,49
050,31,095,"Nebraska","Jefferson County",3,56,91,46,45
050,31,095,"Nebraska","Jefferson County",3,57,87,43,44
050,31,095,"Nebraska","Jefferson County",3,58,96,48,48
050,31,095,"Nebraska","Jefferson County",3,59,106,57,49
050,31,095,"Nebraska","Jefferson County",3,60,114,62,52
050,31,095,"Nebraska","Jefferson County",3,61,105,55,50
050,31,095,"Nebraska","Jefferson County",3,62,120,62,58
050,31,095,"Nebraska","Jefferson County",3,63,132,69,63
050,31,095,"Nebraska","Jefferson County",3,64,125,64,61
050,31,095,"Nebraska","Jefferson County",3,65,118,63,55
050,31,095,"Nebraska","Jefferson County",3,66,106,59,47
050,31,095,"Nebraska","Jefferson County",3,67,109,61,48
050,31,095,"Nebraska","Jefferson County",3,68,101,58,43
050,31,095,"Nebraska","Jefferson County",3,69,101,54,47
050,31,095,"Nebraska","Jefferson County",3,70,98,46,52
050,31,095,"Nebraska","Jefferson County",3,71,95,44,51
050,31,095,"Nebraska","Jefferson County",3,72,93,39,54
050,31,095,"Nebraska","Jefferson County",3,73,86,44,42
050,31,095,"Nebraska","Jefferson County",3,74,86,46,40
050,31,095,"Nebraska","Jefferson County",3,75,63,32,31
050,31,095,"Nebraska","Jefferson County",3,76,51,24,27
050,31,095,"Nebraska","Jefferson County",3,77,58,27,31
050,31,095,"Nebraska","Jefferson County",3,78,62,25,37
050,31,095,"Nebraska","Jefferson County",3,79,53,25,28
050,31,095,"Nebraska","Jefferson County",3,80,45,21,24
050,31,095,"Nebraska","Jefferson County",3,81,52,28,24
050,31,095,"Nebraska","Jefferson County",3,82,40,19,21
050,31,095,"Nebraska","Jefferson County",3,83,36,14,22
050,31,095,"Nebraska","Jefferson County",3,84,40,16,24
050,31,095,"Nebraska","Jefferson County",3,85,236,83,153
050,31,095,"Nebraska","Jefferson County",4,0,78,28,50
050,31,095,"Nebraska","Jefferson County",4,1,86,38,48
050,31,095,"Nebraska","Jefferson County",4,2,91,45,46
050,31,095,"Nebraska","Jefferson County",4,3,93,47,46
050,31,095,"Nebraska","Jefferson County",4,4,78,40,38
050,31,095,"Nebraska","Jefferson County",4,5,81,36,45
050,31,095,"Nebraska","Jefferson County",4,6,83,43,40
050,31,095,"Nebraska","Jefferson County",4,7,86,45,41
050,31,095,"Nebraska","Jefferson County",4,8,106,63,43
050,31,095,"Nebraska","Jefferson County",4,9,99,49,50
050,31,095,"Nebraska","Jefferson County",4,10,90,41,49
050,31,095,"Nebraska","Jefferson County",4,11,88,40,48
050,31,095,"Nebraska","Jefferson County",4,12,86,43,43
050,31,095,"Nebraska","Jefferson County",4,13,97,54,43
050,31,095,"Nebraska","Jefferson County",4,14,107,59,48
050,31,095,"Nebraska","Jefferson County",4,15,96,43,53
050,31,095,"Nebraska","Jefferson County",4,16,99,48,51
050,31,095,"Nebraska","Jefferson County",4,17,101,52,49
050,31,095,"Nebraska","Jefferson County",4,18,80,40,40
050,31,095,"Nebraska","Jefferson County",4,19,58,27,31
050,31,095,"Nebraska","Jefferson County",4,20,53,21,32
050,31,095,"Nebraska","Jefferson County",4,21,71,36,35
050,31,095,"Nebraska","Jefferson County",4,22,67,32,35
050,31,095,"Nebraska","Jefferson County",4,23,68,31,37
050,31,095,"Nebraska","Jefferson County",4,24,69,35,34
050,31,095,"Nebraska","Jefferson County",4,25,67,36,31
050,31,095,"Nebraska","Jefferson County",4,26,56,26,30
050,31,095,"Nebraska","Jefferson County",4,27,71,31,40
050,31,095,"Nebraska","Jefferson County",4,28,54,25,29
050,31,095,"Nebraska","Jefferson County",4,29,62,30,32
050,31,095,"Nebraska","Jefferson County",4,30,84,44,40
050,31,095,"Nebraska","Jefferson County",4,31,84,43,41
050,31,095,"Nebraska","Jefferson County",4,32,79,42,37
050,31,095,"Nebraska","Jefferson County",4,33,69,29,40
050,31,095,"Nebraska","Jefferson County",4,34,83,40,43
050,31,095,"Nebraska","Jefferson County",4,35,75,39,36
050,31,095,"Nebraska","Jefferson County",4,36,81,46,35
050,31,095,"Nebraska","Jefferson County",4,37,79,44,35
050,31,095,"Nebraska","Jefferson County",4,38,79,34,45
050,31,095,"Nebraska","Jefferson County",4,39,91,41,50
050,31,095,"Nebraska","Jefferson County",4,40,78,43,35
050,31,095,"Nebraska","Jefferson County",4,41,86,45,41
050,31,095,"Nebraska","Jefferson County",4,42,76,33,43
050,31,095,"Nebraska","Jefferson County",4,43,75,32,43
050,31,095,"Nebraska","Jefferson County",4,44,73,35,38
050,31,095,"Nebraska","Jefferson County",4,45,80,45,35
050,31,095,"Nebraska","Jefferson County",4,46,71,43,28
050,31,095,"Nebraska","Jefferson County",4,47,85,50,35
050,31,095,"Nebraska","Jefferson County",4,48,74,35,39
050,31,095,"Nebraska","Jefferson County",4,49,73,39,34
050,31,095,"Nebraska","Jefferson County",4,50,80,42,38
050,31,095,"Nebraska","Jefferson County",4,51,81,45,36
050,31,095,"Nebraska","Jefferson County",4,52,83,39,44
050,31,095,"Nebraska","Jefferson County",4,53,71,33,38
050,31,095,"Nebraska","Jefferson County",4,54,68,31,37
050,31,095,"Nebraska","Jefferson County",4,55,72,32,40
050,31,095,"Nebraska","Jefferson County",4,56,92,46,46
050,31,095,"Nebraska","Jefferson County",4,57,90,45,45
050,31,095,"Nebraska","Jefferson County",4,58,94,44,50
050,31,095,"Nebraska","Jefferson County",4,59,97,48,49
050,31,095,"Nebraska","Jefferson County",4,60,107,57,50
050,31,095,"Nebraska","Jefferson County",4,61,110,59,51
050,31,095,"Nebraska","Jefferson County",4,62,104,54,50
050,31,095,"Nebraska","Jefferson County",4,63,120,61,59
050,31,095,"Nebraska","Jefferson County",4,64,124,67,57
050,31,095,"Nebraska","Jefferson County",4,65,126,64,62
050,31,095,"Nebraska","Jefferson County",4,66,113,62,51
050,31,095,"Nebraska","Jefferson County",4,67,108,61,47
050,31,095,"Nebraska","Jefferson County",4,68,106,58,48
050,31,095,"Nebraska","Jefferson County",4,69,100,57,43
050,31,095,"Nebraska","Jefferson County",4,70,94,50,44
050,31,095,"Nebraska","Jefferson County",4,71,95,46,49
050,31,095,"Nebraska","Jefferson County",4,72,95,46,49
050,31,095,"Nebraska","Jefferson County",4,73,87,34,53
050,31,095,"Nebraska","Jefferson County",4,74,85,45,40
050,31,095,"Nebraska","Jefferson County",4,75,86,49,37
050,31,095,"Nebraska","Jefferson County",4,76,60,29,31
050,31,095,"Nebraska","Jefferson County",4,77,47,20,27
050,31,095,"Nebraska","Jefferson County",4,78,52,23,29
050,31,095,"Nebraska","Jefferson County",4,79,58,25,33
050,31,095,"Nebraska","Jefferson County",4,80,52,24,28
050,31,095,"Nebraska","Jefferson County",4,81,45,20,25
050,31,095,"Nebraska","Jefferson County",4,82,40,23,17
050,31,095,"Nebraska","Jefferson County",4,83,40,18,22
050,31,095,"Nebraska","Jefferson County",4,84,31,10,21
050,31,095,"Nebraska","Jefferson County",4,85,231,84,147
050,31,095,"Nebraska","Jefferson County",5,0,78,28,50
050,31,095,"Nebraska","Jefferson County",5,1,79,28,51
050,31,095,"Nebraska","Jefferson County",5,2,87,40,47
050,31,095,"Nebraska","Jefferson County",5,3,85,40,45
050,31,095,"Nebraska","Jefferson County",5,4,93,49,44
050,31,095,"Nebraska","Jefferson County",5,5,80,45,35
050,31,095,"Nebraska","Jefferson County",5,6,86,41,45
050,31,095,"Nebraska","Jefferson County",5,7,86,45,41
050,31,095,"Nebraska","Jefferson County",5,8,84,43,41
050,31,095,"Nebraska","Jefferson County",5,9,103,61,42
050,31,095,"Nebraska","Jefferson County",5,10,94,45,49
050,31,095,"Nebraska","Jefferson County",5,11,87,39,48
050,31,095,"Nebraska","Jefferson County",5,12,87,43,44
050,31,095,"Nebraska","Jefferson County",5,13,88,44,44
050,31,095,"Nebraska","Jefferson County",5,14,97,55,42
050,31,095,"Nebraska","Jefferson County",5,15,107,58,49
050,31,095,"Nebraska","Jefferson County",5,16,98,44,54
050,31,095,"Nebraska","Jefferson County",5,17,99,45,54
050,31,095,"Nebraska","Jefferson County",5,18,85,45,40
050,31,095,"Nebraska","Jefferson County",5,19,61,32,29
050,31,095,"Nebraska","Jefferson County",5,20,63,29,34
050,31,095,"Nebraska","Jefferson County",5,21,50,20,30
050,31,095,"Nebraska","Jefferson County",5,22,73,36,37
050,31,095,"Nebraska","Jefferson County",5,23,62,29,33
050,31,095,"Nebraska","Jefferson County",5,24,66,35,31
050,31,095,"Nebraska","Jefferson County",5,25,69,31,38
050,31,095,"Nebraska","Jefferson County",5,26,67,40,27
050,31,095,"Nebraska","Jefferson County",5,27,59,27,32
050,31,095,"Nebraska","Jefferson County",5,28,75,33,42
050,31,095,"Nebraska","Jefferson County",5,29,45,21,24
050,31,095,"Nebraska","Jefferson County",5,30,64,32,32
050,31,095,"Nebraska","Jefferson County",5,31,86,44,42
050,31,095,"Nebraska","Jefferson County",5,32,82,42,40
050,31,095,"Nebraska","Jefferson County",5,33,75,39,36
050,31,095,"Nebraska","Jefferson County",5,34,66,25,41
050,31,095,"Nebraska","Jefferson County",5,35,80,38,42
050,31,095,"Nebraska","Jefferson County",5,36,70,40,30
050,31,095,"Nebraska","Jefferson County",5,37,80,46,34
050,31,095,"Nebraska","Jefferson County",5,38,76,41,35
050,31,095,"Nebraska","Jefferson County",5,39,77,36,41
050,31,095,"Nebraska","Jefferson County",5,40,89,42,47
050,31,095,"Nebraska","Jefferson County",5,41,83,44,39
050,31,095,"Nebraska","Jefferson County",5,42,86,44,42
050,31,095,"Nebraska","Jefferson County",5,43,74,32,42
050,31,095,"Nebraska","Jefferson County",5,44,73,33,40
050,31,095,"Nebraska","Jefferson County",5,45,74,39,35
050,31,095,"Nebraska","Jefferson County",5,46,76,40,36
050,31,095,"Nebraska","Jefferson County",5,47,72,45,27
050,31,095,"Nebraska","Jefferson County",5,48,85,48,37
050,31,095,"Nebraska","Jefferson County",5,49,75,36,39
050,31,095,"Nebraska","Jefferson County",5,50,76,38,38
050,31,095,"Nebraska","Jefferson County",5,51,78,39,39
050,31,095,"Nebraska","Jefferson County",5,52,85,51,34
050,31,095,"Nebraska","Jefferson County",5,53,79,38,41
050,31,095,"Nebraska","Jefferson County",5,54,72,35,37
050,31,095,"Nebraska","Jefferson County",5,55,63,28,35
050,31,095,"Nebraska","Jefferson County",5,56,70,30,40
050,31,095,"Nebraska","Jefferson County",5,57,89,46,43
050,31,095,"Nebraska","Jefferson County",5,58,95,48,47
050,31,095,"Nebraska","Jefferson County",5,59,92,43,49
050,31,095,"Nebraska","Jefferson County",5,60,98,46,52
050,31,095,"Nebraska","Jefferson County",5,61,106,57,49
050,31,095,"Nebraska","Jefferson County",5,62,110,58,52
050,31,095,"Nebraska","Jefferson County",5,63,104,54,50
050,31,095,"Nebraska","Jefferson County",5,64,117,60,57
050,31,095,"Nebraska","Jefferson County",5,65,125,68,57
050,31,095,"Nebraska","Jefferson County",5,66,120,60,60
050,31,095,"Nebraska","Jefferson County",5,67,109,59,50
050,31,095,"Nebraska","Jefferson County",5,68,103,56,47
050,31,095,"Nebraska","Jefferson County",5,69,109,60,49
050,31,095,"Nebraska","Jefferson County",5,70,95,53,42
050,31,095,"Nebraska","Jefferson County",5,71,89,48,41
050,31,095,"Nebraska","Jefferson County",5,72,95,47,48
050,31,095,"Nebraska","Jefferson County",5,73,89,43,46
050,31,095,"Nebraska","Jefferson County",5,74,83,32,51
050,31,095,"Nebraska","Jefferson County",5,75,87,47,40
050,31,095,"Nebraska","Jefferson County",5,76,82,44,38
050,31,095,"Nebraska","Jefferson County",5,77,57,26,31
050,31,095,"Nebraska","Jefferson County",5,78,41,16,25
050,31,095,"Nebraska","Jefferson County",5,79,50,22,28
050,31,095,"Nebraska","Jefferson County",5,80,54,25,29
050,31,095,"Nebraska","Jefferson County",5,81,55,24,31
050,31,095,"Nebraska","Jefferson County",5,82,36,16,20
050,31,095,"Nebraska","Jefferson County",5,83,40,22,18
050,31,095,"Nebraska","Jefferson County",5,84,38,14,24
050,31,095,"Nebraska","Jefferson County",5,85,227,82,145
050,31,097,"Nebraska","Johnson County",1,0,35,18,17
050,31,097,"Nebraska","Johnson County",1,1,39,17,22
050,31,097,"Nebraska","Johnson County",1,2,54,21,33
050,31,097,"Nebraska","Johnson County",1,3,56,24,32
050,31,097,"Nebraska","Johnson County",1,4,54,28,26
050,31,097,"Nebraska","Johnson County",1,5,58,33,25
050,31,097,"Nebraska","Johnson County",1,6,57,28,29
050,31,097,"Nebraska","Johnson County",1,7,54,27,27
050,31,097,"Nebraska","Johnson County",1,8,54,19,35
050,31,097,"Nebraska","Johnson County",1,9,60,32,28
050,31,097,"Nebraska","Johnson County",1,10,62,35,27
050,31,097,"Nebraska","Johnson County",1,11,51,27,24
050,31,097,"Nebraska","Johnson County",1,12,67,34,33
050,31,097,"Nebraska","Johnson County",1,13,70,27,43
050,31,097,"Nebraska","Johnson County",1,14,63,32,31
050,31,097,"Nebraska","Johnson County",1,15,64,29,35
050,31,097,"Nebraska","Johnson County",1,16,59,29,30
050,31,097,"Nebraska","Johnson County",1,17,51,29,22
050,31,097,"Nebraska","Johnson County",1,18,47,28,19
050,31,097,"Nebraska","Johnson County",1,19,50,32,18
050,31,097,"Nebraska","Johnson County",1,20,42,28,14
050,31,097,"Nebraska","Johnson County",1,21,49,33,16
050,31,097,"Nebraska","Johnson County",1,22,64,43,21
050,31,097,"Nebraska","Johnson County",1,23,68,51,17
050,31,097,"Nebraska","Johnson County",1,24,75,53,22
050,31,097,"Nebraska","Johnson County",1,25,72,49,23
050,31,097,"Nebraska","Johnson County",1,26,89,54,35
050,31,097,"Nebraska","Johnson County",1,27,73,54,19
050,31,097,"Nebraska","Johnson County",1,28,73,54,19
050,31,097,"Nebraska","Johnson County",1,29,76,60,16
050,31,097,"Nebraska","Johnson County",1,30,76,59,17
050,31,097,"Nebraska","Johnson County",1,31,92,70,22
050,31,097,"Nebraska","Johnson County",1,32,71,52,19
050,31,097,"Nebraska","Johnson County",1,33,64,47,17
050,31,097,"Nebraska","Johnson County",1,34,76,55,21
050,31,097,"Nebraska","Johnson County",1,35,69,47,22
050,31,097,"Nebraska","Johnson County",1,36,86,67,19
050,31,097,"Nebraska","Johnson County",1,37,89,61,28
050,31,097,"Nebraska","Johnson County",1,38,73,52,21
050,31,097,"Nebraska","Johnson County",1,39,96,67,29
050,31,097,"Nebraska","Johnson County",1,40,56,35,21
050,31,097,"Nebraska","Johnson County",1,41,68,47,21
050,31,097,"Nebraska","Johnson County",1,42,60,42,18
050,31,097,"Nebraska","Johnson County",1,43,66,44,22
050,31,097,"Nebraska","Johnson County",1,44,62,41,21
050,31,097,"Nebraska","Johnson County",1,45,66,45,21
050,31,097,"Nebraska","Johnson County",1,46,60,43,17
050,31,097,"Nebraska","Johnson County",1,47,50,32,18
050,31,097,"Nebraska","Johnson County",1,48,79,56,23
050,31,097,"Nebraska","Johnson County",1,49,85,60,25
050,31,097,"Nebraska","Johnson County",1,50,73,47,26
050,31,097,"Nebraska","Johnson County",1,51,64,43,21
050,31,097,"Nebraska","Johnson County",1,52,60,39,21
050,31,097,"Nebraska","Johnson County",1,53,77,54,23
050,31,097,"Nebraska","Johnson County",1,54,65,40,25
050,31,097,"Nebraska","Johnson County",1,55,67,37,30
050,31,097,"Nebraska","Johnson County",1,56,78,43,35
050,31,097,"Nebraska","Johnson County",1,57,93,56,37
050,31,097,"Nebraska","Johnson County",1,58,78,47,31
050,31,097,"Nebraska","Johnson County",1,59,63,32,31
050,31,097,"Nebraska","Johnson County",1,60,72,37,35
050,31,097,"Nebraska","Johnson County",1,61,84,49,35
050,31,097,"Nebraska","Johnson County",1,62,77,40,37
050,31,097,"Nebraska","Johnson County",1,63,76,41,35
050,31,097,"Nebraska","Johnson County",1,64,77,47,30
050,31,097,"Nebraska","Johnson County",1,65,64,37,27
050,31,097,"Nebraska","Johnson County",1,66,65,36,29
050,31,097,"Nebraska","Johnson County",1,67,57,33,24
050,31,097,"Nebraska","Johnson County",1,68,57,30,27
050,31,097,"Nebraska","Johnson County",1,69,44,21,23
050,31,097,"Nebraska","Johnson County",1,70,51,22,29
050,31,097,"Nebraska","Johnson County",1,71,53,28,25
050,31,097,"Nebraska","Johnson County",1,72,48,25,23
050,31,097,"Nebraska","Johnson County",1,73,44,22,22
050,31,097,"Nebraska","Johnson County",1,74,36,18,18
050,31,097,"Nebraska","Johnson County",1,75,39,18,21
050,31,097,"Nebraska","Johnson County",1,76,38,15,23
050,31,097,"Nebraska","Johnson County",1,77,32,15,17
050,31,097,"Nebraska","Johnson County",1,78,34,13,21
050,31,097,"Nebraska","Johnson County",1,79,28,15,13
050,31,097,"Nebraska","Johnson County",1,80,18,9,9
050,31,097,"Nebraska","Johnson County",1,81,26,13,13
050,31,097,"Nebraska","Johnson County",1,82,27,11,16
050,31,097,"Nebraska","Johnson County",1,83,22,5,17
050,31,097,"Nebraska","Johnson County",1,84,22,9,13
050,31,097,"Nebraska","Johnson County",1,85,148,45,103
050,31,097,"Nebraska","Johnson County",2,0,41,23,18
050,31,097,"Nebraska","Johnson County",2,1,39,17,22
050,31,097,"Nebraska","Johnson County",2,2,51,20,31
050,31,097,"Nebraska","Johnson County",2,3,55,23,32
050,31,097,"Nebraska","Johnson County",2,4,54,27,27
050,31,097,"Nebraska","Johnson County",2,5,57,31,26
050,31,097,"Nebraska","Johnson County",2,6,58,30,28
050,31,097,"Nebraska","Johnson County",2,7,56,28,28
050,31,097,"Nebraska","Johnson County",2,8,55,22,33
050,31,097,"Nebraska","Johnson County",2,9,58,29,29
050,31,097,"Nebraska","Johnson County",2,10,62,35,27
050,31,097,"Nebraska","Johnson County",2,11,54,30,24
050,31,097,"Nebraska","Johnson County",2,12,64,32,32
050,31,097,"Nebraska","Johnson County",2,13,68,28,40
050,31,097,"Nebraska","Johnson County",2,14,64,31,33
050,31,097,"Nebraska","Johnson County",2,15,63,29,34
050,31,097,"Nebraska","Johnson County",2,16,61,30,31
050,31,097,"Nebraska","Johnson County",2,17,52,29,23
050,31,097,"Nebraska","Johnson County",2,18,46,27,19
050,31,097,"Nebraska","Johnson County",2,19,48,31,17
050,31,097,"Nebraska","Johnson County",2,20,45,29,16
050,31,097,"Nebraska","Johnson County",2,21,50,34,16
050,31,097,"Nebraska","Johnson County",2,22,62,42,20
050,31,097,"Nebraska","Johnson County",2,23,69,52,17
050,31,097,"Nebraska","Johnson County",2,24,74,53,21
050,31,097,"Nebraska","Johnson County",2,25,72,49,23
050,31,097,"Nebraska","Johnson County",2,26,86,55,31
050,31,097,"Nebraska","Johnson County",2,27,77,54,23
050,31,097,"Nebraska","Johnson County",2,28,73,54,19
050,31,097,"Nebraska","Johnson County",2,29,76,59,17
050,31,097,"Nebraska","Johnson County",2,30,77,60,17
050,31,097,"Nebraska","Johnson County",2,31,92,71,21
050,31,097,"Nebraska","Johnson County",2,32,71,51,20
050,31,097,"Nebraska","Johnson County",2,33,66,47,19
050,31,097,"Nebraska","Johnson County",2,34,76,56,20
050,31,097,"Nebraska","Johnson County",2,35,68,46,22
050,31,097,"Nebraska","Johnson County",2,36,84,64,20
050,31,097,"Nebraska","Johnson County",2,37,86,61,25
050,31,097,"Nebraska","Johnson County",2,38,77,54,23
050,31,097,"Nebraska","Johnson County",2,39,92,65,27
050,31,097,"Nebraska","Johnson County",2,40,61,38,23
050,31,097,"Nebraska","Johnson County",2,41,65,45,20
050,31,097,"Nebraska","Johnson County",2,42,61,42,19
050,31,097,"Nebraska","Johnson County",2,43,66,45,21
050,31,097,"Nebraska","Johnson County",2,44,62,41,21
050,31,097,"Nebraska","Johnson County",2,45,68,46,22
050,31,097,"Nebraska","Johnson County",2,46,62,44,18
050,31,097,"Nebraska","Johnson County",2,47,50,32,18
050,31,097,"Nebraska","Johnson County",2,48,74,52,22
050,31,097,"Nebraska","Johnson County",2,49,84,61,23
050,31,097,"Nebraska","Johnson County",2,50,74,48,26
050,31,097,"Nebraska","Johnson County",2,51,65,43,22
050,31,097,"Nebraska","Johnson County",2,52,63,42,21
050,31,097,"Nebraska","Johnson County",2,53,76,53,23
050,31,097,"Nebraska","Johnson County",2,54,65,41,24
050,31,097,"Nebraska","Johnson County",2,55,66,36,30
050,31,097,"Nebraska","Johnson County",2,56,77,42,35
050,31,097,"Nebraska","Johnson County",2,57,89,53,36
050,31,097,"Nebraska","Johnson County",2,58,81,49,32
050,31,097,"Nebraska","Johnson County",2,59,67,35,32
050,31,097,"Nebraska","Johnson County",2,60,70,36,34
050,31,097,"Nebraska","Johnson County",2,61,79,45,34
050,31,097,"Nebraska","Johnson County",2,62,77,40,37
050,31,097,"Nebraska","Johnson County",2,63,77,42,35
050,31,097,"Nebraska","Johnson County",2,64,73,43,30
050,31,097,"Nebraska","Johnson County",2,65,66,39,27
050,31,097,"Nebraska","Johnson County",2,66,66,37,29
050,31,097,"Nebraska","Johnson County",2,67,59,34,25
050,31,097,"Nebraska","Johnson County",2,68,56,30,26
050,31,097,"Nebraska","Johnson County",2,69,46,23,23
050,31,097,"Nebraska","Johnson County",2,70,50,22,28
050,31,097,"Nebraska","Johnson County",2,71,52,27,25
050,31,097,"Nebraska","Johnson County",2,72,47,24,23
050,31,097,"Nebraska","Johnson County",2,73,47,24,23
050,31,097,"Nebraska","Johnson County",2,74,36,18,18
050,31,097,"Nebraska","Johnson County",2,75,39,19,20
050,31,097,"Nebraska","Johnson County",2,76,36,14,22
050,31,097,"Nebraska","Johnson County",2,77,34,15,19
050,31,097,"Nebraska","Johnson County",2,78,32,13,19
050,31,097,"Nebraska","Johnson County",2,79,30,14,16
050,31,097,"Nebraska","Johnson County",2,80,19,10,9
050,31,097,"Nebraska","Johnson County",2,81,24,12,12
050,31,097,"Nebraska","Johnson County",2,82,27,12,15
050,31,097,"Nebraska","Johnson County",2,83,24,7,17
050,31,097,"Nebraska","Johnson County",2,84,22,8,14
050,31,097,"Nebraska","Johnson County",2,85,151,46,105
050,31,097,"Nebraska","Johnson County",3,0,41,23,18
050,31,097,"Nebraska","Johnson County",3,1,42,25,17
050,31,097,"Nebraska","Johnson County",3,2,37,20,17
050,31,097,"Nebraska","Johnson County",3,3,52,22,30
050,31,097,"Nebraska","Johnson County",3,4,56,25,31
050,31,097,"Nebraska","Johnson County",3,5,55,27,28
050,31,097,"Nebraska","Johnson County",3,6,54,30,24
050,31,097,"Nebraska","Johnson County",3,7,58,28,30
050,31,097,"Nebraska","Johnson County",3,8,52,27,25
050,31,097,"Nebraska","Johnson County",3,9,50,19,31
050,31,097,"Nebraska","Johnson County",3,10,58,30,28
050,31,097,"Nebraska","Johnson County",3,11,61,35,26
050,31,097,"Nebraska","Johnson County",3,12,56,31,25
050,31,097,"Nebraska","Johnson County",3,13,67,33,34
050,31,097,"Nebraska","Johnson County",3,14,71,30,41
050,31,097,"Nebraska","Johnson County",3,15,62,28,34
050,31,097,"Nebraska","Johnson County",3,16,63,31,32
050,31,097,"Nebraska","Johnson County",3,17,55,31,24
050,31,097,"Nebraska","Johnson County",3,18,45,26,19
050,31,097,"Nebraska","Johnson County",3,19,37,21,16
050,31,097,"Nebraska","Johnson County",3,20,57,36,21
050,31,097,"Nebraska","Johnson County",3,21,54,41,13
050,31,097,"Nebraska","Johnson County",3,22,59,43,16
050,31,097,"Nebraska","Johnson County",3,23,77,56,21
050,31,097,"Nebraska","Johnson County",3,24,74,58,16
050,31,097,"Nebraska","Johnson County",3,25,75,57,18
050,31,097,"Nebraska","Johnson County",3,26,77,54,23
050,31,097,"Nebraska","Johnson County",3,27,89,55,34
050,31,097,"Nebraska","Johnson County",3,28,80,59,21
050,31,097,"Nebraska","Johnson County",3,29,79,58,21
050,31,097,"Nebraska","Johnson County",3,30,83,69,14
050,31,097,"Nebraska","Johnson County",3,31,100,84,16
050,31,097,"Nebraska","Johnson County",3,32,77,56,21
050,31,097,"Nebraska","Johnson County",3,33,67,46,21
050,31,097,"Nebraska","Johnson County",3,34,76,61,15
050,31,097,"Nebraska","Johnson County",3,35,67,44,23
050,31,097,"Nebraska","Johnson County",3,36,78,56,22
050,31,097,"Nebraska","Johnson County",3,37,78,61,17
050,31,097,"Nebraska","Johnson County",3,38,89,61,28
050,31,097,"Nebraska","Johnson County",3,39,90,65,25
050,31,097,"Nebraska","Johnson County",3,40,66,41,25
050,31,097,"Nebraska","Johnson County",3,41,61,41,20
050,31,097,"Nebraska","Johnson County",3,42,69,48,21
050,31,097,"Nebraska","Johnson County",3,43,56,41,15
050,31,097,"Nebraska","Johnson County",3,44,61,42,19
050,31,097,"Nebraska","Johnson County",3,45,72,50,22
050,31,097,"Nebraska","Johnson County",3,46,71,49,22
050,31,097,"Nebraska","Johnson County",3,47,53,34,19
050,31,097,"Nebraska","Johnson County",3,48,59,41,18
050,31,097,"Nebraska","Johnson County",3,49,75,54,21
050,31,097,"Nebraska","Johnson County",3,50,78,55,23
050,31,097,"Nebraska","Johnson County",3,51,73,45,28
050,31,097,"Nebraska","Johnson County",3,52,74,52,22
050,31,097,"Nebraska","Johnson County",3,53,71,50,21
050,31,097,"Nebraska","Johnson County",3,54,66,42,24
050,31,097,"Nebraska","Johnson County",3,55,54,34,20
050,31,097,"Nebraska","Johnson County",3,56,67,36,31
050,31,097,"Nebraska","Johnson County",3,57,80,41,39
050,31,097,"Nebraska","Johnson County",3,58,88,55,33
050,31,097,"Nebraska","Johnson County",3,59,81,50,31
050,31,097,"Nebraska","Johnson County",3,60,78,42,36
050,31,097,"Nebraska","Johnson County",3,61,66,35,31
050,31,097,"Nebraska","Johnson County",3,62,71,37,34
050,31,097,"Nebraska","Johnson County",3,63,78,43,35
050,31,097,"Nebraska","Johnson County",3,64,69,37,32
050,31,097,"Nebraska","Johnson County",3,65,72,42,30
050,31,097,"Nebraska","Johnson County",3,66,64,38,26
050,31,097,"Nebraska","Johnson County",3,67,65,34,31
050,31,097,"Nebraska","Johnson County",3,68,56,32,24
050,31,097,"Nebraska","Johnson County",3,69,55,29,26
050,31,097,"Nebraska","Johnson County",3,70,42,19,23
050,31,097,"Nebraska","Johnson County",3,71,46,21,25
050,31,097,"Nebraska","Johnson County",3,72,46,24,22
050,31,097,"Nebraska","Johnson County",3,73,46,23,23
050,31,097,"Nebraska","Johnson County",3,74,46,24,22
050,31,097,"Nebraska","Johnson County",3,75,37,20,17
050,31,097,"Nebraska","Johnson County",3,76,36,17,19
050,31,097,"Nebraska","Johnson County",3,77,36,16,20
050,31,097,"Nebraska","Johnson County",3,78,33,14,19
050,31,097,"Nebraska","Johnson County",3,79,30,11,19
050,31,097,"Nebraska","Johnson County",3,80,29,14,15
050,31,097,"Nebraska","Johnson County",3,81,15,7,8
050,31,097,"Nebraska","Johnson County",3,82,23,11,12
050,31,097,"Nebraska","Johnson County",3,83,27,12,15
050,31,097,"Nebraska","Johnson County",3,84,25,8,17
050,31,097,"Nebraska","Johnson County",3,85,150,44,106
050,31,097,"Nebraska","Johnson County",4,0,37,17,20
050,31,097,"Nebraska","Johnson County",4,1,40,22,18
050,31,097,"Nebraska","Johnson County",4,2,37,23,14
050,31,097,"Nebraska","Johnson County",4,3,38,17,21
050,31,097,"Nebraska","Johnson County",4,4,43,22,21
050,31,097,"Nebraska","Johnson County",4,5,51,22,29
050,31,097,"Nebraska","Johnson County",4,6,57,28,29
050,31,097,"Nebraska","Johnson County",4,7,57,31,26
050,31,097,"Nebraska","Johnson County",4,8,62,29,33
050,31,097,"Nebraska","Johnson County",4,9,49,26,23
050,31,097,"Nebraska","Johnson County",4,10,53,21,32
050,31,097,"Nebraska","Johnson County",4,11,56,28,28
050,31,097,"Nebraska","Johnson County",4,12,59,34,25
050,31,097,"Nebraska","Johnson County",4,13,55,29,26
050,31,097,"Nebraska","Johnson County",4,14,68,33,35
050,31,097,"Nebraska","Johnson County",4,15,74,32,42
050,31,097,"Nebraska","Johnson County",4,16,62,29,33
050,31,097,"Nebraska","Johnson County",4,17,64,32,32
050,31,097,"Nebraska","Johnson County",4,18,46,24,22
050,31,097,"Nebraska","Johnson County",4,19,39,22,17
050,31,097,"Nebraska","Johnson County",4,20,43,23,20
050,31,097,"Nebraska","Johnson County",4,21,60,41,19
050,31,097,"Nebraska","Johnson County",4,22,61,48,13
050,31,097,"Nebraska","Johnson County",4,23,67,51,16
050,31,097,"Nebraska","Johnson County",4,24,85,63,22
050,31,097,"Nebraska","Johnson County",4,25,70,54,16
050,31,097,"Nebraska","Johnson County",4,26,71,54,17
050,31,097,"Nebraska","Johnson County",4,27,77,53,24
050,31,097,"Nebraska","Johnson County",4,28,76,51,25
050,31,097,"Nebraska","Johnson County",4,29,82,60,22
050,31,097,"Nebraska","Johnson County",4,30,84,63,21
050,31,097,"Nebraska","Johnson County",4,31,99,85,14
050,31,097,"Nebraska","Johnson County",4,32,81,62,19
050,31,097,"Nebraska","Johnson County",4,33,69,48,21
050,31,097,"Nebraska","Johnson County",4,34,77,58,19
050,31,097,"Nebraska","Johnson County",4,35,68,46,22
050,31,097,"Nebraska","Johnson County",4,36,82,60,22
050,31,097,"Nebraska","Johnson County",4,37,77,54,23
050,31,097,"Nebraska","Johnson County",4,38,74,55,19
050,31,097,"Nebraska","Johnson County",4,39,96,68,28
050,31,097,"Nebraska","Johnson County",4,40,65,38,27
050,31,097,"Nebraska","Johnson County",4,41,69,42,27
050,31,097,"Nebraska","Johnson County",4,42,57,38,19
050,31,097,"Nebraska","Johnson County",4,43,69,49,20
050,31,097,"Nebraska","Johnson County",4,44,50,36,14
050,31,097,"Nebraska","Johnson County",4,45,68,51,17
050,31,097,"Nebraska","Johnson County",4,46,72,50,22
050,31,097,"Nebraska","Johnson County",4,47,69,44,25
050,31,097,"Nebraska","Johnson County",4,48,60,42,18
050,31,097,"Nebraska","Johnson County",4,49,67,48,19
050,31,097,"Nebraska","Johnson County",4,50,63,44,19
050,31,097,"Nebraska","Johnson County",4,51,82,53,29
050,31,097,"Nebraska","Johnson County",4,52,78,51,27
050,31,097,"Nebraska","Johnson County",4,53,84,61,23
050,31,097,"Nebraska","Johnson County",4,54,62,41,21
050,31,097,"Nebraska","Johnson County",4,55,60,35,25
050,31,097,"Nebraska","Johnson County",4,56,56,35,21
050,31,097,"Nebraska","Johnson County",4,57,66,34,32
050,31,097,"Nebraska","Johnson County",4,58,78,41,37
050,31,097,"Nebraska","Johnson County",4,59,81,51,30
050,31,097,"Nebraska","Johnson County",4,60,86,55,31
050,31,097,"Nebraska","Johnson County",4,61,73,41,32
050,31,097,"Nebraska","Johnson County",4,62,57,27,30
050,31,097,"Nebraska","Johnson County",4,63,75,41,34
050,31,097,"Nebraska","Johnson County",4,64,69,35,34
050,31,097,"Nebraska","Johnson County",4,65,66,36,30
050,31,097,"Nebraska","Johnson County",4,66,70,40,30
050,31,097,"Nebraska","Johnson County",4,67,61,34,27
050,31,097,"Nebraska","Johnson County",4,68,64,31,33
050,31,097,"Nebraska","Johnson County",4,69,52,28,24
050,31,097,"Nebraska","Johnson County",4,70,53,28,25
050,31,097,"Nebraska","Johnson County",4,71,39,17,22
050,31,097,"Nebraska","Johnson County",4,72,40,17,23
050,31,097,"Nebraska","Johnson County",4,73,46,24,22
050,31,097,"Nebraska","Johnson County",4,74,45,23,22
050,31,097,"Nebraska","Johnson County",4,75,46,27,19
050,31,097,"Nebraska","Johnson County",4,76,33,18,15
050,31,097,"Nebraska","Johnson County",4,77,35,18,17
050,31,097,"Nebraska","Johnson County",4,78,35,14,21
050,31,097,"Nebraska","Johnson County",4,79,29,11,18
050,31,097,"Nebraska","Johnson County",4,80,26,10,16
050,31,097,"Nebraska","Johnson County",4,81,29,14,15
050,31,097,"Nebraska","Johnson County",4,82,14,7,7
050,31,097,"Nebraska","Johnson County",4,83,22,10,12
050,31,097,"Nebraska","Johnson County",4,84,30,13,17
050,31,097,"Nebraska","Johnson County",4,85,148,42,106
050,31,097,"Nebraska","Johnson County",5,0,37,17,20
050,31,097,"Nebraska","Johnson County",5,1,47,17,30
050,31,097,"Nebraska","Johnson County",5,2,43,23,20
050,31,097,"Nebraska","Johnson County",5,3,46,30,16
050,31,097,"Nebraska","Johnson County",5,4,34,14,20
050,31,097,"Nebraska","Johnson County",5,5,47,26,21
050,31,097,"Nebraska","Johnson County",5,6,52,23,29
050,31,097,"Nebraska","Johnson County",5,7,55,27,28
050,31,097,"Nebraska","Johnson County",5,8,60,32,28
050,31,097,"Nebraska","Johnson County",5,9,59,30,29
050,31,097,"Nebraska","Johnson County",5,10,49,25,24
050,31,097,"Nebraska","Johnson County",5,11,59,26,33
050,31,097,"Nebraska","Johnson County",5,12,52,30,22
050,31,097,"Nebraska","Johnson County",5,13,60,35,25
050,31,097,"Nebraska","Johnson County",5,14,52,25,27
050,31,097,"Nebraska","Johnson County",5,15,65,33,32
050,31,097,"Nebraska","Johnson County",5,16,72,32,40
050,31,097,"Nebraska","Johnson County",5,17,61,27,34
050,31,097,"Nebraska","Johnson County",5,18,54,28,26
050,31,097,"Nebraska","Johnson County",5,19,37,21,16
050,31,097,"Nebraska","Johnson County",5,20,39,25,14
050,31,097,"Nebraska","Johnson County",5,21,54,31,23
050,31,097,"Nebraska","Johnson County",5,22,67,47,20
050,31,097,"Nebraska","Johnson County",5,23,72,58,14
050,31,097,"Nebraska","Johnson County",5,24,63,45,18
050,31,097,"Nebraska","Johnson County",5,25,78,57,21
050,31,097,"Nebraska","Johnson County",5,26,71,55,16
050,31,097,"Nebraska","Johnson County",5,27,66,50,16
050,31,097,"Nebraska","Johnson County",5,28,80,57,23
050,31,097,"Nebraska","Johnson County",5,29,71,50,21
050,31,097,"Nebraska","Johnson County",5,30,87,62,25
050,31,097,"Nebraska","Johnson County",5,31,110,84,26
050,31,097,"Nebraska","Johnson County",5,32,84,68,16
050,31,097,"Nebraska","Johnson County",5,33,66,50,16
050,31,097,"Nebraska","Johnson County",5,34,93,67,26
050,31,097,"Nebraska","Johnson County",5,35,66,46,20
050,31,097,"Nebraska","Johnson County",5,36,75,55,20
050,31,097,"Nebraska","Johnson County",5,37,78,58,20
050,31,097,"Nebraska","Johnson County",5,38,73,52,21
050,31,097,"Nebraska","Johnson County",5,39,79,60,19
050,31,097,"Nebraska","Johnson County",5,40,79,49,30
050,31,097,"Nebraska","Johnson County",5,41,71,44,27
050,31,097,"Nebraska","Johnson County",5,42,67,43,24
050,31,097,"Nebraska","Johnson County",5,43,64,43,21
050,31,097,"Nebraska","Johnson County",5,44,70,48,22
050,31,097,"Nebraska","Johnson County",5,45,57,43,14
050,31,097,"Nebraska","Johnson County",5,46,66,50,16
050,31,097,"Nebraska","Johnson County",5,47,70,44,26
050,31,097,"Nebraska","Johnson County",5,48,79,53,26
050,31,097,"Nebraska","Johnson County",5,49,61,45,16
050,31,097,"Nebraska","Johnson County",5,50,54,39,15
050,31,097,"Nebraska","Johnson County",5,51,60,41,19
050,31,097,"Nebraska","Johnson County",5,52,87,58,29
050,31,097,"Nebraska","Johnson County",5,53,85,59,26
050,31,097,"Nebraska","Johnson County",5,54,67,47,20
050,31,097,"Nebraska","Johnson County",5,55,53,32,21
050,31,097,"Nebraska","Johnson County",5,56,58,33,25
050,31,097,"Nebraska","Johnson County",5,57,56,32,24
050,31,097,"Nebraska","Johnson County",5,58,64,35,29
050,31,097,"Nebraska","Johnson County",5,59,73,37,36
050,31,097,"Nebraska","Johnson County",5,60,83,53,30
050,31,097,"Nebraska","Johnson County",5,61,86,54,32
050,31,097,"Nebraska","Johnson County",5,62,65,33,32
050,31,097,"Nebraska","Johnson County",5,63,61,31,30
050,31,097,"Nebraska","Johnson County",5,64,66,36,30
050,31,097,"Nebraska","Johnson County",5,65,66,34,32
050,31,097,"Nebraska","Johnson County",5,66,64,34,30
050,31,097,"Nebraska","Johnson County",5,67,62,37,25
050,31,097,"Nebraska","Johnson County",5,68,59,32,27
050,31,097,"Nebraska","Johnson County",5,69,63,28,35
050,31,097,"Nebraska","Johnson County",5,70,49,26,23
050,31,097,"Nebraska","Johnson County",5,71,49,27,22
050,31,097,"Nebraska","Johnson County",5,72,32,13,19
050,31,097,"Nebraska","Johnson County",5,73,40,17,23
050,31,097,"Nebraska","Johnson County",5,74,45,24,21
050,31,097,"Nebraska","Johnson County",5,75,47,25,22
050,31,097,"Nebraska","Johnson County",5,76,41,24,17
050,31,097,"Nebraska","Johnson County",5,77,33,19,14
050,31,097,"Nebraska","Johnson County",5,78,34,16,18
050,31,097,"Nebraska","Johnson County",5,79,29,11,18
050,31,097,"Nebraska","Johnson County",5,80,26,10,16
050,31,097,"Nebraska","Johnson County",5,81,26,10,16
050,31,097,"Nebraska","Johnson County",5,82,27,13,14
050,31,097,"Nebraska","Johnson County",5,83,12,7,5
050,31,097,"Nebraska","Johnson County",5,84,22,11,11
050,31,097,"Nebraska","Johnson County",5,85,157,44,113
050,31,099,"Nebraska","Kearney County",1,0,82,43,39
050,31,099,"Nebraska","Kearney County",1,1,88,47,41
050,31,099,"Nebraska","Kearney County",1,2,82,45,37
050,31,099,"Nebraska","Kearney County",1,3,78,38,40
050,31,099,"Nebraska","Kearney County",1,4,87,40,47
050,31,099,"Nebraska","Kearney County",1,5,85,41,44
050,31,099,"Nebraska","Kearney County",1,6,82,45,37
050,31,099,"Nebraska","Kearney County",1,7,87,51,36
050,31,099,"Nebraska","Kearney County",1,8,94,46,48
050,31,099,"Nebraska","Kearney County",1,9,85,41,44
050,31,099,"Nebraska","Kearney County",1,10,94,51,43
050,31,099,"Nebraska","Kearney County",1,11,95,45,50
050,31,099,"Nebraska","Kearney County",1,12,116,48,68
050,31,099,"Nebraska","Kearney County",1,13,113,54,59
050,31,099,"Nebraska","Kearney County",1,14,112,51,61
050,31,099,"Nebraska","Kearney County",1,15,109,62,47
050,31,099,"Nebraska","Kearney County",1,16,96,49,47
050,31,099,"Nebraska","Kearney County",1,17,93,45,48
050,31,099,"Nebraska","Kearney County",1,18,73,40,33
050,31,099,"Nebraska","Kearney County",1,19,49,23,26
050,31,099,"Nebraska","Kearney County",1,20,54,28,26
050,31,099,"Nebraska","Kearney County",1,21,61,31,30
050,31,099,"Nebraska","Kearney County",1,22,65,37,28
050,31,099,"Nebraska","Kearney County",1,23,79,47,32
050,31,099,"Nebraska","Kearney County",1,24,68,33,35
050,31,099,"Nebraska","Kearney County",1,25,67,40,27
050,31,099,"Nebraska","Kearney County",1,26,73,40,33
050,31,099,"Nebraska","Kearney County",1,27,70,38,32
050,31,099,"Nebraska","Kearney County",1,28,79,39,40
050,31,099,"Nebraska","Kearney County",1,29,81,41,40
050,31,099,"Nebraska","Kearney County",1,30,71,35,36
050,31,099,"Nebraska","Kearney County",1,31,75,36,39
050,31,099,"Nebraska","Kearney County",1,32,76,36,40
050,31,099,"Nebraska","Kearney County",1,33,75,29,46
050,31,099,"Nebraska","Kearney County",1,34,79,40,39
050,31,099,"Nebraska","Kearney County",1,35,77,41,36
050,31,099,"Nebraska","Kearney County",1,36,72,39,33
050,31,099,"Nebraska","Kearney County",1,37,90,46,44
050,31,099,"Nebraska","Kearney County",1,38,81,41,40
050,31,099,"Nebraska","Kearney County",1,39,79,43,36
050,31,099,"Nebraska","Kearney County",1,40,76,42,34
050,31,099,"Nebraska","Kearney County",1,41,83,44,39
050,31,099,"Nebraska","Kearney County",1,42,77,42,35
050,31,099,"Nebraska","Kearney County",1,43,85,44,41
050,31,099,"Nebraska","Kearney County",1,44,69,30,39
050,31,099,"Nebraska","Kearney County",1,45,67,31,36
050,31,099,"Nebraska","Kearney County",1,46,67,35,32
050,31,099,"Nebraska","Kearney County",1,47,75,42,33
050,31,099,"Nebraska","Kearney County",1,48,89,47,42
050,31,099,"Nebraska","Kearney County",1,49,84,50,34
050,31,099,"Nebraska","Kearney County",1,50,74,35,39
050,31,099,"Nebraska","Kearney County",1,51,68,35,33
050,31,099,"Nebraska","Kearney County",1,52,69,41,28
050,31,099,"Nebraska","Kearney County",1,53,70,38,32
050,31,099,"Nebraska","Kearney County",1,54,72,35,37
050,31,099,"Nebraska","Kearney County",1,55,75,40,35
050,31,099,"Nebraska","Kearney County",1,56,91,43,48
050,31,099,"Nebraska","Kearney County",1,57,106,46,60
050,31,099,"Nebraska","Kearney County",1,58,107,55,52
050,31,099,"Nebraska","Kearney County",1,59,97,51,46
050,31,099,"Nebraska","Kearney County",1,60,99,55,44
050,31,099,"Nebraska","Kearney County",1,61,110,56,54
050,31,099,"Nebraska","Kearney County",1,62,90,50,40
050,31,099,"Nebraska","Kearney County",1,63,83,41,42
050,31,099,"Nebraska","Kearney County",1,64,100,50,50
050,31,099,"Nebraska","Kearney County",1,65,79,38,41
050,31,099,"Nebraska","Kearney County",1,66,92,44,48
050,31,099,"Nebraska","Kearney County",1,67,96,46,50
050,31,099,"Nebraska","Kearney County",1,68,79,42,37
050,31,099,"Nebraska","Kearney County",1,69,67,37,30
050,31,099,"Nebraska","Kearney County",1,70,63,30,33
050,31,099,"Nebraska","Kearney County",1,71,65,28,37
050,31,099,"Nebraska","Kearney County",1,72,69,30,39
050,31,099,"Nebraska","Kearney County",1,73,70,41,29
050,31,099,"Nebraska","Kearney County",1,74,53,26,27
050,31,099,"Nebraska","Kearney County",1,75,52,21,31
050,31,099,"Nebraska","Kearney County",1,76,54,21,33
050,31,099,"Nebraska","Kearney County",1,77,59,30,29
050,31,099,"Nebraska","Kearney County",1,78,46,23,23
050,31,099,"Nebraska","Kearney County",1,79,47,22,25
050,31,099,"Nebraska","Kearney County",1,80,30,17,13
050,31,099,"Nebraska","Kearney County",1,81,35,19,16
050,31,099,"Nebraska","Kearney County",1,82,33,15,18
050,31,099,"Nebraska","Kearney County",1,83,24,10,14
050,31,099,"Nebraska","Kearney County",1,84,30,12,18
050,31,099,"Nebraska","Kearney County",1,85,185,71,114
050,31,099,"Nebraska","Kearney County",2,0,79,42,37
050,31,099,"Nebraska","Kearney County",2,1,85,45,40
050,31,099,"Nebraska","Kearney County",2,2,83,44,39
050,31,099,"Nebraska","Kearney County",2,3,80,39,41
050,31,099,"Nebraska","Kearney County",2,4,85,39,46
050,31,099,"Nebraska","Kearney County",2,5,86,41,45
050,31,099,"Nebraska","Kearney County",2,6,83,44,39
050,31,099,"Nebraska","Kearney County",2,7,86,49,37
050,31,099,"Nebraska","Kearney County",2,8,92,47,45
050,31,099,"Nebraska","Kearney County",2,9,88,42,46
050,31,099,"Nebraska","Kearney County",2,10,93,50,43
050,31,099,"Nebraska","Kearney County",2,11,95,46,49
050,31,099,"Nebraska","Kearney County",2,12,113,49,64
050,31,099,"Nebraska","Kearney County",2,13,112,51,61
050,31,099,"Nebraska","Kearney County",2,14,114,53,61
050,31,099,"Nebraska","Kearney County",2,15,110,60,50
050,31,099,"Nebraska","Kearney County",2,16,100,52,48
050,31,099,"Nebraska","Kearney County",2,17,93,46,47
050,31,099,"Nebraska","Kearney County",2,18,72,37,35
050,31,099,"Nebraska","Kearney County",2,19,50,25,25
050,31,099,"Nebraska","Kearney County",2,20,55,28,27
050,31,099,"Nebraska","Kearney County",2,21,60,32,28
050,31,099,"Nebraska","Kearney County",2,22,66,37,29
050,31,099,"Nebraska","Kearney County",2,23,75,43,32
050,31,099,"Nebraska","Kearney County",2,24,71,36,35
050,31,099,"Nebraska","Kearney County",2,25,66,38,28
050,31,099,"Nebraska","Kearney County",2,26,74,41,33
050,31,099,"Nebraska","Kearney County",2,27,71,39,32
050,31,099,"Nebraska","Kearney County",2,28,79,40,39
050,31,099,"Nebraska","Kearney County",2,29,80,41,39
050,31,099,"Nebraska","Kearney County",2,30,74,37,37
050,31,099,"Nebraska","Kearney County",2,31,74,36,38
050,31,099,"Nebraska","Kearney County",2,32,77,36,41
050,31,099,"Nebraska","Kearney County",2,33,76,31,45
050,31,099,"Nebraska","Kearney County",2,34,78,37,41
050,31,099,"Nebraska","Kearney County",2,35,80,42,38
050,31,099,"Nebraska","Kearney County",2,36,73,39,34
050,31,099,"Nebraska","Kearney County",2,37,88,46,42
050,31,099,"Nebraska","Kearney County",2,38,84,43,41
050,31,099,"Nebraska","Kearney County",2,39,80,43,37
050,31,099,"Nebraska","Kearney County",2,40,78,43,35
050,31,099,"Nebraska","Kearney County",2,41,81,44,37
050,31,099,"Nebraska","Kearney County",2,42,78,42,36
050,31,099,"Nebraska","Kearney County",2,43,83,43,40
050,31,099,"Nebraska","Kearney County",2,44,74,34,40
050,31,099,"Nebraska","Kearney County",2,45,68,31,37
050,31,099,"Nebraska","Kearney County",2,46,67,34,33
050,31,099,"Nebraska","Kearney County",2,47,72,39,33
050,31,099,"Nebraska","Kearney County",2,48,84,45,39
050,31,099,"Nebraska","Kearney County",2,49,86,49,37
050,31,099,"Nebraska","Kearney County",2,50,76,38,38
050,31,099,"Nebraska","Kearney County",2,51,69,35,34
050,31,099,"Nebraska","Kearney County",2,52,68,39,29
050,31,099,"Nebraska","Kearney County",2,53,68,38,30
050,31,099,"Nebraska","Kearney County",2,54,71,36,35
050,31,099,"Nebraska","Kearney County",2,55,75,39,36
050,31,099,"Nebraska","Kearney County",2,56,88,42,46
050,31,099,"Nebraska","Kearney County",2,57,103,45,58
050,31,099,"Nebraska","Kearney County",2,58,108,54,54
050,31,099,"Nebraska","Kearney County",2,59,101,53,48
050,31,099,"Nebraska","Kearney County",2,60,99,55,44
050,31,099,"Nebraska","Kearney County",2,61,107,55,52
050,31,099,"Nebraska","Kearney County",2,62,93,50,43
050,31,099,"Nebraska","Kearney County",2,63,86,44,42
050,31,099,"Nebraska","Kearney County",2,64,95,47,48
050,31,099,"Nebraska","Kearney County",2,65,83,41,42
050,31,099,"Nebraska","Kearney County",2,66,89,42,47
050,31,099,"Nebraska","Kearney County",2,67,95,46,49
050,31,099,"Nebraska","Kearney County",2,68,83,43,40
050,31,099,"Nebraska","Kearney County",2,69,69,38,31
050,31,099,"Nebraska","Kearney County",2,70,64,32,32
050,31,099,"Nebraska","Kearney County",2,71,64,29,35
050,31,099,"Nebraska","Kearney County",2,72,67,29,38
050,31,099,"Nebraska","Kearney County",2,73,73,40,33
050,31,099,"Nebraska","Kearney County",2,74,53,27,26
050,31,099,"Nebraska","Kearney County",2,75,51,22,29
050,31,099,"Nebraska","Kearney County",2,76,53,21,32
050,31,099,"Nebraska","Kearney County",2,77,60,29,31
050,31,099,"Nebraska","Kearney County",2,78,47,24,23
050,31,099,"Nebraska","Kearney County",2,79,44,22,22
050,31,099,"Nebraska","Kearney County",2,80,33,18,15
050,31,099,"Nebraska","Kearney County",2,81,34,18,16
050,31,099,"Nebraska","Kearney County",2,82,31,15,16
050,31,099,"Nebraska","Kearney County",2,83,27,12,15
050,31,099,"Nebraska","Kearney County",2,84,28,11,17
050,31,099,"Nebraska","Kearney County",2,85,182,69,113
050,31,099,"Nebraska","Kearney County",3,0,86,52,34
050,31,099,"Nebraska","Kearney County",3,1,82,39,43
050,31,099,"Nebraska","Kearney County",3,2,82,45,37
050,31,099,"Nebraska","Kearney County",3,3,73,39,34
050,31,099,"Nebraska","Kearney County",3,4,80,40,40
050,31,099,"Nebraska","Kearney County",3,5,88,43,45
050,31,099,"Nebraska","Kearney County",3,6,88,45,43
050,31,099,"Nebraska","Kearney County",3,7,85,44,41
050,31,099,"Nebraska","Kearney County",3,8,84,45,39
050,31,099,"Nebraska","Kearney County",3,9,106,58,48
050,31,099,"Nebraska","Kearney County",3,10,87,42,45
050,31,099,"Nebraska","Kearney County",3,11,92,42,50
050,31,099,"Nebraska","Kearney County",3,12,90,46,44
050,31,099,"Nebraska","Kearney County",3,13,115,47,68
050,31,099,"Nebraska","Kearney County",3,14,108,50,58
050,31,099,"Nebraska","Kearney County",3,15,117,55,62
050,31,099,"Nebraska","Kearney County",3,16,109,59,50
050,31,099,"Nebraska","Kearney County",3,17,98,49,49
050,31,099,"Nebraska","Kearney County",3,18,80,38,42
050,31,099,"Nebraska","Kearney County",3,19,56,31,25
050,31,099,"Nebraska","Kearney County",3,20,53,26,27
050,31,099,"Nebraska","Kearney County",3,21,53,25,28
050,31,099,"Nebraska","Kearney County",3,22,60,39,21
050,31,099,"Nebraska","Kearney County",3,23,65,35,30
050,31,099,"Nebraska","Kearney County",3,24,78,43,35
050,31,099,"Nebraska","Kearney County",3,25,68,32,36
050,31,099,"Nebraska","Kearney County",3,26,69,37,32
050,31,099,"Nebraska","Kearney County",3,27,81,44,37
050,31,099,"Nebraska","Kearney County",3,28,70,39,31
050,31,099,"Nebraska","Kearney County",3,29,74,35,39
050,31,099,"Nebraska","Kearney County",3,30,79,44,35
050,31,099,"Nebraska","Kearney County",3,31,74,40,34
050,31,099,"Nebraska","Kearney County",3,32,72,37,35
050,31,099,"Nebraska","Kearney County",3,33,83,39,44
050,31,099,"Nebraska","Kearney County",3,34,75,29,46
050,31,099,"Nebraska","Kearney County",3,35,70,31,39
050,31,099,"Nebraska","Kearney County",3,36,87,49,38
050,31,099,"Nebraska","Kearney County",3,37,72,37,35
050,31,099,"Nebraska","Kearney County",3,38,93,50,43
050,31,099,"Nebraska","Kearney County",3,39,89,45,44
050,31,099,"Nebraska","Kearney County",3,40,80,44,36
050,31,099,"Nebraska","Kearney County",3,41,83,47,36
050,31,099,"Nebraska","Kearney County",3,42,81,44,37
050,31,099,"Nebraska","Kearney County",3,43,75,42,33
050,31,099,"Nebraska","Kearney County",3,44,81,41,40
050,31,099,"Nebraska","Kearney County",3,45,74,33,41
050,31,099,"Nebraska","Kearney County",3,46,63,30,33
050,31,099,"Nebraska","Kearney County",3,47,69,34,35
050,31,099,"Nebraska","Kearney County",3,48,73,38,35
050,31,099,"Nebraska","Kearney County",3,49,87,49,38
050,31,099,"Nebraska","Kearney County",3,50,78,42,36
050,31,099,"Nebraska","Kearney County",3,51,75,39,36
050,31,099,"Nebraska","Kearney County",3,52,71,38,33
050,31,099,"Nebraska","Kearney County",3,53,70,39,31
050,31,099,"Nebraska","Kearney County",3,54,63,33,30
050,31,099,"Nebraska","Kearney County",3,55,68,34,34
050,31,099,"Nebraska","Kearney County",3,56,71,39,32
050,31,099,"Nebraska","Kearney County",3,57,87,42,45
050,31,099,"Nebraska","Kearney County",3,58,104,46,58
050,31,099,"Nebraska","Kearney County",3,59,107,52,55
050,31,099,"Nebraska","Kearney County",3,60,101,52,49
050,31,099,"Nebraska","Kearney County",3,61,102,57,45
050,31,099,"Nebraska","Kearney County",3,62,101,50,51
050,31,099,"Nebraska","Kearney County",3,63,94,50,44
050,31,099,"Nebraska","Kearney County",3,64,89,47,42
050,31,099,"Nebraska","Kearney County",3,65,95,49,46
050,31,099,"Nebraska","Kearney County",3,66,84,41,43
050,31,099,"Nebraska","Kearney County",3,67,91,44,47
050,31,099,"Nebraska","Kearney County",3,68,93,44,49
050,31,099,"Nebraska","Kearney County",3,69,79,41,38
050,31,099,"Nebraska","Kearney County",3,70,71,37,34
050,31,099,"Nebraska","Kearney County",3,71,63,32,31
050,31,099,"Nebraska","Kearney County",3,72,63,28,35
050,31,099,"Nebraska","Kearney County",3,73,64,28,36
050,31,099,"Nebraska","Kearney County",3,74,70,39,31
050,31,099,"Nebraska","Kearney County",3,75,51,26,25
050,31,099,"Nebraska","Kearney County",3,76,52,20,32
050,31,099,"Nebraska","Kearney County",3,77,48,19,29
050,31,099,"Nebraska","Kearney County",3,78,59,31,28
050,31,099,"Nebraska","Kearney County",3,79,46,22,24
050,31,099,"Nebraska","Kearney County",3,80,37,20,17
050,31,099,"Nebraska","Kearney County",3,81,33,15,18
050,31,099,"Nebraska","Kearney County",3,82,29,16,13
050,31,099,"Nebraska","Kearney County",3,83,30,15,15
050,31,099,"Nebraska","Kearney County",3,84,24,10,14
050,31,099,"Nebraska","Kearney County",3,85,183,69,114
050,31,099,"Nebraska","Kearney County",4,0,79,45,34
050,31,099,"Nebraska","Kearney County",4,1,94,60,34
050,31,099,"Nebraska","Kearney County",4,2,86,37,49
050,31,099,"Nebraska","Kearney County",4,3,83,46,37
050,31,099,"Nebraska","Kearney County",4,4,73,34,39
050,31,099,"Nebraska","Kearney County",4,5,80,43,37
050,31,099,"Nebraska","Kearney County",4,6,93,48,45
050,31,099,"Nebraska","Kearney County",4,7,93,50,43
050,31,099,"Nebraska","Kearney County",4,8,84,44,40
050,31,099,"Nebraska","Kearney County",4,9,84,46,38
050,31,099,"Nebraska","Kearney County",4,10,104,56,48
050,31,099,"Nebraska","Kearney County",4,11,92,43,49
050,31,099,"Nebraska","Kearney County",4,12,96,43,53
050,31,099,"Nebraska","Kearney County",4,13,94,45,49
050,31,099,"Nebraska","Kearney County",4,14,114,44,70
050,31,099,"Nebraska","Kearney County",4,15,108,46,62
050,31,099,"Nebraska","Kearney County",4,16,117,57,60
050,31,099,"Nebraska","Kearney County",4,17,107,55,52
050,31,099,"Nebraska","Kearney County",4,18,82,43,39
050,31,099,"Nebraska","Kearney County",4,19,60,26,34
050,31,099,"Nebraska","Kearney County",4,20,53,26,27
050,31,099,"Nebraska","Kearney County",4,21,53,24,29
050,31,099,"Nebraska","Kearney County",4,22,54,29,25
050,31,099,"Nebraska","Kearney County",4,23,57,34,23
050,31,099,"Nebraska","Kearney County",4,24,68,34,34
050,31,099,"Nebraska","Kearney County",4,25,85,48,37
050,31,099,"Nebraska","Kearney County",4,26,68,30,38
050,31,099,"Nebraska","Kearney County",4,27,72,40,32
050,31,099,"Nebraska","Kearney County",4,28,79,41,38
050,31,099,"Nebraska","Kearney County",4,29,66,35,31
050,31,099,"Nebraska","Kearney County",4,30,78,38,40
050,31,099,"Nebraska","Kearney County",4,31,84,44,40
050,31,099,"Nebraska","Kearney County",4,32,79,43,36
050,31,099,"Nebraska","Kearney County",4,33,75,34,41
050,31,099,"Nebraska","Kearney County",4,34,76,37,39
050,31,099,"Nebraska","Kearney County",4,35,75,31,44
050,31,099,"Nebraska","Kearney County",4,36,70,29,41
050,31,099,"Nebraska","Kearney County",4,37,90,51,39
050,31,099,"Nebraska","Kearney County",4,38,72,37,35
050,31,099,"Nebraska","Kearney County",4,39,87,47,40
050,31,099,"Nebraska","Kearney County",4,40,84,43,41
050,31,099,"Nebraska","Kearney County",4,41,79,41,38
050,31,099,"Nebraska","Kearney County",4,42,85,48,37
050,31,099,"Nebraska","Kearney County",4,43,82,43,39
050,31,099,"Nebraska","Kearney County",4,44,76,43,33
050,31,099,"Nebraska","Kearney County",4,45,79,40,39
050,31,099,"Nebraska","Kearney County",4,46,72,31,41
050,31,099,"Nebraska","Kearney County",4,47,63,31,32
050,31,099,"Nebraska","Kearney County",4,48,70,35,35
050,31,099,"Nebraska","Kearney County",4,49,76,38,38
050,31,099,"Nebraska","Kearney County",4,50,87,49,38
050,31,099,"Nebraska","Kearney County",4,51,83,44,39
050,31,099,"Nebraska","Kearney County",4,52,76,39,37
050,31,099,"Nebraska","Kearney County",4,53,71,38,33
050,31,099,"Nebraska","Kearney County",4,54,68,40,28
050,31,099,"Nebraska","Kearney County",4,55,64,34,30
050,31,099,"Nebraska","Kearney County",4,56,69,35,34
050,31,099,"Nebraska","Kearney County",4,57,69,38,31
050,31,099,"Nebraska","Kearney County",4,58,84,40,44
050,31,099,"Nebraska","Kearney County",4,59,103,46,57
050,31,099,"Nebraska","Kearney County",4,60,106,50,56
050,31,099,"Nebraska","Kearney County",4,61,94,49,45
050,31,099,"Nebraska","Kearney County",4,62,104,56,48
050,31,099,"Nebraska","Kearney County",4,63,102,50,52
050,31,099,"Nebraska","Kearney County",4,64,97,51,46
050,31,099,"Nebraska","Kearney County",4,65,83,46,37
050,31,099,"Nebraska","Kearney County",4,66,93,49,44
050,31,099,"Nebraska","Kearney County",4,67,86,42,44
050,31,099,"Nebraska","Kearney County",4,68,87,43,44
050,31,099,"Nebraska","Kearney County",4,69,91,42,49
050,31,099,"Nebraska","Kearney County",4,70,80,41,39
050,31,099,"Nebraska","Kearney County",4,71,73,39,34
050,31,099,"Nebraska","Kearney County",4,72,66,33,33
050,31,099,"Nebraska","Kearney County",4,73,60,25,35
050,31,099,"Nebraska","Kearney County",4,74,63,27,36
050,31,099,"Nebraska","Kearney County",4,75,68,37,31
050,31,099,"Nebraska","Kearney County",4,76,53,26,27
050,31,099,"Nebraska","Kearney County",4,77,51,20,31
050,31,099,"Nebraska","Kearney County",4,78,47,19,28
050,31,099,"Nebraska","Kearney County",4,79,57,29,28
050,31,099,"Nebraska","Kearney County",4,80,42,22,20
050,31,099,"Nebraska","Kearney County",4,81,39,20,19
050,31,099,"Nebraska","Kearney County",4,82,35,14,21
050,31,099,"Nebraska","Kearney County",4,83,27,14,13
050,31,099,"Nebraska","Kearney County",4,84,24,11,13
050,31,099,"Nebraska","Kearney County",4,85,174,70,104
050,31,099,"Nebraska","Kearney County",5,0,82,47,35
050,31,099,"Nebraska","Kearney County",5,1,81,49,32
050,31,099,"Nebraska","Kearney County",5,2,95,60,35
050,31,099,"Nebraska","Kearney County",5,3,87,39,48
050,31,099,"Nebraska","Kearney County",5,4,83,46,37
050,31,099,"Nebraska","Kearney County",5,5,77,36,41
050,31,099,"Nebraska","Kearney County",5,6,79,42,37
050,31,099,"Nebraska","Kearney County",5,7,94,47,47
050,31,099,"Nebraska","Kearney County",5,8,94,53,41
050,31,099,"Nebraska","Kearney County",5,9,83,42,41
050,31,099,"Nebraska","Kearney County",5,10,92,51,41
050,31,099,"Nebraska","Kearney County",5,11,106,57,49
050,31,099,"Nebraska","Kearney County",5,12,98,47,51
050,31,099,"Nebraska","Kearney County",5,13,93,43,50
050,31,099,"Nebraska","Kearney County",5,14,96,47,49
050,31,099,"Nebraska","Kearney County",5,15,109,45,64
050,31,099,"Nebraska","Kearney County",5,16,107,48,59
050,31,099,"Nebraska","Kearney County",5,17,118,58,60
050,31,099,"Nebraska","Kearney County",5,18,86,48,38
050,31,099,"Nebraska","Kearney County",5,19,62,32,30
050,31,099,"Nebraska","Kearney County",5,20,60,26,34
050,31,099,"Nebraska","Kearney County",5,21,58,28,30
050,31,099,"Nebraska","Kearney County",5,22,55,27,28
050,31,099,"Nebraska","Kearney County",5,23,61,29,32
050,31,099,"Nebraska","Kearney County",5,24,62,33,29
050,31,099,"Nebraska","Kearney County",5,25,74,32,42
050,31,099,"Nebraska","Kearney County",5,26,89,52,37
050,31,099,"Nebraska","Kearney County",5,27,73,34,39
050,31,099,"Nebraska","Kearney County",5,28,82,44,38
050,31,099,"Nebraska","Kearney County",5,29,83,44,39
050,31,099,"Nebraska","Kearney County",5,30,64,32,32
050,31,099,"Nebraska","Kearney County",5,31,77,38,39
050,31,099,"Nebraska","Kearney County",5,32,90,44,46
050,31,099,"Nebraska","Kearney County",5,33,86,46,40
050,31,099,"Nebraska","Kearney County",5,34,79,39,40
050,31,099,"Nebraska","Kearney County",5,35,77,38,39
050,31,099,"Nebraska","Kearney County",5,36,80,33,47
050,31,099,"Nebraska","Kearney County",5,37,69,28,41
050,31,099,"Nebraska","Kearney County",5,38,95,52,43
050,31,099,"Nebraska","Kearney County",5,39,74,37,37
050,31,099,"Nebraska","Kearney County",5,40,86,48,38
050,31,099,"Nebraska","Kearney County",5,41,85,44,41
050,31,099,"Nebraska","Kearney County",5,42,83,42,41
050,31,099,"Nebraska","Kearney County",5,43,91,49,42
050,31,099,"Nebraska","Kearney County",5,44,84,45,39
050,31,099,"Nebraska","Kearney County",5,45,78,43,35
050,31,099,"Nebraska","Kearney County",5,46,80,40,40
050,31,099,"Nebraska","Kearney County",5,47,72,30,42
050,31,099,"Nebraska","Kearney County",5,48,56,28,28
050,31,099,"Nebraska","Kearney County",5,49,71,36,35
050,31,099,"Nebraska","Kearney County",5,50,77,41,36
050,31,099,"Nebraska","Kearney County",5,51,87,48,39
050,31,099,"Nebraska","Kearney County",5,52,82,44,38
050,31,099,"Nebraska","Kearney County",5,53,78,38,40
050,31,099,"Nebraska","Kearney County",5,54,68,38,30
050,31,099,"Nebraska","Kearney County",5,55,69,40,29
050,31,099,"Nebraska","Kearney County",5,56,61,34,27
050,31,099,"Nebraska","Kearney County",5,57,71,35,36
050,31,099,"Nebraska","Kearney County",5,58,69,38,31
050,31,099,"Nebraska","Kearney County",5,59,86,41,45
050,31,099,"Nebraska","Kearney County",5,60,99,43,56
050,31,099,"Nebraska","Kearney County",5,61,105,49,56
050,31,099,"Nebraska","Kearney County",5,62,92,48,44
050,31,099,"Nebraska","Kearney County",5,63,103,56,47
050,31,099,"Nebraska","Kearney County",5,64,104,48,56
050,31,099,"Nebraska","Kearney County",5,65,93,49,44
050,31,099,"Nebraska","Kearney County",5,66,78,41,37
050,31,099,"Nebraska","Kearney County",5,67,90,48,42
050,31,099,"Nebraska","Kearney County",5,68,80,41,39
050,31,099,"Nebraska","Kearney County",5,69,86,41,45
050,31,099,"Nebraska","Kearney County",5,70,89,42,47
050,31,099,"Nebraska","Kearney County",5,71,82,43,39
050,31,099,"Nebraska","Kearney County",5,72,74,40,34
050,31,099,"Nebraska","Kearney County",5,73,63,30,33
050,31,099,"Nebraska","Kearney County",5,74,59,23,36
050,31,099,"Nebraska","Kearney County",5,75,61,26,35
050,31,099,"Nebraska","Kearney County",5,76,68,35,33
050,31,099,"Nebraska","Kearney County",5,77,52,26,26
050,31,099,"Nebraska","Kearney County",5,78,48,19,29
050,31,099,"Nebraska","Kearney County",5,79,44,17,27
050,31,099,"Nebraska","Kearney County",5,80,52,29,23
050,31,099,"Nebraska","Kearney County",5,81,41,22,19
050,31,099,"Nebraska","Kearney County",5,82,34,17,17
050,31,099,"Nebraska","Kearney County",5,83,32,11,21
050,31,099,"Nebraska","Kearney County",5,84,24,11,13
050,31,099,"Nebraska","Kearney County",5,85,173,72,101
050,31,101,"Nebraska","Keith County",1,0,85,43,42
050,31,101,"Nebraska","Keith County",1,1,89,49,40
050,31,101,"Nebraska","Keith County",1,2,94,54,40
050,31,101,"Nebraska","Keith County",1,3,105,49,56
050,31,101,"Nebraska","Keith County",1,4,100,57,43
050,31,101,"Nebraska","Keith County",1,5,90,51,39
050,31,101,"Nebraska","Keith County",1,6,93,43,50
050,31,101,"Nebraska","Keith County",1,7,86,46,40
050,31,101,"Nebraska","Keith County",1,8,91,52,39
050,31,101,"Nebraska","Keith County",1,9,95,55,40
050,31,101,"Nebraska","Keith County",1,10,90,40,50
050,31,101,"Nebraska","Keith County",1,11,92,46,46
050,31,101,"Nebraska","Keith County",1,12,101,52,49
050,31,101,"Nebraska","Keith County",1,13,111,60,51
050,31,101,"Nebraska","Keith County",1,14,117,62,55
050,31,101,"Nebraska","Keith County",1,15,114,71,43
050,31,101,"Nebraska","Keith County",1,16,109,57,52
050,31,101,"Nebraska","Keith County",1,17,95,50,45
050,31,101,"Nebraska","Keith County",1,18,85,47,38
050,31,101,"Nebraska","Keith County",1,19,61,34,27
050,31,101,"Nebraska","Keith County",1,20,66,30,36
050,31,101,"Nebraska","Keith County",1,21,71,38,33
050,31,101,"Nebraska","Keith County",1,22,77,38,39
050,31,101,"Nebraska","Keith County",1,23,70,31,39
050,31,101,"Nebraska","Keith County",1,24,77,40,37
050,31,101,"Nebraska","Keith County",1,25,84,41,43
050,31,101,"Nebraska","Keith County",1,26,81,38,43
050,31,101,"Nebraska","Keith County",1,27,88,40,48
050,31,101,"Nebraska","Keith County",1,28,73,37,36
050,31,101,"Nebraska","Keith County",1,29,76,36,40
050,31,101,"Nebraska","Keith County",1,30,73,37,36
050,31,101,"Nebraska","Keith County",1,31,69,35,34
050,31,101,"Nebraska","Keith County",1,32,73,40,33
050,31,101,"Nebraska","Keith County",1,33,85,40,45
050,31,101,"Nebraska","Keith County",1,34,90,42,48
050,31,101,"Nebraska","Keith County",1,35,98,49,49
050,31,101,"Nebraska","Keith County",1,36,96,53,43
050,31,101,"Nebraska","Keith County",1,37,99,49,50
050,31,101,"Nebraska","Keith County",1,38,94,46,48
050,31,101,"Nebraska","Keith County",1,39,78,39,39
050,31,101,"Nebraska","Keith County",1,40,73,37,36
050,31,101,"Nebraska","Keith County",1,41,88,46,42
050,31,101,"Nebraska","Keith County",1,42,87,50,37
050,31,101,"Nebraska","Keith County",1,43,87,52,35
050,31,101,"Nebraska","Keith County",1,44,66,35,31
050,31,101,"Nebraska","Keith County",1,45,86,42,44
050,31,101,"Nebraska","Keith County",1,46,73,35,38
050,31,101,"Nebraska","Keith County",1,47,84,42,42
050,31,101,"Nebraska","Keith County",1,48,74,29,45
050,31,101,"Nebraska","Keith County",1,49,100,42,58
050,31,101,"Nebraska","Keith County",1,50,90,42,48
050,31,101,"Nebraska","Keith County",1,51,90,47,43
050,31,101,"Nebraska","Keith County",1,52,105,60,45
050,31,101,"Nebraska","Keith County",1,53,94,51,43
050,31,101,"Nebraska","Keith County",1,54,95,50,45
050,31,101,"Nebraska","Keith County",1,55,105,54,51
050,31,101,"Nebraska","Keith County",1,56,113,56,57
050,31,101,"Nebraska","Keith County",1,57,132,67,65
050,31,101,"Nebraska","Keith County",1,58,153,82,71
050,31,101,"Nebraska","Keith County",1,59,136,74,62
050,31,101,"Nebraska","Keith County",1,60,142,74,68
050,31,101,"Nebraska","Keith County",1,61,146,80,66
050,31,101,"Nebraska","Keith County",1,62,141,75,66
050,31,101,"Nebraska","Keith County",1,63,131,62,69
050,31,101,"Nebraska","Keith County",1,64,127,64,63
050,31,101,"Nebraska","Keith County",1,65,128,64,64
050,31,101,"Nebraska","Keith County",1,66,135,69,66
050,31,101,"Nebraska","Keith County",1,67,136,65,71
050,31,101,"Nebraska","Keith County",1,68,127,65,62
050,31,101,"Nebraska","Keith County",1,69,121,53,68
050,31,101,"Nebraska","Keith County",1,70,119,55,64
050,31,101,"Nebraska","Keith County",1,71,140,70,70
050,31,101,"Nebraska","Keith County",1,72,129,66,63
050,31,101,"Nebraska","Keith County",1,73,130,67,63
050,31,101,"Nebraska","Keith County",1,74,80,40,40
050,31,101,"Nebraska","Keith County",1,75,84,39,45
050,31,101,"Nebraska","Keith County",1,76,90,49,41
050,31,101,"Nebraska","Keith County",1,77,89,43,46
050,31,101,"Nebraska","Keith County",1,78,73,30,43
050,31,101,"Nebraska","Keith County",1,79,74,30,44
050,31,101,"Nebraska","Keith County",1,80,64,32,32
050,31,101,"Nebraska","Keith County",1,81,60,28,32
050,31,101,"Nebraska","Keith County",1,82,61,35,26
050,31,101,"Nebraska","Keith County",1,83,56,28,28
050,31,101,"Nebraska","Keith County",1,84,55,24,31
050,31,101,"Nebraska","Keith County",1,85,237,97,140
050,31,101,"Nebraska","Keith County",2,0,81,40,41
050,31,101,"Nebraska","Keith County",2,1,89,49,40
050,31,101,"Nebraska","Keith County",2,2,93,53,40
050,31,101,"Nebraska","Keith County",2,3,102,50,52
050,31,101,"Nebraska","Keith County",2,4,103,56,47
050,31,101,"Nebraska","Keith County",2,5,93,52,41
050,31,101,"Nebraska","Keith County",2,6,92,45,47
050,31,101,"Nebraska","Keith County",2,7,87,45,42
050,31,101,"Nebraska","Keith County",2,8,89,50,39
050,31,101,"Nebraska","Keith County",2,9,92,52,40
050,31,101,"Nebraska","Keith County",2,10,92,44,48
050,31,101,"Nebraska","Keith County",2,11,93,45,48
050,31,101,"Nebraska","Keith County",2,12,100,51,49
050,31,101,"Nebraska","Keith County",2,13,108,58,50
050,31,101,"Nebraska","Keith County",2,14,115,61,54
050,31,101,"Nebraska","Keith County",2,15,114,67,47
050,31,101,"Nebraska","Keith County",2,16,111,61,50
050,31,101,"Nebraska","Keith County",2,17,99,53,46
050,31,101,"Nebraska","Keith County",2,18,83,45,38
050,31,101,"Nebraska","Keith County",2,19,62,34,28
050,31,101,"Nebraska","Keith County",2,20,65,30,35
050,31,101,"Nebraska","Keith County",2,21,69,35,34
050,31,101,"Nebraska","Keith County",2,22,75,37,38
050,31,101,"Nebraska","Keith County",2,23,71,32,39
050,31,101,"Nebraska","Keith County",2,24,77,39,38
050,31,101,"Nebraska","Keith County",2,25,82,40,42
050,31,101,"Nebraska","Keith County",2,26,82,39,43
050,31,101,"Nebraska","Keith County",2,27,86,39,47
050,31,101,"Nebraska","Keith County",2,28,78,38,40
050,31,101,"Nebraska","Keith County",2,29,75,36,39
050,31,101,"Nebraska","Keith County",2,30,76,38,38
050,31,101,"Nebraska","Keith County",2,31,70,35,35
050,31,101,"Nebraska","Keith County",2,32,71,38,33
050,31,101,"Nebraska","Keith County",2,33,81,39,42
050,31,101,"Nebraska","Keith County",2,34,89,42,47
050,31,101,"Nebraska","Keith County",2,35,95,47,48
050,31,101,"Nebraska","Keith County",2,36,96,51,45
050,31,101,"Nebraska","Keith County",2,37,100,52,48
050,31,101,"Nebraska","Keith County",2,38,94,46,48
050,31,101,"Nebraska","Keith County",2,39,81,40,41
050,31,101,"Nebraska","Keith County",2,40,73,37,36
050,31,101,"Nebraska","Keith County",2,41,84,44,40
050,31,101,"Nebraska","Keith County",2,42,89,50,39
050,31,101,"Nebraska","Keith County",2,43,90,53,37
050,31,101,"Nebraska","Keith County",2,44,72,40,32
050,31,101,"Nebraska","Keith County",2,45,82,40,42
050,31,101,"Nebraska","Keith County",2,46,77,38,39
050,31,101,"Nebraska","Keith County",2,47,80,40,40
050,31,101,"Nebraska","Keith County",2,48,75,31,44
050,31,101,"Nebraska","Keith County",2,49,95,39,56
050,31,101,"Nebraska","Keith County",2,50,92,42,50
050,31,101,"Nebraska","Keith County",2,51,89,45,44
050,31,101,"Nebraska","Keith County",2,52,100,56,44
050,31,101,"Nebraska","Keith County",2,53,95,52,43
050,31,101,"Nebraska","Keith County",2,54,98,52,46
050,31,101,"Nebraska","Keith County",2,55,102,52,50
050,31,101,"Nebraska","Keith County",2,56,112,56,56
050,31,101,"Nebraska","Keith County",2,57,127,64,63
050,31,101,"Nebraska","Keith County",2,58,148,78,70
050,31,101,"Nebraska","Keith County",2,59,141,77,64
050,31,101,"Nebraska","Keith County",2,60,141,74,67
050,31,101,"Nebraska","Keith County",2,61,144,78,66
050,31,101,"Nebraska","Keith County",2,62,144,77,67
050,31,101,"Nebraska","Keith County",2,63,135,66,69
050,31,101,"Nebraska","Keith County",2,64,126,63,63
050,31,101,"Nebraska","Keith County",2,65,129,65,64
050,31,101,"Nebraska","Keith County",2,66,132,66,66
050,31,101,"Nebraska","Keith County",2,67,134,65,69
050,31,101,"Nebraska","Keith County",2,68,131,66,65
050,31,101,"Nebraska","Keith County",2,69,123,56,67
050,31,101,"Nebraska","Keith County",2,70,117,54,63
050,31,101,"Nebraska","Keith County",2,71,135,66,69
050,31,101,"Nebraska","Keith County",2,72,129,66,63
050,31,101,"Nebraska","Keith County",2,73,135,70,65
050,31,101,"Nebraska","Keith County",2,74,86,43,43
050,31,101,"Nebraska","Keith County",2,75,84,40,44
050,31,101,"Nebraska","Keith County",2,76,88,47,41
050,31,101,"Nebraska","Keith County",2,77,87,43,44
050,31,101,"Nebraska","Keith County",2,78,74,32,42
050,31,101,"Nebraska","Keith County",2,79,71,28,43
050,31,101,"Nebraska","Keith County",2,80,67,32,35
050,31,101,"Nebraska","Keith County",2,81,60,28,32
050,31,101,"Nebraska","Keith County",2,82,62,34,28
050,31,101,"Nebraska","Keith County",2,83,58,30,28
050,31,101,"Nebraska","Keith County",2,84,55,25,30
050,31,101,"Nebraska","Keith County",2,85,243,102,141
050,31,101,"Nebraska","Keith County",3,0,80,43,37
050,31,101,"Nebraska","Keith County",3,1,75,41,34
050,31,101,"Nebraska","Keith County",3,2,86,43,43
050,31,101,"Nebraska","Keith County",3,3,89,47,42
050,31,101,"Nebraska","Keith County",3,4,97,46,51
050,31,101,"Nebraska","Keith County",3,5,102,57,45
050,31,101,"Nebraska","Keith County",3,6,91,51,40
050,31,101,"Nebraska","Keith County",3,7,95,44,51
050,31,101,"Nebraska","Keith County",3,8,84,46,38
050,31,101,"Nebraska","Keith County",3,9,88,47,41
050,31,101,"Nebraska","Keith County",3,10,94,54,40
050,31,101,"Nebraska","Keith County",3,11,101,48,53
050,31,101,"Nebraska","Keith County",3,12,91,46,45
050,31,101,"Nebraska","Keith County",3,13,104,54,50
050,31,101,"Nebraska","Keith County",3,14,113,57,56
050,31,101,"Nebraska","Keith County",3,15,127,69,58
050,31,101,"Nebraska","Keith County",3,16,113,65,48
050,31,101,"Nebraska","Keith County",3,17,108,64,44
050,31,101,"Nebraska","Keith County",3,18,88,51,37
050,31,101,"Nebraska","Keith County",3,19,60,32,28
050,31,101,"Nebraska","Keith County",3,20,69,40,29
050,31,101,"Nebraska","Keith County",3,21,61,27,34
050,31,101,"Nebraska","Keith County",3,22,64,35,29
050,31,101,"Nebraska","Keith County",3,23,79,36,43
050,31,101,"Nebraska","Keith County",3,24,66,32,34
050,31,101,"Nebraska","Keith County",3,25,72,37,35
050,31,101,"Nebraska","Keith County",3,26,76,40,36
050,31,101,"Nebraska","Keith County",3,27,85,43,42
050,31,101,"Nebraska","Keith County",3,28,89,44,45
050,31,101,"Nebraska","Keith County",3,29,68,29,39
050,31,101,"Nebraska","Keith County",3,30,80,43,37
050,31,101,"Nebraska","Keith County",3,31,75,35,40
050,31,101,"Nebraska","Keith County",3,32,66,30,36
050,31,101,"Nebraska","Keith County",3,33,71,38,33
050,31,101,"Nebraska","Keith County",3,34,76,35,41
050,31,101,"Nebraska","Keith County",3,35,96,48,48
050,31,101,"Nebraska","Keith County",3,36,99,51,48
050,31,101,"Nebraska","Keith County",3,37,99,53,46
050,31,101,"Nebraska","Keith County",3,38,91,46,45
050,31,101,"Nebraska","Keith County",3,39,91,42,49
050,31,101,"Nebraska","Keith County",3,40,78,40,38
050,31,101,"Nebraska","Keith County",3,41,70,35,35
050,31,101,"Nebraska","Keith County",3,42,85,45,40
050,31,101,"Nebraska","Keith County",3,43,93,52,41
050,31,101,"Nebraska","Keith County",3,44,88,50,38
050,31,101,"Nebraska","Keith County",3,45,71,39,32
050,31,101,"Nebraska","Keith County",3,46,83,41,42
050,31,101,"Nebraska","Keith County",3,47,79,41,38
050,31,101,"Nebraska","Keith County",3,48,82,42,40
050,31,101,"Nebraska","Keith County",3,49,79,34,45
050,31,101,"Nebraska","Keith County",3,50,94,39,55
050,31,101,"Nebraska","Keith County",3,51,94,43,51
050,31,101,"Nebraska","Keith County",3,52,94,46,48
050,31,101,"Nebraska","Keith County",3,53,97,56,41
050,31,101,"Nebraska","Keith County",3,54,95,52,43
050,31,101,"Nebraska","Keith County",3,55,101,56,45
050,31,101,"Nebraska","Keith County",3,56,104,54,50
050,31,101,"Nebraska","Keith County",3,57,108,56,52
050,31,101,"Nebraska","Keith County",3,58,126,61,65
050,31,101,"Nebraska","Keith County",3,59,145,76,69
050,31,101,"Nebraska","Keith County",3,60,144,79,65
050,31,101,"Nebraska","Keith County",3,61,139,74,65
050,31,101,"Nebraska","Keith County",3,62,142,76,66
050,31,101,"Nebraska","Keith County",3,63,143,74,69
050,31,101,"Nebraska","Keith County",3,64,139,70,69
050,31,101,"Nebraska","Keith County",3,65,131,62,69
050,31,101,"Nebraska","Keith County",3,66,125,63,62
050,31,101,"Nebraska","Keith County",3,67,129,64,65
050,31,101,"Nebraska","Keith County",3,68,131,64,67
050,31,101,"Nebraska","Keith County",3,69,129,66,63
050,31,101,"Nebraska","Keith County",3,70,121,51,70
050,31,101,"Nebraska","Keith County",3,71,115,53,62
050,31,101,"Nebraska","Keith County",3,72,133,66,67
050,31,101,"Nebraska","Keith County",3,73,128,65,63
050,31,101,"Nebraska","Keith County",3,74,129,65,64
050,31,101,"Nebraska","Keith County",3,75,84,43,41
050,31,101,"Nebraska","Keith County",3,76,76,32,44
050,31,101,"Nebraska","Keith County",3,77,86,44,42
050,31,101,"Nebraska","Keith County",3,78,83,42,41
050,31,101,"Nebraska","Keith County",3,79,73,34,39
050,31,101,"Nebraska","Keith County",3,80,67,26,41
050,31,101,"Nebraska","Keith County",3,81,61,29,32
050,31,101,"Nebraska","Keith County",3,82,55,25,30
050,31,101,"Nebraska","Keith County",3,83,54,30,24
050,31,101,"Nebraska","Keith County",3,84,54,27,27
050,31,101,"Nebraska","Keith County",3,85,257,107,150
050,31,101,"Nebraska","Keith County",4,0,75,38,37
050,31,101,"Nebraska","Keith County",4,1,82,45,37
050,31,101,"Nebraska","Keith County",4,2,84,48,36
050,31,101,"Nebraska","Keith County",4,3,85,43,42
050,31,101,"Nebraska","Keith County",4,4,86,45,41
050,31,101,"Nebraska","Keith County",4,5,98,49,49
050,31,101,"Nebraska","Keith County",4,6,98,51,47
050,31,101,"Nebraska","Keith County",4,7,89,49,40
050,31,101,"Nebraska","Keith County",4,8,92,41,51
050,31,101,"Nebraska","Keith County",4,9,84,46,38
050,31,101,"Nebraska","Keith County",4,10,87,47,40
050,31,101,"Nebraska","Keith County",4,11,93,51,42
050,31,101,"Nebraska","Keith County",4,12,103,48,55
050,31,101,"Nebraska","Keith County",4,13,86,43,43
050,31,101,"Nebraska","Keith County",4,14,104,53,51
050,31,101,"Nebraska","Keith County",4,15,110,57,53
050,31,101,"Nebraska","Keith County",4,16,125,65,60
050,31,101,"Nebraska","Keith County",4,17,102,57,45
050,31,101,"Nebraska","Keith County",4,18,90,51,39
050,31,101,"Nebraska","Keith County",4,19,66,38,28
050,31,101,"Nebraska","Keith County",4,20,76,41,35
050,31,101,"Nebraska","Keith County",4,21,69,39,30
050,31,101,"Nebraska","Keith County",4,22,66,34,32
050,31,101,"Nebraska","Keith County",4,23,66,33,33
050,31,101,"Nebraska","Keith County",4,24,74,34,40
050,31,101,"Nebraska","Keith County",4,25,69,35,34
050,31,101,"Nebraska","Keith County",4,26,71,39,32
050,31,101,"Nebraska","Keith County",4,27,71,39,32
050,31,101,"Nebraska","Keith County",4,28,86,41,45
050,31,101,"Nebraska","Keith County",4,29,90,41,49
050,31,101,"Nebraska","Keith County",4,30,73,34,39
050,31,101,"Nebraska","Keith County",4,31,79,42,37
050,31,101,"Nebraska","Keith County",4,32,75,36,39
050,31,101,"Nebraska","Keith County",4,33,62,28,34
050,31,101,"Nebraska","Keith County",4,34,66,39,27
050,31,101,"Nebraska","Keith County",4,35,76,37,39
050,31,101,"Nebraska","Keith County",4,36,100,47,53
050,31,101,"Nebraska","Keith County",4,37,94,53,41
050,31,101,"Nebraska","Keith County",4,38,103,55,48
050,31,101,"Nebraska","Keith County",4,39,95,47,48
050,31,101,"Nebraska","Keith County",4,40,95,42,53
050,31,101,"Nebraska","Keith County",4,41,76,41,35
050,31,101,"Nebraska","Keith County",4,42,76,36,40
050,31,101,"Nebraska","Keith County",4,43,83,48,35
050,31,101,"Nebraska","Keith County",4,44,86,45,41
050,31,101,"Nebraska","Keith County",4,45,92,50,42
050,31,101,"Nebraska","Keith County",4,46,68,36,32
050,31,101,"Nebraska","Keith County",4,47,92,46,46
050,31,101,"Nebraska","Keith County",4,48,78,40,38
050,31,101,"Nebraska","Keith County",4,49,81,43,38
050,31,101,"Nebraska","Keith County",4,50,78,34,44
050,31,101,"Nebraska","Keith County",4,51,94,40,54
050,31,101,"Nebraska","Keith County",4,52,91,40,51
050,31,101,"Nebraska","Keith County",4,53,97,49,48
050,31,101,"Nebraska","Keith County",4,54,101,56,45
050,31,101,"Nebraska","Keith County",4,55,99,52,47
050,31,101,"Nebraska","Keith County",4,56,107,61,46
050,31,101,"Nebraska","Keith County",4,57,109,56,53
050,31,101,"Nebraska","Keith County",4,58,107,56,51
050,31,101,"Nebraska","Keith County",4,59,129,63,66
050,31,101,"Nebraska","Keith County",4,60,146,77,69
050,31,101,"Nebraska","Keith County",4,61,150,82,68
050,31,101,"Nebraska","Keith County",4,62,138,75,63
050,31,101,"Nebraska","Keith County",4,63,141,74,67
050,31,101,"Nebraska","Keith County",4,64,146,73,73
050,31,101,"Nebraska","Keith County",4,65,140,73,67
050,31,101,"Nebraska","Keith County",4,66,125,58,67
050,31,101,"Nebraska","Keith County",4,67,119,58,61
050,31,101,"Nebraska","Keith County",4,68,128,64,64
050,31,101,"Nebraska","Keith County",4,69,130,65,65
050,31,101,"Nebraska","Keith County",4,70,126,64,62
050,31,101,"Nebraska","Keith County",4,71,117,49,68
050,31,101,"Nebraska","Keith County",4,72,111,52,59
050,31,101,"Nebraska","Keith County",4,73,128,61,67
050,31,101,"Nebraska","Keith County",4,74,123,59,64
050,31,101,"Nebraska","Keith County",4,75,127,62,65
050,31,101,"Nebraska","Keith County",4,76,78,39,39
050,31,101,"Nebraska","Keith County",4,77,71,30,41
050,31,101,"Nebraska","Keith County",4,78,79,43,36
050,31,101,"Nebraska","Keith County",4,79,82,40,42
050,31,101,"Nebraska","Keith County",4,80,69,30,39
050,31,101,"Nebraska","Keith County",4,81,65,24,41
050,31,101,"Nebraska","Keith County",4,82,57,28,29
050,31,101,"Nebraska","Keith County",4,83,43,18,25
050,31,101,"Nebraska","Keith County",4,84,47,29,18
050,31,101,"Nebraska","Keith County",4,85,254,109,145
050,31,101,"Nebraska","Keith County",5,0,80,40,40
050,31,101,"Nebraska","Keith County",5,1,83,43,40
050,31,101,"Nebraska","Keith County",5,2,87,44,43
050,31,101,"Nebraska","Keith County",5,3,88,51,37
050,31,101,"Nebraska","Keith County",5,4,87,45,42
050,31,101,"Nebraska","Keith County",5,5,84,45,39
050,31,101,"Nebraska","Keith County",5,6,104,56,48
050,31,101,"Nebraska","Keith County",5,7,101,53,48
050,31,101,"Nebraska","Keith County",5,8,95,49,46
050,31,101,"Nebraska","Keith County",5,9,100,45,55
050,31,101,"Nebraska","Keith County",5,10,83,46,37
050,31,101,"Nebraska","Keith County",5,11,92,54,38
050,31,101,"Nebraska","Keith County",5,12,95,48,47
050,31,101,"Nebraska","Keith County",5,13,97,45,52
050,31,101,"Nebraska","Keith County",5,14,85,42,43
050,31,101,"Nebraska","Keith County",5,15,97,49,48
050,31,101,"Nebraska","Keith County",5,16,108,55,53
050,31,101,"Nebraska","Keith County",5,17,118,64,54
050,31,101,"Nebraska","Keith County",5,18,92,54,38
050,31,101,"Nebraska","Keith County",5,19,72,40,32
050,31,101,"Nebraska","Keith County",5,20,70,40,30
050,31,101,"Nebraska","Keith County",5,21,74,40,34
050,31,101,"Nebraska","Keith County",5,22,69,39,30
050,31,101,"Nebraska","Keith County",5,23,78,46,32
050,31,101,"Nebraska","Keith County",5,24,64,41,23
050,31,101,"Nebraska","Keith County",5,25,76,35,41
050,31,101,"Nebraska","Keith County",5,26,63,35,28
050,31,101,"Nebraska","Keith County",5,27,70,40,30
050,31,101,"Nebraska","Keith County",5,28,64,35,29
050,31,101,"Nebraska","Keith County",5,29,83,42,41
050,31,101,"Nebraska","Keith County",5,30,87,39,48
050,31,101,"Nebraska","Keith County",5,31,78,35,43
050,31,101,"Nebraska","Keith County",5,32,80,42,38
050,31,101,"Nebraska","Keith County",5,33,78,35,43
050,31,101,"Nebraska","Keith County",5,34,60,26,34
050,31,101,"Nebraska","Keith County",5,35,66,39,27
050,31,101,"Nebraska","Keith County",5,36,76,37,39
050,31,101,"Nebraska","Keith County",5,37,100,44,56
050,31,101,"Nebraska","Keith County",5,38,94,51,43
050,31,101,"Nebraska","Keith County",5,39,107,58,49
050,31,101,"Nebraska","Keith County",5,40,94,46,48
050,31,101,"Nebraska","Keith County",5,41,95,45,50
050,31,101,"Nebraska","Keith County",5,42,78,42,36
050,31,101,"Nebraska","Keith County",5,43,74,33,41
050,31,101,"Nebraska","Keith County",5,44,75,43,32
050,31,101,"Nebraska","Keith County",5,45,86,47,39
050,31,101,"Nebraska","Keith County",5,46,84,48,36
050,31,101,"Nebraska","Keith County",5,47,66,34,32
050,31,101,"Nebraska","Keith County",5,48,89,44,45
050,31,101,"Nebraska","Keith County",5,49,78,38,40
050,31,101,"Nebraska","Keith County",5,50,79,42,37
050,31,101,"Nebraska","Keith County",5,51,74,32,42
050,31,101,"Nebraska","Keith County",5,52,93,40,53
050,31,101,"Nebraska","Keith County",5,53,89,37,52
050,31,101,"Nebraska","Keith County",5,54,91,44,47
050,31,101,"Nebraska","Keith County",5,55,100,55,45
050,31,101,"Nebraska","Keith County",5,56,100,55,45
050,31,101,"Nebraska","Keith County",5,57,108,61,47
050,31,101,"Nebraska","Keith County",5,58,107,57,50
050,31,101,"Nebraska","Keith County",5,59,117,64,53
050,31,101,"Nebraska","Keith County",5,60,134,60,74
050,31,101,"Nebraska","Keith County",5,61,148,77,71
050,31,101,"Nebraska","Keith County",5,62,149,82,67
050,31,101,"Nebraska","Keith County",5,63,138,74,64
050,31,101,"Nebraska","Keith County",5,64,140,69,71
050,31,101,"Nebraska","Keith County",5,65,150,78,72
050,31,101,"Nebraska","Keith County",5,66,134,66,68
050,31,101,"Nebraska","Keith County",5,67,120,56,64
050,31,101,"Nebraska","Keith County",5,68,121,56,65
050,31,101,"Nebraska","Keith County",5,69,129,66,63
050,31,101,"Nebraska","Keith County",5,70,123,63,60
050,31,101,"Nebraska","Keith County",5,71,126,65,61
050,31,101,"Nebraska","Keith County",5,72,114,47,67
050,31,101,"Nebraska","Keith County",5,73,105,48,57
050,31,101,"Nebraska","Keith County",5,74,122,55,67
050,31,101,"Nebraska","Keith County",5,75,116,56,60
050,31,101,"Nebraska","Keith County",5,76,117,56,61
050,31,101,"Nebraska","Keith County",5,77,75,39,36
050,31,101,"Nebraska","Keith County",5,78,67,29,38
050,31,101,"Nebraska","Keith County",5,79,74,39,35
050,31,101,"Nebraska","Keith County",5,80,78,35,43
050,31,101,"Nebraska","Keith County",5,81,65,29,36
050,31,101,"Nebraska","Keith County",5,82,63,22,41
050,31,101,"Nebraska","Keith County",5,83,52,24,28
050,31,101,"Nebraska","Keith County",5,84,36,17,19
050,31,101,"Nebraska","Keith County",5,85,255,115,140
050,31,103,"Nebraska","Keya Paha County",1,0,5,3,2
050,31,103,"Nebraska","Keya Paha County",1,1,5,4,1
050,31,103,"Nebraska","Keya Paha County",1,2,8,4,4
050,31,103,"Nebraska","Keya Paha County",1,3,5,2,3
050,31,103,"Nebraska","Keya Paha County",1,4,6,3,3
050,31,103,"Nebraska","Keya Paha County",1,5,7,3,4
050,31,103,"Nebraska","Keya Paha County",1,6,3,1,2
050,31,103,"Nebraska","Keya Paha County",1,7,7,3,4
050,31,103,"Nebraska","Keya Paha County",1,8,6,3,3
050,31,103,"Nebraska","Keya Paha County",1,9,7,3,4
050,31,103,"Nebraska","Keya Paha County",1,10,11,3,8
050,31,103,"Nebraska","Keya Paha County",1,11,8,4,4
050,31,103,"Nebraska","Keya Paha County",1,12,7,3,4
050,31,103,"Nebraska","Keya Paha County",1,13,8,3,5
050,31,103,"Nebraska","Keya Paha County",1,14,11,6,5
050,31,103,"Nebraska","Keya Paha County",1,15,16,12,4
050,31,103,"Nebraska","Keya Paha County",1,16,12,7,5
050,31,103,"Nebraska","Keya Paha County",1,17,10,5,5
050,31,103,"Nebraska","Keya Paha County",1,18,7,2,5
050,31,103,"Nebraska","Keya Paha County",1,19,5,3,2
050,31,103,"Nebraska","Keya Paha County",1,20,4,2,2
050,31,103,"Nebraska","Keya Paha County",1,21,4,2,2
050,31,103,"Nebraska","Keya Paha County",1,22,10,4,6
050,31,103,"Nebraska","Keya Paha County",1,23,8,5,3
050,31,103,"Nebraska","Keya Paha County",1,24,9,7,2
050,31,103,"Nebraska","Keya Paha County",1,25,8,4,4
050,31,103,"Nebraska","Keya Paha County",1,26,6,5,1
050,31,103,"Nebraska","Keya Paha County",1,27,9,4,5
050,31,103,"Nebraska","Keya Paha County",1,28,6,5,1
050,31,103,"Nebraska","Keya Paha County",1,29,7,5,2
050,31,103,"Nebraska","Keya Paha County",1,30,14,7,7
050,31,103,"Nebraska","Keya Paha County",1,31,5,3,2
050,31,103,"Nebraska","Keya Paha County",1,32,2,1,1
050,31,103,"Nebraska","Keya Paha County",1,33,4,3,1
050,31,103,"Nebraska","Keya Paha County",1,34,3,1,2
050,31,103,"Nebraska","Keya Paha County",1,35,3,1,2
050,31,103,"Nebraska","Keya Paha County",1,36,6,2,4
050,31,103,"Nebraska","Keya Paha County",1,37,8,5,3
050,31,103,"Nebraska","Keya Paha County",1,38,9,5,4
050,31,103,"Nebraska","Keya Paha County",1,39,6,3,3
050,31,103,"Nebraska","Keya Paha County",1,40,8,4,4
050,31,103,"Nebraska","Keya Paha County",1,41,9,4,5
050,31,103,"Nebraska","Keya Paha County",1,42,6,3,3
050,31,103,"Nebraska","Keya Paha County",1,43,6,3,3
050,31,103,"Nebraska","Keya Paha County",1,44,7,4,3
050,31,103,"Nebraska","Keya Paha County",1,45,9,5,4
050,31,103,"Nebraska","Keya Paha County",1,46,9,4,5
050,31,103,"Nebraska","Keya Paha County",1,47,8,3,5
050,31,103,"Nebraska","Keya Paha County",1,48,5,3,2
050,31,103,"Nebraska","Keya Paha County",1,49,5,2,3
050,31,103,"Nebraska","Keya Paha County",1,50,4,3,1
050,31,103,"Nebraska","Keya Paha County",1,51,6,3,3
050,31,103,"Nebraska","Keya Paha County",1,52,9,5,4
050,31,103,"Nebraska","Keya Paha County",1,53,12,6,6
050,31,103,"Nebraska","Keya Paha County",1,54,6,4,2
050,31,103,"Nebraska","Keya Paha County",1,55,5,2,3
050,31,103,"Nebraska","Keya Paha County",1,56,11,6,5
050,31,103,"Nebraska","Keya Paha County",1,57,11,5,6
050,31,103,"Nebraska","Keya Paha County",1,58,15,6,9
050,31,103,"Nebraska","Keya Paha County",1,59,19,11,8
050,31,103,"Nebraska","Keya Paha County",1,60,17,9,8
050,31,103,"Nebraska","Keya Paha County",1,61,16,8,8
050,31,103,"Nebraska","Keya Paha County",1,62,18,9,9
050,31,103,"Nebraska","Keya Paha County",1,63,14,9,5
050,31,103,"Nebraska","Keya Paha County",1,64,12,7,5
050,31,103,"Nebraska","Keya Paha County",1,65,15,6,9
050,31,103,"Nebraska","Keya Paha County",1,66,12,8,4
050,31,103,"Nebraska","Keya Paha County",1,67,12,8,4
050,31,103,"Nebraska","Keya Paha County",1,68,6,3,3
050,31,103,"Nebraska","Keya Paha County",1,69,9,5,4
050,31,103,"Nebraska","Keya Paha County",1,70,9,5,4
050,31,103,"Nebraska","Keya Paha County",1,71,15,9,6
050,31,103,"Nebraska","Keya Paha County",1,72,15,7,8
050,31,103,"Nebraska","Keya Paha County",1,73,13,5,8
050,31,103,"Nebraska","Keya Paha County",1,74,13,5,8
050,31,103,"Nebraska","Keya Paha County",1,75,10,5,5
050,31,103,"Nebraska","Keya Paha County",1,76,6,4,2
050,31,103,"Nebraska","Keya Paha County",1,77,9,5,4
050,31,103,"Nebraska","Keya Paha County",1,78,7,4,3
050,31,103,"Nebraska","Keya Paha County",1,79,6,3,3
050,31,103,"Nebraska","Keya Paha County",1,80,7,3,4
050,31,103,"Nebraska","Keya Paha County",1,81,10,4,6
050,31,103,"Nebraska","Keya Paha County",1,82,11,4,7
050,31,103,"Nebraska","Keya Paha County",1,83,9,5,4
050,31,103,"Nebraska","Keya Paha County",1,84,9,5,4
050,31,103,"Nebraska","Keya Paha County",1,85,34,14,20
050,31,103,"Nebraska","Keya Paha County",2,0,4,3,1
050,31,103,"Nebraska","Keya Paha County",2,1,5,4,1
050,31,103,"Nebraska","Keya Paha County",2,2,7,4,3
050,31,103,"Nebraska","Keya Paha County",2,3,5,2,3
050,31,103,"Nebraska","Keya Paha County",2,4,6,3,3
050,31,103,"Nebraska","Keya Paha County",2,5,7,3,4
050,31,103,"Nebraska","Keya Paha County",2,6,3,1,2
050,31,103,"Nebraska","Keya Paha County",2,7,6,3,3
050,31,103,"Nebraska","Keya Paha County",2,8,6,3,3
050,31,103,"Nebraska","Keya Paha County",2,9,7,3,4
050,31,103,"Nebraska","Keya Paha County",2,10,10,3,7
050,31,103,"Nebraska","Keya Paha County",2,11,9,4,5
050,31,103,"Nebraska","Keya Paha County",2,12,7,3,4
050,31,103,"Nebraska","Keya Paha County",2,13,8,3,5
050,31,103,"Nebraska","Keya Paha County",2,14,10,5,5
050,31,103,"Nebraska","Keya Paha County",2,15,15,11,4
050,31,103,"Nebraska","Keya Paha County",2,16,13,8,5
050,31,103,"Nebraska","Keya Paha County",2,17,10,5,5
050,31,103,"Nebraska","Keya Paha County",2,18,7,2,5
050,31,103,"Nebraska","Keya Paha County",2,19,5,2,3
050,31,103,"Nebraska","Keya Paha County",2,20,4,2,2
050,31,103,"Nebraska","Keya Paha County",2,21,4,2,2
050,31,103,"Nebraska","Keya Paha County",2,22,8,4,4
050,31,103,"Nebraska","Keya Paha County",2,23,9,5,4
050,31,103,"Nebraska","Keya Paha County",2,24,9,7,2
050,31,103,"Nebraska","Keya Paha County",2,25,7,4,3
050,31,103,"Nebraska","Keya Paha County",2,26,6,4,2
050,31,103,"Nebraska","Keya Paha County",2,27,8,4,4
050,31,103,"Nebraska","Keya Paha County",2,28,7,5,2
050,31,103,"Nebraska","Keya Paha County",2,29,7,5,2
050,31,103,"Nebraska","Keya Paha County",2,30,12,7,5
050,31,103,"Nebraska","Keya Paha County",2,31,7,4,3
050,31,103,"Nebraska","Keya Paha County",2,32,3,2,1
050,31,103,"Nebraska","Keya Paha County",2,33,3,2,1
050,31,103,"Nebraska","Keya Paha County",2,34,3,1,2
050,31,103,"Nebraska","Keya Paha County",2,35,3,1,2
050,31,103,"Nebraska","Keya Paha County",2,36,6,2,4
050,31,103,"Nebraska","Keya Paha County",2,37,7,4,3
050,31,103,"Nebraska","Keya Paha County",2,38,9,5,4
050,31,103,"Nebraska","Keya Paha County",2,39,6,3,3
050,31,103,"Nebraska","Keya Paha County",2,40,8,4,4
050,31,103,"Nebraska","Keya Paha County",2,41,9,4,5
050,31,103,"Nebraska","Keya Paha County",2,42,7,3,4
050,31,103,"Nebraska","Keya Paha County",2,43,6,3,3
050,31,103,"Nebraska","Keya Paha County",2,44,7,4,3
050,31,103,"Nebraska","Keya Paha County",2,45,9,5,4
050,31,103,"Nebraska","Keya Paha County",2,46,9,4,5
050,31,103,"Nebraska","Keya Paha County",2,47,8,3,5
050,31,103,"Nebraska","Keya Paha County",2,48,6,3,3
050,31,103,"Nebraska","Keya Paha County",2,49,5,2,3
050,31,103,"Nebraska","Keya Paha County",2,50,4,3,1
050,31,103,"Nebraska","Keya Paha County",2,51,5,3,2
050,31,103,"Nebraska","Keya Paha County",2,52,8,4,4
050,31,103,"Nebraska","Keya Paha County",2,53,12,6,6
050,31,103,"Nebraska","Keya Paha County",2,54,7,4,3
050,31,103,"Nebraska","Keya Paha County",2,55,5,2,3
050,31,103,"Nebraska","Keya Paha County",2,56,10,5,5
050,31,103,"Nebraska","Keya Paha County",2,57,11,5,6
050,31,103,"Nebraska","Keya Paha County",2,58,14,6,8
050,31,103,"Nebraska","Keya Paha County",2,59,18,10,8
050,31,103,"Nebraska","Keya Paha County",2,60,17,9,8
050,31,103,"Nebraska","Keya Paha County",2,61,16,8,8
050,31,103,"Nebraska","Keya Paha County",2,62,17,8,9
050,31,103,"Nebraska","Keya Paha County",2,63,15,9,6
050,31,103,"Nebraska","Keya Paha County",2,64,12,7,5
050,31,103,"Nebraska","Keya Paha County",2,65,14,6,8
050,31,103,"Nebraska","Keya Paha County",2,66,13,8,5
050,31,103,"Nebraska","Keya Paha County",2,67,12,8,4
050,31,103,"Nebraska","Keya Paha County",2,68,7,4,3
050,31,103,"Nebraska","Keya Paha County",2,69,9,5,4
050,31,103,"Nebraska","Keya Paha County",2,70,9,5,4
050,31,103,"Nebraska","Keya Paha County",2,71,13,8,5
050,31,103,"Nebraska","Keya Paha County",2,72,14,7,7
050,31,103,"Nebraska","Keya Paha County",2,73,14,6,8
050,31,103,"Nebraska","Keya Paha County",2,74,12,5,7
050,31,103,"Nebraska","Keya Paha County",2,75,11,5,6
050,31,103,"Nebraska","Keya Paha County",2,76,7,4,3
050,31,103,"Nebraska","Keya Paha County",2,77,9,5,4
050,31,103,"Nebraska","Keya Paha County",2,78,7,4,3
050,31,103,"Nebraska","Keya Paha County",2,79,6,3,3
050,31,103,"Nebraska","Keya Paha County",2,80,7,3,4
050,31,103,"Nebraska","Keya Paha County",2,81,9,4,5
050,31,103,"Nebraska","Keya Paha County",2,82,11,4,7
050,31,103,"Nebraska","Keya Paha County",2,83,10,5,5
050,31,103,"Nebraska","Keya Paha County",2,84,9,5,4
050,31,103,"Nebraska","Keya Paha County",2,85,34,14,20
050,31,103,"Nebraska","Keya Paha County",3,0,10,6,4
050,31,103,"Nebraska","Keya Paha County",3,1,4,3,1
050,31,103,"Nebraska","Keya Paha County",3,2,4,3,1
050,31,103,"Nebraska","Keya Paha County",3,3,9,6,3
050,31,103,"Nebraska","Keya Paha County",3,4,9,4,5
050,31,103,"Nebraska","Keya Paha County",3,5,7,3,4
050,31,103,"Nebraska","Keya Paha County",3,6,11,3,8
050,31,103,"Nebraska","Keya Paha County",3,7,5,3,2
050,31,103,"Nebraska","Keya Paha County",3,8,7,4,3
050,31,103,"Nebraska","Keya Paha County",3,9,6,3,3
050,31,103,"Nebraska","Keya Paha County",3,10,7,3,4
050,31,103,"Nebraska","Keya Paha County",3,11,9,3,6
050,31,103,"Nebraska","Keya Paha County",3,12,9,4,5
050,31,103,"Nebraska","Keya Paha County",3,13,9,3,6
050,31,103,"Nebraska","Keya Paha County",3,14,7,3,4
050,31,103,"Nebraska","Keya Paha County",3,15,12,5,7
050,31,103,"Nebraska","Keya Paha County",3,16,13,11,2
050,31,103,"Nebraska","Keya Paha County",3,17,15,10,5
050,31,103,"Nebraska","Keya Paha County",3,18,8,4,4
050,31,103,"Nebraska","Keya Paha County",3,19,6,3,3
050,31,103,"Nebraska","Keya Paha County",3,20,5,2,3
050,31,103,"Nebraska","Keya Paha County",3,21,6,3,3
050,31,103,"Nebraska","Keya Paha County",3,22,5,2,3
050,31,103,"Nebraska","Keya Paha County",3,23,8,5,3
050,31,103,"Nebraska","Keya Paha County",3,24,10,4,6
050,31,103,"Nebraska","Keya Paha County",3,25,11,9,2
050,31,103,"Nebraska","Keya Paha County",3,26,7,3,4
050,31,103,"Nebraska","Keya Paha County",3,27,6,4,2
050,31,103,"Nebraska","Keya Paha County",3,28,8,4,4
050,31,103,"Nebraska","Keya Paha County",3,29,8,6,2
050,31,103,"Nebraska","Keya Paha County",3,30,5,3,2
050,31,103,"Nebraska","Keya Paha County",3,31,11,7,4
050,31,103,"Nebraska","Keya Paha County",3,32,6,3,3
050,31,103,"Nebraska","Keya Paha County",3,33,5,3,2
050,31,103,"Nebraska","Keya Paha County",3,34,6,3,3
050,31,103,"Nebraska","Keya Paha County",3,35,4,2,2
050,31,103,"Nebraska","Keya Paha County",3,36,3,1,2
050,31,103,"Nebraska","Keya Paha County",3,37,8,3,5
050,31,103,"Nebraska","Keya Paha County",3,38,7,4,3
050,31,103,"Nebraska","Keya Paha County",3,39,9,5,4
050,31,103,"Nebraska","Keya Paha County",3,40,6,3,3
050,31,103,"Nebraska","Keya Paha County",3,41,8,4,4
050,31,103,"Nebraska","Keya Paha County",3,42,9,4,5
050,31,103,"Nebraska","Keya Paha County",3,43,7,2,5
050,31,103,"Nebraska","Keya Paha County",3,44,7,4,3
050,31,103,"Nebraska","Keya Paha County",3,45,6,4,2
050,31,103,"Nebraska","Keya Paha County",3,46,9,5,4
050,31,103,"Nebraska","Keya Paha County",3,47,9,4,5
050,31,103,"Nebraska","Keya Paha County",3,48,8,3,5
050,31,103,"Nebraska","Keya Paha County",3,49,6,3,3
050,31,103,"Nebraska","Keya Paha County",3,50,4,2,2
050,31,103,"Nebraska","Keya Paha County",3,51,6,5,1
050,31,103,"Nebraska","Keya Paha County",3,52,5,3,2
050,31,103,"Nebraska","Keya Paha County",3,53,8,4,4
050,31,103,"Nebraska","Keya Paha County",3,54,12,6,6
050,31,103,"Nebraska","Keya Paha County",3,55,7,4,3
050,31,103,"Nebraska","Keya Paha County",3,56,5,2,3
050,31,103,"Nebraska","Keya Paha County",3,57,10,5,5
050,31,103,"Nebraska","Keya Paha County",3,58,12,5,7
050,31,103,"Nebraska","Keya Paha County",3,59,14,6,8
050,31,103,"Nebraska","Keya Paha County",3,60,18,10,8
050,31,103,"Nebraska","Keya Paha County",3,61,17,9,8
050,31,103,"Nebraska","Keya Paha County",3,62,16,8,8
050,31,103,"Nebraska","Keya Paha County",3,63,20,10,10
050,31,103,"Nebraska","Keya Paha County",3,64,17,11,6
050,31,103,"Nebraska","Keya Paha County",3,65,8,7,1
050,31,103,"Nebraska","Keya Paha County",3,66,14,6,8
050,31,103,"Nebraska","Keya Paha County",3,67,16,8,8
050,31,103,"Nebraska","Keya Paha County",3,68,13,9,4
050,31,103,"Nebraska","Keya Paha County",3,69,7,5,2
050,31,103,"Nebraska","Keya Paha County",3,70,9,5,4
050,31,103,"Nebraska","Keya Paha County",3,71,10,6,4
050,31,103,"Nebraska","Keya Paha County",3,72,14,9,5
050,31,103,"Nebraska","Keya Paha County",3,73,14,7,7
050,31,103,"Nebraska","Keya Paha County",3,74,14,6,8
050,31,103,"Nebraska","Keya Paha County",3,75,12,5,7
050,31,103,"Nebraska","Keya Paha County",3,76,11,5,6
050,31,103,"Nebraska","Keya Paha County",3,77,7,4,3
050,31,103,"Nebraska","Keya Paha County",3,78,8,5,3
050,31,103,"Nebraska","Keya Paha County",3,79,7,4,3
050,31,103,"Nebraska","Keya Paha County",3,80,5,3,2
050,31,103,"Nebraska","Keya Paha County",3,81,7,3,4
050,31,103,"Nebraska","Keya Paha County",3,82,9,4,5
050,31,103,"Nebraska","Keya Paha County",3,83,11,4,7
050,31,103,"Nebraska","Keya Paha County",3,84,9,5,4
050,31,103,"Nebraska","Keya Paha County",3,85,40,18,22
050,31,103,"Nebraska","Keya Paha County",4,0,7,3,4
050,31,103,"Nebraska","Keya Paha County",4,1,10,6,4
050,31,103,"Nebraska","Keya Paha County",4,2,4,3,1
050,31,103,"Nebraska","Keya Paha County",4,3,6,4,2
050,31,103,"Nebraska","Keya Paha County",4,4,9,6,3
050,31,103,"Nebraska","Keya Paha County",4,5,9,4,5
050,31,103,"Nebraska","Keya Paha County",4,6,6,3,3
050,31,103,"Nebraska","Keya Paha County",4,7,11,4,7
050,31,103,"Nebraska","Keya Paha County",4,8,9,6,3
050,31,103,"Nebraska","Keya Paha County",4,9,8,4,4
050,31,103,"Nebraska","Keya Paha County",4,10,8,4,4
050,31,103,"Nebraska","Keya Paha County",4,11,7,3,4
050,31,103,"Nebraska","Keya Paha County",4,12,9,3,6
050,31,103,"Nebraska","Keya Paha County",4,13,10,5,5
050,31,103,"Nebraska","Keya Paha County",4,14,9,3,6
050,31,103,"Nebraska","Keya Paha County",4,15,8,4,4
050,31,103,"Nebraska","Keya Paha County",4,16,11,5,6
050,31,103,"Nebraska","Keya Paha County",4,17,14,11,3
050,31,103,"Nebraska","Keya Paha County",4,18,12,8,4
050,31,103,"Nebraska","Keya Paha County",4,19,6,2,4
050,31,103,"Nebraska","Keya Paha County",4,20,6,3,3
050,31,103,"Nebraska","Keya Paha County",4,21,4,2,2
050,31,103,"Nebraska","Keya Paha County",4,22,6,3,3
050,31,103,"Nebraska","Keya Paha County",4,23,6,2,4
050,31,103,"Nebraska","Keya Paha County",4,24,6,4,2
050,31,103,"Nebraska","Keya Paha County",4,25,9,3,6
050,31,103,"Nebraska","Keya Paha County",4,26,11,9,2
050,31,103,"Nebraska","Keya Paha County",4,27,9,4,5
050,31,103,"Nebraska","Keya Paha County",4,28,6,4,2
050,31,103,"Nebraska","Keya Paha County",4,29,7,4,3
050,31,103,"Nebraska","Keya Paha County",4,30,9,6,3
050,31,103,"Nebraska","Keya Paha County",4,31,4,1,3
050,31,103,"Nebraska","Keya Paha County",4,32,11,7,4
050,31,103,"Nebraska","Keya Paha County",4,33,8,4,4
050,31,103,"Nebraska","Keya Paha County",4,34,5,3,2
050,31,103,"Nebraska","Keya Paha County",4,35,6,3,3
050,31,103,"Nebraska","Keya Paha County",4,36,6,3,3
050,31,103,"Nebraska","Keya Paha County",4,37,3,1,2
050,31,103,"Nebraska","Keya Paha County",4,38,8,3,5
050,31,103,"Nebraska","Keya Paha County",4,39,7,4,3
050,31,103,"Nebraska","Keya Paha County",4,40,9,5,4
050,31,103,"Nebraska","Keya Paha County",4,41,6,2,4
050,31,103,"Nebraska","Keya Paha County",4,42,11,7,4
050,31,103,"Nebraska","Keya Paha County",4,43,9,4,5
050,31,103,"Nebraska","Keya Paha County",4,44,7,2,5
050,31,103,"Nebraska","Keya Paha County",4,45,8,4,4
050,31,103,"Nebraska","Keya Paha County",4,46,6,4,2
050,31,103,"Nebraska","Keya Paha County",4,47,9,5,4
050,31,103,"Nebraska","Keya Paha County",4,48,9,4,5
050,31,103,"Nebraska","Keya Paha County",4,49,8,3,5
050,31,103,"Nebraska","Keya Paha County",4,50,5,3,2
050,31,103,"Nebraska","Keya Paha County",4,51,4,2,2
050,31,103,"Nebraska","Keya Paha County",4,52,6,5,1
050,31,103,"Nebraska","Keya Paha County",4,53,6,3,3
050,31,103,"Nebraska","Keya Paha County",4,54,8,4,4
050,31,103,"Nebraska","Keya Paha County",4,55,12,6,6
050,31,103,"Nebraska","Keya Paha County",4,56,7,4,3
050,31,103,"Nebraska","Keya Paha County",4,57,5,2,3
050,31,103,"Nebraska","Keya Paha County",4,58,10,5,5
050,31,103,"Nebraska","Keya Paha County",4,59,12,5,7
050,31,103,"Nebraska","Keya Paha County",4,60,13,6,7
050,31,103,"Nebraska","Keya Paha County",4,61,19,11,8
050,31,103,"Nebraska","Keya Paha County",4,62,16,9,7
050,31,103,"Nebraska","Keya Paha County",4,63,16,8,8
050,31,103,"Nebraska","Keya Paha County",4,64,20,10,10
050,31,103,"Nebraska","Keya Paha County",4,65,16,10,6
050,31,103,"Nebraska","Keya Paha County",4,66,8,7,1
050,31,103,"Nebraska","Keya Paha County",4,67,13,5,8
050,31,103,"Nebraska","Keya Paha County",4,68,15,8,7
050,31,103,"Nebraska","Keya Paha County",4,69,13,9,4
050,31,103,"Nebraska","Keya Paha County",4,70,6,5,1
050,31,103,"Nebraska","Keya Paha County",4,71,10,6,4
050,31,103,"Nebraska","Keya Paha County",4,72,9,6,3
050,31,103,"Nebraska","Keya Paha County",4,73,14,9,5
050,31,103,"Nebraska","Keya Paha County",4,74,14,7,7
050,31,103,"Nebraska","Keya Paha County",4,75,13,5,8
050,31,103,"Nebraska","Keya Paha County",4,76,12,5,7
050,31,103,"Nebraska","Keya Paha County",4,77,11,5,6
050,31,103,"Nebraska","Keya Paha County",4,78,7,4,3
050,31,103,"Nebraska","Keya Paha County",4,79,8,5,3
050,31,103,"Nebraska","Keya Paha County",4,80,7,4,3
050,31,103,"Nebraska","Keya Paha County",4,81,4,2,2
050,31,103,"Nebraska","Keya Paha County",4,82,7,3,4
050,31,103,"Nebraska","Keya Paha County",4,83,9,4,5
050,31,103,"Nebraska","Keya Paha County",4,84,11,4,7
050,31,103,"Nebraska","Keya Paha County",4,85,47,22,25
050,31,103,"Nebraska","Keya Paha County",5,0,5,1,4
050,31,103,"Nebraska","Keya Paha County",5,1,9,5,4
050,31,103,"Nebraska","Keya Paha County",5,2,10,6,4
050,31,103,"Nebraska","Keya Paha County",5,3,5,4,1
050,31,103,"Nebraska","Keya Paha County",5,4,8,6,2
050,31,103,"Nebraska","Keya Paha County",5,5,9,6,3
050,31,103,"Nebraska","Keya Paha County",5,6,10,5,5
050,31,103,"Nebraska","Keya Paha County",5,7,3,0,3
050,31,103,"Nebraska","Keya Paha County",5,8,10,3,7
050,31,103,"Nebraska","Keya Paha County",5,9,9,6,3
050,31,103,"Nebraska","Keya Paha County",5,10,8,4,4
050,31,103,"Nebraska","Keya Paha County",5,11,8,4,4
050,31,103,"Nebraska","Keya Paha County",5,12,8,4,4
050,31,103,"Nebraska","Keya Paha County",5,13,9,3,6
050,31,103,"Nebraska","Keya Paha County",5,14,10,5,5
050,31,103,"Nebraska","Keya Paha County",5,15,9,3,6
050,31,103,"Nebraska","Keya Paha County",5,16,8,4,4
050,31,103,"Nebraska","Keya Paha County",5,17,11,5,6
050,31,103,"Nebraska","Keya Paha County",5,18,10,9,1
050,31,103,"Nebraska","Keya Paha County",5,19,9,6,3
050,31,103,"Nebraska","Keya Paha County",5,20,10,5,5
050,31,103,"Nebraska","Keya Paha County",5,21,6,3,3
050,31,103,"Nebraska","Keya Paha County",5,22,4,2,2
050,31,103,"Nebraska","Keya Paha County",5,23,6,3,3
050,31,103,"Nebraska","Keya Paha County",5,24,5,2,3
050,31,103,"Nebraska","Keya Paha County",5,25,8,5,3
050,31,103,"Nebraska","Keya Paha County",5,26,9,2,7
050,31,103,"Nebraska","Keya Paha County",5,27,12,10,2
050,31,103,"Nebraska","Keya Paha County",5,28,9,4,5
050,31,103,"Nebraska","Keya Paha County",5,29,6,4,2
050,31,103,"Nebraska","Keya Paha County",5,30,8,5,3
050,31,103,"Nebraska","Keya Paha County",5,31,10,6,4
050,31,103,"Nebraska","Keya Paha County",5,32,7,4,3
050,31,103,"Nebraska","Keya Paha County",5,33,10,7,3
050,31,103,"Nebraska","Keya Paha County",5,34,9,4,5
050,31,103,"Nebraska","Keya Paha County",5,35,5,3,2
050,31,103,"Nebraska","Keya Paha County",5,36,7,3,4
050,31,103,"Nebraska","Keya Paha County",5,37,6,3,3
050,31,103,"Nebraska","Keya Paha County",5,38,3,1,2
050,31,103,"Nebraska","Keya Paha County",5,39,7,3,4
050,31,103,"Nebraska","Keya Paha County",5,40,6,3,3
050,31,103,"Nebraska","Keya Paha County",5,41,10,6,4
050,31,103,"Nebraska","Keya Paha County",5,42,6,1,5
050,31,103,"Nebraska","Keya Paha County",5,43,11,7,4
050,31,103,"Nebraska","Keya Paha County",5,44,9,4,5
050,31,103,"Nebraska","Keya Paha County",5,45,7,2,5
050,31,103,"Nebraska","Keya Paha County",5,46,8,4,4
050,31,103,"Nebraska","Keya Paha County",5,47,6,4,2
050,31,103,"Nebraska","Keya Paha County",5,48,9,5,4
050,31,103,"Nebraska","Keya Paha County",5,49,7,4,3
050,31,103,"Nebraska","Keya Paha County",5,50,7,3,4
050,31,103,"Nebraska","Keya Paha County",5,51,5,3,2
050,31,103,"Nebraska","Keya Paha County",5,52,6,4,2
050,31,103,"Nebraska","Keya Paha County",5,53,6,5,1
050,31,103,"Nebraska","Keya Paha County",5,54,6,3,3
050,31,103,"Nebraska","Keya Paha County",5,55,8,4,4
050,31,103,"Nebraska","Keya Paha County",5,56,12,6,6
050,31,103,"Nebraska","Keya Paha County",5,57,7,4,3
050,31,103,"Nebraska","Keya Paha County",5,58,5,2,3
050,31,103,"Nebraska","Keya Paha County",5,59,10,5,5
050,31,103,"Nebraska","Keya Paha County",5,60,12,5,7
050,31,103,"Nebraska","Keya Paha County",5,61,13,6,7
050,31,103,"Nebraska","Keya Paha County",5,62,19,11,8
050,31,103,"Nebraska","Keya Paha County",5,63,16,9,7
050,31,103,"Nebraska","Keya Paha County",5,64,16,8,8
050,31,103,"Nebraska","Keya Paha County",5,65,19,9,10
050,31,103,"Nebraska","Keya Paha County",5,66,16,10,6
050,31,103,"Nebraska","Keya Paha County",5,67,8,7,1
050,31,103,"Nebraska","Keya Paha County",5,68,13,5,8
050,31,103,"Nebraska","Keya Paha County",5,69,15,8,7
050,31,103,"Nebraska","Keya Paha County",5,70,13,9,4
050,31,103,"Nebraska","Keya Paha County",5,71,6,5,1
050,31,103,"Nebraska","Keya Paha County",5,72,9,6,3
050,31,103,"Nebraska","Keya Paha County",5,73,9,6,3
050,31,103,"Nebraska","Keya Paha County",5,74,14,9,5
050,31,103,"Nebraska","Keya Paha County",5,75,10,5,5
050,31,103,"Nebraska","Keya Paha County",5,76,13,5,8
050,31,103,"Nebraska","Keya Paha County",5,77,12,5,7
050,31,103,"Nebraska","Keya Paha County",5,78,10,4,6
050,31,103,"Nebraska","Keya Paha County",5,79,7,4,3
050,31,103,"Nebraska","Keya Paha County",5,80,8,5,3
050,31,103,"Nebraska","Keya Paha County",5,81,6,4,2
050,31,103,"Nebraska","Keya Paha County",5,82,4,2,2
050,31,103,"Nebraska","Keya Paha County",5,83,7,3,4
050,31,103,"Nebraska","Keya Paha County",5,84,8,4,4
050,31,103,"Nebraska","Keya Paha County",5,85,56,25,31
050,31,105,"Nebraska","Kimball County",1,0,33,18,15
050,31,105,"Nebraska","Kimball County",1,1,29,14,15
050,31,105,"Nebraska","Kimball County",1,2,44,19,25
050,31,105,"Nebraska","Kimball County",1,3,46,24,22
050,31,105,"Nebraska","Kimball County",1,4,38,18,20
050,31,105,"Nebraska","Kimball County",1,5,44,28,16
050,31,105,"Nebraska","Kimball County",1,6,35,15,20
050,31,105,"Nebraska","Kimball County",1,7,30,17,13
050,31,105,"Nebraska","Kimball County",1,8,35,23,12
050,31,105,"Nebraska","Kimball County",1,9,39,23,16
050,31,105,"Nebraska","Kimball County",1,10,47,26,21
050,31,105,"Nebraska","Kimball County",1,11,44,24,20
050,31,105,"Nebraska","Kimball County",1,12,41,21,20
050,31,105,"Nebraska","Kimball County",1,13,40,22,18
050,31,105,"Nebraska","Kimball County",1,14,38,17,21
050,31,105,"Nebraska","Kimball County",1,15,45,22,23
050,31,105,"Nebraska","Kimball County",1,16,37,18,19
050,31,105,"Nebraska","Kimball County",1,17,38,20,18
050,31,105,"Nebraska","Kimball County",1,18,39,23,16
050,31,105,"Nebraska","Kimball County",1,19,32,20,12
050,31,105,"Nebraska","Kimball County",1,20,36,17,19
050,31,105,"Nebraska","Kimball County",1,21,30,15,15
050,31,105,"Nebraska","Kimball County",1,22,33,17,16
050,31,105,"Nebraska","Kimball County",1,23,32,19,13
050,31,105,"Nebraska","Kimball County",1,24,35,18,17
050,31,105,"Nebraska","Kimball County",1,25,28,12,16
050,31,105,"Nebraska","Kimball County",1,26,32,14,18
050,31,105,"Nebraska","Kimball County",1,27,45,19,26
050,31,105,"Nebraska","Kimball County",1,28,32,15,17
050,31,105,"Nebraska","Kimball County",1,29,26,10,16
050,31,105,"Nebraska","Kimball County",1,30,31,18,13
050,31,105,"Nebraska","Kimball County",1,31,37,21,16
050,31,105,"Nebraska","Kimball County",1,32,36,20,16
050,31,105,"Nebraska","Kimball County",1,33,40,22,18
050,31,105,"Nebraska","Kimball County",1,34,37,20,17
050,31,105,"Nebraska","Kimball County",1,35,44,22,22
050,31,105,"Nebraska","Kimball County",1,36,32,13,19
050,31,105,"Nebraska","Kimball County",1,37,34,17,17
050,31,105,"Nebraska","Kimball County",1,38,28,15,13
050,31,105,"Nebraska","Kimball County",1,39,36,20,16
050,31,105,"Nebraska","Kimball County",1,40,37,22,15
050,31,105,"Nebraska","Kimball County",1,41,28,14,14
050,31,105,"Nebraska","Kimball County",1,42,39,20,19
050,31,105,"Nebraska","Kimball County",1,43,32,19,13
050,31,105,"Nebraska","Kimball County",1,44,25,12,13
050,31,105,"Nebraska","Kimball County",1,45,33,16,17
050,31,105,"Nebraska","Kimball County",1,46,32,16,16
050,31,105,"Nebraska","Kimball County",1,47,31,13,18
050,31,105,"Nebraska","Kimball County",1,48,35,14,21
050,31,105,"Nebraska","Kimball County",1,49,35,17,18
050,31,105,"Nebraska","Kimball County",1,50,49,21,28
050,31,105,"Nebraska","Kimball County",1,51,41,22,19
050,31,105,"Nebraska","Kimball County",1,52,43,23,20
050,31,105,"Nebraska","Kimball County",1,53,44,24,20
050,31,105,"Nebraska","Kimball County",1,54,50,29,21
050,31,105,"Nebraska","Kimball County",1,55,43,17,26
050,31,105,"Nebraska","Kimball County",1,56,39,18,21
050,31,105,"Nebraska","Kimball County",1,57,46,21,25
050,31,105,"Nebraska","Kimball County",1,58,55,22,33
050,31,105,"Nebraska","Kimball County",1,59,54,23,31
050,31,105,"Nebraska","Kimball County",1,60,68,38,30
050,31,105,"Nebraska","Kimball County",1,61,67,37,30
050,31,105,"Nebraska","Kimball County",1,62,54,29,25
050,31,105,"Nebraska","Kimball County",1,63,55,31,24
050,31,105,"Nebraska","Kimball County",1,64,57,28,29
050,31,105,"Nebraska","Kimball County",1,65,64,37,27
050,31,105,"Nebraska","Kimball County",1,66,47,20,27
050,31,105,"Nebraska","Kimball County",1,67,44,24,20
050,31,105,"Nebraska","Kimball County",1,68,53,26,27
050,31,105,"Nebraska","Kimball County",1,69,45,20,25
050,31,105,"Nebraska","Kimball County",1,70,44,18,26
050,31,105,"Nebraska","Kimball County",1,71,48,24,24
050,31,105,"Nebraska","Kimball County",1,72,33,20,13
050,31,105,"Nebraska","Kimball County",1,73,43,19,24
050,31,105,"Nebraska","Kimball County",1,74,37,12,25
050,31,105,"Nebraska","Kimball County",1,75,34,15,19
050,31,105,"Nebraska","Kimball County",1,76,35,13,22
050,31,105,"Nebraska","Kimball County",1,77,39,17,22
050,31,105,"Nebraska","Kimball County",1,78,27,10,17
050,31,105,"Nebraska","Kimball County",1,79,35,16,19
050,31,105,"Nebraska","Kimball County",1,80,28,16,12
050,31,105,"Nebraska","Kimball County",1,81,27,14,13
050,31,105,"Nebraska","Kimball County",1,82,31,10,21
050,31,105,"Nebraska","Kimball County",1,83,19,10,9
050,31,105,"Nebraska","Kimball County",1,84,15,11,4
050,31,105,"Nebraska","Kimball County",1,85,141,53,88
050,31,105,"Nebraska","Kimball County",2,0,34,17,17
050,31,105,"Nebraska","Kimball County",2,1,30,15,15
050,31,105,"Nebraska","Kimball County",2,2,40,18,22
050,31,105,"Nebraska","Kimball County",2,3,45,22,23
050,31,105,"Nebraska","Kimball County",2,4,40,20,20
050,31,105,"Nebraska","Kimball County",2,5,42,25,17
050,31,105,"Nebraska","Kimball County",2,6,36,18,18
050,31,105,"Nebraska","Kimball County",2,7,29,16,13
050,31,105,"Nebraska","Kimball County",2,8,33,21,12
050,31,105,"Nebraska","Kimball County",2,9,38,23,15
050,31,105,"Nebraska","Kimball County",2,10,44,24,20
050,31,105,"Nebraska","Kimball County",2,11,43,23,20
050,31,105,"Nebraska","Kimball County",2,12,42,22,20
050,31,105,"Nebraska","Kimball County",2,13,37,20,17
050,31,105,"Nebraska","Kimball County",2,14,39,18,21
050,31,105,"Nebraska","Kimball County",2,15,42,20,22
050,31,105,"Nebraska","Kimball County",2,16,38,18,20
050,31,105,"Nebraska","Kimball County",2,17,38,20,18
050,31,105,"Nebraska","Kimball County",2,18,37,20,17
050,31,105,"Nebraska","Kimball County",2,19,31,18,13
050,31,105,"Nebraska","Kimball County",2,20,37,19,18
050,31,105,"Nebraska","Kimball County",2,21,29,14,15
050,31,105,"Nebraska","Kimball County",2,22,35,18,17
050,31,105,"Nebraska","Kimball County",2,23,32,18,14
050,31,105,"Nebraska","Kimball County",2,24,32,16,16
050,31,105,"Nebraska","Kimball County",2,25,29,13,16
050,31,105,"Nebraska","Kimball County",2,26,32,14,18
050,31,105,"Nebraska","Kimball County",2,27,41,17,24
050,31,105,"Nebraska","Kimball County",2,28,35,15,20
050,31,105,"Nebraska","Kimball County",2,29,26,11,15
050,31,105,"Nebraska","Kimball County",2,30,30,17,13
050,31,105,"Nebraska","Kimball County",2,31,35,20,15
050,31,105,"Nebraska","Kimball County",2,32,36,20,16
050,31,105,"Nebraska","Kimball County",2,33,39,22,17
050,31,105,"Nebraska","Kimball County",2,34,38,21,17
050,31,105,"Nebraska","Kimball County",2,35,44,23,21
050,31,105,"Nebraska","Kimball County",2,36,34,15,19
050,31,105,"Nebraska","Kimball County",2,37,33,16,17
050,31,105,"Nebraska","Kimball County",2,38,29,15,14
050,31,105,"Nebraska","Kimball County",2,39,33,19,14
050,31,105,"Nebraska","Kimball County",2,40,36,21,15
050,31,105,"Nebraska","Kimball County",2,41,29,15,14
050,31,105,"Nebraska","Kimball County",2,42,36,19,17
050,31,105,"Nebraska","Kimball County",2,43,33,18,15
050,31,105,"Nebraska","Kimball County",2,44,25,12,13
050,31,105,"Nebraska","Kimball County",2,45,31,15,16
050,31,105,"Nebraska","Kimball County",2,46,32,16,16
050,31,105,"Nebraska","Kimball County",2,47,31,14,17
050,31,105,"Nebraska","Kimball County",2,48,34,14,20
050,31,105,"Nebraska","Kimball County",2,49,36,17,19
050,31,105,"Nebraska","Kimball County",2,50,47,21,26
050,31,105,"Nebraska","Kimball County",2,51,42,21,21
050,31,105,"Nebraska","Kimball County",2,52,43,23,20
050,31,105,"Nebraska","Kimball County",2,53,43,23,20
050,31,105,"Nebraska","Kimball County",2,54,50,29,21
050,31,105,"Nebraska","Kimball County",2,55,45,20,25
050,31,105,"Nebraska","Kimball County",2,56,40,18,22
050,31,105,"Nebraska","Kimball County",2,57,43,20,23
050,31,105,"Nebraska","Kimball County",2,58,53,22,31
050,31,105,"Nebraska","Kimball County",2,59,54,23,31
050,31,105,"Nebraska","Kimball County",2,60,66,35,31
050,31,105,"Nebraska","Kimball County",2,61,67,37,30
050,31,105,"Nebraska","Kimball County",2,62,56,30,26
050,31,105,"Nebraska","Kimball County",2,63,55,31,24
050,31,105,"Nebraska","Kimball County",2,64,55,28,27
050,31,105,"Nebraska","Kimball County",2,65,62,34,28
050,31,105,"Nebraska","Kimball County",2,66,51,24,27
050,31,105,"Nebraska","Kimball County",2,67,43,22,21
050,31,105,"Nebraska","Kimball County",2,68,52,26,26
050,31,105,"Nebraska","Kimball County",2,69,48,22,26
050,31,105,"Nebraska","Kimball County",2,70,44,18,26
050,31,105,"Nebraska","Kimball County",2,71,47,23,24
050,31,105,"Nebraska","Kimball County",2,72,36,20,16
050,31,105,"Nebraska","Kimball County",2,73,43,20,23
050,31,105,"Nebraska","Kimball County",2,74,36,13,23
050,31,105,"Nebraska","Kimball County",2,75,34,15,19
050,31,105,"Nebraska","Kimball County",2,76,34,13,21
050,31,105,"Nebraska","Kimball County",2,77,36,17,19
050,31,105,"Nebraska","Kimball County",2,78,29,11,18
050,31,105,"Nebraska","Kimball County",2,79,34,15,19
050,31,105,"Nebraska","Kimball County",2,80,29,16,13
050,31,105,"Nebraska","Kimball County",2,81,27,15,12
050,31,105,"Nebraska","Kimball County",2,82,29,10,19
050,31,105,"Nebraska","Kimball County",2,83,21,10,11
050,31,105,"Nebraska","Kimball County",2,84,16,11,5
050,31,105,"Nebraska","Kimball County",2,85,142,55,87
050,31,105,"Nebraska","Kimball County",3,0,29,15,14
050,31,105,"Nebraska","Kimball County",3,1,33,17,16
050,31,105,"Nebraska","Kimball County",3,2,35,16,19
050,31,105,"Nebraska","Kimball County",3,3,37,17,20
050,31,105,"Nebraska","Kimball County",3,4,42,24,18
050,31,105,"Nebraska","Kimball County",3,5,44,23,21
050,31,105,"Nebraska","Kimball County",3,6,37,23,14
050,31,105,"Nebraska","Kimball County",3,7,33,16,17
050,31,105,"Nebraska","Kimball County",3,8,29,15,14
050,31,105,"Nebraska","Kimball County",3,9,41,24,17
050,31,105,"Nebraska","Kimball County",3,10,39,25,14
050,31,105,"Nebraska","Kimball County",3,11,48,26,22
050,31,105,"Nebraska","Kimball County",3,12,45,23,22
050,31,105,"Nebraska","Kimball County",3,13,43,23,20
050,31,105,"Nebraska","Kimball County",3,14,42,21,21
050,31,105,"Nebraska","Kimball County",3,15,39,18,21
050,31,105,"Nebraska","Kimball County",3,16,41,19,22
050,31,105,"Nebraska","Kimball County",3,17,40,17,23
050,31,105,"Nebraska","Kimball County",3,18,34,18,16
050,31,105,"Nebraska","Kimball County",3,19,28,15,13
050,31,105,"Nebraska","Kimball County",3,20,31,18,13
050,31,105,"Nebraska","Kimball County",3,21,34,17,17
050,31,105,"Nebraska","Kimball County",3,22,32,15,17
050,31,105,"Nebraska","Kimball County",3,23,35,16,19
050,31,105,"Nebraska","Kimball County",3,24,24,15,9
050,31,105,"Nebraska","Kimball County",3,25,30,17,13
050,31,105,"Nebraska","Kimball County",3,26,29,15,14
050,31,105,"Nebraska","Kimball County",3,27,40,18,22
050,31,105,"Nebraska","Kimball County",3,28,38,17,21
050,31,105,"Nebraska","Kimball County",3,29,31,16,15
050,31,105,"Nebraska","Kimball County",3,30,26,13,13
050,31,105,"Nebraska","Kimball County",3,31,33,19,14
050,31,105,"Nebraska","Kimball County",3,32,36,18,18
050,31,105,"Nebraska","Kimball County",3,33,36,21,15
050,31,105,"Nebraska","Kimball County",3,34,44,26,18
050,31,105,"Nebraska","Kimball County",3,35,38,21,17
050,31,105,"Nebraska","Kimball County",3,36,44,24,20
050,31,105,"Nebraska","Kimball County",3,37,35,14,21
050,31,105,"Nebraska","Kimball County",3,38,32,16,16
050,31,105,"Nebraska","Kimball County",3,39,26,14,12
050,31,105,"Nebraska","Kimball County",3,40,33,20,13
050,31,105,"Nebraska","Kimball County",3,41,40,23,17
050,31,105,"Nebraska","Kimball County",3,42,32,15,17
050,31,105,"Nebraska","Kimball County",3,43,40,24,16
050,31,105,"Nebraska","Kimball County",3,44,36,20,16
050,31,105,"Nebraska","Kimball County",3,45,25,13,12
050,31,105,"Nebraska","Kimball County",3,46,29,14,15
050,31,105,"Nebraska","Kimball County",3,47,33,16,17
050,31,105,"Nebraska","Kimball County",3,48,29,12,17
050,31,105,"Nebraska","Kimball County",3,49,32,14,18
050,31,105,"Nebraska","Kimball County",3,50,37,18,19
050,31,105,"Nebraska","Kimball County",3,51,44,21,23
050,31,105,"Nebraska","Kimball County",3,52,36,17,19
050,31,105,"Nebraska","Kimball County",3,53,45,24,21
050,31,105,"Nebraska","Kimball County",3,54,43,24,19
050,31,105,"Nebraska","Kimball County",3,55,52,30,22
050,31,105,"Nebraska","Kimball County",3,56,48,22,26
050,31,105,"Nebraska","Kimball County",3,57,42,19,23
050,31,105,"Nebraska","Kimball County",3,58,49,23,26
050,31,105,"Nebraska","Kimball County",3,59,52,21,31
050,31,105,"Nebraska","Kimball County",3,60,54,23,31
050,31,105,"Nebraska","Kimball County",3,61,73,37,36
050,31,105,"Nebraska","Kimball County",3,62,65,34,31
050,31,105,"Nebraska","Kimball County",3,63,59,31,28
050,31,105,"Nebraska","Kimball County",3,64,55,31,24
050,31,105,"Nebraska","Kimball County",3,65,54,26,28
050,31,105,"Nebraska","Kimball County",3,66,64,35,29
050,31,105,"Nebraska","Kimball County",3,67,46,22,24
050,31,105,"Nebraska","Kimball County",3,68,42,21,21
050,31,105,"Nebraska","Kimball County",3,69,52,26,26
050,31,105,"Nebraska","Kimball County",3,70,50,23,27
050,31,105,"Nebraska","Kimball County",3,71,41,18,23
050,31,105,"Nebraska","Kimball County",3,72,46,22,24
050,31,105,"Nebraska","Kimball County",3,73,34,17,17
050,31,105,"Nebraska","Kimball County",3,74,44,20,24
050,31,105,"Nebraska","Kimball County",3,75,34,12,22
050,31,105,"Nebraska","Kimball County",3,76,32,13,19
050,31,105,"Nebraska","Kimball County",3,77,35,15,20
050,31,105,"Nebraska","Kimball County",3,78,31,13,18
050,31,105,"Nebraska","Kimball County",3,79,28,10,18
050,31,105,"Nebraska","Kimball County",3,80,31,15,16
050,31,105,"Nebraska","Kimball County",3,81,30,18,12
050,31,105,"Nebraska","Kimball County",3,82,26,11,15
050,31,105,"Nebraska","Kimball County",3,83,23,7,16
050,31,105,"Nebraska","Kimball County",3,84,19,9,10
050,31,105,"Nebraska","Kimball County",3,85,133,55,78
050,31,105,"Nebraska","Kimball County",4,0,25,15,10
050,31,105,"Nebraska","Kimball County",4,1,27,14,13
050,31,105,"Nebraska","Kimball County",4,2,36,18,18
050,31,105,"Nebraska","Kimball County",4,3,31,17,14
050,31,105,"Nebraska","Kimball County",4,4,38,16,22
050,31,105,"Nebraska","Kimball County",4,5,44,23,21
050,31,105,"Nebraska","Kimball County",4,6,41,19,22
050,31,105,"Nebraska","Kimball County",4,7,39,22,17
050,31,105,"Nebraska","Kimball County",4,8,30,15,15
050,31,105,"Nebraska","Kimball County",4,9,27,12,15
050,31,105,"Nebraska","Kimball County",4,10,42,26,16
050,31,105,"Nebraska","Kimball County",4,11,36,24,12
050,31,105,"Nebraska","Kimball County",4,12,38,19,19
050,31,105,"Nebraska","Kimball County",4,13,43,22,21
050,31,105,"Nebraska","Kimball County",4,14,41,22,19
050,31,105,"Nebraska","Kimball County",4,15,37,19,18
050,31,105,"Nebraska","Kimball County",4,16,35,15,20
050,31,105,"Nebraska","Kimball County",4,17,42,19,23
050,31,105,"Nebraska","Kimball County",4,18,34,15,19
050,31,105,"Nebraska","Kimball County",4,19,27,15,12
050,31,105,"Nebraska","Kimball County",4,20,25,12,13
050,31,105,"Nebraska","Kimball County",4,21,34,19,15
050,31,105,"Nebraska","Kimball County",4,22,30,17,13
050,31,105,"Nebraska","Kimball County",4,23,32,16,16
050,31,105,"Nebraska","Kimball County",4,24,34,17,17
050,31,105,"Nebraska","Kimball County",4,25,32,20,12
050,31,105,"Nebraska","Kimball County",4,26,27,16,11
050,31,105,"Nebraska","Kimball County",4,27,27,15,12
050,31,105,"Nebraska","Kimball County",4,28,39,18,21
050,31,105,"Nebraska","Kimball County",4,29,34,16,18
050,31,105,"Nebraska","Kimball County",4,30,27,12,15
050,31,105,"Nebraska","Kimball County",4,31,23,10,13
050,31,105,"Nebraska","Kimball County",4,32,32,18,14
050,31,105,"Nebraska","Kimball County",4,33,40,21,19
050,31,105,"Nebraska","Kimball County",4,34,39,20,19
050,31,105,"Nebraska","Kimball County",4,35,44,27,17
050,31,105,"Nebraska","Kimball County",4,36,38,22,16
050,31,105,"Nebraska","Kimball County",4,37,44,23,21
050,31,105,"Nebraska","Kimball County",4,38,32,15,17
050,31,105,"Nebraska","Kimball County",4,39,32,18,14
050,31,105,"Nebraska","Kimball County",4,40,29,15,14
050,31,105,"Nebraska","Kimball County",4,41,32,19,13
050,31,105,"Nebraska","Kimball County",4,42,45,26,19
050,31,105,"Nebraska","Kimball County",4,43,34,18,16
050,31,105,"Nebraska","Kimball County",4,44,41,25,16
050,31,105,"Nebraska","Kimball County",4,45,34,18,16
050,31,105,"Nebraska","Kimball County",4,46,24,12,12
050,31,105,"Nebraska","Kimball County",4,47,29,15,14
050,31,105,"Nebraska","Kimball County",4,48,30,15,15
050,31,105,"Nebraska","Kimball County",4,49,31,14,17
050,31,105,"Nebraska","Kimball County",4,50,35,17,18
050,31,105,"Nebraska","Kimball County",4,51,36,18,18
050,31,105,"Nebraska","Kimball County",4,52,46,22,24
050,31,105,"Nebraska","Kimball County",4,53,38,17,21
050,31,105,"Nebraska","Kimball County",4,54,44,25,19
050,31,105,"Nebraska","Kimball County",4,55,44,24,20
050,31,105,"Nebraska","Kimball County",4,56,46,24,22
050,31,105,"Nebraska","Kimball County",4,57,49,22,27
050,31,105,"Nebraska","Kimball County",4,58,37,16,21
050,31,105,"Nebraska","Kimball County",4,59,46,23,23
050,31,105,"Nebraska","Kimball County",4,60,55,24,31
050,31,105,"Nebraska","Kimball County",4,61,52,23,29
050,31,105,"Nebraska","Kimball County",4,62,68,32,36
050,31,105,"Nebraska","Kimball County",4,63,63,34,29
050,31,105,"Nebraska","Kimball County",4,64,60,31,29
050,31,105,"Nebraska","Kimball County",4,65,55,31,24
050,31,105,"Nebraska","Kimball County",4,66,54,26,28
050,31,105,"Nebraska","Kimball County",4,67,62,36,26
050,31,105,"Nebraska","Kimball County",4,68,46,22,24
050,31,105,"Nebraska","Kimball County",4,69,44,23,21
050,31,105,"Nebraska","Kimball County",4,70,54,27,27
050,31,105,"Nebraska","Kimball County",4,71,48,23,25
050,31,105,"Nebraska","Kimball County",4,72,42,19,23
050,31,105,"Nebraska","Kimball County",4,73,45,21,24
050,31,105,"Nebraska","Kimball County",4,74,36,18,18
050,31,105,"Nebraska","Kimball County",4,75,40,19,21
050,31,105,"Nebraska","Kimball County",4,76,26,7,19
050,31,105,"Nebraska","Kimball County",4,77,31,15,16
050,31,105,"Nebraska","Kimball County",4,78,30,12,18
050,31,105,"Nebraska","Kimball County",4,79,31,13,18
050,31,105,"Nebraska","Kimball County",4,80,28,10,18
050,31,105,"Nebraska","Kimball County",4,81,33,18,15
050,31,105,"Nebraska","Kimball County",4,82,28,14,14
050,31,105,"Nebraska","Kimball County",4,83,22,10,12
050,31,105,"Nebraska","Kimball County",4,84,17,5,12
050,31,105,"Nebraska","Kimball County",4,85,138,58,80
050,31,105,"Nebraska","Kimball County",5,0,26,15,11
050,31,105,"Nebraska","Kimball County",5,1,30,20,10
050,31,105,"Nebraska","Kimball County",5,2,29,18,11
050,31,105,"Nebraska","Kimball County",5,3,34,19,15
050,31,105,"Nebraska","Kimball County",5,4,28,15,13
050,31,105,"Nebraska","Kimball County",5,5,38,16,22
050,31,105,"Nebraska","Kimball County",5,6,42,22,20
050,31,105,"Nebraska","Kimball County",5,7,42,19,23
050,31,105,"Nebraska","Kimball County",5,8,43,24,19
050,31,105,"Nebraska","Kimball County",5,9,31,16,15
050,31,105,"Nebraska","Kimball County",5,10,28,13,15
050,31,105,"Nebraska","Kimball County",5,11,43,26,17
050,31,105,"Nebraska","Kimball County",5,12,37,23,14
050,31,105,"Nebraska","Kimball County",5,13,44,21,23
050,31,105,"Nebraska","Kimball County",5,14,39,22,17
050,31,105,"Nebraska","Kimball County",5,15,41,21,20
050,31,105,"Nebraska","Kimball County",5,16,35,17,18
050,31,105,"Nebraska","Kimball County",5,17,39,18,21
050,31,105,"Nebraska","Kimball County",5,18,32,16,16
050,31,105,"Nebraska","Kimball County",5,19,26,13,13
050,31,105,"Nebraska","Kimball County",5,20,23,12,11
050,31,105,"Nebraska","Kimball County",5,21,20,11,9
050,31,105,"Nebraska","Kimball County",5,22,30,17,13
050,31,105,"Nebraska","Kimball County",5,23,25,11,14
050,31,105,"Nebraska","Kimball County",5,24,36,17,19
050,31,105,"Nebraska","Kimball County",5,25,34,16,18
050,31,105,"Nebraska","Kimball County",5,26,33,18,15
050,31,105,"Nebraska","Kimball County",5,27,28,17,11
050,31,105,"Nebraska","Kimball County",5,28,20,10,10
050,31,105,"Nebraska","Kimball County",5,29,39,20,19
050,31,105,"Nebraska","Kimball County",5,30,34,18,16
050,31,105,"Nebraska","Kimball County",5,31,26,11,15
050,31,105,"Nebraska","Kimball County",5,32,20,8,12
050,31,105,"Nebraska","Kimball County",5,33,28,17,11
050,31,105,"Nebraska","Kimball County",5,34,42,22,20
050,31,105,"Nebraska","Kimball County",5,35,37,20,17
050,31,105,"Nebraska","Kimball County",5,36,41,21,20
050,31,105,"Nebraska","Kimball County",5,37,39,22,17
050,31,105,"Nebraska","Kimball County",5,38,46,25,21
050,31,105,"Nebraska","Kimball County",5,39,36,19,17
050,31,105,"Nebraska","Kimball County",5,40,28,15,13
050,31,105,"Nebraska","Kimball County",5,41,28,15,13
050,31,105,"Nebraska","Kimball County",5,42,37,25,12
050,31,105,"Nebraska","Kimball County",5,43,53,35,18
050,31,105,"Nebraska","Kimball County",5,44,36,19,17
050,31,105,"Nebraska","Kimball County",5,45,40,24,16
050,31,105,"Nebraska","Kimball County",5,46,33,18,15
050,31,105,"Nebraska","Kimball County",5,47,24,12,12
050,31,105,"Nebraska","Kimball County",5,48,30,15,15
050,31,105,"Nebraska","Kimball County",5,49,28,15,13
050,31,105,"Nebraska","Kimball County",5,50,31,15,16
050,31,105,"Nebraska","Kimball County",5,51,36,17,19
050,31,105,"Nebraska","Kimball County",5,52,36,18,18
050,31,105,"Nebraska","Kimball County",5,53,47,23,24
050,31,105,"Nebraska","Kimball County",5,54,38,17,21
050,31,105,"Nebraska","Kimball County",5,55,47,25,22
050,31,105,"Nebraska","Kimball County",5,56,50,27,23
050,31,105,"Nebraska","Kimball County",5,57,48,23,25
050,31,105,"Nebraska","Kimball County",5,58,48,21,27
050,31,105,"Nebraska","Kimball County",5,59,35,16,19
050,31,105,"Nebraska","Kimball County",5,60,47,23,24
050,31,105,"Nebraska","Kimball County",5,61,49,24,25
050,31,105,"Nebraska","Kimball County",5,62,49,20,29
050,31,105,"Nebraska","Kimball County",5,63,68,32,36
050,31,105,"Nebraska","Kimball County",5,64,62,32,30
050,31,105,"Nebraska","Kimball County",5,65,57,29,28
050,31,105,"Nebraska","Kimball County",5,66,56,29,27
050,31,105,"Nebraska","Kimball County",5,67,53,26,27
050,31,105,"Nebraska","Kimball County",5,68,60,35,25
050,31,105,"Nebraska","Kimball County",5,69,46,22,24
050,31,105,"Nebraska","Kimball County",5,70,44,23,21
050,31,105,"Nebraska","Kimball County",5,71,51,25,26
050,31,105,"Nebraska","Kimball County",5,72,44,22,22
050,31,105,"Nebraska","Kimball County",5,73,42,18,24
050,31,105,"Nebraska","Kimball County",5,74,43,21,22
050,31,105,"Nebraska","Kimball County",5,75,31,16,15
050,31,105,"Nebraska","Kimball County",5,76,36,17,19
050,31,105,"Nebraska","Kimball County",5,77,29,9,20
050,31,105,"Nebraska","Kimball County",5,78,24,11,13
050,31,105,"Nebraska","Kimball County",5,79,31,12,19
050,31,105,"Nebraska","Kimball County",5,80,30,13,17
050,31,105,"Nebraska","Kimball County",5,81,31,14,17
050,31,105,"Nebraska","Kimball County",5,82,29,14,15
050,31,105,"Nebraska","Kimball County",5,83,23,14,9
050,31,105,"Nebraska","Kimball County",5,84,17,7,10
050,31,105,"Nebraska","Kimball County",5,85,140,55,85
050,31,107,"Nebraska","Knox County",1,0,99,51,48
050,31,107,"Nebraska","Knox County",1,1,104,48,56
050,31,107,"Nebraska","Knox County",1,2,108,53,55
050,31,107,"Nebraska","Knox County",1,3,105,55,50
050,31,107,"Nebraska","Knox County",1,4,102,63,39
050,31,107,"Nebraska","Knox County",1,5,107,52,55
050,31,107,"Nebraska","Knox County",1,6,118,63,55
050,31,107,"Nebraska","Knox County",1,7,110,53,57
050,31,107,"Nebraska","Knox County",1,8,115,57,58
050,31,107,"Nebraska","Knox County",1,9,108,48,60
050,31,107,"Nebraska","Knox County",1,10,110,54,56
050,31,107,"Nebraska","Knox County",1,11,130,69,61
050,31,107,"Nebraska","Knox County",1,12,121,65,56
050,31,107,"Nebraska","Knox County",1,13,125,57,68
050,31,107,"Nebraska","Knox County",1,14,121,46,75
050,31,107,"Nebraska","Knox County",1,15,129,57,72
050,31,107,"Nebraska","Knox County",1,16,121,60,61
050,31,107,"Nebraska","Knox County",1,17,125,62,63
050,31,107,"Nebraska","Knox County",1,18,104,57,47
050,31,107,"Nebraska","Knox County",1,19,78,38,40
050,31,107,"Nebraska","Knox County",1,20,84,44,40
050,31,107,"Nebraska","Knox County",1,21,80,39,41
050,31,107,"Nebraska","Knox County",1,22,81,44,37
050,31,107,"Nebraska","Knox County",1,23,84,52,32
050,31,107,"Nebraska","Knox County",1,24,77,47,30
050,31,107,"Nebraska","Knox County",1,25,60,31,29
050,31,107,"Nebraska","Knox County",1,26,58,29,29
050,31,107,"Nebraska","Knox County",1,27,76,43,33
050,31,107,"Nebraska","Knox County",1,28,86,41,45
050,31,107,"Nebraska","Knox County",1,29,84,41,43
050,31,107,"Nebraska","Knox County",1,30,69,36,33
050,31,107,"Nebraska","Knox County",1,31,72,34,38
050,31,107,"Nebraska","Knox County",1,32,68,34,34
050,31,107,"Nebraska","Knox County",1,33,67,34,33
050,31,107,"Nebraska","Knox County",1,34,76,38,38
050,31,107,"Nebraska","Knox County",1,35,86,43,43
050,31,107,"Nebraska","Knox County",1,36,75,34,41
050,31,107,"Nebraska","Knox County",1,37,88,51,37
050,31,107,"Nebraska","Knox County",1,38,101,60,41
050,31,107,"Nebraska","Knox County",1,39,84,50,34
050,31,107,"Nebraska","Knox County",1,40,83,45,38
050,31,107,"Nebraska","Knox County",1,41,80,45,35
050,31,107,"Nebraska","Knox County",1,42,76,35,41
050,31,107,"Nebraska","Knox County",1,43,89,42,47
050,31,107,"Nebraska","Knox County",1,44,83,42,41
050,31,107,"Nebraska","Knox County",1,45,85,42,43
050,31,107,"Nebraska","Knox County",1,46,84,47,37
050,31,107,"Nebraska","Knox County",1,47,74,36,38
050,31,107,"Nebraska","Knox County",1,48,81,44,37
050,31,107,"Nebraska","Knox County",1,49,88,50,38
050,31,107,"Nebraska","Knox County",1,50,85,47,38
050,31,107,"Nebraska","Knox County",1,51,79,40,39
050,31,107,"Nebraska","Knox County",1,52,75,41,34
050,31,107,"Nebraska","Knox County",1,53,85,39,46
050,31,107,"Nebraska","Knox County",1,54,102,46,56
050,31,107,"Nebraska","Knox County",1,55,115,60,55
050,31,107,"Nebraska","Knox County",1,56,124,60,64
050,31,107,"Nebraska","Knox County",1,57,129,63,66
050,31,107,"Nebraska","Knox County",1,58,119,60,59
050,31,107,"Nebraska","Knox County",1,59,128,68,60
050,31,107,"Nebraska","Knox County",1,60,134,72,62
050,31,107,"Nebraska","Knox County",1,61,129,61,68
050,31,107,"Nebraska","Knox County",1,62,124,60,64
050,31,107,"Nebraska","Knox County",1,63,125,67,58
050,31,107,"Nebraska","Knox County",1,64,130,66,64
050,31,107,"Nebraska","Knox County",1,65,147,72,75
050,31,107,"Nebraska","Knox County",1,66,133,65,68
050,31,107,"Nebraska","Knox County",1,67,106,52,54
050,31,107,"Nebraska","Knox County",1,68,120,55,65
050,31,107,"Nebraska","Knox County",1,69,123,60,63
050,31,107,"Nebraska","Knox County",1,70,110,59,51
050,31,107,"Nebraska","Knox County",1,71,109,56,53
050,31,107,"Nebraska","Knox County",1,72,110,57,53
050,31,107,"Nebraska","Knox County",1,73,100,50,50
050,31,107,"Nebraska","Knox County",1,74,77,39,38
050,31,107,"Nebraska","Knox County",1,75,78,40,38
050,31,107,"Nebraska","Knox County",1,76,72,32,40
050,31,107,"Nebraska","Knox County",1,77,69,31,38
050,31,107,"Nebraska","Knox County",1,78,67,30,37
050,31,107,"Nebraska","Knox County",1,79,56,26,30
050,31,107,"Nebraska","Knox County",1,80,53,25,28
050,31,107,"Nebraska","Knox County",1,81,62,29,33
050,31,107,"Nebraska","Knox County",1,82,58,26,32
050,31,107,"Nebraska","Knox County",1,83,61,23,38
050,31,107,"Nebraska","Knox County",1,84,53,23,30
050,31,107,"Nebraska","Knox County",1,85,327,110,217
050,31,107,"Nebraska","Knox County",2,0,103,56,47
050,31,107,"Nebraska","Knox County",2,1,103,49,54
050,31,107,"Nebraska","Knox County",2,2,106,52,54
050,31,107,"Nebraska","Knox County",2,3,105,56,49
050,31,107,"Nebraska","Knox County",2,4,101,60,41
050,31,107,"Nebraska","Knox County",2,5,106,55,51
050,31,107,"Nebraska","Knox County",2,6,115,60,55
050,31,107,"Nebraska","Knox County",2,7,112,55,57
050,31,107,"Nebraska","Knox County",2,8,113,55,58
050,31,107,"Nebraska","Knox County",2,9,110,50,60
050,31,107,"Nebraska","Knox County",2,10,111,53,58
050,31,107,"Nebraska","Knox County",2,11,125,66,59
050,31,107,"Nebraska","Knox County",2,12,124,67,57
050,31,107,"Nebraska","Knox County",2,13,126,60,66
050,31,107,"Nebraska","Knox County",2,14,123,49,74
050,31,107,"Nebraska","Knox County",2,15,127,55,72
050,31,107,"Nebraska","Knox County",2,16,123,59,64
050,31,107,"Nebraska","Knox County",2,17,122,61,61
050,31,107,"Nebraska","Knox County",2,18,103,55,48
050,31,107,"Nebraska","Knox County",2,19,81,41,40
050,31,107,"Nebraska","Knox County",2,20,85,43,42
050,31,107,"Nebraska","Knox County",2,21,80,40,40
050,31,107,"Nebraska","Knox County",2,22,82,44,38
050,31,107,"Nebraska","Knox County",2,23,84,51,33
050,31,107,"Nebraska","Knox County",2,24,80,49,31
050,31,107,"Nebraska","Knox County",2,25,62,33,29
050,31,107,"Nebraska","Knox County",2,26,59,30,29
050,31,107,"Nebraska","Knox County",2,27,73,39,34
050,31,107,"Nebraska","Knox County",2,28,84,42,42
050,31,107,"Nebraska","Knox County",2,29,84,41,43
050,31,107,"Nebraska","Knox County",2,30,75,38,37
050,31,107,"Nebraska","Knox County",2,31,72,34,38
050,31,107,"Nebraska","Knox County",2,32,70,35,35
050,31,107,"Nebraska","Knox County",2,33,68,34,34
050,31,107,"Nebraska","Knox County",2,34,73,37,36
050,31,107,"Nebraska","Knox County",2,35,82,40,42
050,31,107,"Nebraska","Knox County",2,36,78,36,42
050,31,107,"Nebraska","Knox County",2,37,86,48,38
050,31,107,"Nebraska","Knox County",2,38,100,59,41
050,31,107,"Nebraska","Knox County",2,39,88,52,36
050,31,107,"Nebraska","Knox County",2,40,82,45,37
050,31,107,"Nebraska","Knox County",2,41,81,45,36
050,31,107,"Nebraska","Knox County",2,42,77,37,40
050,31,107,"Nebraska","Knox County",2,43,86,40,46
050,31,107,"Nebraska","Knox County",2,44,83,41,42
050,31,107,"Nebraska","Knox County",2,45,84,42,42
050,31,107,"Nebraska","Knox County",2,46,83,45,38
050,31,107,"Nebraska","Knox County",2,47,78,38,40
050,31,107,"Nebraska","Knox County",2,48,79,42,37
050,31,107,"Nebraska","Knox County",2,49,87,49,38
050,31,107,"Nebraska","Knox County",2,50,86,48,38
050,31,107,"Nebraska","Knox County",2,51,78,41,37
050,31,107,"Nebraska","Knox County",2,52,76,41,35
050,31,107,"Nebraska","Knox County",2,53,81,39,42
050,31,107,"Nebraska","Knox County",2,54,100,45,55
050,31,107,"Nebraska","Knox County",2,55,111,56,55
050,31,107,"Nebraska","Knox County",2,56,123,61,62
050,31,107,"Nebraska","Knox County",2,57,127,62,65
050,31,107,"Nebraska","Knox County",2,58,119,59,60
050,31,107,"Nebraska","Knox County",2,59,126,66,60
050,31,107,"Nebraska","Knox County",2,60,132,71,61
050,31,107,"Nebraska","Knox County",2,61,128,63,65
050,31,107,"Nebraska","Knox County",2,62,122,59,63
050,31,107,"Nebraska","Knox County",2,63,126,66,60
050,31,107,"Nebraska","Knox County",2,64,130,66,64
050,31,107,"Nebraska","Knox County",2,65,143,71,72
050,31,107,"Nebraska","Knox County",2,66,136,66,70
050,31,107,"Nebraska","Knox County",2,67,113,55,58
050,31,107,"Nebraska","Knox County",2,68,116,54,62
050,31,107,"Nebraska","Knox County",2,69,119,57,62
050,31,107,"Nebraska","Knox County",2,70,110,57,53
050,31,107,"Nebraska","Knox County",2,71,109,57,52
050,31,107,"Nebraska","Knox County",2,72,107,56,51
050,31,107,"Nebraska","Knox County",2,73,107,54,53
050,31,107,"Nebraska","Knox County",2,74,75,38,37
050,31,107,"Nebraska","Knox County",2,75,79,41,38
050,31,107,"Nebraska","Knox County",2,76,73,33,40
050,31,107,"Nebraska","Knox County",2,77,71,32,39
050,31,107,"Nebraska","Knox County",2,78,65,29,36
050,31,107,"Nebraska","Knox County",2,79,58,26,32
050,31,107,"Nebraska","Knox County",2,80,53,24,29
050,31,107,"Nebraska","Knox County",2,81,60,28,32
050,31,107,"Nebraska","Knox County",2,82,59,26,33
050,31,107,"Nebraska","Knox County",2,83,60,24,36
050,31,107,"Nebraska","Knox County",2,84,52,22,30
050,31,107,"Nebraska","Knox County",2,85,330,109,221
050,31,107,"Nebraska","Knox County",3,0,101,54,47
050,31,107,"Nebraska","Knox County",3,1,99,48,51
050,31,107,"Nebraska","Knox County",3,2,101,48,53
050,31,107,"Nebraska","Knox County",3,3,105,49,56
050,31,107,"Nebraska","Knox County",3,4,115,57,58
050,31,107,"Nebraska","Knox County",3,5,101,60,41
050,31,107,"Nebraska","Knox County",3,6,107,57,50
050,31,107,"Nebraska","Knox County",3,7,115,60,55
050,31,107,"Nebraska","Knox County",3,8,120,62,58
050,31,107,"Nebraska","Knox County",3,9,123,60,63
050,31,107,"Nebraska","Knox County",3,10,115,59,56
050,31,107,"Nebraska","Knox County",3,11,120,58,62
050,31,107,"Nebraska","Knox County",3,12,129,68,61
050,31,107,"Nebraska","Knox County",3,13,128,67,61
050,31,107,"Nebraska","Knox County",3,14,124,61,63
050,31,107,"Nebraska","Knox County",3,15,121,48,73
050,31,107,"Nebraska","Knox County",3,16,129,55,74
050,31,107,"Nebraska","Knox County",3,17,123,60,63
050,31,107,"Nebraska","Knox County",3,18,107,57,50
050,31,107,"Nebraska","Knox County",3,19,83,46,37
050,31,107,"Nebraska","Knox County",3,20,86,40,46
050,31,107,"Nebraska","Knox County",3,21,84,43,41
050,31,107,"Nebraska","Knox County",3,22,84,42,42
050,31,107,"Nebraska","Knox County",3,23,88,49,39
050,31,107,"Nebraska","Knox County",3,24,64,35,29
050,31,107,"Nebraska","Knox County",3,25,90,52,38
050,31,107,"Nebraska","Knox County",3,26,73,39,34
050,31,107,"Nebraska","Knox County",3,27,55,29,26
050,31,107,"Nebraska","Knox County",3,28,73,38,35
050,31,107,"Nebraska","Knox County",3,29,80,44,36
050,31,107,"Nebraska","Knox County",3,30,80,38,42
050,31,107,"Nebraska","Knox County",3,31,77,39,38
050,31,107,"Nebraska","Knox County",3,32,74,34,40
050,31,107,"Nebraska","Knox County",3,33,71,35,36
050,31,107,"Nebraska","Knox County",3,34,65,30,35
050,31,107,"Nebraska","Knox County",3,35,73,39,34
050,31,107,"Nebraska","Knox County",3,36,87,44,43
050,31,107,"Nebraska","Knox County",3,37,78,36,42
050,31,107,"Nebraska","Knox County",3,38,92,49,43
050,31,107,"Nebraska","Knox County",3,39,98,54,44
050,31,107,"Nebraska","Knox County",3,40,87,52,35
050,31,107,"Nebraska","Knox County",3,41,86,46,40
050,31,107,"Nebraska","Knox County",3,42,82,46,36
050,31,107,"Nebraska","Knox County",3,43,77,40,37
050,31,107,"Nebraska","Knox County",3,44,83,38,45
050,31,107,"Nebraska","Knox County",3,45,84,45,39
050,31,107,"Nebraska","Knox County",3,46,84,42,42
050,31,107,"Nebraska","Knox County",3,47,82,46,36
050,31,107,"Nebraska","Knox County",3,48,79,39,40
050,31,107,"Nebraska","Knox County",3,49,76,40,36
050,31,107,"Nebraska","Knox County",3,50,88,50,38
050,31,107,"Nebraska","Knox County",3,51,90,48,42
050,31,107,"Nebraska","Knox County",3,52,78,40,38
050,31,107,"Nebraska","Knox County",3,53,77,40,37
050,31,107,"Nebraska","Knox County",3,54,82,40,42
050,31,107,"Nebraska","Knox County",3,55,100,44,56
050,31,107,"Nebraska","Knox County",3,56,108,55,53
050,31,107,"Nebraska","Knox County",3,57,121,60,61
050,31,107,"Nebraska","Knox County",3,58,126,62,64
050,31,107,"Nebraska","Knox County",3,59,119,56,63
050,31,107,"Nebraska","Knox County",3,60,124,65,59
050,31,107,"Nebraska","Knox County",3,61,135,72,63
050,31,107,"Nebraska","Knox County",3,62,127,64,63
050,31,107,"Nebraska","Knox County",3,63,127,63,64
050,31,107,"Nebraska","Knox County",3,64,124,65,59
050,31,107,"Nebraska","Knox County",3,65,130,66,64
050,31,107,"Nebraska","Knox County",3,66,137,68,69
050,31,107,"Nebraska","Knox County",3,67,136,64,72
050,31,107,"Nebraska","Knox County",3,68,116,58,58
050,31,107,"Nebraska","Knox County",3,69,117,52,65
050,31,107,"Nebraska","Knox County",3,70,114,53,61
050,31,107,"Nebraska","Knox County",3,71,109,54,55
050,31,107,"Nebraska","Knox County",3,72,108,55,53
050,31,107,"Nebraska","Knox County",3,73,107,52,55
050,31,107,"Nebraska","Knox County",3,74,100,51,49
050,31,107,"Nebraska","Knox County",3,75,73,35,38
050,31,107,"Nebraska","Knox County",3,76,80,43,37
050,31,107,"Nebraska","Knox County",3,77,65,29,36
050,31,107,"Nebraska","Knox County",3,78,67,27,40
050,31,107,"Nebraska","Knox County",3,79,65,28,37
050,31,107,"Nebraska","Knox County",3,80,63,28,35
050,31,107,"Nebraska","Knox County",3,81,50,22,28
050,31,107,"Nebraska","Knox County",3,82,54,22,32
050,31,107,"Nebraska","Knox County",3,83,54,25,29
050,31,107,"Nebraska","Knox County",3,84,49,19,30
050,31,107,"Nebraska","Knox County",3,85,328,106,222
050,31,107,"Nebraska","Knox County",4,0,96,55,41
050,31,107,"Nebraska","Knox County",4,1,107,54,53
050,31,107,"Nebraska","Knox County",4,2,102,52,50
050,31,107,"Nebraska","Knox County",4,3,95,44,51
050,31,107,"Nebraska","Knox County",4,4,103,49,54
050,31,107,"Nebraska","Knox County",4,5,108,55,53
050,31,107,"Nebraska","Knox County",4,6,101,63,38
050,31,107,"Nebraska","Knox County",4,7,107,55,52
050,31,107,"Nebraska","Knox County",4,8,124,63,61
050,31,107,"Nebraska","Knox County",4,9,112,58,54
050,31,107,"Nebraska","Knox County",4,10,123,63,60
050,31,107,"Nebraska","Knox County",4,11,113,58,55
050,31,107,"Nebraska","Knox County",4,12,119,57,62
050,31,107,"Nebraska","Knox County",4,13,125,66,59
050,31,107,"Nebraska","Knox County",4,14,129,66,63
050,31,107,"Nebraska","Knox County",4,15,124,63,61
050,31,107,"Nebraska","Knox County",4,16,118,48,70
050,31,107,"Nebraska","Knox County",4,17,126,51,75
050,31,107,"Nebraska","Knox County",4,18,101,51,50
050,31,107,"Nebraska","Knox County",4,19,85,45,40
050,31,107,"Nebraska","Knox County",4,20,79,47,32
050,31,107,"Nebraska","Knox County",4,21,74,33,41
050,31,107,"Nebraska","Knox County",4,22,90,45,45
050,31,107,"Nebraska","Knox County",4,23,84,38,46
050,31,107,"Nebraska","Knox County",4,24,81,44,37
050,31,107,"Nebraska","Knox County",4,25,66,35,31
050,31,107,"Nebraska","Knox County",4,26,89,48,41
050,31,107,"Nebraska","Knox County",4,27,67,38,29
050,31,107,"Nebraska","Knox County",4,28,61,31,30
050,31,107,"Nebraska","Knox County",4,29,74,38,36
050,31,107,"Nebraska","Knox County",4,30,75,40,35
050,31,107,"Nebraska","Knox County",4,31,71,32,39
050,31,107,"Nebraska","Knox County",4,32,82,41,41
050,31,107,"Nebraska","Knox County",4,33,72,33,39
050,31,107,"Nebraska","Knox County",4,34,71,35,36
050,31,107,"Nebraska","Knox County",4,35,65,33,32
050,31,107,"Nebraska","Knox County",4,36,69,36,33
050,31,107,"Nebraska","Knox County",4,37,81,41,40
050,31,107,"Nebraska","Knox County",4,38,77,36,41
050,31,107,"Nebraska","Knox County",4,39,90,50,40
050,31,107,"Nebraska","Knox County",4,40,100,54,46
050,31,107,"Nebraska","Knox County",4,41,85,50,35
050,31,107,"Nebraska","Knox County",4,42,86,47,39
050,31,107,"Nebraska","Knox County",4,43,82,47,35
050,31,107,"Nebraska","Knox County",4,44,82,43,39
050,31,107,"Nebraska","Knox County",4,45,84,39,45
050,31,107,"Nebraska","Knox County",4,46,84,44,40
050,31,107,"Nebraska","Knox County",4,47,86,42,44
050,31,107,"Nebraska","Knox County",4,48,84,48,36
050,31,107,"Nebraska","Knox County",4,49,75,37,38
050,31,107,"Nebraska","Knox County",4,50,81,43,38
050,31,107,"Nebraska","Knox County",4,51,90,49,41
050,31,107,"Nebraska","Knox County",4,52,93,51,42
050,31,107,"Nebraska","Knox County",4,53,74,35,39
050,31,107,"Nebraska","Knox County",4,54,76,39,37
050,31,107,"Nebraska","Knox County",4,55,85,43,42
050,31,107,"Nebraska","Knox County",4,56,101,45,56
050,31,107,"Nebraska","Knox County",4,57,104,54,50
050,31,107,"Nebraska","Knox County",4,58,125,64,61
050,31,107,"Nebraska","Knox County",4,59,122,59,63
050,31,107,"Nebraska","Knox County",4,60,117,54,63
050,31,107,"Nebraska","Knox County",4,61,131,69,62
050,31,107,"Nebraska","Knox County",4,62,132,72,60
050,31,107,"Nebraska","Knox County",4,63,137,69,68
050,31,107,"Nebraska","Knox County",4,64,122,60,62
050,31,107,"Nebraska","Knox County",4,65,127,66,61
050,31,107,"Nebraska","Knox County",4,66,123,63,60
050,31,107,"Nebraska","Knox County",4,67,137,70,67
050,31,107,"Nebraska","Knox County",4,68,138,65,73
050,31,107,"Nebraska","Knox County",4,69,113,55,58
050,31,107,"Nebraska","Knox County",4,70,113,49,64
050,31,107,"Nebraska","Knox County",4,71,112,52,60
050,31,107,"Nebraska","Knox County",4,72,108,54,54
050,31,107,"Nebraska","Knox County",4,73,107,51,56
050,31,107,"Nebraska","Knox County",4,74,100,50,50
050,31,107,"Nebraska","Knox County",4,75,99,50,49
050,31,107,"Nebraska","Knox County",4,76,73,36,37
050,31,107,"Nebraska","Knox County",4,77,80,42,38
050,31,107,"Nebraska","Knox County",4,78,58,23,35
050,31,107,"Nebraska","Knox County",4,79,68,27,41
050,31,107,"Nebraska","Knox County",4,80,67,30,37
050,31,107,"Nebraska","Knox County",4,81,54,22,32
050,31,107,"Nebraska","Knox County",4,82,43,19,24
050,31,107,"Nebraska","Knox County",4,83,52,21,31
050,31,107,"Nebraska","Knox County",4,84,43,21,22
050,31,107,"Nebraska","Knox County",4,85,318,104,214
050,31,107,"Nebraska","Knox County",5,0,81,47,34
050,31,107,"Nebraska","Knox County",5,1,99,59,40
050,31,107,"Nebraska","Knox County",5,2,99,48,51
050,31,107,"Nebraska","Knox County",5,3,103,51,52
050,31,107,"Nebraska","Knox County",5,4,94,45,49
050,31,107,"Nebraska","Knox County",5,5,110,56,54
050,31,107,"Nebraska","Knox County",5,6,109,53,56
050,31,107,"Nebraska","Knox County",5,7,103,60,43
050,31,107,"Nebraska","Knox County",5,8,113,59,54
050,31,107,"Nebraska","Knox County",5,9,128,66,62
050,31,107,"Nebraska","Knox County",5,10,117,61,56
050,31,107,"Nebraska","Knox County",5,11,132,66,66
050,31,107,"Nebraska","Knox County",5,12,113,59,54
050,31,107,"Nebraska","Knox County",5,13,121,58,63
050,31,107,"Nebraska","Knox County",5,14,133,69,64
050,31,107,"Nebraska","Knox County",5,15,132,65,67
050,31,107,"Nebraska","Knox County",5,16,117,59,58
050,31,107,"Nebraska","Knox County",5,17,119,46,73
050,31,107,"Nebraska","Knox County",5,18,106,44,62
050,31,107,"Nebraska","Knox County",5,19,79,40,39
050,31,107,"Nebraska","Knox County",5,20,89,47,42
050,31,107,"Nebraska","Knox County",5,21,79,44,35
050,31,107,"Nebraska","Knox County",5,22,76,35,41
050,31,107,"Nebraska","Knox County",5,23,83,44,39
050,31,107,"Nebraska","Knox County",5,24,85,39,46
050,31,107,"Nebraska","Knox County",5,25,77,40,37
050,31,107,"Nebraska","Knox County",5,26,73,39,34
050,31,107,"Nebraska","Knox County",5,27,83,47,36
050,31,107,"Nebraska","Knox County",5,28,71,40,31
050,31,107,"Nebraska","Knox County",5,29,54,26,28
050,31,107,"Nebraska","Knox County",5,30,72,38,34
050,31,107,"Nebraska","Knox County",5,31,75,40,35
050,31,107,"Nebraska","Knox County",5,32,72,31,41
050,31,107,"Nebraska","Knox County",5,33,84,40,44
050,31,107,"Nebraska","Knox County",5,34,81,35,46
050,31,107,"Nebraska","Knox County",5,35,68,34,34
050,31,107,"Nebraska","Knox County",5,36,65,31,34
050,31,107,"Nebraska","Knox County",5,37,78,40,38
050,31,107,"Nebraska","Knox County",5,38,88,46,42
050,31,107,"Nebraska","Knox County",5,39,82,38,44
050,31,107,"Nebraska","Knox County",5,40,92,53,39
050,31,107,"Nebraska","Knox County",5,41,101,55,46
050,31,107,"Nebraska","Knox County",5,42,82,47,35
050,31,107,"Nebraska","Knox County",5,43,87,47,40
050,31,107,"Nebraska","Knox County",5,44,84,49,35
050,31,107,"Nebraska","Knox County",5,45,84,44,40
050,31,107,"Nebraska","Knox County",5,46,80,36,44
050,31,107,"Nebraska","Knox County",5,47,79,44,35
050,31,107,"Nebraska","Knox County",5,48,89,44,45
050,31,107,"Nebraska","Knox County",5,49,85,49,36
050,31,107,"Nebraska","Knox County",5,50,72,37,35
050,31,107,"Nebraska","Knox County",5,51,78,41,37
050,31,107,"Nebraska","Knox County",5,52,93,51,42
050,31,107,"Nebraska","Knox County",5,53,92,50,42
050,31,107,"Nebraska","Knox County",5,54,78,36,42
050,31,107,"Nebraska","Knox County",5,55,78,38,40
050,31,107,"Nebraska","Knox County",5,56,89,46,43
050,31,107,"Nebraska","Knox County",5,57,98,44,54
050,31,107,"Nebraska","Knox County",5,58,114,58,56
050,31,107,"Nebraska","Knox County",5,59,122,60,62
050,31,107,"Nebraska","Knox County",5,60,122,59,63
050,31,107,"Nebraska","Knox County",5,61,124,58,66
050,31,107,"Nebraska","Knox County",5,62,131,68,63
050,31,107,"Nebraska","Knox County",5,63,133,73,60
050,31,107,"Nebraska","Knox County",5,64,131,67,64
050,31,107,"Nebraska","Knox County",5,65,120,58,62
050,31,107,"Nebraska","Knox County",5,66,124,64,60
050,31,107,"Nebraska","Knox County",5,67,123,62,61
050,31,107,"Nebraska","Knox County",5,68,139,72,67
050,31,107,"Nebraska","Knox County",5,69,137,64,73
050,31,107,"Nebraska","Knox County",5,70,109,52,57
050,31,107,"Nebraska","Knox County",5,71,113,47,66
050,31,107,"Nebraska","Knox County",5,72,110,51,59
050,31,107,"Nebraska","Knox County",5,73,103,49,54
050,31,107,"Nebraska","Knox County",5,74,99,48,51
050,31,107,"Nebraska","Knox County",5,75,99,49,50
050,31,107,"Nebraska","Knox County",5,76,95,48,47
050,31,107,"Nebraska","Knox County",5,77,71,35,36
050,31,107,"Nebraska","Knox County",5,78,72,35,37
050,31,107,"Nebraska","Knox County",5,79,60,23,37
050,31,107,"Nebraska","Knox County",5,80,69,28,41
050,31,107,"Nebraska","Knox County",5,81,60,24,36
050,31,107,"Nebraska","Knox County",5,82,50,18,32
050,31,107,"Nebraska","Knox County",5,83,39,17,22
050,31,107,"Nebraska","Knox County",5,84,43,17,26
050,31,107,"Nebraska","Knox County",5,85,302,100,202
050,31,109,"Nebraska","Lancaster County",1,0,3815,1955,1860
050,31,109,"Nebraska","Lancaster County",1,1,3771,1948,1823
050,31,109,"Nebraska","Lancaster County",1,2,3816,1978,1838
050,31,109,"Nebraska","Lancaster County",1,3,4021,2053,1968
050,31,109,"Nebraska","Lancaster County",1,4,4064,2138,1926
050,31,109,"Nebraska","Lancaster County",1,5,4055,2172,1883
050,31,109,"Nebraska","Lancaster County",1,6,4093,2074,2019
050,31,109,"Nebraska","Lancaster County",1,7,4073,2048,2025
050,31,109,"Nebraska","Lancaster County",1,8,4039,2126,1913
050,31,109,"Nebraska","Lancaster County",1,9,4098,2098,2000
050,31,109,"Nebraska","Lancaster County",1,10,4236,2133,2103
050,31,109,"Nebraska","Lancaster County",1,11,4411,2252,2159
050,31,109,"Nebraska","Lancaster County",1,12,4410,2268,2142
050,31,109,"Nebraska","Lancaster County",1,13,4324,2232,2092
050,31,109,"Nebraska","Lancaster County",1,14,4265,2205,2060
050,31,109,"Nebraska","Lancaster County",1,15,4219,2157,2062
050,31,109,"Nebraska","Lancaster County",1,16,4219,2171,2048
050,31,109,"Nebraska","Lancaster County",1,17,4088,2045,2043
050,31,109,"Nebraska","Lancaster County",1,18,4892,2355,2537
050,31,109,"Nebraska","Lancaster County",1,19,7250,3646,3604
050,31,109,"Nebraska","Lancaster County",1,20,7940,3822,4118
050,31,109,"Nebraska","Lancaster County",1,21,7855,4008,3847
050,31,109,"Nebraska","Lancaster County",1,22,6915,3440,3475
050,31,109,"Nebraska","Lancaster County",1,23,6620,3438,3182
050,31,109,"Nebraska","Lancaster County",1,24,5773,3032,2741
050,31,109,"Nebraska","Lancaster County",1,25,5207,2738,2469
050,31,109,"Nebraska","Lancaster County",1,26,5019,2619,2400
050,31,109,"Nebraska","Lancaster County",1,27,4708,2469,2239
050,31,109,"Nebraska","Lancaster County",1,28,4553,2368,2185
050,31,109,"Nebraska","Lancaster County",1,29,4292,2263,2029
050,31,109,"Nebraska","Lancaster County",1,30,4112,2206,1906
050,31,109,"Nebraska","Lancaster County",1,31,4064,2207,1857
050,31,109,"Nebraska","Lancaster County",1,32,3964,2112,1852
050,31,109,"Nebraska","Lancaster County",1,33,3973,2100,1873
050,31,109,"Nebraska","Lancaster County",1,34,4096,2139,1957
050,31,109,"Nebraska","Lancaster County",1,35,4291,2233,2058
050,31,109,"Nebraska","Lancaster County",1,36,4328,2224,2104
050,31,109,"Nebraska","Lancaster County",1,37,4487,2334,2153
050,31,109,"Nebraska","Lancaster County",1,38,4488,2327,2161
050,31,109,"Nebraska","Lancaster County",1,39,4347,2241,2106
050,31,109,"Nebraska","Lancaster County",1,40,4052,2048,2004
050,31,109,"Nebraska","Lancaster County",1,41,3996,2085,1911
050,31,109,"Nebraska","Lancaster County",1,42,3911,2021,1890
050,31,109,"Nebraska","Lancaster County",1,43,3768,1959,1809
050,31,109,"Nebraska","Lancaster County",1,44,3682,1979,1703
050,31,109,"Nebraska","Lancaster County",1,45,3608,1905,1703
050,31,109,"Nebraska","Lancaster County",1,46,3446,1784,1662
050,31,109,"Nebraska","Lancaster County",1,47,3297,1707,1590
050,31,109,"Nebraska","Lancaster County",1,48,3543,1849,1694
050,31,109,"Nebraska","Lancaster County",1,49,3691,1920,1771
050,31,109,"Nebraska","Lancaster County",1,50,3522,1816,1706
050,31,109,"Nebraska","Lancaster County",1,51,3430,1782,1648
050,31,109,"Nebraska","Lancaster County",1,52,3214,1658,1556
050,31,109,"Nebraska","Lancaster County",1,53,3184,1633,1551
050,31,109,"Nebraska","Lancaster County",1,54,3165,1644,1521
050,31,109,"Nebraska","Lancaster County",1,55,3401,1741,1660
050,31,109,"Nebraska","Lancaster County",1,56,3543,1765,1778
050,31,109,"Nebraska","Lancaster County",1,57,3584,1781,1803
050,31,109,"Nebraska","Lancaster County",1,58,3662,1797,1865
050,31,109,"Nebraska","Lancaster County",1,59,3644,1779,1865
050,31,109,"Nebraska","Lancaster County",1,60,3634,1764,1870
050,31,109,"Nebraska","Lancaster County",1,61,3642,1763,1879
050,31,109,"Nebraska","Lancaster County",1,62,3577,1728,1849
050,31,109,"Nebraska","Lancaster County",1,63,3534,1746,1788
050,31,109,"Nebraska","Lancaster County",1,64,3510,1724,1786
050,31,109,"Nebraska","Lancaster County",1,65,3448,1681,1767
050,31,109,"Nebraska","Lancaster County",1,66,3326,1587,1739
050,31,109,"Nebraska","Lancaster County",1,67,3261,1553,1708
050,31,109,"Nebraska","Lancaster County",1,68,3198,1511,1687
050,31,109,"Nebraska","Lancaster County",1,69,3005,1437,1568
050,31,109,"Nebraska","Lancaster County",1,70,2853,1328,1525
050,31,109,"Nebraska","Lancaster County",1,71,2723,1264,1459
050,31,109,"Nebraska","Lancaster County",1,72,2636,1216,1420
050,31,109,"Nebraska","Lancaster County",1,73,2544,1184,1360
050,31,109,"Nebraska","Lancaster County",1,74,1696,788,908
050,31,109,"Nebraska","Lancaster County",1,75,1725,788,937
050,31,109,"Nebraska","Lancaster County",1,76,1678,778,900
050,31,109,"Nebraska","Lancaster County",1,77,1566,746,820
050,31,109,"Nebraska","Lancaster County",1,78,1349,604,745
050,31,109,"Nebraska","Lancaster County",1,79,1225,559,666
050,31,109,"Nebraska","Lancaster County",1,80,1090,477,613
050,31,109,"Nebraska","Lancaster County",1,81,1085,460,625
050,31,109,"Nebraska","Lancaster County",1,82,968,409,559
050,31,109,"Nebraska","Lancaster County",1,83,899,375,524
050,31,109,"Nebraska","Lancaster County",1,84,841,334,507
050,31,109,"Nebraska","Lancaster County",1,85,5066,1760,3306
050,31,109,"Nebraska","Lancaster County",2,0,3784,1923,1861
050,31,109,"Nebraska","Lancaster County",2,1,3773,1946,1827
050,31,109,"Nebraska","Lancaster County",2,2,3807,1971,1836
050,31,109,"Nebraska","Lancaster County",2,3,3956,2030,1926
050,31,109,"Nebraska","Lancaster County",2,4,4055,2119,1936
050,31,109,"Nebraska","Lancaster County",2,5,4054,2159,1895
050,31,109,"Nebraska","Lancaster County",2,6,4087,2095,1992
050,31,109,"Nebraska","Lancaster County",2,7,4083,2064,2019
050,31,109,"Nebraska","Lancaster County",2,8,4043,2108,1935
050,31,109,"Nebraska","Lancaster County",2,9,4089,2108,1981
050,31,109,"Nebraska","Lancaster County",2,10,4201,2124,2077
050,31,109,"Nebraska","Lancaster County",2,11,4354,2212,2142
050,31,109,"Nebraska","Lancaster County",2,12,4436,2276,2160
050,31,109,"Nebraska","Lancaster County",2,13,4342,2241,2101
050,31,109,"Nebraska","Lancaster County",2,14,4289,2219,2070
050,31,109,"Nebraska","Lancaster County",2,15,4240,2172,2068
050,31,109,"Nebraska","Lancaster County",2,16,4237,2175,2062
050,31,109,"Nebraska","Lancaster County",2,17,4138,2085,2053
050,31,109,"Nebraska","Lancaster County",2,18,4936,2370,2566
050,31,109,"Nebraska","Lancaster County",2,19,7266,3645,3621
050,31,109,"Nebraska","Lancaster County",2,20,8021,3858,4163
050,31,109,"Nebraska","Lancaster County",2,21,7847,3997,3850
050,31,109,"Nebraska","Lancaster County",2,22,6960,3465,3495
050,31,109,"Nebraska","Lancaster County",2,23,6578,3417,3161
050,31,109,"Nebraska","Lancaster County",2,24,5756,3020,2736
050,31,109,"Nebraska","Lancaster County",2,25,5212,2741,2471
050,31,109,"Nebraska","Lancaster County",2,26,4995,2615,2380
050,31,109,"Nebraska","Lancaster County",2,27,4710,2463,2247
050,31,109,"Nebraska","Lancaster County",2,28,4562,2378,2184
050,31,109,"Nebraska","Lancaster County",2,29,4347,2274,2073
050,31,109,"Nebraska","Lancaster County",2,30,4173,2225,1948
050,31,109,"Nebraska","Lancaster County",2,31,4050,2193,1857
050,31,109,"Nebraska","Lancaster County",2,32,3967,2115,1852
050,31,109,"Nebraska","Lancaster County",2,33,3960,2105,1855
050,31,109,"Nebraska","Lancaster County",2,34,4059,2119,1940
050,31,109,"Nebraska","Lancaster County",2,35,4262,2221,2041
050,31,109,"Nebraska","Lancaster County",2,36,4279,2200,2079
050,31,109,"Nebraska","Lancaster County",2,37,4456,2306,2150
050,31,109,"Nebraska","Lancaster County",2,38,4502,2338,2164
050,31,109,"Nebraska","Lancaster County",2,39,4358,2245,2113
050,31,109,"Nebraska","Lancaster County",2,40,4143,2107,2036
050,31,109,"Nebraska","Lancaster County",2,41,4012,2077,1935
050,31,109,"Nebraska","Lancaster County",2,42,3920,2028,1892
050,31,109,"Nebraska","Lancaster County",2,43,3833,1992,1841
050,31,109,"Nebraska","Lancaster County",2,44,3656,1950,1706
050,31,109,"Nebraska","Lancaster County",2,45,3645,1936,1709
050,31,109,"Nebraska","Lancaster County",2,46,3465,1801,1664
050,31,109,"Nebraska","Lancaster County",2,47,3316,1715,1601
050,31,109,"Nebraska","Lancaster County",2,48,3478,1813,1665
050,31,109,"Nebraska","Lancaster County",2,49,3666,1913,1753
050,31,109,"Nebraska","Lancaster County",2,50,3550,1832,1718
050,31,109,"Nebraska","Lancaster County",2,51,3443,1789,1654
050,31,109,"Nebraska","Lancaster County",2,52,3250,1680,1570
050,31,109,"Nebraska","Lancaster County",2,53,3191,1633,1558
050,31,109,"Nebraska","Lancaster County",2,54,3159,1639,1520
050,31,109,"Nebraska","Lancaster County",2,55,3331,1709,1622
050,31,109,"Nebraska","Lancaster County",2,56,3518,1762,1756
050,31,109,"Nebraska","Lancaster County",2,57,3581,1781,1800
050,31,109,"Nebraska","Lancaster County",2,58,3630,1784,1846
050,31,109,"Nebraska","Lancaster County",2,59,3655,1786,1869
050,31,109,"Nebraska","Lancaster County",2,60,3625,1763,1862
050,31,109,"Nebraska","Lancaster County",2,61,3625,1756,1869
050,31,109,"Nebraska","Lancaster County",2,62,3594,1740,1854
050,31,109,"Nebraska","Lancaster County",2,63,3565,1747,1818
050,31,109,"Nebraska","Lancaster County",2,64,3493,1719,1774
050,31,109,"Nebraska","Lancaster County",2,65,3454,1687,1767
050,31,109,"Nebraska","Lancaster County",2,66,3349,1601,1748
050,31,109,"Nebraska","Lancaster County",2,67,3252,1544,1708
050,31,109,"Nebraska","Lancaster County",2,68,3184,1506,1678
050,31,109,"Nebraska","Lancaster County",2,69,3070,1460,1610
050,31,109,"Nebraska","Lancaster County",2,70,2875,1348,1527
050,31,109,"Nebraska","Lancaster County",2,71,2750,1275,1475
050,31,109,"Nebraska","Lancaster County",2,72,2611,1206,1405
050,31,109,"Nebraska","Lancaster County",2,73,2669,1238,1431
050,31,109,"Nebraska","Lancaster County",2,74,1781,827,954
050,31,109,"Nebraska","Lancaster County",2,75,1718,789,929
050,31,109,"Nebraska","Lancaster County",2,76,1663,768,895
050,31,109,"Nebraska","Lancaster County",2,77,1621,770,851
050,31,109,"Nebraska","Lancaster County",2,78,1360,614,746
050,31,109,"Nebraska","Lancaster County",2,79,1239,561,678
050,31,109,"Nebraska","Lancaster County",2,80,1106,490,616
050,31,109,"Nebraska","Lancaster County",2,81,1083,463,620
050,31,109,"Nebraska","Lancaster County",2,82,984,415,569
050,31,109,"Nebraska","Lancaster County",2,83,907,380,527
050,31,109,"Nebraska","Lancaster County",2,84,845,335,510
050,31,109,"Nebraska","Lancaster County",2,85,5076,1763,3313
050,31,109,"Nebraska","Lancaster County",3,0,3727,1949,1778
050,31,109,"Nebraska","Lancaster County",3,1,3692,1893,1799
050,31,109,"Nebraska","Lancaster County",3,2,3740,1929,1811
050,31,109,"Nebraska","Lancaster County",3,3,3851,1999,1852
050,31,109,"Nebraska","Lancaster County",3,4,3903,2004,1899
050,31,109,"Nebraska","Lancaster County",3,5,4065,2105,1960
050,31,109,"Nebraska","Lancaster County",3,6,4036,2134,1902
050,31,109,"Nebraska","Lancaster County",3,7,4101,2108,1993
050,31,109,"Nebraska","Lancaster County",3,8,4101,2078,2023
050,31,109,"Nebraska","Lancaster County",3,9,4008,2089,1919
050,31,109,"Nebraska","Lancaster County",3,10,4088,2105,1983
050,31,109,"Nebraska","Lancaster County",3,11,4188,2121,2067
050,31,109,"Nebraska","Lancaster County",3,12,4353,2224,2129
050,31,109,"Nebraska","Lancaster County",3,13,4466,2288,2178
050,31,109,"Nebraska","Lancaster County",3,14,4342,2235,2107
050,31,109,"Nebraska","Lancaster County",3,15,4290,2214,2076
050,31,109,"Nebraska","Lancaster County",3,16,4226,2162,2064
050,31,109,"Nebraska","Lancaster County",3,17,4270,2189,2081
050,31,109,"Nebraska","Lancaster County",3,18,4860,2367,2493
050,31,109,"Nebraska","Lancaster County",3,19,6695,3355,3340
050,31,109,"Nebraska","Lancaster County",3,20,7638,3657,3981
050,31,109,"Nebraska","Lancaster County",3,21,7742,3909,3833
050,31,109,"Nebraska","Lancaster County",3,22,7020,3534,3486
050,31,109,"Nebraska","Lancaster County",3,23,6593,3457,3136
050,31,109,"Nebraska","Lancaster County",3,24,5847,3063,2784
050,31,109,"Nebraska","Lancaster County",3,25,5164,2697,2467
050,31,109,"Nebraska","Lancaster County",3,26,4908,2591,2317
050,31,109,"Nebraska","Lancaster County",3,27,4657,2425,2232
050,31,109,"Nebraska","Lancaster County",3,28,4624,2427,2197
050,31,109,"Nebraska","Lancaster County",3,29,4503,2338,2165
050,31,109,"Nebraska","Lancaster County",3,30,4241,2205,2036
050,31,109,"Nebraska","Lancaster County",3,31,4091,2187,1904
050,31,109,"Nebraska","Lancaster County",3,32,4014,2160,1854
050,31,109,"Nebraska","Lancaster County",3,33,3968,2148,1820
050,31,109,"Nebraska","Lancaster County",3,34,3946,2086,1860
050,31,109,"Nebraska","Lancaster County",3,35,4074,2136,1938
050,31,109,"Nebraska","Lancaster County",3,36,4276,2205,2071
050,31,109,"Nebraska","Lancaster County",3,37,4250,2177,2073
050,31,109,"Nebraska","Lancaster County",3,38,4476,2321,2155
050,31,109,"Nebraska","Lancaster County",3,39,4483,2314,2169
050,31,109,"Nebraska","Lancaster County",3,40,4349,2222,2127
050,31,109,"Nebraska","Lancaster County",3,41,4144,2123,2021
050,31,109,"Nebraska","Lancaster County",3,42,3964,2037,1927
050,31,109,"Nebraska","Lancaster County",3,43,3924,2037,1887
050,31,109,"Nebraska","Lancaster County",3,44,3771,1941,1830
050,31,109,"Nebraska","Lancaster County",3,45,3674,1966,1708
050,31,109,"Nebraska","Lancaster County",3,46,3614,1917,1697
050,31,109,"Nebraska","Lancaster County",3,47,3421,1753,1668
050,31,109,"Nebraska","Lancaster County",3,48,3353,1750,1603
050,31,109,"Nebraska","Lancaster County",3,49,3498,1835,1663
050,31,109,"Nebraska","Lancaster County",3,50,3598,1864,1734
050,31,109,"Nebraska","Lancaster County",3,51,3550,1830,1720
050,31,109,"Nebraska","Lancaster County",3,52,3417,1761,1656
050,31,109,"Nebraska","Lancaster County",3,53,3250,1659,1591
050,31,109,"Nebraska","Lancaster County",3,54,3167,1618,1549
050,31,109,"Nebraska","Lancaster County",3,55,3133,1612,1521
050,31,109,"Nebraska","Lancaster County",3,56,3305,1688,1617
050,31,109,"Nebraska","Lancaster County",3,57,3500,1741,1759
050,31,109,"Nebraska","Lancaster County",3,58,3587,1777,1810
050,31,109,"Nebraska","Lancaster County",3,59,3610,1764,1846
050,31,109,"Nebraska","Lancaster County",3,60,3670,1782,1888
050,31,109,"Nebraska","Lancaster County",3,61,3585,1745,1840
050,31,109,"Nebraska","Lancaster County",3,62,3606,1737,1869
050,31,109,"Nebraska","Lancaster County",3,63,3529,1688,1841
050,31,109,"Nebraska","Lancaster County",3,64,3515,1726,1789
050,31,109,"Nebraska","Lancaster County",3,65,3478,1717,1761
050,31,109,"Nebraska","Lancaster County",3,66,3412,1662,1750
050,31,109,"Nebraska","Lancaster County",3,67,3323,1579,1744
050,31,109,"Nebraska","Lancaster County",3,68,3236,1535,1701
050,31,109,"Nebraska","Lancaster County",3,69,3127,1483,1644
050,31,109,"Nebraska","Lancaster County",3,70,3013,1420,1593
050,31,109,"Nebraska","Lancaster County",3,71,2832,1317,1515
050,31,109,"Nebraska","Lancaster County",3,72,2701,1257,1444
050,31,109,"Nebraska","Lancaster County",3,73,2557,1170,1387
050,31,109,"Nebraska","Lancaster County",3,74,2605,1197,1408
050,31,109,"Nebraska","Lancaster County",3,75,1731,796,935
050,31,109,"Nebraska","Lancaster County",3,76,1661,750,911
050,31,109,"Nebraska","Lancaster County",3,77,1611,744,867
050,31,109,"Nebraska","Lancaster County",3,78,1546,712,834
050,31,109,"Nebraska","Lancaster County",3,79,1313,585,728
050,31,109,"Nebraska","Lancaster County",3,80,1168,534,634
050,31,109,"Nebraska","Lancaster County",3,81,1070,460,610
050,31,109,"Nebraska","Lancaster County",3,82,988,410,578
050,31,109,"Nebraska","Lancaster County",3,83,942,404,538
050,31,109,"Nebraska","Lancaster County",3,84,823,328,495
050,31,109,"Nebraska","Lancaster County",3,85,5016,1760,3256
050,31,109,"Nebraska","Lancaster County",4,0,3648,1891,1757
050,31,109,"Nebraska","Lancaster County",4,1,3706,1925,1781
050,31,109,"Nebraska","Lancaster County",4,2,3708,1908,1800
050,31,109,"Nebraska","Lancaster County",4,3,3774,1953,1821
050,31,109,"Nebraska","Lancaster County",4,4,3809,1958,1851
050,31,109,"Nebraska","Lancaster County",4,5,3897,1987,1910
050,31,109,"Nebraska","Lancaster County",4,6,4081,2124,1957
050,31,109,"Nebraska","Lancaster County",4,7,3995,2114,1881
050,31,109,"Nebraska","Lancaster County",4,8,4081,2108,1973
050,31,109,"Nebraska","Lancaster County",4,9,4157,2097,2060
050,31,109,"Nebraska","Lancaster County",4,10,3997,2097,1900
050,31,109,"Nebraska","Lancaster County",4,11,4101,2094,2007
050,31,109,"Nebraska","Lancaster County",4,12,4184,2116,2068
050,31,109,"Nebraska","Lancaster County",4,13,4351,2211,2140
050,31,109,"Nebraska","Lancaster County",4,14,4474,2308,2166
050,31,109,"Nebraska","Lancaster County",4,15,4352,2240,2112
050,31,109,"Nebraska","Lancaster County",4,16,4301,2214,2087
050,31,109,"Nebraska","Lancaster County",4,17,4253,2191,2062
050,31,109,"Nebraska","Lancaster County",4,18,5034,2462,2572
050,31,109,"Nebraska","Lancaster County",4,19,7028,3523,3505
050,31,109,"Nebraska","Lancaster County",4,20,7828,3735,4093
050,31,109,"Nebraska","Lancaster County",4,21,7851,3936,3915
050,31,109,"Nebraska","Lancaster County",4,22,7173,3545,3628
050,31,109,"Nebraska","Lancaster County",4,23,6611,3512,3099
050,31,109,"Nebraska","Lancaster County",4,24,5708,2999,2709
050,31,109,"Nebraska","Lancaster County",4,25,5192,2732,2460
050,31,109,"Nebraska","Lancaster County",4,26,4772,2476,2296
050,31,109,"Nebraska","Lancaster County",4,27,4584,2396,2188
050,31,109,"Nebraska","Lancaster County",4,28,4518,2357,2161
050,31,109,"Nebraska","Lancaster County",4,29,4530,2367,2163
050,31,109,"Nebraska","Lancaster County",4,30,4371,2250,2121
050,31,109,"Nebraska","Lancaster County",4,31,4202,2173,2029
050,31,109,"Nebraska","Lancaster County",4,32,4011,2101,1910
050,31,109,"Nebraska","Lancaster County",4,33,3985,2153,1832
050,31,109,"Nebraska","Lancaster County",4,34,3915,2100,1815
050,31,109,"Nebraska","Lancaster County",4,35,3936,2063,1873
050,31,109,"Nebraska","Lancaster County",4,36,4017,2071,1946
050,31,109,"Nebraska","Lancaster County",4,37,4222,2167,2055
050,31,109,"Nebraska","Lancaster County",4,38,4258,2182,2076
050,31,109,"Nebraska","Lancaster County",4,39,4401,2264,2137
050,31,109,"Nebraska","Lancaster County",4,40,4398,2248,2150
050,31,109,"Nebraska","Lancaster County",4,41,4314,2213,2101
050,31,109,"Nebraska","Lancaster County",4,42,4109,2089,2020
050,31,109,"Nebraska","Lancaster County",4,43,3934,2036,1898
050,31,109,"Nebraska","Lancaster County",4,44,3874,1985,1889
050,31,109,"Nebraska","Lancaster County",4,45,3739,1916,1823
050,31,109,"Nebraska","Lancaster County",4,46,3650,1942,1708
050,31,109,"Nebraska","Lancaster County",4,47,3550,1858,1692
050,31,109,"Nebraska","Lancaster County",4,48,3386,1728,1658
050,31,109,"Nebraska","Lancaster County",4,49,3323,1732,1591
050,31,109,"Nebraska","Lancaster County",4,50,3408,1757,1651
050,31,109,"Nebraska","Lancaster County",4,51,3532,1837,1695
050,31,109,"Nebraska","Lancaster County",4,52,3497,1806,1691
050,31,109,"Nebraska","Lancaster County",4,53,3368,1712,1656
050,31,109,"Nebraska","Lancaster County",4,54,3203,1633,1570
050,31,109,"Nebraska","Lancaster County",4,55,3129,1585,1544
050,31,109,"Nebraska","Lancaster County",4,56,3112,1587,1525
050,31,109,"Nebraska","Lancaster County",4,57,3258,1670,1588
050,31,109,"Nebraska","Lancaster County",4,58,3491,1729,1762
050,31,109,"Nebraska","Lancaster County",4,59,3531,1748,1783
050,31,109,"Nebraska","Lancaster County",4,60,3534,1726,1808
050,31,109,"Nebraska","Lancaster County",4,61,3639,1758,1881
050,31,109,"Nebraska","Lancaster County",4,62,3562,1717,1845
050,31,109,"Nebraska","Lancaster County",4,63,3539,1693,1846
050,31,109,"Nebraska","Lancaster County",4,64,3500,1659,1841
050,31,109,"Nebraska","Lancaster County",4,65,3512,1717,1795
050,31,109,"Nebraska","Lancaster County",4,66,3407,1659,1748
050,31,109,"Nebraska","Lancaster County",4,67,3362,1631,1731
050,31,109,"Nebraska","Lancaster County",4,68,3270,1537,1733
050,31,109,"Nebraska","Lancaster County",4,69,3187,1511,1676
050,31,109,"Nebraska","Lancaster County",4,70,3085,1432,1653
050,31,109,"Nebraska","Lancaster County",4,71,2968,1388,1580
050,31,109,"Nebraska","Lancaster County",4,72,2803,1312,1491
050,31,109,"Nebraska","Lancaster County",4,73,2674,1243,1431
050,31,109,"Nebraska","Lancaster County",4,74,2512,1143,1369
050,31,109,"Nebraska","Lancaster County",4,75,2535,1155,1380
050,31,109,"Nebraska","Lancaster County",4,76,1695,775,920
050,31,109,"Nebraska","Lancaster County",4,77,1635,745,890
050,31,109,"Nebraska","Lancaster County",4,78,1539,700,839
050,31,109,"Nebraska","Lancaster County",4,79,1512,691,821
050,31,109,"Nebraska","Lancaster County",4,80,1245,555,690
050,31,109,"Nebraska","Lancaster County",4,81,1154,507,647
050,31,109,"Nebraska","Lancaster County",4,82,978,406,572
050,31,109,"Nebraska","Lancaster County",4,83,958,393,565
050,31,109,"Nebraska","Lancaster County",4,84,862,358,504
050,31,109,"Nebraska","Lancaster County",4,85,4945,1751,3194
050,31,109,"Nebraska","Lancaster County",5,0,3661,1897,1764
050,31,109,"Nebraska","Lancaster County",5,1,3658,1901,1757
050,31,109,"Nebraska","Lancaster County",5,2,3722,1922,1800
050,31,109,"Nebraska","Lancaster County",5,3,3775,1930,1845
050,31,109,"Nebraska","Lancaster County",5,4,3764,1959,1805
050,31,109,"Nebraska","Lancaster County",5,5,3856,1966,1890
050,31,109,"Nebraska","Lancaster County",5,6,3924,2010,1914
050,31,109,"Nebraska","Lancaster County",5,7,4079,2118,1961
050,31,109,"Nebraska","Lancaster County",5,8,3999,2112,1887
050,31,109,"Nebraska","Lancaster County",5,9,4124,2105,2019
050,31,109,"Nebraska","Lancaster County",5,10,4120,2068,2052
050,31,109,"Nebraska","Lancaster County",5,11,4028,2112,1916
050,31,109,"Nebraska","Lancaster County",5,12,4122,2105,2017
050,31,109,"Nebraska","Lancaster County",5,13,4201,2133,2068
050,31,109,"Nebraska","Lancaster County",5,14,4375,2232,2143
050,31,109,"Nebraska","Lancaster County",5,15,4498,2321,2177
050,31,109,"Nebraska","Lancaster County",5,16,4365,2250,2115
050,31,109,"Nebraska","Lancaster County",5,17,4339,2251,2088
050,31,109,"Nebraska","Lancaster County",5,18,5013,2480,2533
050,31,109,"Nebraska","Lancaster County",5,19,7112,3582,3530
050,31,109,"Nebraska","Lancaster County",5,20,7985,3811,4174
050,31,109,"Nebraska","Lancaster County",5,21,7885,3967,3918
050,31,109,"Nebraska","Lancaster County",5,22,7284,3605,3679
050,31,109,"Nebraska","Lancaster County",5,23,6769,3550,3219
050,31,109,"Nebraska","Lancaster County",5,24,5866,3150,2716
050,31,109,"Nebraska","Lancaster County",5,25,5147,2707,2440
050,31,109,"Nebraska","Lancaster County",5,26,4864,2577,2287
050,31,109,"Nebraska","Lancaster County",5,27,4475,2307,2168
050,31,109,"Nebraska","Lancaster County",5,28,4447,2330,2117
050,31,109,"Nebraska","Lancaster County",5,29,4444,2314,2130
050,31,109,"Nebraska","Lancaster County",5,30,4386,2271,2115
050,31,109,"Nebraska","Lancaster County",5,31,4295,2209,2086
050,31,109,"Nebraska","Lancaster County",5,32,4183,2155,2028
050,31,109,"Nebraska","Lancaster County",5,33,4027,2118,1909
050,31,109,"Nebraska","Lancaster County",5,34,3953,2113,1840
050,31,109,"Nebraska","Lancaster County",5,35,3921,2106,1815
050,31,109,"Nebraska","Lancaster County",5,36,3923,2045,1878
050,31,109,"Nebraska","Lancaster County",5,37,4013,2088,1925
050,31,109,"Nebraska","Lancaster County",5,38,4236,2172,2064
050,31,109,"Nebraska","Lancaster County",5,39,4280,2176,2104
050,31,109,"Nebraska","Lancaster County",5,40,4373,2237,2136
050,31,109,"Nebraska","Lancaster County",5,41,4396,2253,2143
050,31,109,"Nebraska","Lancaster County",5,42,4270,2167,2103
050,31,109,"Nebraska","Lancaster County",5,43,4114,2092,2022
050,31,109,"Nebraska","Lancaster County",5,44,3909,2020,1889
050,31,109,"Nebraska","Lancaster County",5,45,3886,1990,1896
050,31,109,"Nebraska","Lancaster County",5,46,3732,1899,1833
050,31,109,"Nebraska","Lancaster County",5,47,3622,1899,1723
050,31,109,"Nebraska","Lancaster County",5,48,3556,1887,1669
050,31,109,"Nebraska","Lancaster County",5,49,3369,1719,1650
050,31,109,"Nebraska","Lancaster County",5,50,3294,1694,1600
050,31,109,"Nebraska","Lancaster County",5,51,3400,1759,1641
050,31,109,"Nebraska","Lancaster County",5,52,3533,1847,1686
050,31,109,"Nebraska","Lancaster County",5,53,3501,1789,1712
050,31,109,"Nebraska","Lancaster County",5,54,3351,1719,1632
050,31,109,"Nebraska","Lancaster County",5,55,3219,1616,1603
050,31,109,"Nebraska","Lancaster County",5,56,3125,1573,1552
050,31,109,"Nebraska","Lancaster County",5,57,3081,1573,1508
050,31,109,"Nebraska","Lancaster County",5,58,3244,1644,1600
050,31,109,"Nebraska","Lancaster County",5,59,3474,1728,1746
050,31,109,"Nebraska","Lancaster County",5,60,3509,1736,1773
050,31,109,"Nebraska","Lancaster County",5,61,3487,1699,1788
050,31,109,"Nebraska","Lancaster County",5,62,3614,1725,1889
050,31,109,"Nebraska","Lancaster County",5,63,3498,1670,1828
050,31,109,"Nebraska","Lancaster County",5,64,3482,1653,1829
050,31,109,"Nebraska","Lancaster County",5,65,3505,1657,1848
050,31,109,"Nebraska","Lancaster County",5,66,3445,1682,1763
050,31,109,"Nebraska","Lancaster County",5,67,3374,1627,1747
050,31,109,"Nebraska","Lancaster County",5,68,3325,1601,1724
050,31,109,"Nebraska","Lancaster County",5,69,3220,1508,1712
050,31,109,"Nebraska","Lancaster County",5,70,3135,1467,1668
050,31,109,"Nebraska","Lancaster County",5,71,3043,1401,1642
050,31,109,"Nebraska","Lancaster County",5,72,2967,1403,1564
050,31,109,"Nebraska","Lancaster County",5,73,2750,1282,1468
050,31,109,"Nebraska","Lancaster County",5,74,2616,1215,1401
050,31,109,"Nebraska","Lancaster County",5,75,2450,1109,1341
050,31,109,"Nebraska","Lancaster County",5,76,2483,1122,1361
050,31,109,"Nebraska","Lancaster County",5,77,1658,766,892
050,31,109,"Nebraska","Lancaster County",5,78,1584,703,881
050,31,109,"Nebraska","Lancaster County",5,79,1505,678,827
050,31,109,"Nebraska","Lancaster County",5,80,1430,650,780
050,31,109,"Nebraska","Lancaster County",5,81,1222,530,692
050,31,109,"Nebraska","Lancaster County",5,82,1049,449,600
050,31,109,"Nebraska","Lancaster County",5,83,954,390,564
050,31,109,"Nebraska","Lancaster County",5,84,879,344,535
050,31,109,"Nebraska","Lancaster County",5,85,4965,1797,3168
050,31,111,"Nebraska","Lincoln County",1,0,396,200,196
050,31,111,"Nebraska","Lincoln County",1,1,405,201,204
050,31,111,"Nebraska","Lincoln County",1,2,404,214,190
050,31,111,"Nebraska","Lincoln County",1,3,407,211,196
050,31,111,"Nebraska","Lincoln County",1,4,428,215,213
050,31,111,"Nebraska","Lincoln County",1,5,412,219,193
050,31,111,"Nebraska","Lincoln County",1,6,424,229,195
050,31,111,"Nebraska","Lincoln County",1,7,436,233,203
050,31,111,"Nebraska","Lincoln County",1,8,431,214,217
050,31,111,"Nebraska","Lincoln County",1,9,417,209,208
050,31,111,"Nebraska","Lincoln County",1,10,482,240,242
050,31,111,"Nebraska","Lincoln County",1,11,496,250,246
050,31,111,"Nebraska","Lincoln County",1,12,509,253,256
050,31,111,"Nebraska","Lincoln County",1,13,517,263,254
050,31,111,"Nebraska","Lincoln County",1,14,509,254,255
050,31,111,"Nebraska","Lincoln County",1,15,510,250,260
050,31,111,"Nebraska","Lincoln County",1,16,512,265,247
050,31,111,"Nebraska","Lincoln County",1,17,456,234,222
050,31,111,"Nebraska","Lincoln County",1,18,403,196,207
050,31,111,"Nebraska","Lincoln County",1,19,368,193,175
050,31,111,"Nebraska","Lincoln County",1,20,352,194,158
050,31,111,"Nebraska","Lincoln County",1,21,319,184,135
050,31,111,"Nebraska","Lincoln County",1,22,326,167,159
050,31,111,"Nebraska","Lincoln County",1,23,350,175,175
050,31,111,"Nebraska","Lincoln County",1,24,350,189,161
050,31,111,"Nebraska","Lincoln County",1,25,341,184,157
050,31,111,"Nebraska","Lincoln County",1,26,363,189,174
050,31,111,"Nebraska","Lincoln County",1,27,395,202,193
050,31,111,"Nebraska","Lincoln County",1,28,387,200,187
050,31,111,"Nebraska","Lincoln County",1,29,381,189,192
050,31,111,"Nebraska","Lincoln County",1,30,393,203,190
050,31,111,"Nebraska","Lincoln County",1,31,376,182,194
050,31,111,"Nebraska","Lincoln County",1,32,358,194,164
050,31,111,"Nebraska","Lincoln County",1,33,378,180,198
050,31,111,"Nebraska","Lincoln County",1,34,429,206,223
050,31,111,"Nebraska","Lincoln County",1,35,443,212,231
050,31,111,"Nebraska","Lincoln County",1,36,439,217,222
050,31,111,"Nebraska","Lincoln County",1,37,430,221,209
050,31,111,"Nebraska","Lincoln County",1,38,470,240,230
050,31,111,"Nebraska","Lincoln County",1,39,479,241,238
050,31,111,"Nebraska","Lincoln County",1,40,461,236,225
050,31,111,"Nebraska","Lincoln County",1,41,433,221,212
050,31,111,"Nebraska","Lincoln County",1,42,415,203,212
050,31,111,"Nebraska","Lincoln County",1,43,430,218,212
050,31,111,"Nebraska","Lincoln County",1,44,392,195,197
050,31,111,"Nebraska","Lincoln County",1,45,417,191,226
050,31,111,"Nebraska","Lincoln County",1,46,416,200,216
050,31,111,"Nebraska","Lincoln County",1,47,390,211,179
050,31,111,"Nebraska","Lincoln County",1,48,447,247,200
050,31,111,"Nebraska","Lincoln County",1,49,456,254,202
050,31,111,"Nebraska","Lincoln County",1,50,424,218,206
050,31,111,"Nebraska","Lincoln County",1,51,389,199,190
050,31,111,"Nebraska","Lincoln County",1,52,370,196,174
050,31,111,"Nebraska","Lincoln County",1,53,399,205,194
050,31,111,"Nebraska","Lincoln County",1,54,387,202,185
050,31,111,"Nebraska","Lincoln County",1,55,404,206,198
050,31,111,"Nebraska","Lincoln County",1,56,445,221,224
050,31,111,"Nebraska","Lincoln County",1,57,477,234,243
050,31,111,"Nebraska","Lincoln County",1,58,503,250,253
050,31,111,"Nebraska","Lincoln County",1,59,502,245,257
050,31,111,"Nebraska","Lincoln County",1,60,486,235,251
050,31,111,"Nebraska","Lincoln County",1,61,497,246,251
050,31,111,"Nebraska","Lincoln County",1,62,514,263,251
050,31,111,"Nebraska","Lincoln County",1,63,503,261,242
050,31,111,"Nebraska","Lincoln County",1,64,494,258,236
050,31,111,"Nebraska","Lincoln County",1,65,492,242,250
050,31,111,"Nebraska","Lincoln County",1,66,478,235,243
050,31,111,"Nebraska","Lincoln County",1,67,466,226,240
050,31,111,"Nebraska","Lincoln County",1,68,418,193,225
050,31,111,"Nebraska","Lincoln County",1,69,397,196,201
050,31,111,"Nebraska","Lincoln County",1,70,410,210,200
050,31,111,"Nebraska","Lincoln County",1,71,385,196,189
050,31,111,"Nebraska","Lincoln County",1,72,383,181,202
050,31,111,"Nebraska","Lincoln County",1,73,365,176,189
050,31,111,"Nebraska","Lincoln County",1,74,252,127,125
050,31,111,"Nebraska","Lincoln County",1,75,262,121,141
050,31,111,"Nebraska","Lincoln County",1,76,260,121,139
050,31,111,"Nebraska","Lincoln County",1,77,249,125,124
050,31,111,"Nebraska","Lincoln County",1,78,221,105,116
050,31,111,"Nebraska","Lincoln County",1,79,187,89,98
050,31,111,"Nebraska","Lincoln County",1,80,182,74,108
050,31,111,"Nebraska","Lincoln County",1,81,171,76,95
050,31,111,"Nebraska","Lincoln County",1,82,168,67,101
050,31,111,"Nebraska","Lincoln County",1,83,156,55,101
050,31,111,"Nebraska","Lincoln County",1,84,143,54,89
050,31,111,"Nebraska","Lincoln County",1,85,897,311,586
050,31,111,"Nebraska","Lincoln County",2,0,367,187,180
050,31,111,"Nebraska","Lincoln County",2,1,405,203,202
050,31,111,"Nebraska","Lincoln County",2,2,404,212,192
050,31,111,"Nebraska","Lincoln County",2,3,405,212,193
050,31,111,"Nebraska","Lincoln County",2,4,421,214,207
050,31,111,"Nebraska","Lincoln County",2,5,412,217,195
050,31,111,"Nebraska","Lincoln County",2,6,422,229,193
050,31,111,"Nebraska","Lincoln County",2,7,428,229,199
050,31,111,"Nebraska","Lincoln County",2,8,428,218,210
050,31,111,"Nebraska","Lincoln County",2,9,418,207,211
050,31,111,"Nebraska","Lincoln County",2,10,464,231,233
050,31,111,"Nebraska","Lincoln County",2,11,487,244,243
050,31,111,"Nebraska","Lincoln County",2,12,504,251,253
050,31,111,"Nebraska","Lincoln County",2,13,514,262,252
050,31,111,"Nebraska","Lincoln County",2,14,509,257,252
050,31,111,"Nebraska","Lincoln County",2,15,509,253,256
050,31,111,"Nebraska","Lincoln County",2,16,511,261,250
050,31,111,"Nebraska","Lincoln County",2,17,469,240,229
050,31,111,"Nebraska","Lincoln County",2,18,397,198,199
050,31,111,"Nebraska","Lincoln County",2,19,363,190,173
050,31,111,"Nebraska","Lincoln County",2,20,357,195,162
050,31,111,"Nebraska","Lincoln County",2,21,323,184,139
050,31,111,"Nebraska","Lincoln County",2,22,326,169,157
050,31,111,"Nebraska","Lincoln County",2,23,346,173,173
050,31,111,"Nebraska","Lincoln County",2,24,351,184,167
050,31,111,"Nebraska","Lincoln County",2,25,339,181,158
050,31,111,"Nebraska","Lincoln County",2,26,357,187,170
050,31,111,"Nebraska","Lincoln County",2,27,384,199,185
050,31,111,"Nebraska","Lincoln County",2,28,385,198,187
050,31,111,"Nebraska","Lincoln County",2,29,379,189,190
050,31,111,"Nebraska","Lincoln County",2,30,388,197,191
050,31,111,"Nebraska","Lincoln County",2,31,373,184,189
050,31,111,"Nebraska","Lincoln County",2,32,360,190,170
050,31,111,"Nebraska","Lincoln County",2,33,371,184,187
050,31,111,"Nebraska","Lincoln County",2,34,415,198,217
050,31,111,"Nebraska","Lincoln County",2,35,436,208,228
050,31,111,"Nebraska","Lincoln County",2,36,437,216,221
050,31,111,"Nebraska","Lincoln County",2,37,429,217,212
050,31,111,"Nebraska","Lincoln County",2,38,458,235,223
050,31,111,"Nebraska","Lincoln County",2,39,473,238,235
050,31,111,"Nebraska","Lincoln County",2,40,465,237,228
050,31,111,"Nebraska","Lincoln County",2,41,440,225,215
050,31,111,"Nebraska","Lincoln County",2,42,417,208,209
050,31,111,"Nebraska","Lincoln County",2,43,427,215,212
050,31,111,"Nebraska","Lincoln County",2,44,398,199,199
050,31,111,"Nebraska","Lincoln County",2,45,412,192,220
050,31,111,"Nebraska","Lincoln County",2,46,412,196,216
050,31,111,"Nebraska","Lincoln County",2,47,396,208,188
050,31,111,"Nebraska","Lincoln County",2,48,437,241,196
050,31,111,"Nebraska","Lincoln County",2,49,455,252,203
050,31,111,"Nebraska","Lincoln County",2,50,433,227,206
050,31,111,"Nebraska","Lincoln County",2,51,398,205,193
050,31,111,"Nebraska","Lincoln County",2,52,375,196,179
050,31,111,"Nebraska","Lincoln County",2,53,390,203,187
050,31,111,"Nebraska","Lincoln County",2,54,388,202,186
050,31,111,"Nebraska","Lincoln County",2,55,400,205,195
050,31,111,"Nebraska","Lincoln County",2,56,437,218,219
050,31,111,"Nebraska","Lincoln County",2,57,468,229,239
050,31,111,"Nebraska","Lincoln County",2,58,498,246,252
050,31,111,"Nebraska","Lincoln County",2,59,505,248,257
050,31,111,"Nebraska","Lincoln County",2,60,487,235,252
050,31,111,"Nebraska","Lincoln County",2,61,496,245,251
050,31,111,"Nebraska","Lincoln County",2,62,506,258,248
050,31,111,"Nebraska","Lincoln County",2,63,507,261,246
050,31,111,"Nebraska","Lincoln County",2,64,492,256,236
050,31,111,"Nebraska","Lincoln County",2,65,489,243,246
050,31,111,"Nebraska","Lincoln County",2,66,480,237,243
050,31,111,"Nebraska","Lincoln County",2,67,467,226,241
050,31,111,"Nebraska","Lincoln County",2,68,423,198,225
050,31,111,"Nebraska","Lincoln County",2,69,403,196,207
050,31,111,"Nebraska","Lincoln County",2,70,401,203,198
050,31,111,"Nebraska","Lincoln County",2,71,390,197,193
050,31,111,"Nebraska","Lincoln County",2,72,377,181,196
050,31,111,"Nebraska","Lincoln County",2,73,386,186,200
050,31,111,"Nebraska","Lincoln County",2,74,260,130,130
050,31,111,"Nebraska","Lincoln County",2,75,261,123,138
050,31,111,"Nebraska","Lincoln County",2,76,257,120,137
050,31,111,"Nebraska","Lincoln County",2,77,254,124,130
050,31,111,"Nebraska","Lincoln County",2,78,224,107,117
050,31,111,"Nebraska","Lincoln County",2,79,195,92,103
050,31,111,"Nebraska","Lincoln County",2,80,178,75,103
050,31,111,"Nebraska","Lincoln County",2,81,169,74,95
050,31,111,"Nebraska","Lincoln County",2,82,165,67,98
050,31,111,"Nebraska","Lincoln County",2,83,155,56,99
050,31,111,"Nebraska","Lincoln County",2,84,146,53,93
050,31,111,"Nebraska","Lincoln County",2,85,889,314,575
050,31,111,"Nebraska","Lincoln County",3,0,365,179,186
050,31,111,"Nebraska","Lincoln County",3,1,366,186,180
050,31,111,"Nebraska","Lincoln County",3,2,405,200,205
050,31,111,"Nebraska","Lincoln County",3,3,411,216,195
050,31,111,"Nebraska","Lincoln County",3,4,399,208,191
050,31,111,"Nebraska","Lincoln County",3,5,412,208,204
050,31,111,"Nebraska","Lincoln County",3,6,404,214,190
050,31,111,"Nebraska","Lincoln County",3,7,418,229,189
050,31,111,"Nebraska","Lincoln County",3,8,424,225,199
050,31,111,"Nebraska","Lincoln County",3,9,403,205,198
050,31,111,"Nebraska","Lincoln County",3,10,420,211,209
050,31,111,"Nebraska","Lincoln County",3,11,462,241,221
050,31,111,"Nebraska","Lincoln County",3,12,498,248,250
050,31,111,"Nebraska","Lincoln County",3,13,507,256,251
050,31,111,"Nebraska","Lincoln County",3,14,519,263,256
050,31,111,"Nebraska","Lincoln County",3,15,507,252,255
050,31,111,"Nebraska","Lincoln County",3,16,506,248,258
050,31,111,"Nebraska","Lincoln County",3,17,501,250,251
050,31,111,"Nebraska","Lincoln County",3,18,407,215,192
050,31,111,"Nebraska","Lincoln County",3,19,352,184,168
050,31,111,"Nebraska","Lincoln County",3,20,360,186,174
050,31,111,"Nebraska","Lincoln County",3,21,342,181,161
050,31,111,"Nebraska","Lincoln County",3,22,327,175,152
050,31,111,"Nebraska","Lincoln County",3,23,325,168,157
050,31,111,"Nebraska","Lincoln County",3,24,353,167,186
050,31,111,"Nebraska","Lincoln County",3,25,345,189,156
050,31,111,"Nebraska","Lincoln County",3,26,333,179,154
050,31,111,"Nebraska","Lincoln County",3,27,366,190,176
050,31,111,"Nebraska","Lincoln County",3,28,386,202,184
050,31,111,"Nebraska","Lincoln County",3,29,375,197,178
050,31,111,"Nebraska","Lincoln County",3,30,377,186,191
050,31,111,"Nebraska","Lincoln County",3,31,370,190,180
050,31,111,"Nebraska","Lincoln County",3,32,370,179,191
050,31,111,"Nebraska","Lincoln County",3,33,361,187,174
050,31,111,"Nebraska","Lincoln County",3,34,376,181,195
050,31,111,"Nebraska","Lincoln County",3,35,410,195,215
050,31,111,"Nebraska","Lincoln County",3,36,440,208,232
050,31,111,"Nebraska","Lincoln County",3,37,421,206,215
050,31,111,"Nebraska","Lincoln County",3,38,427,217,210
050,31,111,"Nebraska","Lincoln County",3,39,457,237,220
050,31,111,"Nebraska","Lincoln County",3,40,469,236,233
050,31,111,"Nebraska","Lincoln County",3,41,468,239,229
050,31,111,"Nebraska","Lincoln County",3,42,438,216,222
050,31,111,"Nebraska","Lincoln County",3,43,426,215,211
050,31,111,"Nebraska","Lincoln County",3,44,423,218,205
050,31,111,"Nebraska","Lincoln County",3,45,398,197,201
050,31,111,"Nebraska","Lincoln County",3,46,402,195,207
050,31,111,"Nebraska","Lincoln County",3,47,400,190,210
050,31,111,"Nebraska","Lincoln County",3,48,406,216,190
050,31,111,"Nebraska","Lincoln County",3,49,412,228,184
050,31,111,"Nebraska","Lincoln County",3,50,461,251,210
050,31,111,"Nebraska","Lincoln County",3,51,433,223,210
050,31,111,"Nebraska","Lincoln County",3,52,395,206,189
050,31,111,"Nebraska","Lincoln County",3,53,366,197,169
050,31,111,"Nebraska","Lincoln County",3,54,376,198,178
050,31,111,"Nebraska","Lincoln County",3,55,376,193,183
050,31,111,"Nebraska","Lincoln County",3,56,384,198,186
050,31,111,"Nebraska","Lincoln County",3,57,418,209,209
050,31,111,"Nebraska","Lincoln County",3,58,451,219,232
050,31,111,"Nebraska","Lincoln County",3,59,486,244,242
050,31,111,"Nebraska","Lincoln County",3,60,508,251,257
050,31,111,"Nebraska","Lincoln County",3,61,480,225,255
050,31,111,"Nebraska","Lincoln County",3,62,479,236,243
050,31,111,"Nebraska","Lincoln County",3,63,497,252,245
050,31,111,"Nebraska","Lincoln County",3,64,485,242,243
050,31,111,"Nebraska","Lincoln County",3,65,469,240,229
050,31,111,"Nebraska","Lincoln County",3,66,475,238,237
050,31,111,"Nebraska","Lincoln County",3,67,471,229,242
050,31,111,"Nebraska","Lincoln County",3,68,455,219,236
050,31,111,"Nebraska","Lincoln County",3,69,414,195,219
050,31,111,"Nebraska","Lincoln County",3,70,391,186,205
050,31,111,"Nebraska","Lincoln County",3,71,390,196,194
050,31,111,"Nebraska","Lincoln County",3,72,376,189,187
050,31,111,"Nebraska","Lincoln County",3,73,362,177,185
050,31,111,"Nebraska","Lincoln County",3,74,372,176,196
050,31,111,"Nebraska","Lincoln County",3,75,253,126,127
050,31,111,"Nebraska","Lincoln County",3,76,250,117,133
050,31,111,"Nebraska","Lincoln County",3,77,238,106,132
050,31,111,"Nebraska","Lincoln County",3,78,233,110,123
050,31,111,"Nebraska","Lincoln County",3,79,213,93,120
050,31,111,"Nebraska","Lincoln County",3,80,187,90,97
050,31,111,"Nebraska","Lincoln County",3,81,160,67,93
050,31,111,"Nebraska","Lincoln County",3,82,161,64,97
050,31,111,"Nebraska","Lincoln County",3,83,154,66,88
050,31,111,"Nebraska","Lincoln County",3,84,146,49,97
050,31,111,"Nebraska","Lincoln County",3,85,860,297,563
050,31,111,"Nebraska","Lincoln County",4,0,341,161,180
050,31,111,"Nebraska","Lincoln County",4,1,361,183,178
050,31,111,"Nebraska","Lincoln County",4,2,358,180,178
050,31,111,"Nebraska","Lincoln County",4,3,394,194,200
050,31,111,"Nebraska","Lincoln County",4,4,407,222,185
050,31,111,"Nebraska","Lincoln County",4,5,402,210,192
050,31,111,"Nebraska","Lincoln County",4,6,410,210,200
050,31,111,"Nebraska","Lincoln County",4,7,408,210,198
050,31,111,"Nebraska","Lincoln County",4,8,410,226,184
050,31,111,"Nebraska","Lincoln County",4,9,418,221,197
050,31,111,"Nebraska","Lincoln County",4,10,409,205,204
050,31,111,"Nebraska","Lincoln County",4,11,423,209,214
050,31,111,"Nebraska","Lincoln County",4,12,449,231,218
050,31,111,"Nebraska","Lincoln County",4,13,484,243,241
050,31,111,"Nebraska","Lincoln County",4,14,499,247,252
050,31,111,"Nebraska","Lincoln County",4,15,512,260,252
050,31,111,"Nebraska","Lincoln County",4,16,510,247,263
050,31,111,"Nebraska","Lincoln County",4,17,502,247,255
050,31,111,"Nebraska","Lincoln County",4,18,421,214,207
050,31,111,"Nebraska","Lincoln County",4,19,342,185,157
050,31,111,"Nebraska","Lincoln County",4,20,357,183,174
050,31,111,"Nebraska","Lincoln County",4,21,326,176,150
050,31,111,"Nebraska","Lincoln County",4,22,345,175,170
050,31,111,"Nebraska","Lincoln County",4,23,341,185,156
050,31,111,"Nebraska","Lincoln County",4,24,348,183,165
050,31,111,"Nebraska","Lincoln County",4,25,350,174,176
050,31,111,"Nebraska","Lincoln County",4,26,333,175,158
050,31,111,"Nebraska","Lincoln County",4,27,329,175,154
050,31,111,"Nebraska","Lincoln County",4,28,366,187,179
050,31,111,"Nebraska","Lincoln County",4,29,366,186,180
050,31,111,"Nebraska","Lincoln County",4,30,384,205,179
050,31,111,"Nebraska","Lincoln County",4,31,366,176,190
050,31,111,"Nebraska","Lincoln County",4,32,363,192,171
050,31,111,"Nebraska","Lincoln County",4,33,362,171,191
050,31,111,"Nebraska","Lincoln County",4,34,367,185,182
050,31,111,"Nebraska","Lincoln County",4,35,371,175,196
050,31,111,"Nebraska","Lincoln County",4,36,402,190,212
050,31,111,"Nebraska","Lincoln County",4,37,423,202,221
050,31,111,"Nebraska","Lincoln County",4,38,425,212,213
050,31,111,"Nebraska","Lincoln County",4,39,422,216,206
050,31,111,"Nebraska","Lincoln County",4,40,451,231,220
050,31,111,"Nebraska","Lincoln County",4,41,468,240,228
050,31,111,"Nebraska","Lincoln County",4,42,450,228,222
050,31,111,"Nebraska","Lincoln County",4,43,447,220,227
050,31,111,"Nebraska","Lincoln County",4,44,416,211,205
050,31,111,"Nebraska","Lincoln County",4,45,422,217,205
050,31,111,"Nebraska","Lincoln County",4,46,401,201,200
050,31,111,"Nebraska","Lincoln County",4,47,391,191,200
050,31,111,"Nebraska","Lincoln County",4,48,418,197,221
050,31,111,"Nebraska","Lincoln County",4,49,386,203,183
050,31,111,"Nebraska","Lincoln County",4,50,409,225,184
050,31,111,"Nebraska","Lincoln County",4,51,450,243,207
050,31,111,"Nebraska","Lincoln County",4,52,436,229,207
050,31,111,"Nebraska","Lincoln County",4,53,392,206,186
050,31,111,"Nebraska","Lincoln County",4,54,366,194,172
050,31,111,"Nebraska","Lincoln County",4,55,376,199,177
050,31,111,"Nebraska","Lincoln County",4,56,374,195,179
050,31,111,"Nebraska","Lincoln County",4,57,375,191,184
050,31,111,"Nebraska","Lincoln County",4,58,415,206,209
050,31,111,"Nebraska","Lincoln County",4,59,438,209,229
050,31,111,"Nebraska","Lincoln County",4,60,485,249,236
050,31,111,"Nebraska","Lincoln County",4,61,509,250,259
050,31,111,"Nebraska","Lincoln County",4,62,467,219,248
050,31,111,"Nebraska","Lincoln County",4,63,464,229,235
050,31,111,"Nebraska","Lincoln County",4,64,469,230,239
050,31,111,"Nebraska","Lincoln County",4,65,459,227,232
050,31,111,"Nebraska","Lincoln County",4,66,450,227,223
050,31,111,"Nebraska","Lincoln County",4,67,478,240,238
050,31,111,"Nebraska","Lincoln County",4,68,452,216,236
050,31,111,"Nebraska","Lincoln County",4,69,444,208,236
050,31,111,"Nebraska","Lincoln County",4,70,400,189,211
050,31,111,"Nebraska","Lincoln County",4,71,390,184,206
050,31,111,"Nebraska","Lincoln County",4,72,381,194,187
050,31,111,"Nebraska","Lincoln County",4,73,360,186,174
050,31,111,"Nebraska","Lincoln County",4,74,342,164,178
050,31,111,"Nebraska","Lincoln County",4,75,363,169,194
050,31,111,"Nebraska","Lincoln County",4,76,242,124,118
050,31,111,"Nebraska","Lincoln County",4,77,242,111,131
050,31,111,"Nebraska","Lincoln County",4,78,228,96,132
050,31,111,"Nebraska","Lincoln County",4,79,224,100,124
050,31,111,"Nebraska","Lincoln County",4,80,209,92,117
050,31,111,"Nebraska","Lincoln County",4,81,171,84,87
050,31,111,"Nebraska","Lincoln County",4,82,149,56,93
050,31,111,"Nebraska","Lincoln County",4,83,149,63,86
050,31,111,"Nebraska","Lincoln County",4,84,152,63,89
050,31,111,"Nebraska","Lincoln County",4,85,848,269,579
050,31,111,"Nebraska","Lincoln County",5,0,340,163,177
050,31,111,"Nebraska","Lincoln County",5,1,345,170,175
050,31,111,"Nebraska","Lincoln County",5,2,360,181,179
050,31,111,"Nebraska","Lincoln County",5,3,364,190,174
050,31,111,"Nebraska","Lincoln County",5,4,402,201,201
050,31,111,"Nebraska","Lincoln County",5,5,406,224,182
050,31,111,"Nebraska","Lincoln County",5,6,390,210,180
050,31,111,"Nebraska","Lincoln County",5,7,413,213,200
050,31,111,"Nebraska","Lincoln County",5,8,412,206,206
050,31,111,"Nebraska","Lincoln County",5,9,404,218,186
050,31,111,"Nebraska","Lincoln County",5,10,420,223,197
050,31,111,"Nebraska","Lincoln County",5,11,413,195,218
050,31,111,"Nebraska","Lincoln County",5,12,428,216,212
050,31,111,"Nebraska","Lincoln County",5,13,444,227,217
050,31,111,"Nebraska","Lincoln County",5,14,490,247,243
050,31,111,"Nebraska","Lincoln County",5,15,492,240,252
050,31,111,"Nebraska","Lincoln County",5,16,518,256,262
050,31,111,"Nebraska","Lincoln County",5,17,495,242,253
050,31,111,"Nebraska","Lincoln County",5,18,425,212,213
050,31,111,"Nebraska","Lincoln County",5,19,364,188,176
050,31,111,"Nebraska","Lincoln County",5,20,343,186,157
050,31,111,"Nebraska","Lincoln County",5,21,350,180,170
050,31,111,"Nebraska","Lincoln County",5,22,344,185,159
050,31,111,"Nebraska","Lincoln County",5,23,353,182,171
050,31,111,"Nebraska","Lincoln County",5,24,343,192,151
050,31,111,"Nebraska","Lincoln County",5,25,350,186,164
050,31,111,"Nebraska","Lincoln County",5,26,351,171,180
050,31,111,"Nebraska","Lincoln County",5,27,343,188,155
050,31,111,"Nebraska","Lincoln County",5,28,326,163,163
050,31,111,"Nebraska","Lincoln County",5,29,367,195,172
050,31,111,"Nebraska","Lincoln County",5,30,374,196,178
050,31,111,"Nebraska","Lincoln County",5,31,380,202,178
050,31,111,"Nebraska","Lincoln County",5,32,389,182,207
050,31,111,"Nebraska","Lincoln County",5,33,362,196,166
050,31,111,"Nebraska","Lincoln County",5,34,368,167,201
050,31,111,"Nebraska","Lincoln County",5,35,367,191,176
050,31,111,"Nebraska","Lincoln County",5,36,387,190,197
050,31,111,"Nebraska","Lincoln County",5,37,377,179,198
050,31,111,"Nebraska","Lincoln County",5,38,429,210,219
050,31,111,"Nebraska","Lincoln County",5,39,422,215,207
050,31,111,"Nebraska","Lincoln County",5,40,415,211,204
050,31,111,"Nebraska","Lincoln County",5,41,450,231,219
050,31,111,"Nebraska","Lincoln County",5,42,462,238,224
050,31,111,"Nebraska","Lincoln County",5,43,454,236,218
050,31,111,"Nebraska","Lincoln County",5,44,425,208,217
050,31,111,"Nebraska","Lincoln County",5,45,425,211,214
050,31,111,"Nebraska","Lincoln County",5,46,426,223,203
050,31,111,"Nebraska","Lincoln County",5,47,390,192,198
050,31,111,"Nebraska","Lincoln County",5,48,412,201,211
050,31,111,"Nebraska","Lincoln County",5,49,398,188,210
050,31,111,"Nebraska","Lincoln County",5,50,381,199,182
050,31,111,"Nebraska","Lincoln County",5,51,403,223,180
050,31,111,"Nebraska","Lincoln County",5,52,438,235,203
050,31,111,"Nebraska","Lincoln County",5,53,425,227,198
050,31,111,"Nebraska","Lincoln County",5,54,391,201,190
050,31,111,"Nebraska","Lincoln County",5,55,359,193,166
050,31,111,"Nebraska","Lincoln County",5,56,374,201,173
050,31,111,"Nebraska","Lincoln County",5,57,367,192,175
050,31,111,"Nebraska","Lincoln County",5,58,364,188,176
050,31,111,"Nebraska","Lincoln County",5,59,401,198,203
050,31,111,"Nebraska","Lincoln County",5,60,434,213,221
050,31,111,"Nebraska","Lincoln County",5,61,483,249,234
050,31,111,"Nebraska","Lincoln County",5,62,498,245,253
050,31,111,"Nebraska","Lincoln County",5,63,455,209,246
050,31,111,"Nebraska","Lincoln County",5,64,448,212,236
050,31,111,"Nebraska","Lincoln County",5,65,451,216,235
050,31,111,"Nebraska","Lincoln County",5,66,455,226,229
050,31,111,"Nebraska","Lincoln County",5,67,456,233,223
050,31,111,"Nebraska","Lincoln County",5,68,456,226,230
050,31,111,"Nebraska","Lincoln County",5,69,445,211,234
050,31,111,"Nebraska","Lincoln County",5,70,429,200,229
050,31,111,"Nebraska","Lincoln County",5,71,393,184,209
050,31,111,"Nebraska","Lincoln County",5,72,383,180,203
050,31,111,"Nebraska","Lincoln County",5,73,365,195,170
050,31,111,"Nebraska","Lincoln County",5,74,340,175,165
050,31,111,"Nebraska","Lincoln County",5,75,335,159,176
050,31,111,"Nebraska","Lincoln County",5,76,351,168,183
050,31,111,"Nebraska","Lincoln County",5,77,228,114,114
050,31,111,"Nebraska","Lincoln County",5,78,232,100,132
050,31,111,"Nebraska","Lincoln County",5,79,224,92,132
050,31,111,"Nebraska","Lincoln County",5,80,221,99,122
050,31,111,"Nebraska","Lincoln County",5,81,188,81,107
050,31,111,"Nebraska","Lincoln County",5,82,161,75,86
050,31,111,"Nebraska","Lincoln County",5,83,133,51,82
050,31,111,"Nebraska","Lincoln County",5,84,152,62,90
050,31,111,"Nebraska","Lincoln County",5,85,839,263,576
050,31,113,"Nebraska","Logan County",1,0,7,4,3
050,31,113,"Nebraska","Logan County",1,1,5,0,5
050,31,113,"Nebraska","Logan County",1,2,8,4,4
050,31,113,"Nebraska","Logan County",1,3,10,8,2
050,31,113,"Nebraska","Logan County",1,4,12,7,5
050,31,113,"Nebraska","Logan County",1,5,7,6,1
050,31,113,"Nebraska","Logan County",1,6,10,7,3
050,31,113,"Nebraska","Logan County",1,7,11,8,3
050,31,113,"Nebraska","Logan County",1,8,5,3,2
050,31,113,"Nebraska","Logan County",1,9,5,2,3
050,31,113,"Nebraska","Logan County",1,10,8,4,4
050,31,113,"Nebraska","Logan County",1,11,8,4,4
050,31,113,"Nebraska","Logan County",1,12,7,5,2
050,31,113,"Nebraska","Logan County",1,13,15,9,6
050,31,113,"Nebraska","Logan County",1,14,14,8,6
050,31,113,"Nebraska","Logan County",1,15,13,11,2
050,31,113,"Nebraska","Logan County",1,16,10,5,5
050,31,113,"Nebraska","Logan County",1,17,14,6,8
050,31,113,"Nebraska","Logan County",1,18,7,2,5
050,31,113,"Nebraska","Logan County",1,19,9,6,3
050,31,113,"Nebraska","Logan County",1,20,5,2,3
050,31,113,"Nebraska","Logan County",1,21,7,2,5
050,31,113,"Nebraska","Logan County",1,22,4,2,2
050,31,113,"Nebraska","Logan County",1,23,6,3,3
050,31,113,"Nebraska","Logan County",1,24,5,3,2
050,31,113,"Nebraska","Logan County",1,25,11,6,5
050,31,113,"Nebraska","Logan County",1,26,6,4,2
050,31,113,"Nebraska","Logan County",1,27,6,2,4
050,31,113,"Nebraska","Logan County",1,28,5,3,2
050,31,113,"Nebraska","Logan County",1,29,6,4,2
050,31,113,"Nebraska","Logan County",1,30,7,3,4
050,31,113,"Nebraska","Logan County",1,31,5,3,2
050,31,113,"Nebraska","Logan County",1,32,6,5,1
050,31,113,"Nebraska","Logan County",1,33,5,3,2
050,31,113,"Nebraska","Logan County",1,34,6,3,3
050,31,113,"Nebraska","Logan County",1,35,7,3,4
050,31,113,"Nebraska","Logan County",1,36,9,5,4
050,31,113,"Nebraska","Logan County",1,37,6,2,4
050,31,113,"Nebraska","Logan County",1,38,6,3,3
050,31,113,"Nebraska","Logan County",1,39,13,7,6
050,31,113,"Nebraska","Logan County",1,40,12,6,6
050,31,113,"Nebraska","Logan County",1,41,11,5,6
050,31,113,"Nebraska","Logan County",1,42,9,2,7
050,31,113,"Nebraska","Logan County",1,43,10,6,4
050,31,113,"Nebraska","Logan County",1,44,10,8,2
050,31,113,"Nebraska","Logan County",1,45,9,6,3
050,31,113,"Nebraska","Logan County",1,46,11,6,5
050,31,113,"Nebraska","Logan County",1,47,8,6,2
050,31,113,"Nebraska","Logan County",1,48,5,1,4
050,31,113,"Nebraska","Logan County",1,49,6,1,5
050,31,113,"Nebraska","Logan County",1,50,5,1,4
050,31,113,"Nebraska","Logan County",1,51,7,2,5
050,31,113,"Nebraska","Logan County",1,52,7,3,4
050,31,113,"Nebraska","Logan County",1,53,7,4,3
050,31,113,"Nebraska","Logan County",1,54,10,6,4
050,31,113,"Nebraska","Logan County",1,55,6,3,3
050,31,113,"Nebraska","Logan County",1,56,5,4,1
050,31,113,"Nebraska","Logan County",1,57,12,6,6
050,31,113,"Nebraska","Logan County",1,58,11,5,6
050,31,113,"Nebraska","Logan County",1,59,12,4,8
050,31,113,"Nebraska","Logan County",1,60,15,8,7
050,31,113,"Nebraska","Logan County",1,61,10,6,4
050,31,113,"Nebraska","Logan County",1,62,11,6,5
050,31,113,"Nebraska","Logan County",1,63,8,3,5
050,31,113,"Nebraska","Logan County",1,64,13,8,5
050,31,113,"Nebraska","Logan County",1,65,10,5,5
050,31,113,"Nebraska","Logan County",1,66,11,4,7
050,31,113,"Nebraska","Logan County",1,67,12,5,7
050,31,113,"Nebraska","Logan County",1,68,15,8,7
050,31,113,"Nebraska","Logan County",1,69,12,6,6
050,31,113,"Nebraska","Logan County",1,70,8,4,4
050,31,113,"Nebraska","Logan County",1,71,10,6,4
050,31,113,"Nebraska","Logan County",1,72,6,3,3
050,31,113,"Nebraska","Logan County",1,73,5,1,4
050,31,113,"Nebraska","Logan County",1,74,7,3,4
050,31,113,"Nebraska","Logan County",1,75,8,5,3
050,31,113,"Nebraska","Logan County",1,76,8,5,3
050,31,113,"Nebraska","Logan County",1,77,6,2,4
050,31,113,"Nebraska","Logan County",1,78,6,1,5
050,31,113,"Nebraska","Logan County",1,79,8,3,5
050,31,113,"Nebraska","Logan County",1,80,8,4,4
050,31,113,"Nebraska","Logan County",1,81,6,3,3
050,31,113,"Nebraska","Logan County",1,82,5,4,1
050,31,113,"Nebraska","Logan County",1,83,3,3,0
050,31,113,"Nebraska","Logan County",1,84,2,1,1
050,31,113,"Nebraska","Logan County",1,85,16,6,10
050,31,113,"Nebraska","Logan County",2,0,8,4,4
050,31,113,"Nebraska","Logan County",2,1,5,1,4
050,31,113,"Nebraska","Logan County",2,2,7,3,4
050,31,113,"Nebraska","Logan County",2,3,9,7,2
050,31,113,"Nebraska","Logan County",2,4,11,7,4
050,31,113,"Nebraska","Logan County",2,5,8,6,2
050,31,113,"Nebraska","Logan County",2,6,9,6,3
050,31,113,"Nebraska","Logan County",2,7,10,7,3
050,31,113,"Nebraska","Logan County",2,8,7,4,3
050,31,113,"Nebraska","Logan County",2,9,5,2,3
050,31,113,"Nebraska","Logan County",2,10,8,4,4
050,31,113,"Nebraska","Logan County",2,11,8,4,4
050,31,113,"Nebraska","Logan County",2,12,7,5,2
050,31,113,"Nebraska","Logan County",2,13,13,8,5
050,31,113,"Nebraska","Logan County",2,14,14,8,6
050,31,113,"Nebraska","Logan County",2,15,14,10,4
050,31,113,"Nebraska","Logan County",2,16,12,7,5
050,31,113,"Nebraska","Logan County",2,17,13,6,7
050,31,113,"Nebraska","Logan County",2,18,8,3,5
050,31,113,"Nebraska","Logan County",2,19,7,4,3
050,31,113,"Nebraska","Logan County",2,20,6,3,3
050,31,113,"Nebraska","Logan County",2,21,6,2,4
050,31,113,"Nebraska","Logan County",2,22,5,2,3
050,31,113,"Nebraska","Logan County",2,23,6,3,3
050,31,113,"Nebraska","Logan County",2,24,6,3,3
050,31,113,"Nebraska","Logan County",2,25,9,5,4
050,31,113,"Nebraska","Logan County",2,26,7,4,3
050,31,113,"Nebraska","Logan County",2,27,6,3,3
050,31,113,"Nebraska","Logan County",2,28,5,3,2
050,31,113,"Nebraska","Logan County",2,29,6,4,2
050,31,113,"Nebraska","Logan County",2,30,6,3,3
050,31,113,"Nebraska","Logan County",2,31,6,3,3
050,31,113,"Nebraska","Logan County",2,32,6,5,1
050,31,113,"Nebraska","Logan County",2,33,6,4,2
050,31,113,"Nebraska","Logan County",2,34,6,3,3
050,31,113,"Nebraska","Logan County",2,35,7,3,4
050,31,113,"Nebraska","Logan County",2,36,9,5,4
050,31,113,"Nebraska","Logan County",2,37,8,4,4
050,31,113,"Nebraska","Logan County",2,38,6,3,3
050,31,113,"Nebraska","Logan County",2,39,11,6,5
050,31,113,"Nebraska","Logan County",2,40,12,6,6
050,31,113,"Nebraska","Logan County",2,41,11,5,6
050,31,113,"Nebraska","Logan County",2,42,10,3,7
050,31,113,"Nebraska","Logan County",2,43,11,6,5
050,31,113,"Nebraska","Logan County",2,44,11,8,3
050,31,113,"Nebraska","Logan County",2,45,9,6,3
050,31,113,"Nebraska","Logan County",2,46,10,6,4
050,31,113,"Nebraska","Logan County",2,47,7,5,2
050,31,113,"Nebraska","Logan County",2,48,5,2,3
050,31,113,"Nebraska","Logan County",2,49,6,1,5
050,31,113,"Nebraska","Logan County",2,50,5,1,4
050,31,113,"Nebraska","Logan County",2,51,7,2,5
050,31,113,"Nebraska","Logan County",2,52,7,3,4
050,31,113,"Nebraska","Logan County",2,53,7,4,3
050,31,113,"Nebraska","Logan County",2,54,8,5,3
050,31,113,"Nebraska","Logan County",2,55,6,3,3
050,31,113,"Nebraska","Logan County",2,56,6,4,2
050,31,113,"Nebraska","Logan County",2,57,11,6,5
050,31,113,"Nebraska","Logan County",2,58,11,5,6
050,31,113,"Nebraska","Logan County",2,59,11,4,7
050,31,113,"Nebraska","Logan County",2,60,14,7,7
050,31,113,"Nebraska","Logan County",2,61,11,6,5
050,31,113,"Nebraska","Logan County",2,62,11,6,5
050,31,113,"Nebraska","Logan County",2,63,9,4,5
050,31,113,"Nebraska","Logan County",2,64,12,7,5
050,31,113,"Nebraska","Logan County",2,65,10,5,5
050,31,113,"Nebraska","Logan County",2,66,11,4,7
050,31,113,"Nebraska","Logan County",2,67,12,5,7
050,31,113,"Nebraska","Logan County",2,68,14,7,7
050,31,113,"Nebraska","Logan County",2,69,13,7,6
050,31,113,"Nebraska","Logan County",2,70,8,4,4
050,31,113,"Nebraska","Logan County",2,71,10,6,4
050,31,113,"Nebraska","Logan County",2,72,7,4,3
050,31,113,"Nebraska","Logan County",2,73,6,2,4
050,31,113,"Nebraska","Logan County",2,74,6,2,4
050,31,113,"Nebraska","Logan County",2,75,8,5,3
050,31,113,"Nebraska","Logan County",2,76,8,5,3
050,31,113,"Nebraska","Logan County",2,77,6,2,4
050,31,113,"Nebraska","Logan County",2,78,5,1,4
050,31,113,"Nebraska","Logan County",2,79,7,2,5
050,31,113,"Nebraska","Logan County",2,80,8,4,4
050,31,113,"Nebraska","Logan County",2,81,6,3,3
050,31,113,"Nebraska","Logan County",2,82,6,4,2
050,31,113,"Nebraska","Logan County",2,83,3,3,0
050,31,113,"Nebraska","Logan County",2,84,3,2,1
050,31,113,"Nebraska","Logan County",2,85,14,5,9
050,31,113,"Nebraska","Logan County",3,0,5,2,3
050,31,113,"Nebraska","Logan County",3,1,4,0,4
050,31,113,"Nebraska","Logan County",3,2,5,2,3
050,31,113,"Nebraska","Logan County",3,3,8,4,4
050,31,113,"Nebraska","Logan County",3,4,7,7,0
050,31,113,"Nebraska","Logan County",3,5,11,7,4
050,31,113,"Nebraska","Logan County",3,6,8,6,2
050,31,113,"Nebraska","Logan County",3,7,9,6,3
050,31,113,"Nebraska","Logan County",3,8,10,7,3
050,31,113,"Nebraska","Logan County",3,9,7,4,3
050,31,113,"Nebraska","Logan County",3,10,4,2,2
050,31,113,"Nebraska","Logan County",3,11,8,4,4
050,31,113,"Nebraska","Logan County",3,12,7,3,4
050,31,113,"Nebraska","Logan County",3,13,7,5,2
050,31,113,"Nebraska","Logan County",3,14,13,8,5
050,31,113,"Nebraska","Logan County",3,15,14,8,6
050,31,113,"Nebraska","Logan County",3,16,13,9,4
050,31,113,"Nebraska","Logan County",3,17,12,7,5
050,31,113,"Nebraska","Logan County",3,18,11,5,6
050,31,113,"Nebraska","Logan County",3,19,5,2,3
050,31,113,"Nebraska","Logan County",3,20,7,4,3
050,31,113,"Nebraska","Logan County",3,21,6,3,3
050,31,113,"Nebraska","Logan County",3,22,5,3,2
050,31,113,"Nebraska","Logan County",3,23,3,2,1
050,31,113,"Nebraska","Logan County",3,24,8,3,5
050,31,113,"Nebraska","Logan County",3,25,6,2,4
050,31,113,"Nebraska","Logan County",3,26,6,3,3
050,31,113,"Nebraska","Logan County",3,27,7,3,4
050,31,113,"Nebraska","Logan County",3,28,3,1,2
050,31,113,"Nebraska","Logan County",3,29,5,3,2
050,31,113,"Nebraska","Logan County",3,30,7,3,4
050,31,113,"Nebraska","Logan County",3,31,6,3,3
050,31,113,"Nebraska","Logan County",3,32,7,4,3
050,31,113,"Nebraska","Logan County",3,33,7,6,1
050,31,113,"Nebraska","Logan County",3,34,7,5,2
050,31,113,"Nebraska","Logan County",3,35,6,3,3
050,31,113,"Nebraska","Logan County",3,36,8,3,5
050,31,113,"Nebraska","Logan County",3,37,8,5,3
050,31,113,"Nebraska","Logan County",3,38,8,4,4
050,31,113,"Nebraska","Logan County",3,39,6,3,3
050,31,113,"Nebraska","Logan County",3,40,9,4,5
050,31,113,"Nebraska","Logan County",3,41,11,6,5
050,31,113,"Nebraska","Logan County",3,42,10,4,6
050,31,113,"Nebraska","Logan County",3,43,9,2,7
050,31,113,"Nebraska","Logan County",3,44,10,5,5
050,31,113,"Nebraska","Logan County",3,45,11,8,3
050,31,113,"Nebraska","Logan County",3,46,8,6,2
050,31,113,"Nebraska","Logan County",3,47,9,6,3
050,31,113,"Nebraska","Logan County",3,48,8,6,2
050,31,113,"Nebraska","Logan County",3,49,8,2,6
050,31,113,"Nebraska","Logan County",3,50,5,0,5
050,31,113,"Nebraska","Logan County",3,51,5,1,4
050,31,113,"Nebraska","Logan County",3,52,7,2,5
050,31,113,"Nebraska","Logan County",3,53,7,3,4
050,31,113,"Nebraska","Logan County",3,54,7,4,3
050,31,113,"Nebraska","Logan County",3,55,9,6,3
050,31,113,"Nebraska","Logan County",3,56,6,3,3
050,31,113,"Nebraska","Logan County",3,57,7,4,3
050,31,113,"Nebraska","Logan County",3,58,10,6,4
050,31,113,"Nebraska","Logan County",3,59,11,5,6
050,31,113,"Nebraska","Logan County",3,60,11,4,7
050,31,113,"Nebraska","Logan County",3,61,14,7,7
050,31,113,"Nebraska","Logan County",3,62,11,6,5
050,31,113,"Nebraska","Logan County",3,63,9,6,3
050,31,113,"Nebraska","Logan County",3,64,9,4,5
050,31,113,"Nebraska","Logan County",3,65,12,7,5
050,31,113,"Nebraska","Logan County",3,66,10,5,5
050,31,113,"Nebraska","Logan County",3,67,9,4,5
050,31,113,"Nebraska","Logan County",3,68,12,5,7
050,31,113,"Nebraska","Logan County",3,69,13,7,6
050,31,113,"Nebraska","Logan County",3,70,12,7,5
050,31,113,"Nebraska","Logan County",3,71,8,4,4
050,31,113,"Nebraska","Logan County",3,72,10,6,4
050,31,113,"Nebraska","Logan County",3,73,5,2,3
050,31,113,"Nebraska","Logan County",3,74,6,2,4
050,31,113,"Nebraska","Logan County",3,75,6,2,4
050,31,113,"Nebraska","Logan County",3,76,7,4,3
050,31,113,"Nebraska","Logan County",3,77,8,5,3
050,31,113,"Nebraska","Logan County",3,78,6,2,4
050,31,113,"Nebraska","Logan County",3,79,5,1,4
050,31,113,"Nebraska","Logan County",3,80,6,2,4
050,31,113,"Nebraska","Logan County",3,81,7,3,4
050,31,113,"Nebraska","Logan County",3,82,6,3,3
050,31,113,"Nebraska","Logan County",3,83,6,4,2
050,31,113,"Nebraska","Logan County",3,84,2,2,0
050,31,113,"Nebraska","Logan County",3,85,14,5,9
050,31,113,"Nebraska","Logan County",4,0,7,5,2
050,31,113,"Nebraska","Logan County",4,1,4,1,3
050,31,113,"Nebraska","Logan County",4,2,2,0,2
050,31,113,"Nebraska","Logan County",4,3,3,1,2
050,31,113,"Nebraska","Logan County",4,4,9,5,4
050,31,113,"Nebraska","Logan County",4,5,8,8,0
050,31,113,"Nebraska","Logan County",4,6,11,7,4
050,31,113,"Nebraska","Logan County",4,7,9,6,3
050,31,113,"Nebraska","Logan County",4,8,9,6,3
050,31,113,"Nebraska","Logan County",4,9,9,6,3
050,31,113,"Nebraska","Logan County",4,10,7,4,3
050,31,113,"Nebraska","Logan County",4,11,4,2,2
050,31,113,"Nebraska","Logan County",4,12,9,5,4
050,31,113,"Nebraska","Logan County",4,13,9,4,5
050,31,113,"Nebraska","Logan County",4,14,7,5,2
050,31,113,"Nebraska","Logan County",4,15,13,8,5
050,31,113,"Nebraska","Logan County",4,16,14,8,6
050,31,113,"Nebraska","Logan County",4,17,13,8,5
050,31,113,"Nebraska","Logan County",4,18,10,6,4
050,31,113,"Nebraska","Logan County",4,19,7,3,4
050,31,113,"Nebraska","Logan County",4,20,5,3,2
050,31,113,"Nebraska","Logan County",4,21,8,5,3
050,31,113,"Nebraska","Logan County",4,22,6,3,3
050,31,113,"Nebraska","Logan County",4,23,4,3,1
050,31,113,"Nebraska","Logan County",4,24,3,2,1
050,31,113,"Nebraska","Logan County",4,25,10,5,5
050,31,113,"Nebraska","Logan County",4,26,6,2,4
050,31,113,"Nebraska","Logan County",4,27,4,3,1
050,31,113,"Nebraska","Logan County",4,28,6,2,4
050,31,113,"Nebraska","Logan County",4,29,3,1,2
050,31,113,"Nebraska","Logan County",4,30,4,3,1
050,31,113,"Nebraska","Logan County",4,31,7,2,5
050,31,113,"Nebraska","Logan County",4,32,6,3,3
050,31,113,"Nebraska","Logan County",4,33,7,4,3
050,31,113,"Nebraska","Logan County",4,34,6,5,1
050,31,113,"Nebraska","Logan County",4,35,7,5,2
050,31,113,"Nebraska","Logan County",4,36,7,4,3
050,31,113,"Nebraska","Logan County",4,37,6,3,3
050,31,113,"Nebraska","Logan County",4,38,8,5,3
050,31,113,"Nebraska","Logan County",4,39,8,4,4
050,31,113,"Nebraska","Logan County",4,40,6,3,3
050,31,113,"Nebraska","Logan County",4,41,10,5,5
050,31,113,"Nebraska","Logan County",4,42,10,6,4
050,31,113,"Nebraska","Logan County",4,43,11,4,7
050,31,113,"Nebraska","Logan County",4,44,9,2,7
050,31,113,"Nebraska","Logan County",4,45,9,4,5
050,31,113,"Nebraska","Logan County",4,46,12,8,4
050,31,113,"Nebraska","Logan County",4,47,9,8,1
050,31,113,"Nebraska","Logan County",4,48,5,3,2
050,31,113,"Nebraska","Logan County",4,49,8,6,2
050,31,113,"Nebraska","Logan County",4,50,10,2,8
050,31,113,"Nebraska","Logan County",4,51,5,0,5
050,31,113,"Nebraska","Logan County",4,52,5,1,4
050,31,113,"Nebraska","Logan County",4,53,7,2,5
050,31,113,"Nebraska","Logan County",4,54,7,3,4
050,31,113,"Nebraska","Logan County",4,55,5,3,2
050,31,113,"Nebraska","Logan County",4,56,9,6,3
050,31,113,"Nebraska","Logan County",4,57,7,4,3
050,31,113,"Nebraska","Logan County",4,58,7,4,3
050,31,113,"Nebraska","Logan County",4,59,11,7,4
050,31,113,"Nebraska","Logan County",4,60,12,5,7
050,31,113,"Nebraska","Logan County",4,61,11,5,6
050,31,113,"Nebraska","Logan County",4,62,15,7,8
050,31,113,"Nebraska","Logan County",4,63,11,6,5
050,31,113,"Nebraska","Logan County",4,64,9,7,2
050,31,113,"Nebraska","Logan County",4,65,10,5,5
050,31,113,"Nebraska","Logan County",4,66,12,7,5
050,31,113,"Nebraska","Logan County",4,67,10,5,5
050,31,113,"Nebraska","Logan County",4,68,12,5,7
050,31,113,"Nebraska","Logan County",4,69,12,5,7
050,31,113,"Nebraska","Logan County",4,70,14,8,6
050,31,113,"Nebraska","Logan County",4,71,13,7,6
050,31,113,"Nebraska","Logan County",4,72,8,4,4
050,31,113,"Nebraska","Logan County",4,73,10,6,4
050,31,113,"Nebraska","Logan County",4,74,5,2,3
050,31,113,"Nebraska","Logan County",4,75,6,2,4
050,31,113,"Nebraska","Logan County",4,76,6,2,4
050,31,113,"Nebraska","Logan County",4,77,7,4,3
050,31,113,"Nebraska","Logan County",4,78,8,5,3
050,31,113,"Nebraska","Logan County",4,79,6,2,4
050,31,113,"Nebraska","Logan County",4,80,4,1,3
050,31,113,"Nebraska","Logan County",4,81,6,1,5
050,31,113,"Nebraska","Logan County",4,82,6,3,3
050,31,113,"Nebraska","Logan County",4,83,6,3,3
050,31,113,"Nebraska","Logan County",4,84,6,4,2
050,31,113,"Nebraska","Logan County",4,85,13,4,9
050,31,113,"Nebraska","Logan County",5,0,6,4,2
050,31,113,"Nebraska","Logan County",5,1,9,5,4
050,31,113,"Nebraska","Logan County",5,2,3,1,2
050,31,113,"Nebraska","Logan County",5,3,5,2,3
050,31,113,"Nebraska","Logan County",5,4,4,1,3
050,31,113,"Nebraska","Logan County",5,5,8,4,4
050,31,113,"Nebraska","Logan County",5,6,7,7,0
050,31,113,"Nebraska","Logan County",5,7,11,7,4
050,31,113,"Nebraska","Logan County",5,8,8,6,2
050,31,113,"Nebraska","Logan County",5,9,8,6,2
050,31,113,"Nebraska","Logan County",5,10,8,5,3
050,31,113,"Nebraska","Logan County",5,11,6,4,2
050,31,113,"Nebraska","Logan County",5,12,4,2,2
050,31,113,"Nebraska","Logan County",5,13,8,4,4
050,31,113,"Nebraska","Logan County",5,14,9,4,5
050,31,113,"Nebraska","Logan County",5,15,7,5,2
050,31,113,"Nebraska","Logan County",5,16,15,10,5
050,31,113,"Nebraska","Logan County",5,17,11,5,6
050,31,113,"Nebraska","Logan County",5,18,11,7,4
050,31,113,"Nebraska","Logan County",5,19,5,2,3
050,31,113,"Nebraska","Logan County",5,20,6,2,4
050,31,113,"Nebraska","Logan County",5,21,4,3,1
050,31,113,"Nebraska","Logan County",5,22,6,3,3
050,31,113,"Nebraska","Logan County",5,23,7,3,4
050,31,113,"Nebraska","Logan County",5,24,5,3,2
050,31,113,"Nebraska","Logan County",5,25,6,4,2
050,31,113,"Nebraska","Logan County",5,26,4,3,1
050,31,113,"Nebraska","Logan County",5,27,7,3,4
050,31,113,"Nebraska","Logan County",5,28,4,1,3
050,31,113,"Nebraska","Logan County",5,29,6,3,3
050,31,113,"Nebraska","Logan County",5,30,3,1,2
050,31,113,"Nebraska","Logan County",5,31,4,3,1
050,31,113,"Nebraska","Logan County",5,32,7,3,4
050,31,113,"Nebraska","Logan County",5,33,6,3,3
050,31,113,"Nebraska","Logan County",5,34,6,3,3
050,31,113,"Nebraska","Logan County",5,35,6,5,1
050,31,113,"Nebraska","Logan County",5,36,5,3,2
050,31,113,"Nebraska","Logan County",5,37,7,3,4
050,31,113,"Nebraska","Logan County",5,38,7,3,4
050,31,113,"Nebraska","Logan County",5,39,7,4,3
050,31,113,"Nebraska","Logan County",5,40,7,3,4
050,31,113,"Nebraska","Logan County",5,41,6,3,3
050,31,113,"Nebraska","Logan County",5,42,8,5,3
050,31,113,"Nebraska","Logan County",5,43,10,6,4
050,31,113,"Nebraska","Logan County",5,44,11,4,7
050,31,113,"Nebraska","Logan County",5,45,7,2,5
050,31,113,"Nebraska","Logan County",5,46,9,4,5
050,31,113,"Nebraska","Logan County",5,47,12,8,4
050,31,113,"Nebraska","Logan County",5,48,8,7,1
050,31,113,"Nebraska","Logan County",5,49,3,1,2
050,31,113,"Nebraska","Logan County",5,50,8,6,2
050,31,113,"Nebraska","Logan County",5,51,10,2,8
050,31,113,"Nebraska","Logan County",5,52,4,0,4
050,31,113,"Nebraska","Logan County",5,53,5,1,4
050,31,113,"Nebraska","Logan County",5,54,5,2,3
050,31,113,"Nebraska","Logan County",5,55,7,3,4
050,31,113,"Nebraska","Logan County",5,56,6,4,2
050,31,113,"Nebraska","Logan County",5,57,10,7,3
050,31,113,"Nebraska","Logan County",5,58,6,4,2
050,31,113,"Nebraska","Logan County",5,59,7,4,3
050,31,113,"Nebraska","Logan County",5,60,11,8,3
050,31,113,"Nebraska","Logan County",5,61,13,6,7
050,31,113,"Nebraska","Logan County",5,62,10,4,6
050,31,113,"Nebraska","Logan County",5,63,14,6,8
050,31,113,"Nebraska","Logan County",5,64,11,6,5
050,31,113,"Nebraska","Logan County",5,65,10,7,3
050,31,113,"Nebraska","Logan County",5,66,10,5,5
050,31,113,"Nebraska","Logan County",5,67,12,7,5
050,31,113,"Nebraska","Logan County",5,68,10,5,5
050,31,113,"Nebraska","Logan County",5,69,11,4,7
050,31,113,"Nebraska","Logan County",5,70,11,5,6
050,31,113,"Nebraska","Logan County",5,71,14,8,6
050,31,113,"Nebraska","Logan County",5,72,12,7,5
050,31,113,"Nebraska","Logan County",5,73,7,3,4
050,31,113,"Nebraska","Logan County",5,74,10,6,4
050,31,113,"Nebraska","Logan County",5,75,5,2,3
050,31,113,"Nebraska","Logan County",5,76,6,2,4
050,31,113,"Nebraska","Logan County",5,77,6,2,4
050,31,113,"Nebraska","Logan County",5,78,7,4,3
050,31,113,"Nebraska","Logan County",5,79,7,5,2
050,31,113,"Nebraska","Logan County",5,80,5,2,3
050,31,113,"Nebraska","Logan County",5,81,4,1,3
050,31,113,"Nebraska","Logan County",5,82,6,1,5
050,31,113,"Nebraska","Logan County",5,83,6,3,3
050,31,113,"Nebraska","Logan County",5,84,6,3,3
050,31,113,"Nebraska","Logan County",5,85,16,6,10
050,31,115,"Nebraska","Loup County",1,0,7,4,3
050,31,115,"Nebraska","Loup County",1,1,6,3,3
050,31,115,"Nebraska","Loup County",1,2,4,2,2
050,31,115,"Nebraska","Loup County",1,3,7,2,5
050,31,115,"Nebraska","Loup County",1,4,8,5,3
050,31,115,"Nebraska","Loup County",1,5,7,4,3
050,31,115,"Nebraska","Loup County",1,6,7,4,3
050,31,115,"Nebraska","Loup County",1,7,10,6,4
050,31,115,"Nebraska","Loup County",1,8,9,6,3
050,31,115,"Nebraska","Loup County",1,9,6,3,3
050,31,115,"Nebraska","Loup County",1,10,6,3,3
050,31,115,"Nebraska","Loup County",1,11,5,1,4
050,31,115,"Nebraska","Loup County",1,12,10,5,5
050,31,115,"Nebraska","Loup County",1,13,9,6,3
050,31,115,"Nebraska","Loup County",1,14,6,4,2
050,31,115,"Nebraska","Loup County",1,15,2,2,0
050,31,115,"Nebraska","Loup County",1,16,5,2,3
050,31,115,"Nebraska","Loup County",1,17,12,5,7
050,31,115,"Nebraska","Loup County",1,18,8,6,2
050,31,115,"Nebraska","Loup County",1,19,6,3,3
050,31,115,"Nebraska","Loup County",1,20,6,4,2
050,31,115,"Nebraska","Loup County",1,21,4,2,2
050,31,115,"Nebraska","Loup County",1,22,10,3,7
050,31,115,"Nebraska","Loup County",1,23,5,1,4
050,31,115,"Nebraska","Loup County",1,24,6,4,2
050,31,115,"Nebraska","Loup County",1,25,5,4,1
050,31,115,"Nebraska","Loup County",1,26,6,3,3
050,31,115,"Nebraska","Loup County",1,27,5,2,3
050,31,115,"Nebraska","Loup County",1,28,3,2,1
050,31,115,"Nebraska","Loup County",1,29,6,3,3
050,31,115,"Nebraska","Loup County",1,30,2,1,1
050,31,115,"Nebraska","Loup County",1,31,7,3,4
050,31,115,"Nebraska","Loup County",1,32,6,2,4
050,31,115,"Nebraska","Loup County",1,33,11,6,5
050,31,115,"Nebraska","Loup County",1,34,10,5,5
050,31,115,"Nebraska","Loup County",1,35,6,3,3
050,31,115,"Nebraska","Loup County",1,36,3,2,1
050,31,115,"Nebraska","Loup County",1,37,5,3,2
050,31,115,"Nebraska","Loup County",1,38,1,1,0
050,31,115,"Nebraska","Loup County",1,39,5,3,2
050,31,115,"Nebraska","Loup County",1,40,5,2,3
050,31,115,"Nebraska","Loup County",1,41,5,1,4
050,31,115,"Nebraska","Loup County",1,42,4,1,3
050,31,115,"Nebraska","Loup County",1,43,2,2,0
050,31,115,"Nebraska","Loup County",1,44,5,3,2
050,31,115,"Nebraska","Loup County",1,45,8,4,4
050,31,115,"Nebraska","Loup County",1,46,6,4,2
050,31,115,"Nebraska","Loup County",1,47,7,3,4
050,31,115,"Nebraska","Loup County",1,48,7,5,2
050,31,115,"Nebraska","Loup County",1,49,4,2,2
050,31,115,"Nebraska","Loup County",1,50,6,2,4
050,31,115,"Nebraska","Loup County",1,51,5,0,5
050,31,115,"Nebraska","Loup County",1,52,6,3,3
050,31,115,"Nebraska","Loup County",1,53,5,3,2
050,31,115,"Nebraska","Loup County",1,54,7,3,4
050,31,115,"Nebraska","Loup County",1,55,11,7,4
050,31,115,"Nebraska","Loup County",1,56,6,4,2
050,31,115,"Nebraska","Loup County",1,57,10,3,7
050,31,115,"Nebraska","Loup County",1,58,14,7,7
050,31,115,"Nebraska","Loup County",1,59,15,9,6
050,31,115,"Nebraska","Loup County",1,60,12,8,4
050,31,115,"Nebraska","Loup County",1,61,12,5,7
050,31,115,"Nebraska","Loup County",1,62,16,9,7
050,31,115,"Nebraska","Loup County",1,63,12,6,6
050,31,115,"Nebraska","Loup County",1,64,13,8,5
050,31,115,"Nebraska","Loup County",1,65,12,6,6
050,31,115,"Nebraska","Loup County",1,66,11,6,5
050,31,115,"Nebraska","Loup County",1,67,7,3,4
050,31,115,"Nebraska","Loup County",1,68,5,2,3
050,31,115,"Nebraska","Loup County",1,69,11,7,4
050,31,115,"Nebraska","Loup County",1,70,13,6,7
050,31,115,"Nebraska","Loup County",1,71,13,6,7
050,31,115,"Nebraska","Loup County",1,72,9,4,5
050,31,115,"Nebraska","Loup County",1,73,11,6,5
050,31,115,"Nebraska","Loup County",1,74,5,3,2
050,31,115,"Nebraska","Loup County",1,75,6,3,3
050,31,115,"Nebraska","Loup County",1,76,7,4,3
050,31,115,"Nebraska","Loup County",1,77,6,3,3
050,31,115,"Nebraska","Loup County",1,78,6,3,3
050,31,115,"Nebraska","Loup County",1,79,4,2,2
050,31,115,"Nebraska","Loup County",1,80,5,3,2
050,31,115,"Nebraska","Loup County",1,81,4,3,1
050,31,115,"Nebraska","Loup County",1,82,3,1,2
050,31,115,"Nebraska","Loup County",1,83,3,1,2
050,31,115,"Nebraska","Loup County",1,84,4,2,2
050,31,115,"Nebraska","Loup County",1,85,9,2,7
050,31,115,"Nebraska","Loup County",2,0,7,4,3
050,31,115,"Nebraska","Loup County",2,1,6,3,3
050,31,115,"Nebraska","Loup County",2,2,4,2,2
050,31,115,"Nebraska","Loup County",2,3,6,2,4
050,31,115,"Nebraska","Loup County",2,4,8,5,3
050,31,115,"Nebraska","Loup County",2,5,8,5,3
050,31,115,"Nebraska","Loup County",2,6,7,4,3
050,31,115,"Nebraska","Loup County",2,7,10,6,4
050,31,115,"Nebraska","Loup County",2,8,9,6,3
050,31,115,"Nebraska","Loup County",2,9,7,4,3
050,31,115,"Nebraska","Loup County",2,10,6,3,3
050,31,115,"Nebraska","Loup County",2,11,5,1,4
050,31,115,"Nebraska","Loup County",2,12,9,4,5
050,31,115,"Nebraska","Loup County",2,13,9,6,3
050,31,115,"Nebraska","Loup County",2,14,6,4,2
050,31,115,"Nebraska","Loup County",2,15,2,2,0
050,31,115,"Nebraska","Loup County",2,16,5,2,3
050,31,115,"Nebraska","Loup County",2,17,10,4,6
050,31,115,"Nebraska","Loup County",2,18,9,6,3
050,31,115,"Nebraska","Loup County",2,19,7,4,3
050,31,115,"Nebraska","Loup County",2,20,6,4,2
050,31,115,"Nebraska","Loup County",2,21,4,2,2
050,31,115,"Nebraska","Loup County",2,22,7,2,5
050,31,115,"Nebraska","Loup County",2,23,7,2,5
050,31,115,"Nebraska","Loup County",2,24,5,3,2
050,31,115,"Nebraska","Loup County",2,25,5,4,1
050,31,115,"Nebraska","Loup County",2,26,6,3,3
050,31,115,"Nebraska","Loup County",2,27,5,2,3
050,31,115,"Nebraska","Loup County",2,28,3,2,1
050,31,115,"Nebraska","Loup County",2,29,5,3,2
050,31,115,"Nebraska","Loup County",2,30,3,1,2
050,31,115,"Nebraska","Loup County",2,31,5,2,3
050,31,115,"Nebraska","Loup County",2,32,7,3,4
050,31,115,"Nebraska","Loup County",2,33,10,5,5
050,31,115,"Nebraska","Loup County",2,34,10,5,5
050,31,115,"Nebraska","Loup County",2,35,7,4,3
050,31,115,"Nebraska","Loup County",2,36,3,2,1
050,31,115,"Nebraska","Loup County",2,37,4,3,1
050,31,115,"Nebraska","Loup County",2,38,1,1,0
050,31,115,"Nebraska","Loup County",2,39,4,3,1
050,31,115,"Nebraska","Loup County",2,40,5,2,3
050,31,115,"Nebraska","Loup County",2,41,5,1,4
050,31,115,"Nebraska","Loup County",2,42,4,1,3
050,31,115,"Nebraska","Loup County",2,43,3,2,1
050,31,115,"Nebraska","Loup County",2,44,4,3,1
050,31,115,"Nebraska","Loup County",2,45,8,4,4
050,31,115,"Nebraska","Loup County",2,46,6,4,2
050,31,115,"Nebraska","Loup County",2,47,7,3,4
050,31,115,"Nebraska","Loup County",2,48,7,5,2
050,31,115,"Nebraska","Loup County",2,49,5,3,2
050,31,115,"Nebraska","Loup County",2,50,6,2,4
050,31,115,"Nebraska","Loup County",2,51,6,1,5
050,31,115,"Nebraska","Loup County",2,52,5,2,3
050,31,115,"Nebraska","Loup County",2,53,5,3,2
050,31,115,"Nebraska","Loup County",2,54,6,2,4
050,31,115,"Nebraska","Loup County",2,55,10,6,4
050,31,115,"Nebraska","Loup County",2,56,7,5,2
050,31,115,"Nebraska","Loup County",2,57,10,4,6
050,31,115,"Nebraska","Loup County",2,58,13,6,7
050,31,115,"Nebraska","Loup County",2,59,16,9,7
050,31,115,"Nebraska","Loup County",2,60,14,9,5
050,31,115,"Nebraska","Loup County",2,61,13,6,7
050,31,115,"Nebraska","Loup County",2,62,15,8,7
050,31,115,"Nebraska","Loup County",2,63,13,7,6
050,31,115,"Nebraska","Loup County",2,64,12,7,5
050,31,115,"Nebraska","Loup County",2,65,12,6,6
050,31,115,"Nebraska","Loup County",2,66,11,6,5
050,31,115,"Nebraska","Loup County",2,67,8,4,4
050,31,115,"Nebraska","Loup County",2,68,5,2,3
050,31,115,"Nebraska","Loup County",2,69,10,6,4
050,31,115,"Nebraska","Loup County",2,70,12,6,6
050,31,115,"Nebraska","Loup County",2,71,13,6,7
050,31,115,"Nebraska","Loup County",2,72,9,4,5
050,31,115,"Nebraska","Loup County",2,73,11,6,5
050,31,115,"Nebraska","Loup County",2,74,7,4,3
050,31,115,"Nebraska","Loup County",2,75,6,3,3
050,31,115,"Nebraska","Loup County",2,76,7,4,3
050,31,115,"Nebraska","Loup County",2,77,6,3,3
050,31,115,"Nebraska","Loup County",2,78,6,3,3
050,31,115,"Nebraska","Loup County",2,79,4,2,2
050,31,115,"Nebraska","Loup County",2,80,5,3,2
050,31,115,"Nebraska","Loup County",2,81,4,3,1
050,31,115,"Nebraska","Loup County",2,82,4,2,2
050,31,115,"Nebraska","Loup County",2,83,3,1,2
050,31,115,"Nebraska","Loup County",2,84,4,2,2
050,31,115,"Nebraska","Loup County",2,85,10,3,7
050,31,115,"Nebraska","Loup County",3,0,5,1,4
050,31,115,"Nebraska","Loup County",3,1,7,4,3
050,31,115,"Nebraska","Loup County",3,2,6,2,4
050,31,115,"Nebraska","Loup County",3,3,4,2,2
050,31,115,"Nebraska","Loup County",3,4,6,2,4
050,31,115,"Nebraska","Loup County",3,5,4,3,1
050,31,115,"Nebraska","Loup County",3,6,9,4,5
050,31,115,"Nebraska","Loup County",3,7,7,5,2
050,31,115,"Nebraska","Loup County",3,8,8,6,2
050,31,115,"Nebraska","Loup County",3,9,9,6,3
050,31,115,"Nebraska","Loup County",3,10,5,4,1
050,31,115,"Nebraska","Loup County",3,11,6,3,3
050,31,115,"Nebraska","Loup County",3,12,5,1,4
050,31,115,"Nebraska","Loup County",3,13,10,4,6
050,31,115,"Nebraska","Loup County",3,14,10,7,3
050,31,115,"Nebraska","Loup County",3,15,6,4,2
050,31,115,"Nebraska","Loup County",3,16,3,2,1
050,31,115,"Nebraska","Loup County",3,17,5,2,3
050,31,115,"Nebraska","Loup County",3,18,8,4,4
050,31,115,"Nebraska","Loup County",3,19,5,3,2
050,31,115,"Nebraska","Loup County",3,20,9,5,4
050,31,115,"Nebraska","Loup County",3,21,5,3,2
050,31,115,"Nebraska","Loup County",3,22,4,2,2
050,31,115,"Nebraska","Loup County",3,23,7,3,4
050,31,115,"Nebraska","Loup County",3,24,7,2,5
050,31,115,"Nebraska","Loup County",3,25,5,3,2
050,31,115,"Nebraska","Loup County",3,26,4,3,1
050,31,115,"Nebraska","Loup County",3,27,6,3,3
050,31,115,"Nebraska","Loup County",3,28,6,2,4
050,31,115,"Nebraska","Loup County",3,29,4,2,2
050,31,115,"Nebraska","Loup County",3,30,6,3,3
050,31,115,"Nebraska","Loup County",3,31,5,5,0
050,31,115,"Nebraska","Loup County",3,32,6,2,4
050,31,115,"Nebraska","Loup County",3,33,7,3,4
050,31,115,"Nebraska","Loup County",3,34,8,4,4
050,31,115,"Nebraska","Loup County",3,35,9,5,4
050,31,115,"Nebraska","Loup County",3,36,7,4,3
050,31,115,"Nebraska","Loup County",3,37,4,2,2
050,31,115,"Nebraska","Loup County",3,38,7,6,1
050,31,115,"Nebraska","Loup County",3,39,2,2,0
050,31,115,"Nebraska","Loup County",3,40,5,4,1
050,31,115,"Nebraska","Loup County",3,41,5,2,3
050,31,115,"Nebraska","Loup County",3,42,6,1,5
050,31,115,"Nebraska","Loup County",3,43,4,1,3
050,31,115,"Nebraska","Loup County",3,44,3,2,1
050,31,115,"Nebraska","Loup County",3,45,4,3,1
050,31,115,"Nebraska","Loup County",3,46,8,4,4
050,31,115,"Nebraska","Loup County",3,47,5,3,2
050,31,115,"Nebraska","Loup County",3,48,8,4,4
050,31,115,"Nebraska","Loup County",3,49,7,5,2
050,31,115,"Nebraska","Loup County",3,50,5,3,2
050,31,115,"Nebraska","Loup County",3,51,6,2,4
050,31,115,"Nebraska","Loup County",3,52,6,1,5
050,31,115,"Nebraska","Loup County",3,53,5,2,3
050,31,115,"Nebraska","Loup County",3,54,5,3,2
050,31,115,"Nebraska","Loup County",3,55,4,0,4
050,31,115,"Nebraska","Loup County",3,56,10,6,4
050,31,115,"Nebraska","Loup County",3,57,5,4,1
050,31,115,"Nebraska","Loup County",3,58,10,4,6
050,31,115,"Nebraska","Loup County",3,59,13,6,7
050,31,115,"Nebraska","Loup County",3,60,15,9,6
050,31,115,"Nebraska","Loup County",3,61,13,9,4
050,31,115,"Nebraska","Loup County",3,62,13,4,9
050,31,115,"Nebraska","Loup County",3,63,15,8,7
050,31,115,"Nebraska","Loup County",3,64,13,5,8
050,31,115,"Nebraska","Loup County",3,65,13,8,5
050,31,115,"Nebraska","Loup County",3,66,13,7,6
050,31,115,"Nebraska","Loup County",3,67,11,6,5
050,31,115,"Nebraska","Loup County",3,68,8,4,4
050,31,115,"Nebraska","Loup County",3,69,5,2,3
050,31,115,"Nebraska","Loup County",3,70,10,6,4
050,31,115,"Nebraska","Loup County",3,71,11,5,6
050,31,115,"Nebraska","Loup County",3,72,12,5,7
050,31,115,"Nebraska","Loup County",3,73,9,4,5
050,31,115,"Nebraska","Loup County",3,74,11,6,5
050,31,115,"Nebraska","Loup County",3,75,7,4,3
050,31,115,"Nebraska","Loup County",3,76,7,3,4
050,31,115,"Nebraska","Loup County",3,77,7,4,3
050,31,115,"Nebraska","Loup County",3,78,7,4,3
050,31,115,"Nebraska","Loup County",3,79,6,3,3
050,31,115,"Nebraska","Loup County",3,80,4,2,2
050,31,115,"Nebraska","Loup County",3,81,5,3,2
050,31,115,"Nebraska","Loup County",3,82,4,3,1
050,31,115,"Nebraska","Loup County",3,83,2,2,0
050,31,115,"Nebraska","Loup County",3,84,3,1,2
050,31,115,"Nebraska","Loup County",3,85,10,4,6
050,31,115,"Nebraska","Loup County",4,0,3,0,3
050,31,115,"Nebraska","Loup County",4,1,5,1,4
050,31,115,"Nebraska","Loup County",4,2,7,4,3
050,31,115,"Nebraska","Loup County",4,3,6,2,4
050,31,115,"Nebraska","Loup County",4,4,4,2,2
050,31,115,"Nebraska","Loup County",4,5,6,2,4
050,31,115,"Nebraska","Loup County",4,6,4,3,1
050,31,115,"Nebraska","Loup County",4,7,9,4,5
050,31,115,"Nebraska","Loup County",4,8,7,5,2
050,31,115,"Nebraska","Loup County",4,9,9,6,3
050,31,115,"Nebraska","Loup County",4,10,9,6,3
050,31,115,"Nebraska","Loup County",4,11,5,4,1
050,31,115,"Nebraska","Loup County",4,12,6,3,3
050,31,115,"Nebraska","Loup County",4,13,5,1,4
050,31,115,"Nebraska","Loup County",4,14,8,4,4
050,31,115,"Nebraska","Loup County",4,15,10,7,3
050,31,115,"Nebraska","Loup County",4,16,5,4,1
050,31,115,"Nebraska","Loup County",4,17,3,2,1
050,31,115,"Nebraska","Loup County",4,18,6,2,4
050,31,115,"Nebraska","Loup County",4,19,8,5,3
050,31,115,"Nebraska","Loup County",4,20,5,3,2
050,31,115,"Nebraska","Loup County",4,21,9,5,4
050,31,115,"Nebraska","Loup County",4,22,5,4,1
050,31,115,"Nebraska","Loup County",4,23,2,0,2
050,31,115,"Nebraska","Loup County",4,24,4,3,1
050,31,115,"Nebraska","Loup County",4,25,8,2,6
050,31,115,"Nebraska","Loup County",4,26,7,4,3
050,31,115,"Nebraska","Loup County",4,27,4,3,1
050,31,115,"Nebraska","Loup County",4,28,6,3,3
050,31,115,"Nebraska","Loup County",4,29,7,3,4
050,31,115,"Nebraska","Loup County",4,30,4,2,2
050,31,115,"Nebraska","Loup County",4,31,6,3,3
050,31,115,"Nebraska","Loup County",4,32,5,3,2
050,31,115,"Nebraska","Loup County",4,33,6,2,4
050,31,115,"Nebraska","Loup County",4,34,8,3,5
050,31,115,"Nebraska","Loup County",4,35,8,4,4
050,31,115,"Nebraska","Loup County",4,36,9,5,4
050,31,115,"Nebraska","Loup County",4,37,7,4,3
050,31,115,"Nebraska","Loup County",4,38,4,2,2
050,31,115,"Nebraska","Loup County",4,39,4,3,1
050,31,115,"Nebraska","Loup County",4,40,2,2,0
050,31,115,"Nebraska","Loup County",4,41,6,5,1
050,31,115,"Nebraska","Loup County",4,42,5,2,3
050,31,115,"Nebraska","Loup County",4,43,5,1,4
050,31,115,"Nebraska","Loup County",4,44,4,1,3
050,31,115,"Nebraska","Loup County",4,45,3,2,1
050,31,115,"Nebraska","Loup County",4,46,3,2,1
050,31,115,"Nebraska","Loup County",4,47,8,4,4
050,31,115,"Nebraska","Loup County",4,48,5,3,2
050,31,115,"Nebraska","Loup County",4,49,8,4,4
050,31,115,"Nebraska","Loup County",4,50,10,5,5
050,31,115,"Nebraska","Loup County",4,51,5,3,2
050,31,115,"Nebraska","Loup County",4,52,6,2,4
050,31,115,"Nebraska","Loup County",4,53,4,1,3
050,31,115,"Nebraska","Loup County",4,54,5,2,3
050,31,115,"Nebraska","Loup County",4,55,4,2,2
050,31,115,"Nebraska","Loup County",4,56,4,0,4
050,31,115,"Nebraska","Loup County",4,57,9,6,3
050,31,115,"Nebraska","Loup County",4,58,5,4,1
050,31,115,"Nebraska","Loup County",4,59,12,4,8
050,31,115,"Nebraska","Loup County",4,60,13,6,7
050,31,115,"Nebraska","Loup County",4,61,17,9,8
050,31,115,"Nebraska","Loup County",4,62,12,8,4
050,31,115,"Nebraska","Loup County",4,63,11,4,7
050,31,115,"Nebraska","Loup County",4,64,14,7,7
050,31,115,"Nebraska","Loup County",4,65,13,5,8
050,31,115,"Nebraska","Loup County",4,66,14,9,5
050,31,115,"Nebraska","Loup County",4,67,13,7,6
050,31,115,"Nebraska","Loup County",4,68,11,5,6
050,31,115,"Nebraska","Loup County",4,69,7,3,4
050,31,115,"Nebraska","Loup County",4,70,5,2,3
050,31,115,"Nebraska","Loup County",4,71,10,6,4
050,31,115,"Nebraska","Loup County",4,72,11,5,6
050,31,115,"Nebraska","Loup County",4,73,11,5,6
050,31,115,"Nebraska","Loup County",4,74,10,4,6
050,31,115,"Nebraska","Loup County",4,75,11,6,5
050,31,115,"Nebraska","Loup County",4,76,7,4,3
050,31,115,"Nebraska","Loup County",4,77,7,3,4
050,31,115,"Nebraska","Loup County",4,78,7,4,3
050,31,115,"Nebraska","Loup County",4,79,7,4,3
050,31,115,"Nebraska","Loup County",4,80,5,2,3
050,31,115,"Nebraska","Loup County",4,81,4,2,2
050,31,115,"Nebraska","Loup County",4,82,5,3,2
050,31,115,"Nebraska","Loup County",4,83,4,3,1
050,31,115,"Nebraska","Loup County",4,84,2,2,0
050,31,115,"Nebraska","Loup County",4,85,14,7,7
050,31,115,"Nebraska","Loup County",5,0,3,0,3
050,31,115,"Nebraska","Loup County",5,1,5,2,3
050,31,115,"Nebraska","Loup County",5,2,5,1,4
050,31,115,"Nebraska","Loup County",5,3,8,4,4
050,31,115,"Nebraska","Loup County",5,4,6,2,4
050,31,115,"Nebraska","Loup County",5,5,4,2,2
050,31,115,"Nebraska","Loup County",5,6,5,2,3
050,31,115,"Nebraska","Loup County",5,7,7,6,1
050,31,115,"Nebraska","Loup County",5,8,8,4,4
050,31,115,"Nebraska","Loup County",5,9,6,3,3
050,31,115,"Nebraska","Loup County",5,10,10,7,3
050,31,115,"Nebraska","Loup County",5,11,7,5,2
050,31,115,"Nebraska","Loup County",5,12,5,4,1
050,31,115,"Nebraska","Loup County",5,13,5,3,2
050,31,115,"Nebraska","Loup County",5,14,6,1,5
050,31,115,"Nebraska","Loup County",5,15,9,5,4
050,31,115,"Nebraska","Loup County",5,16,9,6,3
050,31,115,"Nebraska","Loup County",5,17,5,4,1
050,31,115,"Nebraska","Loup County",5,18,5,2,3
050,31,115,"Nebraska","Loup County",5,19,4,1,3
050,31,115,"Nebraska","Loup County",5,20,8,5,3
050,31,115,"Nebraska","Loup County",5,21,4,2,2
050,31,115,"Nebraska","Loup County",5,22,7,5,2
050,31,115,"Nebraska","Loup County",5,23,5,4,1
050,31,115,"Nebraska","Loup County",5,24,0,0,0
050,31,115,"Nebraska","Loup County",5,25,3,2,1
050,31,115,"Nebraska","Loup County",5,26,8,2,6
050,31,115,"Nebraska","Loup County",5,27,7,4,3
050,31,115,"Nebraska","Loup County",5,28,5,3,2
050,31,115,"Nebraska","Loup County",5,29,6,3,3
050,31,115,"Nebraska","Loup County",5,30,6,3,3
050,31,115,"Nebraska","Loup County",5,31,4,2,2
050,31,115,"Nebraska","Loup County",5,32,5,3,2
050,31,115,"Nebraska","Loup County",5,33,5,3,2
050,31,115,"Nebraska","Loup County",5,34,5,2,3
050,31,115,"Nebraska","Loup County",5,35,7,3,4
050,31,115,"Nebraska","Loup County",5,36,8,4,4
050,31,115,"Nebraska","Loup County",5,37,10,5,5
050,31,115,"Nebraska","Loup County",5,38,7,4,3
050,31,115,"Nebraska","Loup County",5,39,4,2,2
050,31,115,"Nebraska","Loup County",5,40,5,3,2
050,31,115,"Nebraska","Loup County",5,41,1,1,0
050,31,115,"Nebraska","Loup County",5,42,7,5,2
050,31,115,"Nebraska","Loup County",5,43,5,2,3
050,31,115,"Nebraska","Loup County",5,44,6,2,4
050,31,115,"Nebraska","Loup County",5,45,4,1,3
050,31,115,"Nebraska","Loup County",5,46,3,2,1
050,31,115,"Nebraska","Loup County",5,47,3,2,1
050,31,115,"Nebraska","Loup County",5,48,8,4,4
050,31,115,"Nebraska","Loup County",5,49,5,3,2
050,31,115,"Nebraska","Loup County",5,50,8,4,4
050,31,115,"Nebraska","Loup County",5,51,8,5,3
050,31,115,"Nebraska","Loup County",5,52,5,3,2
050,31,115,"Nebraska","Loup County",5,53,7,2,5
050,31,115,"Nebraska","Loup County",5,54,3,1,2
050,31,115,"Nebraska","Loup County",5,55,6,3,3
050,31,115,"Nebraska","Loup County",5,56,4,2,2
050,31,115,"Nebraska","Loup County",5,57,4,0,4
050,31,115,"Nebraska","Loup County",5,58,9,6,3
050,31,115,"Nebraska","Loup County",5,59,5,4,1
050,31,115,"Nebraska","Loup County",5,60,12,4,8
050,31,115,"Nebraska","Loup County",5,61,13,6,7
050,31,115,"Nebraska","Loup County",5,62,15,7,8
050,31,115,"Nebraska","Loup County",5,63,12,8,4
050,31,115,"Nebraska","Loup County",5,64,11,4,7
050,31,115,"Nebraska","Loup County",5,65,14,7,7
050,31,115,"Nebraska","Loup County",5,66,13,5,8
050,31,115,"Nebraska","Loup County",5,67,15,10,5
050,31,115,"Nebraska","Loup County",5,68,13,7,6
050,31,115,"Nebraska","Loup County",5,69,11,5,6
050,31,115,"Nebraska","Loup County",5,70,7,3,4
050,31,115,"Nebraska","Loup County",5,71,5,2,3
050,31,115,"Nebraska","Loup County",5,72,10,6,4
050,31,115,"Nebraska","Loup County",5,73,9,5,4
050,31,115,"Nebraska","Loup County",5,74,10,5,5
050,31,115,"Nebraska","Loup County",5,75,10,4,6
050,31,115,"Nebraska","Loup County",5,76,11,6,5
050,31,115,"Nebraska","Loup County",5,77,6,3,3
050,31,115,"Nebraska","Loup County",5,78,7,3,4
050,31,115,"Nebraska","Loup County",5,79,7,4,3
050,31,115,"Nebraska","Loup County",5,80,5,2,3
050,31,115,"Nebraska","Loup County",5,81,5,2,3
050,31,115,"Nebraska","Loup County",5,82,4,2,2
050,31,115,"Nebraska","Loup County",5,83,5,3,2
050,31,115,"Nebraska","Loup County",5,84,4,3,1
050,31,115,"Nebraska","Loup County",5,85,16,9,7
050,31,117,"Nebraska","McPherson County",1,0,2,1,1
050,31,117,"Nebraska","McPherson County",1,1,2,1,1
050,31,117,"Nebraska","McPherson County",1,2,2,2,0
050,31,117,"Nebraska","McPherson County",1,3,4,2,2
050,31,117,"Nebraska","McPherson County",1,4,2,0,2
050,31,117,"Nebraska","McPherson County",1,5,2,1,1
050,31,117,"Nebraska","McPherson County",1,6,4,2,2
050,31,117,"Nebraska","McPherson County",1,7,3,2,1
050,31,117,"Nebraska","McPherson County",1,8,2,0,2
050,31,117,"Nebraska","McPherson County",1,9,1,1,0
050,31,117,"Nebraska","McPherson County",1,10,4,3,1
050,31,117,"Nebraska","McPherson County",1,11,6,4,2
050,31,117,"Nebraska","McPherson County",1,12,6,2,4
050,31,117,"Nebraska","McPherson County",1,13,5,3,2
050,31,117,"Nebraska","McPherson County",1,14,7,3,4
050,31,117,"Nebraska","McPherson County",1,15,7,4,3
050,31,117,"Nebraska","McPherson County",1,16,2,2,0
050,31,117,"Nebraska","McPherson County",1,17,6,3,3
050,31,117,"Nebraska","McPherson County",1,18,7,2,5
050,31,117,"Nebraska","McPherson County",1,19,6,2,4
050,31,117,"Nebraska","McPherson County",1,20,5,2,3
050,31,117,"Nebraska","McPherson County",1,21,4,2,2
050,31,117,"Nebraska","McPherson County",1,22,5,2,3
050,31,117,"Nebraska","McPherson County",1,23,4,2,2
050,31,117,"Nebraska","McPherson County",1,24,3,2,1
050,31,117,"Nebraska","McPherson County",1,25,5,3,2
050,31,117,"Nebraska","McPherson County",1,26,3,1,2
050,31,117,"Nebraska","McPherson County",1,27,4,2,2
050,31,117,"Nebraska","McPherson County",1,28,4,2,2
050,31,117,"Nebraska","McPherson County",1,29,4,2,2
050,31,117,"Nebraska","McPherson County",1,30,5,2,3
050,31,117,"Nebraska","McPherson County",1,31,2,1,1
050,31,117,"Nebraska","McPherson County",1,32,3,3,0
050,31,117,"Nebraska","McPherson County",1,33,2,1,1
050,31,117,"Nebraska","McPherson County",1,34,3,1,2
050,31,117,"Nebraska","McPherson County",1,35,4,2,2
050,31,117,"Nebraska","McPherson County",1,36,2,0,2
050,31,117,"Nebraska","McPherson County",1,37,4,1,3
050,31,117,"Nebraska","McPherson County",1,38,5,2,3
050,31,117,"Nebraska","McPherson County",1,39,3,1,2
050,31,117,"Nebraska","McPherson County",1,40,3,1,2
050,31,117,"Nebraska","McPherson County",1,41,4,3,1
050,31,117,"Nebraska","McPherson County",1,42,5,3,2
050,31,117,"Nebraska","McPherson County",1,43,4,2,2
050,31,117,"Nebraska","McPherson County",1,44,3,0,3
050,31,117,"Nebraska","McPherson County",1,45,4,2,2
050,31,117,"Nebraska","McPherson County",1,46,5,3,2
050,31,117,"Nebraska","McPherson County",1,47,5,4,1
050,31,117,"Nebraska","McPherson County",1,48,5,3,2
050,31,117,"Nebraska","McPherson County",1,49,6,4,2
050,31,117,"Nebraska","McPherson County",1,50,7,5,2
050,31,117,"Nebraska","McPherson County",1,51,4,2,2
050,31,117,"Nebraska","McPherson County",1,52,3,1,2
050,31,117,"Nebraska","McPherson County",1,53,6,3,3
050,31,117,"Nebraska","McPherson County",1,54,7,5,2
050,31,117,"Nebraska","McPherson County",1,55,10,5,5
050,31,117,"Nebraska","McPherson County",1,56,7,3,4
050,31,117,"Nebraska","McPherson County",1,57,7,3,4
050,31,117,"Nebraska","McPherson County",1,58,8,4,4
050,31,117,"Nebraska","McPherson County",1,59,7,4,3
050,31,117,"Nebraska","McPherson County",1,60,7,2,5
050,31,117,"Nebraska","McPherson County",1,61,6,1,5
050,31,117,"Nebraska","McPherson County",1,62,6,2,4
050,31,117,"Nebraska","McPherson County",1,63,8,4,4
050,31,117,"Nebraska","McPherson County",1,64,10,3,7
050,31,117,"Nebraska","McPherson County",1,65,7,4,3
050,31,117,"Nebraska","McPherson County",1,66,5,4,1
050,31,117,"Nebraska","McPherson County",1,67,10,8,2
050,31,117,"Nebraska","McPherson County",1,68,6,3,3
050,31,117,"Nebraska","McPherson County",1,69,4,2,2
050,31,117,"Nebraska","McPherson County",1,70,4,2,2
050,31,117,"Nebraska","McPherson County",1,71,3,0,3
050,31,117,"Nebraska","McPherson County",1,72,7,2,5
050,31,117,"Nebraska","McPherson County",1,73,3,1,2
050,31,117,"Nebraska","McPherson County",1,74,4,2,2
050,31,117,"Nebraska","McPherson County",1,75,3,2,1
050,31,117,"Nebraska","McPherson County",1,76,1,0,1
050,31,117,"Nebraska","McPherson County",1,77,2,1,1
050,31,117,"Nebraska","McPherson County",1,78,3,2,1
050,31,117,"Nebraska","McPherson County",1,79,3,1,2
050,31,117,"Nebraska","McPherson County",1,80,4,3,1
050,31,117,"Nebraska","McPherson County",1,81,5,3,2
050,31,117,"Nebraska","McPherson County",1,82,4,2,2
050,31,117,"Nebraska","McPherson County",1,83,3,2,1
050,31,117,"Nebraska","McPherson County",1,84,2,0,2
050,31,117,"Nebraska","McPherson County",1,85,16,9,7
050,31,117,"Nebraska","McPherson County",2,0,2,1,1
050,31,117,"Nebraska","McPherson County",2,1,2,1,1
050,31,117,"Nebraska","McPherson County",2,2,2,2,0
050,31,117,"Nebraska","McPherson County",2,3,3,2,1
050,31,117,"Nebraska","McPherson County",2,4,3,1,2
050,31,117,"Nebraska","McPherson County",2,5,2,1,1
050,31,117,"Nebraska","McPherson County",2,6,4,2,2
050,31,117,"Nebraska","McPherson County",2,7,3,2,1
050,31,117,"Nebraska","McPherson County",2,8,3,1,2
050,31,117,"Nebraska","McPherson County",2,9,1,1,0
050,31,117,"Nebraska","McPherson County",2,10,3,2,1
050,31,117,"Nebraska","McPherson County",2,11,5,3,2
050,31,117,"Nebraska","McPherson County",2,12,5,2,3
050,31,117,"Nebraska","McPherson County",2,13,6,3,3
050,31,117,"Nebraska","McPherson County",2,14,7,3,4
050,31,117,"Nebraska","McPherson County",2,15,6,3,3
050,31,117,"Nebraska","McPherson County",2,16,3,2,1
050,31,117,"Nebraska","McPherson County",2,17,5,3,2
050,31,117,"Nebraska","McPherson County",2,18,6,2,4
050,31,117,"Nebraska","McPherson County",2,19,6,2,4
050,31,117,"Nebraska","McPherson County",2,20,6,2,4
050,31,117,"Nebraska","McPherson County",2,21,5,2,3
050,31,117,"Nebraska","McPherson County",2,22,5,2,3
050,31,117,"Nebraska","McPherson County",2,23,4,2,2
050,31,117,"Nebraska","McPherson County",2,24,3,2,1
050,31,117,"Nebraska","McPherson County",2,25,4,2,2
050,31,117,"Nebraska","McPherson County",2,26,3,1,2
050,31,117,"Nebraska","McPherson County",2,27,4,2,2
050,31,117,"Nebraska","McPherson County",2,28,4,2,2
050,31,117,"Nebraska","McPherson County",2,29,4,2,2
050,31,117,"Nebraska","McPherson County",2,30,5,2,3
050,31,117,"Nebraska","McPherson County",2,31,2,1,1
050,31,117,"Nebraska","McPherson County",2,32,3,3,0
050,31,117,"Nebraska","McPherson County",2,33,2,1,1
050,31,117,"Nebraska","McPherson County",2,34,3,1,2
050,31,117,"Nebraska","McPherson County",2,35,4,2,2
050,31,117,"Nebraska","McPherson County",2,36,3,1,2
050,31,117,"Nebraska","McPherson County",2,37,4,1,3
050,31,117,"Nebraska","McPherson County",2,38,5,2,3
050,31,117,"Nebraska","McPherson County",2,39,3,1,2
050,31,117,"Nebraska","McPherson County",2,40,3,1,2
050,31,117,"Nebraska","McPherson County",2,41,3,2,1
050,31,117,"Nebraska","McPherson County",2,42,5,3,2
050,31,117,"Nebraska","McPherson County",2,43,4,2,2
050,31,117,"Nebraska","McPherson County",2,44,4,1,3
050,31,117,"Nebraska","McPherson County",2,45,4,2,2
050,31,117,"Nebraska","McPherson County",2,46,5,3,2
050,31,117,"Nebraska","McPherson County",2,47,5,4,1
050,31,117,"Nebraska","McPherson County",2,48,5,3,2
050,31,117,"Nebraska","McPherson County",2,49,6,4,2
050,31,117,"Nebraska","McPherson County",2,50,7,5,2
050,31,117,"Nebraska","McPherson County",2,51,4,2,2
050,31,117,"Nebraska","McPherson County",2,52,3,1,2
050,31,117,"Nebraska","McPherson County",2,53,5,2,3
050,31,117,"Nebraska","McPherson County",2,54,6,4,2
050,31,117,"Nebraska","McPherson County",2,55,9,5,4
050,31,117,"Nebraska","McPherson County",2,56,8,4,4
050,31,117,"Nebraska","McPherson County",2,57,7,3,4
050,31,117,"Nebraska","McPherson County",2,58,8,4,4
050,31,117,"Nebraska","McPherson County",2,59,7,4,3
050,31,117,"Nebraska","McPherson County",2,60,6,2,4
050,31,117,"Nebraska","McPherson County",2,61,6,1,5
050,31,117,"Nebraska","McPherson County",2,62,6,2,4
050,31,117,"Nebraska","McPherson County",2,63,8,4,4
050,31,117,"Nebraska","McPherson County",2,64,9,3,6
050,31,117,"Nebraska","McPherson County",2,65,8,4,4
050,31,117,"Nebraska","McPherson County",2,66,6,4,2
050,31,117,"Nebraska","McPherson County",2,67,9,7,2
050,31,117,"Nebraska","McPherson County",2,68,7,4,3
050,31,117,"Nebraska","McPherson County",2,69,4,2,2
050,31,117,"Nebraska","McPherson County",2,70,4,2,2
050,31,117,"Nebraska","McPherson County",2,71,4,1,3
050,31,117,"Nebraska","McPherson County",2,72,5,1,4
050,31,117,"Nebraska","McPherson County",2,73,4,1,3
050,31,117,"Nebraska","McPherson County",2,74,4,2,2
050,31,117,"Nebraska","McPherson County",2,75,3,2,1
050,31,117,"Nebraska","McPherson County",2,76,1,0,1
050,31,117,"Nebraska","McPherson County",2,77,2,1,1
050,31,117,"Nebraska","McPherson County",2,78,3,2,1
050,31,117,"Nebraska","McPherson County",2,79,3,1,2
050,31,117,"Nebraska","McPherson County",2,80,3,2,1
050,31,117,"Nebraska","McPherson County",2,81,5,3,2
050,31,117,"Nebraska","McPherson County",2,82,4,2,2
050,31,117,"Nebraska","McPherson County",2,83,3,2,1
050,31,117,"Nebraska","McPherson County",2,84,3,1,2
050,31,117,"Nebraska","McPherson County",2,85,16,9,7
050,31,117,"Nebraska","McPherson County",3,0,3,2,1
050,31,117,"Nebraska","McPherson County",3,1,2,1,1
050,31,117,"Nebraska","McPherson County",3,2,1,0,1
050,31,117,"Nebraska","McPherson County",3,3,1,1,0
050,31,117,"Nebraska","McPherson County",3,4,4,3,1
050,31,117,"Nebraska","McPherson County",3,5,3,1,2
050,31,117,"Nebraska","McPherson County",3,6,2,1,1
050,31,117,"Nebraska","McPherson County",3,7,4,2,2
050,31,117,"Nebraska","McPherson County",3,8,3,2,1
050,31,117,"Nebraska","McPherson County",3,9,3,1,2
050,31,117,"Nebraska","McPherson County",3,10,1,1,0
050,31,117,"Nebraska","McPherson County",3,11,4,3,1
050,31,117,"Nebraska","McPherson County",3,12,5,4,1
050,31,117,"Nebraska","McPherson County",3,13,5,2,3
050,31,117,"Nebraska","McPherson County",3,14,9,6,3
050,31,117,"Nebraska","McPherson County",3,15,7,3,4
050,31,117,"Nebraska","McPherson County",3,16,6,3,3
050,31,117,"Nebraska","McPherson County",3,17,3,2,1
050,31,117,"Nebraska","McPherson County",3,18,4,3,1
050,31,117,"Nebraska","McPherson County",3,19,5,1,4
050,31,117,"Nebraska","McPherson County",3,20,4,1,3
050,31,117,"Nebraska","McPherson County",3,21,5,2,3
050,31,117,"Nebraska","McPherson County",3,22,4,1,3
050,31,117,"Nebraska","McPherson County",3,23,4,1,3
050,31,117,"Nebraska","McPherson County",3,24,3,1,2
050,31,117,"Nebraska","McPherson County",3,25,3,2,1
050,31,117,"Nebraska","McPherson County",3,26,4,2,2
050,31,117,"Nebraska","McPherson County",3,27,4,1,3
050,31,117,"Nebraska","McPherson County",3,28,3,2,1
050,31,117,"Nebraska","McPherson County",3,29,2,1,1
050,31,117,"Nebraska","McPherson County",3,30,4,2,2
050,31,117,"Nebraska","McPherson County",3,31,4,1,3
050,31,117,"Nebraska","McPherson County",3,32,2,1,1
050,31,117,"Nebraska","McPherson County",3,33,2,2,0
050,31,117,"Nebraska","McPherson County",3,34,2,1,1
050,31,117,"Nebraska","McPherson County",3,35,4,2,2
050,31,117,"Nebraska","McPherson County",3,36,4,2,2
050,31,117,"Nebraska","McPherson County",3,37,3,1,2
050,31,117,"Nebraska","McPherson County",3,38,5,2,3
050,31,117,"Nebraska","McPherson County",3,39,5,2,3
050,31,117,"Nebraska","McPherson County",3,40,3,1,2
050,31,117,"Nebraska","McPherson County",3,41,3,1,2
050,31,117,"Nebraska","McPherson County",3,42,3,2,1
050,31,117,"Nebraska","McPherson County",3,43,6,3,3
050,31,117,"Nebraska","McPherson County",3,44,5,2,3
050,31,117,"Nebraska","McPherson County",3,45,4,2,2
050,31,117,"Nebraska","McPherson County",3,46,4,2,2
050,31,117,"Nebraska","McPherson County",3,47,5,3,2
050,31,117,"Nebraska","McPherson County",3,48,5,4,1
050,31,117,"Nebraska","McPherson County",3,49,4,3,1
050,31,117,"Nebraska","McPherson County",3,50,4,2,2
050,31,117,"Nebraska","McPherson County",3,51,7,5,2
050,31,117,"Nebraska","McPherson County",3,52,4,2,2
050,31,117,"Nebraska","McPherson County",3,53,3,1,2
050,31,117,"Nebraska","McPherson County",3,54,5,2,3
050,31,117,"Nebraska","McPherson County",3,55,6,4,2
050,31,117,"Nebraska","McPherson County",3,56,9,6,3
050,31,117,"Nebraska","McPherson County",3,57,8,4,4
050,31,117,"Nebraska","McPherson County",3,58,8,4,4
050,31,117,"Nebraska","McPherson County",3,59,7,4,3
050,31,117,"Nebraska","McPherson County",3,60,7,4,3
050,31,117,"Nebraska","McPherson County",3,61,6,2,4
050,31,117,"Nebraska","McPherson County",3,62,5,0,5
050,31,117,"Nebraska","McPherson County",3,63,6,2,4
050,31,117,"Nebraska","McPherson County",3,64,8,4,4
050,31,117,"Nebraska","McPherson County",3,65,9,3,6
050,31,117,"Nebraska","McPherson County",3,66,7,3,4
050,31,117,"Nebraska","McPherson County",3,67,6,4,2
050,31,117,"Nebraska","McPherson County",3,68,9,7,2
050,31,117,"Nebraska","McPherson County",3,69,6,4,2
050,31,117,"Nebraska","McPherson County",3,70,4,2,2
050,31,117,"Nebraska","McPherson County",3,71,4,2,2
050,31,117,"Nebraska","McPherson County",3,72,2,0,2
050,31,117,"Nebraska","McPherson County",3,73,4,0,4
050,31,117,"Nebraska","McPherson County",3,74,4,1,3
050,31,117,"Nebraska","McPherson County",3,75,4,2,2
050,31,117,"Nebraska","McPherson County",3,76,3,2,1
050,31,117,"Nebraska","McPherson County",3,77,1,0,1
050,31,117,"Nebraska","McPherson County",3,78,2,1,1
050,31,117,"Nebraska","McPherson County",3,79,3,2,1
050,31,117,"Nebraska","McPherson County",3,80,3,1,2
050,31,117,"Nebraska","McPherson County",3,81,3,2,1
050,31,117,"Nebraska","McPherson County",3,82,5,3,2
050,31,117,"Nebraska","McPherson County",3,83,4,2,2
050,31,117,"Nebraska","McPherson County",3,84,3,2,1
050,31,117,"Nebraska","McPherson County",3,85,14,6,8
050,31,117,"Nebraska","McPherson County",4,0,4,2,2
050,31,117,"Nebraska","McPherson County",4,1,2,2,0
050,31,117,"Nebraska","McPherson County",4,2,3,1,2
050,31,117,"Nebraska","McPherson County",4,3,2,0,2
050,31,117,"Nebraska","McPherson County",4,4,1,1,0
050,31,117,"Nebraska","McPherson County",4,5,3,2,1
050,31,117,"Nebraska","McPherson County",4,6,3,1,2
050,31,117,"Nebraska","McPherson County",4,7,2,1,1
050,31,117,"Nebraska","McPherson County",4,8,4,2,2
050,31,117,"Nebraska","McPherson County",4,9,3,2,1
050,31,117,"Nebraska","McPherson County",4,10,4,2,2
050,31,117,"Nebraska","McPherson County",4,11,1,1,0
050,31,117,"Nebraska","McPherson County",4,12,5,3,2
050,31,117,"Nebraska","McPherson County",4,13,5,4,1
050,31,117,"Nebraska","McPherson County",4,14,5,2,3
050,31,117,"Nebraska","McPherson County",4,15,9,6,3
050,31,117,"Nebraska","McPherson County",4,16,7,3,4
050,31,117,"Nebraska","McPherson County",4,17,5,3,2
050,31,117,"Nebraska","McPherson County",4,18,3,2,1
050,31,117,"Nebraska","McPherson County",4,19,3,2,1
050,31,117,"Nebraska","McPherson County",4,20,4,1,3
050,31,117,"Nebraska","McPherson County",4,21,6,3,3
050,31,117,"Nebraska","McPherson County",4,22,5,2,3
050,31,117,"Nebraska","McPherson County",4,23,4,1,3
050,31,117,"Nebraska","McPherson County",4,24,4,1,3
050,31,117,"Nebraska","McPherson County",4,25,4,1,3
050,31,117,"Nebraska","McPherson County",4,26,2,2,0
050,31,117,"Nebraska","McPherson County",4,27,4,2,2
050,31,117,"Nebraska","McPherson County",4,28,4,1,3
050,31,117,"Nebraska","McPherson County",4,29,3,2,1
050,31,117,"Nebraska","McPherson County",4,30,3,1,2
050,31,117,"Nebraska","McPherson County",4,31,3,3,0
050,31,117,"Nebraska","McPherson County",4,32,4,1,3
050,31,117,"Nebraska","McPherson County",4,33,2,1,1
050,31,117,"Nebraska","McPherson County",4,34,2,2,0
050,31,117,"Nebraska","McPherson County",4,35,2,1,1
050,31,117,"Nebraska","McPherson County",4,36,5,2,3
050,31,117,"Nebraska","McPherson County",4,37,4,3,1
050,31,117,"Nebraska","McPherson County",4,38,3,1,2
050,31,117,"Nebraska","McPherson County",4,39,5,2,3
050,31,117,"Nebraska","McPherson County",4,40,5,2,3
050,31,117,"Nebraska","McPherson County",4,41,3,1,2
050,31,117,"Nebraska","McPherson County",4,42,3,1,2
050,31,117,"Nebraska","McPherson County",4,43,3,2,1
050,31,117,"Nebraska","McPherson County",4,44,3,3,0
050,31,117,"Nebraska","McPherson County",4,45,5,2,3
050,31,117,"Nebraska","McPherson County",4,46,3,2,1
050,31,117,"Nebraska","McPherson County",4,47,4,2,2
050,31,117,"Nebraska","McPherson County",4,48,5,3,2
050,31,117,"Nebraska","McPherson County",4,49,5,4,1
050,31,117,"Nebraska","McPherson County",4,50,4,3,1
050,31,117,"Nebraska","McPherson County",4,51,4,2,2
050,31,117,"Nebraska","McPherson County",4,52,6,4,2
050,31,117,"Nebraska","McPherson County",4,53,4,2,2
050,31,117,"Nebraska","McPherson County",4,54,3,1,2
050,31,117,"Nebraska","McPherson County",4,55,8,4,4
050,31,117,"Nebraska","McPherson County",4,56,6,4,2
050,31,117,"Nebraska","McPherson County",4,57,7,5,2
050,31,117,"Nebraska","McPherson County",4,58,8,4,4
050,31,117,"Nebraska","McPherson County",4,59,7,3,4
050,31,117,"Nebraska","McPherson County",4,60,8,4,4
050,31,117,"Nebraska","McPherson County",4,61,6,3,3
050,31,117,"Nebraska","McPherson County",4,62,5,1,4
050,31,117,"Nebraska","McPherson County",4,63,4,0,4
050,31,117,"Nebraska","McPherson County",4,64,6,2,4
050,31,117,"Nebraska","McPherson County",4,65,8,4,4
050,31,117,"Nebraska","McPherson County",4,66,9,3,6
050,31,117,"Nebraska","McPherson County",4,67,7,3,4
050,31,117,"Nebraska","McPherson County",4,68,7,4,3
050,31,117,"Nebraska","McPherson County",4,69,9,7,2
050,31,117,"Nebraska","McPherson County",4,70,6,4,2
050,31,117,"Nebraska","McPherson County",4,71,3,1,2
050,31,117,"Nebraska","McPherson County",4,72,4,2,2
050,31,117,"Nebraska","McPherson County",4,73,2,0,2
050,31,117,"Nebraska","McPherson County",4,74,4,0,4
050,31,117,"Nebraska","McPherson County",4,75,3,1,2
050,31,117,"Nebraska","McPherson County",4,76,3,1,2
050,31,117,"Nebraska","McPherson County",4,77,3,2,1
050,31,117,"Nebraska","McPherson County",4,78,1,0,1
050,31,117,"Nebraska","McPherson County",4,79,2,1,1
050,31,117,"Nebraska","McPherson County",4,80,3,2,1
050,31,117,"Nebraska","McPherson County",4,81,3,1,2
050,31,117,"Nebraska","McPherson County",4,82,3,2,1
050,31,117,"Nebraska","McPherson County",4,83,5,3,2
050,31,117,"Nebraska","McPherson County",4,84,4,2,2
050,31,117,"Nebraska","McPherson County",4,85,18,9,9
050,31,117,"Nebraska","McPherson County",5,0,4,2,2
050,31,117,"Nebraska","McPherson County",5,1,4,2,2
050,31,117,"Nebraska","McPherson County",5,2,3,2,1
050,31,117,"Nebraska","McPherson County",5,3,2,1,1
050,31,117,"Nebraska","McPherson County",5,4,1,0,1
050,31,117,"Nebraska","McPherson County",5,5,1,1,0
050,31,117,"Nebraska","McPherson County",5,6,3,2,1
050,31,117,"Nebraska","McPherson County",5,7,3,1,2
050,31,117,"Nebraska","McPherson County",5,8,3,2,1
050,31,117,"Nebraska","McPherson County",5,9,4,3,1
050,31,117,"Nebraska","McPherson County",5,10,3,2,1
050,31,117,"Nebraska","McPherson County",5,11,3,2,1
050,31,117,"Nebraska","McPherson County",5,12,1,1,0
050,31,117,"Nebraska","McPherson County",5,13,6,4,2
050,31,117,"Nebraska","McPherson County",5,14,5,4,1
050,31,117,"Nebraska","McPherson County",5,15,5,2,3
050,31,117,"Nebraska","McPherson County",5,16,9,6,3
050,31,117,"Nebraska","McPherson County",5,17,7,3,4
050,31,117,"Nebraska","McPherson County",5,18,4,2,2
050,31,117,"Nebraska","McPherson County",5,19,2,1,1
050,31,117,"Nebraska","McPherson County",5,20,3,2,1
050,31,117,"Nebraska","McPherson County",5,21,3,1,2
050,31,117,"Nebraska","McPherson County",5,22,5,2,3
050,31,117,"Nebraska","McPherson County",5,23,5,2,3
050,31,117,"Nebraska","McPherson County",5,24,5,2,3
050,31,117,"Nebraska","McPherson County",5,25,4,1,3
050,31,117,"Nebraska","McPherson County",5,26,3,0,3
050,31,117,"Nebraska","McPherson County",5,27,3,3,0
050,31,117,"Nebraska","McPherson County",5,28,4,2,2
050,31,117,"Nebraska","McPherson County",5,29,4,1,3
050,31,117,"Nebraska","McPherson County",5,30,2,1,1
050,31,117,"Nebraska","McPherson County",5,31,3,1,2
050,31,117,"Nebraska","McPherson County",5,32,3,3,0
050,31,117,"Nebraska","McPherson County",5,33,3,1,2
050,31,117,"Nebraska","McPherson County",5,34,3,1,2
050,31,117,"Nebraska","McPherson County",5,35,3,2,1
050,31,117,"Nebraska","McPherson County",5,36,2,1,1
050,31,117,"Nebraska","McPherson County",5,37,5,2,3
050,31,117,"Nebraska","McPherson County",5,38,3,2,1
050,31,117,"Nebraska","McPherson County",5,39,4,2,2
050,31,117,"Nebraska","McPherson County",5,40,5,2,3
050,31,117,"Nebraska","McPherson County",5,41,6,2,4
050,31,117,"Nebraska","McPherson County",5,42,3,1,2
050,31,117,"Nebraska","McPherson County",5,43,3,1,2
050,31,117,"Nebraska","McPherson County",5,44,3,2,1
050,31,117,"Nebraska","McPherson County",5,45,3,3,0
050,31,117,"Nebraska","McPherson County",5,46,5,2,3
050,31,117,"Nebraska","McPherson County",5,47,3,2,1
050,31,117,"Nebraska","McPherson County",5,48,3,2,1
050,31,117,"Nebraska","McPherson County",5,49,5,3,2
050,31,117,"Nebraska","McPherson County",5,50,5,4,1
050,31,117,"Nebraska","McPherson County",5,51,4,3,1
050,31,117,"Nebraska","McPherson County",5,52,4,2,2
050,31,117,"Nebraska","McPherson County",5,53,5,3,2
050,31,117,"Nebraska","McPherson County",5,54,4,2,2
050,31,117,"Nebraska","McPherson County",5,55,2,1,1
050,31,117,"Nebraska","McPherson County",5,56,8,4,4
050,31,117,"Nebraska","McPherson County",5,57,6,4,2
050,31,117,"Nebraska","McPherson County",5,58,7,5,2
050,31,117,"Nebraska","McPherson County",5,59,9,4,5
050,31,117,"Nebraska","McPherson County",5,60,5,2,3
050,31,117,"Nebraska","McPherson County",5,61,8,4,4
050,31,117,"Nebraska","McPherson County",5,62,7,4,3
050,31,117,"Nebraska","McPherson County",5,63,5,1,4
050,31,117,"Nebraska","McPherson County",5,64,4,0,4
050,31,117,"Nebraska","McPherson County",5,65,6,2,4
050,31,117,"Nebraska","McPherson County",5,66,8,4,4
050,31,117,"Nebraska","McPherson County",5,67,9,3,6
050,31,117,"Nebraska","McPherson County",5,68,7,3,4
050,31,117,"Nebraska","McPherson County",5,69,9,6,3
050,31,117,"Nebraska","McPherson County",5,70,9,7,2
050,31,117,"Nebraska","McPherson County",5,71,7,4,3
050,31,117,"Nebraska","McPherson County",5,72,3,1,2
050,31,117,"Nebraska","McPherson County",5,73,4,2,2
050,31,117,"Nebraska","McPherson County",5,74,2,0,2
050,31,117,"Nebraska","McPherson County",5,75,4,0,4
050,31,117,"Nebraska","McPherson County",5,76,3,1,2
050,31,117,"Nebraska","McPherson County",5,77,3,1,2
050,31,117,"Nebraska","McPherson County",5,78,4,2,2
050,31,117,"Nebraska","McPherson County",5,79,1,0,1
050,31,117,"Nebraska","McPherson County",5,80,2,1,1
050,31,117,"Nebraska","McPherson County",5,81,3,2,1
050,31,117,"Nebraska","McPherson County",5,82,4,2,2
050,31,117,"Nebraska","McPherson County",5,83,3,2,1
050,31,117,"Nebraska","McPherson County",5,84,5,3,2
050,31,117,"Nebraska","McPherson County",5,85,22,11,11
050,31,119,"Nebraska","Madison County",1,0,496,245,251
050,31,119,"Nebraska","Madison County",1,1,495,220,275
050,31,119,"Nebraska","Madison County",1,2,536,270,266
050,31,119,"Nebraska","Madison County",1,3,511,249,262
050,31,119,"Nebraska","Madison County",1,4,510,226,284
050,31,119,"Nebraska","Madison County",1,5,494,240,254
050,31,119,"Nebraska","Madison County",1,6,503,253,250
050,31,119,"Nebraska","Madison County",1,7,510,252,258
050,31,119,"Nebraska","Madison County",1,8,485,239,246
050,31,119,"Nebraska","Madison County",1,9,525,278,247
050,31,119,"Nebraska","Madison County",1,10,497,246,251
050,31,119,"Nebraska","Madison County",1,11,543,252,291
050,31,119,"Nebraska","Madison County",1,12,531,274,257
050,31,119,"Nebraska","Madison County",1,13,496,257,239
050,31,119,"Nebraska","Madison County",1,14,489,258,231
050,31,119,"Nebraska","Madison County",1,15,498,257,241
050,31,119,"Nebraska","Madison County",1,16,474,245,229
050,31,119,"Nebraska","Madison County",1,17,486,245,241
050,31,119,"Nebraska","Madison County",1,18,469,224,245
050,31,119,"Nebraska","Madison County",1,19,545,293,252
050,31,119,"Nebraska","Madison County",1,20,478,260,218
050,31,119,"Nebraska","Madison County",1,21,414,214,200
050,31,119,"Nebraska","Madison County",1,22,419,208,211
050,31,119,"Nebraska","Madison County",1,23,423,214,209
050,31,119,"Nebraska","Madison County",1,24,454,230,224
050,31,119,"Nebraska","Madison County",1,25,419,226,193
050,31,119,"Nebraska","Madison County",1,26,436,230,206
050,31,119,"Nebraska","Madison County",1,27,433,211,222
050,31,119,"Nebraska","Madison County",1,28,466,246,220
050,31,119,"Nebraska","Madison County",1,29,427,230,197
050,31,119,"Nebraska","Madison County",1,30,432,232,200
050,31,119,"Nebraska","Madison County",1,31,424,206,218
050,31,119,"Nebraska","Madison County",1,32,442,221,221
050,31,119,"Nebraska","Madison County",1,33,455,241,214
050,31,119,"Nebraska","Madison County",1,34,446,242,204
050,31,119,"Nebraska","Madison County",1,35,492,268,224
050,31,119,"Nebraska","Madison County",1,36,472,238,234
050,31,119,"Nebraska","Madison County",1,37,466,249,217
050,31,119,"Nebraska","Madison County",1,38,467,245,222
050,31,119,"Nebraska","Madison County",1,39,478,258,220
050,31,119,"Nebraska","Madison County",1,40,441,223,218
050,31,119,"Nebraska","Madison County",1,41,393,201,192
050,31,119,"Nebraska","Madison County",1,42,412,200,212
050,31,119,"Nebraska","Madison County",1,43,389,177,212
050,31,119,"Nebraska","Madison County",1,44,384,181,203
050,31,119,"Nebraska","Madison County",1,45,384,206,178
050,31,119,"Nebraska","Madison County",1,46,344,177,167
050,31,119,"Nebraska","Madison County",1,47,362,187,175
050,31,119,"Nebraska","Madison County",1,48,373,194,179
050,31,119,"Nebraska","Madison County",1,49,359,176,183
050,31,119,"Nebraska","Madison County",1,50,345,175,170
050,31,119,"Nebraska","Madison County",1,51,381,195,186
050,31,119,"Nebraska","Madison County",1,52,350,168,182
050,31,119,"Nebraska","Madison County",1,53,384,178,206
050,31,119,"Nebraska","Madison County",1,54,435,221,214
050,31,119,"Nebraska","Madison County",1,55,442,239,203
050,31,119,"Nebraska","Madison County",1,56,477,260,217
050,31,119,"Nebraska","Madison County",1,57,480,237,243
050,31,119,"Nebraska","Madison County",1,58,508,259,249
050,31,119,"Nebraska","Madison County",1,59,505,251,254
050,31,119,"Nebraska","Madison County",1,60,513,264,249
050,31,119,"Nebraska","Madison County",1,61,527,278,249
050,31,119,"Nebraska","Madison County",1,62,505,253,252
050,31,119,"Nebraska","Madison County",1,63,511,254,257
050,31,119,"Nebraska","Madison County",1,64,479,234,245
050,31,119,"Nebraska","Madison County",1,65,442,224,218
050,31,119,"Nebraska","Madison County",1,66,416,220,196
050,31,119,"Nebraska","Madison County",1,67,380,189,191
050,31,119,"Nebraska","Madison County",1,68,362,167,195
050,31,119,"Nebraska","Madison County",1,69,318,151,167
050,31,119,"Nebraska","Madison County",1,70,306,145,161
050,31,119,"Nebraska","Madison County",1,71,287,141,146
050,31,119,"Nebraska","Madison County",1,72,270,123,147
050,31,119,"Nebraska","Madison County",1,73,276,131,145
050,31,119,"Nebraska","Madison County",1,74,218,103,115
050,31,119,"Nebraska","Madison County",1,75,196,89,107
050,31,119,"Nebraska","Madison County",1,76,199,92,107
050,31,119,"Nebraska","Madison County",1,77,195,88,107
050,31,119,"Nebraska","Madison County",1,78,179,85,94
050,31,119,"Nebraska","Madison County",1,79,184,82,102
050,31,119,"Nebraska","Madison County",1,80,154,63,91
050,31,119,"Nebraska","Madison County",1,81,142,69,73
050,31,119,"Nebraska","Madison County",1,82,141,63,78
050,31,119,"Nebraska","Madison County",1,83,137,62,75
050,31,119,"Nebraska","Madison County",1,84,112,47,65
050,31,119,"Nebraska","Madison County",1,85,956,346,610
050,31,119,"Nebraska","Madison County",2,0,483,237,246
050,31,119,"Nebraska","Madison County",2,1,493,225,268
050,31,119,"Nebraska","Madison County",2,2,528,258,270
050,31,119,"Nebraska","Madison County",2,3,518,253,265
050,31,119,"Nebraska","Madison County",2,4,509,231,278
050,31,119,"Nebraska","Madison County",2,5,496,236,260
050,31,119,"Nebraska","Madison County",2,6,501,250,251
050,31,119,"Nebraska","Madison County",2,7,504,251,253
050,31,119,"Nebraska","Madison County",2,8,486,240,246
050,31,119,"Nebraska","Madison County",2,9,513,267,246
050,31,119,"Nebraska","Madison County",2,10,505,253,252
050,31,119,"Nebraska","Madison County",2,11,529,250,279
050,31,119,"Nebraska","Madison County",2,12,533,271,262
050,31,119,"Nebraska","Madison County",2,13,498,259,239
050,31,119,"Nebraska","Madison County",2,14,491,259,232
050,31,119,"Nebraska","Madison County",2,15,496,257,239
050,31,119,"Nebraska","Madison County",2,16,481,249,232
050,31,119,"Nebraska","Madison County",2,17,483,242,241
050,31,119,"Nebraska","Madison County",2,18,475,229,246
050,31,119,"Nebraska","Madison County",2,19,548,292,256
050,31,119,"Nebraska","Madison County",2,20,477,262,215
050,31,119,"Nebraska","Madison County",2,21,411,212,199
050,31,119,"Nebraska","Madison County",2,22,418,209,209
050,31,119,"Nebraska","Madison County",2,23,428,219,209
050,31,119,"Nebraska","Madison County",2,24,444,222,222
050,31,119,"Nebraska","Madison County",2,25,428,228,200
050,31,119,"Nebraska","Madison County",2,26,429,225,204
050,31,119,"Nebraska","Madison County",2,27,434,217,217
050,31,119,"Nebraska","Madison County",2,28,450,233,217
050,31,119,"Nebraska","Madison County",2,29,436,234,202
050,31,119,"Nebraska","Madison County",2,30,432,231,201
050,31,119,"Nebraska","Madison County",2,31,421,211,210
050,31,119,"Nebraska","Madison County",2,32,437,218,219
050,31,119,"Nebraska","Madison County",2,33,449,236,213
050,31,119,"Nebraska","Madison County",2,34,451,245,206
050,31,119,"Nebraska","Madison County",2,35,482,262,220
050,31,119,"Nebraska","Madison County",2,36,472,247,225
050,31,119,"Nebraska","Madison County",2,37,465,245,220
050,31,119,"Nebraska","Madison County",2,38,467,247,220
050,31,119,"Nebraska","Madison County",2,39,474,255,219
050,31,119,"Nebraska","Madison County",2,40,452,232,220
050,31,119,"Nebraska","Madison County",2,41,404,206,198
050,31,119,"Nebraska","Madison County",2,42,406,199,207
050,31,119,"Nebraska","Madison County",2,43,395,183,212
050,31,119,"Nebraska","Madison County",2,44,386,181,205
050,31,119,"Nebraska","Madison County",2,45,383,200,183
050,31,119,"Nebraska","Madison County",2,46,351,182,169
050,31,119,"Nebraska","Madison County",2,47,358,184,174
050,31,119,"Nebraska","Madison County",2,48,363,188,175
050,31,119,"Nebraska","Madison County",2,49,359,178,181
050,31,119,"Nebraska","Madison County",2,50,346,174,172
050,31,119,"Nebraska","Madison County",2,51,371,190,181
050,31,119,"Nebraska","Madison County",2,52,355,172,183
050,31,119,"Nebraska","Madison County",2,53,373,174,199
050,31,119,"Nebraska","Madison County",2,54,428,215,213
050,31,119,"Nebraska","Madison County",2,55,431,231,200
050,31,119,"Nebraska","Madison County",2,56,465,253,212
050,31,119,"Nebraska","Madison County",2,57,481,244,237
050,31,119,"Nebraska","Madison County",2,58,502,253,249
050,31,119,"Nebraska","Madison County",2,59,504,252,252
050,31,119,"Nebraska","Madison County",2,60,508,259,249
050,31,119,"Nebraska","Madison County",2,61,519,270,249
050,31,119,"Nebraska","Madison County",2,62,506,255,251
050,31,119,"Nebraska","Madison County",2,63,517,258,259
050,31,119,"Nebraska","Madison County",2,64,485,236,249
050,31,119,"Nebraska","Madison County",2,65,448,225,223
050,31,119,"Nebraska","Madison County",2,66,419,220,199
050,31,119,"Nebraska","Madison County",2,67,390,197,193
050,31,119,"Nebraska","Madison County",2,68,363,171,192
050,31,119,"Nebraska","Madison County",2,69,323,153,170
050,31,119,"Nebraska","Madison County",2,70,308,147,161
050,31,119,"Nebraska","Madison County",2,71,287,139,148
050,31,119,"Nebraska","Madison County",2,72,268,125,143
050,31,119,"Nebraska","Madison County",2,73,288,135,153
050,31,119,"Nebraska","Madison County",2,74,215,102,113
050,31,119,"Nebraska","Madison County",2,75,201,91,110
050,31,119,"Nebraska","Madison County",2,76,195,91,104
050,31,119,"Nebraska","Madison County",2,77,199,91,108
050,31,119,"Nebraska","Madison County",2,78,182,85,97
050,31,119,"Nebraska","Madison County",2,79,182,82,100
050,31,119,"Nebraska","Madison County",2,80,157,65,92
050,31,119,"Nebraska","Madison County",2,81,146,70,76
050,31,119,"Nebraska","Madison County",2,82,142,64,78
050,31,119,"Nebraska","Madison County",2,83,135,64,71
050,31,119,"Nebraska","Madison County",2,84,114,49,65
050,31,119,"Nebraska","Madison County",2,85,945,337,608
050,31,119,"Nebraska","Madison County",3,0,454,245,209
050,31,119,"Nebraska","Madison County",3,1,474,243,231
050,31,119,"Nebraska","Madison County",3,2,489,227,262
050,31,119,"Nebraska","Madison County",3,3,513,253,260
050,31,119,"Nebraska","Madison County",3,4,521,255,266
050,31,119,"Nebraska","Madison County",3,5,498,229,269
050,31,119,"Nebraska","Madison County",3,6,495,233,262
050,31,119,"Nebraska","Madison County",3,7,503,248,255
050,31,119,"Nebraska","Madison County",3,8,505,243,262
050,31,119,"Nebraska","Madison County",3,9,473,236,237
050,31,119,"Nebraska","Madison County",3,10,519,271,248
050,31,119,"Nebraska","Madison County",3,11,518,264,254
050,31,119,"Nebraska","Madison County",3,12,538,257,281
050,31,119,"Nebraska","Madison County",3,13,535,277,258
050,31,119,"Nebraska","Madison County",3,14,515,267,248
050,31,119,"Nebraska","Madison County",3,15,498,268,230
050,31,119,"Nebraska","Madison County",3,16,501,259,242
050,31,119,"Nebraska","Madison County",3,17,471,246,225
050,31,119,"Nebraska","Madison County",3,18,481,235,246
050,31,119,"Nebraska","Madison County",3,19,575,303,272
050,31,119,"Nebraska","Madison County",3,20,464,256,208
050,31,119,"Nebraska","Madison County",3,21,405,209,196
050,31,119,"Nebraska","Madison County",3,22,413,207,206
050,31,119,"Nebraska","Madison County",3,23,395,201,194
050,31,119,"Nebraska","Madison County",3,24,439,222,217
050,31,119,"Nebraska","Madison County",3,25,415,213,202
050,31,119,"Nebraska","Madison County",3,26,415,221,194
050,31,119,"Nebraska","Madison County",3,27,415,230,185
050,31,119,"Nebraska","Madison County",3,28,429,213,216
050,31,119,"Nebraska","Madison County",3,29,434,223,211
050,31,119,"Nebraska","Madison County",3,30,445,238,207
050,31,119,"Nebraska","Madison County",3,31,421,222,199
050,31,119,"Nebraska","Madison County",3,32,428,209,219
050,31,119,"Nebraska","Madison County",3,33,430,221,209
050,31,119,"Nebraska","Madison County",3,34,461,245,216
050,31,119,"Nebraska","Madison County",3,35,441,234,207
050,31,119,"Nebraska","Madison County",3,36,506,279,227
050,31,119,"Nebraska","Madison County",3,37,471,247,224
050,31,119,"Nebraska","Madison County",3,38,458,244,214
050,31,119,"Nebraska","Madison County",3,39,466,247,219
050,31,119,"Nebraska","Madison County",3,40,465,247,218
050,31,119,"Nebraska","Madison County",3,41,443,220,223
050,31,119,"Nebraska","Madison County",3,42,401,202,199
050,31,119,"Nebraska","Madison County",3,43,396,199,197
050,31,119,"Nebraska","Madison County",3,44,397,184,213
050,31,119,"Nebraska","Madison County",3,45,385,183,202
050,31,119,"Nebraska","Madison County",3,46,387,195,192
050,31,119,"Nebraska","Madison County",3,47,346,185,161
050,31,119,"Nebraska","Madison County",3,48,347,187,160
050,31,119,"Nebraska","Madison County",3,49,355,184,171
050,31,119,"Nebraska","Madison County",3,50,356,179,177
050,31,119,"Nebraska","Madison County",3,51,356,180,176
050,31,119,"Nebraska","Madison County",3,52,361,189,172
050,31,119,"Nebraska","Madison County",3,53,335,161,174
050,31,119,"Nebraska","Madison County",3,54,393,188,205
050,31,119,"Nebraska","Madison County",3,55,402,198,204
050,31,119,"Nebraska","Madison County",3,56,425,221,204
050,31,119,"Nebraska","Madison County",3,57,459,248,211
050,31,119,"Nebraska","Madison County",3,58,480,245,235
050,31,119,"Nebraska","Madison County",3,59,494,247,247
050,31,119,"Nebraska","Madison County",3,60,496,252,244
050,31,119,"Nebraska","Madison County",3,61,498,248,250
050,31,119,"Nebraska","Madison County",3,62,513,263,250
050,31,119,"Nebraska","Madison County",3,63,514,256,258
050,31,119,"Nebraska","Madison County",3,64,499,244,255
050,31,119,"Nebraska","Madison County",3,65,463,226,237
050,31,119,"Nebraska","Madison County",3,66,432,223,209
050,31,119,"Nebraska","Madison County",3,67,411,212,199
050,31,119,"Nebraska","Madison County",3,68,391,193,198
050,31,119,"Nebraska","Madison County",3,69,331,162,169
050,31,119,"Nebraska","Madison County",3,70,330,154,176
050,31,119,"Nebraska","Madison County",3,71,291,138,153
050,31,119,"Nebraska","Madison County",3,72,280,131,149
050,31,119,"Nebraska","Madison County",3,73,263,120,143
050,31,119,"Nebraska","Madison County",3,74,283,130,153
050,31,119,"Nebraska","Madison County",3,75,213,98,115
050,31,119,"Nebraska","Madison County",3,76,194,91,103
050,31,119,"Nebraska","Madison County",3,77,192,90,102
050,31,119,"Nebraska","Madison County",3,78,200,92,108
050,31,119,"Nebraska","Madison County",3,79,183,81,102
050,31,119,"Nebraska","Madison County",3,80,155,64,91
050,31,119,"Nebraska","Madison County",3,81,153,64,89
050,31,119,"Nebraska","Madison County",3,82,141,64,77
050,31,119,"Nebraska","Madison County",3,83,135,67,68
050,31,119,"Nebraska","Madison County",3,84,117,51,66
050,31,119,"Nebraska","Madison County",3,85,907,329,578
050,31,119,"Nebraska","Madison County",4,0,462,245,217
050,31,119,"Nebraska","Madison County",4,1,473,252,221
050,31,119,"Nebraska","Madison County",4,2,474,244,230
050,31,119,"Nebraska","Madison County",4,3,478,225,253
050,31,119,"Nebraska","Madison County",4,4,511,257,254
050,31,119,"Nebraska","Madison County",4,5,511,243,268
050,31,119,"Nebraska","Madison County",4,6,500,229,271
050,31,119,"Nebraska","Madison County",4,7,496,239,257
050,31,119,"Nebraska","Madison County",4,8,502,247,255
050,31,119,"Nebraska","Madison County",4,9,507,241,266
050,31,119,"Nebraska","Madison County",4,10,456,227,229
050,31,119,"Nebraska","Madison County",4,11,527,264,263
050,31,119,"Nebraska","Madison County",4,12,518,257,261
050,31,119,"Nebraska","Madison County",4,13,521,250,271
050,31,119,"Nebraska","Madison County",4,14,529,278,251
050,31,119,"Nebraska","Madison County",4,15,521,275,246
050,31,119,"Nebraska","Madison County",4,16,492,264,228
050,31,119,"Nebraska","Madison County",4,17,506,257,249
050,31,119,"Nebraska","Madison County",4,18,467,238,229
050,31,119,"Nebraska","Madison County",4,19,556,300,256
050,31,119,"Nebraska","Madison County",4,20,501,270,231
050,31,119,"Nebraska","Madison County",4,21,414,217,197
050,31,119,"Nebraska","Madison County",4,22,423,216,207
050,31,119,"Nebraska","Madison County",4,23,422,229,193
050,31,119,"Nebraska","Madison County",4,24,428,226,202
050,31,119,"Nebraska","Madison County",4,25,423,216,207
050,31,119,"Nebraska","Madison County",4,26,398,195,203
050,31,119,"Nebraska","Madison County",4,27,442,236,206
050,31,119,"Nebraska","Madison County",4,28,392,208,184
050,31,119,"Nebraska","Madison County",4,29,429,214,215
050,31,119,"Nebraska","Madison County",4,30,446,238,208
050,31,119,"Nebraska","Madison County",4,31,453,234,219
050,31,119,"Nebraska","Madison County",4,32,430,219,211
050,31,119,"Nebraska","Madison County",4,33,433,214,219
050,31,119,"Nebraska","Madison County",4,34,443,230,213
050,31,119,"Nebraska","Madison County",4,35,457,235,222
050,31,119,"Nebraska","Madison County",4,36,460,248,212
050,31,119,"Nebraska","Madison County",4,37,499,275,224
050,31,119,"Nebraska","Madison County",4,38,466,240,226
050,31,119,"Nebraska","Madison County",4,39,452,237,215
050,31,119,"Nebraska","Madison County",4,40,450,239,211
050,31,119,"Nebraska","Madison County",4,41,464,240,224
050,31,119,"Nebraska","Madison County",4,42,448,224,224
050,31,119,"Nebraska","Madison County",4,43,416,215,201
050,31,119,"Nebraska","Madison County",4,44,407,207,200
050,31,119,"Nebraska","Madison County",4,45,401,188,213
050,31,119,"Nebraska","Madison County",4,46,377,174,203
050,31,119,"Nebraska","Madison County",4,47,377,188,189
050,31,119,"Nebraska","Madison County",4,48,335,184,151
050,31,119,"Nebraska","Madison County",4,49,342,185,157
050,31,119,"Nebraska","Madison County",4,50,351,180,171
050,31,119,"Nebraska","Madison County",4,51,367,184,183
050,31,119,"Nebraska","Madison County",4,52,354,178,176
050,31,119,"Nebraska","Madison County",4,53,359,185,174
050,31,119,"Nebraska","Madison County",4,54,352,176,176
050,31,119,"Nebraska","Madison County",4,55,372,180,192
050,31,119,"Nebraska","Madison County",4,56,399,193,206
050,31,119,"Nebraska","Madison County",4,57,413,213,200
050,31,119,"Nebraska","Madison County",4,58,457,243,214
050,31,119,"Nebraska","Madison County",4,59,468,240,228
050,31,119,"Nebraska","Madison County",4,60,484,241,243
050,31,119,"Nebraska","Madison County",4,61,490,248,242
050,31,119,"Nebraska","Madison County",4,62,479,238,241
050,31,119,"Nebraska","Madison County",4,63,510,263,247
050,31,119,"Nebraska","Madison County",4,64,510,246,264
050,31,119,"Nebraska","Madison County",4,65,481,236,245
050,31,119,"Nebraska","Madison County",4,66,438,212,226
050,31,119,"Nebraska","Madison County",4,67,435,214,221
050,31,119,"Nebraska","Madison County",4,68,404,205,199
050,31,119,"Nebraska","Madison County",4,69,370,187,183
050,31,119,"Nebraska","Madison County",4,70,330,164,166
050,31,119,"Nebraska","Madison County",4,71,309,141,168
050,31,119,"Nebraska","Madison County",4,72,281,135,146
050,31,119,"Nebraska","Madison County",4,73,273,126,147
050,31,119,"Nebraska","Madison County",4,74,252,115,137
050,31,119,"Nebraska","Madison County",4,75,272,120,152
050,31,119,"Nebraska","Madison County",4,76,205,92,113
050,31,119,"Nebraska","Madison County",4,77,196,92,104
050,31,119,"Nebraska","Madison County",4,78,192,93,99
050,31,119,"Nebraska","Madison County",4,79,190,84,106
050,31,119,"Nebraska","Madison County",4,80,160,65,95
050,31,119,"Nebraska","Madison County",4,81,153,68,85
050,31,119,"Nebraska","Madison County",4,82,151,62,89
050,31,119,"Nebraska","Madison County",4,83,138,67,71
050,31,119,"Nebraska","Madison County",4,84,116,52,64
050,31,119,"Nebraska","Madison County",4,85,868,323,545
050,31,119,"Nebraska","Madison County",5,0,463,247,216
050,31,119,"Nebraska","Madison County",5,1,464,242,222
050,31,119,"Nebraska","Madison County",5,2,485,261,224
050,31,119,"Nebraska","Madison County",5,3,463,235,228
050,31,119,"Nebraska","Madison County",5,4,486,234,252
050,31,119,"Nebraska","Madison County",5,5,503,249,254
050,31,119,"Nebraska","Madison County",5,6,505,243,262
050,31,119,"Nebraska","Madison County",5,7,489,222,267
050,31,119,"Nebraska","Madison County",5,8,507,240,267
050,31,119,"Nebraska","Madison County",5,9,509,254,255
050,31,119,"Nebraska","Madison County",5,10,512,246,266
050,31,119,"Nebraska","Madison County",5,11,464,231,233
050,31,119,"Nebraska","Madison County",5,12,528,270,258
050,31,119,"Nebraska","Madison County",5,13,514,259,255
050,31,119,"Nebraska","Madison County",5,14,530,257,273
050,31,119,"Nebraska","Madison County",5,15,524,279,245
050,31,119,"Nebraska","Madison County",5,16,536,276,260
050,31,119,"Nebraska","Madison County",5,17,495,251,244
050,31,119,"Nebraska","Madison County",5,18,501,247,254
050,31,119,"Nebraska","Madison County",5,19,554,307,247
050,31,119,"Nebraska","Madison County",5,20,493,270,223
050,31,119,"Nebraska","Madison County",5,21,441,233,208
050,31,119,"Nebraska","Madison County",5,22,405,213,192
050,31,119,"Nebraska","Madison County",5,23,442,234,208
050,31,119,"Nebraska","Madison County",5,24,426,226,200
050,31,119,"Nebraska","Madison County",5,25,427,229,198
050,31,119,"Nebraska","Madison County",5,26,408,195,213
050,31,119,"Nebraska","Madison County",5,27,404,204,200
050,31,119,"Nebraska","Madison County",5,28,416,214,202
050,31,119,"Nebraska","Madison County",5,29,401,221,180
050,31,119,"Nebraska","Madison County",5,30,430,215,215
050,31,119,"Nebraska","Madison County",5,31,445,237,208
050,31,119,"Nebraska","Madison County",5,32,461,233,228
050,31,119,"Nebraska","Madison County",5,33,424,216,208
050,31,119,"Nebraska","Madison County",5,34,449,228,221
050,31,119,"Nebraska","Madison County",5,35,441,224,217
050,31,119,"Nebraska","Madison County",5,36,470,249,221
050,31,119,"Nebraska","Madison County",5,37,447,241,206
050,31,119,"Nebraska","Madison County",5,38,498,268,230
050,31,119,"Nebraska","Madison County",5,39,475,246,229
050,31,119,"Nebraska","Madison County",5,40,465,240,225
050,31,119,"Nebraska","Madison County",5,41,454,242,212
050,31,119,"Nebraska","Madison County",5,42,468,237,231
050,31,119,"Nebraska","Madison County",5,43,456,229,227
050,31,119,"Nebraska","Madison County",5,44,419,217,202
050,31,119,"Nebraska","Madison County",5,45,404,206,198
050,31,119,"Nebraska","Madison County",5,46,409,196,213
050,31,119,"Nebraska","Madison County",5,47,372,172,200
050,31,119,"Nebraska","Madison County",5,48,373,193,180
050,31,119,"Nebraska","Madison County",5,49,339,189,150
050,31,119,"Nebraska","Madison County",5,50,337,181,156
050,31,119,"Nebraska","Madison County",5,51,363,189,174
050,31,119,"Nebraska","Madison County",5,52,362,176,186
050,31,119,"Nebraska","Madison County",5,53,348,172,176
050,31,119,"Nebraska","Madison County",5,54,393,204,189
050,31,119,"Nebraska","Madison County",5,55,332,169,163
050,31,119,"Nebraska","Madison County",5,56,366,172,194
050,31,119,"Nebraska","Madison County",5,57,397,193,204
050,31,119,"Nebraska","Madison County",5,58,411,214,197
050,31,119,"Nebraska","Madison County",5,59,440,233,207
050,31,119,"Nebraska","Madison County",5,60,470,241,229
050,31,119,"Nebraska","Madison County",5,61,480,241,239
050,31,119,"Nebraska","Madison County",5,62,479,242,237
050,31,119,"Nebraska","Madison County",5,63,479,237,242
050,31,119,"Nebraska","Madison County",5,64,506,258,248
050,31,119,"Nebraska","Madison County",5,65,504,248,256
050,31,119,"Nebraska","Madison County",5,66,467,233,234
050,31,119,"Nebraska","Madison County",5,67,432,203,229
050,31,119,"Nebraska","Madison County",5,68,433,208,225
050,31,119,"Nebraska","Madison County",5,69,381,198,183
050,31,119,"Nebraska","Madison County",5,70,386,195,191
050,31,119,"Nebraska","Madison County",5,71,313,156,157
050,31,119,"Nebraska","Madison County",5,72,304,134,170
050,31,119,"Nebraska","Madison County",5,73,279,134,145
050,31,119,"Nebraska","Madison County",5,74,262,119,143
050,31,119,"Nebraska","Madison County",5,75,249,107,142
050,31,119,"Nebraska","Madison County",5,76,266,117,149
050,31,119,"Nebraska","Madison County",5,77,206,92,114
050,31,119,"Nebraska","Madison County",5,78,201,94,107
050,31,119,"Nebraska","Madison County",5,79,182,85,97
050,31,119,"Nebraska","Madison County",5,80,165,69,96
050,31,119,"Nebraska","Madison County",5,81,154,65,89
050,31,119,"Nebraska","Madison County",5,82,147,63,84
050,31,119,"Nebraska","Madison County",5,83,152,66,86
050,31,119,"Nebraska","Madison County",5,84,118,56,62
050,31,119,"Nebraska","Madison County",5,85,869,330,539
050,31,121,"Nebraska","Merrick County",1,0,79,41,38
050,31,121,"Nebraska","Merrick County",1,1,80,44,36
050,31,121,"Nebraska","Merrick County",1,2,87,49,38
050,31,121,"Nebraska","Merrick County",1,3,90,49,41
050,31,121,"Nebraska","Merrick County",1,4,93,43,50
050,31,121,"Nebraska","Merrick County",1,5,91,42,49
050,31,121,"Nebraska","Merrick County",1,6,88,44,44
050,31,121,"Nebraska","Merrick County",1,7,87,40,47
050,31,121,"Nebraska","Merrick County",1,8,97,44,53
050,31,121,"Nebraska","Merrick County",1,9,99,49,50
050,31,121,"Nebraska","Merrick County",1,10,93,47,46
050,31,121,"Nebraska","Merrick County",1,11,109,54,55
050,31,121,"Nebraska","Merrick County",1,12,92,53,39
050,31,121,"Nebraska","Merrick County",1,13,102,56,46
050,31,121,"Nebraska","Merrick County",1,14,95,48,47
050,31,121,"Nebraska","Merrick County",1,15,100,55,45
050,31,121,"Nebraska","Merrick County",1,16,109,64,45
050,31,121,"Nebraska","Merrick County",1,17,120,60,60
050,31,121,"Nebraska","Merrick County",1,18,88,44,44
050,31,121,"Nebraska","Merrick County",1,19,66,34,32
050,31,121,"Nebraska","Merrick County",1,20,72,37,35
050,31,121,"Nebraska","Merrick County",1,21,64,32,32
050,31,121,"Nebraska","Merrick County",1,22,82,38,44
050,31,121,"Nebraska","Merrick County",1,23,90,42,48
050,31,121,"Nebraska","Merrick County",1,24,84,41,43
050,31,121,"Nebraska","Merrick County",1,25,90,42,48
050,31,121,"Nebraska","Merrick County",1,26,89,40,49
050,31,121,"Nebraska","Merrick County",1,27,84,43,41
050,31,121,"Nebraska","Merrick County",1,28,89,49,40
050,31,121,"Nebraska","Merrick County",1,29,77,42,35
050,31,121,"Nebraska","Merrick County",1,30,76,41,35
050,31,121,"Nebraska","Merrick County",1,31,85,44,41
050,31,121,"Nebraska","Merrick County",1,32,94,46,48
050,31,121,"Nebraska","Merrick County",1,33,78,38,40
050,31,121,"Nebraska","Merrick County",1,34,75,36,39
050,31,121,"Nebraska","Merrick County",1,35,88,45,43
050,31,121,"Nebraska","Merrick County",1,36,83,34,49
050,31,121,"Nebraska","Merrick County",1,37,84,42,42
050,31,121,"Nebraska","Merrick County",1,38,92,49,43
050,31,121,"Nebraska","Merrick County",1,39,99,51,48
050,31,121,"Nebraska","Merrick County",1,40,102,56,46
050,31,121,"Nebraska","Merrick County",1,41,92,45,47
050,31,121,"Nebraska","Merrick County",1,42,95,47,48
050,31,121,"Nebraska","Merrick County",1,43,81,38,43
050,31,121,"Nebraska","Merrick County",1,44,76,37,39
050,31,121,"Nebraska","Merrick County",1,45,79,39,40
050,31,121,"Nebraska","Merrick County",1,46,90,46,44
050,31,121,"Nebraska","Merrick County",1,47,96,57,39
050,31,121,"Nebraska","Merrick County",1,48,101,55,46
050,31,121,"Nebraska","Merrick County",1,49,87,43,44
050,31,121,"Nebraska","Merrick County",1,50,91,50,41
050,31,121,"Nebraska","Merrick County",1,51,84,47,37
050,31,121,"Nebraska","Merrick County",1,52,79,40,39
050,31,121,"Nebraska","Merrick County",1,53,101,47,54
050,31,121,"Nebraska","Merrick County",1,54,101,45,56
050,31,121,"Nebraska","Merrick County",1,55,113,55,58
050,31,121,"Nebraska","Merrick County",1,56,126,64,62
050,31,121,"Nebraska","Merrick County",1,57,115,60,55
050,31,121,"Nebraska","Merrick County",1,58,115,61,54
050,31,121,"Nebraska","Merrick County",1,59,136,82,54
050,31,121,"Nebraska","Merrick County",1,60,127,64,63
050,31,121,"Nebraska","Merrick County",1,61,113,61,52
050,31,121,"Nebraska","Merrick County",1,62,114,61,53
050,31,121,"Nebraska","Merrick County",1,63,114,60,54
050,31,121,"Nebraska","Merrick County",1,64,107,55,52
050,31,121,"Nebraska","Merrick County",1,65,102,51,51
050,31,121,"Nebraska","Merrick County",1,66,109,55,54
050,31,121,"Nebraska","Merrick County",1,67,107,56,51
050,31,121,"Nebraska","Merrick County",1,68,105,56,49
050,31,121,"Nebraska","Merrick County",1,69,98,56,42
050,31,121,"Nebraska","Merrick County",1,70,78,42,36
050,31,121,"Nebraska","Merrick County",1,71,59,30,29
050,31,121,"Nebraska","Merrick County",1,72,72,37,35
050,31,121,"Nebraska","Merrick County",1,73,93,46,47
050,31,121,"Nebraska","Merrick County",1,74,53,30,23
050,31,121,"Nebraska","Merrick County",1,75,56,28,28
050,31,121,"Nebraska","Merrick County",1,76,59,26,33
050,31,121,"Nebraska","Merrick County",1,77,57,24,33
050,31,121,"Nebraska","Merrick County",1,78,64,29,35
050,31,121,"Nebraska","Merrick County",1,79,44,18,26
050,31,121,"Nebraska","Merrick County",1,80,48,21,27
050,31,121,"Nebraska","Merrick County",1,81,53,24,29
050,31,121,"Nebraska","Merrick County",1,82,47,20,27
050,31,121,"Nebraska","Merrick County",1,83,42,17,25
050,31,121,"Nebraska","Merrick County",1,84,36,21,15
050,31,121,"Nebraska","Merrick County",1,85,208,77,131
050,31,121,"Nebraska","Merrick County",2,0,81,40,41
050,31,121,"Nebraska","Merrick County",2,1,80,43,37
050,31,121,"Nebraska","Merrick County",2,2,86,48,38
050,31,121,"Nebraska","Merrick County",2,3,90,50,40
050,31,121,"Nebraska","Merrick County",2,4,93,45,48
050,31,121,"Nebraska","Merrick County",2,5,91,43,48
050,31,121,"Nebraska","Merrick County",2,6,87,43,44
050,31,121,"Nebraska","Merrick County",2,7,87,41,46
050,31,121,"Nebraska","Merrick County",2,8,93,43,50
050,31,121,"Nebraska","Merrick County",2,9,97,46,51
050,31,121,"Nebraska","Merrick County",2,10,95,47,48
050,31,121,"Nebraska","Merrick County",2,11,105,51,54
050,31,121,"Nebraska","Merrick County",2,12,98,54,44
050,31,121,"Nebraska","Merrick County",2,13,99,54,45
050,31,121,"Nebraska","Merrick County",2,14,98,51,47
050,31,121,"Nebraska","Merrick County",2,15,99,55,44
050,31,121,"Nebraska","Merrick County",2,16,110,63,47
050,31,121,"Nebraska","Merrick County",2,17,115,59,56
050,31,121,"Nebraska","Merrick County",2,18,89,45,44
050,31,121,"Nebraska","Merrick County",2,19,67,35,32
050,31,121,"Nebraska","Merrick County",2,20,71,37,34
050,31,121,"Nebraska","Merrick County",2,21,66,33,33
050,31,121,"Nebraska","Merrick County",2,22,80,38,42
050,31,121,"Nebraska","Merrick County",2,23,89,42,47
050,31,121,"Nebraska","Merrick County",2,24,86,41,45
050,31,121,"Nebraska","Merrick County",2,25,90,42,48
050,31,121,"Nebraska","Merrick County",2,26,90,41,49
050,31,121,"Nebraska","Merrick County",2,27,84,42,42
050,31,121,"Nebraska","Merrick County",2,28,87,47,40
050,31,121,"Nebraska","Merrick County",2,29,79,43,36
050,31,121,"Nebraska","Merrick County",2,30,78,42,36
050,31,121,"Nebraska","Merrick County",2,31,84,44,40
050,31,121,"Nebraska","Merrick County",2,32,92,45,47
050,31,121,"Nebraska","Merrick County",2,33,80,39,41
050,31,121,"Nebraska","Merrick County",2,34,77,38,39
050,31,121,"Nebraska","Merrick County",2,35,83,41,42
050,31,121,"Nebraska","Merrick County",2,36,83,36,47
050,31,121,"Nebraska","Merrick County",2,37,84,41,43
050,31,121,"Nebraska","Merrick County",2,38,92,48,44
050,31,121,"Nebraska","Merrick County",2,39,95,49,46
050,31,121,"Nebraska","Merrick County",2,40,104,57,47
050,31,121,"Nebraska","Merrick County",2,41,93,46,47
050,31,121,"Nebraska","Merrick County",2,42,93,46,47
050,31,121,"Nebraska","Merrick County",2,43,86,41,45
050,31,121,"Nebraska","Merrick County",2,44,75,36,39
050,31,121,"Nebraska","Merrick County",2,45,78,39,39
050,31,121,"Nebraska","Merrick County",2,46,86,44,42
050,31,121,"Nebraska","Merrick County",2,47,95,55,40
050,31,121,"Nebraska","Merrick County",2,48,100,56,44
050,31,121,"Nebraska","Merrick County",2,49,91,46,45
050,31,121,"Nebraska","Merrick County",2,50,90,48,42
050,31,121,"Nebraska","Merrick County",2,51,86,48,38
050,31,121,"Nebraska","Merrick County",2,52,80,42,38
050,31,121,"Nebraska","Merrick County",2,53,96,46,50
050,31,121,"Nebraska","Merrick County",2,54,101,45,56
050,31,121,"Nebraska","Merrick County",2,55,112,53,59
050,31,121,"Nebraska","Merrick County",2,56,123,62,61
050,31,121,"Nebraska","Merrick County",2,57,117,61,56
050,31,121,"Nebraska","Merrick County",2,58,114,60,54
050,31,121,"Nebraska","Merrick County",2,59,131,78,53
050,31,121,"Nebraska","Merrick County",2,60,129,68,61
050,31,121,"Nebraska","Merrick County",2,61,116,62,54
050,31,121,"Nebraska","Merrick County",2,62,115,62,53
050,31,121,"Nebraska","Merrick County",2,63,117,61,56
050,31,121,"Nebraska","Merrick County",2,64,109,57,52
050,31,121,"Nebraska","Merrick County",2,65,102,51,51
050,31,121,"Nebraska","Merrick County",2,66,105,53,52
050,31,121,"Nebraska","Merrick County",2,67,106,56,50
050,31,121,"Nebraska","Merrick County",2,68,105,55,50
050,31,121,"Nebraska","Merrick County",2,69,101,57,44
050,31,121,"Nebraska","Merrick County",2,70,82,45,37
050,31,121,"Nebraska","Merrick County",2,71,64,33,31
050,31,121,"Nebraska","Merrick County",2,72,67,34,33
050,31,121,"Nebraska","Merrick County",2,73,92,45,47
050,31,121,"Nebraska","Merrick County",2,74,57,31,26
050,31,121,"Nebraska","Merrick County",2,75,55,28,27
050,31,121,"Nebraska","Merrick County",2,76,56,25,31
050,31,121,"Nebraska","Merrick County",2,77,59,25,34
050,31,121,"Nebraska","Merrick County",2,78,63,28,35
050,31,121,"Nebraska","Merrick County",2,79,47,19,28
050,31,121,"Nebraska","Merrick County",2,80,46,19,27
050,31,121,"Nebraska","Merrick County",2,81,52,24,28
050,31,121,"Nebraska","Merrick County",2,82,47,20,27
050,31,121,"Nebraska","Merrick County",2,83,44,18,26
050,31,121,"Nebraska","Merrick County",2,84,36,20,16
050,31,121,"Nebraska","Merrick County",2,85,208,76,132
050,31,121,"Nebraska","Merrick County",3,0,87,49,38
050,31,121,"Nebraska","Merrick County",3,1,79,44,35
050,31,121,"Nebraska","Merrick County",3,2,79,43,36
050,31,121,"Nebraska","Merrick County",3,3,83,46,37
050,31,121,"Nebraska","Merrick County",3,4,88,50,38
050,31,121,"Nebraska","Merrick County",3,5,93,44,49
050,31,121,"Nebraska","Merrick County",3,6,92,45,47
050,31,121,"Nebraska","Merrick County",3,7,90,43,47
050,31,121,"Nebraska","Merrick County",3,8,84,40,44
050,31,121,"Nebraska","Merrick County",3,9,91,40,51
050,31,121,"Nebraska","Merrick County",3,10,96,41,55
050,31,121,"Nebraska","Merrick County",3,11,105,56,49
050,31,121,"Nebraska","Merrick County",3,12,100,51,49
050,31,121,"Nebraska","Merrick County",3,13,97,52,45
050,31,121,"Nebraska","Merrick County",3,14,102,59,43
050,31,121,"Nebraska","Merrick County",3,15,109,58,51
050,31,121,"Nebraska","Merrick County",3,16,111,59,52
050,31,121,"Nebraska","Merrick County",3,17,103,60,43
050,31,121,"Nebraska","Merrick County",3,18,100,55,45
050,31,121,"Nebraska","Merrick County",3,19,73,39,34
050,31,121,"Nebraska","Merrick County",3,20,68,37,31
050,31,121,"Nebraska","Merrick County",3,21,66,37,29
050,31,121,"Nebraska","Merrick County",3,22,69,33,36
050,31,121,"Nebraska","Merrick County",3,23,79,44,35
050,31,121,"Nebraska","Merrick County",3,24,87,43,44
050,31,121,"Nebraska","Merrick County",3,25,93,44,49
050,31,121,"Nebraska","Merrick County",3,26,100,48,52
050,31,121,"Nebraska","Merrick County",3,27,99,49,50
050,31,121,"Nebraska","Merrick County",3,28,85,43,42
050,31,121,"Nebraska","Merrick County",3,29,90,52,38
050,31,121,"Nebraska","Merrick County",3,30,81,43,38
050,31,121,"Nebraska","Merrick County",3,31,75,42,33
050,31,121,"Nebraska","Merrick County",3,32,91,48,43
050,31,121,"Nebraska","Merrick County",3,33,93,42,51
050,31,121,"Nebraska","Merrick County",3,34,79,39,40
050,31,121,"Nebraska","Merrick County",3,35,82,40,42
050,31,121,"Nebraska","Merrick County",3,36,85,40,45
050,31,121,"Nebraska","Merrick County",3,37,93,44,49
050,31,121,"Nebraska","Merrick County",3,38,81,38,43
050,31,121,"Nebraska","Merrick County",3,39,90,46,44
050,31,121,"Nebraska","Merrick County",3,40,90,50,40
050,31,121,"Nebraska","Merrick County",3,41,110,57,53
050,31,121,"Nebraska","Merrick County",3,42,89,43,46
050,31,121,"Nebraska","Merrick County",3,43,88,44,44
050,31,121,"Nebraska","Merrick County",3,44,90,44,46
050,31,121,"Nebraska","Merrick County",3,45,79,37,42
050,31,121,"Nebraska","Merrick County",3,46,77,36,41
050,31,121,"Nebraska","Merrick County",3,47,90,43,47
050,31,121,"Nebraska","Merrick County",3,48,98,57,41
050,31,121,"Nebraska","Merrick County",3,49,99,55,44
050,31,121,"Nebraska","Merrick County",3,50,90,50,40
050,31,121,"Nebraska","Merrick County",3,51,89,45,44
050,31,121,"Nebraska","Merrick County",3,52,90,53,37
050,31,121,"Nebraska","Merrick County",3,53,81,41,40
050,31,121,"Nebraska","Merrick County",3,54,99,47,52
050,31,121,"Nebraska","Merrick County",3,55,97,43,54
050,31,121,"Nebraska","Merrick County",3,56,101,48,53
050,31,121,"Nebraska","Merrick County",3,57,118,60,58
050,31,121,"Nebraska","Merrick County",3,58,111,58,53
050,31,121,"Nebraska","Merrick County",3,59,116,63,53
050,31,121,"Nebraska","Merrick County",3,60,127,74,53
050,31,121,"Nebraska","Merrick County",3,61,116,65,51
050,31,121,"Nebraska","Merrick County",3,62,118,64,54
050,31,121,"Nebraska","Merrick County",3,63,117,60,57
050,31,121,"Nebraska","Merrick County",3,64,115,62,53
050,31,121,"Nebraska","Merrick County",3,65,108,53,55
050,31,121,"Nebraska","Merrick County",3,66,102,53,49
050,31,121,"Nebraska","Merrick County",3,67,105,52,53
050,31,121,"Nebraska","Merrick County",3,68,111,57,54
050,31,121,"Nebraska","Merrick County",3,69,102,57,45
050,31,121,"Nebraska","Merrick County",3,70,94,52,42
050,31,121,"Nebraska","Merrick County",3,71,81,45,36
050,31,121,"Nebraska","Merrick County",3,72,61,31,30
050,31,121,"Nebraska","Merrick County",3,73,68,34,34
050,31,121,"Nebraska","Merrick County",3,74,92,45,47
050,31,121,"Nebraska","Merrick County",3,75,54,29,25
050,31,121,"Nebraska","Merrick County",3,76,51,26,25
050,31,121,"Nebraska","Merrick County",3,77,52,24,28
050,31,121,"Nebraska","Merrick County",3,78,59,27,32
050,31,121,"Nebraska","Merrick County",3,79,59,25,34
050,31,121,"Nebraska","Merrick County",3,80,38,14,24
050,31,121,"Nebraska","Merrick County",3,81,41,17,24
050,31,121,"Nebraska","Merrick County",3,82,47,20,27
050,31,121,"Nebraska","Merrick County",3,83,48,20,28
050,31,121,"Nebraska","Merrick County",3,84,41,18,23
050,31,121,"Nebraska","Merrick County",3,85,210,75,135
050,31,121,"Nebraska","Merrick County",4,0,83,45,38
050,31,121,"Nebraska","Merrick County",4,1,101,54,47
050,31,121,"Nebraska","Merrick County",4,2,81,46,35
050,31,121,"Nebraska","Merrick County",4,3,87,47,40
050,31,121,"Nebraska","Merrick County",4,4,82,45,37
050,31,121,"Nebraska","Merrick County",4,5,96,57,39
050,31,121,"Nebraska","Merrick County",4,6,95,47,48
050,31,121,"Nebraska","Merrick County",4,7,97,50,47
050,31,121,"Nebraska","Merrick County",4,8,87,41,46
050,31,121,"Nebraska","Merrick County",4,9,89,39,50
050,31,121,"Nebraska","Merrick County",4,10,95,45,50
050,31,121,"Nebraska","Merrick County",4,11,100,43,57
050,31,121,"Nebraska","Merrick County",4,12,101,51,50
050,31,121,"Nebraska","Merrick County",4,13,101,52,49
050,31,121,"Nebraska","Merrick County",4,14,96,51,45
050,31,121,"Nebraska","Merrick County",4,15,112,64,48
050,31,121,"Nebraska","Merrick County",4,16,120,62,58
050,31,121,"Nebraska","Merrick County",4,17,105,53,52
050,31,121,"Nebraska","Merrick County",4,18,93,55,38
050,31,121,"Nebraska","Merrick County",4,19,65,35,30
050,31,121,"Nebraska","Merrick County",4,20,72,43,29
050,31,121,"Nebraska","Merrick County",4,21,67,35,32
050,31,121,"Nebraska","Merrick County",4,22,74,38,36
050,31,121,"Nebraska","Merrick County",4,23,79,38,41
050,31,121,"Nebraska","Merrick County",4,24,82,48,34
050,31,121,"Nebraska","Merrick County",4,25,83,40,43
050,31,121,"Nebraska","Merrick County",4,26,88,42,46
050,31,121,"Nebraska","Merrick County",4,27,112,54,58
050,31,121,"Nebraska","Merrick County",4,28,101,47,54
050,31,121,"Nebraska","Merrick County",4,29,85,46,39
050,31,121,"Nebraska","Merrick County",4,30,84,47,37
050,31,121,"Nebraska","Merrick County",4,31,80,39,41
050,31,121,"Nebraska","Merrick County",4,32,80,46,34
050,31,121,"Nebraska","Merrick County",4,33,95,53,42
050,31,121,"Nebraska","Merrick County",4,34,92,41,51
050,31,121,"Nebraska","Merrick County",4,35,89,45,44
050,31,121,"Nebraska","Merrick County",4,36,74,37,37
050,31,121,"Nebraska","Merrick County",4,37,85,40,45
050,31,121,"Nebraska","Merrick County",4,38,96,43,53
050,31,121,"Nebraska","Merrick County",4,39,82,39,43
050,31,121,"Nebraska","Merrick County",4,40,91,48,43
050,31,121,"Nebraska","Merrick County",4,41,92,51,41
050,31,121,"Nebraska","Merrick County",4,42,109,56,53
050,31,121,"Nebraska","Merrick County",4,43,95,46,49
050,31,121,"Nebraska","Merrick County",4,44,90,47,43
050,31,121,"Nebraska","Merrick County",4,45,90,45,45
050,31,121,"Nebraska","Merrick County",4,46,77,35,42
050,31,121,"Nebraska","Merrick County",4,47,78,36,42
050,31,121,"Nebraska","Merrick County",4,48,89,44,45
050,31,121,"Nebraska","Merrick County",4,49,101,57,44
050,31,121,"Nebraska","Merrick County",4,50,102,55,47
050,31,121,"Nebraska","Merrick County",4,51,96,51,45
050,31,121,"Nebraska","Merrick County",4,52,91,48,43
050,31,121,"Nebraska","Merrick County",4,53,90,55,35
050,31,121,"Nebraska","Merrick County",4,54,86,46,40
050,31,121,"Nebraska","Merrick County",4,55,100,48,52
050,31,121,"Nebraska","Merrick County",4,56,90,41,49
050,31,121,"Nebraska","Merrick County",4,57,100,46,54
050,31,121,"Nebraska","Merrick County",4,58,116,59,57
050,31,121,"Nebraska","Merrick County",4,59,115,60,55
050,31,121,"Nebraska","Merrick County",4,60,117,62,55
050,31,121,"Nebraska","Merrick County",4,61,124,74,50
050,31,121,"Nebraska","Merrick County",4,62,120,66,54
050,31,121,"Nebraska","Merrick County",4,63,118,61,57
050,31,121,"Nebraska","Merrick County",4,64,114,57,57
050,31,121,"Nebraska","Merrick County",4,65,112,59,53
050,31,121,"Nebraska","Merrick County",4,66,109,58,51
050,31,121,"Nebraska","Merrick County",4,67,98,51,47
050,31,121,"Nebraska","Merrick County",4,68,101,49,52
050,31,121,"Nebraska","Merrick County",4,69,105,54,51
050,31,121,"Nebraska","Merrick County",4,70,99,55,44
050,31,121,"Nebraska","Merrick County",4,71,85,47,38
050,31,121,"Nebraska","Merrick County",4,72,83,46,37
050,31,121,"Nebraska","Merrick County",4,73,60,28,32
050,31,121,"Nebraska","Merrick County",4,74,59,30,29
050,31,121,"Nebraska","Merrick County",4,75,89,42,47
050,31,121,"Nebraska","Merrick County",4,76,55,28,27
050,31,121,"Nebraska","Merrick County",4,77,48,25,23
050,31,121,"Nebraska","Merrick County",4,78,52,25,27
050,31,121,"Nebraska","Merrick County",4,79,57,25,32
050,31,121,"Nebraska","Merrick County",4,80,49,22,27
050,31,121,"Nebraska","Merrick County",4,81,34,13,21
050,31,121,"Nebraska","Merrick County",4,82,37,14,23
050,31,121,"Nebraska","Merrick County",4,83,49,20,29
050,31,121,"Nebraska","Merrick County",4,84,43,19,24
050,31,121,"Nebraska","Merrick County",4,85,214,72,142
050,31,121,"Nebraska","Merrick County",5,0,83,45,38
050,31,121,"Nebraska","Merrick County",5,1,84,47,37
050,31,121,"Nebraska","Merrick County",5,2,92,49,43
050,31,121,"Nebraska","Merrick County",5,3,86,48,38
050,31,121,"Nebraska","Merrick County",5,4,88,45,43
050,31,121,"Nebraska","Merrick County",5,5,85,49,36
050,31,121,"Nebraska","Merrick County",5,6,103,64,39
050,31,121,"Nebraska","Merrick County",5,7,96,42,54
050,31,121,"Nebraska","Merrick County",5,8,99,49,50
050,31,121,"Nebraska","Merrick County",5,9,93,48,45
050,31,121,"Nebraska","Merrick County",5,10,92,42,50
050,31,121,"Nebraska","Merrick County",5,11,97,45,52
050,31,121,"Nebraska","Merrick County",5,12,109,47,62
050,31,121,"Nebraska","Merrick County",5,13,106,58,48
050,31,121,"Nebraska","Merrick County",5,14,104,55,49
050,31,121,"Nebraska","Merrick County",5,15,106,56,50
050,31,121,"Nebraska","Merrick County",5,16,119,70,49
050,31,121,"Nebraska","Merrick County",5,17,116,59,57
050,31,121,"Nebraska","Merrick County",5,18,89,47,42
050,31,121,"Nebraska","Merrick County",5,19,75,45,30
050,31,121,"Nebraska","Merrick County",5,20,72,39,33
050,31,121,"Nebraska","Merrick County",5,21,70,40,30
050,31,121,"Nebraska","Merrick County",5,22,72,38,34
050,31,121,"Nebraska","Merrick County",5,23,68,33,35
050,31,121,"Nebraska","Merrick County",5,24,76,36,40
050,31,121,"Nebraska","Merrick County",5,25,79,42,37
050,31,121,"Nebraska","Merrick County",5,26,78,39,39
050,31,121,"Nebraska","Merrick County",5,27,85,41,44
050,31,121,"Nebraska","Merrick County",5,28,104,54,50
050,31,121,"Nebraska","Merrick County",5,29,101,45,56
050,31,121,"Nebraska","Merrick County",5,30,89,48,41
050,31,121,"Nebraska","Merrick County",5,31,90,52,38
050,31,121,"Nebraska","Merrick County",5,32,76,39,37
050,31,121,"Nebraska","Merrick County",5,33,85,45,40
050,31,121,"Nebraska","Merrick County",5,34,95,53,42
050,31,121,"Nebraska","Merrick County",5,35,99,43,56
050,31,121,"Nebraska","Merrick County",5,36,89,45,44
050,31,121,"Nebraska","Merrick County",5,37,85,44,41
050,31,121,"Nebraska","Merrick County",5,38,87,39,48
050,31,121,"Nebraska","Merrick County",5,39,99,43,56
050,31,121,"Nebraska","Merrick County",5,40,87,41,46
050,31,121,"Nebraska","Merrick County",5,41,94,48,46
050,31,121,"Nebraska","Merrick County",5,42,101,56,45
050,31,121,"Nebraska","Merrick County",5,43,110,57,53
050,31,121,"Nebraska","Merrick County",5,44,102,52,50
050,31,121,"Nebraska","Merrick County",5,45,90,49,41
050,31,121,"Nebraska","Merrick County",5,46,82,39,43
050,31,121,"Nebraska","Merrick County",5,47,74,34,40
050,31,121,"Nebraska","Merrick County",5,48,75,37,38
050,31,121,"Nebraska","Merrick County",5,49,91,43,48
050,31,121,"Nebraska","Merrick County",5,50,100,58,42
050,31,121,"Nebraska","Merrick County",5,51,103,58,45
050,31,121,"Nebraska","Merrick County",5,52,93,50,43
050,31,121,"Nebraska","Merrick County",5,53,90,49,41
050,31,121,"Nebraska","Merrick County",5,54,92,52,40
050,31,121,"Nebraska","Merrick County",5,55,83,41,42
050,31,121,"Nebraska","Merrick County",5,56,102,50,52
050,31,121,"Nebraska","Merrick County",5,57,94,41,53
050,31,121,"Nebraska","Merrick County",5,58,101,45,56
050,31,121,"Nebraska","Merrick County",5,59,116,60,56
050,31,121,"Nebraska","Merrick County",5,60,119,65,54
050,31,121,"Nebraska","Merrick County",5,61,117,62,55
050,31,121,"Nebraska","Merrick County",5,62,119,69,50
050,31,121,"Nebraska","Merrick County",5,63,122,66,56
050,31,121,"Nebraska","Merrick County",5,64,121,65,56
050,31,121,"Nebraska","Merrick County",5,65,109,54,55
050,31,121,"Nebraska","Merrick County",5,66,110,58,52
050,31,121,"Nebraska","Merrick County",5,67,107,57,50
050,31,121,"Nebraska","Merrick County",5,68,97,49,48
050,31,121,"Nebraska","Merrick County",5,69,97,48,49
050,31,121,"Nebraska","Merrick County",5,70,100,50,50
050,31,121,"Nebraska","Merrick County",5,71,92,52,40
050,31,121,"Nebraska","Merrick County",5,72,85,48,37
050,31,121,"Nebraska","Merrick County",5,73,82,43,39
050,31,121,"Nebraska","Merrick County",5,74,54,25,29
050,31,121,"Nebraska","Merrick County",5,75,56,26,30
050,31,121,"Nebraska","Merrick County",5,76,87,40,47
050,31,121,"Nebraska","Merrick County",5,77,49,25,24
050,31,121,"Nebraska","Merrick County",5,78,49,27,22
050,31,121,"Nebraska","Merrick County",5,79,50,23,27
050,31,121,"Nebraska","Merrick County",5,80,48,23,25
050,31,121,"Nebraska","Merrick County",5,81,44,21,23
050,31,121,"Nebraska","Merrick County",5,82,32,10,22
050,31,121,"Nebraska","Merrick County",5,83,39,13,26
050,31,121,"Nebraska","Merrick County",5,84,44,20,24
050,31,121,"Nebraska","Merrick County",5,85,225,74,151
050,31,123,"Nebraska","Morrill County",1,0,49,25,24
050,31,123,"Nebraska","Morrill County",1,1,48,25,23
050,31,123,"Nebraska","Morrill County",1,2,47,25,22
050,31,123,"Nebraska","Morrill County",1,3,42,20,22
050,31,123,"Nebraska","Morrill County",1,4,52,28,24
050,31,123,"Nebraska","Morrill County",1,5,55,29,26
050,31,123,"Nebraska","Morrill County",1,6,54,26,28
050,31,123,"Nebraska","Morrill County",1,7,51,23,28
050,31,123,"Nebraska","Morrill County",1,8,54,30,24
050,31,123,"Nebraska","Morrill County",1,9,58,32,26
050,31,123,"Nebraska","Morrill County",1,10,61,31,30
050,31,123,"Nebraska","Morrill County",1,11,65,36,29
050,31,123,"Nebraska","Morrill County",1,12,64,34,30
050,31,123,"Nebraska","Morrill County",1,13,50,20,30
050,31,123,"Nebraska","Morrill County",1,14,66,29,37
050,31,123,"Nebraska","Morrill County",1,15,67,34,33
050,31,123,"Nebraska","Morrill County",1,16,69,39,30
050,31,123,"Nebraska","Morrill County",1,17,56,36,20
050,31,123,"Nebraska","Morrill County",1,18,57,30,27
050,31,123,"Nebraska","Morrill County",1,19,51,26,25
050,31,123,"Nebraska","Morrill County",1,20,46,22,24
050,31,123,"Nebraska","Morrill County",1,21,42,25,17
050,31,123,"Nebraska","Morrill County",1,22,51,30,21
050,31,123,"Nebraska","Morrill County",1,23,54,34,20
050,31,123,"Nebraska","Morrill County",1,24,54,31,23
050,31,123,"Nebraska","Morrill County",1,25,50,26,24
050,31,123,"Nebraska","Morrill County",1,26,53,29,24
050,31,123,"Nebraska","Morrill County",1,27,53,25,28
050,31,123,"Nebraska","Morrill County",1,28,49,26,23
050,31,123,"Nebraska","Morrill County",1,29,44,24,20
050,31,123,"Nebraska","Morrill County",1,30,39,20,19
050,31,123,"Nebraska","Morrill County",1,31,55,29,26
050,31,123,"Nebraska","Morrill County",1,32,51,24,27
050,31,123,"Nebraska","Morrill County",1,33,43,21,22
050,31,123,"Nebraska","Morrill County",1,34,56,29,27
050,31,123,"Nebraska","Morrill County",1,35,53,29,24
050,31,123,"Nebraska","Morrill County",1,36,65,31,34
050,31,123,"Nebraska","Morrill County",1,37,45,25,20
050,31,123,"Nebraska","Morrill County",1,38,51,28,23
050,31,123,"Nebraska","Morrill County",1,39,48,23,25
050,31,123,"Nebraska","Morrill County",1,40,47,26,21
050,31,123,"Nebraska","Morrill County",1,41,56,33,23
050,31,123,"Nebraska","Morrill County",1,42,46,26,20
050,31,123,"Nebraska","Morrill County",1,43,53,23,30
050,31,123,"Nebraska","Morrill County",1,44,52,28,24
050,31,123,"Nebraska","Morrill County",1,45,55,33,22
050,31,123,"Nebraska","Morrill County",1,46,47,20,27
050,31,123,"Nebraska","Morrill County",1,47,53,19,34
050,31,123,"Nebraska","Morrill County",1,48,57,21,36
050,31,123,"Nebraska","Morrill County",1,49,60,29,31
050,31,123,"Nebraska","Morrill County",1,50,55,32,23
050,31,123,"Nebraska","Morrill County",1,51,50,32,18
050,31,123,"Nebraska","Morrill County",1,52,53,36,17
050,31,123,"Nebraska","Morrill County",1,53,46,29,17
050,31,123,"Nebraska","Morrill County",1,54,47,25,22
050,31,123,"Nebraska","Morrill County",1,55,58,33,25
050,31,123,"Nebraska","Morrill County",1,56,65,32,33
050,31,123,"Nebraska","Morrill County",1,57,64,32,32
050,31,123,"Nebraska","Morrill County",1,58,63,27,36
050,31,123,"Nebraska","Morrill County",1,59,64,29,35
050,31,123,"Nebraska","Morrill County",1,60,64,34,30
050,31,123,"Nebraska","Morrill County",1,61,70,37,33
050,31,123,"Nebraska","Morrill County",1,62,63,32,31
050,31,123,"Nebraska","Morrill County",1,63,69,34,35
050,31,123,"Nebraska","Morrill County",1,64,79,41,38
050,31,123,"Nebraska","Morrill County",1,65,73,37,36
050,31,123,"Nebraska","Morrill County",1,66,69,35,34
050,31,123,"Nebraska","Morrill County",1,67,64,34,30
050,31,123,"Nebraska","Morrill County",1,68,60,31,29
050,31,123,"Nebraska","Morrill County",1,69,58,31,27
050,31,123,"Nebraska","Morrill County",1,70,57,32,25
050,31,123,"Nebraska","Morrill County",1,71,49,27,22
050,31,123,"Nebraska","Morrill County",1,72,40,20,20
050,31,123,"Nebraska","Morrill County",1,73,43,21,22
050,31,123,"Nebraska","Morrill County",1,74,33,18,15
050,31,123,"Nebraska","Morrill County",1,75,34,18,16
050,31,123,"Nebraska","Morrill County",1,76,41,24,17
050,31,123,"Nebraska","Morrill County",1,77,38,17,21
050,31,123,"Nebraska","Morrill County",1,78,39,19,20
050,31,123,"Nebraska","Morrill County",1,79,39,23,16
050,31,123,"Nebraska","Morrill County",1,80,32,18,14
050,31,123,"Nebraska","Morrill County",1,81,31,15,16
050,31,123,"Nebraska","Morrill County",1,82,22,9,13
050,31,123,"Nebraska","Morrill County",1,83,22,6,16
050,31,123,"Nebraska","Morrill County",1,84,21,9,12
050,31,123,"Nebraska","Morrill County",1,85,143,54,89
050,31,123,"Nebraska","Morrill County",2,0,51,28,23
050,31,123,"Nebraska","Morrill County",2,1,48,25,23
050,31,123,"Nebraska","Morrill County",2,2,47,25,22
050,31,123,"Nebraska","Morrill County",2,3,42,21,21
050,31,123,"Nebraska","Morrill County",2,4,50,26,24
050,31,123,"Nebraska","Morrill County",2,5,54,29,25
050,31,123,"Nebraska","Morrill County",2,6,53,26,27
050,31,123,"Nebraska","Morrill County",2,7,53,25,28
050,31,123,"Nebraska","Morrill County",2,8,54,29,25
050,31,123,"Nebraska","Morrill County",2,9,56,31,25
050,31,123,"Nebraska","Morrill County",2,10,59,31,28
050,31,123,"Nebraska","Morrill County",2,11,63,35,28
050,31,123,"Nebraska","Morrill County",2,12,65,35,30
050,31,123,"Nebraska","Morrill County",2,13,52,23,29
050,31,123,"Nebraska","Morrill County",2,14,63,27,36
050,31,123,"Nebraska","Morrill County",2,15,68,33,35
050,31,123,"Nebraska","Morrill County",2,16,69,39,30
050,31,123,"Nebraska","Morrill County",2,17,58,36,22
050,31,123,"Nebraska","Morrill County",2,18,54,30,24
050,31,123,"Nebraska","Morrill County",2,19,50,25,25
050,31,123,"Nebraska","Morrill County",2,20,47,24,23
050,31,123,"Nebraska","Morrill County",2,21,44,25,19
050,31,123,"Nebraska","Morrill County",2,22,51,31,20
050,31,123,"Nebraska","Morrill County",2,23,55,34,21
050,31,123,"Nebraska","Morrill County",2,24,54,32,22
050,31,123,"Nebraska","Morrill County",2,25,50,27,23
050,31,123,"Nebraska","Morrill County",2,26,53,29,24
050,31,123,"Nebraska","Morrill County",2,27,53,26,27
050,31,123,"Nebraska","Morrill County",2,28,51,26,25
050,31,123,"Nebraska","Morrill County",2,29,46,25,21
050,31,123,"Nebraska","Morrill County",2,30,41,21,20
050,31,123,"Nebraska","Morrill County",2,31,52,27,25
050,31,123,"Nebraska","Morrill County",2,32,51,25,26
050,31,123,"Nebraska","Morrill County",2,33,45,22,23
050,31,123,"Nebraska","Morrill County",2,34,54,28,26
050,31,123,"Nebraska","Morrill County",2,35,55,29,26
050,31,123,"Nebraska","Morrill County",2,36,60,30,30
050,31,123,"Nebraska","Morrill County",2,37,49,27,22
050,31,123,"Nebraska","Morrill County",2,38,51,28,23
050,31,123,"Nebraska","Morrill County",2,39,49,24,25
050,31,123,"Nebraska","Morrill County",2,40,46,24,22
050,31,123,"Nebraska","Morrill County",2,41,54,32,22
050,31,123,"Nebraska","Morrill County",2,42,47,27,20
050,31,123,"Nebraska","Morrill County",2,43,50,24,26
050,31,123,"Nebraska","Morrill County",2,44,52,27,25
050,31,123,"Nebraska","Morrill County",2,45,55,32,23
050,31,123,"Nebraska","Morrill County",2,46,48,22,26
050,31,123,"Nebraska","Morrill County",2,47,52,20,32
050,31,123,"Nebraska","Morrill County",2,48,56,20,36
050,31,123,"Nebraska","Morrill County",2,49,60,28,32
050,31,123,"Nebraska","Morrill County",2,50,56,31,25
050,31,123,"Nebraska","Morrill County",2,51,50,32,18
050,31,123,"Nebraska","Morrill County",2,52,52,35,17
050,31,123,"Nebraska","Morrill County",2,53,48,31,17
050,31,123,"Nebraska","Morrill County",2,54,47,26,21
050,31,123,"Nebraska","Morrill County",2,55,55,31,24
050,31,123,"Nebraska","Morrill County",2,56,63,32,31
050,31,123,"Nebraska","Morrill County",2,57,63,31,32
050,31,123,"Nebraska","Morrill County",2,58,64,28,36
050,31,123,"Nebraska","Morrill County",2,59,63,28,35
050,31,123,"Nebraska","Morrill County",2,60,63,33,30
050,31,123,"Nebraska","Morrill County",2,61,69,36,33
050,31,123,"Nebraska","Morrill County",2,62,65,34,31
050,31,123,"Nebraska","Morrill County",2,63,67,33,34
050,31,123,"Nebraska","Morrill County",2,64,76,39,37
050,31,123,"Nebraska","Morrill County",2,65,75,38,37
050,31,123,"Nebraska","Morrill County",2,66,71,36,35
050,31,123,"Nebraska","Morrill County",2,67,66,35,31
050,31,123,"Nebraska","Morrill County",2,68,60,31,29
050,31,123,"Nebraska","Morrill County",2,69,57,30,27
050,31,123,"Nebraska","Morrill County",2,70,58,31,27
050,31,123,"Nebraska","Morrill County",2,71,50,29,21
050,31,123,"Nebraska","Morrill County",2,72,41,21,20
050,31,123,"Nebraska","Morrill County",2,73,45,22,23
050,31,123,"Nebraska","Morrill County",2,74,33,17,16
050,31,123,"Nebraska","Morrill County",2,75,35,19,16
050,31,123,"Nebraska","Morrill County",2,76,37,22,15
050,31,123,"Nebraska","Morrill County",2,77,38,17,21
050,31,123,"Nebraska","Morrill County",2,78,39,19,20
050,31,123,"Nebraska","Morrill County",2,79,38,22,16
050,31,123,"Nebraska","Morrill County",2,80,34,19,15
050,31,123,"Nebraska","Morrill County",2,81,31,15,16
050,31,123,"Nebraska","Morrill County",2,82,22,9,13
050,31,123,"Nebraska","Morrill County",2,83,24,7,17
050,31,123,"Nebraska","Morrill County",2,84,20,8,12
050,31,123,"Nebraska","Morrill County",2,85,145,55,90
050,31,123,"Nebraska","Morrill County",3,0,52,25,27
050,31,123,"Nebraska","Morrill County",3,1,53,34,19
050,31,123,"Nebraska","Morrill County",3,2,51,26,25
050,31,123,"Nebraska","Morrill County",3,3,47,23,24
050,31,123,"Nebraska","Morrill County",3,4,47,21,26
050,31,123,"Nebraska","Morrill County",3,5,55,29,26
050,31,123,"Nebraska","Morrill County",3,6,59,34,25
050,31,123,"Nebraska","Morrill County",3,7,56,30,26
050,31,123,"Nebraska","Morrill County",3,8,48,22,26
050,31,123,"Nebraska","Morrill County",3,9,58,34,24
050,31,123,"Nebraska","Morrill County",3,10,49,30,19
050,31,123,"Nebraska","Morrill County",3,11,62,32,30
050,31,123,"Nebraska","Morrill County",3,12,69,39,30
050,31,123,"Nebraska","Morrill County",3,13,65,38,27
050,31,123,"Nebraska","Morrill County",3,14,56,25,31
050,31,123,"Nebraska","Morrill County",3,15,65,28,37
050,31,123,"Nebraska","Morrill County",3,16,70,35,35
050,31,123,"Nebraska","Morrill County",3,17,66,38,28
050,31,123,"Nebraska","Morrill County",3,18,50,31,19
050,31,123,"Nebraska","Morrill County",3,19,42,23,19
050,31,123,"Nebraska","Morrill County",3,20,54,26,28
050,31,123,"Nebraska","Morrill County",3,21,46,22,24
050,31,123,"Nebraska","Morrill County",3,22,45,25,20
050,31,123,"Nebraska","Morrill County",3,23,49,35,14
050,31,123,"Nebraska","Morrill County",3,24,54,33,21
050,31,123,"Nebraska","Morrill County",3,25,52,27,25
050,31,123,"Nebraska","Morrill County",3,26,49,29,20
050,31,123,"Nebraska","Morrill County",3,27,50,25,25
050,31,123,"Nebraska","Morrill County",3,28,54,28,26
050,31,123,"Nebraska","Morrill County",3,29,48,23,25
050,31,123,"Nebraska","Morrill County",3,30,44,24,20
050,31,123,"Nebraska","Morrill County",3,31,43,24,19
050,31,123,"Nebraska","Morrill County",3,32,54,26,28
050,31,123,"Nebraska","Morrill County",3,33,54,28,26
050,31,123,"Nebraska","Morrill County",3,34,47,25,22
050,31,123,"Nebraska","Morrill County",3,35,59,28,31
050,31,123,"Nebraska","Morrill County",3,36,58,31,27
050,31,123,"Nebraska","Morrill County",3,37,63,32,31
050,31,123,"Nebraska","Morrill County",3,38,48,27,21
050,31,123,"Nebraska","Morrill County",3,39,48,26,22
050,31,123,"Nebraska","Morrill County",3,40,51,25,26
050,31,123,"Nebraska","Morrill County",3,41,48,26,22
050,31,123,"Nebraska","Morrill County",3,42,50,28,22
050,31,123,"Nebraska","Morrill County",3,43,48,27,21
050,31,123,"Nebraska","Morrill County",3,44,54,27,27
050,31,123,"Nebraska","Morrill County",3,45,53,27,26
050,31,123,"Nebraska","Morrill County",3,46,52,30,22
050,31,123,"Nebraska","Morrill County",3,47,50,23,27
050,31,123,"Nebraska","Morrill County",3,48,47,18,29
050,31,123,"Nebraska","Morrill County",3,49,57,21,36
050,31,123,"Nebraska","Morrill County",3,50,56,27,29
050,31,123,"Nebraska","Morrill County",3,51,57,31,26
050,31,123,"Nebraska","Morrill County",3,52,49,30,19
050,31,123,"Nebraska","Morrill County",3,53,58,38,20
050,31,123,"Nebraska","Morrill County",3,54,51,33,18
050,31,123,"Nebraska","Morrill County",3,55,49,27,22
050,31,123,"Nebraska","Morrill County",3,56,52,27,25
050,31,123,"Nebraska","Morrill County",3,57,63,33,30
050,31,123,"Nebraska","Morrill County",3,58,65,33,32
050,31,123,"Nebraska","Morrill County",3,59,63,26,37
050,31,123,"Nebraska","Morrill County",3,60,64,28,36
050,31,123,"Nebraska","Morrill County",3,61,65,33,32
050,31,123,"Nebraska","Morrill County",3,62,70,39,31
050,31,123,"Nebraska","Morrill County",3,63,63,32,31
050,31,123,"Nebraska","Morrill County",3,64,66,34,32
050,31,123,"Nebraska","Morrill County",3,65,71,36,35
050,31,123,"Nebraska","Morrill County",3,66,76,36,40
050,31,123,"Nebraska","Morrill County",3,67,67,34,33
050,31,123,"Nebraska","Morrill County",3,68,66,36,30
050,31,123,"Nebraska","Morrill County",3,69,60,30,30
050,31,123,"Nebraska","Morrill County",3,70,55,27,28
050,31,123,"Nebraska","Morrill County",3,71,49,29,20
050,31,123,"Nebraska","Morrill County",3,72,44,25,19
050,31,123,"Nebraska","Morrill County",3,73,40,20,20
050,31,123,"Nebraska","Morrill County",3,74,43,19,24
050,31,123,"Nebraska","Morrill County",3,75,39,20,19
050,31,123,"Nebraska","Morrill County",3,76,34,21,13
050,31,123,"Nebraska","Morrill County",3,77,34,17,17
050,31,123,"Nebraska","Morrill County",3,78,35,16,19
050,31,123,"Nebraska","Morrill County",3,79,36,19,17
050,31,123,"Nebraska","Morrill County",3,80,37,21,16
050,31,123,"Nebraska","Morrill County",3,81,29,15,14
050,31,123,"Nebraska","Morrill County",3,82,27,15,12
050,31,123,"Nebraska","Morrill County",3,83,25,9,16
050,31,123,"Nebraska","Morrill County",3,84,17,6,11
050,31,123,"Nebraska","Morrill County",3,85,145,50,95
050,31,123,"Nebraska","Morrill County",4,0,59,32,27
050,31,123,"Nebraska","Morrill County",4,1,48,23,25
050,31,123,"Nebraska","Morrill County",4,2,51,35,16
050,31,123,"Nebraska","Morrill County",4,3,52,28,24
050,31,123,"Nebraska","Morrill County",4,4,45,24,21
050,31,123,"Nebraska","Morrill County",4,5,49,21,28
050,31,123,"Nebraska","Morrill County",4,6,50,25,25
050,31,123,"Nebraska","Morrill County",4,7,57,31,26
050,31,123,"Nebraska","Morrill County",4,8,55,30,25
050,31,123,"Nebraska","Morrill County",4,9,51,25,26
050,31,123,"Nebraska","Morrill County",4,10,57,34,23
050,31,123,"Nebraska","Morrill County",4,11,54,33,21
050,31,123,"Nebraska","Morrill County",4,12,66,32,34
050,31,123,"Nebraska","Morrill County",4,13,67,37,30
050,31,123,"Nebraska","Morrill County",4,14,66,37,29
050,31,123,"Nebraska","Morrill County",4,15,57,24,33
050,31,123,"Nebraska","Morrill County",4,16,68,27,41
050,31,123,"Nebraska","Morrill County",4,17,69,34,35
050,31,123,"Nebraska","Morrill County",4,18,60,37,23
050,31,123,"Nebraska","Morrill County",4,19,39,25,14
050,31,123,"Nebraska","Morrill County",4,20,37,20,17
050,31,123,"Nebraska","Morrill County",4,21,55,25,30
050,31,123,"Nebraska","Morrill County",4,22,45,23,22
050,31,123,"Nebraska","Morrill County",4,23,41,28,13
050,31,123,"Nebraska","Morrill County",4,24,44,29,15
050,31,123,"Nebraska","Morrill County",4,25,51,33,18
050,31,123,"Nebraska","Morrill County",4,26,42,21,21
050,31,123,"Nebraska","Morrill County",4,27,47,26,21
050,31,123,"Nebraska","Morrill County",4,28,50,25,25
050,31,123,"Nebraska","Morrill County",4,29,53,30,23
050,31,123,"Nebraska","Morrill County",4,30,44,22,22
050,31,123,"Nebraska","Morrill County",4,31,46,23,23
050,31,123,"Nebraska","Morrill County",4,32,42,22,20
050,31,123,"Nebraska","Morrill County",4,33,56,26,30
050,31,123,"Nebraska","Morrill County",4,34,55,30,25
050,31,123,"Nebraska","Morrill County",4,35,49,26,23
050,31,123,"Nebraska","Morrill County",4,36,62,30,32
050,31,123,"Nebraska","Morrill County",4,37,59,33,26
050,31,123,"Nebraska","Morrill County",4,38,62,32,30
050,31,123,"Nebraska","Morrill County",4,39,49,26,23
050,31,123,"Nebraska","Morrill County",4,40,49,27,22
050,31,123,"Nebraska","Morrill County",4,41,50,25,25
050,31,123,"Nebraska","Morrill County",4,42,47,26,21
050,31,123,"Nebraska","Morrill County",4,43,50,28,22
050,31,123,"Nebraska","Morrill County",4,44,48,26,22
050,31,123,"Nebraska","Morrill County",4,45,57,27,30
050,31,123,"Nebraska","Morrill County",4,46,52,27,25
050,31,123,"Nebraska","Morrill County",4,47,54,32,22
050,31,123,"Nebraska","Morrill County",4,48,53,22,31
050,31,123,"Nebraska","Morrill County",4,49,48,21,27
050,31,123,"Nebraska","Morrill County",4,50,57,23,34
050,31,123,"Nebraska","Morrill County",4,51,55,29,26
050,31,123,"Nebraska","Morrill County",4,52,60,32,28
050,31,123,"Nebraska","Morrill County",4,53,47,28,19
050,31,123,"Nebraska","Morrill County",4,54,62,41,21
050,31,123,"Nebraska","Morrill County",4,55,48,30,18
050,31,123,"Nebraska","Morrill County",4,56,44,23,21
050,31,123,"Nebraska","Morrill County",4,57,50,28,22
050,31,123,"Nebraska","Morrill County",4,58,59,31,28
050,31,123,"Nebraska","Morrill County",4,59,60,31,29
050,31,123,"Nebraska","Morrill County",4,60,65,26,39
050,31,123,"Nebraska","Morrill County",4,61,67,29,38
050,31,123,"Nebraska","Morrill County",4,62,64,36,28
050,31,123,"Nebraska","Morrill County",4,63,70,37,33
050,31,123,"Nebraska","Morrill County",4,64,62,31,31
050,31,123,"Nebraska","Morrill County",4,65,68,35,33
050,31,123,"Nebraska","Morrill County",4,66,68,35,33
050,31,123,"Nebraska","Morrill County",4,67,72,34,38
050,31,123,"Nebraska","Morrill County",4,68,65,33,32
050,31,123,"Nebraska","Morrill County",4,69,64,33,31
050,31,123,"Nebraska","Morrill County",4,70,61,27,34
050,31,123,"Nebraska","Morrill County",4,71,51,27,24
050,31,123,"Nebraska","Morrill County",4,72,42,27,15
050,31,123,"Nebraska","Morrill County",4,73,42,24,18
050,31,123,"Nebraska","Morrill County",4,74,41,19,22
050,31,123,"Nebraska","Morrill County",4,75,45,21,24
050,31,123,"Nebraska","Morrill County",4,76,40,21,19
050,31,123,"Nebraska","Morrill County",4,77,31,16,15
050,31,123,"Nebraska","Morrill County",4,78,30,15,15
050,31,123,"Nebraska","Morrill County",4,79,30,15,15
050,31,123,"Nebraska","Morrill County",4,80,37,20,17
050,31,123,"Nebraska","Morrill County",4,81,36,18,18
050,31,123,"Nebraska","Morrill County",4,82,29,16,13
050,31,123,"Nebraska","Morrill County",4,83,31,15,16
050,31,123,"Nebraska","Morrill County",4,84,18,9,9
050,31,123,"Nebraska","Morrill County",4,85,134,42,92
050,31,123,"Nebraska","Morrill County",5,0,57,30,27
050,31,123,"Nebraska","Morrill County",5,1,59,34,25
050,31,123,"Nebraska","Morrill County",5,2,45,22,23
050,31,123,"Nebraska","Morrill County",5,3,53,35,18
050,31,123,"Nebraska","Morrill County",5,4,56,33,23
050,31,123,"Nebraska","Morrill County",5,5,43,21,22
050,31,123,"Nebraska","Morrill County",5,6,53,24,29
050,31,123,"Nebraska","Morrill County",5,7,54,28,26
050,31,123,"Nebraska","Morrill County",5,8,57,30,27
050,31,123,"Nebraska","Morrill County",5,9,56,30,26
050,31,123,"Nebraska","Morrill County",5,10,45,21,24
050,31,123,"Nebraska","Morrill County",5,11,61,36,25
050,31,123,"Nebraska","Morrill County",5,12,57,36,21
050,31,123,"Nebraska","Morrill County",5,13,66,29,37
050,31,123,"Nebraska","Morrill County",5,14,66,37,29
050,31,123,"Nebraska","Morrill County",5,15,66,40,26
050,31,123,"Nebraska","Morrill County",5,16,61,27,34
050,31,123,"Nebraska","Morrill County",5,17,67,26,41
050,31,123,"Nebraska","Morrill County",5,18,57,30,27
050,31,123,"Nebraska","Morrill County",5,19,46,28,18
050,31,123,"Nebraska","Morrill County",5,20,41,27,14
050,31,123,"Nebraska","Morrill County",5,21,36,19,17
050,31,123,"Nebraska","Morrill County",5,22,53,28,25
050,31,123,"Nebraska","Morrill County",5,23,47,25,22
050,31,123,"Nebraska","Morrill County",5,24,41,28,13
050,31,123,"Nebraska","Morrill County",5,25,46,28,18
050,31,123,"Nebraska","Morrill County",5,26,50,32,18
050,31,123,"Nebraska","Morrill County",5,27,40,21,19
050,31,123,"Nebraska","Morrill County",5,28,45,23,22
050,31,123,"Nebraska","Morrill County",5,29,46,23,23
050,31,123,"Nebraska","Morrill County",5,30,58,31,27
050,31,123,"Nebraska","Morrill County",5,31,48,23,25
050,31,123,"Nebraska","Morrill County",5,32,47,25,22
050,31,123,"Nebraska","Morrill County",5,33,41,21,20
050,31,123,"Nebraska","Morrill County",5,34,57,28,29
050,31,123,"Nebraska","Morrill County",5,35,50,26,24
050,31,123,"Nebraska","Morrill County",5,36,51,27,24
050,31,123,"Nebraska","Morrill County",5,37,62,29,33
050,31,123,"Nebraska","Morrill County",5,38,50,26,24
050,31,123,"Nebraska","Morrill County",5,39,59,32,27
050,31,123,"Nebraska","Morrill County",5,40,51,26,25
050,31,123,"Nebraska","Morrill County",5,41,52,28,24
050,31,123,"Nebraska","Morrill County",5,42,54,28,26
050,31,123,"Nebraska","Morrill County",5,43,46,26,20
050,31,123,"Nebraska","Morrill County",5,44,53,28,25
050,31,123,"Nebraska","Morrill County",5,45,51,26,25
050,31,123,"Nebraska","Morrill County",5,46,56,26,30
050,31,123,"Nebraska","Morrill County",5,47,56,31,25
050,31,123,"Nebraska","Morrill County",5,48,54,32,22
050,31,123,"Nebraska","Morrill County",5,49,54,23,31
050,31,123,"Nebraska","Morrill County",5,50,46,20,26
050,31,123,"Nebraska","Morrill County",5,51,57,23,34
050,31,123,"Nebraska","Morrill County",5,52,57,32,25
050,31,123,"Nebraska","Morrill County",5,53,59,28,31
050,31,123,"Nebraska","Morrill County",5,54,49,29,20
050,31,123,"Nebraska","Morrill County",5,55,64,42,22
050,31,123,"Nebraska","Morrill County",5,56,48,28,20
050,31,123,"Nebraska","Morrill County",5,57,44,23,21
050,31,123,"Nebraska","Morrill County",5,58,49,28,21
050,31,123,"Nebraska","Morrill County",5,59,57,30,27
050,31,123,"Nebraska","Morrill County",5,60,60,31,29
050,31,123,"Nebraska","Morrill County",5,61,70,26,44
050,31,123,"Nebraska","Morrill County",5,62,63,28,35
050,31,123,"Nebraska","Morrill County",5,63,62,34,28
050,31,123,"Nebraska","Morrill County",5,64,68,36,32
050,31,123,"Nebraska","Morrill County",5,65,59,29,30
050,31,123,"Nebraska","Morrill County",5,66,66,33,33
050,31,123,"Nebraska","Morrill County",5,67,62,32,30
050,31,123,"Nebraska","Morrill County",5,68,69,32,37
050,31,123,"Nebraska","Morrill County",5,69,61,31,30
050,31,123,"Nebraska","Morrill County",5,70,68,33,35
050,31,123,"Nebraska","Morrill County",5,71,54,24,30
050,31,123,"Nebraska","Morrill County",5,72,49,24,25
050,31,123,"Nebraska","Morrill County",5,73,42,26,16
050,31,123,"Nebraska","Morrill County",5,74,41,22,19
050,31,123,"Nebraska","Morrill County",5,75,44,23,21
050,31,123,"Nebraska","Morrill County",5,76,43,21,22
050,31,123,"Nebraska","Morrill County",5,77,35,15,20
050,31,123,"Nebraska","Morrill County",5,78,26,13,13
050,31,123,"Nebraska","Morrill County",5,79,26,13,13
050,31,123,"Nebraska","Morrill County",5,80,29,15,14
050,31,123,"Nebraska","Morrill County",5,81,35,17,18
050,31,123,"Nebraska","Morrill County",5,82,36,19,17
050,31,123,"Nebraska","Morrill County",5,83,29,14,15
050,31,123,"Nebraska","Morrill County",5,84,25,14,11
050,31,123,"Nebraska","Morrill County",5,85,132,39,93
050,31,125,"Nebraska","Nance County",1,0,38,19,19
050,31,125,"Nebraska","Nance County",1,1,33,15,18
050,31,125,"Nebraska","Nance County",1,2,42,21,21
050,31,125,"Nebraska","Nance County",1,3,43,22,21
050,31,125,"Nebraska","Nance County",1,4,46,24,22
050,31,125,"Nebraska","Nance County",1,5,44,22,22
050,31,125,"Nebraska","Nance County",1,6,43,24,19
050,31,125,"Nebraska","Nance County",1,7,44,24,20
050,31,125,"Nebraska","Nance County",1,8,50,28,22
050,31,125,"Nebraska","Nance County",1,9,45,23,22
050,31,125,"Nebraska","Nance County",1,10,40,24,16
050,31,125,"Nebraska","Nance County",1,11,46,20,26
050,31,125,"Nebraska","Nance County",1,12,49,26,23
050,31,125,"Nebraska","Nance County",1,13,47,26,21
050,31,125,"Nebraska","Nance County",1,14,44,23,21
050,31,125,"Nebraska","Nance County",1,15,50,22,28
050,31,125,"Nebraska","Nance County",1,16,51,28,23
050,31,125,"Nebraska","Nance County",1,17,48,27,21
050,31,125,"Nebraska","Nance County",1,18,42,20,22
050,31,125,"Nebraska","Nance County",1,19,33,15,18
050,31,125,"Nebraska","Nance County",1,20,27,13,14
050,31,125,"Nebraska","Nance County",1,21,34,17,17
050,31,125,"Nebraska","Nance County",1,22,36,17,19
050,31,125,"Nebraska","Nance County",1,23,32,16,16
050,31,125,"Nebraska","Nance County",1,24,31,15,16
050,31,125,"Nebraska","Nance County",1,25,27,15,12
050,31,125,"Nebraska","Nance County",1,26,27,12,15
050,31,125,"Nebraska","Nance County",1,27,35,20,15
050,31,125,"Nebraska","Nance County",1,28,41,25,16
050,31,125,"Nebraska","Nance County",1,29,34,17,17
050,31,125,"Nebraska","Nance County",1,30,32,15,17
050,31,125,"Nebraska","Nance County",1,31,30,12,18
050,31,125,"Nebraska","Nance County",1,32,35,16,19
050,31,125,"Nebraska","Nance County",1,33,44,23,21
050,31,125,"Nebraska","Nance County",1,34,27,19,8
050,31,125,"Nebraska","Nance County",1,35,44,28,16
050,31,125,"Nebraska","Nance County",1,36,33,21,12
050,31,125,"Nebraska","Nance County",1,37,34,19,15
050,31,125,"Nebraska","Nance County",1,38,39,17,22
050,31,125,"Nebraska","Nance County",1,39,38,18,20
050,31,125,"Nebraska","Nance County",1,40,45,22,23
050,31,125,"Nebraska","Nance County",1,41,39,21,18
050,31,125,"Nebraska","Nance County",1,42,49,25,24
050,31,125,"Nebraska","Nance County",1,43,36,20,16
050,31,125,"Nebraska","Nance County",1,44,35,15,20
050,31,125,"Nebraska","Nance County",1,45,33,15,18
050,31,125,"Nebraska","Nance County",1,46,28,14,14
050,31,125,"Nebraska","Nance County",1,47,36,18,18
050,31,125,"Nebraska","Nance County",1,48,47,23,24
050,31,125,"Nebraska","Nance County",1,49,40,20,20
050,31,125,"Nebraska","Nance County",1,50,30,15,15
050,31,125,"Nebraska","Nance County",1,51,26,15,11
050,31,125,"Nebraska","Nance County",1,52,36,18,18
050,31,125,"Nebraska","Nance County",1,53,33,13,20
050,31,125,"Nebraska","Nance County",1,54,41,23,18
050,31,125,"Nebraska","Nance County",1,55,49,27,22
050,31,125,"Nebraska","Nance County",1,56,60,31,29
050,31,125,"Nebraska","Nance County",1,57,62,30,32
050,31,125,"Nebraska","Nance County",1,58,60,30,30
050,31,125,"Nebraska","Nance County",1,59,60,30,30
050,31,125,"Nebraska","Nance County",1,60,59,35,24
050,31,125,"Nebraska","Nance County",1,61,57,31,26
050,31,125,"Nebraska","Nance County",1,62,58,31,27
050,31,125,"Nebraska","Nance County",1,63,56,32,24
050,31,125,"Nebraska","Nance County",1,64,59,31,28
050,31,125,"Nebraska","Nance County",1,65,62,34,28
050,31,125,"Nebraska","Nance County",1,66,51,25,26
050,31,125,"Nebraska","Nance County",1,67,51,23,28
050,31,125,"Nebraska","Nance County",1,68,50,23,27
050,31,125,"Nebraska","Nance County",1,69,41,21,20
050,31,125,"Nebraska","Nance County",1,70,41,24,17
050,31,125,"Nebraska","Nance County",1,71,43,21,22
050,31,125,"Nebraska","Nance County",1,72,36,20,16
050,31,125,"Nebraska","Nance County",1,73,26,9,17
050,31,125,"Nebraska","Nance County",1,74,15,6,9
050,31,125,"Nebraska","Nance County",1,75,16,8,8
050,31,125,"Nebraska","Nance County",1,76,16,6,10
050,31,125,"Nebraska","Nance County",1,77,14,3,11
050,31,125,"Nebraska","Nance County",1,78,14,6,8
050,31,125,"Nebraska","Nance County",1,79,14,8,6
050,31,125,"Nebraska","Nance County",1,80,13,5,8
050,31,125,"Nebraska","Nance County",1,81,15,4,11
050,31,125,"Nebraska","Nance County",1,82,20,7,13
050,31,125,"Nebraska","Nance County",1,83,24,7,17
050,31,125,"Nebraska","Nance County",1,84,19,5,14
050,31,125,"Nebraska","Nance County",1,85,103,34,69
050,31,125,"Nebraska","Nance County",2,0,39,18,21
050,31,125,"Nebraska","Nance County",2,1,35,16,19
050,31,125,"Nebraska","Nance County",2,2,41,20,21
050,31,125,"Nebraska","Nance County",2,3,43,22,21
050,31,125,"Nebraska","Nance County",2,4,47,24,23
050,31,125,"Nebraska","Nance County",2,5,46,24,22
050,31,125,"Nebraska","Nance County",2,6,45,24,21
050,31,125,"Nebraska","Nance County",2,7,45,25,20
050,31,125,"Nebraska","Nance County",2,8,48,27,21
050,31,125,"Nebraska","Nance County",2,9,47,24,23
050,31,125,"Nebraska","Nance County",2,10,41,24,17
050,31,125,"Nebraska","Nance County",2,11,44,21,23
050,31,125,"Nebraska","Nance County",2,12,49,25,24
050,31,125,"Nebraska","Nance County",2,13,49,27,22
050,31,125,"Nebraska","Nance County",2,14,45,24,21
050,31,125,"Nebraska","Nance County",2,15,49,22,27
050,31,125,"Nebraska","Nance County",2,16,51,27,24
050,31,125,"Nebraska","Nance County",2,17,48,27,21
050,31,125,"Nebraska","Nance County",2,18,42,21,21
050,31,125,"Nebraska","Nance County",2,19,33,15,18
050,31,125,"Nebraska","Nance County",2,20,28,13,15
050,31,125,"Nebraska","Nance County",2,21,32,16,16
050,31,125,"Nebraska","Nance County",2,22,37,18,19
050,31,125,"Nebraska","Nance County",2,23,35,18,17
050,31,125,"Nebraska","Nance County",2,24,31,15,16
050,31,125,"Nebraska","Nance County",2,25,28,15,13
050,31,125,"Nebraska","Nance County",2,26,26,12,14
050,31,125,"Nebraska","Nance County",2,27,33,18,15
050,31,125,"Nebraska","Nance County",2,28,40,24,16
050,31,125,"Nebraska","Nance County",2,29,34,18,16
050,31,125,"Nebraska","Nance County",2,30,32,15,17
050,31,125,"Nebraska","Nance County",2,31,31,13,18
050,31,125,"Nebraska","Nance County",2,32,35,16,19
050,31,125,"Nebraska","Nance County",2,33,43,23,20
050,31,125,"Nebraska","Nance County",2,34,32,21,11
050,31,125,"Nebraska","Nance County",2,35,41,26,15
050,31,125,"Nebraska","Nance County",2,36,35,23,12
050,31,125,"Nebraska","Nance County",2,37,34,20,14
050,31,125,"Nebraska","Nance County",2,38,39,18,21
050,31,125,"Nebraska","Nance County",2,39,39,18,21
050,31,125,"Nebraska","Nance County",2,40,44,21,23
050,31,125,"Nebraska","Nance County",2,41,41,21,20
050,31,125,"Nebraska","Nance County",2,42,46,23,23
050,31,125,"Nebraska","Nance County",2,43,40,22,18
050,31,125,"Nebraska","Nance County",2,44,36,16,20
050,31,125,"Nebraska","Nance County",2,45,32,14,18
050,31,125,"Nebraska","Nance County",2,46,30,14,16
050,31,125,"Nebraska","Nance County",2,47,34,17,17
050,31,125,"Nebraska","Nance County",2,48,44,22,22
050,31,125,"Nebraska","Nance County",2,49,42,21,21
050,31,125,"Nebraska","Nance County",2,50,32,16,16
050,31,125,"Nebraska","Nance County",2,51,27,16,11
050,31,125,"Nebraska","Nance County",2,52,34,17,17
050,31,125,"Nebraska","Nance County",2,53,34,14,20
050,31,125,"Nebraska","Nance County",2,54,38,21,17
050,31,125,"Nebraska","Nance County",2,55,47,26,21
050,31,125,"Nebraska","Nance County",2,56,57,30,27
050,31,125,"Nebraska","Nance County",2,57,59,29,30
050,31,125,"Nebraska","Nance County",2,58,61,30,31
050,31,125,"Nebraska","Nance County",2,59,59,30,29
050,31,125,"Nebraska","Nance County",2,60,59,33,26
050,31,125,"Nebraska","Nance County",2,61,57,31,26
050,31,125,"Nebraska","Nance County",2,62,60,32,28
050,31,125,"Nebraska","Nance County",2,63,57,33,24
050,31,125,"Nebraska","Nance County",2,64,57,30,27
050,31,125,"Nebraska","Nance County",2,65,61,33,28
050,31,125,"Nebraska","Nance County",2,66,53,26,27
050,31,125,"Nebraska","Nance County",2,67,51,24,27
050,31,125,"Nebraska","Nance County",2,68,51,23,28
050,31,125,"Nebraska","Nance County",2,69,43,21,22
050,31,125,"Nebraska","Nance County",2,70,41,23,18
050,31,125,"Nebraska","Nance County",2,71,43,22,21
050,31,125,"Nebraska","Nance County",2,72,36,20,16
050,31,125,"Nebraska","Nance County",2,73,30,12,18
050,31,125,"Nebraska","Nance County",2,74,16,5,11
050,31,125,"Nebraska","Nance County",2,75,14,6,8
050,31,125,"Nebraska","Nance County",2,76,16,7,9
050,31,125,"Nebraska","Nance County",2,77,15,4,11
050,31,125,"Nebraska","Nance County",2,78,13,5,8
050,31,125,"Nebraska","Nance County",2,79,14,8,6
050,31,125,"Nebraska","Nance County",2,80,13,6,7
050,31,125,"Nebraska","Nance County",2,81,14,4,10
050,31,125,"Nebraska","Nance County",2,82,19,6,13
050,31,125,"Nebraska","Nance County",2,83,23,7,16
050,31,125,"Nebraska","Nance County",2,84,21,6,15
050,31,125,"Nebraska","Nance County",2,85,104,34,70
050,31,125,"Nebraska","Nance County",3,0,40,25,15
050,31,125,"Nebraska","Nance County",3,1,35,15,20
050,31,125,"Nebraska","Nance County",3,2,35,15,20
050,31,125,"Nebraska","Nance County",3,3,44,20,24
050,31,125,"Nebraska","Nance County",3,4,40,20,20
050,31,125,"Nebraska","Nance County",3,5,44,20,24
050,31,125,"Nebraska","Nance County",3,6,48,27,21
050,31,125,"Nebraska","Nance County",3,7,46,26,20
050,31,125,"Nebraska","Nance County",3,8,46,30,16
050,31,125,"Nebraska","Nance County",3,9,51,28,23
050,31,125,"Nebraska","Nance County",3,10,49,27,22
050,31,125,"Nebraska","Nance County",3,11,44,24,20
050,31,125,"Nebraska","Nance County",3,12,45,21,24
050,31,125,"Nebraska","Nance County",3,13,52,27,25
050,31,125,"Nebraska","Nance County",3,14,44,26,18
050,31,125,"Nebraska","Nance County",3,15,46,24,22
050,31,125,"Nebraska","Nance County",3,16,49,23,26
050,31,125,"Nebraska","Nance County",3,17,49,28,21
050,31,125,"Nebraska","Nance County",3,18,35,17,18
050,31,125,"Nebraska","Nance County",3,19,34,18,16
050,31,125,"Nebraska","Nance County",3,20,36,17,19
050,31,125,"Nebraska","Nance County",3,21,27,14,13
050,31,125,"Nebraska","Nance County",3,22,37,21,16
050,31,125,"Nebraska","Nance County",3,23,30,17,13
050,31,125,"Nebraska","Nance County",3,24,27,12,15
050,31,125,"Nebraska","Nance County",3,25,30,14,16
050,31,125,"Nebraska","Nance County",3,26,26,13,13
050,31,125,"Nebraska","Nance County",3,27,31,12,19
050,31,125,"Nebraska","Nance County",3,28,32,16,16
050,31,125,"Nebraska","Nance County",3,29,40,23,17
050,31,125,"Nebraska","Nance County",3,30,39,21,18
050,31,125,"Nebraska","Nance County",3,31,31,15,16
050,31,125,"Nebraska","Nance County",3,32,42,22,20
050,31,125,"Nebraska","Nance County",3,33,35,17,18
050,31,125,"Nebraska","Nance County",3,34,45,26,19
050,31,125,"Nebraska","Nance County",3,35,31,21,10
050,31,125,"Nebraska","Nance County",3,36,41,26,15
050,31,125,"Nebraska","Nance County",3,37,39,25,14
050,31,125,"Nebraska","Nance County",3,38,36,20,16
050,31,125,"Nebraska","Nance County",3,39,41,20,21
050,31,125,"Nebraska","Nance County",3,40,41,18,23
050,31,125,"Nebraska","Nance County",3,41,42,19,23
050,31,125,"Nebraska","Nance County",3,42,40,20,20
050,31,125,"Nebraska","Nance County",3,43,48,25,23
050,31,125,"Nebraska","Nance County",3,44,41,21,20
050,31,125,"Nebraska","Nance County",3,45,33,15,18
050,31,125,"Nebraska","Nance County",3,46,32,13,19
050,31,125,"Nebraska","Nance County",3,47,29,15,14
050,31,125,"Nebraska","Nance County",3,48,35,14,21
050,31,125,"Nebraska","Nance County",3,49,44,24,20
050,31,125,"Nebraska","Nance County",3,50,41,20,21
050,31,125,"Nebraska","Nance County",3,51,32,16,16
050,31,125,"Nebraska","Nance County",3,52,29,15,14
050,31,125,"Nebraska","Nance County",3,53,33,16,17
050,31,125,"Nebraska","Nance County",3,54,38,17,21
050,31,125,"Nebraska","Nance County",3,55,43,25,18
050,31,125,"Nebraska","Nance County",3,56,45,26,19
050,31,125,"Nebraska","Nance County",3,57,54,27,27
050,31,125,"Nebraska","Nance County",3,58,63,32,31
050,31,125,"Nebraska","Nance County",3,59,60,30,30
050,31,125,"Nebraska","Nance County",3,60,57,28,29
050,31,125,"Nebraska","Nance County",3,61,56,31,25
050,31,125,"Nebraska","Nance County",3,62,61,30,31
050,31,125,"Nebraska","Nance County",3,63,62,37,25
050,31,125,"Nebraska","Nance County",3,64,52,26,26
050,31,125,"Nebraska","Nance County",3,65,58,34,24
050,31,125,"Nebraska","Nance County",3,66,55,29,26
050,31,125,"Nebraska","Nance County",3,67,54,27,27
050,31,125,"Nebraska","Nance County",3,68,51,24,27
050,31,125,"Nebraska","Nance County",3,69,47,20,27
050,31,125,"Nebraska","Nance County",3,70,38,20,18
050,31,125,"Nebraska","Nance County",3,71,43,24,19
050,31,125,"Nebraska","Nance County",3,72,38,19,19
050,31,125,"Nebraska","Nance County",3,73,36,21,15
050,31,125,"Nebraska","Nance County",3,74,27,11,16
050,31,125,"Nebraska","Nance County",3,75,16,6,10
050,31,125,"Nebraska","Nance County",3,76,13,5,8
050,31,125,"Nebraska","Nance County",3,77,16,7,9
050,31,125,"Nebraska","Nance County",3,78,13,3,10
050,31,125,"Nebraska","Nance County",3,79,10,3,7
050,31,125,"Nebraska","Nance County",3,80,11,7,4
050,31,125,"Nebraska","Nance County",3,81,12,5,7
050,31,125,"Nebraska","Nance County",3,82,14,4,10
050,31,125,"Nebraska","Nance County",3,83,18,6,12
050,31,125,"Nebraska","Nance County",3,84,19,4,15
050,31,125,"Nebraska","Nance County",3,85,103,35,68
050,31,125,"Nebraska","Nance County",4,0,38,17,21
050,31,125,"Nebraska","Nance County",4,1,39,22,17
050,31,125,"Nebraska","Nance County",4,2,36,16,20
050,31,125,"Nebraska","Nance County",4,3,32,13,19
050,31,125,"Nebraska","Nance County",4,4,43,17,26
050,31,125,"Nebraska","Nance County",4,5,38,16,22
050,31,125,"Nebraska","Nance County",4,6,44,22,22
050,31,125,"Nebraska","Nance County",4,7,46,28,18
050,31,125,"Nebraska","Nance County",4,8,47,27,20
050,31,125,"Nebraska","Nance County",4,9,45,27,18
050,31,125,"Nebraska","Nance County",4,10,53,29,24
050,31,125,"Nebraska","Nance County",4,11,49,27,22
050,31,125,"Nebraska","Nance County",4,12,45,22,23
050,31,125,"Nebraska","Nance County",4,13,47,22,25
050,31,125,"Nebraska","Nance County",4,14,52,27,25
050,31,125,"Nebraska","Nance County",4,15,42,23,19
050,31,125,"Nebraska","Nance County",4,16,46,24,22
050,31,125,"Nebraska","Nance County",4,17,49,22,27
050,31,125,"Nebraska","Nance County",4,18,41,24,17
050,31,125,"Nebraska","Nance County",4,19,30,16,14
050,31,125,"Nebraska","Nance County",4,20,37,20,17
050,31,125,"Nebraska","Nance County",4,21,38,18,20
050,31,125,"Nebraska","Nance County",4,22,27,12,15
050,31,125,"Nebraska","Nance County",4,23,35,20,15
050,31,125,"Nebraska","Nance County",4,24,24,13,11
050,31,125,"Nebraska","Nance County",4,25,28,12,16
050,31,125,"Nebraska","Nance County",4,26,27,15,12
050,31,125,"Nebraska","Nance County",4,27,25,14,11
050,31,125,"Nebraska","Nance County",4,28,36,16,20
050,31,125,"Nebraska","Nance County",4,29,37,20,17
050,31,125,"Nebraska","Nance County",4,30,40,23,17
050,31,125,"Nebraska","Nance County",4,31,41,23,18
050,31,125,"Nebraska","Nance County",4,32,32,15,17
050,31,125,"Nebraska","Nance County",4,33,45,24,21
050,31,125,"Nebraska","Nance County",4,34,33,14,19
050,31,125,"Nebraska","Nance County",4,35,41,25,16
050,31,125,"Nebraska","Nance County",4,36,31,21,10
050,31,125,"Nebraska","Nance County",4,37,41,24,17
050,31,125,"Nebraska","Nance County",4,38,39,24,15
050,31,125,"Nebraska","Nance County",4,39,34,20,14
050,31,125,"Nebraska","Nance County",4,40,40,19,21
050,31,125,"Nebraska","Nance County",4,41,40,18,22
050,31,125,"Nebraska","Nance County",4,42,43,21,22
050,31,125,"Nebraska","Nance County",4,43,43,24,19
050,31,125,"Nebraska","Nance County",4,44,47,23,24
050,31,125,"Nebraska","Nance County",4,45,38,21,17
050,31,125,"Nebraska","Nance County",4,46,31,12,19
050,31,125,"Nebraska","Nance County",4,47,30,14,16
050,31,125,"Nebraska","Nance County",4,48,32,16,16
050,31,125,"Nebraska","Nance County",4,49,32,15,17
050,31,125,"Nebraska","Nance County",4,50,42,22,20
050,31,125,"Nebraska","Nance County",4,51,40,20,20
050,31,125,"Nebraska","Nance County",4,52,30,17,13
050,31,125,"Nebraska","Nance County",4,53,29,15,14
050,31,125,"Nebraska","Nance County",4,54,32,15,17
050,31,125,"Nebraska","Nance County",4,55,40,17,23
050,31,125,"Nebraska","Nance County",4,56,41,25,16
050,31,125,"Nebraska","Nance County",4,57,43,23,20
050,31,125,"Nebraska","Nance County",4,58,55,27,28
050,31,125,"Nebraska","Nance County",4,59,60,32,28
050,31,125,"Nebraska","Nance County",4,60,61,30,31
050,31,125,"Nebraska","Nance County",4,61,52,26,26
050,31,125,"Nebraska","Nance County",4,62,58,30,28
050,31,125,"Nebraska","Nance County",4,63,67,36,31
050,31,125,"Nebraska","Nance County",4,64,55,30,25
050,31,125,"Nebraska","Nance County",4,65,53,27,26
050,31,125,"Nebraska","Nance County",4,66,53,31,22
050,31,125,"Nebraska","Nance County",4,67,55,28,27
050,31,125,"Nebraska","Nance County",4,68,51,26,25
050,31,125,"Nebraska","Nance County",4,69,48,21,27
050,31,125,"Nebraska","Nance County",4,70,41,16,25
050,31,125,"Nebraska","Nance County",4,71,40,21,19
050,31,125,"Nebraska","Nance County",4,72,38,23,15
050,31,125,"Nebraska","Nance County",4,73,39,19,20
050,31,125,"Nebraska","Nance County",4,74,30,17,13
050,31,125,"Nebraska","Nance County",4,75,26,10,16
050,31,125,"Nebraska","Nance County",4,76,13,5,8
050,31,125,"Nebraska","Nance County",4,77,12,4,8
050,31,125,"Nebraska","Nance County",4,78,14,6,8
050,31,125,"Nebraska","Nance County",4,79,9,1,8
050,31,125,"Nebraska","Nance County",4,80,10,3,7
050,31,125,"Nebraska","Nance County",4,81,10,7,3
050,31,125,"Nebraska","Nance County",4,82,13,5,8
050,31,125,"Nebraska","Nance County",4,83,13,3,10
050,31,125,"Nebraska","Nance County",4,84,16,3,13
050,31,125,"Nebraska","Nance County",4,85,99,33,66
050,31,125,"Nebraska","Nance County",5,0,38,18,20
050,31,125,"Nebraska","Nance County",5,1,44,21,23
050,31,125,"Nebraska","Nance County",5,2,40,25,15
050,31,125,"Nebraska","Nance County",5,3,33,15,18
050,31,125,"Nebraska","Nance County",5,4,34,15,19
050,31,125,"Nebraska","Nance County",5,5,39,17,22
050,31,125,"Nebraska","Nance County",5,6,39,17,22
050,31,125,"Nebraska","Nance County",5,7,40,21,19
050,31,125,"Nebraska","Nance County",5,8,42,25,17
050,31,125,"Nebraska","Nance County",5,9,44,24,20
050,31,125,"Nebraska","Nance County",5,10,47,28,19
050,31,125,"Nebraska","Nance County",5,11,51,28,23
050,31,125,"Nebraska","Nance County",5,12,46,26,20
050,31,125,"Nebraska","Nance County",5,13,43,21,22
050,31,125,"Nebraska","Nance County",5,14,47,23,24
050,31,125,"Nebraska","Nance County",5,15,51,25,26
050,31,125,"Nebraska","Nance County",5,16,45,23,22
050,31,125,"Nebraska","Nance County",5,17,46,24,22
050,31,125,"Nebraska","Nance County",5,18,42,21,21
050,31,125,"Nebraska","Nance County",5,19,30,17,13
050,31,125,"Nebraska","Nance County",5,20,26,15,11
050,31,125,"Nebraska","Nance County",5,21,35,20,15
050,31,125,"Nebraska","Nance County",5,22,42,22,20
050,31,125,"Nebraska","Nance County",5,23,25,14,11
050,31,125,"Nebraska","Nance County",5,24,36,22,14
050,31,125,"Nebraska","Nance County",5,25,24,12,12
050,31,125,"Nebraska","Nance County",5,26,27,10,17
050,31,125,"Nebraska","Nance County",5,27,27,14,13
050,31,125,"Nebraska","Nance County",5,28,29,15,14
050,31,125,"Nebraska","Nance County",5,29,33,15,18
050,31,125,"Nebraska","Nance County",5,30,35,19,16
050,31,125,"Nebraska","Nance County",5,31,41,23,18
050,31,125,"Nebraska","Nance County",5,32,47,27,20
050,31,125,"Nebraska","Nance County",5,33,34,16,18
050,31,125,"Nebraska","Nance County",5,34,44,21,23
050,31,125,"Nebraska","Nance County",5,35,37,17,20
050,31,125,"Nebraska","Nance County",5,36,42,26,16
050,31,125,"Nebraska","Nance County",5,37,32,22,10
050,31,125,"Nebraska","Nance County",5,38,40,23,17
050,31,125,"Nebraska","Nance County",5,39,41,26,15
050,31,125,"Nebraska","Nance County",5,40,37,23,14
050,31,125,"Nebraska","Nance County",5,41,40,19,21
050,31,125,"Nebraska","Nance County",5,42,38,18,20
050,31,125,"Nebraska","Nance County",5,43,44,23,21
050,31,125,"Nebraska","Nance County",5,44,41,22,19
050,31,125,"Nebraska","Nance County",5,45,46,23,23
050,31,125,"Nebraska","Nance County",5,46,36,21,15
050,31,125,"Nebraska","Nance County",5,47,30,13,17
050,31,125,"Nebraska","Nance County",5,48,33,15,18
050,31,125,"Nebraska","Nance County",5,49,32,17,15
050,31,125,"Nebraska","Nance County",5,50,31,14,17
050,31,125,"Nebraska","Nance County",5,51,42,23,19
050,31,125,"Nebraska","Nance County",5,52,40,20,20
050,31,125,"Nebraska","Nance County",5,53,30,17,13
050,31,125,"Nebraska","Nance County",5,54,31,14,17
050,31,125,"Nebraska","Nance County",5,55,34,15,19
050,31,125,"Nebraska","Nance County",5,56,40,20,20
050,31,125,"Nebraska","Nance County",5,57,39,22,17
050,31,125,"Nebraska","Nance County",5,58,47,26,21
050,31,125,"Nebraska","Nance County",5,59,51,26,25
050,31,125,"Nebraska","Nance County",5,60,59,30,29
050,31,125,"Nebraska","Nance County",5,61,57,26,31
050,31,125,"Nebraska","Nance County",5,62,53,26,27
050,31,125,"Nebraska","Nance County",5,63,61,35,26
050,31,125,"Nebraska","Nance County",5,64,62,30,32
050,31,125,"Nebraska","Nance County",5,65,56,31,25
050,31,125,"Nebraska","Nance County",5,66,48,23,25
050,31,125,"Nebraska","Nance County",5,67,51,30,21
050,31,125,"Nebraska","Nance County",5,68,55,28,27
050,31,125,"Nebraska","Nance County",5,69,46,23,23
050,31,125,"Nebraska","Nance County",5,70,42,19,23
050,31,125,"Nebraska","Nance County",5,71,41,15,26
050,31,125,"Nebraska","Nance County",5,72,37,20,17
050,31,125,"Nebraska","Nance County",5,73,39,23,16
050,31,125,"Nebraska","Nance County",5,74,36,15,21
050,31,125,"Nebraska","Nance County",5,75,29,17,12
050,31,125,"Nebraska","Nance County",5,76,23,9,14
050,31,125,"Nebraska","Nance County",5,77,12,4,8
050,31,125,"Nebraska","Nance County",5,78,11,3,8
050,31,125,"Nebraska","Nance County",5,79,11,6,5
050,31,125,"Nebraska","Nance County",5,80,8,1,7
050,31,125,"Nebraska","Nance County",5,81,11,4,7
050,31,125,"Nebraska","Nance County",5,82,10,7,3
050,31,125,"Nebraska","Nance County",5,83,13,4,9
050,31,125,"Nebraska","Nance County",5,84,11,1,10
050,31,125,"Nebraska","Nance County",5,85,92,32,60
050,31,127,"Nebraska","Nemaha County",1,0,79,41,38
050,31,127,"Nebraska","Nemaha County",1,1,90,47,43
050,31,127,"Nebraska","Nemaha County",1,2,87,45,42
050,31,127,"Nebraska","Nemaha County",1,3,91,44,47
050,31,127,"Nebraska","Nemaha County",1,4,80,40,40
050,31,127,"Nebraska","Nemaha County",1,5,85,41,44
050,31,127,"Nebraska","Nemaha County",1,6,93,53,40
050,31,127,"Nebraska","Nemaha County",1,7,90,43,47
050,31,127,"Nebraska","Nemaha County",1,8,81,40,41
050,31,127,"Nebraska","Nemaha County",1,9,84,39,45
050,31,127,"Nebraska","Nemaha County",1,10,104,48,56
050,31,127,"Nebraska","Nemaha County",1,11,96,43,53
050,31,127,"Nebraska","Nemaha County",1,12,95,50,45
050,31,127,"Nebraska","Nemaha County",1,13,95,55,40
050,31,127,"Nebraska","Nemaha County",1,14,87,44,43
050,31,127,"Nebraska","Nemaha County",1,15,93,53,40
050,31,127,"Nebraska","Nemaha County",1,16,84,43,41
050,31,127,"Nebraska","Nemaha County",1,17,73,36,37
050,31,127,"Nebraska","Nemaha County",1,18,136,61,75
050,31,127,"Nebraska","Nemaha County",1,19,204,104,100
050,31,127,"Nebraska","Nemaha County",1,20,168,87,81
050,31,127,"Nebraska","Nemaha County",1,21,105,57,48
050,31,127,"Nebraska","Nemaha County",1,22,88,43,45
050,31,127,"Nebraska","Nemaha County",1,23,82,41,41
050,31,127,"Nebraska","Nemaha County",1,24,69,33,36
050,31,127,"Nebraska","Nemaha County",1,25,72,35,37
050,31,127,"Nebraska","Nemaha County",1,26,75,38,37
050,31,127,"Nebraska","Nemaha County",1,27,95,52,43
050,31,127,"Nebraska","Nemaha County",1,28,75,41,34
050,31,127,"Nebraska","Nemaha County",1,29,62,30,32
050,31,127,"Nebraska","Nemaha County",1,30,73,33,40
050,31,127,"Nebraska","Nemaha County",1,31,82,45,37
050,31,127,"Nebraska","Nemaha County",1,32,90,50,40
050,31,127,"Nebraska","Nemaha County",1,33,95,57,38
050,31,127,"Nebraska","Nemaha County",1,34,92,49,43
050,31,127,"Nebraska","Nemaha County",1,35,78,42,36
050,31,127,"Nebraska","Nemaha County",1,36,82,48,34
050,31,127,"Nebraska","Nemaha County",1,37,90,42,48
050,31,127,"Nebraska","Nemaha County",1,38,93,43,50
050,31,127,"Nebraska","Nemaha County",1,39,91,47,44
050,31,127,"Nebraska","Nemaha County",1,40,92,57,35
050,31,127,"Nebraska","Nemaha County",1,41,80,44,36
050,31,127,"Nebraska","Nemaha County",1,42,58,31,27
050,31,127,"Nebraska","Nemaha County",1,43,62,36,26
050,31,127,"Nebraska","Nemaha County",1,44,72,34,38
050,31,127,"Nebraska","Nemaha County",1,45,69,32,37
050,31,127,"Nebraska","Nemaha County",1,46,66,29,37
050,31,127,"Nebraska","Nemaha County",1,47,60,31,29
050,31,127,"Nebraska","Nemaha County",1,48,60,24,36
050,31,127,"Nebraska","Nemaha County",1,49,69,33,36
050,31,127,"Nebraska","Nemaha County",1,50,68,37,31
050,31,127,"Nebraska","Nemaha County",1,51,78,41,37
050,31,127,"Nebraska","Nemaha County",1,52,66,31,35
050,31,127,"Nebraska","Nemaha County",1,53,71,37,34
050,31,127,"Nebraska","Nemaha County",1,54,71,38,33
050,31,127,"Nebraska","Nemaha County",1,55,88,41,47
050,31,127,"Nebraska","Nemaha County",1,56,90,42,48
050,31,127,"Nebraska","Nemaha County",1,57,90,44,46
050,31,127,"Nebraska","Nemaha County",1,58,101,52,49
050,31,127,"Nebraska","Nemaha County",1,59,94,50,44
050,31,127,"Nebraska","Nemaha County",1,60,90,48,42
050,31,127,"Nebraska","Nemaha County",1,61,95,49,46
050,31,127,"Nebraska","Nemaha County",1,62,96,51,45
050,31,127,"Nebraska","Nemaha County",1,63,95,46,49
050,31,127,"Nebraska","Nemaha County",1,64,92,40,52
050,31,127,"Nebraska","Nemaha County",1,65,90,44,46
050,31,127,"Nebraska","Nemaha County",1,66,84,49,35
050,31,127,"Nebraska","Nemaha County",1,67,85,43,42
050,31,127,"Nebraska","Nemaha County",1,68,109,56,53
050,31,127,"Nebraska","Nemaha County",1,69,93,45,48
050,31,127,"Nebraska","Nemaha County",1,70,96,45,51
050,31,127,"Nebraska","Nemaha County",1,71,72,34,38
050,31,127,"Nebraska","Nemaha County",1,72,70,38,32
050,31,127,"Nebraska","Nemaha County",1,73,72,42,30
050,31,127,"Nebraska","Nemaha County",1,74,43,23,20
050,31,127,"Nebraska","Nemaha County",1,75,48,21,27
050,31,127,"Nebraska","Nemaha County",1,76,64,32,32
050,31,127,"Nebraska","Nemaha County",1,77,60,30,30
050,31,127,"Nebraska","Nemaha County",1,78,39,17,22
050,31,127,"Nebraska","Nemaha County",1,79,36,14,22
050,31,127,"Nebraska","Nemaha County",1,80,39,19,20
050,31,127,"Nebraska","Nemaha County",1,81,37,19,18
050,31,127,"Nebraska","Nemaha County",1,82,31,13,18
050,31,127,"Nebraska","Nemaha County",1,83,20,7,13
050,31,127,"Nebraska","Nemaha County",1,84,33,15,18
050,31,127,"Nebraska","Nemaha County",1,85,195,75,120
050,31,127,"Nebraska","Nemaha County",2,0,75,37,38
050,31,127,"Nebraska","Nemaha County",2,1,87,45,42
050,31,127,"Nebraska","Nemaha County",2,2,88,46,42
050,31,127,"Nebraska","Nemaha County",2,3,89,44,45
050,31,127,"Nebraska","Nemaha County",2,4,82,40,42
050,31,127,"Nebraska","Nemaha County",2,5,85,42,43
050,31,127,"Nebraska","Nemaha County",2,6,92,50,42
050,31,127,"Nebraska","Nemaha County",2,7,92,45,47
050,31,127,"Nebraska","Nemaha County",2,8,85,41,44
050,31,127,"Nebraska","Nemaha County",2,9,85,40,45
050,31,127,"Nebraska","Nemaha County",2,10,100,46,54
050,31,127,"Nebraska","Nemaha County",2,11,98,44,54
050,31,127,"Nebraska","Nemaha County",2,12,95,48,47
050,31,127,"Nebraska","Nemaha County",2,13,96,54,42
050,31,127,"Nebraska","Nemaha County",2,14,90,47,43
050,31,127,"Nebraska","Nemaha County",2,15,93,52,41
050,31,127,"Nebraska","Nemaha County",2,16,85,45,40
050,31,127,"Nebraska","Nemaha County",2,17,75,37,38
050,31,127,"Nebraska","Nemaha County",2,18,133,61,72
050,31,127,"Nebraska","Nemaha County",2,19,205,104,101
050,31,127,"Nebraska","Nemaha County",2,20,171,90,81
050,31,127,"Nebraska","Nemaha County",2,21,106,57,49
050,31,127,"Nebraska","Nemaha County",2,22,87,43,44
050,31,127,"Nebraska","Nemaha County",2,23,80,41,39
050,31,127,"Nebraska","Nemaha County",2,24,70,33,37
050,31,127,"Nebraska","Nemaha County",2,25,71,34,37
050,31,127,"Nebraska","Nemaha County",2,26,76,38,38
050,31,127,"Nebraska","Nemaha County",2,27,92,50,42
050,31,127,"Nebraska","Nemaha County",2,28,82,44,38
050,31,127,"Nebraska","Nemaha County",2,29,63,31,32
050,31,127,"Nebraska","Nemaha County",2,30,72,33,39
050,31,127,"Nebraska","Nemaha County",2,31,81,43,38
050,31,127,"Nebraska","Nemaha County",2,32,90,50,40
050,31,127,"Nebraska","Nemaha County",2,33,93,55,38
050,31,127,"Nebraska","Nemaha County",2,34,91,50,41
050,31,127,"Nebraska","Nemaha County",2,35,83,45,38
050,31,127,"Nebraska","Nemaha County",2,36,79,45,34
050,31,127,"Nebraska","Nemaha County",2,37,89,44,45
050,31,127,"Nebraska","Nemaha County",2,38,93,43,50
050,31,127,"Nebraska","Nemaha County",2,39,91,46,45
050,31,127,"Nebraska","Nemaha County",2,40,91,54,37
050,31,127,"Nebraska","Nemaha County",2,41,84,48,36
050,31,127,"Nebraska","Nemaha County",2,42,63,34,29
050,31,127,"Nebraska","Nemaha County",2,43,63,36,27
050,31,127,"Nebraska","Nemaha County",2,44,68,34,34
050,31,127,"Nebraska","Nemaha County",2,45,71,33,38
050,31,127,"Nebraska","Nemaha County",2,46,68,31,37
050,31,127,"Nebraska","Nemaha County",2,47,60,30,30
050,31,127,"Nebraska","Nemaha County",2,48,59,25,34
050,31,127,"Nebraska","Nemaha County",2,49,69,31,38
050,31,127,"Nebraska","Nemaha County",2,50,68,36,32
050,31,127,"Nebraska","Nemaha County",2,51,74,39,35
050,31,127,"Nebraska","Nemaha County",2,52,68,33,35
050,31,127,"Nebraska","Nemaha County",2,53,69,35,34
050,31,127,"Nebraska","Nemaha County",2,54,71,38,33
050,31,127,"Nebraska","Nemaha County",2,55,83,40,43
050,31,127,"Nebraska","Nemaha County",2,56,90,42,48
050,31,127,"Nebraska","Nemaha County",2,57,90,44,46
050,31,127,"Nebraska","Nemaha County",2,58,98,50,48
050,31,127,"Nebraska","Nemaha County",2,59,96,51,45
050,31,127,"Nebraska","Nemaha County",2,60,90,48,42
050,31,127,"Nebraska","Nemaha County",2,61,94,49,45
050,31,127,"Nebraska","Nemaha County",2,62,95,51,44
050,31,127,"Nebraska","Nemaha County",2,63,96,48,48
050,31,127,"Nebraska","Nemaha County",2,64,92,41,51
050,31,127,"Nebraska","Nemaha County",2,65,90,43,47
050,31,127,"Nebraska","Nemaha County",2,66,87,48,39
050,31,127,"Nebraska","Nemaha County",2,67,84,44,40
050,31,127,"Nebraska","Nemaha County",2,68,103,52,51
050,31,127,"Nebraska","Nemaha County",2,69,98,48,50
050,31,127,"Nebraska","Nemaha County",2,70,93,43,50
050,31,127,"Nebraska","Nemaha County",2,71,77,36,41
050,31,127,"Nebraska","Nemaha County",2,72,69,36,33
050,31,127,"Nebraska","Nemaha County",2,73,75,43,32
050,31,127,"Nebraska","Nemaha County",2,74,45,25,20
050,31,127,"Nebraska","Nemaha County",2,75,47,21,26
050,31,127,"Nebraska","Nemaha County",2,76,59,29,30
050,31,127,"Nebraska","Nemaha County",2,77,62,31,31
050,31,127,"Nebraska","Nemaha County",2,78,42,19,23
050,31,127,"Nebraska","Nemaha County",2,79,37,15,22
050,31,127,"Nebraska","Nemaha County",2,80,39,18,21
050,31,127,"Nebraska","Nemaha County",2,81,36,18,18
050,31,127,"Nebraska","Nemaha County",2,82,33,15,18
050,31,127,"Nebraska","Nemaha County",2,83,21,8,13
050,31,127,"Nebraska","Nemaha County",2,84,29,12,17
050,31,127,"Nebraska","Nemaha County",2,85,196,77,119
050,31,127,"Nebraska","Nemaha County",3,0,87,49,38
050,31,127,"Nebraska","Nemaha County",3,1,76,34,42
050,31,127,"Nebraska","Nemaha County",3,2,82,40,42
050,31,127,"Nebraska","Nemaha County",3,3,91,48,43
050,31,127,"Nebraska","Nemaha County",3,4,88,43,45
050,31,127,"Nebraska","Nemaha County",3,5,84,39,45
050,31,127,"Nebraska","Nemaha County",3,6,90,45,45
050,31,127,"Nebraska","Nemaha County",3,7,90,46,44
050,31,127,"Nebraska","Nemaha County",3,8,89,46,43
050,31,127,"Nebraska","Nemaha County",3,9,88,43,45
050,31,127,"Nebraska","Nemaha County",3,10,80,37,43
050,31,127,"Nebraska","Nemaha County",3,11,103,49,54
050,31,127,"Nebraska","Nemaha County",3,12,99,48,51
050,31,127,"Nebraska","Nemaha County",3,13,99,50,49
050,31,127,"Nebraska","Nemaha County",3,14,92,52,40
050,31,127,"Nebraska","Nemaha County",3,15,89,47,42
050,31,127,"Nebraska","Nemaha County",3,16,91,50,41
050,31,127,"Nebraska","Nemaha County",3,17,89,46,43
050,31,127,"Nebraska","Nemaha County",3,18,120,53,67
050,31,127,"Nebraska","Nemaha County",3,19,181,93,88
050,31,127,"Nebraska","Nemaha County",3,20,160,86,74
050,31,127,"Nebraska","Nemaha County",3,21,106,54,52
050,31,127,"Nebraska","Nemaha County",3,22,80,42,38
050,31,127,"Nebraska","Nemaha County",3,23,74,39,35
050,31,127,"Nebraska","Nemaha County",3,24,75,36,39
050,31,127,"Nebraska","Nemaha County",3,25,76,35,41
050,31,127,"Nebraska","Nemaha County",3,26,70,32,38
050,31,127,"Nebraska","Nemaha County",3,27,69,36,33
050,31,127,"Nebraska","Nemaha County",3,28,90,45,45
050,31,127,"Nebraska","Nemaha County",3,29,77,41,36
050,31,127,"Nebraska","Nemaha County",3,30,63,34,29
050,31,127,"Nebraska","Nemaha County",3,31,73,32,41
050,31,127,"Nebraska","Nemaha County",3,32,82,42,40
050,31,127,"Nebraska","Nemaha County",3,33,89,48,41
050,31,127,"Nebraska","Nemaha County",3,34,87,51,36
050,31,127,"Nebraska","Nemaha County",3,35,92,48,44
050,31,127,"Nebraska","Nemaha County",3,36,80,44,36
050,31,127,"Nebraska","Nemaha County",3,37,79,45,34
050,31,127,"Nebraska","Nemaha County",3,38,95,47,48
050,31,127,"Nebraska","Nemaha County",3,39,91,40,51
050,31,127,"Nebraska","Nemaha County",3,40,90,44,46
050,31,127,"Nebraska","Nemaha County",3,41,90,52,38
050,31,127,"Nebraska","Nemaha County",3,42,88,49,39
050,31,127,"Nebraska","Nemaha County",3,43,70,40,30
050,31,127,"Nebraska","Nemaha County",3,44,63,36,27
050,31,127,"Nebraska","Nemaha County",3,45,69,36,33
050,31,127,"Nebraska","Nemaha County",3,46,74,34,40
050,31,127,"Nebraska","Nemaha County",3,47,68,30,38
050,31,127,"Nebraska","Nemaha County",3,48,58,29,29
050,31,127,"Nebraska","Nemaha County",3,49,61,27,34
050,31,127,"Nebraska","Nemaha County",3,50,64,28,36
050,31,127,"Nebraska","Nemaha County",3,51,63,34,29
050,31,127,"Nebraska","Nemaha County",3,52,73,39,34
050,31,127,"Nebraska","Nemaha County",3,53,69,33,36
050,31,127,"Nebraska","Nemaha County",3,54,71,36,35
050,31,127,"Nebraska","Nemaha County",3,55,70,38,32
050,31,127,"Nebraska","Nemaha County",3,56,82,40,42
050,31,127,"Nebraska","Nemaha County",3,57,88,42,46
050,31,127,"Nebraska","Nemaha County",3,58,90,44,46
050,31,127,"Nebraska","Nemaha County",3,59,97,49,48
050,31,127,"Nebraska","Nemaha County",3,60,92,48,44
050,31,127,"Nebraska","Nemaha County",3,61,87,47,40
050,31,127,"Nebraska","Nemaha County",3,62,97,49,48
050,31,127,"Nebraska","Nemaha County",3,63,91,48,43
050,31,127,"Nebraska","Nemaha County",3,64,90,44,46
050,31,127,"Nebraska","Nemaha County",3,65,89,41,48
050,31,127,"Nebraska","Nemaha County",3,66,91,45,46
050,31,127,"Nebraska","Nemaha County",3,67,91,49,42
050,31,127,"Nebraska","Nemaha County",3,68,80,43,37
050,31,127,"Nebraska","Nemaha County",3,69,102,51,51
050,31,127,"Nebraska","Nemaha County",3,70,98,50,48
050,31,127,"Nebraska","Nemaha County",3,71,91,40,51
050,31,127,"Nebraska","Nemaha County",3,72,76,37,39
050,31,127,"Nebraska","Nemaha County",3,73,67,33,34
050,31,127,"Nebraska","Nemaha County",3,74,71,40,31
050,31,127,"Nebraska","Nemaha County",3,75,43,23,20
050,31,127,"Nebraska","Nemaha County",3,76,41,19,22
050,31,127,"Nebraska","Nemaha County",3,77,55,27,28
050,31,127,"Nebraska","Nemaha County",3,78,56,27,29
050,31,127,"Nebraska","Nemaha County",3,79,44,20,24
050,31,127,"Nebraska","Nemaha County",3,80,32,11,21
050,31,127,"Nebraska","Nemaha County",3,81,36,17,19
050,31,127,"Nebraska","Nemaha County",3,82,36,19,17
050,31,127,"Nebraska","Nemaha County",3,83,28,13,15
050,31,127,"Nebraska","Nemaha County",3,84,21,7,14
050,31,127,"Nebraska","Nemaha County",3,85,185,79,106
050,31,127,"Nebraska","Nemaha County",4,0,78,41,37
050,31,127,"Nebraska","Nemaha County",4,1,86,58,28
050,31,127,"Nebraska","Nemaha County",4,2,77,32,45
050,31,127,"Nebraska","Nemaha County",4,3,83,37,46
050,31,127,"Nebraska","Nemaha County",4,4,88,45,43
050,31,127,"Nebraska","Nemaha County",4,5,91,48,43
050,31,127,"Nebraska","Nemaha County",4,6,88,43,45
050,31,127,"Nebraska","Nemaha County",4,7,88,44,44
050,31,127,"Nebraska","Nemaha County",4,8,85,45,40
050,31,127,"Nebraska","Nemaha County",4,9,90,47,43
050,31,127,"Nebraska","Nemaha County",4,10,91,45,46
050,31,127,"Nebraska","Nemaha County",4,11,87,42,45
050,31,127,"Nebraska","Nemaha County",4,12,100,45,55
050,31,127,"Nebraska","Nemaha County",4,13,102,50,52
050,31,127,"Nebraska","Nemaha County",4,14,102,51,51
050,31,127,"Nebraska","Nemaha County",4,15,93,54,39
050,31,127,"Nebraska","Nemaha County",4,16,94,50,44
050,31,127,"Nebraska","Nemaha County",4,17,96,53,43
050,31,127,"Nebraska","Nemaha County",4,18,128,58,70
050,31,127,"Nebraska","Nemaha County",4,19,180,92,88
050,31,127,"Nebraska","Nemaha County",4,20,156,84,72
050,31,127,"Nebraska","Nemaha County",4,21,115,63,52
050,31,127,"Nebraska","Nemaha County",4,22,86,42,44
050,31,127,"Nebraska","Nemaha County",4,23,70,46,24
050,31,127,"Nebraska","Nemaha County",4,24,81,42,39
050,31,127,"Nebraska","Nemaha County",4,25,76,36,40
050,31,127,"Nebraska","Nemaha County",4,26,71,34,37
050,31,127,"Nebraska","Nemaha County",4,27,68,37,31
050,31,127,"Nebraska","Nemaha County",4,28,75,40,35
050,31,127,"Nebraska","Nemaha County",4,29,74,39,35
050,31,127,"Nebraska","Nemaha County",4,30,78,42,36
050,31,127,"Nebraska","Nemaha County",4,31,65,33,32
050,31,127,"Nebraska","Nemaha County",4,32,71,32,39
050,31,127,"Nebraska","Nemaha County",4,33,84,44,40
050,31,127,"Nebraska","Nemaha County",4,34,89,48,41
050,31,127,"Nebraska","Nemaha County",4,35,88,51,37
050,31,127,"Nebraska","Nemaha County",4,36,91,47,44
050,31,127,"Nebraska","Nemaha County",4,37,78,44,34
050,31,127,"Nebraska","Nemaha County",4,38,77,40,37
050,31,127,"Nebraska","Nemaha County",4,39,94,45,49
050,31,127,"Nebraska","Nemaha County",4,40,90,38,52
050,31,127,"Nebraska","Nemaha County",4,41,92,44,48
050,31,127,"Nebraska","Nemaha County",4,42,89,51,38
050,31,127,"Nebraska","Nemaha County",4,43,89,49,40
050,31,127,"Nebraska","Nemaha County",4,44,70,40,30
050,31,127,"Nebraska","Nemaha County",4,45,64,36,28
050,31,127,"Nebraska","Nemaha County",4,46,72,36,36
050,31,127,"Nebraska","Nemaha County",4,47,78,38,40
050,31,127,"Nebraska","Nemaha County",4,48,68,31,37
050,31,127,"Nebraska","Nemaha County",4,49,59,31,28
050,31,127,"Nebraska","Nemaha County",4,50,59,26,33
050,31,127,"Nebraska","Nemaha County",4,51,69,28,41
050,31,127,"Nebraska","Nemaha County",4,52,66,33,33
050,31,127,"Nebraska","Nemaha County",4,53,71,37,34
050,31,127,"Nebraska","Nemaha County",4,54,65,32,33
050,31,127,"Nebraska","Nemaha County",4,55,73,36,37
050,31,127,"Nebraska","Nemaha County",4,56,68,39,29
050,31,127,"Nebraska","Nemaha County",4,57,83,40,43
050,31,127,"Nebraska","Nemaha County",4,58,93,44,49
050,31,127,"Nebraska","Nemaha County",4,59,89,42,47
050,31,127,"Nebraska","Nemaha County",4,60,101,51,50
050,31,127,"Nebraska","Nemaha County",4,61,87,45,42
050,31,127,"Nebraska","Nemaha County",4,62,86,48,38
050,31,127,"Nebraska","Nemaha County",4,63,103,52,51
050,31,127,"Nebraska","Nemaha County",4,64,93,50,43
050,31,127,"Nebraska","Nemaha County",4,65,94,43,51
050,31,127,"Nebraska","Nemaha County",4,66,91,41,50
050,31,127,"Nebraska","Nemaha County",4,67,89,43,46
050,31,127,"Nebraska","Nemaha County",4,68,93,49,44
050,31,127,"Nebraska","Nemaha County",4,69,76,43,33
050,31,127,"Nebraska","Nemaha County",4,70,99,54,45
050,31,127,"Nebraska","Nemaha County",4,71,97,49,48
050,31,127,"Nebraska","Nemaha County",4,72,89,40,49
050,31,127,"Nebraska","Nemaha County",4,73,73,33,40
050,31,127,"Nebraska","Nemaha County",4,74,64,30,34
050,31,127,"Nebraska","Nemaha County",4,75,66,35,31
050,31,127,"Nebraska","Nemaha County",4,76,39,21,18
050,31,127,"Nebraska","Nemaha County",4,77,41,19,22
050,31,127,"Nebraska","Nemaha County",4,78,51,25,26
050,31,127,"Nebraska","Nemaha County",4,79,51,25,26
050,31,127,"Nebraska","Nemaha County",4,80,40,18,22
050,31,127,"Nebraska","Nemaha County",4,81,31,11,20
050,31,127,"Nebraska","Nemaha County",4,82,36,16,20
050,31,127,"Nebraska","Nemaha County",4,83,32,16,16
050,31,127,"Nebraska","Nemaha County",4,84,29,11,18
050,31,127,"Nebraska","Nemaha County",4,85,164,72,92
050,31,127,"Nebraska","Nemaha County",5,0,81,43,38
050,31,127,"Nebraska","Nemaha County",5,1,80,43,37
050,31,127,"Nebraska","Nemaha County",5,2,91,60,31
050,31,127,"Nebraska","Nemaha County",5,3,78,38,40
050,31,127,"Nebraska","Nemaha County",5,4,86,39,47
050,31,127,"Nebraska","Nemaha County",5,5,87,42,45
050,31,127,"Nebraska","Nemaha County",5,6,93,49,44
050,31,127,"Nebraska","Nemaha County",5,7,89,40,49
050,31,127,"Nebraska","Nemaha County",5,8,85,43,42
050,31,127,"Nebraska","Nemaha County",5,9,80,44,36
050,31,127,"Nebraska","Nemaha County",5,10,90,47,43
050,31,127,"Nebraska","Nemaha County",5,11,92,44,48
050,31,127,"Nebraska","Nemaha County",5,12,91,44,47
050,31,127,"Nebraska","Nemaha County",5,13,115,57,58
050,31,127,"Nebraska","Nemaha County",5,14,110,56,54
050,31,127,"Nebraska","Nemaha County",5,15,102,51,51
050,31,127,"Nebraska","Nemaha County",5,16,93,51,42
050,31,127,"Nebraska","Nemaha County",5,17,90,47,43
050,31,127,"Nebraska","Nemaha County",5,18,137,67,70
050,31,127,"Nebraska","Nemaha County",5,19,183,94,89
050,31,127,"Nebraska","Nemaha County",5,20,147,79,68
050,31,127,"Nebraska","Nemaha County",5,21,114,59,55
050,31,127,"Nebraska","Nemaha County",5,22,101,53,48
050,31,127,"Nebraska","Nemaha County",5,23,74,36,38
050,31,127,"Nebraska","Nemaha County",5,24,61,39,22
050,31,127,"Nebraska","Nemaha County",5,25,77,33,44
050,31,127,"Nebraska","Nemaha County",5,26,72,34,38
050,31,127,"Nebraska","Nemaha County",5,27,71,32,39
050,31,127,"Nebraska","Nemaha County",5,28,70,41,29
050,31,127,"Nebraska","Nemaha County",5,29,76,38,38
050,31,127,"Nebraska","Nemaha County",5,30,85,45,40
050,31,127,"Nebraska","Nemaha County",5,31,71,38,33
050,31,127,"Nebraska","Nemaha County",5,32,67,37,30
050,31,127,"Nebraska","Nemaha County",5,33,71,29,42
050,31,127,"Nebraska","Nemaha County",5,34,82,41,41
050,31,127,"Nebraska","Nemaha County",5,35,96,53,43
050,31,127,"Nebraska","Nemaha County",5,36,91,50,41
050,31,127,"Nebraska","Nemaha County",5,37,93,50,43
050,31,127,"Nebraska","Nemaha County",5,38,80,44,36
050,31,127,"Nebraska","Nemaha County",5,39,79,39,40
050,31,127,"Nebraska","Nemaha County",5,40,91,42,49
050,31,127,"Nebraska","Nemaha County",5,41,95,41,54
050,31,127,"Nebraska","Nemaha County",5,42,93,45,48
050,31,127,"Nebraska","Nemaha County",5,43,91,55,36
050,31,127,"Nebraska","Nemaha County",5,44,94,51,43
050,31,127,"Nebraska","Nemaha County",5,45,70,39,31
050,31,127,"Nebraska","Nemaha County",5,46,66,38,28
050,31,127,"Nebraska","Nemaha County",5,47,73,37,36
050,31,127,"Nebraska","Nemaha County",5,48,79,38,41
050,31,127,"Nebraska","Nemaha County",5,49,71,32,39
050,31,127,"Nebraska","Nemaha County",5,50,55,29,26
050,31,127,"Nebraska","Nemaha County",5,51,64,27,37
050,31,127,"Nebraska","Nemaha County",5,52,76,34,42
050,31,127,"Nebraska","Nemaha County",5,53,66,33,33
050,31,127,"Nebraska","Nemaha County",5,54,70,36,34
050,31,127,"Nebraska","Nemaha County",5,55,63,31,32
050,31,127,"Nebraska","Nemaha County",5,56,72,34,38
050,31,127,"Nebraska","Nemaha County",5,57,67,38,29
050,31,127,"Nebraska","Nemaha County",5,58,84,41,43
050,31,127,"Nebraska","Nemaha County",5,59,88,39,49
050,31,127,"Nebraska","Nemaha County",5,60,90,43,47
050,31,127,"Nebraska","Nemaha County",5,61,104,53,51
050,31,127,"Nebraska","Nemaha County",5,62,83,42,41
050,31,127,"Nebraska","Nemaha County",5,63,87,48,39
050,31,127,"Nebraska","Nemaha County",5,64,106,55,51
050,31,127,"Nebraska","Nemaha County",5,65,91,48,43
050,31,127,"Nebraska","Nemaha County",5,66,90,41,49
050,31,127,"Nebraska","Nemaha County",5,67,89,41,48
050,31,127,"Nebraska","Nemaha County",5,68,90,43,47
050,31,127,"Nebraska","Nemaha County",5,69,85,49,36
050,31,127,"Nebraska","Nemaha County",5,70,78,47,31
050,31,127,"Nebraska","Nemaha County",5,71,95,51,44
050,31,127,"Nebraska","Nemaha County",5,72,92,46,46
050,31,127,"Nebraska","Nemaha County",5,73,85,38,47
050,31,127,"Nebraska","Nemaha County",5,74,71,32,39
050,31,127,"Nebraska","Nemaha County",5,75,63,26,37
050,31,127,"Nebraska","Nemaha County",5,76,58,32,26
050,31,127,"Nebraska","Nemaha County",5,77,37,19,18
050,31,127,"Nebraska","Nemaha County",5,78,35,14,21
050,31,127,"Nebraska","Nemaha County",5,79,46,23,23
050,31,127,"Nebraska","Nemaha County",5,80,47,23,24
050,31,127,"Nebraska","Nemaha County",5,81,41,18,23
050,31,127,"Nebraska","Nemaha County",5,82,32,10,22
050,31,127,"Nebraska","Nemaha County",5,83,33,14,19
050,31,127,"Nebraska","Nemaha County",5,84,31,12,19
050,31,127,"Nebraska","Nemaha County",5,85,158,74,84
050,31,129,"Nebraska","Nuckolls County",1,0,44,23,21
050,31,129,"Nebraska","Nuckolls County",1,1,44,25,19
050,31,129,"Nebraska","Nuckolls County",1,2,44,21,23
050,31,129,"Nebraska","Nuckolls County",1,3,35,17,18
050,31,129,"Nebraska","Nuckolls County",1,4,43,20,23
050,31,129,"Nebraska","Nuckolls County",1,5,45,20,25
050,31,129,"Nebraska","Nuckolls County",1,6,37,21,16
050,31,129,"Nebraska","Nuckolls County",1,7,41,24,17
050,31,129,"Nebraska","Nuckolls County",1,8,45,21,24
050,31,129,"Nebraska","Nuckolls County",1,9,50,32,18
050,31,129,"Nebraska","Nuckolls County",1,10,46,21,25
050,31,129,"Nebraska","Nuckolls County",1,11,41,20,21
050,31,129,"Nebraska","Nuckolls County",1,12,50,27,23
050,31,129,"Nebraska","Nuckolls County",1,13,50,23,27
050,31,129,"Nebraska","Nuckolls County",1,14,49,27,22
050,31,129,"Nebraska","Nuckolls County",1,15,54,28,26
050,31,129,"Nebraska","Nuckolls County",1,16,51,30,21
050,31,129,"Nebraska","Nuckolls County",1,17,54,29,25
050,31,129,"Nebraska","Nuckolls County",1,18,47,23,24
050,31,129,"Nebraska","Nuckolls County",1,19,31,18,13
050,31,129,"Nebraska","Nuckolls County",1,20,39,25,14
050,31,129,"Nebraska","Nuckolls County",1,21,39,20,19
050,31,129,"Nebraska","Nuckolls County",1,22,39,16,23
050,31,129,"Nebraska","Nuckolls County",1,23,42,20,22
050,31,129,"Nebraska","Nuckolls County",1,24,36,20,16
050,31,129,"Nebraska","Nuckolls County",1,25,34,18,16
050,31,129,"Nebraska","Nuckolls County",1,26,36,19,17
050,31,129,"Nebraska","Nuckolls County",1,27,38,18,20
050,31,129,"Nebraska","Nuckolls County",1,28,42,19,23
050,31,129,"Nebraska","Nuckolls County",1,29,33,17,16
050,31,129,"Nebraska","Nuckolls County",1,30,41,17,24
050,31,129,"Nebraska","Nuckolls County",1,31,40,20,20
050,31,129,"Nebraska","Nuckolls County",1,32,35,20,15
050,31,129,"Nebraska","Nuckolls County",1,33,36,19,17
050,31,129,"Nebraska","Nuckolls County",1,34,42,23,19
050,31,129,"Nebraska","Nuckolls County",1,35,36,21,15
050,31,129,"Nebraska","Nuckolls County",1,36,43,21,22
050,31,129,"Nebraska","Nuckolls County",1,37,55,21,34
050,31,129,"Nebraska","Nuckolls County",1,38,48,20,28
050,31,129,"Nebraska","Nuckolls County",1,39,42,22,20
050,31,129,"Nebraska","Nuckolls County",1,40,43,22,21
050,31,129,"Nebraska","Nuckolls County",1,41,40,28,12
050,31,129,"Nebraska","Nuckolls County",1,42,35,20,15
050,31,129,"Nebraska","Nuckolls County",1,43,42,27,15
050,31,129,"Nebraska","Nuckolls County",1,44,35,20,15
050,31,129,"Nebraska","Nuckolls County",1,45,36,18,18
050,31,129,"Nebraska","Nuckolls County",1,46,43,19,24
050,31,129,"Nebraska","Nuckolls County",1,47,44,21,23
050,31,129,"Nebraska","Nuckolls County",1,48,44,22,22
050,31,129,"Nebraska","Nuckolls County",1,49,47,26,21
050,31,129,"Nebraska","Nuckolls County",1,50,40,22,18
050,31,129,"Nebraska","Nuckolls County",1,51,34,17,17
050,31,129,"Nebraska","Nuckolls County",1,52,37,18,19
050,31,129,"Nebraska","Nuckolls County",1,53,44,22,22
050,31,129,"Nebraska","Nuckolls County",1,54,48,31,17
050,31,129,"Nebraska","Nuckolls County",1,55,50,29,21
050,31,129,"Nebraska","Nuckolls County",1,56,59,29,30
050,31,129,"Nebraska","Nuckolls County",1,57,58,29,29
050,31,129,"Nebraska","Nuckolls County",1,58,58,32,26
050,31,129,"Nebraska","Nuckolls County",1,59,64,27,37
050,31,129,"Nebraska","Nuckolls County",1,60,67,29,38
050,31,129,"Nebraska","Nuckolls County",1,61,95,51,44
050,31,129,"Nebraska","Nuckolls County",1,62,93,50,43
050,31,129,"Nebraska","Nuckolls County",1,63,81,44,37
050,31,129,"Nebraska","Nuckolls County",1,64,70,37,33
050,31,129,"Nebraska","Nuckolls County",1,65,60,31,29
050,31,129,"Nebraska","Nuckolls County",1,66,62,29,33
050,31,129,"Nebraska","Nuckolls County",1,67,70,35,35
050,31,129,"Nebraska","Nuckolls County",1,68,55,26,29
050,31,129,"Nebraska","Nuckolls County",1,69,59,29,30
050,31,129,"Nebraska","Nuckolls County",1,70,55,26,29
050,31,129,"Nebraska","Nuckolls County",1,71,47,24,23
050,31,129,"Nebraska","Nuckolls County",1,72,58,28,30
050,31,129,"Nebraska","Nuckolls County",1,73,59,27,32
050,31,129,"Nebraska","Nuckolls County",1,74,41,18,23
050,31,129,"Nebraska","Nuckolls County",1,75,54,29,25
050,31,129,"Nebraska","Nuckolls County",1,76,42,19,23
050,31,129,"Nebraska","Nuckolls County",1,77,31,16,15
050,31,129,"Nebraska","Nuckolls County",1,78,40,21,19
050,31,129,"Nebraska","Nuckolls County",1,79,36,14,22
050,31,129,"Nebraska","Nuckolls County",1,80,35,14,21
050,31,129,"Nebraska","Nuckolls County",1,81,30,8,22
050,31,129,"Nebraska","Nuckolls County",1,82,27,8,19
050,31,129,"Nebraska","Nuckolls County",1,83,30,15,15
050,31,129,"Nebraska","Nuckolls County",1,84,30,10,20
050,31,129,"Nebraska","Nuckolls County",1,85,172,68,104
050,31,129,"Nebraska","Nuckolls County",2,0,42,24,18
050,31,129,"Nebraska","Nuckolls County",2,1,45,25,20
050,31,129,"Nebraska","Nuckolls County",2,2,45,23,22
050,31,129,"Nebraska","Nuckolls County",2,3,38,18,20
050,31,129,"Nebraska","Nuckolls County",2,4,41,19,22
050,31,129,"Nebraska","Nuckolls County",2,5,45,20,25
050,31,129,"Nebraska","Nuckolls County",2,6,40,22,18
050,31,129,"Nebraska","Nuckolls County",2,7,40,23,17
050,31,129,"Nebraska","Nuckolls County",2,8,44,22,22
050,31,129,"Nebraska","Nuckolls County",2,9,48,28,20
050,31,129,"Nebraska","Nuckolls County",2,10,46,23,23
050,31,129,"Nebraska","Nuckolls County",2,11,41,20,21
050,31,129,"Nebraska","Nuckolls County",2,12,48,25,23
050,31,129,"Nebraska","Nuckolls County",2,13,49,23,26
050,31,129,"Nebraska","Nuckolls County",2,14,50,26,24
050,31,129,"Nebraska","Nuckolls County",2,15,54,28,26
050,31,129,"Nebraska","Nuckolls County",2,16,52,30,22
050,31,129,"Nebraska","Nuckolls County",2,17,52,28,24
050,31,129,"Nebraska","Nuckolls County",2,18,45,23,22
050,31,129,"Nebraska","Nuckolls County",2,19,34,19,15
050,31,129,"Nebraska","Nuckolls County",2,20,37,23,14
050,31,129,"Nebraska","Nuckolls County",2,21,38,21,17
050,31,129,"Nebraska","Nuckolls County",2,22,40,17,23
050,31,129,"Nebraska","Nuckolls County",2,23,43,20,23
050,31,129,"Nebraska","Nuckolls County",2,24,37,20,17
050,31,129,"Nebraska","Nuckolls County",2,25,35,19,16
050,31,129,"Nebraska","Nuckolls County",2,26,36,19,17
050,31,129,"Nebraska","Nuckolls County",2,27,37,18,19
050,31,129,"Nebraska","Nuckolls County",2,28,40,19,21
050,31,129,"Nebraska","Nuckolls County",2,29,36,17,19
050,31,129,"Nebraska","Nuckolls County",2,30,41,17,24
050,31,129,"Nebraska","Nuckolls County",2,31,41,20,21
050,31,129,"Nebraska","Nuckolls County",2,32,37,21,16
050,31,129,"Nebraska","Nuckolls County",2,33,36,19,17
050,31,129,"Nebraska","Nuckolls County",2,34,42,23,19
050,31,129,"Nebraska","Nuckolls County",2,35,36,21,15
050,31,129,"Nebraska","Nuckolls County",2,36,41,21,20
050,31,129,"Nebraska","Nuckolls County",2,37,53,21,32
050,31,129,"Nebraska","Nuckolls County",2,38,50,20,30
050,31,129,"Nebraska","Nuckolls County",2,39,42,21,21
050,31,129,"Nebraska","Nuckolls County",2,40,42,22,20
050,31,129,"Nebraska","Nuckolls County",2,41,41,27,14
050,31,129,"Nebraska","Nuckolls County",2,42,36,22,14
050,31,129,"Nebraska","Nuckolls County",2,43,40,25,15
050,31,129,"Nebraska","Nuckolls County",2,44,35,21,14
050,31,129,"Nebraska","Nuckolls County",2,45,36,18,18
050,31,129,"Nebraska","Nuckolls County",2,46,41,19,22
050,31,129,"Nebraska","Nuckolls County",2,47,44,20,24
050,31,129,"Nebraska","Nuckolls County",2,48,43,21,22
050,31,129,"Nebraska","Nuckolls County",2,49,46,25,21
050,31,129,"Nebraska","Nuckolls County",2,50,42,23,19
050,31,129,"Nebraska","Nuckolls County",2,51,35,18,17
050,31,129,"Nebraska","Nuckolls County",2,52,36,18,18
050,31,129,"Nebraska","Nuckolls County",2,53,42,21,21
050,31,129,"Nebraska","Nuckolls County",2,54,48,29,19
050,31,129,"Nebraska","Nuckolls County",2,55,48,28,20
050,31,129,"Nebraska","Nuckolls County",2,56,56,29,27
050,31,129,"Nebraska","Nuckolls County",2,57,58,29,29
050,31,129,"Nebraska","Nuckolls County",2,58,56,30,26
050,31,129,"Nebraska","Nuckolls County",2,59,63,28,35
050,31,129,"Nebraska","Nuckolls County",2,60,66,29,37
050,31,129,"Nebraska","Nuckolls County",2,61,88,46,42
050,31,129,"Nebraska","Nuckolls County",2,62,94,51,43
050,31,129,"Nebraska","Nuckolls County",2,63,84,46,38
050,31,129,"Nebraska","Nuckolls County",2,64,73,38,35
050,31,129,"Nebraska","Nuckolls County",2,65,63,33,30
050,31,129,"Nebraska","Nuckolls County",2,66,62,29,33
050,31,129,"Nebraska","Nuckolls County",2,67,68,33,35
050,31,129,"Nebraska","Nuckolls County",2,68,59,29,30
050,31,129,"Nebraska","Nuckolls County",2,69,59,29,30
050,31,129,"Nebraska","Nuckolls County",2,70,56,27,29
050,31,129,"Nebraska","Nuckolls County",2,71,48,24,24
050,31,129,"Nebraska","Nuckolls County",2,72,54,26,28
050,31,129,"Nebraska","Nuckolls County",2,73,62,29,33
050,31,129,"Nebraska","Nuckolls County",2,74,43,19,24
050,31,129,"Nebraska","Nuckolls County",2,75,49,25,24
050,31,129,"Nebraska","Nuckolls County",2,76,43,20,23
050,31,129,"Nebraska","Nuckolls County",2,77,33,16,17
050,31,129,"Nebraska","Nuckolls County",2,78,38,20,18
050,31,129,"Nebraska","Nuckolls County",2,79,37,16,21
050,31,129,"Nebraska","Nuckolls County",2,80,36,14,22
050,31,129,"Nebraska","Nuckolls County",2,81,30,9,21
050,31,129,"Nebraska","Nuckolls County",2,82,28,8,20
050,31,129,"Nebraska","Nuckolls County",2,83,29,13,16
050,31,129,"Nebraska","Nuckolls County",2,84,29,11,18
050,31,129,"Nebraska","Nuckolls County",2,85,177,69,108
050,31,129,"Nebraska","Nuckolls County",3,0,42,25,17
050,31,129,"Nebraska","Nuckolls County",3,1,45,28,17
050,31,129,"Nebraska","Nuckolls County",3,2,47,25,22
050,31,129,"Nebraska","Nuckolls County",3,3,50,24,26
050,31,129,"Nebraska","Nuckolls County",3,4,37,15,22
050,31,129,"Nebraska","Nuckolls County",3,5,38,18,20
050,31,129,"Nebraska","Nuckolls County",3,6,48,21,27
050,31,129,"Nebraska","Nuckolls County",3,7,42,24,18
050,31,129,"Nebraska","Nuckolls County",3,8,41,24,17
050,31,129,"Nebraska","Nuckolls County",3,9,43,21,22
050,31,129,"Nebraska","Nuckolls County",3,10,52,28,24
050,31,129,"Nebraska","Nuckolls County",3,11,50,26,24
050,31,129,"Nebraska","Nuckolls County",3,12,42,22,20
050,31,129,"Nebraska","Nuckolls County",3,13,50,25,25
050,31,129,"Nebraska","Nuckolls County",3,14,50,24,26
050,31,129,"Nebraska","Nuckolls County",3,15,48,20,28
050,31,129,"Nebraska","Nuckolls County",3,16,52,26,26
050,31,129,"Nebraska","Nuckolls County",3,17,47,27,20
050,31,129,"Nebraska","Nuckolls County",3,18,44,25,19
050,31,129,"Nebraska","Nuckolls County",3,19,32,16,16
050,31,129,"Nebraska","Nuckolls County",3,20,37,18,19
050,31,129,"Nebraska","Nuckolls County",3,21,39,24,15
050,31,129,"Nebraska","Nuckolls County",3,22,38,22,16
050,31,129,"Nebraska","Nuckolls County",3,23,34,14,20
050,31,129,"Nebraska","Nuckolls County",3,24,50,23,27
050,31,129,"Nebraska","Nuckolls County",3,25,33,15,18
050,31,129,"Nebraska","Nuckolls County",3,26,33,18,15
050,31,129,"Nebraska","Nuckolls County",3,27,40,19,21
050,31,129,"Nebraska","Nuckolls County",3,28,35,20,15
050,31,129,"Nebraska","Nuckolls County",3,29,38,18,20
050,31,129,"Nebraska","Nuckolls County",3,30,35,18,17
050,31,129,"Nebraska","Nuckolls County",3,31,43,19,24
050,31,129,"Nebraska","Nuckolls County",3,32,40,20,20
050,31,129,"Nebraska","Nuckolls County",3,33,38,22,16
050,31,129,"Nebraska","Nuckolls County",3,34,41,23,18
050,31,129,"Nebraska","Nuckolls County",3,35,41,20,21
050,31,129,"Nebraska","Nuckolls County",3,36,37,21,16
050,31,129,"Nebraska","Nuckolls County",3,37,43,23,20
050,31,129,"Nebraska","Nuckolls County",3,38,52,19,33
050,31,129,"Nebraska","Nuckolls County",3,39,47,19,28
050,31,129,"Nebraska","Nuckolls County",3,40,44,21,23
050,31,129,"Nebraska","Nuckolls County",3,41,43,23,20
050,31,129,"Nebraska","Nuckolls County",3,42,38,26,12
050,31,129,"Nebraska","Nuckolls County",3,43,36,22,14
050,31,129,"Nebraska","Nuckolls County",3,44,42,26,16
050,31,129,"Nebraska","Nuckolls County",3,45,37,21,16
050,31,129,"Nebraska","Nuckolls County",3,46,40,21,19
050,31,129,"Nebraska","Nuckolls County",3,47,43,22,21
050,31,129,"Nebraska","Nuckolls County",3,48,45,20,25
050,31,129,"Nebraska","Nuckolls County",3,49,42,21,21
050,31,129,"Nebraska","Nuckolls County",3,50,45,25,20
050,31,129,"Nebraska","Nuckolls County",3,51,42,23,19
050,31,129,"Nebraska","Nuckolls County",3,52,35,18,17
050,31,129,"Nebraska","Nuckolls County",3,53,35,17,18
050,31,129,"Nebraska","Nuckolls County",3,54,44,22,22
050,31,129,"Nebraska","Nuckolls County",3,55,48,29,19
050,31,129,"Nebraska","Nuckolls County",3,56,45,26,19
050,31,129,"Nebraska","Nuckolls County",3,57,58,31,27
050,31,129,"Nebraska","Nuckolls County",3,58,57,28,29
050,31,129,"Nebraska","Nuckolls County",3,59,57,31,26
050,31,129,"Nebraska","Nuckolls County",3,60,66,28,38
050,31,129,"Nebraska","Nuckolls County",3,61,66,30,36
050,31,129,"Nebraska","Nuckolls County",3,62,93,50,43
050,31,129,"Nebraska","Nuckolls County",3,63,93,50,43
050,31,129,"Nebraska","Nuckolls County",3,64,87,46,41
050,31,129,"Nebraska","Nuckolls County",3,65,72,39,33
050,31,129,"Nebraska","Nuckolls County",3,66,63,32,31
050,31,129,"Nebraska","Nuckolls County",3,67,64,29,35
050,31,129,"Nebraska","Nuckolls County",3,68,66,32,34
050,31,129,"Nebraska","Nuckolls County",3,69,55,27,28
050,31,129,"Nebraska","Nuckolls County",3,70,58,28,30
050,31,129,"Nebraska","Nuckolls County",3,71,57,28,29
050,31,129,"Nebraska","Nuckolls County",3,72,46,22,24
050,31,129,"Nebraska","Nuckolls County",3,73,52,24,28
050,31,129,"Nebraska","Nuckolls County",3,74,60,28,32
050,31,129,"Nebraska","Nuckolls County",3,75,39,18,21
050,31,129,"Nebraska","Nuckolls County",3,76,49,25,24
050,31,129,"Nebraska","Nuckolls County",3,77,37,17,20
050,31,129,"Nebraska","Nuckolls County",3,78,32,16,16
050,31,129,"Nebraska","Nuckolls County",3,79,34,18,16
050,31,129,"Nebraska","Nuckolls County",3,80,38,17,21
050,31,129,"Nebraska","Nuckolls County",3,81,33,12,21
050,31,129,"Nebraska","Nuckolls County",3,82,28,9,19
050,31,129,"Nebraska","Nuckolls County",3,83,25,7,18
050,31,129,"Nebraska","Nuckolls County",3,84,24,10,14
050,31,129,"Nebraska","Nuckolls County",3,85,164,60,104
050,31,129,"Nebraska","Nuckolls County",4,0,42,24,18
050,31,129,"Nebraska","Nuckolls County",4,1,47,29,18
050,31,129,"Nebraska","Nuckolls County",4,2,41,26,15
050,31,129,"Nebraska","Nuckolls County",4,3,49,27,22
050,31,129,"Nebraska","Nuckolls County",4,4,46,23,23
050,31,129,"Nebraska","Nuckolls County",4,5,37,14,23
050,31,129,"Nebraska","Nuckolls County",4,6,42,20,22
050,31,129,"Nebraska","Nuckolls County",4,7,45,21,24
050,31,129,"Nebraska","Nuckolls County",4,8,44,24,20
050,31,129,"Nebraska","Nuckolls County",4,9,44,27,17
050,31,129,"Nebraska","Nuckolls County",4,10,44,22,22
050,31,129,"Nebraska","Nuckolls County",4,11,50,28,22
050,31,129,"Nebraska","Nuckolls County",4,12,55,25,30
050,31,129,"Nebraska","Nuckolls County",4,13,47,25,22
050,31,129,"Nebraska","Nuckolls County",4,14,49,25,24
050,31,129,"Nebraska","Nuckolls County",4,15,46,24,22
050,31,129,"Nebraska","Nuckolls County",4,16,48,23,25
050,31,129,"Nebraska","Nuckolls County",4,17,54,29,25
050,31,129,"Nebraska","Nuckolls County",4,18,43,24,19
050,31,129,"Nebraska","Nuckolls County",4,19,31,18,13
050,31,129,"Nebraska","Nuckolls County",4,20,32,17,15
050,31,129,"Nebraska","Nuckolls County",4,21,38,19,19
050,31,129,"Nebraska","Nuckolls County",4,22,40,24,16
050,31,129,"Nebraska","Nuckolls County",4,23,46,24,22
050,31,129,"Nebraska","Nuckolls County",4,24,40,19,21
050,31,129,"Nebraska","Nuckolls County",4,25,48,24,24
050,31,129,"Nebraska","Nuckolls County",4,26,31,14,17
050,31,129,"Nebraska","Nuckolls County",4,27,39,18,21
050,31,129,"Nebraska","Nuckolls County",4,28,41,19,22
050,31,129,"Nebraska","Nuckolls County",4,29,39,22,17
050,31,129,"Nebraska","Nuckolls County",4,30,43,23,20
050,31,129,"Nebraska","Nuckolls County",4,31,30,16,14
050,31,129,"Nebraska","Nuckolls County",4,32,50,22,28
050,31,129,"Nebraska","Nuckolls County",4,33,39,18,21
050,31,129,"Nebraska","Nuckolls County",4,34,37,22,15
050,31,129,"Nebraska","Nuckolls County",4,35,42,25,17
050,31,129,"Nebraska","Nuckolls County",4,36,40,19,21
050,31,129,"Nebraska","Nuckolls County",4,37,39,23,16
050,31,129,"Nebraska","Nuckolls County",4,38,43,23,20
050,31,129,"Nebraska","Nuckolls County",4,39,51,17,34
050,31,129,"Nebraska","Nuckolls County",4,40,47,18,29
050,31,129,"Nebraska","Nuckolls County",4,41,42,21,21
050,31,129,"Nebraska","Nuckolls County",4,42,44,24,20
050,31,129,"Nebraska","Nuckolls County",4,43,38,25,13
050,31,129,"Nebraska","Nuckolls County",4,44,34,20,14
050,31,129,"Nebraska","Nuckolls County",4,45,40,26,14
050,31,129,"Nebraska","Nuckolls County",4,46,33,20,13
050,31,129,"Nebraska","Nuckolls County",4,47,41,22,19
050,31,129,"Nebraska","Nuckolls County",4,48,45,22,23
050,31,129,"Nebraska","Nuckolls County",4,49,45,20,25
050,31,129,"Nebraska","Nuckolls County",4,50,43,22,21
050,31,129,"Nebraska","Nuckolls County",4,51,38,21,17
050,31,129,"Nebraska","Nuckolls County",4,52,41,22,19
050,31,129,"Nebraska","Nuckolls County",4,53,38,18,20
050,31,129,"Nebraska","Nuckolls County",4,54,35,17,18
050,31,129,"Nebraska","Nuckolls County",4,55,44,22,22
050,31,129,"Nebraska","Nuckolls County",4,56,47,28,19
050,31,129,"Nebraska","Nuckolls County",4,57,44,25,19
050,31,129,"Nebraska","Nuckolls County",4,58,55,29,26
050,31,129,"Nebraska","Nuckolls County",4,59,58,29,29
050,31,129,"Nebraska","Nuckolls County",4,60,54,30,24
050,31,129,"Nebraska","Nuckolls County",4,61,62,27,35
050,31,129,"Nebraska","Nuckolls County",4,62,70,33,37
050,31,129,"Nebraska","Nuckolls County",4,63,93,50,43
050,31,129,"Nebraska","Nuckolls County",4,64,90,50,40
050,31,129,"Nebraska","Nuckolls County",4,65,86,45,41
050,31,129,"Nebraska","Nuckolls County",4,66,74,39,35
050,31,129,"Nebraska","Nuckolls County",4,67,65,32,33
050,31,129,"Nebraska","Nuckolls County",4,68,60,27,33
050,31,129,"Nebraska","Nuckolls County",4,69,66,31,35
050,31,129,"Nebraska","Nuckolls County",4,70,56,27,29
050,31,129,"Nebraska","Nuckolls County",4,71,56,28,28
050,31,129,"Nebraska","Nuckolls County",4,72,54,26,28
050,31,129,"Nebraska","Nuckolls County",4,73,45,22,23
050,31,129,"Nebraska","Nuckolls County",4,74,54,26,28
050,31,129,"Nebraska","Nuckolls County",4,75,57,29,28
050,31,129,"Nebraska","Nuckolls County",4,76,39,17,22
050,31,129,"Nebraska","Nuckolls County",4,77,45,23,22
050,31,129,"Nebraska","Nuckolls County",4,78,36,17,19
050,31,129,"Nebraska","Nuckolls County",4,79,30,15,15
050,31,129,"Nebraska","Nuckolls County",4,80,36,18,18
050,31,129,"Nebraska","Nuckolls County",4,81,35,15,20
050,31,129,"Nebraska","Nuckolls County",4,82,32,12,20
050,31,129,"Nebraska","Nuckolls County",4,83,29,10,19
050,31,129,"Nebraska","Nuckolls County",4,84,22,3,19
050,31,129,"Nebraska","Nuckolls County",4,85,159,57,102
050,31,129,"Nebraska","Nuckolls County",5,0,43,26,17
050,31,129,"Nebraska","Nuckolls County",5,1,42,24,18
050,31,129,"Nebraska","Nuckolls County",5,2,47,27,20
050,31,129,"Nebraska","Nuckolls County",5,3,40,25,15
050,31,129,"Nebraska","Nuckolls County",5,4,51,28,23
050,31,129,"Nebraska","Nuckolls County",5,5,50,24,26
050,31,129,"Nebraska","Nuckolls County",5,6,39,16,23
050,31,129,"Nebraska","Nuckolls County",5,7,40,19,21
050,31,129,"Nebraska","Nuckolls County",5,8,48,23,25
050,31,129,"Nebraska","Nuckolls County",5,9,44,24,20
050,31,129,"Nebraska","Nuckolls County",5,10,39,24,15
050,31,129,"Nebraska","Nuckolls County",5,11,47,22,25
050,31,129,"Nebraska","Nuckolls County",5,12,50,28,22
050,31,129,"Nebraska","Nuckolls County",5,13,60,30,30
050,31,129,"Nebraska","Nuckolls County",5,14,51,28,23
050,31,129,"Nebraska","Nuckolls County",5,15,51,25,26
050,31,129,"Nebraska","Nuckolls County",5,16,44,23,21
050,31,129,"Nebraska","Nuckolls County",5,17,49,22,27
050,31,129,"Nebraska","Nuckolls County",5,18,46,26,20
050,31,129,"Nebraska","Nuckolls County",5,19,32,18,14
050,31,129,"Nebraska","Nuckolls County",5,20,37,20,17
050,31,129,"Nebraska","Nuckolls County",5,21,34,17,17
050,31,129,"Nebraska","Nuckolls County",5,22,38,18,20
050,31,129,"Nebraska","Nuckolls County",5,23,40,22,18
050,31,129,"Nebraska","Nuckolls County",5,24,40,20,20
050,31,129,"Nebraska","Nuckolls County",5,25,34,17,17
050,31,129,"Nebraska","Nuckolls County",5,26,46,25,21
050,31,129,"Nebraska","Nuckolls County",5,27,33,14,19
050,31,129,"Nebraska","Nuckolls County",5,28,39,21,18
050,31,129,"Nebraska","Nuckolls County",5,29,42,20,22
050,31,129,"Nebraska","Nuckolls County",5,30,44,23,21
050,31,129,"Nebraska","Nuckolls County",5,31,48,23,25
050,31,129,"Nebraska","Nuckolls County",5,32,31,16,15
050,31,129,"Nebraska","Nuckolls County",5,33,51,22,29
050,31,129,"Nebraska","Nuckolls County",5,34,44,22,22
050,31,129,"Nebraska","Nuckolls County",5,35,38,22,16
050,31,129,"Nebraska","Nuckolls County",5,36,42,25,17
050,31,129,"Nebraska","Nuckolls County",5,37,41,20,21
050,31,129,"Nebraska","Nuckolls County",5,38,41,21,20
050,31,129,"Nebraska","Nuckolls County",5,39,46,24,22
050,31,129,"Nebraska","Nuckolls County",5,40,49,16,33
050,31,129,"Nebraska","Nuckolls County",5,41,45,18,27
050,31,129,"Nebraska","Nuckolls County",5,42,46,23,23
050,31,129,"Nebraska","Nuckolls County",5,43,43,24,19
050,31,129,"Nebraska","Nuckolls County",5,44,34,23,11
050,31,129,"Nebraska","Nuckolls County",5,45,34,20,14
050,31,129,"Nebraska","Nuckolls County",5,46,40,26,14
050,31,129,"Nebraska","Nuckolls County",5,47,36,22,14
050,31,129,"Nebraska","Nuckolls County",5,48,41,22,19
050,31,129,"Nebraska","Nuckolls County",5,49,45,22,23
050,31,129,"Nebraska","Nuckolls County",5,50,47,20,27
050,31,129,"Nebraska","Nuckolls County",5,51,43,21,22
050,31,129,"Nebraska","Nuckolls County",5,52,43,25,18
050,31,129,"Nebraska","Nuckolls County",5,53,41,22,19
050,31,129,"Nebraska","Nuckolls County",5,54,40,19,21
050,31,129,"Nebraska","Nuckolls County",5,55,37,18,19
050,31,129,"Nebraska","Nuckolls County",5,56,43,21,22
050,31,129,"Nebraska","Nuckolls County",5,57,45,28,17
050,31,129,"Nebraska","Nuckolls County",5,58,44,25,19
050,31,129,"Nebraska","Nuckolls County",5,59,55,30,25
050,31,129,"Nebraska","Nuckolls County",5,60,57,28,29
050,31,129,"Nebraska","Nuckolls County",5,61,55,29,26
050,31,129,"Nebraska","Nuckolls County",5,62,64,28,36
050,31,129,"Nebraska","Nuckolls County",5,63,72,35,37
050,31,129,"Nebraska","Nuckolls County",5,64,92,49,43
050,31,129,"Nebraska","Nuckolls County",5,65,89,50,39
050,31,129,"Nebraska","Nuckolls County",5,66,82,44,38
050,31,129,"Nebraska","Nuckolls County",5,67,75,40,35
050,31,129,"Nebraska","Nuckolls County",5,68,62,32,30
050,31,129,"Nebraska","Nuckolls County",5,69,60,26,34
050,31,129,"Nebraska","Nuckolls County",5,70,69,32,37
050,31,129,"Nebraska","Nuckolls County",5,71,56,28,28
050,31,129,"Nebraska","Nuckolls County",5,72,53,26,27
050,31,129,"Nebraska","Nuckolls County",5,73,52,24,28
050,31,129,"Nebraska","Nuckolls County",5,74,47,23,24
050,31,129,"Nebraska","Nuckolls County",5,75,52,26,26
050,31,129,"Nebraska","Nuckolls County",5,76,54,27,27
050,31,129,"Nebraska","Nuckolls County",5,77,34,15,19
050,31,129,"Nebraska","Nuckolls County",5,78,45,23,22
050,31,129,"Nebraska","Nuckolls County",5,79,35,16,19
050,31,129,"Nebraska","Nuckolls County",5,80,33,17,16
050,31,129,"Nebraska","Nuckolls County",5,81,34,17,17
050,31,129,"Nebraska","Nuckolls County",5,82,35,16,19
050,31,129,"Nebraska","Nuckolls County",5,83,34,13,21
050,31,129,"Nebraska","Nuckolls County",5,84,26,6,20
050,31,129,"Nebraska","Nuckolls County",5,85,155,50,105
050,31,131,"Nebraska","Otoe County",1,0,179,91,88
050,31,131,"Nebraska","Otoe County",1,1,184,85,99
050,31,131,"Nebraska","Otoe County",1,2,208,112,96
050,31,131,"Nebraska","Otoe County",1,3,205,120,85
050,31,131,"Nebraska","Otoe County",1,4,206,104,102
050,31,131,"Nebraska","Otoe County",1,5,239,139,100
050,31,131,"Nebraska","Otoe County",1,6,193,99,94
050,31,131,"Nebraska","Otoe County",1,7,197,106,91
050,31,131,"Nebraska","Otoe County",1,8,211,102,109
050,31,131,"Nebraska","Otoe County",1,9,215,111,104
050,31,131,"Nebraska","Otoe County",1,10,227,117,110
050,31,131,"Nebraska","Otoe County",1,11,229,121,108
050,31,131,"Nebraska","Otoe County",1,12,227,127,100
050,31,131,"Nebraska","Otoe County",1,13,233,119,114
050,31,131,"Nebraska","Otoe County",1,14,233,117,116
050,31,131,"Nebraska","Otoe County",1,15,235,119,116
050,31,131,"Nebraska","Otoe County",1,16,223,102,121
050,31,131,"Nebraska","Otoe County",1,17,207,99,108
050,31,131,"Nebraska","Otoe County",1,18,181,87,94
050,31,131,"Nebraska","Otoe County",1,19,149,79,70
050,31,131,"Nebraska","Otoe County",1,20,166,88,78
050,31,131,"Nebraska","Otoe County",1,21,162,87,75
050,31,131,"Nebraska","Otoe County",1,22,158,81,77
050,31,131,"Nebraska","Otoe County",1,23,164,86,78
050,31,131,"Nebraska","Otoe County",1,24,139,74,65
050,31,131,"Nebraska","Otoe County",1,25,151,85,66
050,31,131,"Nebraska","Otoe County",1,26,162,85,77
050,31,131,"Nebraska","Otoe County",1,27,169,102,67
050,31,131,"Nebraska","Otoe County",1,28,185,96,89
050,31,131,"Nebraska","Otoe County",1,29,162,79,83
050,31,131,"Nebraska","Otoe County",1,30,165,91,74
050,31,131,"Nebraska","Otoe County",1,31,161,81,80
050,31,131,"Nebraska","Otoe County",1,32,177,82,95
050,31,131,"Nebraska","Otoe County",1,33,185,89,96
050,31,131,"Nebraska","Otoe County",1,34,177,94,83
050,31,131,"Nebraska","Otoe County",1,35,192,101,91
050,31,131,"Nebraska","Otoe County",1,36,204,108,96
050,31,131,"Nebraska","Otoe County",1,37,184,98,86
050,31,131,"Nebraska","Otoe County",1,38,173,80,93
050,31,131,"Nebraska","Otoe County",1,39,192,96,96
050,31,131,"Nebraska","Otoe County",1,40,195,100,95
050,31,131,"Nebraska","Otoe County",1,41,197,99,98
050,31,131,"Nebraska","Otoe County",1,42,188,99,89
050,31,131,"Nebraska","Otoe County",1,43,172,85,87
050,31,131,"Nebraska","Otoe County",1,44,164,81,83
050,31,131,"Nebraska","Otoe County",1,45,177,90,87
050,31,131,"Nebraska","Otoe County",1,46,189,95,94
050,31,131,"Nebraska","Otoe County",1,47,177,94,83
050,31,131,"Nebraska","Otoe County",1,48,196,103,93
050,31,131,"Nebraska","Otoe County",1,49,206,107,99
050,31,131,"Nebraska","Otoe County",1,50,199,114,85
050,31,131,"Nebraska","Otoe County",1,51,191,107,84
050,31,131,"Nebraska","Otoe County",1,52,190,87,103
050,31,131,"Nebraska","Otoe County",1,53,178,78,100
050,31,131,"Nebraska","Otoe County",1,54,196,102,94
050,31,131,"Nebraska","Otoe County",1,55,216,112,104
050,31,131,"Nebraska","Otoe County",1,56,239,113,126
050,31,131,"Nebraska","Otoe County",1,57,230,115,115
050,31,131,"Nebraska","Otoe County",1,58,246,125,121
050,31,131,"Nebraska","Otoe County",1,59,240,130,110
050,31,131,"Nebraska","Otoe County",1,60,236,126,110
050,31,131,"Nebraska","Otoe County",1,61,245,122,123
050,31,131,"Nebraska","Otoe County",1,62,247,119,128
050,31,131,"Nebraska","Otoe County",1,63,232,118,114
050,31,131,"Nebraska","Otoe County",1,64,234,114,120
050,31,131,"Nebraska","Otoe County",1,65,223,103,120
050,31,131,"Nebraska","Otoe County",1,66,210,106,104
050,31,131,"Nebraska","Otoe County",1,67,182,89,93
050,31,131,"Nebraska","Otoe County",1,68,175,82,93
050,31,131,"Nebraska","Otoe County",1,69,178,88,90
050,31,131,"Nebraska","Otoe County",1,70,168,77,91
050,31,131,"Nebraska","Otoe County",1,71,165,83,82
050,31,131,"Nebraska","Otoe County",1,72,155,74,81
050,31,131,"Nebraska","Otoe County",1,73,157,74,83
050,31,131,"Nebraska","Otoe County",1,74,117,59,58
050,31,131,"Nebraska","Otoe County",1,75,104,52,52
050,31,131,"Nebraska","Otoe County",1,76,118,56,62
050,31,131,"Nebraska","Otoe County",1,77,110,54,56
050,31,131,"Nebraska","Otoe County",1,78,89,40,49
050,31,131,"Nebraska","Otoe County",1,79,93,40,53
050,31,131,"Nebraska","Otoe County",1,80,99,37,62
050,31,131,"Nebraska","Otoe County",1,81,85,38,47
050,31,131,"Nebraska","Otoe County",1,82,65,32,33
050,31,131,"Nebraska","Otoe County",1,83,78,40,38
050,31,131,"Nebraska","Otoe County",1,84,67,30,37
050,31,131,"Nebraska","Otoe County",1,85,483,159,324
050,31,131,"Nebraska","Otoe County",2,0,174,82,92
050,31,131,"Nebraska","Otoe County",2,1,187,88,99
050,31,131,"Nebraska","Otoe County",2,2,201,106,95
050,31,131,"Nebraska","Otoe County",2,3,203,117,86
050,31,131,"Nebraska","Otoe County",2,4,210,111,99
050,31,131,"Nebraska","Otoe County",2,5,231,130,101
050,31,131,"Nebraska","Otoe County",2,6,206,110,96
050,31,131,"Nebraska","Otoe County",2,7,197,104,93
050,31,131,"Nebraska","Otoe County",2,8,208,103,105
050,31,131,"Nebraska","Otoe County",2,9,210,107,103
050,31,131,"Nebraska","Otoe County",2,10,223,115,108
050,31,131,"Nebraska","Otoe County",2,11,226,119,107
050,31,131,"Nebraska","Otoe County",2,12,230,127,103
050,31,131,"Nebraska","Otoe County",2,13,233,121,112
050,31,131,"Nebraska","Otoe County",2,14,232,116,116
050,31,131,"Nebraska","Otoe County",2,15,234,117,117
050,31,131,"Nebraska","Otoe County",2,16,226,105,121
050,31,131,"Nebraska","Otoe County",2,17,208,97,111
050,31,131,"Nebraska","Otoe County",2,18,177,85,92
050,31,131,"Nebraska","Otoe County",2,19,149,76,73
050,31,131,"Nebraska","Otoe County",2,20,165,87,78
050,31,131,"Nebraska","Otoe County",2,21,164,86,78
050,31,131,"Nebraska","Otoe County",2,22,161,83,78
050,31,131,"Nebraska","Otoe County",2,23,162,85,77
050,31,131,"Nebraska","Otoe County",2,24,143,76,67
050,31,131,"Nebraska","Otoe County",2,25,150,84,66
050,31,131,"Nebraska","Otoe County",2,26,160,86,74
050,31,131,"Nebraska","Otoe County",2,27,169,99,70
050,31,131,"Nebraska","Otoe County",2,28,182,96,86
050,31,131,"Nebraska","Otoe County",2,29,171,86,85
050,31,131,"Nebraska","Otoe County",2,30,166,90,76
050,31,131,"Nebraska","Otoe County",2,31,162,84,78
050,31,131,"Nebraska","Otoe County",2,32,174,82,92
050,31,131,"Nebraska","Otoe County",2,33,183,88,95
050,31,131,"Nebraska","Otoe County",2,34,180,94,86
050,31,131,"Nebraska","Otoe County",2,35,192,100,92
050,31,131,"Nebraska","Otoe County",2,36,199,105,94
050,31,131,"Nebraska","Otoe County",2,37,187,99,88
050,31,131,"Nebraska","Otoe County",2,38,177,84,93
050,31,131,"Nebraska","Otoe County",2,39,187,92,95
050,31,131,"Nebraska","Otoe County",2,40,199,103,96
050,31,131,"Nebraska","Otoe County",2,41,193,96,97
050,31,131,"Nebraska","Otoe County",2,42,188,98,90
050,31,131,"Nebraska","Otoe County",2,43,174,87,87
050,31,131,"Nebraska","Otoe County",2,44,162,79,83
050,31,131,"Nebraska","Otoe County",2,45,175,88,87
050,31,131,"Nebraska","Otoe County",2,46,187,95,92
050,31,131,"Nebraska","Otoe County",2,47,181,96,85
050,31,131,"Nebraska","Otoe County",2,48,192,101,91
050,31,131,"Nebraska","Otoe County",2,49,206,108,98
050,31,131,"Nebraska","Otoe County",2,50,202,113,89
050,31,131,"Nebraska","Otoe County",2,51,190,106,84
050,31,131,"Nebraska","Otoe County",2,52,189,90,99
050,31,131,"Nebraska","Otoe County",2,53,180,80,100
050,31,131,"Nebraska","Otoe County",2,54,190,95,95
050,31,131,"Nebraska","Otoe County",2,55,210,109,101
050,31,131,"Nebraska","Otoe County",2,56,235,113,122
050,31,131,"Nebraska","Otoe County",2,57,232,114,118
050,31,131,"Nebraska","Otoe County",2,58,241,122,119
050,31,131,"Nebraska","Otoe County",2,59,241,130,111
050,31,131,"Nebraska","Otoe County",2,60,237,127,110
050,31,131,"Nebraska","Otoe County",2,61,243,123,120
050,31,131,"Nebraska","Otoe County",2,62,244,118,126
050,31,131,"Nebraska","Otoe County",2,63,236,118,118
050,31,131,"Nebraska","Otoe County",2,64,230,112,118
050,31,131,"Nebraska","Otoe County",2,65,228,106,122
050,31,131,"Nebraska","Otoe County",2,66,213,104,109
050,31,131,"Nebraska","Otoe County",2,67,188,93,95
050,31,131,"Nebraska","Otoe County",2,68,175,83,92
050,31,131,"Nebraska","Otoe County",2,69,177,86,91
050,31,131,"Nebraska","Otoe County",2,70,171,80,91
050,31,131,"Nebraska","Otoe County",2,71,164,81,83
050,31,131,"Nebraska","Otoe County",2,72,153,74,79
050,31,131,"Nebraska","Otoe County",2,73,165,78,87
050,31,131,"Nebraska","Otoe County",2,74,117,57,60
050,31,131,"Nebraska","Otoe County",2,75,107,54,53
050,31,131,"Nebraska","Otoe County",2,76,113,54,59
050,31,131,"Nebraska","Otoe County",2,77,114,56,58
050,31,131,"Nebraska","Otoe County",2,78,91,42,49
050,31,131,"Nebraska","Otoe County",2,79,94,41,53
050,31,131,"Nebraska","Otoe County",2,80,97,38,59
050,31,131,"Nebraska","Otoe County",2,81,87,37,50
050,31,131,"Nebraska","Otoe County",2,82,69,33,36
050,31,131,"Nebraska","Otoe County",2,83,75,36,39
050,31,131,"Nebraska","Otoe County",2,84,68,32,36
050,31,131,"Nebraska","Otoe County",2,85,479,160,319
050,31,131,"Nebraska","Otoe County",3,0,194,98,96
050,31,131,"Nebraska","Otoe County",3,1,182,83,99
050,31,131,"Nebraska","Otoe County",3,2,196,97,99
050,31,131,"Nebraska","Otoe County",3,3,206,110,96
050,31,131,"Nebraska","Otoe County",3,4,201,116,85
050,31,131,"Nebraska","Otoe County",3,5,216,106,110
050,31,131,"Nebraska","Otoe County",3,6,233,128,105
050,31,131,"Nebraska","Otoe County",3,7,199,108,91
050,31,131,"Nebraska","Otoe County",3,8,199,105,94
050,31,131,"Nebraska","Otoe County",3,9,205,104,101
050,31,131,"Nebraska","Otoe County",3,10,208,111,97
050,31,131,"Nebraska","Otoe County",3,11,222,118,104
050,31,131,"Nebraska","Otoe County",3,12,222,118,104
050,31,131,"Nebraska","Otoe County",3,13,233,130,103
050,31,131,"Nebraska","Otoe County",3,14,227,123,104
050,31,131,"Nebraska","Otoe County",3,15,221,111,110
050,31,131,"Nebraska","Otoe County",3,16,235,118,117
050,31,131,"Nebraska","Otoe County",3,17,223,103,120
050,31,131,"Nebraska","Otoe County",3,18,184,92,92
050,31,131,"Nebraska","Otoe County",3,19,148,75,73
050,31,131,"Nebraska","Otoe County",3,20,149,75,74
050,31,131,"Nebraska","Otoe County",3,21,160,81,79
050,31,131,"Nebraska","Otoe County",3,22,169,86,83
050,31,131,"Nebraska","Otoe County",3,23,167,93,74
050,31,131,"Nebraska","Otoe County",3,24,149,77,72
050,31,131,"Nebraska","Otoe County",3,25,142,74,68
050,31,131,"Nebraska","Otoe County",3,26,148,84,64
050,31,131,"Nebraska","Otoe County",3,27,157,83,74
050,31,131,"Nebraska","Otoe County",3,28,174,96,78
050,31,131,"Nebraska","Otoe County",3,29,185,94,91
050,31,131,"Nebraska","Otoe County",3,30,197,97,100
050,31,131,"Nebraska","Otoe County",3,31,175,96,79
050,31,131,"Nebraska","Otoe County",3,32,170,88,82
050,31,131,"Nebraska","Otoe County",3,33,180,91,89
050,31,131,"Nebraska","Otoe County",3,34,183,93,90
050,31,131,"Nebraska","Otoe County",3,35,182,92,90
050,31,131,"Nebraska","Otoe County",3,36,192,100,92
050,31,131,"Nebraska","Otoe County",3,37,206,112,94
050,31,131,"Nebraska","Otoe County",3,38,194,102,92
050,31,131,"Nebraska","Otoe County",3,39,178,82,96
050,31,131,"Nebraska","Otoe County",3,40,188,97,91
050,31,131,"Nebraska","Otoe County",3,41,200,104,96
050,31,131,"Nebraska","Otoe County",3,42,196,100,96
050,31,131,"Nebraska","Otoe County",3,43,198,98,100
050,31,131,"Nebraska","Otoe County",3,44,184,95,89
050,31,131,"Nebraska","Otoe County",3,45,166,79,87
050,31,131,"Nebraska","Otoe County",3,46,180,93,87
050,31,131,"Nebraska","Otoe County",3,47,188,96,92
050,31,131,"Nebraska","Otoe County",3,48,187,99,88
050,31,131,"Nebraska","Otoe County",3,49,196,101,95
050,31,131,"Nebraska","Otoe County",3,50,212,112,100
050,31,131,"Nebraska","Otoe County",3,51,207,112,95
050,31,131,"Nebraska","Otoe County",3,52,189,106,83
050,31,131,"Nebraska","Otoe County",3,53,191,90,101
050,31,131,"Nebraska","Otoe County",3,54,183,82,101
050,31,131,"Nebraska","Otoe County",3,55,196,95,101
050,31,131,"Nebraska","Otoe County",3,56,213,109,104
050,31,131,"Nebraska","Otoe County",3,57,227,112,115
050,31,131,"Nebraska","Otoe County",3,58,227,112,115
050,31,131,"Nebraska","Otoe County",3,59,238,123,115
050,31,131,"Nebraska","Otoe County",3,60,236,128,108
050,31,131,"Nebraska","Otoe County",3,61,235,125,110
050,31,131,"Nebraska","Otoe County",3,62,244,121,123
050,31,131,"Nebraska","Otoe County",3,63,243,117,126
050,31,131,"Nebraska","Otoe County",3,64,237,114,123
050,31,131,"Nebraska","Otoe County",3,65,228,113,115
050,31,131,"Nebraska","Otoe County",3,66,222,102,120
050,31,131,"Nebraska","Otoe County",3,67,213,104,109
050,31,131,"Nebraska","Otoe County",3,68,183,90,93
050,31,131,"Nebraska","Otoe County",3,69,172,83,89
050,31,131,"Nebraska","Otoe County",3,70,176,83,93
050,31,131,"Nebraska","Otoe County",3,71,164,77,87
050,31,131,"Nebraska","Otoe County",3,72,163,80,83
050,31,131,"Nebraska","Otoe County",3,73,156,71,85
050,31,131,"Nebraska","Otoe County",3,74,154,74,80
050,31,131,"Nebraska","Otoe County",3,75,111,53,58
050,31,131,"Nebraska","Otoe County",3,76,99,51,48
050,31,131,"Nebraska","Otoe County",3,77,111,52,59
050,31,131,"Nebraska","Otoe County",3,78,111,55,56
050,31,131,"Nebraska","Otoe County",3,79,93,44,49
050,31,131,"Nebraska","Otoe County",3,80,90,42,48
050,31,131,"Nebraska","Otoe County",3,81,99,38,61
050,31,131,"Nebraska","Otoe County",3,82,75,32,43
050,31,131,"Nebraska","Otoe County",3,83,72,31,41
050,31,131,"Nebraska","Otoe County",3,84,69,33,36
050,31,131,"Nebraska","Otoe County",3,85,484,170,314
050,31,131,"Nebraska","Otoe County",4,0,191,97,94
050,31,131,"Nebraska","Otoe County",4,1,185,96,89
050,31,131,"Nebraska","Otoe County",4,2,190,88,102
050,31,131,"Nebraska","Otoe County",4,3,196,103,93
050,31,131,"Nebraska","Otoe County",4,4,228,123,105
050,31,131,"Nebraska","Otoe County",4,5,217,124,93
050,31,131,"Nebraska","Otoe County",4,6,220,107,113
050,31,131,"Nebraska","Otoe County",4,7,239,137,102
050,31,131,"Nebraska","Otoe County",4,8,202,111,91
050,31,131,"Nebraska","Otoe County",4,9,202,104,98
050,31,131,"Nebraska","Otoe County",4,10,214,107,107
050,31,131,"Nebraska","Otoe County",4,11,209,107,102
050,31,131,"Nebraska","Otoe County",4,12,225,121,104
050,31,131,"Nebraska","Otoe County",4,13,245,131,114
050,31,131,"Nebraska","Otoe County",4,14,242,136,106
050,31,131,"Nebraska","Otoe County",4,15,230,122,108
050,31,131,"Nebraska","Otoe County",4,16,225,114,111
050,31,131,"Nebraska","Otoe County",4,17,236,123,113
050,31,131,"Nebraska","Otoe County",4,18,194,97,97
050,31,131,"Nebraska","Otoe County",4,19,151,82,69
050,31,131,"Nebraska","Otoe County",4,20,149,79,70
050,31,131,"Nebraska","Otoe County",4,21,151,76,75
050,31,131,"Nebraska","Otoe County",4,22,166,85,81
050,31,131,"Nebraska","Otoe County",4,23,169,94,75
050,31,131,"Nebraska","Otoe County",4,24,163,90,73
050,31,131,"Nebraska","Otoe County",4,25,150,77,73
050,31,131,"Nebraska","Otoe County",4,26,150,78,72
050,31,131,"Nebraska","Otoe County",4,27,154,81,73
050,31,131,"Nebraska","Otoe County",4,28,156,83,73
050,31,131,"Nebraska","Otoe County",4,29,183,94,89
050,31,131,"Nebraska","Otoe County",4,30,196,103,93
050,31,131,"Nebraska","Otoe County",4,31,202,104,98
050,31,131,"Nebraska","Otoe County",4,32,180,101,79
050,31,131,"Nebraska","Otoe County",4,33,173,91,82
050,31,131,"Nebraska","Otoe County",4,34,185,94,91
050,31,131,"Nebraska","Otoe County",4,35,196,96,100
050,31,131,"Nebraska","Otoe County",4,36,181,87,94
050,31,131,"Nebraska","Otoe County",4,37,213,116,97
050,31,131,"Nebraska","Otoe County",4,38,212,115,97
050,31,131,"Nebraska","Otoe County",4,39,193,99,94
050,31,131,"Nebraska","Otoe County",4,40,183,88,95
050,31,131,"Nebraska","Otoe County",4,41,189,97,92
050,31,131,"Nebraska","Otoe County",4,42,201,102,99
050,31,131,"Nebraska","Otoe County",4,43,202,101,101
050,31,131,"Nebraska","Otoe County",4,44,203,100,103
050,31,131,"Nebraska","Otoe County",4,45,182,96,86
050,31,131,"Nebraska","Otoe County",4,46,171,82,89
050,31,131,"Nebraska","Otoe County",4,47,180,94,86
050,31,131,"Nebraska","Otoe County",4,48,188,98,90
050,31,131,"Nebraska","Otoe County",4,49,190,102,88
050,31,131,"Nebraska","Otoe County",4,50,194,103,91
050,31,131,"Nebraska","Otoe County",4,51,216,117,99
050,31,131,"Nebraska","Otoe County",4,52,205,112,93
050,31,131,"Nebraska","Otoe County",4,53,187,100,87
050,31,131,"Nebraska","Otoe County",4,54,196,90,106
050,31,131,"Nebraska","Otoe County",4,55,188,83,105
050,31,131,"Nebraska","Otoe County",4,56,193,94,99
050,31,131,"Nebraska","Otoe County",4,57,213,111,102
050,31,131,"Nebraska","Otoe County",4,58,225,110,115
050,31,131,"Nebraska","Otoe County",4,59,224,111,113
050,31,131,"Nebraska","Otoe County",4,60,238,123,115
050,31,131,"Nebraska","Otoe County",4,61,236,126,110
050,31,131,"Nebraska","Otoe County",4,62,237,122,115
050,31,131,"Nebraska","Otoe County",4,63,239,117,122
050,31,131,"Nebraska","Otoe County",4,64,240,118,122
050,31,131,"Nebraska","Otoe County",4,65,244,115,129
050,31,131,"Nebraska","Otoe County",4,66,221,109,112
050,31,131,"Nebraska","Otoe County",4,67,217,103,114
050,31,131,"Nebraska","Otoe County",4,68,215,104,111
050,31,131,"Nebraska","Otoe County",4,69,184,92,92
050,31,131,"Nebraska","Otoe County",4,70,168,80,88
050,31,131,"Nebraska","Otoe County",4,71,158,76,82
050,31,131,"Nebraska","Otoe County",4,72,159,77,82
050,31,131,"Nebraska","Otoe County",4,73,163,78,85
050,31,131,"Nebraska","Otoe County",4,74,148,68,80
050,31,131,"Nebraska","Otoe County",4,75,148,69,79
050,31,131,"Nebraska","Otoe County",4,76,108,52,56
050,31,131,"Nebraska","Otoe County",4,77,91,46,45
050,31,131,"Nebraska","Otoe County",4,78,109,50,59
050,31,131,"Nebraska","Otoe County",4,79,107,56,51
050,31,131,"Nebraska","Otoe County",4,80,87,45,42
050,31,131,"Nebraska","Otoe County",4,81,90,40,50
050,31,131,"Nebraska","Otoe County",4,82,83,32,51
050,31,131,"Nebraska","Otoe County",4,83,76,29,47
050,31,131,"Nebraska","Otoe County",4,84,61,25,36
050,31,131,"Nebraska","Otoe County",4,85,466,168,298
050,31,131,"Nebraska","Otoe County",5,0,195,100,95
050,31,131,"Nebraska","Otoe County",5,1,181,97,84
050,31,131,"Nebraska","Otoe County",5,2,186,99,87
050,31,131,"Nebraska","Otoe County",5,3,202,100,102
050,31,131,"Nebraska","Otoe County",5,4,204,113,91
050,31,131,"Nebraska","Otoe County",5,5,228,126,102
050,31,131,"Nebraska","Otoe County",5,6,218,122,96
050,31,131,"Nebraska","Otoe County",5,7,226,108,118
050,31,131,"Nebraska","Otoe County",5,8,237,133,104
050,31,131,"Nebraska","Otoe County",5,9,208,110,98
050,31,131,"Nebraska","Otoe County",5,10,203,98,105
050,31,131,"Nebraska","Otoe County",5,11,208,100,108
050,31,131,"Nebraska","Otoe County",5,12,211,111,100
050,31,131,"Nebraska","Otoe County",5,13,241,130,111
050,31,131,"Nebraska","Otoe County",5,14,246,132,114
050,31,131,"Nebraska","Otoe County",5,15,242,135,107
050,31,131,"Nebraska","Otoe County",5,16,240,130,110
050,31,131,"Nebraska","Otoe County",5,17,233,123,110
050,31,131,"Nebraska","Otoe County",5,18,218,123,95
050,31,131,"Nebraska","Otoe County",5,19,159,80,79
050,31,131,"Nebraska","Otoe County",5,20,155,85,70
050,31,131,"Nebraska","Otoe County",5,21,159,78,81
050,31,131,"Nebraska","Otoe County",5,22,155,74,81
050,31,131,"Nebraska","Otoe County",5,23,171,93,78
050,31,131,"Nebraska","Otoe County",5,24,172,91,81
050,31,131,"Nebraska","Otoe County",5,25,165,89,76
050,31,131,"Nebraska","Otoe County",5,26,160,83,77
050,31,131,"Nebraska","Otoe County",5,27,159,87,72
050,31,131,"Nebraska","Otoe County",5,28,158,80,78
050,31,131,"Nebraska","Otoe County",5,29,158,85,73
050,31,131,"Nebraska","Otoe County",5,30,178,92,86
050,31,131,"Nebraska","Otoe County",5,31,188,96,92
050,31,131,"Nebraska","Otoe County",5,32,199,101,98
050,31,131,"Nebraska","Otoe County",5,33,184,97,87
050,31,131,"Nebraska","Otoe County",5,34,176,94,82
050,31,131,"Nebraska","Otoe County",5,35,194,94,100
050,31,131,"Nebraska","Otoe County",5,36,221,102,119
050,31,131,"Nebraska","Otoe County",5,37,211,100,111
050,31,131,"Nebraska","Otoe County",5,38,215,115,100
050,31,131,"Nebraska","Otoe County",5,39,223,118,105
050,31,131,"Nebraska","Otoe County",5,40,198,107,91
050,31,131,"Nebraska","Otoe County",5,41,173,84,89
050,31,131,"Nebraska","Otoe County",5,42,196,100,96
050,31,131,"Nebraska","Otoe County",5,43,196,99,97
050,31,131,"Nebraska","Otoe County",5,44,209,105,104
050,31,131,"Nebraska","Otoe County",5,45,201,98,103
050,31,131,"Nebraska","Otoe County",5,46,178,94,84
050,31,131,"Nebraska","Otoe County",5,47,175,80,95
050,31,131,"Nebraska","Otoe County",5,48,180,93,87
050,31,131,"Nebraska","Otoe County",5,49,191,98,93
050,31,131,"Nebraska","Otoe County",5,50,184,100,84
050,31,131,"Nebraska","Otoe County",5,51,192,102,90
050,31,131,"Nebraska","Otoe County",5,52,204,112,92
050,31,131,"Nebraska","Otoe County",5,53,204,110,94
050,31,131,"Nebraska","Otoe County",5,54,198,100,98
050,31,131,"Nebraska","Otoe County",5,55,185,85,100
050,31,131,"Nebraska","Otoe County",5,56,180,77,103
050,31,131,"Nebraska","Otoe County",5,57,188,92,96
050,31,131,"Nebraska","Otoe County",5,58,214,111,103
050,31,131,"Nebraska","Otoe County",5,59,225,111,114
050,31,131,"Nebraska","Otoe County",5,60,218,104,114
050,31,131,"Nebraska","Otoe County",5,61,235,121,114
050,31,131,"Nebraska","Otoe County",5,62,233,126,107
050,31,131,"Nebraska","Otoe County",5,63,232,117,115
050,31,131,"Nebraska","Otoe County",5,64,239,116,123
050,31,131,"Nebraska","Otoe County",5,65,243,120,123
050,31,131,"Nebraska","Otoe County",5,66,242,114,128
050,31,131,"Nebraska","Otoe County",5,67,218,112,106
050,31,131,"Nebraska","Otoe County",5,68,212,98,114
050,31,131,"Nebraska","Otoe County",5,69,215,103,112
050,31,131,"Nebraska","Otoe County",5,70,188,92,96
050,31,131,"Nebraska","Otoe County",5,71,161,74,87
050,31,131,"Nebraska","Otoe County",5,72,155,74,81
050,31,131,"Nebraska","Otoe County",5,73,159,73,86
050,31,131,"Nebraska","Otoe County",5,74,159,77,82
050,31,131,"Nebraska","Otoe County",5,75,141,64,77
050,31,131,"Nebraska","Otoe County",5,76,141,67,74
050,31,131,"Nebraska","Otoe County",5,77,101,45,56
050,31,131,"Nebraska","Otoe County",5,78,90,45,45
050,31,131,"Nebraska","Otoe County",5,79,105,50,55
050,31,131,"Nebraska","Otoe County",5,80,104,57,47
050,31,131,"Nebraska","Otoe County",5,81,88,45,43
050,31,131,"Nebraska","Otoe County",5,82,73,31,42
050,31,131,"Nebraska","Otoe County",5,83,84,29,55
050,31,131,"Nebraska","Otoe County",5,84,68,25,43
050,31,131,"Nebraska","Otoe County",5,85,473,167,306
050,31,133,"Nebraska","Pawnee County",1,0,35,18,17
050,31,133,"Nebraska","Pawnee County",1,1,29,15,14
050,31,133,"Nebraska","Pawnee County",1,2,33,14,19
050,31,133,"Nebraska","Pawnee County",1,3,39,20,19
050,31,133,"Nebraska","Pawnee County",1,4,41,22,19
050,31,133,"Nebraska","Pawnee County",1,5,23,12,11
050,31,133,"Nebraska","Pawnee County",1,6,28,16,12
050,31,133,"Nebraska","Pawnee County",1,7,33,18,15
050,31,133,"Nebraska","Pawnee County",1,8,32,18,14
050,31,133,"Nebraska","Pawnee County",1,9,28,17,11
050,31,133,"Nebraska","Pawnee County",1,10,32,14,18
050,31,133,"Nebraska","Pawnee County",1,11,34,22,12
050,31,133,"Nebraska","Pawnee County",1,12,28,14,14
050,31,133,"Nebraska","Pawnee County",1,13,27,13,14
050,31,133,"Nebraska","Pawnee County",1,14,35,15,20
050,31,133,"Nebraska","Pawnee County",1,15,30,16,14
050,31,133,"Nebraska","Pawnee County",1,16,26,17,9
050,31,133,"Nebraska","Pawnee County",1,17,31,13,18
050,31,133,"Nebraska","Pawnee County",1,18,30,15,15
050,31,133,"Nebraska","Pawnee County",1,19,19,10,9
050,31,133,"Nebraska","Pawnee County",1,20,23,11,12
050,31,133,"Nebraska","Pawnee County",1,21,27,11,16
050,31,133,"Nebraska","Pawnee County",1,22,23,11,12
050,31,133,"Nebraska","Pawnee County",1,23,23,13,10
050,31,133,"Nebraska","Pawnee County",1,24,16,7,9
050,31,133,"Nebraska","Pawnee County",1,25,24,14,10
050,31,133,"Nebraska","Pawnee County",1,26,25,15,10
050,31,133,"Nebraska","Pawnee County",1,27,25,13,12
050,31,133,"Nebraska","Pawnee County",1,28,23,10,13
050,31,133,"Nebraska","Pawnee County",1,29,22,13,9
050,31,133,"Nebraska","Pawnee County",1,30,20,9,11
050,31,133,"Nebraska","Pawnee County",1,31,17,8,9
050,31,133,"Nebraska","Pawnee County",1,32,16,7,9
050,31,133,"Nebraska","Pawnee County",1,33,23,10,13
050,31,133,"Nebraska","Pawnee County",1,34,24,12,12
050,31,133,"Nebraska","Pawnee County",1,35,26,10,16
050,31,133,"Nebraska","Pawnee County",1,36,25,15,10
050,31,133,"Nebraska","Pawnee County",1,37,23,12,11
050,31,133,"Nebraska","Pawnee County",1,38,22,12,10
050,31,133,"Nebraska","Pawnee County",1,39,30,15,15
050,31,133,"Nebraska","Pawnee County",1,40,26,10,16
050,31,133,"Nebraska","Pawnee County",1,41,23,9,14
050,31,133,"Nebraska","Pawnee County",1,42,28,14,14
050,31,133,"Nebraska","Pawnee County",1,43,18,9,9
050,31,133,"Nebraska","Pawnee County",1,44,13,5,8
050,31,133,"Nebraska","Pawnee County",1,45,19,9,10
050,31,133,"Nebraska","Pawnee County",1,46,25,10,15
050,31,133,"Nebraska","Pawnee County",1,47,16,9,7
050,31,133,"Nebraska","Pawnee County",1,48,30,16,14
050,31,133,"Nebraska","Pawnee County",1,49,35,17,18
050,31,133,"Nebraska","Pawnee County",1,50,28,14,14
050,31,133,"Nebraska","Pawnee County",1,51,27,14,13
050,31,133,"Nebraska","Pawnee County",1,52,29,15,14
050,31,133,"Nebraska","Pawnee County",1,53,33,15,18
050,31,133,"Nebraska","Pawnee County",1,54,33,21,12
050,31,133,"Nebraska","Pawnee County",1,55,22,11,11
050,31,133,"Nebraska","Pawnee County",1,56,30,12,18
050,31,133,"Nebraska","Pawnee County",1,57,40,22,18
050,31,133,"Nebraska","Pawnee County",1,58,35,16,19
050,31,133,"Nebraska","Pawnee County",1,59,40,14,26
050,31,133,"Nebraska","Pawnee County",1,60,40,22,18
050,31,133,"Nebraska","Pawnee County",1,61,42,22,20
050,31,133,"Nebraska","Pawnee County",1,62,37,20,17
050,31,133,"Nebraska","Pawnee County",1,63,40,21,19
050,31,133,"Nebraska","Pawnee County",1,64,39,23,16
050,31,133,"Nebraska","Pawnee County",1,65,41,21,20
050,31,133,"Nebraska","Pawnee County",1,66,34,19,15
050,31,133,"Nebraska","Pawnee County",1,67,42,23,19
050,31,133,"Nebraska","Pawnee County",1,68,46,25,21
050,31,133,"Nebraska","Pawnee County",1,69,37,19,18
050,31,133,"Nebraska","Pawnee County",1,70,27,16,11
050,31,133,"Nebraska","Pawnee County",1,71,34,19,15
050,31,133,"Nebraska","Pawnee County",1,72,38,18,20
050,31,133,"Nebraska","Pawnee County",1,73,49,25,24
050,31,133,"Nebraska","Pawnee County",1,74,26,11,15
050,31,133,"Nebraska","Pawnee County",1,75,26,10,16
050,31,133,"Nebraska","Pawnee County",1,76,32,14,18
050,31,133,"Nebraska","Pawnee County",1,77,31,13,18
050,31,133,"Nebraska","Pawnee County",1,78,19,10,9
050,31,133,"Nebraska","Pawnee County",1,79,18,8,10
050,31,133,"Nebraska","Pawnee County",1,80,18,8,10
050,31,133,"Nebraska","Pawnee County",1,81,18,8,10
050,31,133,"Nebraska","Pawnee County",1,82,21,8,13
050,31,133,"Nebraska","Pawnee County",1,83,20,8,12
050,31,133,"Nebraska","Pawnee County",1,84,20,10,10
050,31,133,"Nebraska","Pawnee County",1,85,130,49,81
050,31,133,"Nebraska","Pawnee County",2,0,31,16,15
050,31,133,"Nebraska","Pawnee County",2,1,31,16,15
050,31,133,"Nebraska","Pawnee County",2,2,33,15,18
050,31,133,"Nebraska","Pawnee County",2,3,38,18,20
050,31,133,"Nebraska","Pawnee County",2,4,39,21,18
050,31,133,"Nebraska","Pawnee County",2,5,27,14,13
050,31,133,"Nebraska","Pawnee County",2,6,27,15,12
050,31,133,"Nebraska","Pawnee County",2,7,31,17,14
050,31,133,"Nebraska","Pawnee County",2,8,33,18,15
050,31,133,"Nebraska","Pawnee County",2,9,29,17,12
050,31,133,"Nebraska","Pawnee County",2,10,32,15,17
050,31,133,"Nebraska","Pawnee County",2,11,34,20,14
050,31,133,"Nebraska","Pawnee County",2,12,30,16,14
050,31,133,"Nebraska","Pawnee County",2,13,28,14,14
050,31,133,"Nebraska","Pawnee County",2,14,32,14,18
050,31,133,"Nebraska","Pawnee County",2,15,31,16,15
050,31,133,"Nebraska","Pawnee County",2,16,27,17,10
050,31,133,"Nebraska","Pawnee County",2,17,29,14,15
050,31,133,"Nebraska","Pawnee County",2,18,28,14,14
050,31,133,"Nebraska","Pawnee County",2,19,19,10,9
050,31,133,"Nebraska","Pawnee County",2,20,22,10,12
050,31,133,"Nebraska","Pawnee County",2,21,26,11,15
050,31,133,"Nebraska","Pawnee County",2,22,22,10,12
050,31,133,"Nebraska","Pawnee County",2,23,23,12,11
050,31,133,"Nebraska","Pawnee County",2,24,18,9,9
050,31,133,"Nebraska","Pawnee County",2,25,23,13,10
050,31,133,"Nebraska","Pawnee County",2,26,24,14,10
050,31,133,"Nebraska","Pawnee County",2,27,25,13,12
050,31,133,"Nebraska","Pawnee County",2,28,23,11,12
050,31,133,"Nebraska","Pawnee County",2,29,22,12,10
050,31,133,"Nebraska","Pawnee County",2,30,21,10,11
050,31,133,"Nebraska","Pawnee County",2,31,19,9,10
050,31,133,"Nebraska","Pawnee County",2,32,16,7,9
050,31,133,"Nebraska","Pawnee County",2,33,21,9,12
050,31,133,"Nebraska","Pawnee County",2,34,23,11,12
050,31,133,"Nebraska","Pawnee County",2,35,27,11,16
050,31,133,"Nebraska","Pawnee County",2,36,25,14,11
050,31,133,"Nebraska","Pawnee County",2,37,23,13,10
050,31,133,"Nebraska","Pawnee County",2,38,22,12,10
050,31,133,"Nebraska","Pawnee County",2,39,27,14,13
050,31,133,"Nebraska","Pawnee County",2,40,27,11,16
050,31,133,"Nebraska","Pawnee County",2,41,24,10,14
050,31,133,"Nebraska","Pawnee County",2,42,27,13,14
050,31,133,"Nebraska","Pawnee County",2,43,20,10,10
050,31,133,"Nebraska","Pawnee County",2,44,13,5,8
050,31,133,"Nebraska","Pawnee County",2,45,18,8,10
050,31,133,"Nebraska","Pawnee County",2,46,24,10,14
050,31,133,"Nebraska","Pawnee County",2,47,19,10,9
050,31,133,"Nebraska","Pawnee County",2,48,27,14,13
050,31,133,"Nebraska","Pawnee County",2,49,33,16,17
050,31,133,"Nebraska","Pawnee County",2,50,30,15,15
050,31,133,"Nebraska","Pawnee County",2,51,27,14,13
050,31,133,"Nebraska","Pawnee County",2,52,29,15,14
050,31,133,"Nebraska","Pawnee County",2,53,33,15,18
050,31,133,"Nebraska","Pawnee County",2,54,32,19,13
050,31,133,"Nebraska","Pawnee County",2,55,25,13,12
050,31,133,"Nebraska","Pawnee County",2,56,29,12,17
050,31,133,"Nebraska","Pawnee County",2,57,37,19,18
050,31,133,"Nebraska","Pawnee County",2,58,36,17,19
050,31,133,"Nebraska","Pawnee County",2,59,38,15,23
050,31,133,"Nebraska","Pawnee County",2,60,40,20,20
050,31,133,"Nebraska","Pawnee County",2,61,42,22,20
050,31,133,"Nebraska","Pawnee County",2,62,38,20,18
050,31,133,"Nebraska","Pawnee County",2,63,40,21,19
050,31,133,"Nebraska","Pawnee County",2,64,38,22,16
050,31,133,"Nebraska","Pawnee County",2,65,40,21,19
050,31,133,"Nebraska","Pawnee County",2,66,36,20,16
050,31,133,"Nebraska","Pawnee County",2,67,40,22,18
050,31,133,"Nebraska","Pawnee County",2,68,43,23,20
050,31,133,"Nebraska","Pawnee County",2,69,38,20,18
050,31,133,"Nebraska","Pawnee County",2,70,30,17,13
050,31,133,"Nebraska","Pawnee County",2,71,32,18,14
050,31,133,"Nebraska","Pawnee County",2,72,36,18,18
050,31,133,"Nebraska","Pawnee County",2,73,50,25,25
050,31,133,"Nebraska","Pawnee County",2,74,29,13,16
050,31,133,"Nebraska","Pawnee County",2,75,26,10,16
050,31,133,"Nebraska","Pawnee County",2,76,31,13,18
050,31,133,"Nebraska","Pawnee County",2,77,33,14,19
050,31,133,"Nebraska","Pawnee County",2,78,21,11,10
050,31,133,"Nebraska","Pawnee County",2,79,19,9,10
050,31,133,"Nebraska","Pawnee County",2,80,18,8,10
050,31,133,"Nebraska","Pawnee County",2,81,17,7,10
050,31,133,"Nebraska","Pawnee County",2,82,20,8,12
050,31,133,"Nebraska","Pawnee County",2,83,20,8,12
050,31,133,"Nebraska","Pawnee County",2,84,21,10,11
050,31,133,"Nebraska","Pawnee County",2,85,129,48,81
050,31,133,"Nebraska","Pawnee County",3,0,30,15,15
050,31,133,"Nebraska","Pawnee County",3,1,36,23,13
050,31,133,"Nebraska","Pawnee County",3,2,35,16,19
050,31,133,"Nebraska","Pawnee County",3,3,28,15,13
050,31,133,"Nebraska","Pawnee County",3,4,39,19,20
050,31,133,"Nebraska","Pawnee County",3,5,40,21,19
050,31,133,"Nebraska","Pawnee County",3,6,29,16,13
050,31,133,"Nebraska","Pawnee County",3,7,28,15,13
050,31,133,"Nebraska","Pawnee County",3,8,32,17,15
050,31,133,"Nebraska","Pawnee County",3,9,34,18,16
050,31,133,"Nebraska","Pawnee County",3,10,30,19,11
050,31,133,"Nebraska","Pawnee County",3,11,30,15,15
050,31,133,"Nebraska","Pawnee County",3,12,33,19,14
050,31,133,"Nebraska","Pawnee County",3,13,31,18,13
050,31,133,"Nebraska","Pawnee County",3,14,29,13,16
050,31,133,"Nebraska","Pawnee County",3,15,32,14,18
050,31,133,"Nebraska","Pawnee County",3,16,32,16,16
050,31,133,"Nebraska","Pawnee County",3,17,26,18,8
050,31,133,"Nebraska","Pawnee County",3,18,24,13,11
050,31,133,"Nebraska","Pawnee County",3,19,19,9,10
050,31,133,"Nebraska","Pawnee County",3,20,21,10,11
050,31,133,"Nebraska","Pawnee County",3,21,25,11,14
050,31,133,"Nebraska","Pawnee County",3,22,29,12,17
050,31,133,"Nebraska","Pawnee County",3,23,25,9,16
050,31,133,"Nebraska","Pawnee County",3,24,25,15,10
050,31,133,"Nebraska","Pawnee County",3,25,18,7,11
050,31,133,"Nebraska","Pawnee County",3,26,20,12,8
050,31,133,"Nebraska","Pawnee County",3,27,24,13,11
050,31,133,"Nebraska","Pawnee County",3,28,22,12,10
050,31,133,"Nebraska","Pawnee County",3,29,29,13,16
050,31,133,"Nebraska","Pawnee County",3,30,26,12,14
050,31,133,"Nebraska","Pawnee County",3,31,24,12,12
050,31,133,"Nebraska","Pawnee County",3,32,22,11,11
050,31,133,"Nebraska","Pawnee County",3,33,15,6,9
050,31,133,"Nebraska","Pawnee County",3,34,18,7,11
050,31,133,"Nebraska","Pawnee County",3,35,21,10,11
050,31,133,"Nebraska","Pawnee County",3,36,28,11,17
050,31,133,"Nebraska","Pawnee County",3,37,24,14,10
050,31,133,"Nebraska","Pawnee County",3,38,27,15,12
050,31,133,"Nebraska","Pawnee County",3,39,19,11,8
050,31,133,"Nebraska","Pawnee County",3,40,28,18,10
050,31,133,"Nebraska","Pawnee County",3,41,27,12,15
050,31,133,"Nebraska","Pawnee County",3,42,28,10,18
050,31,133,"Nebraska","Pawnee County",3,43,26,13,13
050,31,133,"Nebraska","Pawnee County",3,44,21,11,10
050,31,133,"Nebraska","Pawnee County",3,45,16,6,10
050,31,133,"Nebraska","Pawnee County",3,46,18,9,9
050,31,133,"Nebraska","Pawnee County",3,47,23,9,14
050,31,133,"Nebraska","Pawnee County",3,48,19,10,9
050,31,133,"Nebraska","Pawnee County",3,49,27,13,14
050,31,133,"Nebraska","Pawnee County",3,50,32,17,15
050,31,133,"Nebraska","Pawnee County",3,51,29,14,15
050,31,133,"Nebraska","Pawnee County",3,52,25,12,13
050,31,133,"Nebraska","Pawnee County",3,53,30,16,14
050,31,133,"Nebraska","Pawnee County",3,54,33,14,19
050,31,133,"Nebraska","Pawnee County",3,55,32,19,13
050,31,133,"Nebraska","Pawnee County",3,56,30,13,17
050,31,133,"Nebraska","Pawnee County",3,57,27,13,14
050,31,133,"Nebraska","Pawnee County",3,58,36,18,18
050,31,133,"Nebraska","Pawnee County",3,59,37,18,19
050,31,133,"Nebraska","Pawnee County",3,60,38,16,22
050,31,133,"Nebraska","Pawnee County",3,61,39,19,20
050,31,133,"Nebraska","Pawnee County",3,62,41,21,20
050,31,133,"Nebraska","Pawnee County",3,63,35,18,17
050,31,133,"Nebraska","Pawnee County",3,64,39,21,18
050,31,133,"Nebraska","Pawnee County",3,65,37,21,16
050,31,133,"Nebraska","Pawnee County",3,66,39,20,19
050,31,133,"Nebraska","Pawnee County",3,67,36,20,16
050,31,133,"Nebraska","Pawnee County",3,68,41,22,19
050,31,133,"Nebraska","Pawnee County",3,69,41,22,19
050,31,133,"Nebraska","Pawnee County",3,70,35,19,16
050,31,133,"Nebraska","Pawnee County",3,71,30,16,14
050,31,133,"Nebraska","Pawnee County",3,72,33,20,13
050,31,133,"Nebraska","Pawnee County",3,73,34,16,18
050,31,133,"Nebraska","Pawnee County",3,74,48,24,24
050,31,133,"Nebraska","Pawnee County",3,75,28,12,16
050,31,133,"Nebraska","Pawnee County",3,76,27,10,17
050,31,133,"Nebraska","Pawnee County",3,77,32,12,20
050,31,133,"Nebraska","Pawnee County",3,78,30,14,16
050,31,133,"Nebraska","Pawnee County",3,79,22,11,11
050,31,133,"Nebraska","Pawnee County",3,80,16,9,7
050,31,133,"Nebraska","Pawnee County",3,81,17,7,10
050,31,133,"Nebraska","Pawnee County",3,82,16,6,10
050,31,133,"Nebraska","Pawnee County",3,83,18,7,11
050,31,133,"Nebraska","Pawnee County",3,84,18,8,10
050,31,133,"Nebraska","Pawnee County",3,85,125,48,77
050,31,133,"Nebraska","Pawnee County",4,0,33,22,11
050,31,133,"Nebraska","Pawnee County",4,1,32,15,17
050,31,133,"Nebraska","Pawnee County",4,2,34,19,15
050,31,133,"Nebraska","Pawnee County",4,3,33,14,19
050,31,133,"Nebraska","Pawnee County",4,4,26,14,12
050,31,133,"Nebraska","Pawnee County",4,5,37,21,16
050,31,133,"Nebraska","Pawnee County",4,6,40,17,23
050,31,133,"Nebraska","Pawnee County",4,7,30,16,14
050,31,133,"Nebraska","Pawnee County",4,8,30,14,16
050,31,133,"Nebraska","Pawnee County",4,9,32,17,15
050,31,133,"Nebraska","Pawnee County",4,10,32,19,13
050,31,133,"Nebraska","Pawnee County",4,11,29,17,12
050,31,133,"Nebraska","Pawnee County",4,12,33,15,18
050,31,133,"Nebraska","Pawnee County",4,13,36,22,14
050,31,133,"Nebraska","Pawnee County",4,14,29,15,14
050,31,133,"Nebraska","Pawnee County",4,15,32,15,17
050,31,133,"Nebraska","Pawnee County",4,16,29,12,17
050,31,133,"Nebraska","Pawnee County",4,17,32,16,16
050,31,133,"Nebraska","Pawnee County",4,18,23,16,7
050,31,133,"Nebraska","Pawnee County",4,19,19,11,8
050,31,133,"Nebraska","Pawnee County",4,20,22,11,11
050,31,133,"Nebraska","Pawnee County",4,21,18,10,8
050,31,133,"Nebraska","Pawnee County",4,22,21,12,9
050,31,133,"Nebraska","Pawnee County",4,23,27,10,17
050,31,133,"Nebraska","Pawnee County",4,24,23,10,13
050,31,133,"Nebraska","Pawnee County",4,25,23,12,11
050,31,133,"Nebraska","Pawnee County",4,26,17,6,11
050,31,133,"Nebraska","Pawnee County",4,27,19,12,7
050,31,133,"Nebraska","Pawnee County",4,28,27,13,14
050,31,133,"Nebraska","Pawnee County",4,29,22,12,10
050,31,133,"Nebraska","Pawnee County",4,30,28,14,14
050,31,133,"Nebraska","Pawnee County",4,31,24,13,11
050,31,133,"Nebraska","Pawnee County",4,32,26,13,13
050,31,133,"Nebraska","Pawnee County",4,33,22,11,11
050,31,133,"Nebraska","Pawnee County",4,34,17,6,11
050,31,133,"Nebraska","Pawnee County",4,35,20,8,12
050,31,133,"Nebraska","Pawnee County",4,36,21,10,11
050,31,133,"Nebraska","Pawnee County",4,37,32,14,18
050,31,133,"Nebraska","Pawnee County",4,38,26,15,11
050,31,133,"Nebraska","Pawnee County",4,39,28,16,12
050,31,133,"Nebraska","Pawnee County",4,40,23,14,9
050,31,133,"Nebraska","Pawnee County",4,41,22,14,8
050,31,133,"Nebraska","Pawnee County",4,42,24,9,15
050,31,133,"Nebraska","Pawnee County",4,43,29,11,18
050,31,133,"Nebraska","Pawnee County",4,44,27,12,15
050,31,133,"Nebraska","Pawnee County",4,45,21,11,10
050,31,133,"Nebraska","Pawnee County",4,46,19,6,13
050,31,133,"Nebraska","Pawnee County",4,47,19,10,9
050,31,133,"Nebraska","Pawnee County",4,48,20,7,13
050,31,133,"Nebraska","Pawnee County",4,49,20,11,9
050,31,133,"Nebraska","Pawnee County",4,50,22,10,12
050,31,133,"Nebraska","Pawnee County",4,51,33,17,16
050,31,133,"Nebraska","Pawnee County",4,52,28,14,14
050,31,133,"Nebraska","Pawnee County",4,53,26,13,13
050,31,133,"Nebraska","Pawnee County",4,54,31,18,13
050,31,133,"Nebraska","Pawnee County",4,55,34,14,20
050,31,133,"Nebraska","Pawnee County",4,56,33,19,14
050,31,133,"Nebraska","Pawnee County",4,57,30,15,15
050,31,133,"Nebraska","Pawnee County",4,58,27,12,15
050,31,133,"Nebraska","Pawnee County",4,59,36,19,17
050,31,133,"Nebraska","Pawnee County",4,60,37,18,19
050,31,133,"Nebraska","Pawnee County",4,61,42,18,24
050,31,133,"Nebraska","Pawnee County",4,62,36,18,18
050,31,133,"Nebraska","Pawnee County",4,63,41,21,20
050,31,133,"Nebraska","Pawnee County",4,64,34,18,16
050,31,133,"Nebraska","Pawnee County",4,65,40,19,21
050,31,133,"Nebraska","Pawnee County",4,66,38,21,17
050,31,133,"Nebraska","Pawnee County",4,67,40,21,19
050,31,133,"Nebraska","Pawnee County",4,68,36,20,16
050,31,133,"Nebraska","Pawnee County",4,69,40,21,19
050,31,133,"Nebraska","Pawnee County",4,70,39,22,17
050,31,133,"Nebraska","Pawnee County",4,71,38,21,17
050,31,133,"Nebraska","Pawnee County",4,72,28,15,13
050,31,133,"Nebraska","Pawnee County",4,73,32,19,13
050,31,133,"Nebraska","Pawnee County",4,74,32,15,17
050,31,133,"Nebraska","Pawnee County",4,75,47,22,25
050,31,133,"Nebraska","Pawnee County",4,76,27,12,15
050,31,133,"Nebraska","Pawnee County",4,77,27,8,19
050,31,133,"Nebraska","Pawnee County",4,78,30,14,16
050,31,133,"Nebraska","Pawnee County",4,79,26,12,14
050,31,133,"Nebraska","Pawnee County",4,80,20,10,10
050,31,133,"Nebraska","Pawnee County",4,81,16,9,7
050,31,133,"Nebraska","Pawnee County",4,82,18,8,10
050,31,133,"Nebraska","Pawnee County",4,83,13,4,9
050,31,133,"Nebraska","Pawnee County",4,84,17,8,9
050,31,133,"Nebraska","Pawnee County",4,85,129,48,81
050,31,133,"Nebraska","Pawnee County",5,0,31,20,11
050,31,133,"Nebraska","Pawnee County",5,1,30,24,6
050,31,133,"Nebraska","Pawnee County",5,2,29,15,14
050,31,133,"Nebraska","Pawnee County",5,3,33,16,17
050,31,133,"Nebraska","Pawnee County",5,4,34,15,19
050,31,133,"Nebraska","Pawnee County",5,5,27,14,13
050,31,133,"Nebraska","Pawnee County",5,6,38,22,16
050,31,133,"Nebraska","Pawnee County",5,7,34,18,16
050,31,133,"Nebraska","Pawnee County",5,8,32,15,17
050,31,133,"Nebraska","Pawnee County",5,9,26,12,14
050,31,133,"Nebraska","Pawnee County",5,10,37,19,18
050,31,133,"Nebraska","Pawnee County",5,11,33,20,13
050,31,133,"Nebraska","Pawnee County",5,12,32,20,12
050,31,133,"Nebraska","Pawnee County",5,13,31,14,17
050,31,133,"Nebraska","Pawnee County",5,14,34,19,15
050,31,133,"Nebraska","Pawnee County",5,15,30,17,13
050,31,133,"Nebraska","Pawnee County",5,16,35,14,21
050,31,133,"Nebraska","Pawnee County",5,17,33,15,18
050,31,133,"Nebraska","Pawnee County",5,18,28,14,14
050,31,133,"Nebraska","Pawnee County",5,19,19,13,6
050,31,133,"Nebraska","Pawnee County",5,20,18,7,11
050,31,133,"Nebraska","Pawnee County",5,21,23,10,13
050,31,133,"Nebraska","Pawnee County",5,22,22,13,9
050,31,133,"Nebraska","Pawnee County",5,23,21,12,9
050,31,133,"Nebraska","Pawnee County",5,24,24,8,16
050,31,133,"Nebraska","Pawnee County",5,25,27,13,14
050,31,133,"Nebraska","Pawnee County",5,26,20,12,8
050,31,133,"Nebraska","Pawnee County",5,27,15,5,10
050,31,133,"Nebraska","Pawnee County",5,28,17,10,7
050,31,133,"Nebraska","Pawnee County",5,29,28,13,15
050,31,133,"Nebraska","Pawnee County",5,30,21,13,8
050,31,133,"Nebraska","Pawnee County",5,31,27,13,14
050,31,133,"Nebraska","Pawnee County",5,32,24,12,12
050,31,133,"Nebraska","Pawnee County",5,33,28,15,13
050,31,133,"Nebraska","Pawnee County",5,34,21,11,10
050,31,133,"Nebraska","Pawnee County",5,35,16,5,11
050,31,133,"Nebraska","Pawnee County",5,36,21,10,11
050,31,133,"Nebraska","Pawnee County",5,37,23,11,12
050,31,133,"Nebraska","Pawnee County",5,38,29,13,16
050,31,133,"Nebraska","Pawnee County",5,39,25,15,10
050,31,133,"Nebraska","Pawnee County",5,40,26,14,12
050,31,133,"Nebraska","Pawnee County",5,41,20,13,7
050,31,133,"Nebraska","Pawnee County",5,42,23,14,9
050,31,133,"Nebraska","Pawnee County",5,43,25,9,16
050,31,133,"Nebraska","Pawnee County",5,44,26,9,17
050,31,133,"Nebraska","Pawnee County",5,45,31,13,18
050,31,133,"Nebraska","Pawnee County",5,46,21,11,10
050,31,133,"Nebraska","Pawnee County",5,47,16,6,10
050,31,133,"Nebraska","Pawnee County",5,48,18,8,10
050,31,133,"Nebraska","Pawnee County",5,49,20,8,12
050,31,133,"Nebraska","Pawnee County",5,50,22,12,10
050,31,133,"Nebraska","Pawnee County",5,51,23,11,12
050,31,133,"Nebraska","Pawnee County",5,52,34,15,19
050,31,133,"Nebraska","Pawnee County",5,53,28,14,14
050,31,133,"Nebraska","Pawnee County",5,54,26,12,14
050,31,133,"Nebraska","Pawnee County",5,55,31,18,13
050,31,133,"Nebraska","Pawnee County",5,56,34,14,20
050,31,133,"Nebraska","Pawnee County",5,57,32,19,13
050,31,133,"Nebraska","Pawnee County",5,58,30,16,14
050,31,133,"Nebraska","Pawnee County",5,59,26,12,14
050,31,133,"Nebraska","Pawnee County",5,60,35,19,16
050,31,133,"Nebraska","Pawnee County",5,61,39,18,21
050,31,133,"Nebraska","Pawnee County",5,62,40,17,23
050,31,133,"Nebraska","Pawnee County",5,63,36,18,18
050,31,133,"Nebraska","Pawnee County",5,64,42,23,19
050,31,133,"Nebraska","Pawnee County",5,65,32,17,15
050,31,133,"Nebraska","Pawnee County",5,66,42,20,22
050,31,133,"Nebraska","Pawnee County",5,67,40,21,19
050,31,133,"Nebraska","Pawnee County",5,68,40,20,20
050,31,133,"Nebraska","Pawnee County",5,69,36,20,16
050,31,133,"Nebraska","Pawnee County",5,70,39,21,18
050,31,133,"Nebraska","Pawnee County",5,71,40,22,18
050,31,133,"Nebraska","Pawnee County",5,72,35,19,16
050,31,133,"Nebraska","Pawnee County",5,73,27,14,13
050,31,133,"Nebraska","Pawnee County",5,74,30,18,12
050,31,133,"Nebraska","Pawnee County",5,75,31,14,17
050,31,133,"Nebraska","Pawnee County",5,76,47,22,25
050,31,133,"Nebraska","Pawnee County",5,77,25,9,16
050,31,133,"Nebraska","Pawnee County",5,78,24,8,16
050,31,133,"Nebraska","Pawnee County",5,79,27,12,15
050,31,133,"Nebraska","Pawnee County",5,80,25,11,14
050,31,133,"Nebraska","Pawnee County",5,81,20,10,10
050,31,133,"Nebraska","Pawnee County",5,82,16,9,7
050,31,133,"Nebraska","Pawnee County",5,83,15,7,8
050,31,133,"Nebraska","Pawnee County",5,84,12,5,7
050,31,133,"Nebraska","Pawnee County",5,85,129,49,80
050,31,135,"Nebraska","Perkins County",1,0,29,15,14
050,31,135,"Nebraska","Perkins County",1,1,31,14,17
050,31,135,"Nebraska","Perkins County",1,2,37,20,17
050,31,135,"Nebraska","Perkins County",1,3,35,19,16
050,31,135,"Nebraska","Perkins County",1,4,44,23,21
050,31,135,"Nebraska","Perkins County",1,5,41,21,20
050,31,135,"Nebraska","Perkins County",1,6,42,24,18
050,31,135,"Nebraska","Perkins County",1,7,40,21,19
050,31,135,"Nebraska","Perkins County",1,8,36,17,19
050,31,135,"Nebraska","Perkins County",1,9,39,18,21
050,31,135,"Nebraska","Perkins County",1,10,33,17,16
050,31,135,"Nebraska","Perkins County",1,11,38,21,17
050,31,135,"Nebraska","Perkins County",1,12,52,25,27
050,31,135,"Nebraska","Perkins County",1,13,49,25,24
050,31,135,"Nebraska","Perkins County",1,14,36,22,14
050,31,135,"Nebraska","Perkins County",1,15,42,16,26
050,31,135,"Nebraska","Perkins County",1,16,46,23,23
050,31,135,"Nebraska","Perkins County",1,17,40,25,15
050,31,135,"Nebraska","Perkins County",1,18,30,19,11
050,31,135,"Nebraska","Perkins County",1,19,30,21,9
050,31,135,"Nebraska","Perkins County",1,20,28,19,9
050,31,135,"Nebraska","Perkins County",1,21,24,16,8
050,31,135,"Nebraska","Perkins County",1,22,27,11,16
050,31,135,"Nebraska","Perkins County",1,23,30,16,14
050,31,135,"Nebraska","Perkins County",1,24,30,17,13
050,31,135,"Nebraska","Perkins County",1,25,29,17,12
050,31,135,"Nebraska","Perkins County",1,26,27,18,9
050,31,135,"Nebraska","Perkins County",1,27,27,12,15
050,31,135,"Nebraska","Perkins County",1,28,22,14,8
050,31,135,"Nebraska","Perkins County",1,29,20,8,12
050,31,135,"Nebraska","Perkins County",1,30,19,7,12
050,31,135,"Nebraska","Perkins County",1,31,27,15,12
050,31,135,"Nebraska","Perkins County",1,32,26,13,13
050,31,135,"Nebraska","Perkins County",1,33,26,13,13
050,31,135,"Nebraska","Perkins County",1,34,43,23,20
050,31,135,"Nebraska","Perkins County",1,35,42,21,21
050,31,135,"Nebraska","Perkins County",1,36,35,20,15
050,31,135,"Nebraska","Perkins County",1,37,33,20,13
050,31,135,"Nebraska","Perkins County",1,38,35,20,15
050,31,135,"Nebraska","Perkins County",1,39,39,18,21
050,31,135,"Nebraska","Perkins County",1,40,34,19,15
050,31,135,"Nebraska","Perkins County",1,41,36,20,16
050,31,135,"Nebraska","Perkins County",1,42,34,19,15
050,31,135,"Nebraska","Perkins County",1,43,38,21,17
050,31,135,"Nebraska","Perkins County",1,44,32,18,14
050,31,135,"Nebraska","Perkins County",1,45,38,18,20
050,31,135,"Nebraska","Perkins County",1,46,32,15,17
050,31,135,"Nebraska","Perkins County",1,47,28,13,15
050,31,135,"Nebraska","Perkins County",1,48,28,14,14
050,31,135,"Nebraska","Perkins County",1,49,28,12,16
050,31,135,"Nebraska","Perkins County",1,50,22,11,11
050,31,135,"Nebraska","Perkins County",1,51,27,15,12
050,31,135,"Nebraska","Perkins County",1,52,26,15,11
050,31,135,"Nebraska","Perkins County",1,53,25,10,15
050,31,135,"Nebraska","Perkins County",1,54,30,15,15
050,31,135,"Nebraska","Perkins County",1,55,29,18,11
050,31,135,"Nebraska","Perkins County",1,56,30,13,17
050,31,135,"Nebraska","Perkins County",1,57,32,14,18
050,31,135,"Nebraska","Perkins County",1,58,43,22,21
050,31,135,"Nebraska","Perkins County",1,59,44,24,20
050,31,135,"Nebraska","Perkins County",1,60,45,22,23
050,31,135,"Nebraska","Perkins County",1,61,40,20,20
050,31,135,"Nebraska","Perkins County",1,62,37,17,20
050,31,135,"Nebraska","Perkins County",1,63,45,19,26
050,31,135,"Nebraska","Perkins County",1,64,36,17,19
050,31,135,"Nebraska","Perkins County",1,65,38,19,19
050,31,135,"Nebraska","Perkins County",1,66,41,25,16
050,31,135,"Nebraska","Perkins County",1,67,45,25,20
050,31,135,"Nebraska","Perkins County",1,68,41,23,18
050,31,135,"Nebraska","Perkins County",1,69,39,21,18
050,31,135,"Nebraska","Perkins County",1,70,38,21,17
050,31,135,"Nebraska","Perkins County",1,71,39,21,18
050,31,135,"Nebraska","Perkins County",1,72,28,11,17
050,31,135,"Nebraska","Perkins County",1,73,37,15,22
050,31,135,"Nebraska","Perkins County",1,74,26,13,13
050,31,135,"Nebraska","Perkins County",1,75,24,15,9
050,31,135,"Nebraska","Perkins County",1,76,21,10,11
050,31,135,"Nebraska","Perkins County",1,77,24,11,13
050,31,135,"Nebraska","Perkins County",1,78,16,7,9
050,31,135,"Nebraska","Perkins County",1,79,13,7,6
050,31,135,"Nebraska","Perkins County",1,80,17,10,7
050,31,135,"Nebraska","Perkins County",1,81,15,8,7
050,31,135,"Nebraska","Perkins County",1,82,18,6,12
050,31,135,"Nebraska","Perkins County",1,83,20,8,12
050,31,135,"Nebraska","Perkins County",1,84,18,8,10
050,31,135,"Nebraska","Perkins County",1,85,100,37,63
050,31,135,"Nebraska","Perkins County",2,0,30,13,17
050,31,135,"Nebraska","Perkins County",2,1,30,14,16
050,31,135,"Nebraska","Perkins County",2,2,35,18,17
050,31,135,"Nebraska","Perkins County",2,3,36,19,17
050,31,135,"Nebraska","Perkins County",2,4,42,22,20
050,31,135,"Nebraska","Perkins County",2,5,42,22,20
050,31,135,"Nebraska","Perkins County",2,6,41,23,18
050,31,135,"Nebraska","Perkins County",2,7,41,22,19
050,31,135,"Nebraska","Perkins County",2,8,36,17,19
050,31,135,"Nebraska","Perkins County",2,9,37,17,20
050,31,135,"Nebraska","Perkins County",2,10,32,16,16
050,31,135,"Nebraska","Perkins County",2,11,37,20,17
050,31,135,"Nebraska","Perkins County",2,12,50,25,25
050,31,135,"Nebraska","Perkins County",2,13,51,25,26
050,31,135,"Nebraska","Perkins County",2,14,39,22,17
050,31,135,"Nebraska","Perkins County",2,15,41,17,24
050,31,135,"Nebraska","Perkins County",2,16,45,21,24
050,31,135,"Nebraska","Perkins County",2,17,42,25,17
050,31,135,"Nebraska","Perkins County",2,18,32,20,12
050,31,135,"Nebraska","Perkins County",2,19,29,20,9
050,31,135,"Nebraska","Perkins County",2,20,27,19,8
050,31,135,"Nebraska","Perkins County",2,21,24,16,8
050,31,135,"Nebraska","Perkins County",2,22,27,13,14
050,31,135,"Nebraska","Perkins County",2,23,29,15,14
050,31,135,"Nebraska","Perkins County",2,24,30,17,13
050,31,135,"Nebraska","Perkins County",2,25,30,18,12
050,31,135,"Nebraska","Perkins County",2,26,26,17,9
050,31,135,"Nebraska","Perkins County",2,27,26,13,13
050,31,135,"Nebraska","Perkins County",2,28,23,13,10
050,31,135,"Nebraska","Perkins County",2,29,21,9,12
050,31,135,"Nebraska","Perkins County",2,30,20,8,12
050,31,135,"Nebraska","Perkins County",2,31,25,13,12
050,31,135,"Nebraska","Perkins County",2,32,25,13,12
050,31,135,"Nebraska","Perkins County",2,33,26,13,13
050,31,135,"Nebraska","Perkins County",2,34,39,20,19
050,31,135,"Nebraska","Perkins County",2,35,42,22,20
050,31,135,"Nebraska","Perkins County",2,36,36,20,16
050,31,135,"Nebraska","Perkins County",2,37,34,20,14
050,31,135,"Nebraska","Perkins County",2,38,36,21,15
050,31,135,"Nebraska","Perkins County",2,39,38,19,19
050,31,135,"Nebraska","Perkins County",2,40,35,18,17
050,31,135,"Nebraska","Perkins County",2,41,36,20,16
050,31,135,"Nebraska","Perkins County",2,42,35,19,16
050,31,135,"Nebraska","Perkins County",2,43,37,21,16
050,31,135,"Nebraska","Perkins County",2,44,34,19,15
050,31,135,"Nebraska","Perkins County",2,45,37,18,19
050,31,135,"Nebraska","Perkins County",2,46,34,16,18
050,31,135,"Nebraska","Perkins County",2,47,29,13,16
050,31,135,"Nebraska","Perkins County",2,48,28,13,15
050,31,135,"Nebraska","Perkins County",2,49,29,13,16
050,31,135,"Nebraska","Perkins County",2,50,24,11,13
050,31,135,"Nebraska","Perkins County",2,51,26,14,12
050,31,135,"Nebraska","Perkins County",2,52,26,15,11
050,31,135,"Nebraska","Perkins County",2,53,25,11,14
050,31,135,"Nebraska","Perkins County",2,54,29,14,15
050,31,135,"Nebraska","Perkins County",2,55,28,16,12
050,31,135,"Nebraska","Perkins County",2,56,30,14,16
050,31,135,"Nebraska","Perkins County",2,57,32,14,18
050,31,135,"Nebraska","Perkins County",2,58,40,20,20
050,31,135,"Nebraska","Perkins County",2,59,43,24,19
050,31,135,"Nebraska","Perkins County",2,60,45,22,23
050,31,135,"Nebraska","Perkins County",2,61,41,20,21
050,31,135,"Nebraska","Perkins County",2,62,38,18,20
050,31,135,"Nebraska","Perkins County",2,63,44,19,25
050,31,135,"Nebraska","Perkins County",2,64,38,17,21
050,31,135,"Nebraska","Perkins County",2,65,38,19,19
050,31,135,"Nebraska","Perkins County",2,66,40,23,17
050,31,135,"Nebraska","Perkins County",2,67,43,25,18
050,31,135,"Nebraska","Perkins County",2,68,41,23,18
050,31,135,"Nebraska","Perkins County",2,69,39,21,18
050,31,135,"Nebraska","Perkins County",2,70,38,21,17
050,31,135,"Nebraska","Perkins County",2,71,39,21,18
050,31,135,"Nebraska","Perkins County",2,72,31,14,17
050,31,135,"Nebraska","Perkins County",2,73,37,15,22
050,31,135,"Nebraska","Perkins County",2,74,27,12,15
050,31,135,"Nebraska","Perkins County",2,75,25,15,10
050,31,135,"Nebraska","Perkins County",2,76,21,11,10
050,31,135,"Nebraska","Perkins County",2,77,24,11,13
050,31,135,"Nebraska","Perkins County",2,78,18,8,10
050,31,135,"Nebraska","Perkins County",2,79,14,7,7
050,31,135,"Nebraska","Perkins County",2,80,16,9,7
050,31,135,"Nebraska","Perkins County",2,81,16,9,7
050,31,135,"Nebraska","Perkins County",2,82,17,6,11
050,31,135,"Nebraska","Perkins County",2,83,19,7,12
050,31,135,"Nebraska","Perkins County",2,84,18,8,10
050,31,135,"Nebraska","Perkins County",2,85,102,37,65
050,31,135,"Nebraska","Perkins County",3,0,30,22,8
050,31,135,"Nebraska","Perkins County",3,1,29,13,16
050,31,135,"Nebraska","Perkins County",3,2,34,17,17
050,31,135,"Nebraska","Perkins County",3,3,34,17,17
050,31,135,"Nebraska","Perkins County",3,4,39,21,18
050,31,135,"Nebraska","Perkins County",3,5,40,20,20
050,31,135,"Nebraska","Perkins County",3,6,42,24,18
050,31,135,"Nebraska","Perkins County",3,7,41,22,19
050,31,135,"Nebraska","Perkins County",3,8,40,18,22
050,31,135,"Nebraska","Perkins County",3,9,35,18,17
050,31,135,"Nebraska","Perkins County",3,10,37,18,19
050,31,135,"Nebraska","Perkins County",3,11,27,12,15
050,31,135,"Nebraska","Perkins County",3,12,41,21,20
050,31,135,"Nebraska","Perkins County",3,13,48,24,24
050,31,135,"Nebraska","Perkins County",3,14,49,26,23
050,31,135,"Nebraska","Perkins County",3,15,37,19,18
050,31,135,"Nebraska","Perkins County",3,16,37,16,21
050,31,135,"Nebraska","Perkins County",3,17,43,20,23
050,31,135,"Nebraska","Perkins County",3,18,36,22,14
050,31,135,"Nebraska","Perkins County",3,19,29,17,12
050,31,135,"Nebraska","Perkins County",3,20,31,20,11
050,31,135,"Nebraska","Perkins County",3,21,23,14,9
050,31,135,"Nebraska","Perkins County",3,22,29,20,9
050,31,135,"Nebraska","Perkins County",3,23,34,16,18
050,31,135,"Nebraska","Perkins County",3,24,31,16,15
050,31,135,"Nebraska","Perkins County",3,25,23,14,9
050,31,135,"Nebraska","Perkins County",3,26,27,14,13
050,31,135,"Nebraska","Perkins County",3,27,24,15,9
050,31,135,"Nebraska","Perkins County",3,28,26,12,14
050,31,135,"Nebraska","Perkins County",3,29,26,16,10
050,31,135,"Nebraska","Perkins County",3,30,20,9,11
050,31,135,"Nebraska","Perkins County",3,31,23,10,13
050,31,135,"Nebraska","Perkins County",3,32,21,11,10
050,31,135,"Nebraska","Perkins County",3,33,25,13,12
050,31,135,"Nebraska","Perkins County",3,34,27,14,13
050,31,135,"Nebraska","Perkins County",3,35,41,21,20
050,31,135,"Nebraska","Perkins County",3,36,40,22,18
050,31,135,"Nebraska","Perkins County",3,37,34,19,15
050,31,135,"Nebraska","Perkins County",3,38,32,19,13
050,31,135,"Nebraska","Perkins County",3,39,38,22,16
050,31,135,"Nebraska","Perkins County",3,40,39,21,18
050,31,135,"Nebraska","Perkins County",3,41,34,18,16
050,31,135,"Nebraska","Perkins County",3,42,33,16,17
050,31,135,"Nebraska","Perkins County",3,43,34,17,17
050,31,135,"Nebraska","Perkins County",3,44,34,19,15
050,31,135,"Nebraska","Perkins County",3,45,33,19,14
050,31,135,"Nebraska","Perkins County",3,46,37,18,19
050,31,135,"Nebraska","Perkins County",3,47,33,16,17
050,31,135,"Nebraska","Perkins County",3,48,27,13,14
050,31,135,"Nebraska","Perkins County",3,49,26,13,13
050,31,135,"Nebraska","Perkins County",3,50,29,13,16
050,31,135,"Nebraska","Perkins County",3,51,25,12,13
050,31,135,"Nebraska","Perkins County",3,52,25,13,12
050,31,135,"Nebraska","Perkins County",3,53,31,16,15
050,31,135,"Nebraska","Perkins County",3,54,24,11,13
050,31,135,"Nebraska","Perkins County",3,55,28,13,15
050,31,135,"Nebraska","Perkins County",3,56,28,16,12
050,31,135,"Nebraska","Perkins County",3,57,28,12,16
050,31,135,"Nebraska","Perkins County",3,58,32,14,18
050,31,135,"Nebraska","Perkins County",3,59,40,20,20
050,31,135,"Nebraska","Perkins County",3,60,41,23,18
050,31,135,"Nebraska","Perkins County",3,61,47,22,25
050,31,135,"Nebraska","Perkins County",3,62,41,20,21
050,31,135,"Nebraska","Perkins County",3,63,37,17,20
050,31,135,"Nebraska","Perkins County",3,64,43,18,25
050,31,135,"Nebraska","Perkins County",3,65,37,16,21
050,31,135,"Nebraska","Perkins County",3,66,36,18,18
050,31,135,"Nebraska","Perkins County",3,67,39,22,17
050,31,135,"Nebraska","Perkins County",3,68,42,24,18
050,31,135,"Nebraska","Perkins County",3,69,40,23,17
050,31,135,"Nebraska","Perkins County",3,70,40,22,18
050,31,135,"Nebraska","Perkins County",3,71,36,19,17
050,31,135,"Nebraska","Perkins County",3,72,39,21,18
050,31,135,"Nebraska","Perkins County",3,73,32,15,17
050,31,135,"Nebraska","Perkins County",3,74,40,16,24
050,31,135,"Nebraska","Perkins County",3,75,26,13,13
050,31,135,"Nebraska","Perkins County",3,76,23,15,8
050,31,135,"Nebraska","Perkins County",3,77,23,11,12
050,31,135,"Nebraska","Perkins County",3,78,24,10,14
050,31,135,"Nebraska","Perkins County",3,79,19,9,10
050,31,135,"Nebraska","Perkins County",3,80,13,6,7
050,31,135,"Nebraska","Perkins County",3,81,17,10,7
050,31,135,"Nebraska","Perkins County",3,82,16,8,8
050,31,135,"Nebraska","Perkins County",3,83,13,4,9
050,31,135,"Nebraska","Perkins County",3,84,18,8,10
050,31,135,"Nebraska","Perkins County",3,85,94,36,58
050,31,135,"Nebraska","Perkins County",4,0,24,16,8
050,31,135,"Nebraska","Perkins County",4,1,28,22,6
050,31,135,"Nebraska","Perkins County",4,2,34,14,20
050,31,135,"Nebraska","Perkins County",4,3,36,19,17
050,31,135,"Nebraska","Perkins County",4,4,33,17,16
050,31,135,"Nebraska","Perkins County",4,5,44,25,19
050,31,135,"Nebraska","Perkins County",4,6,40,22,18
050,31,135,"Nebraska","Perkins County",4,7,42,22,20
050,31,135,"Nebraska","Perkins County",4,8,39,19,20
050,31,135,"Nebraska","Perkins County",4,9,38,18,20
050,31,135,"Nebraska","Perkins County",4,10,35,19,16
050,31,135,"Nebraska","Perkins County",4,11,37,18,19
050,31,135,"Nebraska","Perkins County",4,12,31,12,19
050,31,135,"Nebraska","Perkins County",4,13,37,17,20
050,31,135,"Nebraska","Perkins County",4,14,54,27,27
050,31,135,"Nebraska","Perkins County",4,15,48,25,23
050,31,135,"Nebraska","Perkins County",4,16,37,19,18
050,31,135,"Nebraska","Perkins County",4,17,36,16,20
050,31,135,"Nebraska","Perkins County",4,18,39,20,19
050,31,135,"Nebraska","Perkins County",4,19,27,16,11
050,31,135,"Nebraska","Perkins County",4,20,28,17,11
050,31,135,"Nebraska","Perkins County",4,21,28,19,9
050,31,135,"Nebraska","Perkins County",4,22,26,15,11
050,31,135,"Nebraska","Perkins County",4,23,24,15,9
050,31,135,"Nebraska","Perkins County",4,24,27,11,16
050,31,135,"Nebraska","Perkins County",4,25,34,16,18
050,31,135,"Nebraska","Perkins County",4,26,27,18,9
050,31,135,"Nebraska","Perkins County",4,27,28,15,13
050,31,135,"Nebraska","Perkins County",4,28,28,14,14
050,31,135,"Nebraska","Perkins County",4,29,24,12,12
050,31,135,"Nebraska","Perkins County",4,30,28,15,13
050,31,135,"Nebraska","Perkins County",4,31,24,13,11
050,31,135,"Nebraska","Perkins County",4,32,22,11,11
050,31,135,"Nebraska","Perkins County",4,33,25,13,12
050,31,135,"Nebraska","Perkins County",4,34,25,13,12
050,31,135,"Nebraska","Perkins County",4,35,28,13,15
050,31,135,"Nebraska","Perkins County",4,36,42,22,20
050,31,135,"Nebraska","Perkins County",4,37,42,24,18
050,31,135,"Nebraska","Perkins County",4,38,33,17,16
050,31,135,"Nebraska","Perkins County",4,39,32,19,13
050,31,135,"Nebraska","Perkins County",4,40,38,21,17
050,31,135,"Nebraska","Perkins County",4,41,41,23,18
050,31,135,"Nebraska","Perkins County",4,42,35,19,16
050,31,135,"Nebraska","Perkins County",4,43,32,15,17
050,31,135,"Nebraska","Perkins County",4,44,34,17,17
050,31,135,"Nebraska","Perkins County",4,45,33,19,14
050,31,135,"Nebraska","Perkins County",4,46,34,19,15
050,31,135,"Nebraska","Perkins County",4,47,37,18,19
050,31,135,"Nebraska","Perkins County",4,48,34,16,18
050,31,135,"Nebraska","Perkins County",4,49,28,14,14
050,31,135,"Nebraska","Perkins County",4,50,26,12,14
050,31,135,"Nebraska","Perkins County",4,51,29,13,16
050,31,135,"Nebraska","Perkins County",4,52,26,14,12
050,31,135,"Nebraska","Perkins County",4,53,28,18,10
050,31,135,"Nebraska","Perkins County",4,54,31,15,16
050,31,135,"Nebraska","Perkins County",4,55,25,11,14
050,31,135,"Nebraska","Perkins County",4,56,28,12,16
050,31,135,"Nebraska","Perkins County",4,57,28,16,12
050,31,135,"Nebraska","Perkins County",4,58,29,13,16
050,31,135,"Nebraska","Perkins County",4,59,31,14,17
050,31,135,"Nebraska","Perkins County",4,60,39,20,19
050,31,135,"Nebraska","Perkins County",4,61,42,24,18
050,31,135,"Nebraska","Perkins County",4,62,45,20,25
050,31,135,"Nebraska","Perkins County",4,63,41,20,21
050,31,135,"Nebraska","Perkins County",4,64,37,16,21
050,31,135,"Nebraska","Perkins County",4,65,42,17,25
050,31,135,"Nebraska","Perkins County",4,66,39,16,23
050,31,135,"Nebraska","Perkins County",4,67,38,19,19
050,31,135,"Nebraska","Perkins County",4,68,38,22,16
050,31,135,"Nebraska","Perkins County",4,69,43,24,19
050,31,135,"Nebraska","Perkins County",4,70,39,21,18
050,31,135,"Nebraska","Perkins County",4,71,40,22,18
050,31,135,"Nebraska","Perkins County",4,72,35,19,16
050,31,135,"Nebraska","Perkins County",4,73,38,20,18
050,31,135,"Nebraska","Perkins County",4,74,33,16,17
050,31,135,"Nebraska","Perkins County",4,75,38,16,22
050,31,135,"Nebraska","Perkins County",4,76,23,11,12
050,31,135,"Nebraska","Perkins County",4,77,21,14,7
050,31,135,"Nebraska","Perkins County",4,78,23,11,12
050,31,135,"Nebraska","Perkins County",4,79,25,11,14
050,31,135,"Nebraska","Perkins County",4,80,17,8,9
050,31,135,"Nebraska","Perkins County",4,81,12,7,5
050,31,135,"Nebraska","Perkins County",4,82,20,9,11
050,31,135,"Nebraska","Perkins County",4,83,14,7,7
050,31,135,"Nebraska","Perkins County",4,84,10,5,5
050,31,135,"Nebraska","Perkins County",4,85,94,35,59
050,31,135,"Nebraska","Perkins County",5,0,24,17,7
050,31,135,"Nebraska","Perkins County",5,1,22,15,7
050,31,135,"Nebraska","Perkins County",5,2,29,25,4
050,31,135,"Nebraska","Perkins County",5,3,32,14,18
050,31,135,"Nebraska","Perkins County",5,4,35,17,18
050,31,135,"Nebraska","Perkins County",5,5,35,19,16
050,31,135,"Nebraska","Perkins County",5,6,45,23,22
050,31,135,"Nebraska","Perkins County",5,7,40,22,18
050,31,135,"Nebraska","Perkins County",5,8,42,23,19
050,31,135,"Nebraska","Perkins County",5,9,39,18,21
050,31,135,"Nebraska","Perkins County",5,10,41,19,22
050,31,135,"Nebraska","Perkins County",5,11,37,21,16
050,31,135,"Nebraska","Perkins County",5,12,37,18,19
050,31,135,"Nebraska","Perkins County",5,13,33,13,20
050,31,135,"Nebraska","Perkins County",5,14,39,17,22
050,31,135,"Nebraska","Perkins County",5,15,52,27,25
050,31,135,"Nebraska","Perkins County",5,16,49,26,23
050,31,135,"Nebraska","Perkins County",5,17,34,17,17
050,31,135,"Nebraska","Perkins County",5,18,28,13,15
050,31,135,"Nebraska","Perkins County",5,19,28,15,13
050,31,135,"Nebraska","Perkins County",5,20,23,13,10
050,31,135,"Nebraska","Perkins County",5,21,30,18,12
050,31,135,"Nebraska","Perkins County",5,22,28,19,9
050,31,135,"Nebraska","Perkins County",5,23,29,16,13
050,31,135,"Nebraska","Perkins County",5,24,21,12,9
050,31,135,"Nebraska","Perkins County",5,25,29,11,18
050,31,135,"Nebraska","Perkins County",5,26,41,25,16
050,31,135,"Nebraska","Perkins County",5,27,27,16,11
050,31,135,"Nebraska","Perkins County",5,28,30,16,14
050,31,135,"Nebraska","Perkins County",5,29,29,16,13
050,31,135,"Nebraska","Perkins County",5,30,26,14,12
050,31,135,"Nebraska","Perkins County",5,31,31,16,15
050,31,135,"Nebraska","Perkins County",5,32,25,14,11
050,31,135,"Nebraska","Perkins County",5,33,24,14,10
050,31,135,"Nebraska","Perkins County",5,34,22,13,9
050,31,135,"Nebraska","Perkins County",5,35,25,10,15
050,31,135,"Nebraska","Perkins County",5,36,27,13,14
050,31,135,"Nebraska","Perkins County",5,37,42,23,19
050,31,135,"Nebraska","Perkins County",5,38,44,25,19
050,31,135,"Nebraska","Perkins County",5,39,33,16,17
050,31,135,"Nebraska","Perkins County",5,40,33,20,13
050,31,135,"Nebraska","Perkins County",5,41,38,19,19
050,31,135,"Nebraska","Perkins County",5,42,41,23,18
050,31,135,"Nebraska","Perkins County",5,43,36,20,16
050,31,135,"Nebraska","Perkins County",5,44,33,16,17
050,31,135,"Nebraska","Perkins County",5,45,35,17,18
050,31,135,"Nebraska","Perkins County",5,46,35,18,17
050,31,135,"Nebraska","Perkins County",5,47,32,18,14
050,31,135,"Nebraska","Perkins County",5,48,33,16,17
050,31,135,"Nebraska","Perkins County",5,49,36,18,18
050,31,135,"Nebraska","Perkins County",5,50,28,14,14
050,31,135,"Nebraska","Perkins County",5,51,25,13,12
050,31,135,"Nebraska","Perkins County",5,52,29,13,16
050,31,135,"Nebraska","Perkins County",5,53,31,19,12
050,31,135,"Nebraska","Perkins County",5,54,23,13,10
050,31,135,"Nebraska","Perkins County",5,55,31,15,16
050,31,135,"Nebraska","Perkins County",5,56,23,10,13
050,31,135,"Nebraska","Perkins County",5,57,28,13,15
050,31,135,"Nebraska","Perkins County",5,58,28,16,12
050,31,135,"Nebraska","Perkins County",5,59,27,13,14
050,31,135,"Nebraska","Perkins County",5,60,31,14,17
050,31,135,"Nebraska","Perkins County",5,61,37,20,17
050,31,135,"Nebraska","Perkins County",5,62,44,23,21
050,31,135,"Nebraska","Perkins County",5,63,45,22,23
050,31,135,"Nebraska","Perkins County",5,64,41,20,21
050,31,135,"Nebraska","Perkins County",5,65,38,17,21
050,31,135,"Nebraska","Perkins County",5,66,43,17,26
050,31,135,"Nebraska","Perkins County",5,67,40,15,25
050,31,135,"Nebraska","Perkins County",5,68,36,19,17
050,31,135,"Nebraska","Perkins County",5,69,39,23,16
050,31,135,"Nebraska","Perkins County",5,70,39,22,17
050,31,135,"Nebraska","Perkins County",5,71,38,20,18
050,31,135,"Nebraska","Perkins County",5,72,39,22,17
050,31,135,"Nebraska","Perkins County",5,73,35,18,17
050,31,135,"Nebraska","Perkins County",5,74,36,19,17
050,31,135,"Nebraska","Perkins County",5,75,30,15,15
050,31,135,"Nebraska","Perkins County",5,76,35,14,21
050,31,135,"Nebraska","Perkins County",5,77,21,9,12
050,31,135,"Nebraska","Perkins County",5,78,20,14,6
050,31,135,"Nebraska","Perkins County",5,79,22,12,10
050,31,135,"Nebraska","Perkins County",5,80,24,10,14
050,31,135,"Nebraska","Perkins County",5,81,15,8,7
050,31,135,"Nebraska","Perkins County",5,82,9,3,6
050,31,135,"Nebraska","Perkins County",5,83,17,8,9
050,31,135,"Nebraska","Perkins County",5,84,9,7,2
050,31,135,"Nebraska","Perkins County",5,85,80,29,51
050,31,137,"Nebraska","Phelps County",1,0,116,59,57
050,31,137,"Nebraska","Phelps County",1,1,120,54,66
050,31,137,"Nebraska","Phelps County",1,2,115,53,62
050,31,137,"Nebraska","Phelps County",1,3,116,60,56
050,31,137,"Nebraska","Phelps County",1,4,115,64,51
050,31,137,"Nebraska","Phelps County",1,5,114,59,55
050,31,137,"Nebraska","Phelps County",1,6,113,58,55
050,31,137,"Nebraska","Phelps County",1,7,123,67,56
050,31,137,"Nebraska","Phelps County",1,8,122,70,52
050,31,137,"Nebraska","Phelps County",1,9,119,58,61
050,31,137,"Nebraska","Phelps County",1,10,133,72,61
050,31,137,"Nebraska","Phelps County",1,11,138,72,66
050,31,137,"Nebraska","Phelps County",1,12,121,69,52
050,31,137,"Nebraska","Phelps County",1,13,125,72,53
050,31,137,"Nebraska","Phelps County",1,14,130,70,60
050,31,137,"Nebraska","Phelps County",1,15,122,59,63
050,31,137,"Nebraska","Phelps County",1,16,129,67,62
050,31,137,"Nebraska","Phelps County",1,17,126,65,61
050,31,137,"Nebraska","Phelps County",1,18,111,60,51
050,31,137,"Nebraska","Phelps County",1,19,97,52,45
050,31,137,"Nebraska","Phelps County",1,20,87,42,45
050,31,137,"Nebraska","Phelps County",1,21,99,49,50
050,31,137,"Nebraska","Phelps County",1,22,90,46,44
050,31,137,"Nebraska","Phelps County",1,23,86,49,37
050,31,137,"Nebraska","Phelps County",1,24,90,47,43
050,31,137,"Nebraska","Phelps County",1,25,104,51,53
050,31,137,"Nebraska","Phelps County",1,26,103,56,47
050,31,137,"Nebraska","Phelps County",1,27,100,55,45
050,31,137,"Nebraska","Phelps County",1,28,105,51,54
050,31,137,"Nebraska","Phelps County",1,29,103,59,44
050,31,137,"Nebraska","Phelps County",1,30,100,53,47
050,31,137,"Nebraska","Phelps County",1,31,88,44,44
050,31,137,"Nebraska","Phelps County",1,32,96,51,45
050,31,137,"Nebraska","Phelps County",1,33,112,62,50
050,31,137,"Nebraska","Phelps County",1,34,106,49,57
050,31,137,"Nebraska","Phelps County",1,35,107,57,50
050,31,137,"Nebraska","Phelps County",1,36,100,50,50
050,31,137,"Nebraska","Phelps County",1,37,105,58,47
050,31,137,"Nebraska","Phelps County",1,38,112,69,43
050,31,137,"Nebraska","Phelps County",1,39,113,62,51
050,31,137,"Nebraska","Phelps County",1,40,105,50,55
050,31,137,"Nebraska","Phelps County",1,41,89,48,41
050,31,137,"Nebraska","Phelps County",1,42,94,37,57
050,31,137,"Nebraska","Phelps County",1,43,85,46,39
050,31,137,"Nebraska","Phelps County",1,44,87,48,39
050,31,137,"Nebraska","Phelps County",1,45,83,44,39
050,31,137,"Nebraska","Phelps County",1,46,92,39,53
050,31,137,"Nebraska","Phelps County",1,47,97,52,45
050,31,137,"Nebraska","Phelps County",1,48,111,59,52
050,31,137,"Nebraska","Phelps County",1,49,108,56,52
050,31,137,"Nebraska","Phelps County",1,50,105,55,50
050,31,137,"Nebraska","Phelps County",1,51,97,51,46
050,31,137,"Nebraska","Phelps County",1,52,104,54,50
050,31,137,"Nebraska","Phelps County",1,53,95,45,50
050,31,137,"Nebraska","Phelps County",1,54,108,54,54
050,31,137,"Nebraska","Phelps County",1,55,131,63,68
050,31,137,"Nebraska","Phelps County",1,56,136,68,68
050,31,137,"Nebraska","Phelps County",1,57,134,71,63
050,31,137,"Nebraska","Phelps County",1,58,128,62,66
050,31,137,"Nebraska","Phelps County",1,59,141,73,68
050,31,137,"Nebraska","Phelps County",1,60,132,62,70
050,31,137,"Nebraska","Phelps County",1,61,132,70,62
050,31,137,"Nebraska","Phelps County",1,62,116,66,50
050,31,137,"Nebraska","Phelps County",1,63,98,51,47
050,31,137,"Nebraska","Phelps County",1,64,104,57,47
050,31,137,"Nebraska","Phelps County",1,65,108,59,49
050,31,137,"Nebraska","Phelps County",1,66,103,57,46
050,31,137,"Nebraska","Phelps County",1,67,105,56,49
050,31,137,"Nebraska","Phelps County",1,68,102,52,50
050,31,137,"Nebraska","Phelps County",1,69,80,37,43
050,31,137,"Nebraska","Phelps County",1,70,85,35,50
050,31,137,"Nebraska","Phelps County",1,71,90,44,46
050,31,137,"Nebraska","Phelps County",1,72,89,40,49
050,31,137,"Nebraska","Phelps County",1,73,92,42,50
050,31,137,"Nebraska","Phelps County",1,74,71,35,36
050,31,137,"Nebraska","Phelps County",1,75,67,29,38
050,31,137,"Nebraska","Phelps County",1,76,65,30,35
050,31,137,"Nebraska","Phelps County",1,77,69,26,43
050,31,137,"Nebraska","Phelps County",1,78,58,27,31
050,31,137,"Nebraska","Phelps County",1,79,62,30,32
050,31,137,"Nebraska","Phelps County",1,80,66,30,36
050,31,137,"Nebraska","Phelps County",1,81,64,32,32
050,31,137,"Nebraska","Phelps County",1,82,44,17,27
050,31,137,"Nebraska","Phelps County",1,83,55,17,38
050,31,137,"Nebraska","Phelps County",1,84,59,23,36
050,31,137,"Nebraska","Phelps County",1,85,314,98,216
050,31,137,"Nebraska","Phelps County",2,0,115,61,54
050,31,137,"Nebraska","Phelps County",2,1,119,55,64
050,31,137,"Nebraska","Phelps County",2,2,117,52,65
050,31,137,"Nebraska","Phelps County",2,3,117,58,59
050,31,137,"Nebraska","Phelps County",2,4,115,63,52
050,31,137,"Nebraska","Phelps County",2,5,116,62,54
050,31,137,"Nebraska","Phelps County",2,6,113,59,54
050,31,137,"Nebraska","Phelps County",2,7,119,64,55
050,31,137,"Nebraska","Phelps County",2,8,123,70,53
050,31,137,"Nebraska","Phelps County",2,9,121,61,60
050,31,137,"Nebraska","Phelps County",2,10,131,69,62
050,31,137,"Nebraska","Phelps County",2,11,138,72,66
050,31,137,"Nebraska","Phelps County",2,12,126,70,56
050,31,137,"Nebraska","Phelps County",2,13,125,72,53
050,31,137,"Nebraska","Phelps County",2,14,129,71,58
050,31,137,"Nebraska","Phelps County",2,15,125,62,63
050,31,137,"Nebraska","Phelps County",2,16,128,65,63
050,31,137,"Nebraska","Phelps County",2,17,128,67,61
050,31,137,"Nebraska","Phelps County",2,18,109,59,50
050,31,137,"Nebraska","Phelps County",2,19,94,51,43
050,31,137,"Nebraska","Phelps County",2,20,91,45,46
050,31,137,"Nebraska","Phelps County",2,21,96,47,49
050,31,137,"Nebraska","Phelps County",2,22,93,47,46
050,31,137,"Nebraska","Phelps County",2,23,87,48,39
050,31,137,"Nebraska","Phelps County",2,24,89,48,41
050,31,137,"Nebraska","Phelps County",2,25,104,52,52
050,31,137,"Nebraska","Phelps County",2,26,103,55,48
050,31,137,"Nebraska","Phelps County",2,27,103,58,45
050,31,137,"Nebraska","Phelps County",2,28,105,53,52
050,31,137,"Nebraska","Phelps County",2,29,104,58,46
050,31,137,"Nebraska","Phelps County",2,30,100,54,46
050,31,137,"Nebraska","Phelps County",2,31,90,46,44
050,31,137,"Nebraska","Phelps County",2,32,96,50,46
050,31,137,"Nebraska","Phelps County",2,33,108,59,49
050,31,137,"Nebraska","Phelps County",2,34,107,51,56
050,31,137,"Nebraska","Phelps County",2,35,108,57,51
050,31,137,"Nebraska","Phelps County",2,36,101,51,50
050,31,137,"Nebraska","Phelps County",2,37,104,57,47
050,31,137,"Nebraska","Phelps County",2,38,111,66,45
050,31,137,"Nebraska","Phelps County",2,39,115,65,50
050,31,137,"Nebraska","Phelps County",2,40,108,53,55
050,31,137,"Nebraska","Phelps County",2,41,92,48,44
050,31,137,"Nebraska","Phelps County",2,42,90,38,52
050,31,137,"Nebraska","Phelps County",2,43,87,44,43
050,31,137,"Nebraska","Phelps County",2,44,86,47,39
050,31,137,"Nebraska","Phelps County",2,45,86,46,40
050,31,137,"Nebraska","Phelps County",2,46,88,40,48
050,31,137,"Nebraska","Phelps County",2,47,94,48,46
050,31,137,"Nebraska","Phelps County",2,48,106,56,50
050,31,137,"Nebraska","Phelps County",2,49,109,56,53
050,31,137,"Nebraska","Phelps County",2,50,107,56,51
050,31,137,"Nebraska","Phelps County",2,51,97,51,46
050,31,137,"Nebraska","Phelps County",2,52,102,54,48
050,31,137,"Nebraska","Phelps County",2,53,96,47,49
050,31,137,"Nebraska","Phelps County",2,54,104,52,52
050,31,137,"Nebraska","Phelps County",2,55,124,59,65
050,31,137,"Nebraska","Phelps County",2,56,136,67,69
050,31,137,"Nebraska","Phelps County",2,57,133,69,64
050,31,137,"Nebraska","Phelps County",2,58,130,65,65
050,31,137,"Nebraska","Phelps County",2,59,136,69,67
050,31,137,"Nebraska","Phelps County",2,60,134,65,69
050,31,137,"Nebraska","Phelps County",2,61,132,68,64
050,31,137,"Nebraska","Phelps County",2,62,119,66,53
050,31,137,"Nebraska","Phelps County",2,63,104,56,48
050,31,137,"Nebraska","Phelps County",2,64,102,55,47
050,31,137,"Nebraska","Phelps County",2,65,107,58,49
050,31,137,"Nebraska","Phelps County",2,66,103,57,46
050,31,137,"Nebraska","Phelps County",2,67,105,57,48
050,31,137,"Nebraska","Phelps County",2,68,101,52,49
050,31,137,"Nebraska","Phelps County",2,69,86,41,45
050,31,137,"Nebraska","Phelps County",2,70,84,35,49
050,31,137,"Nebraska","Phelps County",2,71,88,42,46
050,31,137,"Nebraska","Phelps County",2,72,89,41,48
050,31,137,"Nebraska","Phelps County",2,73,95,44,51
050,31,137,"Nebraska","Phelps County",2,74,73,35,38
050,31,137,"Nebraska","Phelps County",2,75,68,30,38
050,31,137,"Nebraska","Phelps County",2,76,66,30,36
050,31,137,"Nebraska","Phelps County",2,77,69,28,41
050,31,137,"Nebraska","Phelps County",2,78,59,27,32
050,31,137,"Nebraska","Phelps County",2,79,60,28,32
050,31,137,"Nebraska","Phelps County",2,80,67,31,36
050,31,137,"Nebraska","Phelps County",2,81,60,29,31
050,31,137,"Nebraska","Phelps County",2,82,48,21,27
050,31,137,"Nebraska","Phelps County",2,83,54,17,37
050,31,137,"Nebraska","Phelps County",2,84,58,21,37
050,31,137,"Nebraska","Phelps County",2,85,314,97,217
050,31,137,"Nebraska","Phelps County",3,0,106,53,53
050,31,137,"Nebraska","Phelps County",3,1,133,71,62
050,31,137,"Nebraska","Phelps County",3,2,133,67,66
050,31,137,"Nebraska","Phelps County",3,3,117,51,66
050,31,137,"Nebraska","Phelps County",3,4,119,61,58
050,31,137,"Nebraska","Phelps County",3,5,120,64,56
050,31,137,"Nebraska","Phelps County",3,6,117,60,57
050,31,137,"Nebraska","Phelps County",3,7,107,52,55
050,31,137,"Nebraska","Phelps County",3,8,118,63,55
050,31,137,"Nebraska","Phelps County",3,9,134,76,58
050,31,137,"Nebraska","Phelps County",3,10,119,59,60
050,31,137,"Nebraska","Phelps County",3,11,130,72,58
050,31,137,"Nebraska","Phelps County",3,12,134,72,62
050,31,137,"Nebraska","Phelps County",3,13,131,72,59
050,31,137,"Nebraska","Phelps County",3,14,116,67,49
050,31,137,"Nebraska","Phelps County",3,15,124,68,56
050,31,137,"Nebraska","Phelps County",3,16,122,58,64
050,31,137,"Nebraska","Phelps County",3,17,125,64,61
050,31,137,"Nebraska","Phelps County",3,18,105,55,50
050,31,137,"Nebraska","Phelps County",3,19,89,48,41
050,31,137,"Nebraska","Phelps County",3,20,103,50,53
050,31,137,"Nebraska","Phelps County",3,21,92,49,43
050,31,137,"Nebraska","Phelps County",3,22,109,53,56
050,31,137,"Nebraska","Phelps County",3,23,90,47,43
050,31,137,"Nebraska","Phelps County",3,24,90,51,39
050,31,137,"Nebraska","Phelps County",3,25,86,46,40
050,31,137,"Nebraska","Phelps County",3,26,97,48,49
050,31,137,"Nebraska","Phelps County",3,27,104,54,50
050,31,137,"Nebraska","Phelps County",3,28,103,57,46
050,31,137,"Nebraska","Phelps County",3,29,111,55,56
050,31,137,"Nebraska","Phelps County",3,30,109,61,48
050,31,137,"Nebraska","Phelps County",3,31,104,57,47
050,31,137,"Nebraska","Phelps County",3,32,101,49,52
050,31,137,"Nebraska","Phelps County",3,33,102,51,51
050,31,137,"Nebraska","Phelps County",3,34,110,59,51
050,31,137,"Nebraska","Phelps County",3,35,102,50,52
050,31,137,"Nebraska","Phelps County",3,36,107,57,50
050,31,137,"Nebraska","Phelps County",3,37,104,52,52
050,31,137,"Nebraska","Phelps County",3,38,103,60,43
050,31,137,"Nebraska","Phelps County",3,39,105,64,41
050,31,137,"Nebraska","Phelps County",3,40,115,66,49
050,31,137,"Nebraska","Phelps County",3,41,105,46,59
050,31,137,"Nebraska","Phelps County",3,42,94,49,45
050,31,137,"Nebraska","Phelps County",3,43,92,40,52
050,31,137,"Nebraska","Phelps County",3,44,90,44,46
050,31,137,"Nebraska","Phelps County",3,45,87,49,38
050,31,137,"Nebraska","Phelps County",3,46,94,48,46
050,31,137,"Nebraska","Phelps County",3,47,84,38,46
050,31,137,"Nebraska","Phelps County",3,48,90,45,45
050,31,137,"Nebraska","Phelps County",3,49,107,54,53
050,31,137,"Nebraska","Phelps County",3,50,111,60,51
050,31,137,"Nebraska","Phelps County",3,51,107,56,51
050,31,137,"Nebraska","Phelps County",3,52,99,52,47
050,31,137,"Nebraska","Phelps County",3,53,102,53,49
050,31,137,"Nebraska","Phelps County",3,54,89,42,47
050,31,137,"Nebraska","Phelps County",3,55,99,49,50
050,31,137,"Nebraska","Phelps County",3,56,131,61,70
050,31,137,"Nebraska","Phelps County",3,57,129,64,65
050,31,137,"Nebraska","Phelps County",3,58,128,65,63
050,31,137,"Nebraska","Phelps County",3,59,129,65,64
050,31,137,"Nebraska","Phelps County",3,60,136,70,66
050,31,137,"Nebraska","Phelps County",3,61,126,58,68
050,31,137,"Nebraska","Phelps County",3,62,132,68,64
050,31,137,"Nebraska","Phelps County",3,63,115,67,48
050,31,137,"Nebraska","Phelps County",3,64,105,55,50
050,31,137,"Nebraska","Phelps County",3,65,93,50,43
050,31,137,"Nebraska","Phelps County",3,66,101,55,46
050,31,137,"Nebraska","Phelps County",3,67,100,54,46
050,31,137,"Nebraska","Phelps County",3,68,102,54,48
050,31,137,"Nebraska","Phelps County",3,69,98,52,46
050,31,137,"Nebraska","Phelps County",3,70,84,38,46
050,31,137,"Nebraska","Phelps County",3,71,79,31,48
050,31,137,"Nebraska","Phelps County",3,72,84,38,46
050,31,137,"Nebraska","Phelps County",3,73,83,41,42
050,31,137,"Nebraska","Phelps County",3,74,93,43,50
050,31,137,"Nebraska","Phelps County",3,75,66,30,36
050,31,137,"Nebraska","Phelps County",3,76,68,31,37
050,31,137,"Nebraska","Phelps County",3,77,57,24,33
050,31,137,"Nebraska","Phelps County",3,78,67,29,38
050,31,137,"Nebraska","Phelps County",3,79,52,20,32
050,31,137,"Nebraska","Phelps County",3,80,67,32,35
050,31,137,"Nebraska","Phelps County",3,81,52,22,30
050,31,137,"Nebraska","Phelps County",3,82,50,26,24
050,31,137,"Nebraska","Phelps County",3,83,55,23,32
050,31,137,"Nebraska","Phelps County",3,84,49,14,35
050,31,137,"Nebraska","Phelps County",3,85,296,92,204
050,31,137,"Nebraska","Phelps County",4,0,116,54,62
050,31,137,"Nebraska","Phelps County",4,1,104,53,51
050,31,137,"Nebraska","Phelps County",4,2,139,77,62
050,31,137,"Nebraska","Phelps County",4,3,131,65,66
050,31,137,"Nebraska","Phelps County",4,4,124,60,64
050,31,137,"Nebraska","Phelps County",4,5,125,62,63
050,31,137,"Nebraska","Phelps County",4,6,125,70,55
050,31,137,"Nebraska","Phelps County",4,7,118,61,57
050,31,137,"Nebraska","Phelps County",4,8,111,54,57
050,31,137,"Nebraska","Phelps County",4,9,123,65,58
050,31,137,"Nebraska","Phelps County",4,10,134,72,62
050,31,137,"Nebraska","Phelps County",4,11,120,61,59
050,31,137,"Nebraska","Phelps County",4,12,126,68,58
050,31,137,"Nebraska","Phelps County",4,13,133,71,62
050,31,137,"Nebraska","Phelps County",4,14,126,72,54
050,31,137,"Nebraska","Phelps County",4,15,115,67,48
050,31,137,"Nebraska","Phelps County",4,16,120,65,55
050,31,137,"Nebraska","Phelps County",4,17,121,58,63
050,31,137,"Nebraska","Phelps County",4,18,106,60,46
050,31,137,"Nebraska","Phelps County",4,19,78,42,36
050,31,137,"Nebraska","Phelps County",4,20,94,49,45
050,31,137,"Nebraska","Phelps County",4,21,104,52,52
050,31,137,"Nebraska","Phelps County",4,22,99,53,46
050,31,137,"Nebraska","Phelps County",4,23,107,56,51
050,31,137,"Nebraska","Phelps County",4,24,102,51,51
050,31,137,"Nebraska","Phelps County",4,25,88,48,40
050,31,137,"Nebraska","Phelps County",4,26,103,56,47
050,31,137,"Nebraska","Phelps County",4,27,101,51,50
050,31,137,"Nebraska","Phelps County",4,28,112,53,59
050,31,137,"Nebraska","Phelps County",4,29,107,56,51
050,31,137,"Nebraska","Phelps County",4,30,112,60,52
050,31,137,"Nebraska","Phelps County",4,31,114,59,55
050,31,137,"Nebraska","Phelps County",4,32,114,64,50
050,31,137,"Nebraska","Phelps County",4,33,99,48,51
050,31,137,"Nebraska","Phelps County",4,34,92,43,49
050,31,137,"Nebraska","Phelps County",4,35,111,58,53
050,31,137,"Nebraska","Phelps County",4,36,101,50,51
050,31,137,"Nebraska","Phelps County",4,37,109,59,50
050,31,137,"Nebraska","Phelps County",4,38,109,53,56
050,31,137,"Nebraska","Phelps County",4,39,101,59,42
050,31,137,"Nebraska","Phelps County",4,40,105,67,38
050,31,137,"Nebraska","Phelps County",4,41,117,68,49
050,31,137,"Nebraska","Phelps County",4,42,101,43,58
050,31,137,"Nebraska","Phelps County",4,43,99,53,46
050,31,137,"Nebraska","Phelps County",4,44,97,43,54
050,31,137,"Nebraska","Phelps County",4,45,90,43,47
050,31,137,"Nebraska","Phelps County",4,46,86,47,39
050,31,137,"Nebraska","Phelps County",4,47,95,50,45
050,31,137,"Nebraska","Phelps County",4,48,79,36,43
050,31,137,"Nebraska","Phelps County",4,49,86,46,40
050,31,137,"Nebraska","Phelps County",4,50,108,55,53
050,31,137,"Nebraska","Phelps County",4,51,111,60,51
050,31,137,"Nebraska","Phelps County",4,52,96,51,45
050,31,137,"Nebraska","Phelps County",4,53,101,53,48
050,31,137,"Nebraska","Phelps County",4,54,107,54,53
050,31,137,"Nebraska","Phelps County",4,55,89,43,46
050,31,137,"Nebraska","Phelps County",4,56,99,47,52
050,31,137,"Nebraska","Phelps County",4,57,130,62,68
050,31,137,"Nebraska","Phelps County",4,58,132,67,65
050,31,137,"Nebraska","Phelps County",4,59,133,68,65
050,31,137,"Nebraska","Phelps County",4,60,127,63,64
050,31,137,"Nebraska","Phelps County",4,61,138,72,66
050,31,137,"Nebraska","Phelps County",4,62,128,59,69
050,31,137,"Nebraska","Phelps County",4,63,132,68,64
050,31,137,"Nebraska","Phelps County",4,64,116,67,49
050,31,137,"Nebraska","Phelps County",4,65,105,54,51
050,31,137,"Nebraska","Phelps County",4,66,88,49,39
050,31,137,"Nebraska","Phelps County",4,67,101,56,45
050,31,137,"Nebraska","Phelps County",4,68,102,53,49
050,31,137,"Nebraska","Phelps County",4,69,101,53,48
050,31,137,"Nebraska","Phelps County",4,70,101,50,51
050,31,137,"Nebraska","Phelps County",4,71,84,36,48
050,31,137,"Nebraska","Phelps County",4,72,78,28,50
050,31,137,"Nebraska","Phelps County",4,73,79,39,40
050,31,137,"Nebraska","Phelps County",4,74,80,39,41
050,31,137,"Nebraska","Phelps County",4,75,87,40,47
050,31,137,"Nebraska","Phelps County",4,76,61,28,33
050,31,137,"Nebraska","Phelps County",4,77,60,26,34
050,31,137,"Nebraska","Phelps County",4,78,64,29,35
050,31,137,"Nebraska","Phelps County",4,79,63,25,38
050,31,137,"Nebraska","Phelps County",4,80,60,23,37
050,31,137,"Nebraska","Phelps County",4,81,54,23,31
050,31,137,"Nebraska","Phelps County",4,82,44,20,24
050,31,137,"Nebraska","Phelps County",4,83,51,24,27
050,31,137,"Nebraska","Phelps County",4,84,53,21,32
050,31,137,"Nebraska","Phelps County",4,85,296,89,207
050,31,137,"Nebraska","Phelps County",5,0,117,53,64
050,31,137,"Nebraska","Phelps County",5,1,116,55,61
050,31,137,"Nebraska","Phelps County",5,2,109,57,52
050,31,137,"Nebraska","Phelps County",5,3,144,83,61
050,31,137,"Nebraska","Phelps County",5,4,138,70,68
050,31,137,"Nebraska","Phelps County",5,5,125,56,69
050,31,137,"Nebraska","Phelps County",5,6,129,64,65
050,31,137,"Nebraska","Phelps County",5,7,128,69,59
050,31,137,"Nebraska","Phelps County",5,8,114,63,51
050,31,137,"Nebraska","Phelps County",5,9,112,54,58
050,31,137,"Nebraska","Phelps County",5,10,121,65,56
050,31,137,"Nebraska","Phelps County",5,11,137,76,61
050,31,137,"Nebraska","Phelps County",5,12,122,60,62
050,31,137,"Nebraska","Phelps County",5,13,127,67,60
050,31,137,"Nebraska","Phelps County",5,14,134,74,60
050,31,137,"Nebraska","Phelps County",5,15,129,74,55
050,31,137,"Nebraska","Phelps County",5,16,116,68,48
050,31,137,"Nebraska","Phelps County",5,17,125,68,57
050,31,137,"Nebraska","Phelps County",5,18,102,51,51
050,31,137,"Nebraska","Phelps County",5,19,75,40,35
050,31,137,"Nebraska","Phelps County",5,20,91,43,48
050,31,137,"Nebraska","Phelps County",5,21,98,50,48
050,31,137,"Nebraska","Phelps County",5,22,126,67,59
050,31,137,"Nebraska","Phelps County",5,23,99,55,44
050,31,137,"Nebraska","Phelps County",5,24,104,52,52
050,31,137,"Nebraska","Phelps County",5,25,108,50,58
050,31,137,"Nebraska","Phelps County",5,26,89,51,38
050,31,137,"Nebraska","Phelps County",5,27,114,61,53
050,31,137,"Nebraska","Phelps County",5,28,109,54,55
050,31,137,"Nebraska","Phelps County",5,29,114,53,61
050,31,137,"Nebraska","Phelps County",5,30,113,61,52
050,31,137,"Nebraska","Phelps County",5,31,112,59,53
050,31,137,"Nebraska","Phelps County",5,32,117,60,57
050,31,137,"Nebraska","Phelps County",5,33,110,62,48
050,31,137,"Nebraska","Phelps County",5,34,105,50,55
050,31,137,"Nebraska","Phelps County",5,35,93,44,49
050,31,137,"Nebraska","Phelps County",5,36,108,57,51
050,31,137,"Nebraska","Phelps County",5,37,106,54,52
050,31,137,"Nebraska","Phelps County",5,38,111,60,51
050,31,137,"Nebraska","Phelps County",5,39,107,56,51
050,31,137,"Nebraska","Phelps County",5,40,110,63,47
050,31,137,"Nebraska","Phelps County",5,41,109,71,38
050,31,137,"Nebraska","Phelps County",5,42,118,69,49
050,31,137,"Nebraska","Phelps County",5,43,100,41,59
050,31,137,"Nebraska","Phelps County",5,44,101,55,46
050,31,137,"Nebraska","Phelps County",5,45,95,42,53
050,31,137,"Nebraska","Phelps County",5,46,92,45,47
050,31,137,"Nebraska","Phelps County",5,47,85,45,40
050,31,137,"Nebraska","Phelps County",5,48,93,47,46
050,31,137,"Nebraska","Phelps County",5,49,81,39,42
050,31,137,"Nebraska","Phelps County",5,50,87,45,42
050,31,137,"Nebraska","Phelps County",5,51,109,56,53
050,31,137,"Nebraska","Phelps County",5,52,106,56,50
050,31,137,"Nebraska","Phelps County",5,53,95,51,44
050,31,137,"Nebraska","Phelps County",5,54,106,59,47
050,31,137,"Nebraska","Phelps County",5,55,99,47,52
050,31,137,"Nebraska","Phelps County",5,56,94,47,47
050,31,137,"Nebraska","Phelps County",5,57,101,51,50
050,31,137,"Nebraska","Phelps County",5,58,130,62,68
050,31,137,"Nebraska","Phelps County",5,59,130,64,66
050,31,137,"Nebraska","Phelps County",5,60,126,67,59
050,31,137,"Nebraska","Phelps County",5,61,123,62,61
050,31,137,"Nebraska","Phelps County",5,62,139,72,67
050,31,137,"Nebraska","Phelps County",5,63,132,61,71
050,31,137,"Nebraska","Phelps County",5,64,125,62,63
050,31,137,"Nebraska","Phelps County",5,65,114,64,50
050,31,137,"Nebraska","Phelps County",5,66,100,53,47
050,31,137,"Nebraska","Phelps County",5,67,87,48,39
050,31,137,"Nebraska","Phelps County",5,68,98,54,44
050,31,137,"Nebraska","Phelps County",5,69,99,52,47
050,31,137,"Nebraska","Phelps County",5,70,99,48,51
050,31,137,"Nebraska","Phelps County",5,71,97,48,49
050,31,137,"Nebraska","Phelps County",5,72,81,34,47
050,31,137,"Nebraska","Phelps County",5,73,73,30,43
050,31,137,"Nebraska","Phelps County",5,74,75,39,36
050,31,137,"Nebraska","Phelps County",5,75,78,38,40
050,31,137,"Nebraska","Phelps County",5,76,87,44,43
050,31,137,"Nebraska","Phelps County",5,77,55,23,32
050,31,137,"Nebraska","Phelps County",5,78,60,29,31
050,31,137,"Nebraska","Phelps County",5,79,57,22,35
050,31,137,"Nebraska","Phelps County",5,80,70,29,41
050,31,137,"Nebraska","Phelps County",5,81,48,16,32
050,31,137,"Nebraska","Phelps County",5,82,46,20,26
050,31,137,"Nebraska","Phelps County",5,83,45,19,26
050,31,137,"Nebraska","Phelps County",5,84,50,22,28
050,31,137,"Nebraska","Phelps County",5,85,298,93,205
050,31,139,"Nebraska","Pierce County",1,0,96,50,46
050,31,139,"Nebraska","Pierce County",1,1,95,56,39
050,31,139,"Nebraska","Pierce County",1,2,88,42,46
050,31,139,"Nebraska","Pierce County",1,3,90,41,49
050,31,139,"Nebraska","Pierce County",1,4,102,43,59
050,31,139,"Nebraska","Pierce County",1,5,107,52,55
050,31,139,"Nebraska","Pierce County",1,6,106,53,53
050,31,139,"Nebraska","Pierce County",1,7,106,47,59
050,31,139,"Nebraska","Pierce County",1,8,103,48,55
050,31,139,"Nebraska","Pierce County",1,9,104,56,48
050,31,139,"Nebraska","Pierce County",1,10,108,56,52
050,31,139,"Nebraska","Pierce County",1,11,111,55,56
050,31,139,"Nebraska","Pierce County",1,12,111,50,61
050,31,139,"Nebraska","Pierce County",1,13,101,48,53
050,31,139,"Nebraska","Pierce County",1,14,112,60,52
050,31,139,"Nebraska","Pierce County",1,15,124,65,59
050,31,139,"Nebraska","Pierce County",1,16,111,61,50
050,31,139,"Nebraska","Pierce County",1,17,105,63,42
050,31,139,"Nebraska","Pierce County",1,18,85,40,45
050,31,139,"Nebraska","Pierce County",1,19,67,31,36
050,31,139,"Nebraska","Pierce County",1,20,77,41,36
050,31,139,"Nebraska","Pierce County",1,21,70,40,30
050,31,139,"Nebraska","Pierce County",1,22,71,41,30
050,31,139,"Nebraska","Pierce County",1,23,71,37,34
050,31,139,"Nebraska","Pierce County",1,24,68,39,29
050,31,139,"Nebraska","Pierce County",1,25,79,39,40
050,31,139,"Nebraska","Pierce County",1,26,78,40,38
050,31,139,"Nebraska","Pierce County",1,27,75,41,34
050,31,139,"Nebraska","Pierce County",1,28,76,38,38
050,31,139,"Nebraska","Pierce County",1,29,74,37,37
050,31,139,"Nebraska","Pierce County",1,30,59,34,25
050,31,139,"Nebraska","Pierce County",1,31,73,43,30
050,31,139,"Nebraska","Pierce County",1,32,74,41,33
050,31,139,"Nebraska","Pierce County",1,33,71,36,35
050,31,139,"Nebraska","Pierce County",1,34,80,36,44
050,31,139,"Nebraska","Pierce County",1,35,100,50,50
050,31,139,"Nebraska","Pierce County",1,36,83,48,35
050,31,139,"Nebraska","Pierce County",1,37,99,50,49
050,31,139,"Nebraska","Pierce County",1,38,98,54,44
050,31,139,"Nebraska","Pierce County",1,39,91,53,38
050,31,139,"Nebraska","Pierce County",1,40,95,53,42
050,31,139,"Nebraska","Pierce County",1,41,84,39,45
050,31,139,"Nebraska","Pierce County",1,42,73,36,37
050,31,139,"Nebraska","Pierce County",1,43,74,43,31
050,31,139,"Nebraska","Pierce County",1,44,74,42,32
050,31,139,"Nebraska","Pierce County",1,45,69,32,37
050,31,139,"Nebraska","Pierce County",1,46,76,37,39
050,31,139,"Nebraska","Pierce County",1,47,78,42,36
050,31,139,"Nebraska","Pierce County",1,48,85,39,46
050,31,139,"Nebraska","Pierce County",1,49,80,35,45
050,31,139,"Nebraska","Pierce County",1,50,79,47,32
050,31,139,"Nebraska","Pierce County",1,51,80,43,37
050,31,139,"Nebraska","Pierce County",1,52,89,39,50
050,31,139,"Nebraska","Pierce County",1,53,94,48,46
050,31,139,"Nebraska","Pierce County",1,54,80,42,38
050,31,139,"Nebraska","Pierce County",1,55,94,45,49
050,31,139,"Nebraska","Pierce County",1,56,113,56,57
050,31,139,"Nebraska","Pierce County",1,57,128,63,65
050,31,139,"Nebraska","Pierce County",1,58,118,62,56
050,31,139,"Nebraska","Pierce County",1,59,115,63,52
050,31,139,"Nebraska","Pierce County",1,60,114,63,51
050,31,139,"Nebraska","Pierce County",1,61,113,57,56
050,31,139,"Nebraska","Pierce County",1,62,100,50,50
050,31,139,"Nebraska","Pierce County",1,63,94,50,44
050,31,139,"Nebraska","Pierce County",1,64,105,58,47
050,31,139,"Nebraska","Pierce County",1,65,100,54,46
050,31,139,"Nebraska","Pierce County",1,66,78,43,35
050,31,139,"Nebraska","Pierce County",1,67,86,45,41
050,31,139,"Nebraska","Pierce County",1,68,95,52,43
050,31,139,"Nebraska","Pierce County",1,69,81,43,38
050,31,139,"Nebraska","Pierce County",1,70,66,34,32
050,31,139,"Nebraska","Pierce County",1,71,72,33,39
050,31,139,"Nebraska","Pierce County",1,72,73,34,39
050,31,139,"Nebraska","Pierce County",1,73,67,34,33
050,31,139,"Nebraska","Pierce County",1,74,45,25,20
050,31,139,"Nebraska","Pierce County",1,75,53,25,28
050,31,139,"Nebraska","Pierce County",1,76,60,27,33
050,31,139,"Nebraska","Pierce County",1,77,66,35,31
050,31,139,"Nebraska","Pierce County",1,78,51,26,25
050,31,139,"Nebraska","Pierce County",1,79,40,18,22
050,31,139,"Nebraska","Pierce County",1,80,38,15,23
050,31,139,"Nebraska","Pierce County",1,81,41,18,23
050,31,139,"Nebraska","Pierce County",1,82,36,14,22
050,31,139,"Nebraska","Pierce County",1,83,35,12,23
050,31,139,"Nebraska","Pierce County",1,84,26,10,16
050,31,139,"Nebraska","Pierce County",1,85,207,85,122
050,31,139,"Nebraska","Pierce County",2,0,103,53,50
050,31,139,"Nebraska","Pierce County",2,1,93,53,40
050,31,139,"Nebraska","Pierce County",2,2,90,45,45
050,31,139,"Nebraska","Pierce County",2,3,90,42,48
050,31,139,"Nebraska","Pierce County",2,4,101,43,58
050,31,139,"Nebraska","Pierce County",2,5,105,50,55
050,31,139,"Nebraska","Pierce County",2,6,107,53,54
050,31,139,"Nebraska","Pierce County",2,7,107,48,59
050,31,139,"Nebraska","Pierce County",2,8,105,48,57
050,31,139,"Nebraska","Pierce County",2,9,103,54,49
050,31,139,"Nebraska","Pierce County",2,10,107,56,51
050,31,139,"Nebraska","Pierce County",2,11,110,55,55
050,31,139,"Nebraska","Pierce County",2,12,113,52,61
050,31,139,"Nebraska","Pierce County",2,13,103,48,55
050,31,139,"Nebraska","Pierce County",2,14,110,58,52
050,31,139,"Nebraska","Pierce County",2,15,121,64,57
050,31,139,"Nebraska","Pierce County",2,16,115,64,51
050,31,139,"Nebraska","Pierce County",2,17,107,63,44
050,31,139,"Nebraska","Pierce County",2,18,86,44,42
050,31,139,"Nebraska","Pierce County",2,19,67,31,36
050,31,139,"Nebraska","Pierce County",2,20,77,40,37
050,31,139,"Nebraska","Pierce County",2,21,72,41,31
050,31,139,"Nebraska","Pierce County",2,22,70,40,30
050,31,139,"Nebraska","Pierce County",2,23,71,38,33
050,31,139,"Nebraska","Pierce County",2,24,70,40,30
050,31,139,"Nebraska","Pierce County",2,25,78,39,39
050,31,139,"Nebraska","Pierce County",2,26,78,39,39
050,31,139,"Nebraska","Pierce County",2,27,77,41,36
050,31,139,"Nebraska","Pierce County",2,28,76,38,38
050,31,139,"Nebraska","Pierce County",2,29,74,37,37
050,31,139,"Nebraska","Pierce County",2,30,65,36,29
050,31,139,"Nebraska","Pierce County",2,31,71,41,30
050,31,139,"Nebraska","Pierce County",2,32,74,42,32
050,31,139,"Nebraska","Pierce County",2,33,72,37,35
050,31,139,"Nebraska","Pierce County",2,34,79,36,43
050,31,139,"Nebraska","Pierce County",2,35,96,47,49
050,31,139,"Nebraska","Pierce County",2,36,85,47,38
050,31,139,"Nebraska","Pierce County",2,37,96,50,46
050,31,139,"Nebraska","Pierce County",2,38,100,54,46
050,31,139,"Nebraska","Pierce County",2,39,94,54,40
050,31,139,"Nebraska","Pierce County",2,40,95,54,41
050,31,139,"Nebraska","Pierce County",2,41,87,42,45
050,31,139,"Nebraska","Pierce County",2,42,74,36,38
050,31,139,"Nebraska","Pierce County",2,43,75,42,33
050,31,139,"Nebraska","Pierce County",2,44,73,42,31
050,31,139,"Nebraska","Pierce County",2,45,72,35,37
050,31,139,"Nebraska","Pierce County",2,46,74,36,38
050,31,139,"Nebraska","Pierce County",2,47,77,41,36
050,31,139,"Nebraska","Pierce County",2,48,83,39,44
050,31,139,"Nebraska","Pierce County",2,49,82,36,46
050,31,139,"Nebraska","Pierce County",2,50,78,44,34
050,31,139,"Nebraska","Pierce County",2,51,79,43,36
050,31,139,"Nebraska","Pierce County",2,52,87,41,46
050,31,139,"Nebraska","Pierce County",2,53,94,47,47
050,31,139,"Nebraska","Pierce County",2,54,83,43,40
050,31,139,"Nebraska","Pierce County",2,55,90,45,45
050,31,139,"Nebraska","Pierce County",2,56,108,53,55
050,31,139,"Nebraska","Pierce County",2,57,125,61,64
050,31,139,"Nebraska","Pierce County",2,58,120,62,58
050,31,139,"Nebraska","Pierce County",2,59,117,63,54
050,31,139,"Nebraska","Pierce County",2,60,113,62,51
050,31,139,"Nebraska","Pierce County",2,61,113,58,55
050,31,139,"Nebraska","Pierce County",2,62,103,52,51
050,31,139,"Nebraska","Pierce County",2,63,96,51,45
050,31,139,"Nebraska","Pierce County",2,64,101,55,46
050,31,139,"Nebraska","Pierce County",2,65,101,55,46
050,31,139,"Nebraska","Pierce County",2,66,83,46,37
050,31,139,"Nebraska","Pierce County",2,67,82,43,39
050,31,139,"Nebraska","Pierce County",2,68,91,50,41
050,31,139,"Nebraska","Pierce County",2,69,85,46,39
050,31,139,"Nebraska","Pierce County",2,70,69,36,33
050,31,139,"Nebraska","Pierce County",2,71,71,33,38
050,31,139,"Nebraska","Pierce County",2,72,71,33,38
050,31,139,"Nebraska","Pierce County",2,73,73,36,37
050,31,139,"Nebraska","Pierce County",2,74,46,25,21
050,31,139,"Nebraska","Pierce County",2,75,50,24,26
050,31,139,"Nebraska","Pierce County",2,76,57,26,31
050,31,139,"Nebraska","Pierce County",2,77,66,34,32
050,31,139,"Nebraska","Pierce County",2,78,51,25,26
050,31,139,"Nebraska","Pierce County",2,79,42,20,22
050,31,139,"Nebraska","Pierce County",2,80,39,16,23
050,31,139,"Nebraska","Pierce County",2,81,41,18,23
050,31,139,"Nebraska","Pierce County",2,82,37,14,23
050,31,139,"Nebraska","Pierce County",2,83,36,13,23
050,31,139,"Nebraska","Pierce County",2,84,27,10,17
050,31,139,"Nebraska","Pierce County",2,85,210,86,124
050,31,139,"Nebraska","Pierce County",3,0,94,50,44
050,31,139,"Nebraska","Pierce County",3,1,105,51,54
050,31,139,"Nebraska","Pierce County",3,2,91,48,43
050,31,139,"Nebraska","Pierce County",3,3,94,48,46
050,31,139,"Nebraska","Pierce County",3,4,98,47,51
050,31,139,"Nebraska","Pierce County",3,5,97,43,54
050,31,139,"Nebraska","Pierce County",3,6,108,51,57
050,31,139,"Nebraska","Pierce County",3,7,108,55,53
050,31,139,"Nebraska","Pierce County",3,8,110,50,60
050,31,139,"Nebraska","Pierce County",3,9,100,45,55
050,31,139,"Nebraska","Pierce County",3,10,109,56,53
050,31,139,"Nebraska","Pierce County",3,11,100,54,46
050,31,139,"Nebraska","Pierce County",3,12,106,51,55
050,31,139,"Nebraska","Pierce County",3,13,112,52,60
050,31,139,"Nebraska","Pierce County",3,14,102,48,54
050,31,139,"Nebraska","Pierce County",3,15,111,58,53
050,31,139,"Nebraska","Pierce County",3,16,122,63,59
050,31,139,"Nebraska","Pierce County",3,17,117,65,52
050,31,139,"Nebraska","Pierce County",3,18,89,52,37
050,31,139,"Nebraska","Pierce County",3,19,65,31,34
050,31,139,"Nebraska","Pierce County",3,20,76,33,43
050,31,139,"Nebraska","Pierce County",3,21,77,41,36
050,31,139,"Nebraska","Pierce County",3,22,81,47,34
050,31,139,"Nebraska","Pierce County",3,23,76,47,29
050,31,139,"Nebraska","Pierce County",3,24,66,36,30
050,31,139,"Nebraska","Pierce County",3,25,65,39,26
050,31,139,"Nebraska","Pierce County",3,26,74,31,43
050,31,139,"Nebraska","Pierce County",3,27,81,39,42
050,31,139,"Nebraska","Pierce County",3,28,74,37,37
050,31,139,"Nebraska","Pierce County",3,29,82,44,38
050,31,139,"Nebraska","Pierce County",3,30,79,42,37
050,31,139,"Nebraska","Pierce County",3,31,74,41,33
050,31,139,"Nebraska","Pierce County",3,32,72,42,30
050,31,139,"Nebraska","Pierce County",3,33,74,42,32
050,31,139,"Nebraska","Pierce County",3,34,74,38,36
050,31,139,"Nebraska","Pierce County",3,35,82,37,45
050,31,139,"Nebraska","Pierce County",3,36,99,48,51
050,31,139,"Nebraska","Pierce County",3,37,83,46,37
050,31,139,"Nebraska","Pierce County",3,38,96,50,46
050,31,139,"Nebraska","Pierce County",3,39,98,55,43
050,31,139,"Nebraska","Pierce County",3,40,95,55,40
050,31,139,"Nebraska","Pierce County",3,41,100,57,43
050,31,139,"Nebraska","Pierce County",3,42,88,42,46
050,31,139,"Nebraska","Pierce County",3,43,77,36,41
050,31,139,"Nebraska","Pierce County",3,44,74,40,34
050,31,139,"Nebraska","Pierce County",3,45,74,42,32
050,31,139,"Nebraska","Pierce County",3,46,75,38,37
050,31,139,"Nebraska","Pierce County",3,47,74,35,39
050,31,139,"Nebraska","Pierce County",3,48,77,41,36
050,31,139,"Nebraska","Pierce County",3,49,84,39,45
050,31,139,"Nebraska","Pierce County",3,50,77,36,41
050,31,139,"Nebraska","Pierce County",3,51,76,44,32
050,31,139,"Nebraska","Pierce County",3,52,80,43,37
050,31,139,"Nebraska","Pierce County",3,53,83,38,45
050,31,139,"Nebraska","Pierce County",3,54,96,47,49
050,31,139,"Nebraska","Pierce County",3,55,81,41,40
050,31,139,"Nebraska","Pierce County",3,56,84,42,42
050,31,139,"Nebraska","Pierce County",3,57,107,51,56
050,31,139,"Nebraska","Pierce County",3,58,120,58,62
050,31,139,"Nebraska","Pierce County",3,59,119,63,56
050,31,139,"Nebraska","Pierce County",3,60,113,59,54
050,31,139,"Nebraska","Pierce County",3,61,108,62,46
050,31,139,"Nebraska","Pierce County",3,62,108,54,54
050,31,139,"Nebraska","Pierce County",3,63,100,51,49
050,31,139,"Nebraska","Pierce County",3,64,93,49,44
050,31,139,"Nebraska","Pierce County",3,65,101,54,47
050,31,139,"Nebraska","Pierce County",3,66,97,52,45
050,31,139,"Nebraska","Pierce County",3,67,78,43,35
050,31,139,"Nebraska","Pierce County",3,68,81,43,38
050,31,139,"Nebraska","Pierce County",3,69,86,47,39
050,31,139,"Nebraska","Pierce County",3,70,80,43,37
050,31,139,"Nebraska","Pierce County",3,71,65,34,31
050,31,139,"Nebraska","Pierce County",3,72,64,32,32
050,31,139,"Nebraska","Pierce County",3,73,71,30,41
050,31,139,"Nebraska","Pierce County",3,74,66,32,34
050,31,139,"Nebraska","Pierce County",3,75,47,23,24
050,31,139,"Nebraska","Pierce County",3,76,43,21,22
050,31,139,"Nebraska","Pierce County",3,77,60,28,32
050,31,139,"Nebraska","Pierce County",3,78,63,31,32
050,31,139,"Nebraska","Pierce County",3,79,49,25,24
050,31,139,"Nebraska","Pierce County",3,80,38,18,20
050,31,139,"Nebraska","Pierce County",3,81,37,16,21
050,31,139,"Nebraska","Pierce County",3,82,39,16,23
050,31,139,"Nebraska","Pierce County",3,83,44,16,28
050,31,139,"Nebraska","Pierce County",3,84,26,10,16
050,31,139,"Nebraska","Pierce County",3,85,200,82,118
050,31,139,"Nebraska","Pierce County",4,0,93,48,45
050,31,139,"Nebraska","Pierce County",4,1,95,49,46
050,31,139,"Nebraska","Pierce County",4,2,102,48,54
050,31,139,"Nebraska","Pierce County",4,3,97,52,45
050,31,139,"Nebraska","Pierce County",4,4,93,45,48
050,31,139,"Nebraska","Pierce County",4,5,101,49,52
050,31,139,"Nebraska","Pierce County",4,6,108,49,59
050,31,139,"Nebraska","Pierce County",4,7,112,51,61
050,31,139,"Nebraska","Pierce County",4,8,104,53,51
050,31,139,"Nebraska","Pierce County",4,9,115,54,61
050,31,139,"Nebraska","Pierce County",4,10,107,52,55
050,31,139,"Nebraska","Pierce County",4,11,101,51,50
050,31,139,"Nebraska","Pierce County",4,12,100,55,45
050,31,139,"Nebraska","Pierce County",4,13,108,52,56
050,31,139,"Nebraska","Pierce County",4,14,117,52,65
050,31,139,"Nebraska","Pierce County",4,15,101,48,53
050,31,139,"Nebraska","Pierce County",4,16,113,58,55
050,31,139,"Nebraska","Pierce County",4,17,120,66,54
050,31,139,"Nebraska","Pierce County",4,18,100,57,43
050,31,139,"Nebraska","Pierce County",4,19,65,41,24
050,31,139,"Nebraska","Pierce County",4,20,74,35,39
050,31,139,"Nebraska","Pierce County",4,21,76,37,39
050,31,139,"Nebraska","Pierce County",4,22,78,45,33
050,31,139,"Nebraska","Pierce County",4,23,83,47,36
050,31,139,"Nebraska","Pierce County",4,24,75,44,31
050,31,139,"Nebraska","Pierce County",4,25,69,38,31
050,31,139,"Nebraska","Pierce County",4,26,75,40,35
050,31,139,"Nebraska","Pierce County",4,27,80,36,44
050,31,139,"Nebraska","Pierce County",4,28,85,40,45
050,31,139,"Nebraska","Pierce County",4,29,74,36,38
050,31,139,"Nebraska","Pierce County",4,30,81,43,38
050,31,139,"Nebraska","Pierce County",4,31,79,47,32
050,31,139,"Nebraska","Pierce County",4,32,70,37,33
050,31,139,"Nebraska","Pierce County",4,33,76,42,34
050,31,139,"Nebraska","Pierce County",4,34,78,45,33
050,31,139,"Nebraska","Pierce County",4,35,74,38,36
050,31,139,"Nebraska","Pierce County",4,36,86,35,51
050,31,139,"Nebraska","Pierce County",4,37,101,54,47
050,31,139,"Nebraska","Pierce County",4,38,84,47,37
050,31,139,"Nebraska","Pierce County",4,39,91,45,46
050,31,139,"Nebraska","Pierce County",4,40,95,53,42
050,31,139,"Nebraska","Pierce County",4,41,102,60,42
050,31,139,"Nebraska","Pierce County",4,42,96,55,41
050,31,139,"Nebraska","Pierce County",4,43,86,42,44
050,31,139,"Nebraska","Pierce County",4,44,75,34,41
050,31,139,"Nebraska","Pierce County",4,45,78,42,36
050,31,139,"Nebraska","Pierce County",4,46,74,42,32
050,31,139,"Nebraska","Pierce County",4,47,75,40,35
050,31,139,"Nebraska","Pierce County",4,48,73,35,38
050,31,139,"Nebraska","Pierce County",4,49,76,39,37
050,31,139,"Nebraska","Pierce County",4,50,82,39,43
050,31,139,"Nebraska","Pierce County",4,51,75,35,40
050,31,139,"Nebraska","Pierce County",4,52,76,44,32
050,31,139,"Nebraska","Pierce County",4,53,75,39,36
050,31,139,"Nebraska","Pierce County",4,54,83,39,44
050,31,139,"Nebraska","Pierce County",4,55,94,47,47
050,31,139,"Nebraska","Pierce County",4,56,84,43,41
050,31,139,"Nebraska","Pierce County",4,57,83,42,41
050,31,139,"Nebraska","Pierce County",4,58,103,49,54
050,31,139,"Nebraska","Pierce County",4,59,117,57,60
050,31,139,"Nebraska","Pierce County",4,60,115,60,55
050,31,139,"Nebraska","Pierce County",4,61,111,57,54
050,31,139,"Nebraska","Pierce County",4,62,104,61,43
050,31,139,"Nebraska","Pierce County",4,63,102,51,51
050,31,139,"Nebraska","Pierce County",4,64,96,50,46
050,31,139,"Nebraska","Pierce County",4,65,92,49,43
050,31,139,"Nebraska","Pierce County",4,66,99,52,47
050,31,139,"Nebraska","Pierce County",4,67,91,49,42
050,31,139,"Nebraska","Pierce County",4,68,76,43,33
050,31,139,"Nebraska","Pierce County",4,69,82,43,39
050,31,139,"Nebraska","Pierce County",4,70,84,46,38
050,31,139,"Nebraska","Pierce County",4,71,77,42,35
050,31,139,"Nebraska","Pierce County",4,72,65,36,29
050,31,139,"Nebraska","Pierce County",4,73,61,27,34
050,31,139,"Nebraska","Pierce County",4,74,61,26,35
050,31,139,"Nebraska","Pierce County",4,75,66,31,35
050,31,139,"Nebraska","Pierce County",4,76,41,21,20
050,31,139,"Nebraska","Pierce County",4,77,44,23,21
050,31,139,"Nebraska","Pierce County",4,78,58,26,32
050,31,139,"Nebraska","Pierce County",4,79,60,29,31
050,31,139,"Nebraska","Pierce County",4,80,43,22,21
050,31,139,"Nebraska","Pierce County",4,81,36,17,19
050,31,139,"Nebraska","Pierce County",4,82,35,15,20
050,31,139,"Nebraska","Pierce County",4,83,44,17,27
050,31,139,"Nebraska","Pierce County",4,84,37,14,23
050,31,139,"Nebraska","Pierce County",4,85,194,79,115
050,31,139,"Nebraska","Pierce County",5,0,93,49,44
050,31,139,"Nebraska","Pierce County",5,1,103,56,47
050,31,139,"Nebraska","Pierce County",5,2,90,45,45
050,31,139,"Nebraska","Pierce County",5,3,108,53,55
050,31,139,"Nebraska","Pierce County",5,4,102,53,49
050,31,139,"Nebraska","Pierce County",5,5,94,46,48
050,31,139,"Nebraska","Pierce County",5,6,101,50,51
050,31,139,"Nebraska","Pierce County",5,7,112,51,61
050,31,139,"Nebraska","Pierce County",5,8,107,52,55
050,31,139,"Nebraska","Pierce County",5,9,102,51,51
050,31,139,"Nebraska","Pierce County",5,10,110,52,58
050,31,139,"Nebraska","Pierce County",5,11,100,48,52
050,31,139,"Nebraska","Pierce County",5,12,103,52,51
050,31,139,"Nebraska","Pierce County",5,13,106,55,51
050,31,139,"Nebraska","Pierce County",5,14,112,51,61
050,31,139,"Nebraska","Pierce County",5,15,121,52,69
050,31,139,"Nebraska","Pierce County",5,16,99,45,54
050,31,139,"Nebraska","Pierce County",5,17,106,56,50
050,31,139,"Nebraska","Pierce County",5,18,104,61,43
050,31,139,"Nebraska","Pierce County",5,19,69,37,32
050,31,139,"Nebraska","Pierce County",5,20,69,44,25
050,31,139,"Nebraska","Pierce County",5,21,76,36,40
050,31,139,"Nebraska","Pierce County",5,22,83,42,41
050,31,139,"Nebraska","Pierce County",5,23,76,44,32
050,31,139,"Nebraska","Pierce County",5,24,73,40,33
050,31,139,"Nebraska","Pierce County",5,25,72,41,31
050,31,139,"Nebraska","Pierce County",5,26,74,40,34
050,31,139,"Nebraska","Pierce County",5,27,79,43,36
050,31,139,"Nebraska","Pierce County",5,28,81,37,44
050,31,139,"Nebraska","Pierce County",5,29,85,40,45
050,31,139,"Nebraska","Pierce County",5,30,83,45,38
050,31,139,"Nebraska","Pierce County",5,31,74,39,35
050,31,139,"Nebraska","Pierce County",5,32,79,44,35
050,31,139,"Nebraska","Pierce County",5,33,70,37,33
050,31,139,"Nebraska","Pierce County",5,34,82,45,37
050,31,139,"Nebraska","Pierce County",5,35,80,45,35
050,31,139,"Nebraska","Pierce County",5,36,86,42,44
050,31,139,"Nebraska","Pierce County",5,37,89,40,49
050,31,139,"Nebraska","Pierce County",5,38,102,54,48
050,31,139,"Nebraska","Pierce County",5,39,80,42,38
050,31,139,"Nebraska","Pierce County",5,40,87,42,45
050,31,139,"Nebraska","Pierce County",5,41,89,48,41
050,31,139,"Nebraska","Pierce County",5,42,103,60,43
050,31,139,"Nebraska","Pierce County",5,43,97,54,43
050,31,139,"Nebraska","Pierce County",5,44,85,42,43
050,31,139,"Nebraska","Pierce County",5,45,75,33,42
050,31,139,"Nebraska","Pierce County",5,46,74,40,34
050,31,139,"Nebraska","Pierce County",5,47,73,42,31
050,31,139,"Nebraska","Pierce County",5,48,75,40,35
050,31,139,"Nebraska","Pierce County",5,49,75,35,40
050,31,139,"Nebraska","Pierce County",5,50,72,37,35
050,31,139,"Nebraska","Pierce County",5,51,83,41,42
050,31,139,"Nebraska","Pierce County",5,52,73,34,39
050,31,139,"Nebraska","Pierce County",5,53,75,43,32
050,31,139,"Nebraska","Pierce County",5,54,75,39,36
050,31,139,"Nebraska","Pierce County",5,55,81,37,44
050,31,139,"Nebraska","Pierce County",5,56,93,47,46
050,31,139,"Nebraska","Pierce County",5,57,82,41,41
050,31,139,"Nebraska","Pierce County",5,58,80,40,40
050,31,139,"Nebraska","Pierce County",5,59,104,50,54
050,31,139,"Nebraska","Pierce County",5,60,112,56,56
050,31,139,"Nebraska","Pierce County",5,61,113,58,55
050,31,139,"Nebraska","Pierce County",5,62,111,59,52
050,31,139,"Nebraska","Pierce County",5,63,103,61,42
050,31,139,"Nebraska","Pierce County",5,64,101,50,51
050,31,139,"Nebraska","Pierce County",5,65,95,49,46
050,31,139,"Nebraska","Pierce County",5,66,91,48,43
050,31,139,"Nebraska","Pierce County",5,67,95,50,45
050,31,139,"Nebraska","Pierce County",5,68,88,48,40
050,31,139,"Nebraska","Pierce County",5,69,75,43,32
050,31,139,"Nebraska","Pierce County",5,70,76,40,36
050,31,139,"Nebraska","Pierce County",5,71,81,45,36
050,31,139,"Nebraska","Pierce County",5,72,75,42,33
050,31,139,"Nebraska","Pierce County",5,73,63,32,31
050,31,139,"Nebraska","Pierce County",5,74,56,23,33
050,31,139,"Nebraska","Pierce County",5,75,61,26,35
050,31,139,"Nebraska","Pierce County",5,76,58,28,30
050,31,139,"Nebraska","Pierce County",5,77,41,22,19
050,31,139,"Nebraska","Pierce County",5,78,41,21,20
050,31,139,"Nebraska","Pierce County",5,79,58,26,32
050,31,139,"Nebraska","Pierce County",5,80,58,29,29
050,31,139,"Nebraska","Pierce County",5,81,41,22,19
050,31,139,"Nebraska","Pierce County",5,82,36,16,20
050,31,139,"Nebraska","Pierce County",5,83,41,17,24
050,31,139,"Nebraska","Pierce County",5,84,37,13,24
050,31,139,"Nebraska","Pierce County",5,85,206,84,122
050,31,141,"Nebraska","Platte County",1,0,462,234,228
050,31,141,"Nebraska","Platte County",1,1,459,230,229
050,31,141,"Nebraska","Platte County",1,2,488,235,253
050,31,141,"Nebraska","Platte County",1,3,514,269,245
050,31,141,"Nebraska","Platte County",1,4,504,251,253
050,31,141,"Nebraska","Platte County",1,5,550,267,283
050,31,141,"Nebraska","Platte County",1,6,525,259,266
050,31,141,"Nebraska","Platte County",1,7,514,278,236
050,31,141,"Nebraska","Platte County",1,8,532,285,247
050,31,141,"Nebraska","Platte County",1,9,501,248,253
050,31,141,"Nebraska","Platte County",1,10,530,263,267
050,31,141,"Nebraska","Platte County",1,11,513,272,241
050,31,141,"Nebraska","Platte County",1,12,535,291,244
050,31,141,"Nebraska","Platte County",1,13,517,275,242
050,31,141,"Nebraska","Platte County",1,14,512,253,259
050,31,141,"Nebraska","Platte County",1,15,493,254,239
050,31,141,"Nebraska","Platte County",1,16,509,261,248
050,31,141,"Nebraska","Platte County",1,17,497,255,242
050,31,141,"Nebraska","Platte County",1,18,409,215,194
050,31,141,"Nebraska","Platte County",1,19,336,176,160
050,31,141,"Nebraska","Platte County",1,20,361,190,171
050,31,141,"Nebraska","Platte County",1,21,379,197,182
050,31,141,"Nebraska","Platte County",1,22,379,202,177
050,31,141,"Nebraska","Platte County",1,23,387,204,183
050,31,141,"Nebraska","Platte County",1,24,404,226,178
050,31,141,"Nebraska","Platte County",1,25,405,235,170
050,31,141,"Nebraska","Platte County",1,26,423,220,203
050,31,141,"Nebraska","Platte County",1,27,410,215,195
050,31,141,"Nebraska","Platte County",1,28,440,225,215
050,31,141,"Nebraska","Platte County",1,29,380,194,186
050,31,141,"Nebraska","Platte County",1,30,370,189,181
050,31,141,"Nebraska","Platte County",1,31,378,197,181
050,31,141,"Nebraska","Platte County",1,32,418,216,202
050,31,141,"Nebraska","Platte County",1,33,419,222,197
050,31,141,"Nebraska","Platte County",1,34,420,234,186
050,31,141,"Nebraska","Platte County",1,35,441,236,205
050,31,141,"Nebraska","Platte County",1,36,433,225,208
050,31,141,"Nebraska","Platte County",1,37,446,244,202
050,31,141,"Nebraska","Platte County",1,38,439,231,208
050,31,141,"Nebraska","Platte County",1,39,420,224,196
050,31,141,"Nebraska","Platte County",1,40,432,204,228
050,31,141,"Nebraska","Platte County",1,41,416,205,211
050,31,141,"Nebraska","Platte County",1,42,391,209,182
050,31,141,"Nebraska","Platte County",1,43,392,216,176
050,31,141,"Nebraska","Platte County",1,44,349,169,180
050,31,141,"Nebraska","Platte County",1,45,378,186,192
050,31,141,"Nebraska","Platte County",1,46,362,187,175
050,31,141,"Nebraska","Platte County",1,47,365,190,175
050,31,141,"Nebraska","Platte County",1,48,370,206,164
050,31,141,"Nebraska","Platte County",1,49,376,214,162
050,31,141,"Nebraska","Platte County",1,50,337,167,170
050,31,141,"Nebraska","Platte County",1,51,356,183,173
050,31,141,"Nebraska","Platte County",1,52,391,212,179
050,31,141,"Nebraska","Platte County",1,53,380,196,184
050,31,141,"Nebraska","Platte County",1,54,367,185,182
050,31,141,"Nebraska","Platte County",1,55,389,201,188
050,31,141,"Nebraska","Platte County",1,56,454,226,228
050,31,141,"Nebraska","Platte County",1,57,468,238,230
050,31,141,"Nebraska","Platte County",1,58,472,232,240
050,31,141,"Nebraska","Platte County",1,59,465,229,236
050,31,141,"Nebraska","Platte County",1,60,490,249,241
050,31,141,"Nebraska","Platte County",1,61,462,243,219
050,31,141,"Nebraska","Platte County",1,62,469,243,226
050,31,141,"Nebraska","Platte County",1,63,449,229,220
050,31,141,"Nebraska","Platte County",1,64,436,230,206
050,31,141,"Nebraska","Platte County",1,65,427,212,215
050,31,141,"Nebraska","Platte County",1,66,422,208,214
050,31,141,"Nebraska","Platte County",1,67,386,197,189
050,31,141,"Nebraska","Platte County",1,68,383,203,180
050,31,141,"Nebraska","Platte County",1,69,349,182,167
050,31,141,"Nebraska","Platte County",1,70,315,169,146
050,31,141,"Nebraska","Platte County",1,71,316,156,160
050,31,141,"Nebraska","Platte County",1,72,299,140,159
050,31,141,"Nebraska","Platte County",1,73,288,131,157
050,31,141,"Nebraska","Platte County",1,74,208,97,111
050,31,141,"Nebraska","Platte County",1,75,212,107,105
050,31,141,"Nebraska","Platte County",1,76,227,109,118
050,31,141,"Nebraska","Platte County",1,77,225,98,127
050,31,141,"Nebraska","Platte County",1,78,189,81,108
050,31,141,"Nebraska","Platte County",1,79,165,65,100
050,31,141,"Nebraska","Platte County",1,80,153,65,88
050,31,141,"Nebraska","Platte County",1,81,157,67,90
050,31,141,"Nebraska","Platte County",1,82,161,69,92
050,31,141,"Nebraska","Platte County",1,83,133,53,80
050,31,141,"Nebraska","Platte County",1,84,133,54,79
050,31,141,"Nebraska","Platte County",1,85,879,332,547
050,31,141,"Nebraska","Platte County",2,0,450,228,222
050,31,141,"Nebraska","Platte County",2,1,463,231,232
050,31,141,"Nebraska","Platte County",2,2,480,232,248
050,31,141,"Nebraska","Platte County",2,3,506,259,247
050,31,141,"Nebraska","Platte County",2,4,510,257,253
050,31,141,"Nebraska","Platte County",2,5,540,264,276
050,31,141,"Nebraska","Platte County",2,6,533,263,270
050,31,141,"Nebraska","Platte County",2,7,516,274,242
050,31,141,"Nebraska","Platte County",2,8,527,281,246
050,31,141,"Nebraska","Platte County",2,9,510,259,251
050,31,141,"Nebraska","Platte County",2,10,521,257,264
050,31,141,"Nebraska","Platte County",2,11,517,271,246
050,31,141,"Nebraska","Platte County",2,12,530,287,243
050,31,141,"Nebraska","Platte County",2,13,523,279,244
050,31,141,"Nebraska","Platte County",2,14,513,259,254
050,31,141,"Nebraska","Platte County",2,15,498,254,244
050,31,141,"Nebraska","Platte County",2,16,505,261,244
050,31,141,"Nebraska","Platte County",2,17,500,256,244
050,31,141,"Nebraska","Platte County",2,18,414,216,198
050,31,141,"Nebraska","Platte County",2,19,340,178,162
050,31,141,"Nebraska","Platte County",2,20,363,190,173
050,31,141,"Nebraska","Platte County",2,21,376,195,181
050,31,141,"Nebraska","Platte County",2,22,381,200,181
050,31,141,"Nebraska","Platte County",2,23,385,203,182
050,31,141,"Nebraska","Platte County",2,24,398,221,177
050,31,141,"Nebraska","Platte County",2,25,406,232,174
050,31,141,"Nebraska","Platte County",2,26,418,223,195
050,31,141,"Nebraska","Platte County",2,27,412,215,197
050,31,141,"Nebraska","Platte County",2,28,429,220,209
050,31,141,"Nebraska","Platte County",2,29,390,199,191
050,31,141,"Nebraska","Platte County",2,30,375,192,183
050,31,141,"Nebraska","Platte County",2,31,373,193,180
050,31,141,"Nebraska","Platte County",2,32,407,211,196
050,31,141,"Nebraska","Platte County",2,33,421,223,198
050,31,141,"Nebraska","Platte County",2,34,425,234,191
050,31,141,"Nebraska","Platte County",2,35,439,238,201
050,31,141,"Nebraska","Platte County",2,36,431,225,206
050,31,141,"Nebraska","Platte County",2,37,444,240,204
050,31,141,"Nebraska","Platte County",2,38,440,232,208
050,31,141,"Nebraska","Platte County",2,39,424,224,200
050,31,141,"Nebraska","Platte County",2,40,432,211,221
050,31,141,"Nebraska","Platte County",2,41,420,204,216
050,31,141,"Nebraska","Platte County",2,42,394,207,187
050,31,141,"Nebraska","Platte County",2,43,392,215,177
050,31,141,"Nebraska","Platte County",2,44,354,178,176
050,31,141,"Nebraska","Platte County",2,45,375,185,190
050,31,141,"Nebraska","Platte County",2,46,364,187,177
050,31,141,"Nebraska","Platte County",2,47,364,190,174
050,31,141,"Nebraska","Platte County",2,48,369,203,166
050,31,141,"Nebraska","Platte County",2,49,375,212,163
050,31,141,"Nebraska","Platte County",2,50,345,177,168
050,31,141,"Nebraska","Platte County",2,51,350,178,172
050,31,141,"Nebraska","Platte County",2,52,379,203,176
050,31,141,"Nebraska","Platte County",2,53,379,198,181
050,31,141,"Nebraska","Platte County",2,54,368,186,182
050,31,141,"Nebraska","Platte County",2,55,383,197,186
050,31,141,"Nebraska","Platte County",2,56,439,221,218
050,31,141,"Nebraska","Platte County",2,57,466,235,231
050,31,141,"Nebraska","Platte County",2,58,468,232,236
050,31,141,"Nebraska","Platte County",2,59,466,227,239
050,31,141,"Nebraska","Platte County",2,60,478,241,237
050,31,141,"Nebraska","Platte County",2,61,467,244,223
050,31,141,"Nebraska","Platte County",2,62,464,243,221
050,31,141,"Nebraska","Platte County",2,63,453,231,222
050,31,141,"Nebraska","Platte County",2,64,434,226,208
050,31,141,"Nebraska","Platte County",2,65,424,211,213
050,31,141,"Nebraska","Platte County",2,66,426,210,216
050,31,141,"Nebraska","Platte County",2,67,395,200,195
050,31,141,"Nebraska","Platte County",2,68,380,200,180
050,31,141,"Nebraska","Platte County",2,69,356,185,171
050,31,141,"Nebraska","Platte County",2,70,320,172,148
050,31,141,"Nebraska","Platte County",2,71,315,158,157
050,31,141,"Nebraska","Platte County",2,72,294,139,155
050,31,141,"Nebraska","Platte County",2,73,303,140,163
050,31,141,"Nebraska","Platte County",2,74,211,97,114
050,31,141,"Nebraska","Platte County",2,75,211,105,106
050,31,141,"Nebraska","Platte County",2,76,222,106,116
050,31,141,"Nebraska","Platte County",2,77,226,101,125
050,31,141,"Nebraska","Platte County",2,78,195,84,111
050,31,141,"Nebraska","Platte County",2,79,170,69,101
050,31,141,"Nebraska","Platte County",2,80,158,67,91
050,31,141,"Nebraska","Platte County",2,81,151,65,86
050,31,141,"Nebraska","Platte County",2,82,160,69,91
050,31,141,"Nebraska","Platte County",2,83,137,55,82
050,31,141,"Nebraska","Platte County",2,84,132,54,78
050,31,141,"Nebraska","Platte County",2,85,890,339,551
050,31,141,"Nebraska","Platte County",3,0,491,232,259
050,31,141,"Nebraska","Platte County",3,1,452,232,220
050,31,141,"Nebraska","Platte County",3,2,466,234,232
050,31,141,"Nebraska","Platte County",3,3,486,235,251
050,31,141,"Nebraska","Platte County",3,4,509,264,245
050,31,141,"Nebraska","Platte County",3,5,509,263,246
050,31,141,"Nebraska","Platte County",3,6,530,260,270
050,31,141,"Nebraska","Platte County",3,7,531,261,270
050,31,141,"Nebraska","Platte County",3,8,495,261,234
050,31,141,"Nebraska","Platte County",3,9,533,275,258
050,31,141,"Nebraska","Platte County",3,10,505,253,252
050,31,141,"Nebraska","Platte County",3,11,510,244,266
050,31,141,"Nebraska","Platte County",3,12,501,265,236
050,31,141,"Nebraska","Platte County",3,13,518,279,239
050,31,141,"Nebraska","Platte County",3,14,527,276,251
050,31,141,"Nebraska","Platte County",3,15,516,251,265
050,31,141,"Nebraska","Platte County",3,16,504,255,249
050,31,141,"Nebraska","Platte County",3,17,490,249,241
050,31,141,"Nebraska","Platte County",3,18,431,220,211
050,31,141,"Nebraska","Platte County",3,19,349,180,169
050,31,141,"Nebraska","Platte County",3,20,359,192,167
050,31,141,"Nebraska","Platte County",3,21,363,187,176
050,31,141,"Nebraska","Platte County",3,22,412,216,196
050,31,141,"Nebraska","Platte County",3,23,398,207,191
050,31,141,"Nebraska","Platte County",3,24,355,198,157
050,31,141,"Nebraska","Platte County",3,25,391,219,172
050,31,141,"Nebraska","Platte County",3,26,402,222,180
050,31,141,"Nebraska","Platte County",3,27,415,221,194
050,31,141,"Nebraska","Platte County",3,28,408,210,198
050,31,141,"Nebraska","Platte County",3,29,435,218,217
050,31,141,"Nebraska","Platte County",3,30,403,209,194
050,31,141,"Nebraska","Platte County",3,31,379,199,180
050,31,141,"Nebraska","Platte County",3,32,373,196,177
050,31,141,"Nebraska","Platte County",3,33,414,209,205
050,31,141,"Nebraska","Platte County",3,34,424,227,197
050,31,141,"Nebraska","Platte County",3,35,426,241,185
050,31,141,"Nebraska","Platte County",3,36,446,249,197
050,31,141,"Nebraska","Platte County",3,37,443,232,211
050,31,141,"Nebraska","Platte County",3,38,427,225,202
050,31,141,"Nebraska","Platte County",3,39,424,224,200
050,31,141,"Nebraska","Platte County",3,40,427,231,196
050,31,141,"Nebraska","Platte County",3,41,430,212,218
050,31,141,"Nebraska","Platte County",3,42,421,203,218
050,31,141,"Nebraska","Platte County",3,43,395,204,191
050,31,141,"Nebraska","Platte County",3,44,391,219,172
050,31,141,"Nebraska","Platte County",3,45,360,175,185
050,31,141,"Nebraska","Platte County",3,46,384,196,188
050,31,141,"Nebraska","Platte County",3,47,365,183,182
050,31,141,"Nebraska","Platte County",3,48,379,199,180
050,31,141,"Nebraska","Platte County",3,49,374,207,167
050,31,141,"Nebraska","Platte County",3,50,368,209,159
050,31,141,"Nebraska","Platte County",3,51,350,178,172
050,31,141,"Nebraska","Platte County",3,52,345,177,168
050,31,141,"Nebraska","Platte County",3,53,372,202,170
050,31,141,"Nebraska","Platte County",3,54,381,199,182
050,31,141,"Nebraska","Platte County",3,55,373,193,180
050,31,141,"Nebraska","Platte County",3,56,389,204,185
050,31,141,"Nebraska","Platte County",3,57,438,220,218
050,31,141,"Nebraska","Platte County",3,58,466,232,234
050,31,141,"Nebraska","Platte County",3,59,467,229,238
050,31,141,"Nebraska","Platte County",3,60,468,230,238
050,31,141,"Nebraska","Platte County",3,61,469,237,232
050,31,141,"Nebraska","Platte County",3,62,463,248,215
050,31,141,"Nebraska","Platte County",3,63,463,240,223
050,31,141,"Nebraska","Platte County",3,64,445,225,220
050,31,141,"Nebraska","Platte County",3,65,430,228,202
050,31,141,"Nebraska","Platte County",3,66,418,208,210
050,31,141,"Nebraska","Platte County",3,67,416,206,210
050,31,141,"Nebraska","Platte County",3,68,381,192,189
050,31,141,"Nebraska","Platte County",3,69,379,193,186
050,31,141,"Nebraska","Platte County",3,70,336,177,159
050,31,141,"Nebraska","Platte County",3,71,312,165,147
050,31,141,"Nebraska","Platte County",3,72,302,153,149
050,31,141,"Nebraska","Platte County",3,73,292,141,151
050,31,141,"Nebraska","Platte County",3,74,291,131,160
050,31,141,"Nebraska","Platte County",3,75,205,94,111
050,31,141,"Nebraska","Platte County",3,76,216,106,110
050,31,141,"Nebraska","Platte County",3,77,194,92,102
050,31,141,"Nebraska","Platte County",3,78,217,97,120
050,31,141,"Nebraska","Platte County",3,79,182,75,107
050,31,141,"Nebraska","Platte County",3,80,161,70,91
050,31,141,"Nebraska","Platte County",3,81,145,61,84
050,31,141,"Nebraska","Platte County",3,82,143,58,85
050,31,141,"Nebraska","Platte County",3,83,143,54,89
050,31,141,"Nebraska","Platte County",3,84,132,55,77
050,31,141,"Nebraska","Platte County",3,85,867,333,534
050,31,141,"Nebraska","Platte County",4,0,446,226,220
050,31,141,"Nebraska","Platte County",4,1,471,229,242
050,31,141,"Nebraska","Platte County",4,2,441,227,214
050,31,141,"Nebraska","Platte County",4,3,460,232,228
050,31,141,"Nebraska","Platte County",4,4,512,239,273
050,31,141,"Nebraska","Platte County",4,5,508,270,238
050,31,141,"Nebraska","Platte County",4,6,521,275,246
050,31,141,"Nebraska","Platte County",4,7,501,255,246
050,31,141,"Nebraska","Platte County",4,8,536,258,278
050,31,141,"Nebraska","Platte County",4,9,497,263,234
050,31,141,"Nebraska","Platte County",4,10,521,264,257
050,31,141,"Nebraska","Platte County",4,11,507,252,255
050,31,141,"Nebraska","Platte County",4,12,528,261,267
050,31,141,"Nebraska","Platte County",4,13,523,274,249
050,31,141,"Nebraska","Platte County",4,14,516,276,240
050,31,141,"Nebraska","Platte County",4,15,524,269,255
050,31,141,"Nebraska","Platte County",4,16,517,252,265
050,31,141,"Nebraska","Platte County",4,17,499,248,251
050,31,141,"Nebraska","Platte County",4,18,417,217,200
050,31,141,"Nebraska","Platte County",4,19,368,189,179
050,31,141,"Nebraska","Platte County",4,20,382,202,180
050,31,141,"Nebraska","Platte County",4,21,379,207,172
050,31,141,"Nebraska","Platte County",4,22,401,213,188
050,31,141,"Nebraska","Platte County",4,23,428,233,195
050,31,141,"Nebraska","Platte County",4,24,374,200,174
050,31,141,"Nebraska","Platte County",4,25,350,185,165
050,31,141,"Nebraska","Platte County",4,26,394,220,174
050,31,141,"Nebraska","Platte County",4,27,392,219,173
050,31,141,"Nebraska","Platte County",4,28,410,204,206
050,31,141,"Nebraska","Platte County",4,29,409,211,198
050,31,141,"Nebraska","Platte County",4,30,415,201,214
050,31,141,"Nebraska","Platte County",4,31,402,213,189
050,31,141,"Nebraska","Platte County",4,32,383,204,179
050,31,141,"Nebraska","Platte County",4,33,381,205,176
050,31,141,"Nebraska","Platte County",4,34,412,208,204
050,31,141,"Nebraska","Platte County",4,35,418,232,186
050,31,141,"Nebraska","Platte County",4,36,430,237,193
050,31,141,"Nebraska","Platte County",4,37,439,242,197
050,31,141,"Nebraska","Platte County",4,38,441,228,213
050,31,141,"Nebraska","Platte County",4,39,427,230,197
050,31,141,"Nebraska","Platte County",4,40,434,228,206
050,31,141,"Nebraska","Platte County",4,41,420,226,194
050,31,141,"Nebraska","Platte County",4,42,445,221,224
050,31,141,"Nebraska","Platte County",4,43,432,207,225
050,31,141,"Nebraska","Platte County",4,44,399,211,188
050,31,141,"Nebraska","Platte County",4,45,395,220,175
050,31,141,"Nebraska","Platte County",4,46,357,173,184
050,31,141,"Nebraska","Platte County",4,47,392,201,191
050,31,141,"Nebraska","Platte County",4,48,360,182,178
050,31,141,"Nebraska","Platte County",4,49,387,203,184
050,31,141,"Nebraska","Platte County",4,50,382,212,170
050,31,141,"Nebraska","Platte County",4,51,367,209,158
050,31,141,"Nebraska","Platte County",4,52,348,179,169
050,31,141,"Nebraska","Platte County",4,53,349,174,175
050,31,141,"Nebraska","Platte County",4,54,365,198,167
050,31,141,"Nebraska","Platte County",4,55,380,201,179
050,31,141,"Nebraska","Platte County",4,56,380,196,184
050,31,141,"Nebraska","Platte County",4,57,377,194,183
050,31,141,"Nebraska","Platte County",4,58,432,221,211
050,31,141,"Nebraska","Platte County",4,59,459,226,233
050,31,141,"Nebraska","Platte County",4,60,460,232,228
050,31,141,"Nebraska","Platte County",4,61,451,221,230
050,31,141,"Nebraska","Platte County",4,62,471,241,230
050,31,141,"Nebraska","Platte County",4,63,455,243,212
050,31,141,"Nebraska","Platte County",4,64,439,226,213
050,31,141,"Nebraska","Platte County",4,65,432,218,214
050,31,141,"Nebraska","Platte County",4,66,422,217,205
050,31,141,"Nebraska","Platte County",4,67,406,206,200
050,31,141,"Nebraska","Platte County",4,68,401,196,205
050,31,141,"Nebraska","Platte County",4,69,382,189,193
050,31,141,"Nebraska","Platte County",4,70,366,186,180
050,31,141,"Nebraska","Platte County",4,71,332,171,161
050,31,141,"Nebraska","Platte County",4,72,305,165,140
050,31,141,"Nebraska","Platte County",4,73,305,153,152
050,31,141,"Nebraska","Platte County",4,74,294,140,154
050,31,141,"Nebraska","Platte County",4,75,301,142,159
050,31,141,"Nebraska","Platte County",4,76,212,97,115
050,31,141,"Nebraska","Platte County",4,77,199,97,102
050,31,141,"Nebraska","Platte County",4,78,188,89,99
050,31,141,"Nebraska","Platte County",4,79,209,91,118
050,31,141,"Nebraska","Platte County",4,80,176,75,101
050,31,141,"Nebraska","Platte County",4,81,153,66,87
050,31,141,"Nebraska","Platte County",4,82,139,55,84
050,31,141,"Nebraska","Platte County",4,83,126,45,81
050,31,141,"Nebraska","Platte County",4,84,137,54,83
050,31,141,"Nebraska","Platte County",4,85,854,313,541
050,31,141,"Nebraska","Platte County",5,0,446,225,221
050,31,141,"Nebraska","Platte County",5,1,462,230,232
050,31,141,"Nebraska","Platte County",5,2,486,230,256
050,31,141,"Nebraska","Platte County",5,3,455,233,222
050,31,141,"Nebraska","Platte County",5,4,454,233,221
050,31,141,"Nebraska","Platte County",5,5,517,240,277
050,31,141,"Nebraska","Platte County",5,6,518,278,240
050,31,141,"Nebraska","Platte County",5,7,521,270,251
050,31,141,"Nebraska","Platte County",5,8,522,265,257
050,31,141,"Nebraska","Platte County",5,9,537,255,282
050,31,141,"Nebraska","Platte County",5,10,514,264,250
050,31,141,"Nebraska","Platte County",5,11,542,273,269
050,31,141,"Nebraska","Platte County",5,12,506,256,250
050,31,141,"Nebraska","Platte County",5,13,545,267,278
050,31,141,"Nebraska","Platte County",5,14,526,268,258
050,31,141,"Nebraska","Platte County",5,15,514,276,238
050,31,141,"Nebraska","Platte County",5,16,531,283,248
050,31,141,"Nebraska","Platte County",5,17,512,256,256
050,31,141,"Nebraska","Platte County",5,18,428,224,204
050,31,141,"Nebraska","Platte County",5,19,352,183,169
050,31,141,"Nebraska","Platte County",5,20,386,207,179
050,31,141,"Nebraska","Platte County",5,21,390,208,182
050,31,141,"Nebraska","Platte County",5,22,421,230,191
050,31,141,"Nebraska","Platte County",5,23,414,221,193
050,31,141,"Nebraska","Platte County",5,24,410,226,184
050,31,141,"Nebraska","Platte County",5,25,369,200,169
050,31,141,"Nebraska","Platte County",5,26,350,178,172
050,31,141,"Nebraska","Platte County",5,27,403,223,180
050,31,141,"Nebraska","Platte County",5,28,399,217,182
050,31,141,"Nebraska","Platte County",5,29,416,195,221
050,31,141,"Nebraska","Platte County",5,30,418,222,196
050,31,141,"Nebraska","Platte County",5,31,419,208,211
050,31,141,"Nebraska","Platte County",5,32,404,212,192
050,31,141,"Nebraska","Platte County",5,33,399,219,180
050,31,141,"Nebraska","Platte County",5,34,410,221,189
050,31,141,"Nebraska","Platte County",5,35,415,215,200
050,31,141,"Nebraska","Platte County",5,36,429,239,190
050,31,141,"Nebraska","Platte County",5,37,424,231,193
050,31,141,"Nebraska","Platte County",5,38,438,236,202
050,31,141,"Nebraska","Platte County",5,39,454,233,221
050,31,141,"Nebraska","Platte County",5,40,435,231,204
050,31,141,"Nebraska","Platte County",5,41,436,226,210
050,31,141,"Nebraska","Platte County",5,42,406,217,189
050,31,141,"Nebraska","Platte County",5,43,426,214,212
050,31,141,"Nebraska","Platte County",5,44,434,199,235
050,31,141,"Nebraska","Platte County",5,45,394,206,188
050,31,141,"Nebraska","Platte County",5,46,392,213,179
050,31,141,"Nebraska","Platte County",5,47,349,169,180
050,31,141,"Nebraska","Platte County",5,48,393,207,186
050,31,141,"Nebraska","Platte County",5,49,356,181,175
050,31,141,"Nebraska","Platte County",5,50,399,203,196
050,31,141,"Nebraska","Platte County",5,51,383,211,172
050,31,141,"Nebraska","Platte County",5,52,359,206,153
050,31,141,"Nebraska","Platte County",5,53,345,176,169
050,31,141,"Nebraska","Platte County",5,54,345,175,170
050,31,141,"Nebraska","Platte County",5,55,366,194,172
050,31,141,"Nebraska","Platte County",5,56,384,200,184
050,31,141,"Nebraska","Platte County",5,57,374,193,181
050,31,141,"Nebraska","Platte County",5,58,368,182,186
050,31,141,"Nebraska","Platte County",5,59,426,216,210
050,31,141,"Nebraska","Platte County",5,60,455,225,230
050,31,141,"Nebraska","Platte County",5,61,451,228,223
050,31,141,"Nebraska","Platte County",5,62,448,219,229
050,31,141,"Nebraska","Platte County",5,63,459,235,224
050,31,141,"Nebraska","Platte County",5,64,442,240,202
050,31,141,"Nebraska","Platte County",5,65,431,223,208
050,31,141,"Nebraska","Platte County",5,66,425,209,216
050,31,141,"Nebraska","Platte County",5,67,417,217,200
050,31,141,"Nebraska","Platte County",5,68,396,198,198
050,31,141,"Nebraska","Platte County",5,69,396,187,209
050,31,141,"Nebraska","Platte County",5,70,368,183,185
050,31,141,"Nebraska","Platte County",5,71,360,178,182
050,31,141,"Nebraska","Platte County",5,72,320,167,153
050,31,141,"Nebraska","Platte County",5,73,301,164,137
050,31,141,"Nebraska","Platte County",5,74,301,151,150
050,31,141,"Nebraska","Platte County",5,75,299,148,151
050,31,141,"Nebraska","Platte County",5,76,306,142,164
050,31,141,"Nebraska","Platte County",5,77,198,88,110
050,31,141,"Nebraska","Platte County",5,78,197,95,102
050,31,141,"Nebraska","Platte County",5,79,181,83,98
050,31,141,"Nebraska","Platte County",5,80,205,92,113
050,31,141,"Nebraska","Platte County",5,81,169,69,100
050,31,141,"Nebraska","Platte County",5,82,144,57,87
050,31,141,"Nebraska","Platte County",5,83,129,45,84
050,31,141,"Nebraska","Platte County",5,84,121,45,76
050,31,141,"Nebraska","Platte County",5,85,864,307,557
050,31,143,"Nebraska","Polk County",1,0,57,29,28
050,31,143,"Nebraska","Polk County",1,1,66,34,32
050,31,143,"Nebraska","Polk County",1,2,59,33,26
050,31,143,"Nebraska","Polk County",1,3,56,27,29
050,31,143,"Nebraska","Polk County",1,4,48,24,24
050,31,143,"Nebraska","Polk County",1,5,51,29,22
050,31,143,"Nebraska","Polk County",1,6,56,28,28
050,31,143,"Nebraska","Polk County",1,7,59,29,30
050,31,143,"Nebraska","Polk County",1,8,54,26,28
050,31,143,"Nebraska","Polk County",1,9,67,31,36
050,31,143,"Nebraska","Polk County",1,10,71,35,36
050,31,143,"Nebraska","Polk County",1,11,75,35,40
050,31,143,"Nebraska","Polk County",1,12,70,33,37
050,31,143,"Nebraska","Polk County",1,13,79,39,40
050,31,143,"Nebraska","Polk County",1,14,83,43,40
050,31,143,"Nebraska","Polk County",1,15,72,39,33
050,31,143,"Nebraska","Polk County",1,16,71,38,33
050,31,143,"Nebraska","Polk County",1,17,79,39,40
050,31,143,"Nebraska","Polk County",1,18,60,33,27
050,31,143,"Nebraska","Polk County",1,19,48,27,21
050,31,143,"Nebraska","Polk County",1,20,59,32,27
050,31,143,"Nebraska","Polk County",1,21,60,32,28
050,31,143,"Nebraska","Polk County",1,22,50,25,25
050,31,143,"Nebraska","Polk County",1,23,53,28,25
050,31,143,"Nebraska","Polk County",1,24,45,26,19
050,31,143,"Nebraska","Polk County",1,25,40,20,20
050,31,143,"Nebraska","Polk County",1,26,52,25,27
050,31,143,"Nebraska","Polk County",1,27,60,31,29
050,31,143,"Nebraska","Polk County",1,28,48,24,24
050,31,143,"Nebraska","Polk County",1,29,56,29,27
050,31,143,"Nebraska","Polk County",1,30,46,19,27
050,31,143,"Nebraska","Polk County",1,31,46,25,21
050,31,143,"Nebraska","Polk County",1,32,44,19,25
050,31,143,"Nebraska","Polk County",1,33,49,29,20
050,31,143,"Nebraska","Polk County",1,34,51,28,23
050,31,143,"Nebraska","Polk County",1,35,47,24,23
050,31,143,"Nebraska","Polk County",1,36,46,26,20
050,31,143,"Nebraska","Polk County",1,37,42,22,20
050,31,143,"Nebraska","Polk County",1,38,53,25,28
050,31,143,"Nebraska","Polk County",1,39,69,29,40
050,31,143,"Nebraska","Polk County",1,40,59,27,32
050,31,143,"Nebraska","Polk County",1,41,55,27,28
050,31,143,"Nebraska","Polk County",1,42,56,28,28
050,31,143,"Nebraska","Polk County",1,43,59,34,25
050,31,143,"Nebraska","Polk County",1,44,64,33,31
050,31,143,"Nebraska","Polk County",1,45,55,25,30
050,31,143,"Nebraska","Polk County",1,46,52,23,29
050,31,143,"Nebraska","Polk County",1,47,55,31,24
050,31,143,"Nebraska","Polk County",1,48,63,33,30
050,31,143,"Nebraska","Polk County",1,49,74,36,38
050,31,143,"Nebraska","Polk County",1,50,67,33,34
050,31,143,"Nebraska","Polk County",1,51,63,26,37
050,31,143,"Nebraska","Polk County",1,52,71,37,34
050,31,143,"Nebraska","Polk County",1,53,64,36,28
050,31,143,"Nebraska","Polk County",1,54,76,46,30
050,31,143,"Nebraska","Polk County",1,55,73,43,30
050,31,143,"Nebraska","Polk County",1,56,76,42,34
050,31,143,"Nebraska","Polk County",1,57,76,39,37
050,31,143,"Nebraska","Polk County",1,58,76,37,39
050,31,143,"Nebraska","Polk County",1,59,84,45,39
050,31,143,"Nebraska","Polk County",1,60,85,47,38
050,31,143,"Nebraska","Polk County",1,61,74,38,36
050,31,143,"Nebraska","Polk County",1,62,75,32,43
050,31,143,"Nebraska","Polk County",1,63,80,38,42
050,31,143,"Nebraska","Polk County",1,64,91,47,44
050,31,143,"Nebraska","Polk County",1,65,84,42,42
050,31,143,"Nebraska","Polk County",1,66,82,41,41
050,31,143,"Nebraska","Polk County",1,67,90,44,46
050,31,143,"Nebraska","Polk County",1,68,85,44,41
050,31,143,"Nebraska","Polk County",1,69,68,36,32
050,31,143,"Nebraska","Polk County",1,70,74,43,31
050,31,143,"Nebraska","Polk County",1,71,66,34,32
050,31,143,"Nebraska","Polk County",1,72,58,31,27
050,31,143,"Nebraska","Polk County",1,73,49,28,21
050,31,143,"Nebraska","Polk County",1,74,40,21,19
050,31,143,"Nebraska","Polk County",1,75,40,20,20
050,31,143,"Nebraska","Polk County",1,76,46,21,25
050,31,143,"Nebraska","Polk County",1,77,38,19,19
050,31,143,"Nebraska","Polk County",1,78,36,17,19
050,31,143,"Nebraska","Polk County",1,79,30,15,15
050,31,143,"Nebraska","Polk County",1,80,28,12,16
050,31,143,"Nebraska","Polk County",1,81,25,13,12
050,31,143,"Nebraska","Polk County",1,82,26,14,12
050,31,143,"Nebraska","Polk County",1,83,30,16,14
050,31,143,"Nebraska","Polk County",1,84,31,15,16
050,31,143,"Nebraska","Polk County",1,85,169,66,103
050,31,143,"Nebraska","Polk County",2,0,54,29,25
050,31,143,"Nebraska","Polk County",2,1,64,33,31
050,31,143,"Nebraska","Polk County",2,2,63,35,28
050,31,143,"Nebraska","Polk County",2,3,57,28,29
050,31,143,"Nebraska","Polk County",2,4,51,25,26
050,31,143,"Nebraska","Polk County",2,5,52,28,24
050,31,143,"Nebraska","Polk County",2,6,57,29,28
050,31,143,"Nebraska","Polk County",2,7,59,29,30
050,31,143,"Nebraska","Polk County",2,8,56,27,29
050,31,143,"Nebraska","Polk County",2,9,65,30,35
050,31,143,"Nebraska","Polk County",2,10,69,34,35
050,31,143,"Nebraska","Polk County",2,11,72,34,38
050,31,143,"Nebraska","Polk County",2,12,71,33,38
050,31,143,"Nebraska","Polk County",2,13,77,37,40
050,31,143,"Nebraska","Polk County",2,14,82,42,40
050,31,143,"Nebraska","Polk County",2,15,74,40,34
050,31,143,"Nebraska","Polk County",2,16,72,38,34
050,31,143,"Nebraska","Polk County",2,17,77,39,38
050,31,143,"Nebraska","Polk County",2,18,61,33,28
050,31,143,"Nebraska","Polk County",2,19,48,27,21
050,31,143,"Nebraska","Polk County",2,20,59,32,27
050,31,143,"Nebraska","Polk County",2,21,59,32,27
050,31,143,"Nebraska","Polk County",2,22,53,27,26
050,31,143,"Nebraska","Polk County",2,23,53,29,24
050,31,143,"Nebraska","Polk County",2,24,45,26,19
050,31,143,"Nebraska","Polk County",2,25,43,23,20
050,31,143,"Nebraska","Polk County",2,26,50,25,25
050,31,143,"Nebraska","Polk County",2,27,59,30,29
050,31,143,"Nebraska","Polk County",2,28,51,25,26
050,31,143,"Nebraska","Polk County",2,29,56,29,27
050,31,143,"Nebraska","Polk County",2,30,51,23,28
050,31,143,"Nebraska","Polk County",2,31,46,23,23
050,31,143,"Nebraska","Polk County",2,32,47,22,25
050,31,143,"Nebraska","Polk County",2,33,48,27,21
050,31,143,"Nebraska","Polk County",2,34,52,29,23
050,31,143,"Nebraska","Polk County",2,35,48,25,23
050,31,143,"Nebraska","Polk County",2,36,46,26,20
050,31,143,"Nebraska","Polk County",2,37,44,24,20
050,31,143,"Nebraska","Polk County",2,38,52,25,27
050,31,143,"Nebraska","Polk County",2,39,65,28,37
050,31,143,"Nebraska","Polk County",2,40,63,28,35
050,31,143,"Nebraska","Polk County",2,41,54,26,28
050,31,143,"Nebraska","Polk County",2,42,55,27,28
050,31,143,"Nebraska","Polk County",2,43,59,33,26
050,31,143,"Nebraska","Polk County",2,44,62,33,29
050,31,143,"Nebraska","Polk County",2,45,57,27,30
050,31,143,"Nebraska","Polk County",2,46,52,23,29
050,31,143,"Nebraska","Polk County",2,47,54,29,25
050,31,143,"Nebraska","Polk County",2,48,61,32,29
050,31,143,"Nebraska","Polk County",2,49,72,36,36
050,31,143,"Nebraska","Polk County",2,50,68,33,35
050,31,143,"Nebraska","Polk County",2,51,63,27,36
050,31,143,"Nebraska","Polk County",2,52,69,34,35
050,31,143,"Nebraska","Polk County",2,53,66,36,30
050,31,143,"Nebraska","Polk County",2,54,72,43,29
050,31,143,"Nebraska","Polk County",2,55,75,44,31
050,31,143,"Nebraska","Polk County",2,56,75,43,32
050,31,143,"Nebraska","Polk County",2,57,76,40,36
050,31,143,"Nebraska","Polk County",2,58,77,38,39
050,31,143,"Nebraska","Polk County",2,59,83,43,40
050,31,143,"Nebraska","Polk County",2,60,84,46,38
050,31,143,"Nebraska","Polk County",2,61,75,39,36
050,31,143,"Nebraska","Polk County",2,62,74,34,40
050,31,143,"Nebraska","Polk County",2,63,80,37,43
050,31,143,"Nebraska","Polk County",2,64,88,44,44
050,31,143,"Nebraska","Polk County",2,65,85,43,42
050,31,143,"Nebraska","Polk County",2,66,82,42,40
050,31,143,"Nebraska","Polk County",2,67,89,44,45
050,31,143,"Nebraska","Polk County",2,68,85,43,42
050,31,143,"Nebraska","Polk County",2,69,72,38,34
050,31,143,"Nebraska","Polk County",2,70,72,41,31
050,31,143,"Nebraska","Polk County",2,71,67,36,31
050,31,143,"Nebraska","Polk County",2,72,58,31,27
050,31,143,"Nebraska","Polk County",2,73,54,30,24
050,31,143,"Nebraska","Polk County",2,74,39,21,18
050,31,143,"Nebraska","Polk County",2,75,38,19,19
050,31,143,"Nebraska","Polk County",2,76,45,21,24
050,31,143,"Nebraska","Polk County",2,77,41,20,21
050,31,143,"Nebraska","Polk County",2,78,36,17,19
050,31,143,"Nebraska","Polk County",2,79,31,15,16
050,31,143,"Nebraska","Polk County",2,80,28,12,16
050,31,143,"Nebraska","Polk County",2,81,24,12,12
050,31,143,"Nebraska","Polk County",2,82,25,13,12
050,31,143,"Nebraska","Polk County",2,83,28,15,13
050,31,143,"Nebraska","Polk County",2,84,28,15,13
050,31,143,"Nebraska","Polk County",2,85,169,66,103
050,31,143,"Nebraska","Polk County",3,0,51,27,24
050,31,143,"Nebraska","Polk County",3,1,54,32,22
050,31,143,"Nebraska","Polk County",3,2,68,35,33
050,31,143,"Nebraska","Polk County",3,3,59,31,28
050,31,143,"Nebraska","Polk County",3,4,54,26,28
050,31,143,"Nebraska","Polk County",3,5,54,25,29
050,31,143,"Nebraska","Polk County",3,6,50,27,23
050,31,143,"Nebraska","Polk County",3,7,62,31,31
050,31,143,"Nebraska","Polk County",3,8,61,30,31
050,31,143,"Nebraska","Polk County",3,9,57,27,30
050,31,143,"Nebraska","Polk County",3,10,65,31,34
050,31,143,"Nebraska","Polk County",3,11,72,36,36
050,31,143,"Nebraska","Polk County",3,12,77,36,41
050,31,143,"Nebraska","Polk County",3,13,70,31,39
050,31,143,"Nebraska","Polk County",3,14,81,40,41
050,31,143,"Nebraska","Polk County",3,15,79,43,36
050,31,143,"Nebraska","Polk County",3,16,72,40,32
050,31,143,"Nebraska","Polk County",3,17,71,38,33
050,31,143,"Nebraska","Polk County",3,18,67,38,29
050,31,143,"Nebraska","Polk County",3,19,44,24,20
050,31,143,"Nebraska","Polk County",3,20,54,30,24
050,31,143,"Nebraska","Polk County",3,21,61,33,28
050,31,143,"Nebraska","Polk County",3,22,50,28,22
050,31,143,"Nebraska","Polk County",3,23,54,28,26
050,31,143,"Nebraska","Polk County",3,24,53,31,22
050,31,143,"Nebraska","Polk County",3,25,44,26,18
050,31,143,"Nebraska","Polk County",3,26,49,28,21
050,31,143,"Nebraska","Polk County",3,27,52,27,25
050,31,143,"Nebraska","Polk County",3,28,53,23,30
050,31,143,"Nebraska","Polk County",3,29,46,23,23
050,31,143,"Nebraska","Polk County",3,30,60,30,30
050,31,143,"Nebraska","Polk County",3,31,50,26,24
050,31,143,"Nebraska","Polk County",3,32,48,25,23
050,31,143,"Nebraska","Polk County",3,33,50,23,27
050,31,143,"Nebraska","Polk County",3,34,47,25,22
050,31,143,"Nebraska","Polk County",3,35,49,28,21
050,31,143,"Nebraska","Polk County",3,36,50,29,21
050,31,143,"Nebraska","Polk County",3,37,47,24,23
050,31,143,"Nebraska","Polk County",3,38,42,22,20
050,31,143,"Nebraska","Polk County",3,39,56,27,29
050,31,143,"Nebraska","Polk County",3,40,67,28,39
050,31,143,"Nebraska","Polk County",3,41,61,26,35
050,31,143,"Nebraska","Polk County",3,42,52,23,29
050,31,143,"Nebraska","Polk County",3,43,58,29,29
050,31,143,"Nebraska","Polk County",3,44,58,30,28
050,31,143,"Nebraska","Polk County",3,45,64,33,31
050,31,143,"Nebraska","Polk County",3,46,56,27,29
050,31,143,"Nebraska","Polk County",3,47,54,24,30
050,31,143,"Nebraska","Polk County",3,48,56,30,26
050,31,143,"Nebraska","Polk County",3,49,61,32,29
050,31,143,"Nebraska","Polk County",3,50,70,35,35
050,31,143,"Nebraska","Polk County",3,51,66,31,35
050,31,143,"Nebraska","Polk County",3,52,64,27,37
050,31,143,"Nebraska","Polk County",3,53,66,34,32
050,31,143,"Nebraska","Polk County",3,54,67,36,31
050,31,143,"Nebraska","Polk County",3,55,67,41,26
050,31,143,"Nebraska","Polk County",3,56,73,42,31
050,31,143,"Nebraska","Polk County",3,57,79,44,35
050,31,143,"Nebraska","Polk County",3,58,71,36,35
050,31,143,"Nebraska","Polk County",3,59,80,38,42
050,31,143,"Nebraska","Polk County",3,60,86,47,39
050,31,143,"Nebraska","Polk County",3,61,80,43,37
050,31,143,"Nebraska","Polk County",3,62,74,41,33
050,31,143,"Nebraska","Polk County",3,63,76,35,41
050,31,143,"Nebraska","Polk County",3,64,86,41,45
050,31,143,"Nebraska","Polk County",3,65,83,43,40
050,31,143,"Nebraska","Polk County",3,66,82,41,41
050,31,143,"Nebraska","Polk County",3,67,82,42,40
050,31,143,"Nebraska","Polk County",3,68,86,43,43
050,31,143,"Nebraska","Polk County",3,69,84,42,42
050,31,143,"Nebraska","Polk County",3,70,69,36,33
050,31,143,"Nebraska","Polk County",3,71,73,41,32
050,31,143,"Nebraska","Polk County",3,72,64,35,29
050,31,143,"Nebraska","Polk County",3,73,56,31,25
050,31,143,"Nebraska","Polk County",3,74,48,27,21
050,31,143,"Nebraska","Polk County",3,75,38,20,18
050,31,143,"Nebraska","Polk County",3,76,36,18,18
050,31,143,"Nebraska","Polk County",3,77,39,15,24
050,31,143,"Nebraska","Polk County",3,78,40,18,22
050,31,143,"Nebraska","Polk County",3,79,35,16,19
050,31,143,"Nebraska","Polk County",3,80,28,13,15
050,31,143,"Nebraska","Polk County",3,81,29,13,16
050,31,143,"Nebraska","Polk County",3,82,23,12,11
050,31,143,"Nebraska","Polk County",3,83,28,13,15
050,31,143,"Nebraska","Polk County",3,84,23,12,11
050,31,143,"Nebraska","Polk County",3,85,170,71,99
050,31,143,"Nebraska","Polk County",4,0,54,25,29
050,31,143,"Nebraska","Polk County",4,1,52,28,24
050,31,143,"Nebraska","Polk County",4,2,53,30,23
050,31,143,"Nebraska","Polk County",4,3,76,37,39
050,31,143,"Nebraska","Polk County",4,4,55,30,25
050,31,143,"Nebraska","Polk County",4,5,68,34,34
050,31,143,"Nebraska","Polk County",4,6,54,26,28
050,31,143,"Nebraska","Polk County",4,7,53,27,26
050,31,143,"Nebraska","Polk County",4,8,63,30,33
050,31,143,"Nebraska","Polk County",4,9,57,30,27
050,31,143,"Nebraska","Polk County",4,10,58,29,29
050,31,143,"Nebraska","Polk County",4,11,63,30,33
050,31,143,"Nebraska","Polk County",4,12,70,36,34
050,31,143,"Nebraska","Polk County",4,13,79,38,41
050,31,143,"Nebraska","Polk County",4,14,74,32,42
050,31,143,"Nebraska","Polk County",4,15,83,39,44
050,31,143,"Nebraska","Polk County",4,16,85,44,41
050,31,143,"Nebraska","Polk County",4,17,75,41,34
050,31,143,"Nebraska","Polk County",4,18,69,41,28
050,31,143,"Nebraska","Polk County",4,19,52,27,25
050,31,143,"Nebraska","Polk County",4,20,47,25,22
050,31,143,"Nebraska","Polk County",4,21,54,29,25
050,31,143,"Nebraska","Polk County",4,22,63,31,32
050,31,143,"Nebraska","Polk County",4,23,45,22,23
050,31,143,"Nebraska","Polk County",4,24,57,31,26
050,31,143,"Nebraska","Polk County",4,25,55,27,28
050,31,143,"Nebraska","Polk County",4,26,46,26,20
050,31,143,"Nebraska","Polk County",4,27,51,31,20
050,31,143,"Nebraska","Polk County",4,28,54,26,28
050,31,143,"Nebraska","Polk County",4,29,58,28,30
050,31,143,"Nebraska","Polk County",4,30,53,26,27
050,31,143,"Nebraska","Polk County",4,31,59,33,26
050,31,143,"Nebraska","Polk County",4,32,47,25,22
050,31,143,"Nebraska","Polk County",4,33,50,26,24
050,31,143,"Nebraska","Polk County",4,34,55,28,27
050,31,143,"Nebraska","Polk County",4,35,48,25,23
050,31,143,"Nebraska","Polk County",4,36,52,30,22
050,31,143,"Nebraska","Polk County",4,37,55,33,22
050,31,143,"Nebraska","Polk County",4,38,51,25,26
050,31,143,"Nebraska","Polk County",4,39,48,27,21
050,31,143,"Nebraska","Polk County",4,40,57,27,30
050,31,143,"Nebraska","Polk County",4,41,69,30,39
050,31,143,"Nebraska","Polk County",4,42,58,23,35
050,31,143,"Nebraska","Polk County",4,43,53,23,30
050,31,143,"Nebraska","Polk County",4,44,58,32,26
050,31,143,"Nebraska","Polk County",4,45,61,32,29
050,31,143,"Nebraska","Polk County",4,46,62,30,32
050,31,143,"Nebraska","Polk County",4,47,51,24,27
050,31,143,"Nebraska","Polk County",4,48,49,21,28
050,31,143,"Nebraska","Polk County",4,49,57,30,27
050,31,143,"Nebraska","Polk County",4,50,59,32,27
050,31,143,"Nebraska","Polk County",4,51,70,36,34
050,31,143,"Nebraska","Polk County",4,52,66,31,35
050,31,143,"Nebraska","Polk County",4,53,60,27,33
050,31,143,"Nebraska","Polk County",4,54,64,33,31
050,31,143,"Nebraska","Polk County",4,55,66,36,30
050,31,143,"Nebraska","Polk County",4,56,64,39,25
050,31,143,"Nebraska","Polk County",4,57,74,42,32
050,31,143,"Nebraska","Polk County",4,58,73,40,33
050,31,143,"Nebraska","Polk County",4,59,75,36,39
050,31,143,"Nebraska","Polk County",4,60,79,38,41
050,31,143,"Nebraska","Polk County",4,61,87,46,41
050,31,143,"Nebraska","Polk County",4,62,78,42,36
050,31,143,"Nebraska","Polk County",4,63,74,43,31
050,31,143,"Nebraska","Polk County",4,64,77,35,42
050,31,143,"Nebraska","Polk County",4,65,82,42,40
050,31,143,"Nebraska","Polk County",4,66,84,44,40
050,31,143,"Nebraska","Polk County",4,67,90,44,46
050,31,143,"Nebraska","Polk County",4,68,82,42,40
050,31,143,"Nebraska","Polk County",4,69,84,42,42
050,31,143,"Nebraska","Polk County",4,70,82,41,41
050,31,143,"Nebraska","Polk County",4,71,65,31,34
050,31,143,"Nebraska","Polk County",4,72,70,39,31
050,31,143,"Nebraska","Polk County",4,73,63,34,29
050,31,143,"Nebraska","Polk County",4,74,55,29,26
050,31,143,"Nebraska","Polk County",4,75,46,26,20
050,31,143,"Nebraska","Polk County",4,76,37,21,16
050,31,143,"Nebraska","Polk County",4,77,33,16,17
050,31,143,"Nebraska","Polk County",4,78,37,13,24
050,31,143,"Nebraska","Polk County",4,79,40,17,23
050,31,143,"Nebraska","Polk County",4,80,33,15,18
050,31,143,"Nebraska","Polk County",4,81,28,13,15
050,31,143,"Nebraska","Polk County",4,82,26,12,14
050,31,143,"Nebraska","Polk County",4,83,26,12,14
050,31,143,"Nebraska","Polk County",4,84,23,10,13
050,31,143,"Nebraska","Polk County",4,85,172,73,99
050,31,143,"Nebraska","Polk County",5,0,54,25,29
050,31,143,"Nebraska","Polk County",5,1,53,24,29
050,31,143,"Nebraska","Polk County",5,2,51,23,28
050,31,143,"Nebraska","Polk County",5,3,54,28,26
050,31,143,"Nebraska","Polk County",5,4,79,39,40
050,31,143,"Nebraska","Polk County",5,5,56,30,26
050,31,143,"Nebraska","Polk County",5,6,64,34,30
050,31,143,"Nebraska","Polk County",5,7,58,28,30
050,31,143,"Nebraska","Polk County",5,8,57,29,28
050,31,143,"Nebraska","Polk County",5,9,64,30,34
050,31,143,"Nebraska","Polk County",5,10,59,32,27
050,31,143,"Nebraska","Polk County",5,11,58,32,26
050,31,143,"Nebraska","Polk County",5,12,64,34,30
050,31,143,"Nebraska","Polk County",5,13,68,33,35
050,31,143,"Nebraska","Polk County",5,14,81,37,44
050,31,143,"Nebraska","Polk County",5,15,70,30,40
050,31,143,"Nebraska","Polk County",5,16,83,41,42
050,31,143,"Nebraska","Polk County",5,17,89,45,44
050,31,143,"Nebraska","Polk County",5,18,65,41,24
050,31,143,"Nebraska","Polk County",5,19,51,31,20
050,31,143,"Nebraska","Polk County",5,20,54,29,25
050,31,143,"Nebraska","Polk County",5,21,46,22,24
050,31,143,"Nebraska","Polk County",5,22,44,23,21
050,31,143,"Nebraska","Polk County",5,23,65,34,31
050,31,143,"Nebraska","Polk County",5,24,42,20,22
050,31,143,"Nebraska","Polk County",5,25,58,30,28
050,31,143,"Nebraska","Polk County",5,26,55,29,26
050,31,143,"Nebraska","Polk County",5,27,53,30,23
050,31,143,"Nebraska","Polk County",5,28,49,28,21
050,31,143,"Nebraska","Polk County",5,29,54,29,25
050,31,143,"Nebraska","Polk County",5,30,62,35,27
050,31,143,"Nebraska","Polk County",5,31,56,28,28
050,31,143,"Nebraska","Polk County",5,32,59,32,27
050,31,143,"Nebraska","Polk County",5,33,47,23,24
050,31,143,"Nebraska","Polk County",5,34,53,29,24
050,31,143,"Nebraska","Polk County",5,35,59,31,28
050,31,143,"Nebraska","Polk County",5,36,52,26,26
050,31,143,"Nebraska","Polk County",5,37,57,34,23
050,31,143,"Nebraska","Polk County",5,38,56,34,22
050,31,143,"Nebraska","Polk County",5,39,49,26,23
050,31,143,"Nebraska","Polk County",5,40,55,35,20
050,31,143,"Nebraska","Polk County",5,41,59,28,31
050,31,143,"Nebraska","Polk County",5,42,63,26,37
050,31,143,"Nebraska","Polk County",5,43,55,23,32
050,31,143,"Nebraska","Polk County",5,44,49,21,28
050,31,143,"Nebraska","Polk County",5,45,57,32,25
050,31,143,"Nebraska","Polk County",5,46,60,31,29
050,31,143,"Nebraska","Polk County",5,47,60,27,33
050,31,143,"Nebraska","Polk County",5,48,47,24,23
050,31,143,"Nebraska","Polk County",5,49,52,23,29
050,31,143,"Nebraska","Polk County",5,50,57,30,27
050,31,143,"Nebraska","Polk County",5,51,62,33,29
050,31,143,"Nebraska","Polk County",5,52,72,37,35
050,31,143,"Nebraska","Polk County",5,53,66,30,36
050,31,143,"Nebraska","Polk County",5,54,60,27,33
050,31,143,"Nebraska","Polk County",5,55,68,36,32
050,31,143,"Nebraska","Polk County",5,56,65,36,29
050,31,143,"Nebraska","Polk County",5,57,64,39,25
050,31,143,"Nebraska","Polk County",5,58,76,41,35
050,31,143,"Nebraska","Polk County",5,59,76,42,34
050,31,143,"Nebraska","Polk County",5,60,70,36,34
050,31,143,"Nebraska","Polk County",5,61,79,38,41
050,31,143,"Nebraska","Polk County",5,62,89,49,40
050,31,143,"Nebraska","Polk County",5,63,78,42,36
050,31,143,"Nebraska","Polk County",5,64,81,46,35
050,31,143,"Nebraska","Polk County",5,65,73,34,39
050,31,143,"Nebraska","Polk County",5,66,79,41,38
050,31,143,"Nebraska","Polk County",5,67,82,43,39
050,31,143,"Nebraska","Polk County",5,68,89,44,45
050,31,143,"Nebraska","Polk County",5,69,82,44,38
050,31,143,"Nebraska","Polk County",5,70,80,41,39
050,31,143,"Nebraska","Polk County",5,71,76,37,39
050,31,143,"Nebraska","Polk County",5,72,57,27,30
050,31,143,"Nebraska","Polk County",5,73,69,39,30
050,31,143,"Nebraska","Polk County",5,74,63,33,30
050,31,143,"Nebraska","Polk County",5,75,54,29,25
050,31,143,"Nebraska","Polk County",5,76,44,26,18
050,31,143,"Nebraska","Polk County",5,77,33,18,15
050,31,143,"Nebraska","Polk County",5,78,31,14,17
050,31,143,"Nebraska","Polk County",5,79,35,12,23
050,31,143,"Nebraska","Polk County",5,80,37,16,21
050,31,143,"Nebraska","Polk County",5,81,30,14,16
050,31,143,"Nebraska","Polk County",5,82,26,12,14
050,31,143,"Nebraska","Polk County",5,83,29,12,17
050,31,143,"Nebraska","Polk County",5,84,21,9,12
050,31,143,"Nebraska","Polk County",5,85,170,68,102
050,31,145,"Nebraska","Red Willow County",1,0,134,68,66
050,31,145,"Nebraska","Red Willow County",1,1,131,63,68
050,31,145,"Nebraska","Red Willow County",1,2,132,69,63
050,31,145,"Nebraska","Red Willow County",1,3,150,75,75
050,31,145,"Nebraska","Red Willow County",1,4,132,62,70
050,31,145,"Nebraska","Red Willow County",1,5,109,61,48
050,31,145,"Nebraska","Red Willow County",1,6,124,69,55
050,31,145,"Nebraska","Red Willow County",1,7,132,78,54
050,31,145,"Nebraska","Red Willow County",1,8,132,65,67
050,31,145,"Nebraska","Red Willow County",1,9,141,74,67
050,31,145,"Nebraska","Red Willow County",1,10,141,79,62
050,31,145,"Nebraska","Red Willow County",1,11,123,62,61
050,31,145,"Nebraska","Red Willow County",1,12,135,63,72
050,31,145,"Nebraska","Red Willow County",1,13,133,58,75
050,31,145,"Nebraska","Red Willow County",1,14,147,68,79
050,31,145,"Nebraska","Red Willow County",1,15,146,67,79
050,31,145,"Nebraska","Red Willow County",1,16,145,72,73
050,31,145,"Nebraska","Red Willow County",1,17,142,77,65
050,31,145,"Nebraska","Red Willow County",1,18,136,78,58
050,31,145,"Nebraska","Red Willow County",1,19,126,70,56
050,31,145,"Nebraska","Red Willow County",1,20,120,78,42
050,31,145,"Nebraska","Red Willow County",1,21,117,72,45
050,31,145,"Nebraska","Red Willow County",1,22,110,64,46
050,31,145,"Nebraska","Red Willow County",1,23,128,68,60
050,31,145,"Nebraska","Red Willow County",1,24,124,66,58
050,31,145,"Nebraska","Red Willow County",1,25,135,66,69
050,31,145,"Nebraska","Red Willow County",1,26,125,64,61
050,31,145,"Nebraska","Red Willow County",1,27,115,61,54
050,31,145,"Nebraska","Red Willow County",1,28,123,65,58
050,31,145,"Nebraska","Red Willow County",1,29,126,64,62
050,31,145,"Nebraska","Red Willow County",1,30,112,58,54
050,31,145,"Nebraska","Red Willow County",1,31,114,61,53
050,31,145,"Nebraska","Red Willow County",1,32,105,50,55
050,31,145,"Nebraska","Red Willow County",1,33,121,60,61
050,31,145,"Nebraska","Red Willow County",1,34,129,65,64
050,31,145,"Nebraska","Red Willow County",1,35,126,68,58
050,31,145,"Nebraska","Red Willow County",1,36,128,59,69
050,31,145,"Nebraska","Red Willow County",1,37,144,79,65
050,31,145,"Nebraska","Red Willow County",1,38,125,66,59
050,31,145,"Nebraska","Red Willow County",1,39,136,68,68
050,31,145,"Nebraska","Red Willow County",1,40,147,80,67
050,31,145,"Nebraska","Red Willow County",1,41,138,75,63
050,31,145,"Nebraska","Red Willow County",1,42,103,56,47
050,31,145,"Nebraska","Red Willow County",1,43,101,49,52
050,31,145,"Nebraska","Red Willow County",1,44,114,52,62
050,31,145,"Nebraska","Red Willow County",1,45,100,44,56
050,31,145,"Nebraska","Red Willow County",1,46,103,51,52
050,31,145,"Nebraska","Red Willow County",1,47,100,50,50
050,31,145,"Nebraska","Red Willow County",1,48,118,64,54
050,31,145,"Nebraska","Red Willow County",1,49,133,72,61
050,31,145,"Nebraska","Red Willow County",1,50,125,64,61
050,31,145,"Nebraska","Red Willow County",1,51,115,68,47
050,31,145,"Nebraska","Red Willow County",1,52,105,61,44
050,31,145,"Nebraska","Red Willow County",1,53,115,54,61
050,31,145,"Nebraska","Red Willow County",1,54,106,57,49
050,31,145,"Nebraska","Red Willow County",1,55,128,66,62
050,31,145,"Nebraska","Red Willow County",1,56,141,73,68
050,31,145,"Nebraska","Red Willow County",1,57,155,73,82
050,31,145,"Nebraska","Red Willow County",1,58,176,82,94
050,31,145,"Nebraska","Red Willow County",1,59,177,88,89
050,31,145,"Nebraska","Red Willow County",1,60,176,92,84
050,31,145,"Nebraska","Red Willow County",1,61,165,84,81
050,31,145,"Nebraska","Red Willow County",1,62,168,80,88
050,31,145,"Nebraska","Red Willow County",1,63,136,68,68
050,31,145,"Nebraska","Red Willow County",1,64,153,73,80
050,31,145,"Nebraska","Red Willow County",1,65,146,76,70
050,31,145,"Nebraska","Red Willow County",1,66,147,73,74
050,31,145,"Nebraska","Red Willow County",1,67,156,74,82
050,31,145,"Nebraska","Red Willow County",1,68,129,62,67
050,31,145,"Nebraska","Red Willow County",1,69,131,69,62
050,31,145,"Nebraska","Red Willow County",1,70,124,60,64
050,31,145,"Nebraska","Red Willow County",1,71,102,55,47
050,31,145,"Nebraska","Red Willow County",1,72,111,61,50
050,31,145,"Nebraska","Red Willow County",1,73,106,53,53
050,31,145,"Nebraska","Red Willow County",1,74,59,29,30
050,31,145,"Nebraska","Red Willow County",1,75,57,23,34
050,31,145,"Nebraska","Red Willow County",1,76,73,35,38
050,31,145,"Nebraska","Red Willow County",1,77,82,39,43
050,31,145,"Nebraska","Red Willow County",1,78,70,35,35
050,31,145,"Nebraska","Red Willow County",1,79,68,28,40
050,31,145,"Nebraska","Red Willow County",1,80,82,32,50
050,31,145,"Nebraska","Red Willow County",1,81,74,30,44
050,31,145,"Nebraska","Red Willow County",1,82,73,30,43
050,31,145,"Nebraska","Red Willow County",1,83,55,22,33
050,31,145,"Nebraska","Red Willow County",1,84,50,14,36
050,31,145,"Nebraska","Red Willow County",1,85,354,128,226
050,31,145,"Nebraska","Red Willow County",2,0,141,67,74
050,31,145,"Nebraska","Red Willow County",2,1,129,63,66
050,31,145,"Nebraska","Red Willow County",2,2,132,66,66
050,31,145,"Nebraska","Red Willow County",2,3,145,72,73
050,31,145,"Nebraska","Red Willow County",2,4,134,64,70
050,31,145,"Nebraska","Red Willow County",2,5,114,62,52
050,31,145,"Nebraska","Red Willow County",2,6,121,68,53
050,31,145,"Nebraska","Red Willow County",2,7,129,75,54
050,31,145,"Nebraska","Red Willow County",2,8,132,68,64
050,31,145,"Nebraska","Red Willow County",2,9,139,72,67
050,31,145,"Nebraska","Red Willow County",2,10,140,77,63
050,31,145,"Nebraska","Red Willow County",2,11,125,64,61
050,31,145,"Nebraska","Red Willow County",2,12,132,62,70
050,31,145,"Nebraska","Red Willow County",2,13,134,59,75
050,31,145,"Nebraska","Red Willow County",2,14,143,65,78
050,31,145,"Nebraska","Red Willow County",2,15,145,66,79
050,31,145,"Nebraska","Red Willow County",2,16,145,71,74
050,31,145,"Nebraska","Red Willow County",2,17,144,77,67
050,31,145,"Nebraska","Red Willow County",2,18,134,78,56
050,31,145,"Nebraska","Red Willow County",2,19,125,71,54
050,31,145,"Nebraska","Red Willow County",2,20,124,78,46
050,31,145,"Nebraska","Red Willow County",2,21,115,70,45
050,31,145,"Nebraska","Red Willow County",2,22,113,66,47
050,31,145,"Nebraska","Red Willow County",2,23,127,70,57
050,31,145,"Nebraska","Red Willow County",2,24,125,66,59
050,31,145,"Nebraska","Red Willow County",2,25,132,66,66
050,31,145,"Nebraska","Red Willow County",2,26,123,60,63
050,31,145,"Nebraska","Red Willow County",2,27,117,61,56
050,31,145,"Nebraska","Red Willow County",2,28,122,65,57
050,31,145,"Nebraska","Red Willow County",2,29,125,64,61
050,31,145,"Nebraska","Red Willow County",2,30,114,58,56
050,31,145,"Nebraska","Red Willow County",2,31,113,59,54
050,31,145,"Nebraska","Red Willow County",2,32,108,54,54
050,31,145,"Nebraska","Red Willow County",2,33,117,57,60
050,31,145,"Nebraska","Red Willow County",2,34,130,67,63
050,31,145,"Nebraska","Red Willow County",2,35,127,66,61
050,31,145,"Nebraska","Red Willow County",2,36,126,60,66
050,31,145,"Nebraska","Red Willow County",2,37,140,74,66
050,31,145,"Nebraska","Red Willow County",2,38,131,70,61
050,31,145,"Nebraska","Red Willow County",2,39,133,67,66
050,31,145,"Nebraska","Red Willow County",2,40,145,77,68
050,31,145,"Nebraska","Red Willow County",2,41,140,77,63
050,31,145,"Nebraska","Red Willow County",2,42,111,61,50
050,31,145,"Nebraska","Red Willow County",2,43,99,49,50
050,31,145,"Nebraska","Red Willow County",2,44,110,52,58
050,31,145,"Nebraska","Red Willow County",2,45,104,46,58
050,31,145,"Nebraska","Red Willow County",2,46,100,50,50
050,31,145,"Nebraska","Red Willow County",2,47,98,48,50
050,31,145,"Nebraska","Red Willow County",2,48,112,60,52
050,31,145,"Nebraska","Red Willow County",2,49,131,72,59
050,31,145,"Nebraska","Red Willow County",2,50,126,65,61
050,31,145,"Nebraska","Red Willow County",2,51,117,67,50
050,31,145,"Nebraska","Red Willow County",2,52,106,61,45
050,31,145,"Nebraska","Red Willow County",2,53,112,55,57
050,31,145,"Nebraska","Red Willow County",2,54,107,56,51
050,31,145,"Nebraska","Red Willow County",2,55,123,64,59
050,31,145,"Nebraska","Red Willow County",2,56,138,72,66
050,31,145,"Nebraska","Red Willow County",2,57,151,73,78
050,31,145,"Nebraska","Red Willow County",2,58,171,80,91
050,31,145,"Nebraska","Red Willow County",2,59,178,87,91
050,31,145,"Nebraska","Red Willow County",2,60,176,92,84
050,31,145,"Nebraska","Red Willow County",2,61,167,86,81
050,31,145,"Nebraska","Red Willow County",2,62,165,81,84
050,31,145,"Nebraska","Red Willow County",2,63,145,71,74
050,31,145,"Nebraska","Red Willow County",2,64,147,71,76
050,31,145,"Nebraska","Red Willow County",2,65,147,75,72
050,31,145,"Nebraska","Red Willow County",2,66,144,73,71
050,31,145,"Nebraska","Red Willow County",2,67,153,73,80
050,31,145,"Nebraska","Red Willow County",2,68,133,63,70
050,31,145,"Nebraska","Red Willow County",2,69,130,67,63
050,31,145,"Nebraska","Red Willow County",2,70,126,62,64
050,31,145,"Nebraska","Red Willow County",2,71,107,56,51
050,31,145,"Nebraska","Red Willow County",2,72,105,57,48
050,31,145,"Nebraska","Red Willow County",2,73,113,57,56
050,31,145,"Nebraska","Red Willow County",2,74,63,32,31
050,31,145,"Nebraska","Red Willow County",2,75,58,24,34
050,31,145,"Nebraska","Red Willow County",2,76,68,32,36
050,31,145,"Nebraska","Red Willow County",2,77,83,39,44
050,31,145,"Nebraska","Red Willow County",2,78,71,36,35
050,31,145,"Nebraska","Red Willow County",2,79,68,30,38
050,31,145,"Nebraska","Red Willow County",2,80,77,31,46
050,31,145,"Nebraska","Red Willow County",2,81,75,29,46
050,31,145,"Nebraska","Red Willow County",2,82,73,30,43
050,31,145,"Nebraska","Red Willow County",2,83,59,24,35
050,31,145,"Nebraska","Red Willow County",2,84,51,15,36
050,31,145,"Nebraska","Red Willow County",2,85,354,127,227
050,31,145,"Nebraska","Red Willow County",3,0,122,54,68
050,31,145,"Nebraska","Red Willow County",3,1,143,69,74
050,31,145,"Nebraska","Red Willow County",3,2,133,65,68
050,31,145,"Nebraska","Red Willow County",3,3,137,71,66
050,31,145,"Nebraska","Red Willow County",3,4,137,71,66
050,31,145,"Nebraska","Red Willow County",3,5,137,65,72
050,31,145,"Nebraska","Red Willow County",3,6,118,65,53
050,31,145,"Nebraska","Red Willow County",3,7,120,64,56
050,31,145,"Nebraska","Red Willow County",3,8,122,70,52
050,31,145,"Nebraska","Red Willow County",3,9,132,70,62
050,31,145,"Nebraska","Red Willow County",3,10,140,72,68
050,31,145,"Nebraska","Red Willow County",3,11,137,74,63
050,31,145,"Nebraska","Red Willow County",3,12,132,69,63
050,31,145,"Nebraska","Red Willow County",3,13,126,58,68
050,31,145,"Nebraska","Red Willow County",3,14,132,57,75
050,31,145,"Nebraska","Red Willow County",3,15,138,67,71
050,31,145,"Nebraska","Red Willow County",3,16,145,68,77
050,31,145,"Nebraska","Red Willow County",3,17,144,68,76
050,31,145,"Nebraska","Red Willow County",3,18,131,74,57
050,31,145,"Nebraska","Red Willow County",3,19,123,79,44
050,31,145,"Nebraska","Red Willow County",3,20,130,75,55
050,31,145,"Nebraska","Red Willow County",3,21,108,60,48
050,31,145,"Nebraska","Red Willow County",3,22,122,67,55
050,31,145,"Nebraska","Red Willow County",3,23,110,66,44
050,31,145,"Nebraska","Red Willow County",3,24,129,68,61
050,31,145,"Nebraska","Red Willow County",3,25,134,72,62
050,31,145,"Nebraska","Red Willow County",3,26,135,64,71
050,31,145,"Nebraska","Red Willow County",3,27,117,58,59
050,31,145,"Nebraska","Red Willow County",3,28,118,61,57
050,31,145,"Nebraska","Red Willow County",3,29,133,77,56
050,31,145,"Nebraska","Red Willow County",3,30,123,62,61
050,31,145,"Nebraska","Red Willow County",3,31,117,58,59
050,31,145,"Nebraska","Red Willow County",3,32,120,65,55
050,31,145,"Nebraska","Red Willow County",3,33,107,52,55
050,31,145,"Nebraska","Red Willow County",3,34,115,60,55
050,31,145,"Nebraska","Red Willow County",3,35,125,60,65
050,31,145,"Nebraska","Red Willow County",3,36,127,66,61
050,31,145,"Nebraska","Red Willow County",3,37,127,59,68
050,31,145,"Nebraska","Red Willow County",3,38,142,77,65
050,31,145,"Nebraska","Red Willow County",3,39,141,77,64
050,31,145,"Nebraska","Red Willow County",3,40,123,63,60
050,31,145,"Nebraska","Red Willow County",3,41,144,75,69
050,31,145,"Nebraska","Red Willow County",3,42,142,75,67
050,31,145,"Nebraska","Red Willow County",3,43,113,65,48
050,31,145,"Nebraska","Red Willow County",3,44,98,51,47
050,31,145,"Nebraska","Red Willow County",3,45,107,48,59
050,31,145,"Nebraska","Red Willow County",3,46,103,50,53
050,31,145,"Nebraska","Red Willow County",3,47,96,44,52
050,31,145,"Nebraska","Red Willow County",3,48,97,47,50
050,31,145,"Nebraska","Red Willow County",3,49,116,63,53
050,31,145,"Nebraska","Red Willow County",3,50,124,66,58
050,31,145,"Nebraska","Red Willow County",3,51,135,73,62
050,31,145,"Nebraska","Red Willow County",3,52,115,63,52
050,31,145,"Nebraska","Red Willow County",3,53,101,58,43
050,31,145,"Nebraska","Red Willow County",3,54,115,60,55
050,31,145,"Nebraska","Red Willow County",3,55,99,52,47
050,31,145,"Nebraska","Red Willow County",3,56,125,63,62
050,31,145,"Nebraska","Red Willow County",3,57,137,69,68
050,31,145,"Nebraska","Red Willow County",3,58,145,68,77
050,31,145,"Nebraska","Red Willow County",3,59,174,83,91
050,31,145,"Nebraska","Red Willow County",3,60,177,84,93
050,31,145,"Nebraska","Red Willow County",3,61,178,97,81
050,31,145,"Nebraska","Red Willow County",3,62,160,82,78
050,31,145,"Nebraska","Red Willow County",3,63,160,78,82
050,31,145,"Nebraska","Red Willow County",3,64,141,67,74
050,31,145,"Nebraska","Red Willow County",3,65,143,70,73
050,31,145,"Nebraska","Red Willow County",3,66,145,74,71
050,31,145,"Nebraska","Red Willow County",3,67,145,72,73
050,31,145,"Nebraska","Red Willow County",3,68,149,68,81
050,31,145,"Nebraska","Red Willow County",3,69,130,63,67
050,31,145,"Nebraska","Red Willow County",3,70,127,65,62
050,31,145,"Nebraska","Red Willow County",3,71,122,58,64
050,31,145,"Nebraska","Red Willow County",3,72,106,55,51
050,31,145,"Nebraska","Red Willow County",3,73,102,53,49
050,31,145,"Nebraska","Red Willow County",3,74,109,55,54
050,31,145,"Nebraska","Red Willow County",3,75,59,27,32
050,31,145,"Nebraska","Red Willow County",3,76,57,22,35
050,31,145,"Nebraska","Red Willow County",3,77,73,34,39
050,31,145,"Nebraska","Red Willow County",3,78,74,34,40
050,31,145,"Nebraska","Red Willow County",3,79,69,33,36
050,31,145,"Nebraska","Red Willow County",3,80,62,30,32
050,31,145,"Nebraska","Red Willow County",3,81,71,28,43
050,31,145,"Nebraska","Red Willow County",3,82,70,26,44
050,31,145,"Nebraska","Red Willow County",3,83,71,30,41
050,31,145,"Nebraska","Red Willow County",3,84,55,22,33
050,31,145,"Nebraska","Red Willow County",3,85,327,112,215
050,31,145,"Nebraska","Red Willow County",4,0,113,54,59
050,31,145,"Nebraska","Red Willow County",4,1,119,57,62
050,31,145,"Nebraska","Red Willow County",4,2,142,63,79
050,31,145,"Nebraska","Red Willow County",4,3,126,62,64
050,31,145,"Nebraska","Red Willow County",4,4,133,70,63
050,31,145,"Nebraska","Red Willow County",4,5,139,71,68
050,31,145,"Nebraska","Red Willow County",4,6,135,69,66
050,31,145,"Nebraska","Red Willow County",4,7,125,66,59
050,31,145,"Nebraska","Red Willow County",4,8,121,64,57
050,31,145,"Nebraska","Red Willow County",4,9,131,72,59
050,31,145,"Nebraska","Red Willow County",4,10,130,65,65
050,31,145,"Nebraska","Red Willow County",4,11,146,74,72
050,31,145,"Nebraska","Red Willow County",4,12,133,73,60
050,31,145,"Nebraska","Red Willow County",4,13,140,74,66
050,31,145,"Nebraska","Red Willow County",4,14,134,68,66
050,31,145,"Nebraska","Red Willow County",4,15,133,59,74
050,31,145,"Nebraska","Red Willow County",4,16,139,72,67
050,31,145,"Nebraska","Red Willow County",4,17,148,70,78
050,31,145,"Nebraska","Red Willow County",4,18,136,72,64
050,31,145,"Nebraska","Red Willow County",4,19,113,71,42
050,31,145,"Nebraska","Red Willow County",4,20,122,73,49
050,31,145,"Nebraska","Red Willow County",4,21,108,55,53
050,31,145,"Nebraska","Red Willow County",4,22,112,57,55
050,31,145,"Nebraska","Red Willow County",4,23,127,76,51
050,31,145,"Nebraska","Red Willow County",4,24,117,63,54
050,31,145,"Nebraska","Red Willow County",4,25,123,66,57
050,31,145,"Nebraska","Red Willow County",4,26,127,67,60
050,31,145,"Nebraska","Red Willow County",4,27,122,56,66
050,31,145,"Nebraska","Red Willow County",4,28,124,63,61
050,31,145,"Nebraska","Red Willow County",4,29,114,62,52
050,31,145,"Nebraska","Red Willow County",4,30,122,68,54
050,31,145,"Nebraska","Red Willow County",4,31,132,63,69
050,31,145,"Nebraska","Red Willow County",4,32,115,58,57
050,31,145,"Nebraska","Red Willow County",4,33,121,63,58
050,31,145,"Nebraska","Red Willow County",4,34,114,59,55
050,31,145,"Nebraska","Red Willow County",4,35,113,56,57
050,31,145,"Nebraska","Red Willow County",4,36,124,56,68
050,31,145,"Nebraska","Red Willow County",4,37,119,65,54
050,31,145,"Nebraska","Red Willow County",4,38,121,57,64
050,31,145,"Nebraska","Red Willow County",4,39,141,74,67
050,31,145,"Nebraska","Red Willow County",4,40,144,78,66
050,31,145,"Nebraska","Red Willow County",4,41,128,66,62
050,31,145,"Nebraska","Red Willow County",4,42,148,81,67
050,31,145,"Nebraska","Red Willow County",4,43,135,75,60
050,31,145,"Nebraska","Red Willow County",4,44,112,68,44
050,31,145,"Nebraska","Red Willow County",4,45,106,51,55
050,31,145,"Nebraska","Red Willow County",4,46,111,55,56
050,31,145,"Nebraska","Red Willow County",4,47,97,41,56
050,31,145,"Nebraska","Red Willow County",4,48,98,44,54
050,31,145,"Nebraska","Red Willow County",4,49,97,46,51
050,31,145,"Nebraska","Red Willow County",4,50,111,59,52
050,31,145,"Nebraska","Red Willow County",4,51,125,67,58
050,31,145,"Nebraska","Red Willow County",4,52,130,66,64
050,31,145,"Nebraska","Red Willow County",4,53,116,62,54
050,31,145,"Nebraska","Red Willow County",4,54,107,63,44
050,31,145,"Nebraska","Red Willow County",4,55,115,59,56
050,31,145,"Nebraska","Red Willow County",4,56,100,54,46
050,31,145,"Nebraska","Red Willow County",4,57,123,61,62
050,31,145,"Nebraska","Red Willow County",4,58,135,67,68
050,31,145,"Nebraska","Red Willow County",4,59,146,73,73
050,31,145,"Nebraska","Red Willow County",4,60,177,80,97
050,31,145,"Nebraska","Red Willow County",4,61,172,82,90
050,31,145,"Nebraska","Red Willow County",4,62,176,94,82
050,31,145,"Nebraska","Red Willow County",4,63,156,80,76
050,31,145,"Nebraska","Red Willow County",4,64,159,80,79
050,31,145,"Nebraska","Red Willow County",4,65,140,65,75
050,31,145,"Nebraska","Red Willow County",4,66,138,66,72
050,31,145,"Nebraska","Red Willow County",4,67,145,75,70
050,31,145,"Nebraska","Red Willow County",4,68,144,72,72
050,31,145,"Nebraska","Red Willow County",4,69,145,65,80
050,31,145,"Nebraska","Red Willow County",4,70,123,56,67
050,31,145,"Nebraska","Red Willow County",4,71,126,63,63
050,31,145,"Nebraska","Red Willow County",4,72,115,55,60
050,31,145,"Nebraska","Red Willow County",4,73,106,55,51
050,31,145,"Nebraska","Red Willow County",4,74,99,52,47
050,31,145,"Nebraska","Red Willow County",4,75,104,52,52
050,31,145,"Nebraska","Red Willow County",4,76,58,27,31
050,31,145,"Nebraska","Red Willow County",4,77,60,24,36
050,31,145,"Nebraska","Red Willow County",4,78,63,28,35
050,31,145,"Nebraska","Red Willow County",4,79,72,32,40
050,31,145,"Nebraska","Red Willow County",4,80,65,34,31
050,31,145,"Nebraska","Red Willow County",4,81,53,28,25
050,31,145,"Nebraska","Red Willow County",4,82,61,22,39
050,31,145,"Nebraska","Red Willow County",4,83,67,25,42
050,31,145,"Nebraska","Red Willow County",4,84,65,25,40
050,31,145,"Nebraska","Red Willow County",4,85,301,105,196
050,31,145,"Nebraska","Red Willow County",5,0,107,52,55
050,31,145,"Nebraska","Red Willow County",5,1,111,51,60
050,31,145,"Nebraska","Red Willow County",5,2,122,59,63
050,31,145,"Nebraska","Red Willow County",5,3,143,58,85
050,31,145,"Nebraska","Red Willow County",5,4,125,66,59
050,31,145,"Nebraska","Red Willow County",5,5,132,72,60
050,31,145,"Nebraska","Red Willow County",5,6,138,70,68
050,31,145,"Nebraska","Red Willow County",5,7,137,69,68
050,31,145,"Nebraska","Red Willow County",5,8,123,67,56
050,31,145,"Nebraska","Red Willow County",5,9,118,63,55
050,31,145,"Nebraska","Red Willow County",5,10,128,68,60
050,31,145,"Nebraska","Red Willow County",5,11,129,67,62
050,31,145,"Nebraska","Red Willow County",5,12,146,72,74
050,31,145,"Nebraska","Red Willow County",5,13,135,72,63
050,31,145,"Nebraska","Red Willow County",5,14,140,70,70
050,31,145,"Nebraska","Red Willow County",5,15,136,68,68
050,31,145,"Nebraska","Red Willow County",5,16,138,62,76
050,31,145,"Nebraska","Red Willow County",5,17,139,75,64
050,31,145,"Nebraska","Red Willow County",5,18,130,65,65
050,31,145,"Nebraska","Red Willow County",5,19,125,73,52
050,31,145,"Nebraska","Red Willow County",5,20,115,74,41
050,31,145,"Nebraska","Red Willow County",5,21,110,61,49
050,31,145,"Nebraska","Red Willow County",5,22,114,53,61
050,31,145,"Nebraska","Red Willow County",5,23,125,65,60
050,31,145,"Nebraska","Red Willow County",5,24,124,68,56
050,31,145,"Nebraska","Red Willow County",5,25,122,68,54
050,31,145,"Nebraska","Red Willow County",5,26,125,67,58
050,31,145,"Nebraska","Red Willow County",5,27,112,61,51
050,31,145,"Nebraska","Red Willow County",5,28,125,60,65
050,31,145,"Nebraska","Red Willow County",5,29,133,69,64
050,31,145,"Nebraska","Red Willow County",5,30,110,61,49
050,31,145,"Nebraska","Red Willow County",5,31,128,68,60
050,31,145,"Nebraska","Red Willow County",5,32,121,60,61
050,31,145,"Nebraska","Red Willow County",5,33,116,60,56
050,31,145,"Nebraska","Red Willow County",5,34,125,68,57
050,31,145,"Nebraska","Red Willow County",5,35,115,58,57
050,31,145,"Nebraska","Red Willow County",5,36,111,52,59
050,31,145,"Nebraska","Red Willow County",5,37,124,61,63
050,31,145,"Nebraska","Red Willow County",5,38,113,60,53
050,31,145,"Nebraska","Red Willow County",5,39,119,55,64
050,31,145,"Nebraska","Red Willow County",5,40,142,73,69
050,31,145,"Nebraska","Red Willow County",5,41,147,79,68
050,31,145,"Nebraska","Red Willow County",5,42,128,69,59
050,31,145,"Nebraska","Red Willow County",5,43,136,71,65
050,31,145,"Nebraska","Red Willow County",5,44,137,77,60
050,31,145,"Nebraska","Red Willow County",5,45,111,64,47
050,31,145,"Nebraska","Red Willow County",5,46,108,55,53
050,31,145,"Nebraska","Red Willow County",5,47,114,54,60
050,31,145,"Nebraska","Red Willow County",5,48,96,41,55
050,31,145,"Nebraska","Red Willow County",5,49,99,47,52
050,31,145,"Nebraska","Red Willow County",5,50,91,42,49
050,31,145,"Nebraska","Red Willow County",5,51,107,56,51
050,31,145,"Nebraska","Red Willow County",5,52,120,63,57
050,31,145,"Nebraska","Red Willow County",5,53,130,65,65
050,31,145,"Nebraska","Red Willow County",5,54,118,67,51
050,31,145,"Nebraska","Red Willow County",5,55,108,63,45
050,31,145,"Nebraska","Red Willow County",5,56,122,65,57
050,31,145,"Nebraska","Red Willow County",5,57,99,52,47
050,31,145,"Nebraska","Red Willow County",5,58,122,62,60
050,31,145,"Nebraska","Red Willow County",5,59,139,71,68
050,31,145,"Nebraska","Red Willow County",5,60,149,72,77
050,31,145,"Nebraska","Red Willow County",5,61,175,81,94
050,31,145,"Nebraska","Red Willow County",5,62,166,78,88
050,31,145,"Nebraska","Red Willow County",5,63,175,93,82
050,31,145,"Nebraska","Red Willow County",5,64,157,81,76
050,31,145,"Nebraska","Red Willow County",5,65,157,77,80
050,31,145,"Nebraska","Red Willow County",5,66,135,61,74
050,31,145,"Nebraska","Red Willow County",5,67,137,66,71
050,31,145,"Nebraska","Red Willow County",5,68,141,72,69
050,31,145,"Nebraska","Red Willow County",5,69,142,71,71
050,31,145,"Nebraska","Red Willow County",5,70,139,58,81
050,31,145,"Nebraska","Red Willow County",5,71,124,57,67
050,31,145,"Nebraska","Red Willow County",5,72,118,55,63
050,31,145,"Nebraska","Red Willow County",5,73,111,52,59
050,31,145,"Nebraska","Red Willow County",5,74,102,54,48
050,31,145,"Nebraska","Red Willow County",5,75,95,47,48
050,31,145,"Nebraska","Red Willow County",5,76,99,49,50
050,31,145,"Nebraska","Red Willow County",5,77,60,28,32
050,31,145,"Nebraska","Red Willow County",5,78,50,20,30
050,31,145,"Nebraska","Red Willow County",5,79,62,26,36
050,31,145,"Nebraska","Red Willow County",5,80,68,29,39
050,31,145,"Nebraska","Red Willow County",5,81,57,32,25
050,31,145,"Nebraska","Red Willow County",5,82,49,25,24
050,31,145,"Nebraska","Red Willow County",5,83,59,22,37
050,31,145,"Nebraska","Red Willow County",5,84,65,24,41
050,31,145,"Nebraska","Red Willow County",5,85,302,102,200
050,31,147,"Nebraska","Richardson County",1,0,86,44,42
050,31,147,"Nebraska","Richardson County",1,1,91,49,42
050,31,147,"Nebraska","Richardson County",1,2,91,49,42
050,31,147,"Nebraska","Richardson County",1,3,77,39,38
050,31,147,"Nebraska","Richardson County",1,4,79,44,35
050,31,147,"Nebraska","Richardson County",1,5,106,58,48
050,31,147,"Nebraska","Richardson County",1,6,109,62,47
050,31,147,"Nebraska","Richardson County",1,7,93,49,44
050,31,147,"Nebraska","Richardson County",1,8,89,40,49
050,31,147,"Nebraska","Richardson County",1,9,97,47,50
050,31,147,"Nebraska","Richardson County",1,10,96,50,46
050,31,147,"Nebraska","Richardson County",1,11,100,56,44
050,31,147,"Nebraska","Richardson County",1,12,106,58,48
050,31,147,"Nebraska","Richardson County",1,13,91,49,42
050,31,147,"Nebraska","Richardson County",1,14,90,40,50
050,31,147,"Nebraska","Richardson County",1,15,93,46,47
050,31,147,"Nebraska","Richardson County",1,16,105,59,46
050,31,147,"Nebraska","Richardson County",1,17,109,60,49
050,31,147,"Nebraska","Richardson County",1,18,89,48,41
050,31,147,"Nebraska","Richardson County",1,19,60,34,26
050,31,147,"Nebraska","Richardson County",1,20,82,45,37
050,31,147,"Nebraska","Richardson County",1,21,82,44,38
050,31,147,"Nebraska","Richardson County",1,22,71,33,38
050,31,147,"Nebraska","Richardson County",1,23,73,39,34
050,31,147,"Nebraska","Richardson County",1,24,75,34,41
050,31,147,"Nebraska","Richardson County",1,25,76,34,42
050,31,147,"Nebraska","Richardson County",1,26,79,40,39
050,31,147,"Nebraska","Richardson County",1,27,78,45,33
050,31,147,"Nebraska","Richardson County",1,28,67,36,31
050,31,147,"Nebraska","Richardson County",1,29,70,38,32
050,31,147,"Nebraska","Richardson County",1,30,68,34,34
050,31,147,"Nebraska","Richardson County",1,31,59,34,25
050,31,147,"Nebraska","Richardson County",1,32,68,36,32
050,31,147,"Nebraska","Richardson County",1,33,81,39,42
050,31,147,"Nebraska","Richardson County",1,34,95,39,56
050,31,147,"Nebraska","Richardson County",1,35,86,44,42
050,31,147,"Nebraska","Richardson County",1,36,90,49,41
050,31,147,"Nebraska","Richardson County",1,37,85,42,43
050,31,147,"Nebraska","Richardson County",1,38,83,40,43
050,31,147,"Nebraska","Richardson County",1,39,78,39,39
050,31,147,"Nebraska","Richardson County",1,40,84,40,44
050,31,147,"Nebraska","Richardson County",1,41,87,43,44
050,31,147,"Nebraska","Richardson County",1,42,75,46,29
050,31,147,"Nebraska","Richardson County",1,43,74,39,35
050,31,147,"Nebraska","Richardson County",1,44,71,37,34
050,31,147,"Nebraska","Richardson County",1,45,74,42,32
050,31,147,"Nebraska","Richardson County",1,46,71,38,33
050,31,147,"Nebraska","Richardson County",1,47,92,42,50
050,31,147,"Nebraska","Richardson County",1,48,90,41,49
050,31,147,"Nebraska","Richardson County",1,49,94,47,47
050,31,147,"Nebraska","Richardson County",1,50,85,40,45
050,31,147,"Nebraska","Richardson County",1,51,83,42,41
050,31,147,"Nebraska","Richardson County",1,52,87,48,39
050,31,147,"Nebraska","Richardson County",1,53,95,45,50
050,31,147,"Nebraska","Richardson County",1,54,101,50,51
050,31,147,"Nebraska","Richardson County",1,55,121,65,56
050,31,147,"Nebraska","Richardson County",1,56,123,60,63
050,31,147,"Nebraska","Richardson County",1,57,125,60,65
050,31,147,"Nebraska","Richardson County",1,58,127,68,59
050,31,147,"Nebraska","Richardson County",1,59,139,75,64
050,31,147,"Nebraska","Richardson County",1,60,144,75,69
050,31,147,"Nebraska","Richardson County",1,61,133,67,66
050,31,147,"Nebraska","Richardson County",1,62,142,70,72
050,31,147,"Nebraska","Richardson County",1,63,139,73,66
050,31,147,"Nebraska","Richardson County",1,64,116,59,57
050,31,147,"Nebraska","Richardson County",1,65,112,59,53
050,31,147,"Nebraska","Richardson County",1,66,107,54,53
050,31,147,"Nebraska","Richardson County",1,67,110,57,53
050,31,147,"Nebraska","Richardson County",1,68,123,60,63
050,31,147,"Nebraska","Richardson County",1,69,110,52,58
050,31,147,"Nebraska","Richardson County",1,70,101,49,52
050,31,147,"Nebraska","Richardson County",1,71,95,48,47
050,31,147,"Nebraska","Richardson County",1,72,89,47,42
050,31,147,"Nebraska","Richardson County",1,73,88,46,42
050,31,147,"Nebraska","Richardson County",1,74,73,30,43
050,31,147,"Nebraska","Richardson County",1,75,76,35,41
050,31,147,"Nebraska","Richardson County",1,76,68,34,34
050,31,147,"Nebraska","Richardson County",1,77,70,32,38
050,31,147,"Nebraska","Richardson County",1,78,72,37,35
050,31,147,"Nebraska","Richardson County",1,79,52,26,26
050,31,147,"Nebraska","Richardson County",1,80,50,27,23
050,31,147,"Nebraska","Richardson County",1,81,39,17,22
050,31,147,"Nebraska","Richardson County",1,82,46,19,27
050,31,147,"Nebraska","Richardson County",1,83,49,24,25
050,31,147,"Nebraska","Richardson County",1,84,48,26,22
050,31,147,"Nebraska","Richardson County",1,85,319,115,204
050,31,147,"Nebraska","Richardson County",2,0,85,39,46
050,31,147,"Nebraska","Richardson County",2,1,90,48,42
050,31,147,"Nebraska","Richardson County",2,2,92,50,42
050,31,147,"Nebraska","Richardson County",2,3,78,41,37
050,31,147,"Nebraska","Richardson County",2,4,79,43,36
050,31,147,"Nebraska","Richardson County",2,5,101,56,45
050,31,147,"Nebraska","Richardson County",2,6,107,60,47
050,31,147,"Nebraska","Richardson County",2,7,96,52,44
050,31,147,"Nebraska","Richardson County",2,8,90,42,48
050,31,147,"Nebraska","Richardson County",2,9,95,46,49
050,31,147,"Nebraska","Richardson County",2,10,99,50,49
050,31,147,"Nebraska","Richardson County",2,11,99,53,46
050,31,147,"Nebraska","Richardson County",2,12,104,58,46
050,31,147,"Nebraska","Richardson County",2,13,95,52,43
050,31,147,"Nebraska","Richardson County",2,14,89,41,48
050,31,147,"Nebraska","Richardson County",2,15,92,45,47
050,31,147,"Nebraska","Richardson County",2,16,103,56,47
050,31,147,"Nebraska","Richardson County",2,17,109,60,49
050,31,147,"Nebraska","Richardson County",2,18,90,49,41
050,31,147,"Nebraska","Richardson County",2,19,63,34,29
050,31,147,"Nebraska","Richardson County",2,20,81,45,36
050,31,147,"Nebraska","Richardson County",2,21,82,44,38
050,31,147,"Nebraska","Richardson County",2,22,72,34,38
050,31,147,"Nebraska","Richardson County",2,23,74,38,36
050,31,147,"Nebraska","Richardson County",2,24,76,35,41
050,31,147,"Nebraska","Richardson County",2,25,77,36,41
050,31,147,"Nebraska","Richardson County",2,26,76,38,38
050,31,147,"Nebraska","Richardson County",2,27,78,44,34
050,31,147,"Nebraska","Richardson County",2,28,69,38,31
050,31,147,"Nebraska","Richardson County",2,29,69,37,32
050,31,147,"Nebraska","Richardson County",2,30,69,35,34
050,31,147,"Nebraska","Richardson County",2,31,62,34,28
050,31,147,"Nebraska","Richardson County",2,32,66,35,31
050,31,147,"Nebraska","Richardson County",2,33,78,39,39
050,31,147,"Nebraska","Richardson County",2,34,92,39,53
050,31,147,"Nebraska","Richardson County",2,35,89,44,45
050,31,147,"Nebraska","Richardson County",2,36,87,47,40
050,31,147,"Nebraska","Richardson County",2,37,84,42,42
050,31,147,"Nebraska","Richardson County",2,38,85,41,44
050,31,147,"Nebraska","Richardson County",2,39,79,39,40
050,31,147,"Nebraska","Richardson County",2,40,84,39,45
050,31,147,"Nebraska","Richardson County",2,41,87,43,44
050,31,147,"Nebraska","Richardson County",2,42,75,44,31
050,31,147,"Nebraska","Richardson County",2,43,75,41,34
050,31,147,"Nebraska","Richardson County",2,44,71,37,34
050,31,147,"Nebraska","Richardson County",2,45,73,41,32
050,31,147,"Nebraska","Richardson County",2,46,73,40,33
050,31,147,"Nebraska","Richardson County",2,47,87,41,46
050,31,147,"Nebraska","Richardson County",2,48,91,42,49
050,31,147,"Nebraska","Richardson County",2,49,94,46,48
050,31,147,"Nebraska","Richardson County",2,50,86,41,45
050,31,147,"Nebraska","Richardson County",2,51,83,42,41
050,31,147,"Nebraska","Richardson County",2,52,85,46,39
050,31,147,"Nebraska","Richardson County",2,53,92,45,47
050,31,147,"Nebraska","Richardson County",2,54,100,49,51
050,31,147,"Nebraska","Richardson County",2,55,117,61,56
050,31,147,"Nebraska","Richardson County",2,56,123,61,62
050,31,147,"Nebraska","Richardson County",2,57,127,61,66
050,31,147,"Nebraska","Richardson County",2,58,125,65,60
050,31,147,"Nebraska","Richardson County",2,59,136,73,63
050,31,147,"Nebraska","Richardson County",2,60,142,74,68
050,31,147,"Nebraska","Richardson County",2,61,134,68,66
050,31,147,"Nebraska","Richardson County",2,62,140,70,70
050,31,147,"Nebraska","Richardson County",2,63,141,73,68
050,31,147,"Nebraska","Richardson County",2,64,121,62,59
050,31,147,"Nebraska","Richardson County",2,65,112,59,53
050,31,147,"Nebraska","Richardson County",2,66,109,55,54
050,31,147,"Nebraska","Richardson County",2,67,109,56,53
050,31,147,"Nebraska","Richardson County",2,68,120,59,61
050,31,147,"Nebraska","Richardson County",2,69,112,53,59
050,31,147,"Nebraska","Richardson County",2,70,102,49,53
050,31,147,"Nebraska","Richardson County",2,71,98,49,49
050,31,147,"Nebraska","Richardson County",2,72,87,45,42
050,31,147,"Nebraska","Richardson County",2,73,90,46,44
050,31,147,"Nebraska","Richardson County",2,74,71,31,40
050,31,147,"Nebraska","Richardson County",2,75,75,34,41
050,31,147,"Nebraska","Richardson County",2,76,67,32,35
050,31,147,"Nebraska","Richardson County",2,77,71,33,38
050,31,147,"Nebraska","Richardson County",2,78,68,34,34
050,31,147,"Nebraska","Richardson County",2,79,56,28,28
050,31,147,"Nebraska","Richardson County",2,80,50,27,23
050,31,147,"Nebraska","Richardson County",2,81,41,19,22
050,31,147,"Nebraska","Richardson County",2,82,46,19,27
050,31,147,"Nebraska","Richardson County",2,83,46,21,25
050,31,147,"Nebraska","Richardson County",2,84,50,26,24
050,31,147,"Nebraska","Richardson County",2,85,319,117,202
050,31,147,"Nebraska","Richardson County",3,0,80,43,37
050,31,147,"Nebraska","Richardson County",3,1,89,42,47
050,31,147,"Nebraska","Richardson County",3,2,91,50,41
050,31,147,"Nebraska","Richardson County",3,3,95,53,42
050,31,147,"Nebraska","Richardson County",3,4,83,44,39
050,31,147,"Nebraska","Richardson County",3,5,81,43,38
050,31,147,"Nebraska","Richardson County",3,6,101,54,47
050,31,147,"Nebraska","Richardson County",3,7,106,59,47
050,31,147,"Nebraska","Richardson County",3,8,96,51,45
050,31,147,"Nebraska","Richardson County",3,9,94,42,52
050,31,147,"Nebraska","Richardson County",3,10,102,51,51
050,31,147,"Nebraska","Richardson County",3,11,102,51,51
050,31,147,"Nebraska","Richardson County",3,12,97,54,43
050,31,147,"Nebraska","Richardson County",3,13,105,60,45
050,31,147,"Nebraska","Richardson County",3,14,101,57,44
050,31,147,"Nebraska","Richardson County",3,15,90,43,47
050,31,147,"Nebraska","Richardson County",3,16,95,46,49
050,31,147,"Nebraska","Richardson County",3,17,101,52,49
050,31,147,"Nebraska","Richardson County",3,18,93,56,37
050,31,147,"Nebraska","Richardson County",3,19,69,40,29
050,31,147,"Nebraska","Richardson County",3,20,69,34,35
050,31,147,"Nebraska","Richardson County",3,21,82,45,37
050,31,147,"Nebraska","Richardson County",3,22,77,44,33
050,31,147,"Nebraska","Richardson County",3,23,75,36,39
050,31,147,"Nebraska","Richardson County",3,24,71,37,34
050,31,147,"Nebraska","Richardson County",3,25,74,32,42
050,31,147,"Nebraska","Richardson County",3,26,68,32,36
050,31,147,"Nebraska","Richardson County",3,27,83,43,40
050,31,147,"Nebraska","Richardson County",3,28,76,45,31
050,31,147,"Nebraska","Richardson County",3,29,69,34,35
050,31,147,"Nebraska","Richardson County",3,30,70,39,31
050,31,147,"Nebraska","Richardson County",3,31,65,32,33
050,31,147,"Nebraska","Richardson County",3,32,59,34,25
050,31,147,"Nebraska","Richardson County",3,33,77,41,36
050,31,147,"Nebraska","Richardson County",3,34,80,38,42
050,31,147,"Nebraska","Richardson County",3,35,91,38,53
050,31,147,"Nebraska","Richardson County",3,36,90,43,47
050,31,147,"Nebraska","Richardson County",3,37,87,46,41
050,31,147,"Nebraska","Richardson County",3,38,83,41,42
050,31,147,"Nebraska","Richardson County",3,39,82,40,42
050,31,147,"Nebraska","Richardson County",3,40,82,38,44
050,31,147,"Nebraska","Richardson County",3,41,86,42,44
050,31,147,"Nebraska","Richardson County",3,42,90,47,43
050,31,147,"Nebraska","Richardson County",3,43,75,45,30
050,31,147,"Nebraska","Richardson County",3,44,78,43,35
050,31,147,"Nebraska","Richardson County",3,45,68,35,33
050,31,147,"Nebraska","Richardson County",3,46,73,43,30
050,31,147,"Nebraska","Richardson County",3,47,72,40,32
050,31,147,"Nebraska","Richardson County",3,48,82,37,45
050,31,147,"Nebraska","Richardson County",3,49,89,40,49
050,31,147,"Nebraska","Richardson County",3,50,90,41,49
050,31,147,"Nebraska","Richardson County",3,51,86,42,44
050,31,147,"Nebraska","Richardson County",3,52,78,38,40
050,31,147,"Nebraska","Richardson County",3,53,84,45,39
050,31,147,"Nebraska","Richardson County",3,54,93,45,48
050,31,147,"Nebraska","Richardson County",3,55,97,48,49
050,31,147,"Nebraska","Richardson County",3,56,120,64,56
050,31,147,"Nebraska","Richardson County",3,57,124,62,62
050,31,147,"Nebraska","Richardson County",3,58,124,60,64
050,31,147,"Nebraska","Richardson County",3,59,125,65,60
050,31,147,"Nebraska","Richardson County",3,60,134,71,63
050,31,147,"Nebraska","Richardson County",3,61,138,74,64
050,31,147,"Nebraska","Richardson County",3,62,129,64,65
050,31,147,"Nebraska","Richardson County",3,63,134,66,68
050,31,147,"Nebraska","Richardson County",3,64,138,71,67
050,31,147,"Nebraska","Richardson County",3,65,121,61,60
050,31,147,"Nebraska","Richardson County",3,66,115,60,55
050,31,147,"Nebraska","Richardson County",3,67,100,51,49
050,31,147,"Nebraska","Richardson County",3,68,111,53,58
050,31,147,"Nebraska","Richardson County",3,69,114,60,54
050,31,147,"Nebraska","Richardson County",3,70,109,49,60
050,31,147,"Nebraska","Richardson County",3,71,99,48,51
050,31,147,"Nebraska","Richardson County",3,72,95,49,46
050,31,147,"Nebraska","Richardson County",3,73,86,42,44
050,31,147,"Nebraska","Richardson County",3,74,85,41,44
050,31,147,"Nebraska","Richardson County",3,75,66,29,37
050,31,147,"Nebraska","Richardson County",3,76,71,32,39
050,31,147,"Nebraska","Richardson County",3,77,63,30,33
050,31,147,"Nebraska","Richardson County",3,78,71,34,37
050,31,147,"Nebraska","Richardson County",3,79,63,32,31
050,31,147,"Nebraska","Richardson County",3,80,52,24,28
050,31,147,"Nebraska","Richardson County",3,81,49,26,23
050,31,147,"Nebraska","Richardson County",3,82,32,16,16
050,31,147,"Nebraska","Richardson County",3,83,39,17,22
050,31,147,"Nebraska","Richardson County",3,84,47,17,30
050,31,147,"Nebraska","Richardson County",3,85,310,118,192
050,31,147,"Nebraska","Richardson County",4,0,71,35,36
050,31,147,"Nebraska","Richardson County",4,1,76,42,34
050,31,147,"Nebraska","Richardson County",4,2,88,39,49
050,31,147,"Nebraska","Richardson County",4,3,91,50,41
050,31,147,"Nebraska","Richardson County",4,4,97,54,43
050,31,147,"Nebraska","Richardson County",4,5,83,44,39
050,31,147,"Nebraska","Richardson County",4,6,81,42,39
050,31,147,"Nebraska","Richardson County",4,7,98,54,44
050,31,147,"Nebraska","Richardson County",4,8,108,63,45
050,31,147,"Nebraska","Richardson County",4,9,94,52,42
050,31,147,"Nebraska","Richardson County",4,10,95,43,52
050,31,147,"Nebraska","Richardson County",4,11,106,54,52
050,31,147,"Nebraska","Richardson County",4,12,105,54,51
050,31,147,"Nebraska","Richardson County",4,13,95,54,41
050,31,147,"Nebraska","Richardson County",4,14,102,58,44
050,31,147,"Nebraska","Richardson County",4,15,111,59,52
050,31,147,"Nebraska","Richardson County",4,16,83,39,44
050,31,147,"Nebraska","Richardson County",4,17,99,50,49
050,31,147,"Nebraska","Richardson County",4,18,84,42,42
050,31,147,"Nebraska","Richardson County",4,19,74,46,28
050,31,147,"Nebraska","Richardson County",4,20,69,39,30
050,31,147,"Nebraska","Richardson County",4,21,70,34,36
050,31,147,"Nebraska","Richardson County",4,22,86,43,43
050,31,147,"Nebraska","Richardson County",4,23,71,40,31
050,31,147,"Nebraska","Richardson County",4,24,71,33,38
050,31,147,"Nebraska","Richardson County",4,25,69,37,32
050,31,147,"Nebraska","Richardson County",4,26,71,32,39
050,31,147,"Nebraska","Richardson County",4,27,66,34,32
050,31,147,"Nebraska","Richardson County",4,28,84,42,42
050,31,147,"Nebraska","Richardson County",4,29,78,41,37
050,31,147,"Nebraska","Richardson County",4,30,69,35,34
050,31,147,"Nebraska","Richardson County",4,31,76,39,37
050,31,147,"Nebraska","Richardson County",4,32,68,34,34
050,31,147,"Nebraska","Richardson County",4,33,60,35,25
050,31,147,"Nebraska","Richardson County",4,34,73,36,37
050,31,147,"Nebraska","Richardson County",4,35,82,42,40
050,31,147,"Nebraska","Richardson County",4,36,98,42,56
050,31,147,"Nebraska","Richardson County",4,37,91,45,46
050,31,147,"Nebraska","Richardson County",4,38,92,51,41
050,31,147,"Nebraska","Richardson County",4,39,82,40,42
050,31,147,"Nebraska","Richardson County",4,40,78,38,40
050,31,147,"Nebraska","Richardson County",4,41,85,39,46
050,31,147,"Nebraska","Richardson County",4,42,98,49,49
050,31,147,"Nebraska","Richardson County",4,43,90,48,42
050,31,147,"Nebraska","Richardson County",4,44,76,46,30
050,31,147,"Nebraska","Richardson County",4,45,80,40,40
050,31,147,"Nebraska","Richardson County",4,46,65,34,31
050,31,147,"Nebraska","Richardson County",4,47,75,44,31
050,31,147,"Nebraska","Richardson County",4,48,71,40,31
050,31,147,"Nebraska","Richardson County",4,49,83,38,45
050,31,147,"Nebraska","Richardson County",4,50,89,39,50
050,31,147,"Nebraska","Richardson County",4,51,91,42,49
050,31,147,"Nebraska","Richardson County",4,52,89,46,43
050,31,147,"Nebraska","Richardson County",4,53,81,37,44
050,31,147,"Nebraska","Richardson County",4,54,82,42,40
050,31,147,"Nebraska","Richardson County",4,55,90,44,46
050,31,147,"Nebraska","Richardson County",4,56,98,49,49
050,31,147,"Nebraska","Richardson County",4,57,120,65,55
050,31,147,"Nebraska","Richardson County",4,58,123,61,62
050,31,147,"Nebraska","Richardson County",4,59,125,61,64
050,31,147,"Nebraska","Richardson County",4,60,123,62,61
050,31,147,"Nebraska","Richardson County",4,61,132,73,59
050,31,147,"Nebraska","Richardson County",4,62,136,74,62
050,31,147,"Nebraska","Richardson County",4,63,125,63,62
050,31,147,"Nebraska","Richardson County",4,64,133,63,70
050,31,147,"Nebraska","Richardson County",4,65,146,76,70
050,31,147,"Nebraska","Richardson County",4,66,121,61,60
050,31,147,"Nebraska","Richardson County",4,67,110,59,51
050,31,147,"Nebraska","Richardson County",4,68,95,45,50
050,31,147,"Nebraska","Richardson County",4,69,109,54,55
050,31,147,"Nebraska","Richardson County",4,70,107,55,52
050,31,147,"Nebraska","Richardson County",4,71,106,46,60
050,31,147,"Nebraska","Richardson County",4,72,96,47,49
050,31,147,"Nebraska","Richardson County",4,73,89,45,44
050,31,147,"Nebraska","Richardson County",4,74,77,37,40
050,31,147,"Nebraska","Richardson County",4,75,80,39,41
050,31,147,"Nebraska","Richardson County",4,76,66,28,38
050,31,147,"Nebraska","Richardson County",4,77,65,29,36
050,31,147,"Nebraska","Richardson County",4,78,61,26,35
050,31,147,"Nebraska","Richardson County",4,79,67,31,36
050,31,147,"Nebraska","Richardson County",4,80,61,30,31
050,31,147,"Nebraska","Richardson County",4,81,50,23,27
050,31,147,"Nebraska","Richardson County",4,82,39,22,17
050,31,147,"Nebraska","Richardson County",4,83,29,15,14
050,31,147,"Nebraska","Richardson County",4,84,43,15,28
050,31,147,"Nebraska","Richardson County",4,85,308,111,197
050,31,147,"Nebraska","Richardson County",5,0,71,33,38
050,31,147,"Nebraska","Richardson County",5,1,70,32,38
050,31,147,"Nebraska","Richardson County",5,2,79,42,37
050,31,147,"Nebraska","Richardson County",5,3,89,42,47
050,31,147,"Nebraska","Richardson County",5,4,85,47,38
050,31,147,"Nebraska","Richardson County",5,5,105,61,44
050,31,147,"Nebraska","Richardson County",5,6,79,41,38
050,31,147,"Nebraska","Richardson County",5,7,82,42,40
050,31,147,"Nebraska","Richardson County",5,8,99,55,44
050,31,147,"Nebraska","Richardson County",5,9,111,64,47
050,31,147,"Nebraska","Richardson County",5,10,95,57,38
050,31,147,"Nebraska","Richardson County",5,11,91,44,47
050,31,147,"Nebraska","Richardson County",5,12,108,52,56
050,31,147,"Nebraska","Richardson County",5,13,102,53,49
050,31,147,"Nebraska","Richardson County",5,14,96,51,45
050,31,147,"Nebraska","Richardson County",5,15,103,58,45
050,31,147,"Nebraska","Richardson County",5,16,105,58,47
050,31,147,"Nebraska","Richardson County",5,17,87,41,46
050,31,147,"Nebraska","Richardson County",5,18,77,41,36
050,31,147,"Nebraska","Richardson County",5,19,62,36,26
050,31,147,"Nebraska","Richardson County",5,20,75,45,30
050,31,147,"Nebraska","Richardson County",5,21,71,38,33
050,31,147,"Nebraska","Richardson County",5,22,71,33,38
050,31,147,"Nebraska","Richardson County",5,23,91,46,45
050,31,147,"Nebraska","Richardson County",5,24,70,40,30
050,31,147,"Nebraska","Richardson County",5,25,79,37,42
050,31,147,"Nebraska","Richardson County",5,26,74,41,33
050,31,147,"Nebraska","Richardson County",5,27,70,32,38
050,31,147,"Nebraska","Richardson County",5,28,73,36,37
050,31,147,"Nebraska","Richardson County",5,29,90,44,46
050,31,147,"Nebraska","Richardson County",5,30,83,44,39
050,31,147,"Nebraska","Richardson County",5,31,70,38,32
050,31,147,"Nebraska","Richardson County",5,32,76,38,38
050,31,147,"Nebraska","Richardson County",5,33,68,34,34
050,31,147,"Nebraska","Richardson County",5,34,67,40,27
050,31,147,"Nebraska","Richardson County",5,35,78,39,39
050,31,147,"Nebraska","Richardson County",5,36,80,40,40
050,31,147,"Nebraska","Richardson County",5,37,97,43,54
050,31,147,"Nebraska","Richardson County",5,38,90,43,47
050,31,147,"Nebraska","Richardson County",5,39,93,53,40
050,31,147,"Nebraska","Richardson County",5,40,82,39,43
050,31,147,"Nebraska","Richardson County",5,41,80,39,41
050,31,147,"Nebraska","Richardson County",5,42,82,36,46
050,31,147,"Nebraska","Richardson County",5,43,93,45,48
050,31,147,"Nebraska","Richardson County",5,44,86,45,41
050,31,147,"Nebraska","Richardson County",5,45,76,48,28
050,31,147,"Nebraska","Richardson County",5,46,81,42,39
050,31,147,"Nebraska","Richardson County",5,47,63,29,34
050,31,147,"Nebraska","Richardson County",5,48,74,43,31
050,31,147,"Nebraska","Richardson County",5,49,72,41,31
050,31,147,"Nebraska","Richardson County",5,50,87,37,50
050,31,147,"Nebraska","Richardson County",5,51,86,38,48
050,31,147,"Nebraska","Richardson County",5,52,88,39,49
050,31,147,"Nebraska","Richardson County",5,53,88,44,44
050,31,147,"Nebraska","Richardson County",5,54,77,34,43
050,31,147,"Nebraska","Richardson County",5,55,81,43,38
050,31,147,"Nebraska","Richardson County",5,56,94,45,49
050,31,147,"Nebraska","Richardson County",5,57,96,49,47
050,31,147,"Nebraska","Richardson County",5,58,123,65,58
050,31,147,"Nebraska","Richardson County",5,59,125,63,62
050,31,147,"Nebraska","Richardson County",5,60,129,62,67
050,31,147,"Nebraska","Richardson County",5,61,120,61,59
050,31,147,"Nebraska","Richardson County",5,62,132,73,59
050,31,147,"Nebraska","Richardson County",5,63,131,73,58
050,31,147,"Nebraska","Richardson County",5,64,122,60,62
050,31,147,"Nebraska","Richardson County",5,65,133,65,68
050,31,147,"Nebraska","Richardson County",5,66,148,77,71
050,31,147,"Nebraska","Richardson County",5,67,116,62,54
050,31,147,"Nebraska","Richardson County",5,68,106,53,53
050,31,147,"Nebraska","Richardson County",5,69,96,47,49
050,31,147,"Nebraska","Richardson County",5,70,105,51,54
050,31,147,"Nebraska","Richardson County",5,71,106,55,51
050,31,147,"Nebraska","Richardson County",5,72,103,46,57
050,31,147,"Nebraska","Richardson County",5,73,92,43,49
050,31,147,"Nebraska","Richardson County",5,74,86,42,44
050,31,147,"Nebraska","Richardson County",5,75,73,35,38
050,31,147,"Nebraska","Richardson County",5,76,77,36,41
050,31,147,"Nebraska","Richardson County",5,77,61,25,36
050,31,147,"Nebraska","Richardson County",5,78,62,27,35
050,31,147,"Nebraska","Richardson County",5,79,61,25,36
050,31,147,"Nebraska","Richardson County",5,80,61,27,34
050,31,147,"Nebraska","Richardson County",5,81,60,30,30
050,31,147,"Nebraska","Richardson County",5,82,40,21,19
050,31,147,"Nebraska","Richardson County",5,83,39,21,18
050,31,147,"Nebraska","Richardson County",5,84,35,14,21
050,31,147,"Nebraska","Richardson County",5,85,299,101,198
050,31,149,"Nebraska","Rock County",1,0,13,7,6
050,31,149,"Nebraska","Rock County",1,1,13,7,6
050,31,149,"Nebraska","Rock County",1,2,13,8,5
050,31,149,"Nebraska","Rock County",1,3,16,7,9
050,31,149,"Nebraska","Rock County",1,4,21,9,12
050,31,149,"Nebraska","Rock County",1,5,12,4,8
050,31,149,"Nebraska","Rock County",1,6,12,6,6
050,31,149,"Nebraska","Rock County",1,7,14,6,8
050,31,149,"Nebraska","Rock County",1,8,11,6,5
050,31,149,"Nebraska","Rock County",1,9,12,7,5
050,31,149,"Nebraska","Rock County",1,10,14,10,4
050,31,149,"Nebraska","Rock County",1,11,22,11,11
050,31,149,"Nebraska","Rock County",1,12,14,8,6
050,31,149,"Nebraska","Rock County",1,13,20,12,8
050,31,149,"Nebraska","Rock County",1,14,15,7,8
050,31,149,"Nebraska","Rock County",1,15,19,11,8
050,31,149,"Nebraska","Rock County",1,16,22,13,9
050,31,149,"Nebraska","Rock County",1,17,15,7,8
050,31,149,"Nebraska","Rock County",1,18,11,7,4
050,31,149,"Nebraska","Rock County",1,19,6,4,2
050,31,149,"Nebraska","Rock County",1,20,9,5,4
050,31,149,"Nebraska","Rock County",1,21,11,6,5
050,31,149,"Nebraska","Rock County",1,22,14,6,8
050,31,149,"Nebraska","Rock County",1,23,12,6,6
050,31,149,"Nebraska","Rock County",1,24,11,5,6
050,31,149,"Nebraska","Rock County",1,25,11,3,8
050,31,149,"Nebraska","Rock County",1,26,11,6,5
050,31,149,"Nebraska","Rock County",1,27,10,5,5
050,31,149,"Nebraska","Rock County",1,28,9,4,5
050,31,149,"Nebraska","Rock County",1,29,8,4,4
050,31,149,"Nebraska","Rock County",1,30,7,4,3
050,31,149,"Nebraska","Rock County",1,31,13,5,8
050,31,149,"Nebraska","Rock County",1,32,17,7,10
050,31,149,"Nebraska","Rock County",1,33,14,7,7
050,31,149,"Nebraska","Rock County",1,34,13,6,7
050,31,149,"Nebraska","Rock County",1,35,14,9,5
050,31,149,"Nebraska","Rock County",1,36,14,11,3
050,31,149,"Nebraska","Rock County",1,37,12,8,4
050,31,149,"Nebraska","Rock County",1,38,15,9,6
050,31,149,"Nebraska","Rock County",1,39,17,8,9
050,31,149,"Nebraska","Rock County",1,40,16,8,8
050,31,149,"Nebraska","Rock County",1,41,19,8,11
050,31,149,"Nebraska","Rock County",1,42,18,7,11
050,31,149,"Nebraska","Rock County",1,43,15,8,7
050,31,149,"Nebraska","Rock County",1,44,11,7,4
050,31,149,"Nebraska","Rock County",1,45,8,5,3
050,31,149,"Nebraska","Rock County",1,46,6,3,3
050,31,149,"Nebraska","Rock County",1,47,7,2,5
050,31,149,"Nebraska","Rock County",1,48,14,8,6
050,31,149,"Nebraska","Rock County",1,49,12,7,5
050,31,149,"Nebraska","Rock County",1,50,10,4,6
050,31,149,"Nebraska","Rock County",1,51,13,6,7
050,31,149,"Nebraska","Rock County",1,52,13,9,4
050,31,149,"Nebraska","Rock County",1,53,7,4,3
050,31,149,"Nebraska","Rock County",1,54,7,2,5
050,31,149,"Nebraska","Rock County",1,55,9,3,6
050,31,149,"Nebraska","Rock County",1,56,10,6,4
050,31,149,"Nebraska","Rock County",1,57,20,11,9
050,31,149,"Nebraska","Rock County",1,58,26,14,12
050,31,149,"Nebraska","Rock County",1,59,25,10,15
050,31,149,"Nebraska","Rock County",1,60,20,7,13
050,31,149,"Nebraska","Rock County",1,61,19,10,9
050,31,149,"Nebraska","Rock County",1,62,24,13,11
050,31,149,"Nebraska","Rock County",1,63,26,12,14
050,31,149,"Nebraska","Rock County",1,64,31,17,14
050,31,149,"Nebraska","Rock County",1,65,27,16,11
050,31,149,"Nebraska","Rock County",1,66,22,10,12
050,31,149,"Nebraska","Rock County",1,67,30,14,16
050,31,149,"Nebraska","Rock County",1,68,27,13,14
050,31,149,"Nebraska","Rock County",1,69,19,8,11
050,31,149,"Nebraska","Rock County",1,70,22,12,10
050,31,149,"Nebraska","Rock County",1,71,21,11,10
050,31,149,"Nebraska","Rock County",1,72,21,9,12
050,31,149,"Nebraska","Rock County",1,73,14,9,5
050,31,149,"Nebraska","Rock County",1,74,10,6,4
050,31,149,"Nebraska","Rock County",1,75,7,4,3
050,31,149,"Nebraska","Rock County",1,76,9,3,6
050,31,149,"Nebraska","Rock County",1,77,13,4,9
050,31,149,"Nebraska","Rock County",1,78,14,8,6
050,31,149,"Nebraska","Rock County",1,79,9,4,5
050,31,149,"Nebraska","Rock County",1,80,5,1,4
050,31,149,"Nebraska","Rock County",1,81,4,2,2
050,31,149,"Nebraska","Rock County",1,82,6,2,4
050,31,149,"Nebraska","Rock County",1,83,9,5,4
050,31,149,"Nebraska","Rock County",1,84,7,3,4
050,31,149,"Nebraska","Rock County",1,85,44,13,31
050,31,149,"Nebraska","Rock County",2,0,14,7,7
050,31,149,"Nebraska","Rock County",2,1,12,6,6
050,31,149,"Nebraska","Rock County",2,2,14,8,6
050,31,149,"Nebraska","Rock County",2,3,15,7,8
050,31,149,"Nebraska","Rock County",2,4,20,8,12
050,31,149,"Nebraska","Rock County",2,5,14,5,9
050,31,149,"Nebraska","Rock County",2,6,12,5,7
050,31,149,"Nebraska","Rock County",2,7,14,6,8
050,31,149,"Nebraska","Rock County",2,8,12,6,6
050,31,149,"Nebraska","Rock County",2,9,12,7,5
050,31,149,"Nebraska","Rock County",2,10,14,9,5
050,31,149,"Nebraska","Rock County",2,11,19,10,9
050,31,149,"Nebraska","Rock County",2,12,15,8,7
050,31,149,"Nebraska","Rock County",2,13,18,11,7
050,31,149,"Nebraska","Rock County",2,14,16,8,8
050,31,149,"Nebraska","Rock County",2,15,18,10,8
050,31,149,"Nebraska","Rock County",2,16,21,12,9
050,31,149,"Nebraska","Rock County",2,17,18,9,9
050,31,149,"Nebraska","Rock County",2,18,10,6,4
050,31,149,"Nebraska","Rock County",2,19,8,5,3
050,31,149,"Nebraska","Rock County",2,20,9,5,4
050,31,149,"Nebraska","Rock County",2,21,11,6,5
050,31,149,"Nebraska","Rock County",2,22,15,6,9
050,31,149,"Nebraska","Rock County",2,23,13,6,7
050,31,149,"Nebraska","Rock County",2,24,12,5,7
050,31,149,"Nebraska","Rock County",2,25,11,4,7
050,31,149,"Nebraska","Rock County",2,26,12,6,6
050,31,149,"Nebraska","Rock County",2,27,10,5,5
050,31,149,"Nebraska","Rock County",2,28,9,4,5
050,31,149,"Nebraska","Rock County",2,29,8,4,4
050,31,149,"Nebraska","Rock County",2,30,8,4,4
050,31,149,"Nebraska","Rock County",2,31,12,5,7
050,31,149,"Nebraska","Rock County",2,32,17,7,10
050,31,149,"Nebraska","Rock County",2,33,15,7,8
050,31,149,"Nebraska","Rock County",2,34,13,6,7
050,31,149,"Nebraska","Rock County",2,35,14,8,6
050,31,149,"Nebraska","Rock County",2,36,15,11,4
050,31,149,"Nebraska","Rock County",2,37,12,9,3
050,31,149,"Nebraska","Rock County",2,38,15,9,6
050,31,149,"Nebraska","Rock County",2,39,17,9,8
050,31,149,"Nebraska","Rock County",2,40,16,8,8
050,31,149,"Nebraska","Rock County",2,41,18,8,10
050,31,149,"Nebraska","Rock County",2,42,18,7,11
050,31,149,"Nebraska","Rock County",2,43,14,7,7
050,31,149,"Nebraska","Rock County",2,44,12,7,5
050,31,149,"Nebraska","Rock County",2,45,8,5,3
050,31,149,"Nebraska","Rock County",2,46,7,4,3
050,31,149,"Nebraska","Rock County",2,47,7,3,4
050,31,149,"Nebraska","Rock County",2,48,12,6,6
050,31,149,"Nebraska","Rock County",2,49,12,7,5
050,31,149,"Nebraska","Rock County",2,50,11,5,6
050,31,149,"Nebraska","Rock County",2,51,12,5,7
050,31,149,"Nebraska","Rock County",2,52,13,8,5
050,31,149,"Nebraska","Rock County",2,53,8,5,3
050,31,149,"Nebraska","Rock County",2,54,6,2,4
050,31,149,"Nebraska","Rock County",2,55,9,3,6
050,31,149,"Nebraska","Rock County",2,56,9,5,4
050,31,149,"Nebraska","Rock County",2,57,18,10,8
050,31,149,"Nebraska","Rock County",2,58,24,13,11
050,31,149,"Nebraska","Rock County",2,59,26,11,15
050,31,149,"Nebraska","Rock County",2,60,21,8,13
050,31,149,"Nebraska","Rock County",2,61,19,9,10
050,31,149,"Nebraska","Rock County",2,62,22,12,10
050,31,149,"Nebraska","Rock County",2,63,26,13,13
050,31,149,"Nebraska","Rock County",2,64,29,15,14
050,31,149,"Nebraska","Rock County",2,65,28,16,12
050,31,149,"Nebraska","Rock County",2,66,24,12,12
050,31,149,"Nebraska","Rock County",2,67,28,13,15
050,31,149,"Nebraska","Rock County",2,68,27,13,14
050,31,149,"Nebraska","Rock County",2,69,21,9,12
050,31,149,"Nebraska","Rock County",2,70,21,11,10
050,31,149,"Nebraska","Rock County",2,71,21,11,10
050,31,149,"Nebraska","Rock County",2,72,20,9,11
050,31,149,"Nebraska","Rock County",2,73,17,10,7
050,31,149,"Nebraska","Rock County",2,74,10,6,4
050,31,149,"Nebraska","Rock County",2,75,7,4,3
050,31,149,"Nebraska","Rock County",2,76,9,3,6
050,31,149,"Nebraska","Rock County",2,77,13,4,9
050,31,149,"Nebraska","Rock County",2,78,12,7,5
050,31,149,"Nebraska","Rock County",2,79,10,5,5
050,31,149,"Nebraska","Rock County",2,80,6,2,4
050,31,149,"Nebraska","Rock County",2,81,5,2,3
050,31,149,"Nebraska","Rock County",2,82,6,2,4
050,31,149,"Nebraska","Rock County",2,83,8,4,4
050,31,149,"Nebraska","Rock County",2,84,7,3,4
050,31,149,"Nebraska","Rock County",2,85,44,13,31
050,31,149,"Nebraska","Rock County",3,0,22,16,6
050,31,149,"Nebraska","Rock County",3,1,12,7,5
050,31,149,"Nebraska","Rock County",3,2,13,6,7
050,31,149,"Nebraska","Rock County",3,3,9,8,1
050,31,149,"Nebraska","Rock County",3,4,15,7,8
050,31,149,"Nebraska","Rock County",3,5,25,12,13
050,31,149,"Nebraska","Rock County",3,6,14,5,9
050,31,149,"Nebraska","Rock County",3,7,14,7,7
050,31,149,"Nebraska","Rock County",3,8,16,7,9
050,31,149,"Nebraska","Rock County",3,9,12,6,6
050,31,149,"Nebraska","Rock County",3,10,15,10,5
050,31,149,"Nebraska","Rock County",3,11,14,9,5
050,31,149,"Nebraska","Rock County",3,12,20,9,11
050,31,149,"Nebraska","Rock County",3,13,16,9,7
050,31,149,"Nebraska","Rock County",3,14,21,11,10
050,31,149,"Nebraska","Rock County",3,15,15,7,8
050,31,149,"Nebraska","Rock County",3,16,21,10,11
050,31,149,"Nebraska","Rock County",3,17,20,11,9
050,31,149,"Nebraska","Rock County",3,18,16,8,8
050,31,149,"Nebraska","Rock County",3,19,6,4,2
050,31,149,"Nebraska","Rock County",3,20,9,5,4
050,31,149,"Nebraska","Rock County",3,21,10,5,5
050,31,149,"Nebraska","Rock County",3,22,9,5,4
050,31,149,"Nebraska","Rock County",3,23,11,5,6
050,31,149,"Nebraska","Rock County",3,24,18,9,9
050,31,149,"Nebraska","Rock County",3,25,13,5,8
050,31,149,"Nebraska","Rock County",3,26,8,2,6
050,31,149,"Nebraska","Rock County",3,27,14,8,6
050,31,149,"Nebraska","Rock County",3,28,8,4,4
050,31,149,"Nebraska","Rock County",3,29,10,4,6
050,31,149,"Nebraska","Rock County",3,30,8,3,5
050,31,149,"Nebraska","Rock County",3,31,10,6,4
050,31,149,"Nebraska","Rock County",3,32,10,5,5
050,31,149,"Nebraska","Rock County",3,33,14,6,8
050,31,149,"Nebraska","Rock County",3,34,15,7,8
050,31,149,"Nebraska","Rock County",3,35,13,6,7
050,31,149,"Nebraska","Rock County",3,36,15,7,8
050,31,149,"Nebraska","Rock County",3,37,15,11,4
050,31,149,"Nebraska","Rock County",3,38,11,9,2
050,31,149,"Nebraska","Rock County",3,39,15,9,6
050,31,149,"Nebraska","Rock County",3,40,18,9,9
050,31,149,"Nebraska","Rock County",3,41,18,9,9
050,31,149,"Nebraska","Rock County",3,42,18,9,9
050,31,149,"Nebraska","Rock County",3,43,19,8,11
050,31,149,"Nebraska","Rock County",3,44,13,6,7
050,31,149,"Nebraska","Rock County",3,45,13,7,6
050,31,149,"Nebraska","Rock County",3,46,9,6,3
050,31,149,"Nebraska","Rock County",3,47,7,4,3
050,31,149,"Nebraska","Rock County",3,48,7,3,4
050,31,149,"Nebraska","Rock County",3,49,12,6,6
050,31,149,"Nebraska","Rock County",3,50,12,7,5
050,31,149,"Nebraska","Rock County",3,51,11,5,6
050,31,149,"Nebraska","Rock County",3,52,12,5,7
050,31,149,"Nebraska","Rock County",3,53,14,8,6
050,31,149,"Nebraska","Rock County",3,54,8,5,3
050,31,149,"Nebraska","Rock County",3,55,6,2,4
050,31,149,"Nebraska","Rock County",3,56,9,3,6
050,31,149,"Nebraska","Rock County",3,57,9,5,4
050,31,149,"Nebraska","Rock County",3,58,18,10,8
050,31,149,"Nebraska","Rock County",3,59,24,13,11
050,31,149,"Nebraska","Rock County",3,60,24,11,13
050,31,149,"Nebraska","Rock County",3,61,21,8,13
050,31,149,"Nebraska","Rock County",3,62,17,9,8
050,31,149,"Nebraska","Rock County",3,63,22,12,10
050,31,149,"Nebraska","Rock County",3,64,26,13,13
050,31,149,"Nebraska","Rock County",3,65,26,15,11
050,31,149,"Nebraska","Rock County",3,66,27,15,12
050,31,149,"Nebraska","Rock County",3,67,24,12,12
050,31,149,"Nebraska","Rock County",3,68,28,13,15
050,31,149,"Nebraska","Rock County",3,69,27,13,14
050,31,149,"Nebraska","Rock County",3,70,20,8,12
050,31,149,"Nebraska","Rock County",3,71,21,11,10
050,31,149,"Nebraska","Rock County",3,72,22,11,11
050,31,149,"Nebraska","Rock County",3,73,20,9,11
050,31,149,"Nebraska","Rock County",3,74,17,10,7
050,31,149,"Nebraska","Rock County",3,75,9,5,4
050,31,149,"Nebraska","Rock County",3,76,6,3,3
050,31,149,"Nebraska","Rock County",3,77,8,2,6
050,31,149,"Nebraska","Rock County",3,78,9,2,7
050,31,149,"Nebraska","Rock County",3,79,11,6,5
050,31,149,"Nebraska","Rock County",3,80,8,3,5
050,31,149,"Nebraska","Rock County",3,81,7,3,4
050,31,149,"Nebraska","Rock County",3,82,6,2,4
050,31,149,"Nebraska","Rock County",3,83,7,3,4
050,31,149,"Nebraska","Rock County",3,84,8,3,5
050,31,149,"Nebraska","Rock County",3,85,45,14,31
050,31,149,"Nebraska","Rock County",4,0,16,11,5
050,31,149,"Nebraska","Rock County",4,1,25,16,9
050,31,149,"Nebraska","Rock County",4,2,12,7,5
050,31,149,"Nebraska","Rock County",4,3,13,6,7
050,31,149,"Nebraska","Rock County",4,4,10,8,2
050,31,149,"Nebraska","Rock County",4,5,14,7,7
050,31,149,"Nebraska","Rock County",4,6,22,9,13
050,31,149,"Nebraska","Rock County",4,7,13,5,8
050,31,149,"Nebraska","Rock County",4,8,15,7,8
050,31,149,"Nebraska","Rock County",4,9,12,5,7
050,31,149,"Nebraska","Rock County",4,10,12,6,6
050,31,149,"Nebraska","Rock County",4,11,15,10,5
050,31,149,"Nebraska","Rock County",4,12,14,9,5
050,31,149,"Nebraska","Rock County",4,13,18,7,11
050,31,149,"Nebraska","Rock County",4,14,12,7,5
050,31,149,"Nebraska","Rock County",4,15,21,11,10
050,31,149,"Nebraska","Rock County",4,16,15,7,8
050,31,149,"Nebraska","Rock County",4,17,21,9,12
050,31,149,"Nebraska","Rock County",4,18,16,9,7
050,31,149,"Nebraska","Rock County",4,19,11,7,4
050,31,149,"Nebraska","Rock County",4,20,4,3,1
050,31,149,"Nebraska","Rock County",4,21,8,4,4
050,31,149,"Nebraska","Rock County",4,22,10,4,6
050,31,149,"Nebraska","Rock County",4,23,11,5,6
050,31,149,"Nebraska","Rock County",4,24,10,6,4
050,31,149,"Nebraska","Rock County",4,25,19,8,11
050,31,149,"Nebraska","Rock County",4,26,12,5,7
050,31,149,"Nebraska","Rock County",4,27,9,3,6
050,31,149,"Nebraska","Rock County",4,28,12,7,5
050,31,149,"Nebraska","Rock County",4,29,7,4,3
050,31,149,"Nebraska","Rock County",4,30,11,4,7
050,31,149,"Nebraska","Rock County",4,31,8,4,4
050,31,149,"Nebraska","Rock County",4,32,10,6,4
050,31,149,"Nebraska","Rock County",4,33,8,4,4
050,31,149,"Nebraska","Rock County",4,34,12,4,8
050,31,149,"Nebraska","Rock County",4,35,15,7,8
050,31,149,"Nebraska","Rock County",4,36,13,6,7
050,31,149,"Nebraska","Rock County",4,37,13,7,6
050,31,149,"Nebraska","Rock County",4,38,15,11,4
050,31,149,"Nebraska","Rock County",4,39,12,9,3
050,31,149,"Nebraska","Rock County",4,40,15,9,6
050,31,149,"Nebraska","Rock County",4,41,18,9,9
050,31,149,"Nebraska","Rock County",4,42,18,9,9
050,31,149,"Nebraska","Rock County",4,43,18,9,9
050,31,149,"Nebraska","Rock County",4,44,18,7,11
050,31,149,"Nebraska","Rock County",4,45,13,6,7
050,31,149,"Nebraska","Rock County",4,46,13,7,6
050,31,149,"Nebraska","Rock County",4,47,9,6,3
050,31,149,"Nebraska","Rock County",4,48,7,4,3
050,31,149,"Nebraska","Rock County",4,49,8,3,5
050,31,149,"Nebraska","Rock County",4,50,14,7,7
050,31,149,"Nebraska","Rock County",4,51,12,7,5
050,31,149,"Nebraska","Rock County",4,52,12,6,6
050,31,149,"Nebraska","Rock County",4,53,13,6,7
050,31,149,"Nebraska","Rock County",4,54,14,8,6
050,31,149,"Nebraska","Rock County",4,55,9,6,3
050,31,149,"Nebraska","Rock County",4,56,6,2,4
050,31,149,"Nebraska","Rock County",4,57,10,4,6
050,31,149,"Nebraska","Rock County",4,58,9,4,5
050,31,149,"Nebraska","Rock County",4,59,17,9,8
050,31,149,"Nebraska","Rock County",4,60,25,13,12
050,31,149,"Nebraska","Rock County",4,61,25,12,13
050,31,149,"Nebraska","Rock County",4,62,21,8,13
050,31,149,"Nebraska","Rock County",4,63,15,8,7
050,31,149,"Nebraska","Rock County",4,64,22,12,10
050,31,149,"Nebraska","Rock County",4,65,26,13,13
050,31,149,"Nebraska","Rock County",4,66,22,12,10
050,31,149,"Nebraska","Rock County",4,67,24,14,10
050,31,149,"Nebraska","Rock County",4,68,24,12,12
050,31,149,"Nebraska","Rock County",4,69,28,13,15
050,31,149,"Nebraska","Rock County",4,70,26,12,14
050,31,149,"Nebraska","Rock County",4,71,20,8,12
050,31,149,"Nebraska","Rock County",4,72,21,11,10
050,31,149,"Nebraska","Rock County",4,73,21,11,10
050,31,149,"Nebraska","Rock County",4,74,18,8,10
050,31,149,"Nebraska","Rock County",4,75,17,10,7
050,31,149,"Nebraska","Rock County",4,76,8,4,4
050,31,149,"Nebraska","Rock County",4,77,7,3,4
050,31,149,"Nebraska","Rock County",4,78,7,2,5
050,31,149,"Nebraska","Rock County",4,79,8,1,7
050,31,149,"Nebraska","Rock County",4,80,11,6,5
050,31,149,"Nebraska","Rock County",4,81,9,3,6
050,31,149,"Nebraska","Rock County",4,82,6,3,3
050,31,149,"Nebraska","Rock County",4,83,7,3,4
050,31,149,"Nebraska","Rock County",4,84,5,2,3
050,31,149,"Nebraska","Rock County",4,85,39,16,23
050,31,149,"Nebraska","Rock County",5,0,15,12,3
050,31,149,"Nebraska","Rock County",5,1,20,13,7
050,31,149,"Nebraska","Rock County",5,2,23,16,7
050,31,149,"Nebraska","Rock County",5,3,13,8,5
050,31,149,"Nebraska","Rock County",5,4,13,6,7
050,31,149,"Nebraska","Rock County",5,5,11,8,3
050,31,149,"Nebraska","Rock County",5,6,15,8,7
050,31,149,"Nebraska","Rock County",5,7,20,8,12
050,31,149,"Nebraska","Rock County",5,8,15,8,7
050,31,149,"Nebraska","Rock County",5,9,17,8,9
050,31,149,"Nebraska","Rock County",5,10,11,3,8
050,31,149,"Nebraska","Rock County",5,11,13,7,6
050,31,149,"Nebraska","Rock County",5,12,14,8,6
050,31,149,"Nebraska","Rock County",5,13,14,9,5
050,31,149,"Nebraska","Rock County",5,14,18,8,10
050,31,149,"Nebraska","Rock County",5,15,14,9,5
050,31,149,"Nebraska","Rock County",5,16,20,11,9
050,31,149,"Nebraska","Rock County",5,17,18,7,11
050,31,149,"Nebraska","Rock County",5,18,16,6,10
050,31,149,"Nebraska","Rock County",5,19,13,8,5
050,31,149,"Nebraska","Rock County",5,20,12,7,5
050,31,149,"Nebraska","Rock County",5,21,4,3,1
050,31,149,"Nebraska","Rock County",5,22,9,4,5
050,31,149,"Nebraska","Rock County",5,23,7,1,6
050,31,149,"Nebraska","Rock County",5,24,13,7,6
050,31,149,"Nebraska","Rock County",5,25,13,9,4
050,31,149,"Nebraska","Rock County",5,26,24,10,14
050,31,149,"Nebraska","Rock County",5,27,13,6,7
050,31,149,"Nebraska","Rock County",5,28,8,1,7
050,31,149,"Nebraska","Rock County",5,29,14,7,7
050,31,149,"Nebraska","Rock County",5,30,8,5,3
050,31,149,"Nebraska","Rock County",5,31,12,6,6
050,31,149,"Nebraska","Rock County",5,32,8,3,5
050,31,149,"Nebraska","Rock County",5,33,8,5,3
050,31,149,"Nebraska","Rock County",5,34,9,4,5
050,31,149,"Nebraska","Rock County",5,35,12,4,8
050,31,149,"Nebraska","Rock County",5,36,15,7,8
050,31,149,"Nebraska","Rock County",5,37,13,6,7
050,31,149,"Nebraska","Rock County",5,38,13,7,6
050,31,149,"Nebraska","Rock County",5,39,14,11,3
050,31,149,"Nebraska","Rock County",5,40,11,8,3
050,31,149,"Nebraska","Rock County",5,41,15,9,6
050,31,149,"Nebraska","Rock County",5,42,18,9,9
050,31,149,"Nebraska","Rock County",5,43,17,9,8
050,31,149,"Nebraska","Rock County",5,44,18,8,10
050,31,149,"Nebraska","Rock County",5,45,19,8,11
050,31,149,"Nebraska","Rock County",5,46,13,6,7
050,31,149,"Nebraska","Rock County",5,47,14,7,7
050,31,149,"Nebraska","Rock County",5,48,10,6,4
050,31,149,"Nebraska","Rock County",5,49,10,7,3
050,31,149,"Nebraska","Rock County",5,50,8,1,7
050,31,149,"Nebraska","Rock County",5,51,16,7,9
050,31,149,"Nebraska","Rock County",5,52,12,7,5
050,31,149,"Nebraska","Rock County",5,53,12,6,6
050,31,149,"Nebraska","Rock County",5,54,15,7,8
050,31,149,"Nebraska","Rock County",5,55,13,7,6
050,31,149,"Nebraska","Rock County",5,56,9,6,3
050,31,149,"Nebraska","Rock County",5,57,9,2,7
050,31,149,"Nebraska","Rock County",5,58,9,3,6
050,31,149,"Nebraska","Rock County",5,59,13,8,5
050,31,149,"Nebraska","Rock County",5,60,17,9,8
050,31,149,"Nebraska","Rock County",5,61,25,13,12
050,31,149,"Nebraska","Rock County",5,62,28,12,16
050,31,149,"Nebraska","Rock County",5,63,20,7,13
050,31,149,"Nebraska","Rock County",5,64,15,8,7
050,31,149,"Nebraska","Rock County",5,65,22,12,10
050,31,149,"Nebraska","Rock County",5,66,25,13,12
050,31,149,"Nebraska","Rock County",5,67,22,12,10
050,31,149,"Nebraska","Rock County",5,68,22,14,8
050,31,149,"Nebraska","Rock County",5,69,25,12,13
050,31,149,"Nebraska","Rock County",5,70,26,12,14
050,31,149,"Nebraska","Rock County",5,71,26,12,14
050,31,149,"Nebraska","Rock County",5,72,19,8,11
050,31,149,"Nebraska","Rock County",5,73,21,11,10
050,31,149,"Nebraska","Rock County",5,74,18,8,10
050,31,149,"Nebraska","Rock County",5,75,20,10,10
050,31,149,"Nebraska","Rock County",5,76,17,10,7
050,31,149,"Nebraska","Rock County",5,77,7,3,4
050,31,149,"Nebraska","Rock County",5,78,6,3,3
050,31,149,"Nebraska","Rock County",5,79,7,1,6
050,31,149,"Nebraska","Rock County",5,80,9,1,8
050,31,149,"Nebraska","Rock County",5,81,12,6,6
050,31,149,"Nebraska","Rock County",5,82,10,3,7
050,31,149,"Nebraska","Rock County",5,83,8,4,4
050,31,149,"Nebraska","Rock County",5,84,6,3,3
050,31,149,"Nebraska","Rock County",5,85,35,17,18
050,31,151,"Nebraska","Saline County",1,0,199,102,97
050,31,151,"Nebraska","Saline County",1,1,192,97,95
050,31,151,"Nebraska","Saline County",1,2,193,100,93
050,31,151,"Nebraska","Saline County",1,3,211,109,102
050,31,151,"Nebraska","Saline County",1,4,197,93,104
050,31,151,"Nebraska","Saline County",1,5,213,110,103
050,31,151,"Nebraska","Saline County",1,6,201,108,93
050,31,151,"Nebraska","Saline County",1,7,204,98,106
050,31,151,"Nebraska","Saline County",1,8,228,115,113
050,31,151,"Nebraska","Saline County",1,9,236,128,108
050,31,151,"Nebraska","Saline County",1,10,226,113,113
050,31,151,"Nebraska","Saline County",1,11,228,114,114
050,31,151,"Nebraska","Saline County",1,12,227,111,116
050,31,151,"Nebraska","Saline County",1,13,247,142,105
050,31,151,"Nebraska","Saline County",1,14,255,150,105
050,31,151,"Nebraska","Saline County",1,15,219,116,103
050,31,151,"Nebraska","Saline County",1,16,214,117,97
050,31,151,"Nebraska","Saline County",1,17,214,111,103
050,31,151,"Nebraska","Saline County",1,18,262,121,141
050,31,151,"Nebraska","Saline County",1,19,388,192,196
050,31,151,"Nebraska","Saline County",1,20,310,171,139
050,31,151,"Nebraska","Saline County",1,21,276,144,132
050,31,151,"Nebraska","Saline County",1,22,246,139,107
050,31,151,"Nebraska","Saline County",1,23,149,88,61
050,31,151,"Nebraska","Saline County",1,24,153,83,70
050,31,151,"Nebraska","Saline County",1,25,168,86,82
050,31,151,"Nebraska","Saline County",1,26,156,77,79
050,31,151,"Nebraska","Saline County",1,27,156,76,80
050,31,151,"Nebraska","Saline County",1,28,155,81,74
050,31,151,"Nebraska","Saline County",1,29,126,67,59
050,31,151,"Nebraska","Saline County",1,30,139,67,72
050,31,151,"Nebraska","Saline County",1,31,134,73,61
050,31,151,"Nebraska","Saline County",1,32,145,80,65
050,31,151,"Nebraska","Saline County",1,33,165,76,89
050,31,151,"Nebraska","Saline County",1,34,168,100,68
050,31,151,"Nebraska","Saline County",1,35,186,99,87
050,31,151,"Nebraska","Saline County",1,36,202,127,75
050,31,151,"Nebraska","Saline County",1,37,197,115,82
050,31,151,"Nebraska","Saline County",1,38,176,86,90
050,31,151,"Nebraska","Saline County",1,39,189,89,100
050,31,151,"Nebraska","Saline County",1,40,181,85,96
050,31,151,"Nebraska","Saline County",1,41,179,88,91
050,31,151,"Nebraska","Saline County",1,42,191,98,93
050,31,151,"Nebraska","Saline County",1,43,170,91,79
050,31,151,"Nebraska","Saline County",1,44,171,96,75
050,31,151,"Nebraska","Saline County",1,45,170,85,85
050,31,151,"Nebraska","Saline County",1,46,186,90,96
050,31,151,"Nebraska","Saline County",1,47,175,96,79
050,31,151,"Nebraska","Saline County",1,48,185,98,87
050,31,151,"Nebraska","Saline County",1,49,190,102,88
050,31,151,"Nebraska","Saline County",1,50,187,90,97
050,31,151,"Nebraska","Saline County",1,51,179,95,84
050,31,151,"Nebraska","Saline County",1,52,167,91,76
050,31,151,"Nebraska","Saline County",1,53,162,91,71
050,31,151,"Nebraska","Saline County",1,54,171,89,82
050,31,151,"Nebraska","Saline County",1,55,172,91,81
050,31,151,"Nebraska","Saline County",1,56,172,89,83
050,31,151,"Nebraska","Saline County",1,57,183,96,87
050,31,151,"Nebraska","Saline County",1,58,190,103,87
050,31,151,"Nebraska","Saline County",1,59,201,110,91
050,31,151,"Nebraska","Saline County",1,60,184,98,86
050,31,151,"Nebraska","Saline County",1,61,173,94,79
050,31,151,"Nebraska","Saline County",1,62,172,92,80
050,31,151,"Nebraska","Saline County",1,63,156,82,74
050,31,151,"Nebraska","Saline County",1,64,157,83,74
050,31,151,"Nebraska","Saline County",1,65,154,74,80
050,31,151,"Nebraska","Saline County",1,66,156,71,85
050,31,151,"Nebraska","Saline County",1,67,151,75,76
050,31,151,"Nebraska","Saline County",1,68,130,69,61
050,31,151,"Nebraska","Saline County",1,69,124,58,66
050,31,151,"Nebraska","Saline County",1,70,115,55,60
050,31,151,"Nebraska","Saline County",1,71,113,58,55
050,31,151,"Nebraska","Saline County",1,72,121,55,66
050,31,151,"Nebraska","Saline County",1,73,113,55,58
050,31,151,"Nebraska","Saline County",1,74,74,39,35
050,31,151,"Nebraska","Saline County",1,75,83,40,43
050,31,151,"Nebraska","Saline County",1,76,85,39,46
050,31,151,"Nebraska","Saline County",1,77,87,39,48
050,31,151,"Nebraska","Saline County",1,78,59,32,27
050,31,151,"Nebraska","Saline County",1,79,61,30,31
050,31,151,"Nebraska","Saline County",1,80,53,25,28
050,31,151,"Nebraska","Saline County",1,81,58,28,30
050,31,151,"Nebraska","Saline County",1,82,51,24,27
050,31,151,"Nebraska","Saline County",1,83,46,22,24
050,31,151,"Nebraska","Saline County",1,84,50,19,31
050,31,151,"Nebraska","Saline County",1,85,309,106,203
050,31,151,"Nebraska","Saline County",2,0,199,101,98
050,31,151,"Nebraska","Saline County",2,1,193,97,96
050,31,151,"Nebraska","Saline County",2,2,189,96,93
050,31,151,"Nebraska","Saline County",2,3,203,104,99
050,31,151,"Nebraska","Saline County",2,4,199,95,104
050,31,151,"Nebraska","Saline County",2,5,211,108,103
050,31,151,"Nebraska","Saline County",2,6,202,108,94
050,31,151,"Nebraska","Saline County",2,7,201,98,103
050,31,151,"Nebraska","Saline County",2,8,222,112,110
050,31,151,"Nebraska","Saline County",2,9,233,125,108
050,31,151,"Nebraska","Saline County",2,10,227,116,111
050,31,151,"Nebraska","Saline County",2,11,226,112,114
050,31,151,"Nebraska","Saline County",2,12,229,111,118
050,31,151,"Nebraska","Saline County",2,13,240,135,105
050,31,151,"Nebraska","Saline County",2,14,251,146,105
050,31,151,"Nebraska","Saline County",2,15,229,124,105
050,31,151,"Nebraska","Saline County",2,16,216,118,98
050,31,151,"Nebraska","Saline County",2,17,214,111,103
050,31,151,"Nebraska","Saline County",2,18,262,125,137
050,31,151,"Nebraska","Saline County",2,19,386,190,196
050,31,151,"Nebraska","Saline County",2,20,312,172,140
050,31,151,"Nebraska","Saline County",2,21,279,145,134
050,31,151,"Nebraska","Saline County",2,22,243,137,106
050,31,151,"Nebraska","Saline County",2,23,153,89,64
050,31,151,"Nebraska","Saline County",2,24,152,84,68
050,31,151,"Nebraska","Saline County",2,25,162,85,77
050,31,151,"Nebraska","Saline County",2,26,157,79,78
050,31,151,"Nebraska","Saline County",2,27,156,76,80
050,31,151,"Nebraska","Saline County",2,28,157,82,75
050,31,151,"Nebraska","Saline County",2,29,134,71,63
050,31,151,"Nebraska","Saline County",2,30,135,66,69
050,31,151,"Nebraska","Saline County",2,31,132,70,62
050,31,151,"Nebraska","Saline County",2,32,142,78,64
050,31,151,"Nebraska","Saline County",2,33,160,78,82
050,31,151,"Nebraska","Saline County",2,34,166,94,72
050,31,151,"Nebraska","Saline County",2,35,179,97,82
050,31,151,"Nebraska","Saline County",2,36,194,116,78
050,31,151,"Nebraska","Saline County",2,37,193,114,79
050,31,151,"Nebraska","Saline County",2,38,184,95,89
050,31,151,"Nebraska","Saline County",2,39,184,88,96
050,31,151,"Nebraska","Saline County",2,40,183,85,98
050,31,151,"Nebraska","Saline County",2,41,179,88,91
050,31,151,"Nebraska","Saline County",2,42,185,94,91
050,31,151,"Nebraska","Saline County",2,43,175,92,83
050,31,151,"Nebraska","Saline County",2,44,171,94,77
050,31,151,"Nebraska","Saline County",2,45,170,87,83
050,31,151,"Nebraska","Saline County",2,46,181,89,92
050,31,151,"Nebraska","Saline County",2,47,178,96,82
050,31,151,"Nebraska","Saline County",2,48,182,99,83
050,31,151,"Nebraska","Saline County",2,49,188,99,89
050,31,151,"Nebraska","Saline County",2,50,185,90,95
050,31,151,"Nebraska","Saline County",2,51,181,95,86
050,31,151,"Nebraska","Saline County",2,52,169,91,78
050,31,151,"Nebraska","Saline County",2,53,160,89,71
050,31,151,"Nebraska","Saline County",2,54,169,90,79
050,31,151,"Nebraska","Saline County",2,55,169,89,80
050,31,151,"Nebraska","Saline County",2,56,171,89,82
050,31,151,"Nebraska","Saline County",2,57,180,95,85
050,31,151,"Nebraska","Saline County",2,58,189,102,87
050,31,151,"Nebraska","Saline County",2,59,200,109,91
050,31,151,"Nebraska","Saline County",2,60,188,100,88
050,31,151,"Nebraska","Saline County",2,61,177,96,81
050,31,151,"Nebraska","Saline County",2,62,172,92,80
050,31,151,"Nebraska","Saline County",2,63,160,84,76
050,31,151,"Nebraska","Saline County",2,64,155,83,72
050,31,151,"Nebraska","Saline County",2,65,154,76,78
050,31,151,"Nebraska","Saline County",2,66,156,72,84
050,31,151,"Nebraska","Saline County",2,67,152,75,77
050,31,151,"Nebraska","Saline County",2,68,132,69,63
050,31,151,"Nebraska","Saline County",2,69,125,60,65
050,31,151,"Nebraska","Saline County",2,70,116,56,60
050,31,151,"Nebraska","Saline County",2,71,111,57,54
050,31,151,"Nebraska","Saline County",2,72,117,55,62
050,31,151,"Nebraska","Saline County",2,73,118,56,62
050,31,151,"Nebraska","Saline County",2,74,78,40,38
050,31,151,"Nebraska","Saline County",2,75,79,38,41
050,31,151,"Nebraska","Saline County",2,76,82,37,45
050,31,151,"Nebraska","Saline County",2,77,89,40,49
050,31,151,"Nebraska","Saline County",2,78,61,31,30
050,31,151,"Nebraska","Saline County",2,79,59,29,30
050,31,151,"Nebraska","Saline County",2,80,56,27,29
050,31,151,"Nebraska","Saline County",2,81,57,28,29
050,31,151,"Nebraska","Saline County",2,82,50,23,27
050,31,151,"Nebraska","Saline County",2,83,47,23,24
050,31,151,"Nebraska","Saline County",2,84,47,18,29
050,31,151,"Nebraska","Saline County",2,85,311,107,204
050,31,151,"Nebraska","Saline County",3,0,190,94,96
050,31,151,"Nebraska","Saline County",3,1,195,101,94
050,31,151,"Nebraska","Saline County",3,2,200,102,98
050,31,151,"Nebraska","Saline County",3,3,195,99,96
050,31,151,"Nebraska","Saline County",3,4,207,106,101
050,31,151,"Nebraska","Saline County",3,5,203,100,103
050,31,151,"Nebraska","Saline County",3,6,207,109,98
050,31,151,"Nebraska","Saline County",3,7,201,109,92
050,31,151,"Nebraska","Saline County",3,8,202,101,101
050,31,151,"Nebraska","Saline County",3,9,219,109,110
050,31,151,"Nebraska","Saline County",3,10,229,117,112
050,31,151,"Nebraska","Saline County",3,11,237,126,111
050,31,151,"Nebraska","Saline County",3,12,232,114,118
050,31,151,"Nebraska","Saline County",3,13,222,110,112
050,31,151,"Nebraska","Saline County",3,14,229,129,100
050,31,151,"Nebraska","Saline County",3,15,245,142,103
050,31,151,"Nebraska","Saline County",3,16,224,122,102
050,31,151,"Nebraska","Saline County",3,17,207,112,95
050,31,151,"Nebraska","Saline County",3,18,251,121,130
050,31,151,"Nebraska","Saline County",3,19,329,160,169
050,31,151,"Nebraska","Saline County",3,20,270,144,126
050,31,151,"Nebraska","Saline County",3,21,278,146,132
050,31,151,"Nebraska","Saline County",3,22,222,115,107
050,31,151,"Nebraska","Saline County",3,23,161,89,72
050,31,151,"Nebraska","Saline County",3,24,138,75,63
050,31,151,"Nebraska","Saline County",3,25,163,88,75
050,31,151,"Nebraska","Saline County",3,26,142,74,68
050,31,151,"Nebraska","Saline County",3,27,169,83,86
050,31,151,"Nebraska","Saline County",3,28,160,79,81
050,31,151,"Nebraska","Saline County",3,29,157,81,76
050,31,151,"Nebraska","Saline County",3,30,133,68,65
050,31,151,"Nebraska","Saline County",3,31,145,72,73
050,31,151,"Nebraska","Saline County",3,32,134,71,63
050,31,151,"Nebraska","Saline County",3,33,130,68,62
050,31,151,"Nebraska","Saline County",3,34,161,85,76
050,31,151,"Nebraska","Saline County",3,35,159,88,71
050,31,151,"Nebraska","Saline County",3,36,176,95,81
050,31,151,"Nebraska","Saline County",3,37,196,119,77
050,31,151,"Nebraska","Saline County",3,38,198,121,77
050,31,151,"Nebraska","Saline County",3,39,193,103,90
050,31,151,"Nebraska","Saline County",3,40,176,84,92
050,31,151,"Nebraska","Saline County",3,41,183,87,96
050,31,151,"Nebraska","Saline County",3,42,174,88,86
050,31,151,"Nebraska","Saline County",3,43,190,94,96
050,31,151,"Nebraska","Saline County",3,44,173,97,76
050,31,151,"Nebraska","Saline County",3,45,162,85,77
050,31,151,"Nebraska","Saline County",3,46,166,85,81
050,31,151,"Nebraska","Saline County",3,47,183,88,95
050,31,151,"Nebraska","Saline County",3,48,178,94,84
050,31,151,"Nebraska","Saline County",3,49,184,101,83
050,31,151,"Nebraska","Saline County",3,50,183,93,90
050,31,151,"Nebraska","Saline County",3,51,170,83,87
050,31,151,"Nebraska","Saline County",3,52,177,90,87
050,31,151,"Nebraska","Saline County",3,53,166,91,75
050,31,151,"Nebraska","Saline County",3,54,159,88,71
050,31,151,"Nebraska","Saline County",3,55,161,88,73
050,31,151,"Nebraska","Saline County",3,56,164,86,78
050,31,151,"Nebraska","Saline County",3,57,165,90,75
050,31,151,"Nebraska","Saline County",3,58,172,89,83
050,31,151,"Nebraska","Saline County",3,59,187,103,84
050,31,151,"Nebraska","Saline County",3,60,194,105,89
050,31,151,"Nebraska","Saline County",3,61,190,102,88
050,31,151,"Nebraska","Saline County",3,62,181,98,83
050,31,151,"Nebraska","Saline County",3,63,167,92,75
050,31,151,"Nebraska","Saline County",3,64,157,81,76
050,31,151,"Nebraska","Saline County",3,65,153,82,71
050,31,151,"Nebraska","Saline County",3,66,152,75,77
050,31,151,"Nebraska","Saline County",3,67,156,70,86
050,31,151,"Nebraska","Saline County",3,68,142,66,76
050,31,151,"Nebraska","Saline County",3,69,139,69,70
050,31,151,"Nebraska","Saline County",3,70,115,60,55
050,31,151,"Nebraska","Saline County",3,71,112,52,60
050,31,151,"Nebraska","Saline County",3,72,107,54,53
050,31,151,"Nebraska","Saline County",3,73,115,54,61
050,31,151,"Nebraska","Saline County",3,74,117,57,60
050,31,151,"Nebraska","Saline County",3,75,77,39,38
050,31,151,"Nebraska","Saline County",3,76,80,38,42
050,31,151,"Nebraska","Saline County",3,77,85,36,49
050,31,151,"Nebraska","Saline County",3,78,79,36,43
050,31,151,"Nebraska","Saline County",3,79,60,28,32
050,31,151,"Nebraska","Saline County",3,80,56,29,27
050,31,151,"Nebraska","Saline County",3,81,58,29,29
050,31,151,"Nebraska","Saline County",3,82,49,23,26
050,31,151,"Nebraska","Saline County",3,83,51,27,24
050,31,151,"Nebraska","Saline County",3,84,40,13,27
050,31,151,"Nebraska","Saline County",3,85,311,108,203
050,31,151,"Nebraska","Saline County",4,0,171,82,89
050,31,151,"Nebraska","Saline County",4,1,200,98,102
050,31,151,"Nebraska","Saline County",4,2,196,105,91
050,31,151,"Nebraska","Saline County",4,3,199,108,91
050,31,151,"Nebraska","Saline County",4,4,193,103,90
050,31,151,"Nebraska","Saline County",4,5,220,110,110
050,31,151,"Nebraska","Saline County",4,6,198,95,103
050,31,151,"Nebraska","Saline County",4,7,213,115,98
050,31,151,"Nebraska","Saline County",4,8,202,109,93
050,31,151,"Nebraska","Saline County",4,9,205,105,100
050,31,151,"Nebraska","Saline County",4,10,214,105,109
050,31,151,"Nebraska","Saline County",4,11,233,120,113
050,31,151,"Nebraska","Saline County",4,12,224,115,109
050,31,151,"Nebraska","Saline County",4,13,241,123,118
050,31,151,"Nebraska","Saline County",4,14,234,118,116
050,31,151,"Nebraska","Saline County",4,15,243,138,105
050,31,151,"Nebraska","Saline County",4,16,237,133,104
050,31,151,"Nebraska","Saline County",4,17,226,126,100
050,31,151,"Nebraska","Saline County",4,18,254,135,119
050,31,151,"Nebraska","Saline County",4,19,341,174,167
050,31,151,"Nebraska","Saline County",4,20,260,141,119
050,31,151,"Nebraska","Saline County",4,21,267,135,132
050,31,151,"Nebraska","Saline County",4,22,245,143,102
050,31,151,"Nebraska","Saline County",4,23,172,89,83
050,31,151,"Nebraska","Saline County",4,24,162,87,75
050,31,151,"Nebraska","Saline County",4,25,140,81,59
050,31,151,"Nebraska","Saline County",4,26,168,85,83
050,31,151,"Nebraska","Saline County",4,27,139,69,70
050,31,151,"Nebraska","Saline County",4,28,148,71,77
050,31,151,"Nebraska","Saline County",4,29,154,72,82
050,31,151,"Nebraska","Saline County",4,30,158,85,73
050,31,151,"Nebraska","Saline County",4,31,133,69,64
050,31,151,"Nebraska","Saline County",4,32,150,75,75
050,31,151,"Nebraska","Saline County",4,33,134,71,63
050,31,151,"Nebraska","Saline County",4,34,141,83,58
050,31,151,"Nebraska","Saline County",4,35,154,75,79
050,31,151,"Nebraska","Saline County",4,36,172,94,78
050,31,151,"Nebraska","Saline County",4,37,175,94,81
050,31,151,"Nebraska","Saline County",4,38,188,115,73
050,31,151,"Nebraska","Saline County",4,39,200,124,76
050,31,151,"Nebraska","Saline County",4,40,188,101,87
050,31,151,"Nebraska","Saline County",4,41,182,86,96
050,31,151,"Nebraska","Saline County",4,42,192,92,100
050,31,151,"Nebraska","Saline County",4,43,179,91,88
050,31,151,"Nebraska","Saline County",4,44,201,103,98
050,31,151,"Nebraska","Saline County",4,45,171,94,77
050,31,151,"Nebraska","Saline County",4,46,163,91,72
050,31,151,"Nebraska","Saline County",4,47,165,81,84
050,31,151,"Nebraska","Saline County",4,48,177,81,96
050,31,151,"Nebraska","Saline County",4,49,172,94,78
050,31,151,"Nebraska","Saline County",4,50,172,96,76
050,31,151,"Nebraska","Saline County",4,51,184,96,88
050,31,151,"Nebraska","Saline County",4,52,169,79,90
050,31,151,"Nebraska","Saline County",4,53,171,86,85
050,31,151,"Nebraska","Saline County",4,54,169,93,76
050,31,151,"Nebraska","Saline County",4,55,148,83,65
050,31,151,"Nebraska","Saline County",4,56,158,85,73
050,31,151,"Nebraska","Saline County",4,57,160,84,76
050,31,151,"Nebraska","Saline County",4,58,162,91,71
050,31,151,"Nebraska","Saline County",4,59,171,89,82
050,31,151,"Nebraska","Saline County",4,60,180,98,82
050,31,151,"Nebraska","Saline County",4,61,193,105,88
050,31,151,"Nebraska","Saline County",4,62,189,103,86
050,31,151,"Nebraska","Saline County",4,63,178,97,81
050,31,151,"Nebraska","Saline County",4,64,160,87,73
050,31,151,"Nebraska","Saline County",4,65,159,81,78
050,31,151,"Nebraska","Saline County",4,66,151,81,70
050,31,151,"Nebraska","Saline County",4,67,152,74,78
050,31,151,"Nebraska","Saline County",4,68,149,66,83
050,31,151,"Nebraska","Saline County",4,69,140,64,76
050,31,151,"Nebraska","Saline County",4,70,132,70,62
050,31,151,"Nebraska","Saline County",4,71,119,62,57
050,31,151,"Nebraska","Saline County",4,72,111,52,59
050,31,151,"Nebraska","Saline County",4,73,100,51,49
050,31,151,"Nebraska","Saline County",4,74,107,53,54
050,31,151,"Nebraska","Saline County",4,75,110,53,57
050,31,151,"Nebraska","Saline County",4,76,71,36,35
050,31,151,"Nebraska","Saline County",4,77,77,35,42
050,31,151,"Nebraska","Saline County",4,78,77,33,44
050,31,151,"Nebraska","Saline County",4,79,74,30,44
050,31,151,"Nebraska","Saline County",4,80,64,31,33
050,31,151,"Nebraska","Saline County",4,81,58,30,28
050,31,151,"Nebraska","Saline County",4,82,49,23,26
050,31,151,"Nebraska","Saline County",4,83,53,28,25
050,31,151,"Nebraska","Saline County",4,84,43,18,25
050,31,151,"Nebraska","Saline County",4,85,294,102,192
050,31,151,"Nebraska","Saline County",5,0,170,83,87
050,31,151,"Nebraska","Saline County",5,1,176,94,82
050,31,151,"Nebraska","Saline County",5,2,206,102,104
050,31,151,"Nebraska","Saline County",5,3,193,100,93
050,31,151,"Nebraska","Saline County",5,4,196,104,92
050,31,151,"Nebraska","Saline County",5,5,200,106,94
050,31,151,"Nebraska","Saline County",5,6,223,106,117
050,31,151,"Nebraska","Saline County",5,7,202,98,104
050,31,151,"Nebraska","Saline County",5,8,222,116,106
050,31,151,"Nebraska","Saline County",5,9,198,110,88
050,31,151,"Nebraska","Saline County",5,10,202,106,96
050,31,151,"Nebraska","Saline County",5,11,229,117,112
050,31,151,"Nebraska","Saline County",5,12,231,120,111
050,31,151,"Nebraska","Saline County",5,13,234,123,111
050,31,151,"Nebraska","Saline County",5,14,238,119,119
050,31,151,"Nebraska","Saline County",5,15,228,115,113
050,31,151,"Nebraska","Saline County",5,16,239,134,105
050,31,151,"Nebraska","Saline County",5,17,237,138,99
050,31,151,"Nebraska","Saline County",5,18,264,136,128
050,31,151,"Nebraska","Saline County",5,19,341,180,161
050,31,151,"Nebraska","Saline County",5,20,262,146,116
050,31,151,"Nebraska","Saline County",5,21,250,125,125
050,31,151,"Nebraska","Saline County",5,22,225,120,105
050,31,151,"Nebraska","Saline County",5,23,167,93,74
050,31,151,"Nebraska","Saline County",5,24,150,78,72
050,31,151,"Nebraska","Saline County",5,25,150,79,71
050,31,151,"Nebraska","Saline County",5,26,153,84,69
050,31,151,"Nebraska","Saline County",5,27,154,89,65
050,31,151,"Nebraska","Saline County",5,28,143,73,70
050,31,151,"Nebraska","Saline County",5,29,157,74,83
050,31,151,"Nebraska","Saline County",5,30,154,73,81
050,31,151,"Nebraska","Saline County",5,31,157,83,74
050,31,151,"Nebraska","Saline County",5,32,140,69,71
050,31,151,"Nebraska","Saline County",5,33,151,74,77
050,31,151,"Nebraska","Saline County",5,34,137,77,60
050,31,151,"Nebraska","Saline County",5,35,137,77,60
050,31,151,"Nebraska","Saline County",5,36,163,79,84
050,31,151,"Nebraska","Saline County",5,37,179,102,77
050,31,151,"Nebraska","Saline County",5,38,177,93,84
050,31,151,"Nebraska","Saline County",5,39,193,122,71
050,31,151,"Nebraska","Saline County",5,40,192,112,80
050,31,151,"Nebraska","Saline County",5,41,188,96,92
050,31,151,"Nebraska","Saline County",5,42,189,93,96
050,31,151,"Nebraska","Saline County",5,43,195,94,101
050,31,151,"Nebraska","Saline County",5,44,180,87,93
050,31,151,"Nebraska","Saline County",5,45,196,97,99
050,31,151,"Nebraska","Saline County",5,46,176,98,78
050,31,151,"Nebraska","Saline County",5,47,165,92,73
050,31,151,"Nebraska","Saline County",5,48,167,85,82
050,31,151,"Nebraska","Saline County",5,49,176,82,94
050,31,151,"Nebraska","Saline County",5,50,169,93,76
050,31,151,"Nebraska","Saline County",5,51,181,102,79
050,31,151,"Nebraska","Saline County",5,52,175,93,82
050,31,151,"Nebraska","Saline County",5,53,169,79,90
050,31,151,"Nebraska","Saline County",5,54,165,81,84
050,31,151,"Nebraska","Saline County",5,55,163,96,67
050,31,151,"Nebraska","Saline County",5,56,154,85,69
050,31,151,"Nebraska","Saline County",5,57,160,90,70
050,31,151,"Nebraska","Saline County",5,58,156,84,72
050,31,151,"Nebraska","Saline County",5,59,161,91,70
050,31,151,"Nebraska","Saline County",5,60,169,88,81
050,31,151,"Nebraska","Saline County",5,61,177,98,79
050,31,151,"Nebraska","Saline County",5,62,191,103,88
050,31,151,"Nebraska","Saline County",5,63,187,102,85
050,31,151,"Nebraska","Saline County",5,64,175,95,80
050,31,151,"Nebraska","Saline County",5,65,159,84,75
050,31,151,"Nebraska","Saline County",5,66,154,82,72
050,31,151,"Nebraska","Saline County",5,67,148,78,70
050,31,151,"Nebraska","Saline County",5,68,147,70,77
050,31,151,"Nebraska","Saline County",5,69,149,64,85
050,31,151,"Nebraska","Saline County",5,70,132,63,69
050,31,151,"Nebraska","Saline County",5,71,130,68,62
050,31,151,"Nebraska","Saline County",5,72,121,64,57
050,31,151,"Nebraska","Saline County",5,73,109,50,59
050,31,151,"Nebraska","Saline County",5,74,98,52,46
050,31,151,"Nebraska","Saline County",5,75,104,50,54
050,31,151,"Nebraska","Saline County",5,76,106,52,54
050,31,151,"Nebraska","Saline County",5,77,73,34,39
050,31,151,"Nebraska","Saline County",5,78,68,31,37
050,31,151,"Nebraska","Saline County",5,79,75,29,46
050,31,151,"Nebraska","Saline County",5,80,73,31,42
050,31,151,"Nebraska","Saline County",5,81,64,31,33
050,31,151,"Nebraska","Saline County",5,82,47,23,24
050,31,151,"Nebraska","Saline County",5,83,52,29,23
050,31,151,"Nebraska","Saline County",5,84,46,19,27
050,31,151,"Nebraska","Saline County",5,85,296,102,194
050,31,153,"Nebraska","Sarpy County",1,0,2432,1244,1188
050,31,153,"Nebraska","Sarpy County",1,1,2495,1278,1217
050,31,153,"Nebraska","Sarpy County",1,2,2656,1364,1292
050,31,153,"Nebraska","Sarpy County",1,3,2673,1332,1341
050,31,153,"Nebraska","Sarpy County",1,4,2827,1447,1380
050,31,153,"Nebraska","Sarpy County",1,5,2874,1506,1368
050,31,153,"Nebraska","Sarpy County",1,6,2895,1475,1420
050,31,153,"Nebraska","Sarpy County",1,7,2899,1534,1365
050,31,153,"Nebraska","Sarpy County",1,8,2914,1438,1476
050,31,153,"Nebraska","Sarpy County",1,9,2920,1555,1365
050,31,153,"Nebraska","Sarpy County",1,10,3047,1612,1435
050,31,153,"Nebraska","Sarpy County",1,11,3184,1643,1541
050,31,153,"Nebraska","Sarpy County",1,12,3167,1650,1517
050,31,153,"Nebraska","Sarpy County",1,13,3124,1626,1498
050,31,153,"Nebraska","Sarpy County",1,14,2968,1537,1431
050,31,153,"Nebraska","Sarpy County",1,15,2994,1522,1472
050,31,153,"Nebraska","Sarpy County",1,16,2988,1523,1465
050,31,153,"Nebraska","Sarpy County",1,17,2948,1496,1452
050,31,153,"Nebraska","Sarpy County",1,18,2427,1245,1182
050,31,153,"Nebraska","Sarpy County",1,19,2007,1051,956
050,31,153,"Nebraska","Sarpy County",1,20,2148,1148,1000
050,31,153,"Nebraska","Sarpy County",1,21,2263,1218,1045
050,31,153,"Nebraska","Sarpy County",1,22,2294,1191,1103
050,31,153,"Nebraska","Sarpy County",1,23,2364,1239,1125
050,31,153,"Nebraska","Sarpy County",1,24,2480,1297,1183
050,31,153,"Nebraska","Sarpy County",1,25,2465,1285,1180
050,31,153,"Nebraska","Sarpy County",1,26,2562,1356,1206
050,31,153,"Nebraska","Sarpy County",1,27,2591,1374,1217
050,31,153,"Nebraska","Sarpy County",1,28,2635,1337,1298
050,31,153,"Nebraska","Sarpy County",1,29,2642,1337,1305
050,31,153,"Nebraska","Sarpy County",1,30,2679,1362,1317
050,31,153,"Nebraska","Sarpy County",1,31,2646,1308,1338
050,31,153,"Nebraska","Sarpy County",1,32,2755,1371,1384
050,31,153,"Nebraska","Sarpy County",1,33,2915,1471,1444
050,31,153,"Nebraska","Sarpy County",1,34,2912,1495,1417
050,31,153,"Nebraska","Sarpy County",1,35,2907,1468,1439
050,31,153,"Nebraska","Sarpy County",1,36,2858,1400,1458
050,31,153,"Nebraska","Sarpy County",1,37,3026,1534,1492
050,31,153,"Nebraska","Sarpy County",1,38,3001,1528,1473
050,31,153,"Nebraska","Sarpy County",1,39,3045,1537,1508
050,31,153,"Nebraska","Sarpy County",1,40,2919,1488,1431
050,31,153,"Nebraska","Sarpy County",1,41,2696,1367,1329
050,31,153,"Nebraska","Sarpy County",1,42,2652,1358,1294
050,31,153,"Nebraska","Sarpy County",1,43,2488,1256,1232
050,31,153,"Nebraska","Sarpy County",1,44,2383,1190,1193
050,31,153,"Nebraska","Sarpy County",1,45,2409,1193,1216
050,31,153,"Nebraska","Sarpy County",1,46,2306,1183,1123
050,31,153,"Nebraska","Sarpy County",1,47,2387,1232,1155
050,31,153,"Nebraska","Sarpy County",1,48,2518,1307,1211
050,31,153,"Nebraska","Sarpy County",1,49,2463,1272,1191
050,31,153,"Nebraska","Sarpy County",1,50,2374,1187,1187
050,31,153,"Nebraska","Sarpy County",1,51,2235,1100,1135
050,31,153,"Nebraska","Sarpy County",1,52,2139,1088,1051
050,31,153,"Nebraska","Sarpy County",1,53,2200,1119,1081
050,31,153,"Nebraska","Sarpy County",1,54,2226,1136,1090
050,31,153,"Nebraska","Sarpy County",1,55,2326,1155,1171
050,31,153,"Nebraska","Sarpy County",1,56,2406,1193,1213
050,31,153,"Nebraska","Sarpy County",1,57,2342,1189,1153
050,31,153,"Nebraska","Sarpy County",1,58,2327,1172,1155
050,31,153,"Nebraska","Sarpy County",1,59,2291,1139,1152
050,31,153,"Nebraska","Sarpy County",1,60,2195,1080,1115
050,31,153,"Nebraska","Sarpy County",1,61,2052,1000,1052
050,31,153,"Nebraska","Sarpy County",1,62,2028,1014,1014
050,31,153,"Nebraska","Sarpy County",1,63,1953,988,965
050,31,153,"Nebraska","Sarpy County",1,64,1820,906,914
050,31,153,"Nebraska","Sarpy County",1,65,1827,894,933
050,31,153,"Nebraska","Sarpy County",1,66,1638,781,857
050,31,153,"Nebraska","Sarpy County",1,67,1567,731,836
050,31,153,"Nebraska","Sarpy County",1,68,1555,720,835
050,31,153,"Nebraska","Sarpy County",1,69,1410,641,769
050,31,153,"Nebraska","Sarpy County",1,70,1337,627,710
050,31,153,"Nebraska","Sarpy County",1,71,1337,623,714
050,31,153,"Nebraska","Sarpy County",1,72,1291,612,679
050,31,153,"Nebraska","Sarpy County",1,73,1305,634,671
050,31,153,"Nebraska","Sarpy County",1,74,896,417,479
050,31,153,"Nebraska","Sarpy County",1,75,870,398,472
050,31,153,"Nebraska","Sarpy County",1,76,872,408,464
050,31,153,"Nebraska","Sarpy County",1,77,814,371,443
050,31,153,"Nebraska","Sarpy County",1,78,678,304,374
050,31,153,"Nebraska","Sarpy County",1,79,573,255,318
050,31,153,"Nebraska","Sarpy County",1,80,576,246,330
050,31,153,"Nebraska","Sarpy County",1,81,579,240,339
050,31,153,"Nebraska","Sarpy County",1,82,520,221,299
050,31,153,"Nebraska","Sarpy County",1,83,442,187,255
050,31,153,"Nebraska","Sarpy County",1,84,408,169,239
050,31,153,"Nebraska","Sarpy County",1,85,2340,843,1497
050,31,153,"Nebraska","Sarpy County",2,0,2446,1235,1211
050,31,153,"Nebraska","Sarpy County",2,1,2495,1277,1218
050,31,153,"Nebraska","Sarpy County",2,2,2625,1348,1277
050,31,153,"Nebraska","Sarpy County",2,3,2671,1339,1332
050,31,153,"Nebraska","Sarpy County",2,4,2800,1421,1379
050,31,153,"Nebraska","Sarpy County",2,5,2864,1486,1378
050,31,153,"Nebraska","Sarpy County",2,6,2891,1486,1405
050,31,153,"Nebraska","Sarpy County",2,7,2895,1511,1384
050,31,153,"Nebraska","Sarpy County",2,8,2900,1464,1436
050,31,153,"Nebraska","Sarpy County",2,9,2916,1525,1391
050,31,153,"Nebraska","Sarpy County",2,10,3020,1601,1419
050,31,153,"Nebraska","Sarpy County",2,11,3152,1638,1514
050,31,153,"Nebraska","Sarpy County",2,12,3190,1654,1536
050,31,153,"Nebraska","Sarpy County",2,13,3131,1628,1503
050,31,153,"Nebraska","Sarpy County",2,14,3009,1555,1454
050,31,153,"Nebraska","Sarpy County",2,15,2992,1525,1467
050,31,153,"Nebraska","Sarpy County",2,16,3002,1533,1469
050,31,153,"Nebraska","Sarpy County",2,17,2959,1502,1457
050,31,153,"Nebraska","Sarpy County",2,18,2448,1262,1186
050,31,153,"Nebraska","Sarpy County",2,19,2048,1069,979
050,31,153,"Nebraska","Sarpy County",2,20,2196,1164,1032
050,31,153,"Nebraska","Sarpy County",2,21,2265,1207,1058
050,31,153,"Nebraska","Sarpy County",2,22,2309,1203,1106
050,31,153,"Nebraska","Sarpy County",2,23,2375,1242,1133
050,31,153,"Nebraska","Sarpy County",2,24,2470,1291,1179
050,31,153,"Nebraska","Sarpy County",2,25,2483,1295,1188
050,31,153,"Nebraska","Sarpy County",2,26,2557,1353,1204
050,31,153,"Nebraska","Sarpy County",2,27,2580,1367,1213
050,31,153,"Nebraska","Sarpy County",2,28,2632,1346,1286
050,31,153,"Nebraska","Sarpy County",2,29,2669,1347,1322
050,31,153,"Nebraska","Sarpy County",2,30,2702,1375,1327
050,31,153,"Nebraska","Sarpy County",2,31,2654,1322,1332
050,31,153,"Nebraska","Sarpy County",2,32,2747,1365,1382
050,31,153,"Nebraska","Sarpy County",2,33,2891,1459,1432
050,31,153,"Nebraska","Sarpy County",2,34,2924,1497,1427
050,31,153,"Nebraska","Sarpy County",2,35,2928,1485,1443
050,31,153,"Nebraska","Sarpy County",2,36,2870,1420,1450
050,31,153,"Nebraska","Sarpy County",2,37,2998,1508,1490
050,31,153,"Nebraska","Sarpy County",2,38,3023,1536,1487
050,31,153,"Nebraska","Sarpy County",2,39,3031,1534,1497
050,31,153,"Nebraska","Sarpy County",2,40,2960,1506,1454
050,31,153,"Nebraska","Sarpy County",2,41,2760,1400,1360
050,31,153,"Nebraska","Sarpy County",2,42,2655,1358,1297
050,31,153,"Nebraska","Sarpy County",2,43,2540,1289,1251
050,31,153,"Nebraska","Sarpy County",2,44,2384,1194,1190
050,31,153,"Nebraska","Sarpy County",2,45,2404,1191,1213
050,31,153,"Nebraska","Sarpy County",2,46,2318,1180,1138
050,31,153,"Nebraska","Sarpy County",2,47,2359,1217,1142
050,31,153,"Nebraska","Sarpy County",2,48,2479,1286,1193
050,31,153,"Nebraska","Sarpy County",2,49,2481,1286,1195
050,31,153,"Nebraska","Sarpy County",2,50,2398,1206,1192
050,31,153,"Nebraska","Sarpy County",2,51,2256,1117,1139
050,31,153,"Nebraska","Sarpy County",2,52,2153,1085,1068
050,31,153,"Nebraska","Sarpy County",2,53,2182,1108,1074
050,31,153,"Nebraska","Sarpy County",2,54,2211,1123,1088
050,31,153,"Nebraska","Sarpy County",2,55,2297,1147,1150
050,31,153,"Nebraska","Sarpy County",2,56,2382,1182,1200
050,31,153,"Nebraska","Sarpy County",2,57,2356,1188,1168
050,31,153,"Nebraska","Sarpy County",2,58,2321,1169,1152
050,31,153,"Nebraska","Sarpy County",2,59,2310,1151,1159
050,31,153,"Nebraska","Sarpy County",2,60,2207,1088,1119
050,31,153,"Nebraska","Sarpy County",2,61,2082,1017,1065
050,31,153,"Nebraska","Sarpy County",2,62,2026,1007,1019
050,31,153,"Nebraska","Sarpy County",2,63,1982,1000,982
050,31,153,"Nebraska","Sarpy County",2,64,1840,918,922
050,31,153,"Nebraska","Sarpy County",2,65,1811,890,921
050,31,153,"Nebraska","Sarpy County",2,66,1683,808,875
050,31,153,"Nebraska","Sarpy County",2,67,1577,734,843
050,31,153,"Nebraska","Sarpy County",2,68,1543,709,834
050,31,153,"Nebraska","Sarpy County",2,69,1453,663,790
050,31,153,"Nebraska","Sarpy County",2,70,1350,627,723
050,31,153,"Nebraska","Sarpy County",2,71,1327,616,711
050,31,153,"Nebraska","Sarpy County",2,72,1281,605,676
050,31,153,"Nebraska","Sarpy County",2,73,1361,658,703
050,31,153,"Nebraska","Sarpy County",2,74,933,441,492
050,31,153,"Nebraska","Sarpy County",2,75,877,403,474
050,31,153,"Nebraska","Sarpy County",2,76,857,400,457
050,31,153,"Nebraska","Sarpy County",2,77,846,389,457
050,31,153,"Nebraska","Sarpy County",2,78,690,315,375
050,31,153,"Nebraska","Sarpy County",2,79,594,266,328
050,31,153,"Nebraska","Sarpy County",2,80,570,245,325
050,31,153,"Nebraska","Sarpy County",2,81,575,242,333
050,31,153,"Nebraska","Sarpy County",2,82,529,220,309
050,31,153,"Nebraska","Sarpy County",2,83,453,190,263
050,31,153,"Nebraska","Sarpy County",2,84,409,171,238
050,31,153,"Nebraska","Sarpy County",2,85,2347,848,1499
050,31,153,"Nebraska","Sarpy County",3,0,2392,1207,1185
050,31,153,"Nebraska","Sarpy County",3,1,2482,1250,1232
050,31,153,"Nebraska","Sarpy County",3,2,2573,1312,1261
050,31,153,"Nebraska","Sarpy County",3,3,2702,1407,1295
050,31,153,"Nebraska","Sarpy County",3,4,2772,1416,1356
050,31,153,"Nebraska","Sarpy County",3,5,2854,1464,1390
050,31,153,"Nebraska","Sarpy County",3,6,2906,1515,1391
050,31,153,"Nebraska","Sarpy County",3,7,2948,1502,1446
050,31,153,"Nebraska","Sarpy County",3,8,2907,1531,1376
050,31,153,"Nebraska","Sarpy County",3,9,2965,1502,1463
050,31,153,"Nebraska","Sarpy County",3,10,2926,1513,1413
050,31,153,"Nebraska","Sarpy County",3,11,3053,1617,1436
050,31,153,"Nebraska","Sarpy County",3,12,3137,1623,1514
050,31,153,"Nebraska","Sarpy County",3,13,3154,1638,1516
050,31,153,"Nebraska","Sarpy County",3,14,3166,1648,1518
050,31,153,"Nebraska","Sarpy County",3,15,3012,1574,1438
050,31,153,"Nebraska","Sarpy County",3,16,2994,1522,1472
050,31,153,"Nebraska","Sarpy County",3,17,2991,1552,1439
050,31,153,"Nebraska","Sarpy County",3,18,2523,1299,1224
050,31,153,"Nebraska","Sarpy County",3,19,2103,1107,996
050,31,153,"Nebraska","Sarpy County",3,20,2317,1230,1087
050,31,153,"Nebraska","Sarpy County",3,21,2345,1258,1087
050,31,153,"Nebraska","Sarpy County",3,22,2338,1234,1104
050,31,153,"Nebraska","Sarpy County",3,23,2390,1256,1134
050,31,153,"Nebraska","Sarpy County",3,24,2514,1323,1191
050,31,153,"Nebraska","Sarpy County",3,25,2455,1277,1178
050,31,153,"Nebraska","Sarpy County",3,26,2568,1344,1224
050,31,153,"Nebraska","Sarpy County",3,27,2596,1354,1242
050,31,153,"Nebraska","Sarpy County",3,28,2653,1374,1279
050,31,153,"Nebraska","Sarpy County",3,29,2662,1366,1296
050,31,153,"Nebraska","Sarpy County",3,30,2715,1383,1332
050,31,153,"Nebraska","Sarpy County",3,31,2750,1392,1358
050,31,153,"Nebraska","Sarpy County",3,32,2743,1355,1388
050,31,153,"Nebraska","Sarpy County",3,33,2830,1431,1399
050,31,153,"Nebraska","Sarpy County",3,34,2935,1476,1459
050,31,153,"Nebraska","Sarpy County",3,35,2966,1513,1453
050,31,153,"Nebraska","Sarpy County",3,36,2941,1475,1466
050,31,153,"Nebraska","Sarpy County",3,37,2973,1454,1519
050,31,153,"Nebraska","Sarpy County",3,38,3023,1534,1489
050,31,153,"Nebraska","Sarpy County",3,39,3042,1556,1486
050,31,153,"Nebraska","Sarpy County",3,40,3048,1534,1514
050,31,153,"Nebraska","Sarpy County",3,41,2989,1521,1468
050,31,153,"Nebraska","Sarpy County",3,42,2773,1433,1340
050,31,153,"Nebraska","Sarpy County",3,43,2623,1338,1285
050,31,153,"Nebraska","Sarpy County",3,44,2536,1279,1257
050,31,153,"Nebraska","Sarpy County",3,45,2415,1205,1210
050,31,153,"Nebraska","Sarpy County",3,46,2402,1203,1199
050,31,153,"Nebraska","Sarpy County",3,47,2332,1180,1152
050,31,153,"Nebraska","Sarpy County",3,48,2375,1219,1156
050,31,153,"Nebraska","Sarpy County",3,49,2495,1287,1208
050,31,153,"Nebraska","Sarpy County",3,50,2474,1278,1196
050,31,153,"Nebraska","Sarpy County",3,51,2394,1221,1173
050,31,153,"Nebraska","Sarpy County",3,52,2257,1128,1129
050,31,153,"Nebraska","Sarpy County",3,53,2155,1079,1076
050,31,153,"Nebraska","Sarpy County",3,54,2180,1104,1076
050,31,153,"Nebraska","Sarpy County",3,55,2201,1107,1094
050,31,153,"Nebraska","Sarpy County",3,56,2303,1143,1160
050,31,153,"Nebraska","Sarpy County",3,57,2370,1180,1190
050,31,153,"Nebraska","Sarpy County",3,58,2330,1173,1157
050,31,153,"Nebraska","Sarpy County",3,59,2323,1161,1162
050,31,153,"Nebraska","Sarpy County",3,60,2286,1136,1150
050,31,153,"Nebraska","Sarpy County",3,61,2162,1056,1106
050,31,153,"Nebraska","Sarpy County",3,62,2065,1014,1051
050,31,153,"Nebraska","Sarpy County",3,63,2004,983,1021
050,31,153,"Nebraska","Sarpy County",3,64,1936,969,967
050,31,153,"Nebraska","Sarpy County",3,65,1852,921,931
050,31,153,"Nebraska","Sarpy County",3,66,1798,870,928
050,31,153,"Nebraska","Sarpy County",3,67,1673,801,872
050,31,153,"Nebraska","Sarpy County",3,68,1566,715,851
050,31,153,"Nebraska","Sarpy County",3,69,1532,703,829
050,31,153,"Nebraska","Sarpy County",3,70,1448,653,795
050,31,153,"Nebraska","Sarpy County",3,71,1336,616,720
050,31,153,"Nebraska","Sarpy County",3,72,1310,605,705
050,31,153,"Nebraska","Sarpy County",3,73,1252,580,672
050,31,153,"Nebraska","Sarpy County",3,74,1339,645,694
050,31,153,"Nebraska","Sarpy County",3,75,898,425,473
050,31,153,"Nebraska","Sarpy County",3,76,854,394,460
050,31,153,"Nebraska","Sarpy County",3,77,839,388,451
050,31,153,"Nebraska","Sarpy County",3,78,812,375,437
050,31,153,"Nebraska","Sarpy County",3,79,657,299,358
050,31,153,"Nebraska","Sarpy County",3,80,586,257,329
050,31,153,"Nebraska","Sarpy County",3,81,540,231,309
050,31,153,"Nebraska","Sarpy County",3,82,538,217,321
050,31,153,"Nebraska","Sarpy County",3,83,501,207,294
050,31,153,"Nebraska","Sarpy County",3,84,429,181,248
050,31,153,"Nebraska","Sarpy County",3,85,2322,847,1475
050,31,153,"Nebraska","Sarpy County",4,0,2347,1214,1133
050,31,153,"Nebraska","Sarpy County",4,1,2431,1241,1190
050,31,153,"Nebraska","Sarpy County",4,2,2661,1353,1308
050,31,153,"Nebraska","Sarpy County",4,3,2609,1325,1284
050,31,153,"Nebraska","Sarpy County",4,4,2741,1429,1312
050,31,153,"Nebraska","Sarpy County",4,5,2830,1466,1364
050,31,153,"Nebraska","Sarpy County",4,6,2862,1484,1378
050,31,153,"Nebraska","Sarpy County",4,7,2942,1512,1430
050,31,153,"Nebraska","Sarpy County",4,8,2983,1540,1443
050,31,153,"Nebraska","Sarpy County",4,9,2944,1571,1373
050,31,153,"Nebraska","Sarpy County",4,10,2985,1501,1484
050,31,153,"Nebraska","Sarpy County",4,11,2915,1514,1401
050,31,153,"Nebraska","Sarpy County",4,12,3071,1613,1458
050,31,153,"Nebraska","Sarpy County",4,13,3119,1610,1509
050,31,153,"Nebraska","Sarpy County",4,14,3162,1633,1529
050,31,153,"Nebraska","Sarpy County",4,15,3174,1641,1533
050,31,153,"Nebraska","Sarpy County",4,16,3020,1557,1463
050,31,153,"Nebraska","Sarpy County",4,17,3006,1531,1475
050,31,153,"Nebraska","Sarpy County",4,18,2570,1362,1208
050,31,153,"Nebraska","Sarpy County",4,19,2081,1092,989
050,31,153,"Nebraska","Sarpy County",4,20,2262,1200,1062
050,31,153,"Nebraska","Sarpy County",4,21,2424,1266,1158
050,31,153,"Nebraska","Sarpy County",4,22,2470,1291,1179
050,31,153,"Nebraska","Sarpy County",4,23,2504,1278,1226
050,31,153,"Nebraska","Sarpy County",4,24,2470,1310,1160
050,31,153,"Nebraska","Sarpy County",4,25,2571,1339,1232
050,31,153,"Nebraska","Sarpy County",4,26,2605,1356,1249
050,31,153,"Nebraska","Sarpy County",4,27,2616,1359,1257
050,31,153,"Nebraska","Sarpy County",4,28,2680,1383,1297
050,31,153,"Nebraska","Sarpy County",4,29,2673,1406,1267
050,31,153,"Nebraska","Sarpy County",4,30,2760,1422,1338
050,31,153,"Nebraska","Sarpy County",4,31,2863,1474,1389
050,31,153,"Nebraska","Sarpy County",4,32,2892,1480,1412
050,31,153,"Nebraska","Sarpy County",4,33,2785,1368,1417
050,31,153,"Nebraska","Sarpy County",4,34,2828,1431,1397
050,31,153,"Nebraska","Sarpy County",4,35,3005,1506,1499
050,31,153,"Nebraska","Sarpy County",4,36,2975,1525,1450
050,31,153,"Nebraska","Sarpy County",4,37,3030,1544,1486
050,31,153,"Nebraska","Sarpy County",4,38,3007,1488,1519
050,31,153,"Nebraska","Sarpy County",4,39,3040,1526,1514
050,31,153,"Nebraska","Sarpy County",4,40,3111,1587,1524
050,31,153,"Nebraska","Sarpy County",4,41,3037,1522,1515
050,31,153,"Nebraska","Sarpy County",4,42,2979,1529,1450
050,31,153,"Nebraska","Sarpy County",4,43,2772,1428,1344
050,31,153,"Nebraska","Sarpy County",4,44,2628,1355,1273
050,31,153,"Nebraska","Sarpy County",4,45,2550,1297,1253
050,31,153,"Nebraska","Sarpy County",4,46,2404,1186,1218
050,31,153,"Nebraska","Sarpy County",4,47,2385,1204,1181
050,31,153,"Nebraska","Sarpy County",4,48,2305,1163,1142
050,31,153,"Nebraska","Sarpy County",4,49,2339,1207,1132
050,31,153,"Nebraska","Sarpy County",4,50,2469,1264,1205
050,31,153,"Nebraska","Sarpy County",4,51,2479,1283,1196
050,31,153,"Nebraska","Sarpy County",4,52,2380,1206,1174
050,31,153,"Nebraska","Sarpy County",4,53,2248,1125,1123
050,31,153,"Nebraska","Sarpy County",4,54,2149,1079,1070
050,31,153,"Nebraska","Sarpy County",4,55,2148,1096,1052
050,31,153,"Nebraska","Sarpy County",4,56,2214,1127,1087
050,31,153,"Nebraska","Sarpy County",4,57,2280,1138,1142
050,31,153,"Nebraska","Sarpy County",4,58,2345,1166,1179
050,31,153,"Nebraska","Sarpy County",4,59,2311,1166,1145
050,31,153,"Nebraska","Sarpy County",4,60,2299,1152,1147
050,31,153,"Nebraska","Sarpy County",4,61,2273,1131,1142
050,31,153,"Nebraska","Sarpy County",4,62,2122,1045,1077
050,31,153,"Nebraska","Sarpy County",4,63,2021,984,1037
050,31,153,"Nebraska","Sarpy County",4,64,1964,958,1006
050,31,153,"Nebraska","Sarpy County",4,65,1911,951,960
050,31,153,"Nebraska","Sarpy County",4,66,1828,893,935
050,31,153,"Nebraska","Sarpy County",4,67,1788,856,932
050,31,153,"Nebraska","Sarpy County",4,68,1656,779,877
050,31,153,"Nebraska","Sarpy County",4,69,1550,705,845
050,31,153,"Nebraska","Sarpy County",4,70,1537,703,834
050,31,153,"Nebraska","Sarpy County",4,71,1441,639,802
050,31,153,"Nebraska","Sarpy County",4,72,1316,601,715
050,31,153,"Nebraska","Sarpy County",4,73,1319,591,728
050,31,153,"Nebraska","Sarpy County",4,74,1258,574,684
050,31,153,"Nebraska","Sarpy County",4,75,1295,612,683
050,31,153,"Nebraska","Sarpy County",4,76,869,410,459
050,31,153,"Nebraska","Sarpy County",4,77,838,383,455
050,31,153,"Nebraska","Sarpy County",4,78,803,370,433
050,31,153,"Nebraska","Sarpy County",4,79,788,358,430
050,31,153,"Nebraska","Sarpy County",4,80,642,290,352
050,31,153,"Nebraska","Sarpy County",4,81,562,238,324
050,31,153,"Nebraska","Sarpy County",4,82,500,210,290
050,31,153,"Nebraska","Sarpy County",4,83,505,209,296
050,31,153,"Nebraska","Sarpy County",4,84,475,197,278
050,31,153,"Nebraska","Sarpy County",4,85,2421,895,1526
050,31,153,"Nebraska","Sarpy County",5,0,2361,1224,1137
050,31,153,"Nebraska","Sarpy County",5,1,2433,1250,1183
050,31,153,"Nebraska","Sarpy County",5,2,2527,1296,1231
050,31,153,"Nebraska","Sarpy County",5,3,2716,1391,1325
050,31,153,"Nebraska","Sarpy County",5,4,2658,1351,1307
050,31,153,"Nebraska","Sarpy County",5,5,2801,1448,1353
050,31,153,"Nebraska","Sarpy County",5,6,2859,1480,1379
050,31,153,"Nebraska","Sarpy County",5,7,2879,1510,1369
050,31,153,"Nebraska","Sarpy County",5,8,2961,1534,1427
050,31,153,"Nebraska","Sarpy County",5,9,3000,1553,1447
050,31,153,"Nebraska","Sarpy County",5,10,2992,1570,1422
050,31,153,"Nebraska","Sarpy County",5,11,2990,1502,1488
050,31,153,"Nebraska","Sarpy County",5,12,2945,1514,1431
050,31,153,"Nebraska","Sarpy County",5,13,3105,1631,1474
050,31,153,"Nebraska","Sarpy County",5,14,3153,1604,1549
050,31,153,"Nebraska","Sarpy County",5,15,3161,1628,1533
050,31,153,"Nebraska","Sarpy County",5,16,3236,1697,1539
050,31,153,"Nebraska","Sarpy County",5,17,3027,1569,1458
050,31,153,"Nebraska","Sarpy County",5,18,2581,1363,1218
050,31,153,"Nebraska","Sarpy County",5,19,2165,1164,1001
050,31,153,"Nebraska","Sarpy County",5,20,2370,1243,1127
050,31,153,"Nebraska","Sarpy County",5,21,2425,1267,1158
050,31,153,"Nebraska","Sarpy County",5,22,2588,1321,1267
050,31,153,"Nebraska","Sarpy County",5,23,2644,1362,1282
050,31,153,"Nebraska","Sarpy County",5,24,2649,1384,1265
050,31,153,"Nebraska","Sarpy County",5,25,2610,1348,1262
050,31,153,"Nebraska","Sarpy County",5,26,2655,1366,1289
050,31,153,"Nebraska","Sarpy County",5,27,2691,1396,1295
050,31,153,"Nebraska","Sarpy County",5,28,2682,1391,1291
050,31,153,"Nebraska","Sarpy County",5,29,2717,1377,1340
050,31,153,"Nebraska","Sarpy County",5,30,2799,1482,1317
050,31,153,"Nebraska","Sarpy County",5,31,2859,1478,1381
050,31,153,"Nebraska","Sarpy County",5,32,2916,1496,1420
050,31,153,"Nebraska","Sarpy County",5,33,3003,1560,1443
050,31,153,"Nebraska","Sarpy County",5,34,2849,1418,1431
050,31,153,"Nebraska","Sarpy County",5,35,2891,1465,1426
050,31,153,"Nebraska","Sarpy County",5,36,3059,1535,1524
050,31,153,"Nebraska","Sarpy County",5,37,3038,1554,1484
050,31,153,"Nebraska","Sarpy County",5,38,3050,1567,1483
050,31,153,"Nebraska","Sarpy County",5,39,3059,1507,1552
050,31,153,"Nebraska","Sarpy County",5,40,3102,1581,1521
050,31,153,"Nebraska","Sarpy County",5,41,3131,1616,1515
050,31,153,"Nebraska","Sarpy County",5,42,3024,1519,1505
050,31,153,"Nebraska","Sarpy County",5,43,2974,1526,1448
050,31,153,"Nebraska","Sarpy County",5,44,2790,1449,1341
050,31,153,"Nebraska","Sarpy County",5,45,2643,1380,1263
050,31,153,"Nebraska","Sarpy County",5,46,2542,1262,1280
050,31,153,"Nebraska","Sarpy County",5,47,2421,1206,1215
050,31,153,"Nebraska","Sarpy County",5,48,2373,1186,1187
050,31,153,"Nebraska","Sarpy County",5,49,2313,1174,1139
050,31,153,"Nebraska","Sarpy County",5,50,2366,1226,1140
050,31,153,"Nebraska","Sarpy County",5,51,2467,1281,1186
050,31,153,"Nebraska","Sarpy County",5,52,2459,1258,1201
050,31,153,"Nebraska","Sarpy County",5,53,2384,1207,1177
050,31,153,"Nebraska","Sarpy County",5,54,2256,1136,1120
050,31,153,"Nebraska","Sarpy County",5,55,2155,1089,1066
050,31,153,"Nebraska","Sarpy County",5,56,2148,1091,1057
050,31,153,"Nebraska","Sarpy County",5,57,2187,1110,1077
050,31,153,"Nebraska","Sarpy County",5,58,2245,1115,1130
050,31,153,"Nebraska","Sarpy County",5,59,2370,1182,1188
050,31,153,"Nebraska","Sarpy County",5,60,2304,1162,1142
050,31,153,"Nebraska","Sarpy County",5,61,2292,1138,1154
050,31,153,"Nebraska","Sarpy County",5,62,2264,1123,1141
050,31,153,"Nebraska","Sarpy County",5,63,2106,1047,1059
050,31,153,"Nebraska","Sarpy County",5,64,1982,964,1018
050,31,153,"Nebraska","Sarpy County",5,65,1963,938,1025
050,31,153,"Nebraska","Sarpy County",5,66,1880,932,948
050,31,153,"Nebraska","Sarpy County",5,67,1799,874,925
050,31,153,"Nebraska","Sarpy County",5,68,1762,841,921
050,31,153,"Nebraska","Sarpy County",5,69,1650,778,872
050,31,153,"Nebraska","Sarpy County",5,70,1539,701,838
050,31,153,"Nebraska","Sarpy County",5,71,1508,686,822
050,31,153,"Nebraska","Sarpy County",5,72,1424,628,796
050,31,153,"Nebraska","Sarpy County",5,73,1318,596,722
050,31,153,"Nebraska","Sarpy County",5,74,1297,575,722
050,31,153,"Nebraska","Sarpy County",5,75,1228,555,673
050,31,153,"Nebraska","Sarpy County",5,76,1278,593,685
050,31,153,"Nebraska","Sarpy County",5,77,851,401,450
050,31,153,"Nebraska","Sarpy County",5,78,813,369,444
050,31,153,"Nebraska","Sarpy County",5,79,770,353,417
050,31,153,"Nebraska","Sarpy County",5,80,775,342,433
050,31,153,"Nebraska","Sarpy County",5,81,614,278,336
050,31,153,"Nebraska","Sarpy County",5,82,526,219,307
050,31,153,"Nebraska","Sarpy County",5,83,467,197,270
050,31,153,"Nebraska","Sarpy County",5,84,484,210,274
050,31,153,"Nebraska","Sarpy County",5,85,2538,963,1575
050,31,155,"Nebraska","Saunders County",1,0,247,126,121
050,31,155,"Nebraska","Saunders County",1,1,253,125,128
050,31,155,"Nebraska","Saunders County",1,2,306,167,139
050,31,155,"Nebraska","Saunders County",1,3,309,165,144
050,31,155,"Nebraska","Saunders County",1,4,285,145,140
050,31,155,"Nebraska","Saunders County",1,5,295,151,144
050,31,155,"Nebraska","Saunders County",1,6,302,147,155
050,31,155,"Nebraska","Saunders County",1,7,301,150,151
050,31,155,"Nebraska","Saunders County",1,8,309,166,143
050,31,155,"Nebraska","Saunders County",1,9,318,166,152
050,31,155,"Nebraska","Saunders County",1,10,342,174,168
050,31,155,"Nebraska","Saunders County",1,11,316,163,153
050,31,155,"Nebraska","Saunders County",1,12,340,181,159
050,31,155,"Nebraska","Saunders County",1,13,343,185,158
050,31,155,"Nebraska","Saunders County",1,14,341,187,154
050,31,155,"Nebraska","Saunders County",1,15,302,165,137
050,31,155,"Nebraska","Saunders County",1,16,329,170,159
050,31,155,"Nebraska","Saunders County",1,17,309,171,138
050,31,155,"Nebraska","Saunders County",1,18,264,157,107
050,31,155,"Nebraska","Saunders County",1,19,200,115,85
050,31,155,"Nebraska","Saunders County",1,20,229,123,106
050,31,155,"Nebraska","Saunders County",1,21,212,113,99
050,31,155,"Nebraska","Saunders County",1,22,207,98,109
050,31,155,"Nebraska","Saunders County",1,23,224,112,112
050,31,155,"Nebraska","Saunders County",1,24,222,112,110
050,31,155,"Nebraska","Saunders County",1,25,219,106,113
050,31,155,"Nebraska","Saunders County",1,26,224,109,115
050,31,155,"Nebraska","Saunders County",1,27,236,119,117
050,31,155,"Nebraska","Saunders County",1,28,272,145,127
050,31,155,"Nebraska","Saunders County",1,29,208,104,104
050,31,155,"Nebraska","Saunders County",1,30,221,112,109
050,31,155,"Nebraska","Saunders County",1,31,220,98,122
050,31,155,"Nebraska","Saunders County",1,32,246,120,126
050,31,155,"Nebraska","Saunders County",1,33,258,128,130
050,31,155,"Nebraska","Saunders County",1,34,260,139,121
050,31,155,"Nebraska","Saunders County",1,35,289,145,144
050,31,155,"Nebraska","Saunders County",1,36,298,153,145
050,31,155,"Nebraska","Saunders County",1,37,299,158,141
050,31,155,"Nebraska","Saunders County",1,38,305,154,151
050,31,155,"Nebraska","Saunders County",1,39,294,145,149
050,31,155,"Nebraska","Saunders County",1,40,277,135,142
050,31,155,"Nebraska","Saunders County",1,41,257,138,119
050,31,155,"Nebraska","Saunders County",1,42,251,135,116
050,31,155,"Nebraska","Saunders County",1,43,231,125,106
050,31,155,"Nebraska","Saunders County",1,44,256,142,114
050,31,155,"Nebraska","Saunders County",1,45,245,112,133
050,31,155,"Nebraska","Saunders County",1,46,227,114,113
050,31,155,"Nebraska","Saunders County",1,47,238,125,113
050,31,155,"Nebraska","Saunders County",1,48,262,133,129
050,31,155,"Nebraska","Saunders County",1,49,247,125,122
050,31,155,"Nebraska","Saunders County",1,50,232,118,114
050,31,155,"Nebraska","Saunders County",1,51,257,128,129
050,31,155,"Nebraska","Saunders County",1,52,267,132,135
050,31,155,"Nebraska","Saunders County",1,53,302,152,150
050,31,155,"Nebraska","Saunders County",1,54,309,158,151
050,31,155,"Nebraska","Saunders County",1,55,344,181,163
050,31,155,"Nebraska","Saunders County",1,56,357,195,162
050,31,155,"Nebraska","Saunders County",1,57,382,193,189
050,31,155,"Nebraska","Saunders County",1,58,380,191,189
050,31,155,"Nebraska","Saunders County",1,59,343,169,174
050,31,155,"Nebraska","Saunders County",1,60,356,185,171
050,31,155,"Nebraska","Saunders County",1,61,334,172,162
050,31,155,"Nebraska","Saunders County",1,62,320,173,147
050,31,155,"Nebraska","Saunders County",1,63,298,162,136
050,31,155,"Nebraska","Saunders County",1,64,300,155,145
050,31,155,"Nebraska","Saunders County",1,65,263,131,132
050,31,155,"Nebraska","Saunders County",1,66,248,123,125
050,31,155,"Nebraska","Saunders County",1,67,264,134,130
050,31,155,"Nebraska","Saunders County",1,68,284,150,134
050,31,155,"Nebraska","Saunders County",1,69,236,129,107
050,31,155,"Nebraska","Saunders County",1,70,238,128,110
050,31,155,"Nebraska","Saunders County",1,71,241,126,115
050,31,155,"Nebraska","Saunders County",1,72,234,125,109
050,31,155,"Nebraska","Saunders County",1,73,220,114,106
050,31,155,"Nebraska","Saunders County",1,74,163,84,79
050,31,155,"Nebraska","Saunders County",1,75,148,75,73
050,31,155,"Nebraska","Saunders County",1,76,154,79,75
050,31,155,"Nebraska","Saunders County",1,77,133,60,73
050,31,155,"Nebraska","Saunders County",1,78,129,62,67
050,31,155,"Nebraska","Saunders County",1,79,114,51,63
050,31,155,"Nebraska","Saunders County",1,80,114,59,55
050,31,155,"Nebraska","Saunders County",1,81,113,62,51
050,31,155,"Nebraska","Saunders County",1,82,88,38,50
050,31,155,"Nebraska","Saunders County",1,83,95,32,63
050,31,155,"Nebraska","Saunders County",1,84,86,28,58
050,31,155,"Nebraska","Saunders County",1,85,490,171,319
050,31,155,"Nebraska","Saunders County",2,0,246,124,122
050,31,155,"Nebraska","Saunders County",2,1,255,126,129
050,31,155,"Nebraska","Saunders County",2,2,296,157,139
050,31,155,"Nebraska","Saunders County",2,3,309,166,143
050,31,155,"Nebraska","Saunders County",2,4,295,152,143
050,31,155,"Nebraska","Saunders County",2,5,296,151,145
050,31,155,"Nebraska","Saunders County",2,6,302,148,154
050,31,155,"Nebraska","Saunders County",2,7,305,151,154
050,31,155,"Nebraska","Saunders County",2,8,308,163,145
050,31,155,"Nebraska","Saunders County",2,9,322,169,153
050,31,155,"Nebraska","Saunders County",2,10,340,174,166
050,31,155,"Nebraska","Saunders County",2,11,323,165,158
050,31,155,"Nebraska","Saunders County",2,12,338,178,160
050,31,155,"Nebraska","Saunders County",2,13,346,185,161
050,31,155,"Nebraska","Saunders County",2,14,341,187,154
050,31,155,"Nebraska","Saunders County",2,15,315,172,143
050,31,155,"Nebraska","Saunders County",2,16,326,170,156
050,31,155,"Nebraska","Saunders County",2,17,315,172,143
050,31,155,"Nebraska","Saunders County",2,18,263,155,108
050,31,155,"Nebraska","Saunders County",2,19,205,119,86
050,31,155,"Nebraska","Saunders County",2,20,229,124,105
050,31,155,"Nebraska","Saunders County",2,21,215,114,101
050,31,155,"Nebraska","Saunders County",2,22,211,103,108
050,31,155,"Nebraska","Saunders County",2,23,217,108,109
050,31,155,"Nebraska","Saunders County",2,24,225,115,110
050,31,155,"Nebraska","Saunders County",2,25,218,106,112
050,31,155,"Nebraska","Saunders County",2,26,220,107,113
050,31,155,"Nebraska","Saunders County",2,27,238,120,118
050,31,155,"Nebraska","Saunders County",2,28,266,139,127
050,31,155,"Nebraska","Saunders County",2,29,226,115,111
050,31,155,"Nebraska","Saunders County",2,30,220,110,110
050,31,155,"Nebraska","Saunders County",2,31,223,103,120
050,31,155,"Nebraska","Saunders County",2,32,244,117,127
050,31,155,"Nebraska","Saunders County",2,33,258,127,131
050,31,155,"Nebraska","Saunders County",2,34,264,139,125
050,31,155,"Nebraska","Saunders County",2,35,286,144,142
050,31,155,"Nebraska","Saunders County",2,36,299,154,145
050,31,155,"Nebraska","Saunders County",2,37,301,158,143
050,31,155,"Nebraska","Saunders County",2,38,307,156,151
050,31,155,"Nebraska","Saunders County",2,39,297,147,150
050,31,155,"Nebraska","Saunders County",2,40,282,139,143
050,31,155,"Nebraska","Saunders County",2,41,262,138,124
050,31,155,"Nebraska","Saunders County",2,42,253,136,117
050,31,155,"Nebraska","Saunders County",2,43,240,130,110
050,31,155,"Nebraska","Saunders County",2,44,248,137,111
050,31,155,"Nebraska","Saunders County",2,45,253,122,131
050,31,155,"Nebraska","Saunders County",2,46,231,114,117
050,31,155,"Nebraska","Saunders County",2,47,237,122,115
050,31,155,"Nebraska","Saunders County",2,48,259,132,127
050,31,155,"Nebraska","Saunders County",2,49,250,127,123
050,31,155,"Nebraska","Saunders County",2,50,238,120,118
050,31,155,"Nebraska","Saunders County",2,51,251,125,126
050,31,155,"Nebraska","Saunders County",2,52,268,133,135
050,31,155,"Nebraska","Saunders County",2,53,292,145,147
050,31,155,"Nebraska","Saunders County",2,54,308,156,152
050,31,155,"Nebraska","Saunders County",2,55,336,177,159
050,31,155,"Nebraska","Saunders County",2,56,354,190,164
050,31,155,"Nebraska","Saunders County",2,57,378,195,183
050,31,155,"Nebraska","Saunders County",2,58,380,191,189
050,31,155,"Nebraska","Saunders County",2,59,357,177,180
050,31,155,"Nebraska","Saunders County",2,60,352,180,172
050,31,155,"Nebraska","Saunders County",2,61,339,175,164
050,31,155,"Nebraska","Saunders County",2,62,324,173,151
050,31,155,"Nebraska","Saunders County",2,63,307,167,140
050,31,155,"Nebraska","Saunders County",2,64,296,155,141
050,31,155,"Nebraska","Saunders County",2,65,269,136,133
050,31,155,"Nebraska","Saunders County",2,66,251,124,127
050,31,155,"Nebraska","Saunders County",2,67,261,133,128
050,31,155,"Nebraska","Saunders County",2,68,275,145,130
050,31,155,"Nebraska","Saunders County",2,69,248,135,113
050,31,155,"Nebraska","Saunders County",2,70,236,128,108
050,31,155,"Nebraska","Saunders County",2,71,240,125,115
050,31,155,"Nebraska","Saunders County",2,72,228,119,109
050,31,155,"Nebraska","Saunders County",2,73,235,123,112
050,31,155,"Nebraska","Saunders County",2,74,169,88,81
050,31,155,"Nebraska","Saunders County",2,75,148,76,72
050,31,155,"Nebraska","Saunders County",2,76,149,76,73
050,31,155,"Nebraska","Saunders County",2,77,140,64,76
050,31,155,"Nebraska","Saunders County",2,78,123,59,64
050,31,155,"Nebraska","Saunders County",2,79,115,53,62
050,31,155,"Nebraska","Saunders County",2,80,107,51,56
050,31,155,"Nebraska","Saunders County",2,81,115,63,52
050,31,155,"Nebraska","Saunders County",2,82,91,42,49
050,31,155,"Nebraska","Saunders County",2,83,95,33,62
050,31,155,"Nebraska","Saunders County",2,84,86,28,58
050,31,155,"Nebraska","Saunders County",2,85,488,167,321
050,31,155,"Nebraska","Saunders County",3,0,281,145,136
050,31,155,"Nebraska","Saunders County",3,1,254,135,119
050,31,155,"Nebraska","Saunders County",3,2,275,134,141
050,31,155,"Nebraska","Saunders County",3,3,305,166,139
050,31,155,"Nebraska","Saunders County",3,4,334,183,151
050,31,155,"Nebraska","Saunders County",3,5,317,165,152
050,31,155,"Nebraska","Saunders County",3,6,329,161,168
050,31,155,"Nebraska","Saunders County",3,7,313,152,161
050,31,155,"Nebraska","Saunders County",3,8,317,159,158
050,31,155,"Nebraska","Saunders County",3,9,326,173,153
050,31,155,"Nebraska","Saunders County",3,10,328,168,160
050,31,155,"Nebraska","Saunders County",3,11,347,182,165
050,31,155,"Nebraska","Saunders County",3,12,350,178,172
050,31,155,"Nebraska","Saunders County",3,13,351,190,161
050,31,155,"Nebraska","Saunders County",3,14,344,184,160
050,31,155,"Nebraska","Saunders County",3,15,330,183,147
050,31,155,"Nebraska","Saunders County",3,16,319,171,148
050,31,155,"Nebraska","Saunders County",3,17,337,173,164
050,31,155,"Nebraska","Saunders County",3,18,266,160,106
050,31,155,"Nebraska","Saunders County",3,19,218,127,91
050,31,155,"Nebraska","Saunders County",3,20,227,132,95
050,31,155,"Nebraska","Saunders County",3,21,229,120,109
050,31,155,"Nebraska","Saunders County",3,22,235,122,113
050,31,155,"Nebraska","Saunders County",3,23,201,97,104
050,31,155,"Nebraska","Saunders County",3,24,209,112,97
050,31,155,"Nebraska","Saunders County",3,25,227,113,114
050,31,155,"Nebraska","Saunders County",3,26,209,108,101
050,31,155,"Nebraska","Saunders County",3,27,225,112,113
050,31,155,"Nebraska","Saunders County",3,28,245,127,118
050,31,155,"Nebraska","Saunders County",3,29,270,138,132
050,31,155,"Nebraska","Saunders County",3,30,247,129,118
050,31,155,"Nebraska","Saunders County",3,31,221,114,107
050,31,155,"Nebraska","Saunders County",3,32,247,109,138
050,31,155,"Nebraska","Saunders County",3,33,254,123,131
050,31,155,"Nebraska","Saunders County",3,34,276,141,135
050,31,155,"Nebraska","Saunders County",3,35,283,150,133
050,31,155,"Nebraska","Saunders County",3,36,310,163,147
050,31,155,"Nebraska","Saunders County",3,37,318,161,157
050,31,155,"Nebraska","Saunders County",3,38,315,160,155
050,31,155,"Nebraska","Saunders County",3,39,312,166,146
050,31,155,"Nebraska","Saunders County",3,40,304,148,156
050,31,155,"Nebraska","Saunders County",3,41,298,146,152
050,31,155,"Nebraska","Saunders County",3,42,279,142,137
050,31,155,"Nebraska","Saunders County",3,43,271,148,123
050,31,155,"Nebraska","Saunders County",3,44,249,137,112
050,31,155,"Nebraska","Saunders County",3,45,251,139,112
050,31,155,"Nebraska","Saunders County",3,46,250,125,125
050,31,155,"Nebraska","Saunders County",3,47,228,113,115
050,31,155,"Nebraska","Saunders County",3,48,250,122,128
050,31,155,"Nebraska","Saunders County",3,49,253,131,122
050,31,155,"Nebraska","Saunders County",3,50,250,126,124
050,31,155,"Nebraska","Saunders County",3,51,246,124,122
050,31,155,"Nebraska","Saunders County",3,52,258,129,129
050,31,155,"Nebraska","Saunders County",3,53,259,126,133
050,31,155,"Nebraska","Saunders County",3,54,300,151,149
050,31,155,"Nebraska","Saunders County",3,55,311,160,151
050,31,155,"Nebraska","Saunders County",3,56,330,171,159
050,31,155,"Nebraska","Saunders County",3,57,353,190,163
050,31,155,"Nebraska","Saunders County",3,58,387,199,188
050,31,155,"Nebraska","Saunders County",3,59,384,195,189
050,31,155,"Nebraska","Saunders County",3,60,361,184,177
050,31,155,"Nebraska","Saunders County",3,61,353,179,174
050,31,155,"Nebraska","Saunders County",3,62,357,181,176
050,31,155,"Nebraska","Saunders County",3,63,321,170,151
050,31,155,"Nebraska","Saunders County",3,64,307,169,138
050,31,155,"Nebraska","Saunders County",3,65,298,153,145
050,31,155,"Nebraska","Saunders County",3,66,260,134,126
050,31,155,"Nebraska","Saunders County",3,67,247,123,124
050,31,155,"Nebraska","Saunders County",3,68,251,123,128
050,31,155,"Nebraska","Saunders County",3,69,260,137,123
050,31,155,"Nebraska","Saunders County",3,70,237,128,109
050,31,155,"Nebraska","Saunders County",3,71,234,128,106
050,31,155,"Nebraska","Saunders County",3,72,232,119,113
050,31,155,"Nebraska","Saunders County",3,73,228,117,111
050,31,155,"Nebraska","Saunders County",3,74,238,129,109
050,31,155,"Nebraska","Saunders County",3,75,150,74,76
050,31,155,"Nebraska","Saunders County",3,76,149,80,69
050,31,155,"Nebraska","Saunders County",3,77,146,73,73
050,31,155,"Nebraska","Saunders County",3,78,133,61,72
050,31,155,"Nebraska","Saunders County",3,79,115,55,60
050,31,155,"Nebraska","Saunders County",3,80,108,50,58
050,31,155,"Nebraska","Saunders County",3,81,104,49,55
050,31,155,"Nebraska","Saunders County",3,82,91,43,48
050,31,155,"Nebraska","Saunders County",3,83,99,40,59
050,31,155,"Nebraska","Saunders County",3,84,73,22,51
050,31,155,"Nebraska","Saunders County",3,85,468,160,308
050,31,155,"Nebraska","Saunders County",4,0,246,134,112
050,31,155,"Nebraska","Saunders County",4,1,319,166,153
050,31,155,"Nebraska","Saunders County",4,2,265,143,122
050,31,155,"Nebraska","Saunders County",4,3,288,144,144
050,31,155,"Nebraska","Saunders County",4,4,317,176,141
050,31,155,"Nebraska","Saunders County",4,5,337,182,155
050,31,155,"Nebraska","Saunders County",4,6,329,174,155
050,31,155,"Nebraska","Saunders County",4,7,335,161,174
050,31,155,"Nebraska","Saunders County",4,8,314,151,163
050,31,155,"Nebraska","Saunders County",4,9,315,166,149
050,31,155,"Nebraska","Saunders County",4,10,337,181,156
050,31,155,"Nebraska","Saunders County",4,11,334,173,161
050,31,155,"Nebraska","Saunders County",4,12,351,182,169
050,31,155,"Nebraska","Saunders County",4,13,349,174,175
050,31,155,"Nebraska","Saunders County",4,14,351,183,168
050,31,155,"Nebraska","Saunders County",4,15,353,186,167
050,31,155,"Nebraska","Saunders County",4,16,335,184,151
050,31,155,"Nebraska","Saunders County",4,17,324,174,150
050,31,155,"Nebraska","Saunders County",4,18,289,156,133
050,31,155,"Nebraska","Saunders County",4,19,212,131,81
050,31,155,"Nebraska","Saunders County",4,20,229,130,99
050,31,155,"Nebraska","Saunders County",4,21,220,126,94
050,31,155,"Nebraska","Saunders County",4,22,249,129,120
050,31,155,"Nebraska","Saunders County",4,23,229,119,110
050,31,155,"Nebraska","Saunders County",4,24,211,106,105
050,31,155,"Nebraska","Saunders County",4,25,216,119,97
050,31,155,"Nebraska","Saunders County",4,26,240,123,117
050,31,155,"Nebraska","Saunders County",4,27,219,114,105
050,31,155,"Nebraska","Saunders County",4,28,226,124,102
050,31,155,"Nebraska","Saunders County",4,29,235,118,117
050,31,155,"Nebraska","Saunders County",4,30,282,140,142
050,31,155,"Nebraska","Saunders County",4,31,245,130,115
050,31,155,"Nebraska","Saunders County",4,32,259,140,119
050,31,155,"Nebraska","Saunders County",4,33,269,122,147
050,31,155,"Nebraska","Saunders County",4,34,270,131,139
050,31,155,"Nebraska","Saunders County",4,35,280,146,134
050,31,155,"Nebraska","Saunders County",4,36,299,158,141
050,31,155,"Nebraska","Saunders County",4,37,317,163,154
050,31,155,"Nebraska","Saunders County",4,38,322,165,157
050,31,155,"Nebraska","Saunders County",4,39,317,163,154
050,31,155,"Nebraska","Saunders County",4,40,320,168,152
050,31,155,"Nebraska","Saunders County",4,41,305,150,155
050,31,155,"Nebraska","Saunders County",4,42,299,149,150
050,31,155,"Nebraska","Saunders County",4,43,289,151,138
050,31,155,"Nebraska","Saunders County",4,44,269,146,123
050,31,155,"Nebraska","Saunders County",4,45,263,139,124
050,31,155,"Nebraska","Saunders County",4,46,243,138,105
050,31,155,"Nebraska","Saunders County",4,47,250,124,126
050,31,155,"Nebraska","Saunders County",4,48,230,113,117
050,31,155,"Nebraska","Saunders County",4,49,258,125,133
050,31,155,"Nebraska","Saunders County",4,50,255,134,121
050,31,155,"Nebraska","Saunders County",4,51,260,129,131
050,31,155,"Nebraska","Saunders County",4,52,251,128,123
050,31,155,"Nebraska","Saunders County",4,53,254,128,126
050,31,155,"Nebraska","Saunders County",4,54,267,131,136
050,31,155,"Nebraska","Saunders County",4,55,302,152,150
050,31,155,"Nebraska","Saunders County",4,56,318,163,155
050,31,155,"Nebraska","Saunders County",4,57,340,177,163
050,31,155,"Nebraska","Saunders County",4,58,348,189,159
050,31,155,"Nebraska","Saunders County",4,59,379,199,180
050,31,155,"Nebraska","Saunders County",4,60,395,202,193
050,31,155,"Nebraska","Saunders County",4,61,359,182,177
050,31,155,"Nebraska","Saunders County",4,62,367,184,183
050,31,155,"Nebraska","Saunders County",4,63,363,181,182
050,31,155,"Nebraska","Saunders County",4,64,321,167,154
050,31,155,"Nebraska","Saunders County",4,65,306,171,135
050,31,155,"Nebraska","Saunders County",4,66,299,154,145
050,31,155,"Nebraska","Saunders County",4,67,254,130,124
050,31,155,"Nebraska","Saunders County",4,68,247,122,125
050,31,155,"Nebraska","Saunders County",4,69,249,120,129
050,31,155,"Nebraska","Saunders County",4,70,256,136,120
050,31,155,"Nebraska","Saunders County",4,71,232,127,105
050,31,155,"Nebraska","Saunders County",4,72,222,118,104
050,31,155,"Nebraska","Saunders County",4,73,233,116,117
050,31,155,"Nebraska","Saunders County",4,74,230,123,107
050,31,155,"Nebraska","Saunders County",4,75,222,119,103
050,31,155,"Nebraska","Saunders County",4,76,152,76,76
050,31,155,"Nebraska","Saunders County",4,77,145,72,73
050,31,155,"Nebraska","Saunders County",4,78,132,71,61
050,31,155,"Nebraska","Saunders County",4,79,129,57,72
050,31,155,"Nebraska","Saunders County",4,80,111,51,60
050,31,155,"Nebraska","Saunders County",4,81,107,50,57
050,31,155,"Nebraska","Saunders County",4,82,90,39,51
050,31,155,"Nebraska","Saunders County",4,83,99,40,59
050,31,155,"Nebraska","Saunders County",4,84,80,32,48
050,31,155,"Nebraska","Saunders County",4,85,443,149,294
050,31,155,"Nebraska","Saunders County",5,0,242,131,111
050,31,155,"Nebraska","Saunders County",5,1,273,154,119
050,31,155,"Nebraska","Saunders County",5,2,335,177,158
050,31,155,"Nebraska","Saunders County",5,3,281,151,130
050,31,155,"Nebraska","Saunders County",5,4,295,150,145
050,31,155,"Nebraska","Saunders County",5,5,331,182,149
050,31,155,"Nebraska","Saunders County",5,6,348,189,159
050,31,155,"Nebraska","Saunders County",5,7,330,176,154
050,31,155,"Nebraska","Saunders County",5,8,343,165,178
050,31,155,"Nebraska","Saunders County",5,9,320,152,168
050,31,155,"Nebraska","Saunders County",5,10,313,155,158
050,31,155,"Nebraska","Saunders County",5,11,338,183,155
050,31,155,"Nebraska","Saunders County",5,12,334,171,163
050,31,155,"Nebraska","Saunders County",5,13,348,182,166
050,31,155,"Nebraska","Saunders County",5,14,365,187,178
050,31,155,"Nebraska","Saunders County",5,15,344,182,162
050,31,155,"Nebraska","Saunders County",5,16,353,186,167
050,31,155,"Nebraska","Saunders County",5,17,326,176,150
050,31,155,"Nebraska","Saunders County",5,18,279,152,127
050,31,155,"Nebraska","Saunders County",5,19,232,130,102
050,31,155,"Nebraska","Saunders County",5,20,216,129,87
050,31,155,"Nebraska","Saunders County",5,21,228,125,103
050,31,155,"Nebraska","Saunders County",5,22,246,137,109
050,31,155,"Nebraska","Saunders County",5,23,237,126,111
050,31,155,"Nebraska","Saunders County",5,24,235,120,115
050,31,155,"Nebraska","Saunders County",5,25,195,90,105
050,31,155,"Nebraska","Saunders County",5,26,231,126,105
050,31,155,"Nebraska","Saunders County",5,27,244,123,121
050,31,155,"Nebraska","Saunders County",5,28,235,119,116
050,31,155,"Nebraska","Saunders County",5,29,250,139,111
050,31,155,"Nebraska","Saunders County",5,30,259,130,129
050,31,155,"Nebraska","Saunders County",5,31,285,143,142
050,31,155,"Nebraska","Saunders County",5,32,261,140,121
050,31,155,"Nebraska","Saunders County",5,33,277,149,128
050,31,155,"Nebraska","Saunders County",5,34,289,128,161
050,31,155,"Nebraska","Saunders County",5,35,285,140,145
050,31,155,"Nebraska","Saunders County",5,36,282,149,133
050,31,155,"Nebraska","Saunders County",5,37,299,161,138
050,31,155,"Nebraska","Saunders County",5,38,330,171,159
050,31,155,"Nebraska","Saunders County",5,39,330,169,161
050,31,155,"Nebraska","Saunders County",5,40,310,159,151
050,31,155,"Nebraska","Saunders County",5,41,323,163,160
050,31,155,"Nebraska","Saunders County",5,42,305,158,147
050,31,155,"Nebraska","Saunders County",5,43,320,164,156
050,31,155,"Nebraska","Saunders County",5,44,288,157,131
050,31,155,"Nebraska","Saunders County",5,45,280,151,129
050,31,155,"Nebraska","Saunders County",5,46,264,138,126
050,31,155,"Nebraska","Saunders County",5,47,241,132,109
050,31,155,"Nebraska","Saunders County",5,48,256,124,132
050,31,155,"Nebraska","Saunders County",5,49,226,111,115
050,31,155,"Nebraska","Saunders County",5,50,252,116,136
050,31,155,"Nebraska","Saunders County",5,51,260,134,126
050,31,155,"Nebraska","Saunders County",5,52,275,134,141
050,31,155,"Nebraska","Saunders County",5,53,257,132,125
050,31,155,"Nebraska","Saunders County",5,54,250,129,121
050,31,155,"Nebraska","Saunders County",5,55,260,131,129
050,31,155,"Nebraska","Saunders County",5,56,297,152,145
050,31,155,"Nebraska","Saunders County",5,57,327,168,159
050,31,155,"Nebraska","Saunders County",5,58,341,179,162
050,31,155,"Nebraska","Saunders County",5,59,344,186,158
050,31,155,"Nebraska","Saunders County",5,60,383,199,184
050,31,155,"Nebraska","Saunders County",5,61,389,199,190
050,31,155,"Nebraska","Saunders County",5,62,368,188,180
050,31,155,"Nebraska","Saunders County",5,63,361,180,181
050,31,155,"Nebraska","Saunders County",5,64,362,185,177
050,31,155,"Nebraska","Saunders County",5,65,316,167,149
050,31,155,"Nebraska","Saunders County",5,66,300,167,133
050,31,155,"Nebraska","Saunders County",5,67,302,158,144
050,31,155,"Nebraska","Saunders County",5,68,253,130,123
050,31,155,"Nebraska","Saunders County",5,69,242,117,125
050,31,155,"Nebraska","Saunders County",5,70,243,116,127
050,31,155,"Nebraska","Saunders County",5,71,247,133,114
050,31,155,"Nebraska","Saunders County",5,72,228,118,110
050,31,155,"Nebraska","Saunders County",5,73,219,115,104
050,31,155,"Nebraska","Saunders County",5,74,234,120,114
050,31,155,"Nebraska","Saunders County",5,75,212,111,101
050,31,155,"Nebraska","Saunders County",5,76,218,118,100
050,31,155,"Nebraska","Saunders County",5,77,144,71,73
050,31,155,"Nebraska","Saunders County",5,78,137,70,67
050,31,155,"Nebraska","Saunders County",5,79,125,66,59
050,31,155,"Nebraska","Saunders County",5,80,121,55,66
050,31,155,"Nebraska","Saunders County",5,81,113,50,63
050,31,155,"Nebraska","Saunders County",5,82,90,37,53
050,31,155,"Nebraska","Saunders County",5,83,102,37,65
050,31,155,"Nebraska","Saunders County",5,84,92,37,55
050,31,155,"Nebraska","Saunders County",5,85,442,153,289
050,31,157,"Nebraska","Scotts Bluff County",1,0,424,219,205
050,31,157,"Nebraska","Scotts Bluff County",1,1,456,252,204
050,31,157,"Nebraska","Scotts Bluff County",1,2,467,230,237
050,31,157,"Nebraska","Scotts Bluff County",1,3,490,243,247
050,31,157,"Nebraska","Scotts Bluff County",1,4,462,229,233
050,31,157,"Nebraska","Scotts Bluff County",1,5,470,243,227
050,31,157,"Nebraska","Scotts Bluff County",1,6,494,261,233
050,31,157,"Nebraska","Scotts Bluff County",1,7,493,248,245
050,31,157,"Nebraska","Scotts Bluff County",1,8,470,244,226
050,31,157,"Nebraska","Scotts Bluff County",1,9,505,274,231
050,31,157,"Nebraska","Scotts Bluff County",1,10,536,291,245
050,31,157,"Nebraska","Scotts Bluff County",1,11,517,264,253
050,31,157,"Nebraska","Scotts Bluff County",1,12,545,271,274
050,31,157,"Nebraska","Scotts Bluff County",1,13,543,263,280
050,31,157,"Nebraska","Scotts Bluff County",1,14,504,249,255
050,31,157,"Nebraska","Scotts Bluff County",1,15,530,272,258
050,31,157,"Nebraska","Scotts Bluff County",1,16,499,257,242
050,31,157,"Nebraska","Scotts Bluff County",1,17,506,250,256
050,31,157,"Nebraska","Scotts Bluff County",1,18,476,236,240
050,31,157,"Nebraska","Scotts Bluff County",1,19,429,220,209
050,31,157,"Nebraska","Scotts Bluff County",1,20,399,219,180
050,31,157,"Nebraska","Scotts Bluff County",1,21,379,205,174
050,31,157,"Nebraska","Scotts Bluff County",1,22,376,191,185
050,31,157,"Nebraska","Scotts Bluff County",1,23,372,191,181
050,31,157,"Nebraska","Scotts Bluff County",1,24,388,199,189
050,31,157,"Nebraska","Scotts Bluff County",1,25,403,198,205
050,31,157,"Nebraska","Scotts Bluff County",1,26,419,219,200
050,31,157,"Nebraska","Scotts Bluff County",1,27,414,219,195
050,31,157,"Nebraska","Scotts Bluff County",1,28,444,222,222
050,31,157,"Nebraska","Scotts Bluff County",1,29,445,210,235
050,31,157,"Nebraska","Scotts Bluff County",1,30,463,243,220
050,31,157,"Nebraska","Scotts Bluff County",1,31,393,198,195
050,31,157,"Nebraska","Scotts Bluff County",1,32,395,192,203
050,31,157,"Nebraska","Scotts Bluff County",1,33,408,189,219
050,31,157,"Nebraska","Scotts Bluff County",1,34,438,214,224
050,31,157,"Nebraska","Scotts Bluff County",1,35,409,199,210
050,31,157,"Nebraska","Scotts Bluff County",1,36,443,224,219
050,31,157,"Nebraska","Scotts Bluff County",1,37,458,205,253
050,31,157,"Nebraska","Scotts Bluff County",1,38,456,234,222
050,31,157,"Nebraska","Scotts Bluff County",1,39,434,222,212
050,31,157,"Nebraska","Scotts Bluff County",1,40,430,205,225
050,31,157,"Nebraska","Scotts Bluff County",1,41,434,229,205
050,31,157,"Nebraska","Scotts Bluff County",1,42,412,203,209
050,31,157,"Nebraska","Scotts Bluff County",1,43,408,205,203
050,31,157,"Nebraska","Scotts Bluff County",1,44,401,217,184
050,31,157,"Nebraska","Scotts Bluff County",1,45,401,207,194
050,31,157,"Nebraska","Scotts Bluff County",1,46,386,207,179
050,31,157,"Nebraska","Scotts Bluff County",1,47,389,193,196
050,31,157,"Nebraska","Scotts Bluff County",1,48,414,204,210
050,31,157,"Nebraska","Scotts Bluff County",1,49,413,209,204
050,31,157,"Nebraska","Scotts Bluff County",1,50,402,174,228
050,31,157,"Nebraska","Scotts Bluff County",1,51,379,183,196
050,31,157,"Nebraska","Scotts Bluff County",1,52,328,162,166
050,31,157,"Nebraska","Scotts Bluff County",1,53,368,187,181
050,31,157,"Nebraska","Scotts Bluff County",1,54,398,199,199
050,31,157,"Nebraska","Scotts Bluff County",1,55,448,223,225
050,31,157,"Nebraska","Scotts Bluff County",1,56,476,242,234
050,31,157,"Nebraska","Scotts Bluff County",1,57,478,241,237
050,31,157,"Nebraska","Scotts Bluff County",1,58,487,229,258
050,31,157,"Nebraska","Scotts Bluff County",1,59,477,228,249
050,31,157,"Nebraska","Scotts Bluff County",1,60,483,263,220
050,31,157,"Nebraska","Scotts Bluff County",1,61,518,272,246
050,31,157,"Nebraska","Scotts Bluff County",1,62,507,248,259
050,31,157,"Nebraska","Scotts Bluff County",1,63,486,219,267
050,31,157,"Nebraska","Scotts Bluff County",1,64,474,221,253
050,31,157,"Nebraska","Scotts Bluff County",1,65,489,233,256
050,31,157,"Nebraska","Scotts Bluff County",1,66,490,236,254
050,31,157,"Nebraska","Scotts Bluff County",1,67,458,215,243
050,31,157,"Nebraska","Scotts Bluff County",1,68,441,203,238
050,31,157,"Nebraska","Scotts Bluff County",1,69,417,195,222
050,31,157,"Nebraska","Scotts Bluff County",1,70,393,193,200
050,31,157,"Nebraska","Scotts Bluff County",1,71,356,164,192
050,31,157,"Nebraska","Scotts Bluff County",1,72,334,157,177
050,31,157,"Nebraska","Scotts Bluff County",1,73,357,172,185
050,31,157,"Nebraska","Scotts Bluff County",1,74,261,121,140
050,31,157,"Nebraska","Scotts Bluff County",1,75,279,114,165
050,31,157,"Nebraska","Scotts Bluff County",1,76,284,128,156
050,31,157,"Nebraska","Scotts Bluff County",1,77,266,114,152
050,31,157,"Nebraska","Scotts Bluff County",1,78,217,82,135
050,31,157,"Nebraska","Scotts Bluff County",1,79,195,78,117
050,31,157,"Nebraska","Scotts Bluff County",1,80,173,76,97
050,31,157,"Nebraska","Scotts Bluff County",1,81,166,68,98
050,31,157,"Nebraska","Scotts Bluff County",1,82,176,77,99
050,31,157,"Nebraska","Scotts Bluff County",1,83,177,74,103
050,31,157,"Nebraska","Scotts Bluff County",1,84,154,58,96
050,31,157,"Nebraska","Scotts Bluff County",1,85,1062,357,705
050,31,157,"Nebraska","Scotts Bluff County",2,0,403,212,191
050,31,157,"Nebraska","Scotts Bluff County",2,1,452,246,206
050,31,157,"Nebraska","Scotts Bluff County",2,2,468,236,232
050,31,157,"Nebraska","Scotts Bluff County",2,3,482,237,245
050,31,157,"Nebraska","Scotts Bluff County",2,4,469,233,236
050,31,157,"Nebraska","Scotts Bluff County",2,5,469,240,229
050,31,157,"Nebraska","Scotts Bluff County",2,6,490,257,233
050,31,157,"Nebraska","Scotts Bluff County",2,7,490,251,239
050,31,157,"Nebraska","Scotts Bluff County",2,8,475,245,230
050,31,157,"Nebraska","Scotts Bluff County",2,9,499,269,230
050,31,157,"Nebraska","Scotts Bluff County",2,10,533,289,244
050,31,157,"Nebraska","Scotts Bluff County",2,11,519,270,249
050,31,157,"Nebraska","Scotts Bluff County",2,12,540,270,270
050,31,157,"Nebraska","Scotts Bluff County",2,13,542,263,279
050,31,157,"Nebraska","Scotts Bluff County",2,14,512,252,260
050,31,157,"Nebraska","Scotts Bluff County",2,15,525,265,260
050,31,157,"Nebraska","Scotts Bluff County",2,16,506,260,246
050,31,157,"Nebraska","Scotts Bluff County",2,17,507,253,254
050,31,157,"Nebraska","Scotts Bluff County",2,18,472,233,239
050,31,157,"Nebraska","Scotts Bluff County",2,19,428,220,208
050,31,157,"Nebraska","Scotts Bluff County",2,20,407,222,185
050,31,157,"Nebraska","Scotts Bluff County",2,21,374,201,173
050,31,157,"Nebraska","Scotts Bluff County",2,22,377,194,183
050,31,157,"Nebraska","Scotts Bluff County",2,23,374,191,183
050,31,157,"Nebraska","Scotts Bluff County",2,24,383,196,187
050,31,157,"Nebraska","Scotts Bluff County",2,25,399,198,201
050,31,157,"Nebraska","Scotts Bluff County",2,26,418,217,201
050,31,157,"Nebraska","Scotts Bluff County",2,27,413,219,194
050,31,157,"Nebraska","Scotts Bluff County",2,28,434,221,213
050,31,157,"Nebraska","Scotts Bluff County",2,29,447,213,234
050,31,157,"Nebraska","Scotts Bluff County",2,30,464,238,226
050,31,157,"Nebraska","Scotts Bluff County",2,31,405,208,197
050,31,157,"Nebraska","Scotts Bluff County",2,32,393,193,200
050,31,157,"Nebraska","Scotts Bluff County",2,33,407,192,215
050,31,157,"Nebraska","Scotts Bluff County",2,34,429,207,222
050,31,157,"Nebraska","Scotts Bluff County",2,35,420,205,215
050,31,157,"Nebraska","Scotts Bluff County",2,36,432,215,217
050,31,157,"Nebraska","Scotts Bluff County",2,37,451,207,244
050,31,157,"Nebraska","Scotts Bluff County",2,38,458,228,230
050,31,157,"Nebraska","Scotts Bluff County",2,39,436,223,213
050,31,157,"Nebraska","Scotts Bluff County",2,40,435,212,223
050,31,157,"Nebraska","Scotts Bluff County",2,41,431,223,208
050,31,157,"Nebraska","Scotts Bluff County",2,42,413,207,206
050,31,157,"Nebraska","Scotts Bluff County",2,43,409,207,202
050,31,157,"Nebraska","Scotts Bluff County",2,44,399,212,187
050,31,157,"Nebraska","Scotts Bluff County",2,45,398,208,190
050,31,157,"Nebraska","Scotts Bluff County",2,46,388,206,182
050,31,157,"Nebraska","Scotts Bluff County",2,47,389,197,192
050,31,157,"Nebraska","Scotts Bluff County",2,48,411,202,209
050,31,157,"Nebraska","Scotts Bluff County",2,49,417,208,209
050,31,157,"Nebraska","Scotts Bluff County",2,50,408,184,224
050,31,157,"Nebraska","Scotts Bluff County",2,51,384,180,204
050,31,157,"Nebraska","Scotts Bluff County",2,52,338,164,174
050,31,157,"Nebraska","Scotts Bluff County",2,53,360,182,178
050,31,157,"Nebraska","Scotts Bluff County",2,54,392,197,195
050,31,157,"Nebraska","Scotts Bluff County",2,55,436,218,218
050,31,157,"Nebraska","Scotts Bluff County",2,56,471,238,233
050,31,157,"Nebraska","Scotts Bluff County",2,57,476,241,235
050,31,157,"Nebraska","Scotts Bluff County",2,58,485,231,254
050,31,157,"Nebraska","Scotts Bluff County",2,59,477,227,250
050,31,157,"Nebraska","Scotts Bluff County",2,60,477,252,225
050,31,157,"Nebraska","Scotts Bluff County",2,61,503,266,237
050,31,157,"Nebraska","Scotts Bluff County",2,62,509,255,254
050,31,157,"Nebraska","Scotts Bluff County",2,63,493,227,266
050,31,157,"Nebraska","Scotts Bluff County",2,64,470,218,252
050,31,157,"Nebraska","Scotts Bluff County",2,65,480,228,252
050,31,157,"Nebraska","Scotts Bluff County",2,66,488,235,253
050,31,157,"Nebraska","Scotts Bluff County",2,67,465,220,245
050,31,157,"Nebraska","Scotts Bluff County",2,68,443,204,239
050,31,157,"Nebraska","Scotts Bluff County",2,69,424,197,227
050,31,157,"Nebraska","Scotts Bluff County",2,70,398,192,206
050,31,157,"Nebraska","Scotts Bluff County",2,71,361,170,191
050,31,157,"Nebraska","Scotts Bluff County",2,72,336,156,180
050,31,157,"Nebraska","Scotts Bluff County",2,73,365,174,191
050,31,157,"Nebraska","Scotts Bluff County",2,74,265,125,140
050,31,157,"Nebraska","Scotts Bluff County",2,75,275,115,160
050,31,157,"Nebraska","Scotts Bluff County",2,76,280,125,155
050,31,157,"Nebraska","Scotts Bluff County",2,77,273,116,157
050,31,157,"Nebraska","Scotts Bluff County",2,78,224,88,136
050,31,157,"Nebraska","Scotts Bluff County",2,79,198,78,120
050,31,157,"Nebraska","Scotts Bluff County",2,80,173,74,99
050,31,157,"Nebraska","Scotts Bluff County",2,81,165,69,96
050,31,157,"Nebraska","Scotts Bluff County",2,82,172,75,97
050,31,157,"Nebraska","Scotts Bluff County",2,83,173,71,102
050,31,157,"Nebraska","Scotts Bluff County",2,84,157,61,96
050,31,157,"Nebraska","Scotts Bluff County",2,85,1065,355,710
050,31,157,"Nebraska","Scotts Bluff County",3,0,468,228,240
050,31,157,"Nebraska","Scotts Bluff County",3,1,402,200,202
050,31,157,"Nebraska","Scotts Bluff County",3,2,435,239,196
050,31,157,"Nebraska","Scotts Bluff County",3,3,461,229,232
050,31,157,"Nebraska","Scotts Bluff County",3,4,468,237,231
050,31,157,"Nebraska","Scotts Bluff County",3,5,460,227,233
050,31,157,"Nebraska","Scotts Bluff County",3,6,473,235,238
050,31,157,"Nebraska","Scotts Bluff County",3,7,467,245,222
050,31,157,"Nebraska","Scotts Bluff County",3,8,486,241,245
050,31,157,"Nebraska","Scotts Bluff County",3,9,467,245,222
050,31,157,"Nebraska","Scotts Bluff County",3,10,502,270,232
050,31,157,"Nebraska","Scotts Bluff County",3,11,536,293,243
050,31,157,"Nebraska","Scotts Bluff County",3,12,501,255,246
050,31,157,"Nebraska","Scotts Bluff County",3,13,544,274,270
050,31,157,"Nebraska","Scotts Bluff County",3,14,538,258,280
050,31,157,"Nebraska","Scotts Bluff County",3,15,513,252,261
050,31,157,"Nebraska","Scotts Bluff County",3,16,526,266,260
050,31,157,"Nebraska","Scotts Bluff County",3,17,515,270,245
050,31,157,"Nebraska","Scotts Bluff County",3,18,479,239,240
050,31,157,"Nebraska","Scotts Bluff County",3,19,430,213,217
050,31,157,"Nebraska","Scotts Bluff County",3,20,432,239,193
050,31,157,"Nebraska","Scotts Bluff County",3,21,392,213,179
050,31,157,"Nebraska","Scotts Bluff County",3,22,385,199,186
050,31,157,"Nebraska","Scotts Bluff County",3,23,396,200,196
050,31,157,"Nebraska","Scotts Bluff County",3,24,372,188,184
050,31,157,"Nebraska","Scotts Bluff County",3,25,392,206,186
050,31,157,"Nebraska","Scotts Bluff County",3,26,397,197,200
050,31,157,"Nebraska","Scotts Bluff County",3,27,419,221,198
050,31,157,"Nebraska","Scotts Bluff County",3,28,407,215,192
050,31,157,"Nebraska","Scotts Bluff County",3,29,434,221,213
050,31,157,"Nebraska","Scotts Bluff County",3,30,456,218,238
050,31,157,"Nebraska","Scotts Bluff County",3,31,448,227,221
050,31,157,"Nebraska","Scotts Bluff County",3,32,397,215,182
050,31,157,"Nebraska","Scotts Bluff County",3,33,384,189,195
050,31,157,"Nebraska","Scotts Bluff County",3,34,404,187,217
050,31,157,"Nebraska","Scotts Bluff County",3,35,409,199,210
050,31,157,"Nebraska","Scotts Bluff County",3,36,408,193,215
050,31,157,"Nebraska","Scotts Bluff County",3,37,419,209,210
050,31,157,"Nebraska","Scotts Bluff County",3,38,443,201,242
050,31,157,"Nebraska","Scotts Bluff County",3,39,456,232,224
050,31,157,"Nebraska","Scotts Bluff County",3,40,441,224,217
050,31,157,"Nebraska","Scotts Bluff County",3,41,437,217,220
050,31,157,"Nebraska","Scotts Bluff County",3,42,431,213,218
050,31,157,"Nebraska","Scotts Bluff County",3,43,401,194,207
050,31,157,"Nebraska","Scotts Bluff County",3,44,407,201,206
050,31,157,"Nebraska","Scotts Bluff County",3,45,407,213,194
050,31,157,"Nebraska","Scotts Bluff County",3,46,391,208,183
050,31,157,"Nebraska","Scotts Bluff County",3,47,380,195,185
050,31,157,"Nebraska","Scotts Bluff County",3,48,397,201,196
050,31,157,"Nebraska","Scotts Bluff County",3,49,403,198,205
050,31,157,"Nebraska","Scotts Bluff County",3,50,409,204,205
050,31,157,"Nebraska","Scotts Bluff County",3,51,402,186,216
050,31,157,"Nebraska","Scotts Bluff County",3,52,379,174,205
050,31,157,"Nebraska","Scotts Bluff County",3,53,340,170,170
050,31,157,"Nebraska","Scotts Bluff County",3,54,362,181,181
050,31,157,"Nebraska","Scotts Bluff County",3,55,396,200,196
050,31,157,"Nebraska","Scotts Bluff County",3,56,440,223,217
050,31,157,"Nebraska","Scotts Bluff County",3,57,472,234,238
050,31,157,"Nebraska","Scotts Bluff County",3,58,481,243,238
050,31,157,"Nebraska","Scotts Bluff County",3,59,472,228,244
050,31,157,"Nebraska","Scotts Bluff County",3,60,480,229,251
050,31,157,"Nebraska","Scotts Bluff County",3,61,469,246,223
050,31,157,"Nebraska","Scotts Bluff County",3,62,482,254,228
050,31,157,"Nebraska","Scotts Bluff County",3,63,505,252,253
050,31,157,"Nebraska","Scotts Bluff County",3,64,493,227,266
050,31,157,"Nebraska","Scotts Bluff County",3,65,461,213,248
050,31,157,"Nebraska","Scotts Bluff County",3,66,469,224,245
050,31,157,"Nebraska","Scotts Bluff County",3,67,477,232,245
050,31,157,"Nebraska","Scotts Bluff County",3,68,463,218,245
050,31,157,"Nebraska","Scotts Bluff County",3,69,437,197,240
050,31,157,"Nebraska","Scotts Bluff County",3,70,424,198,226
050,31,157,"Nebraska","Scotts Bluff County",3,71,388,182,206
050,31,157,"Nebraska","Scotts Bluff County",3,72,357,166,191
050,31,157,"Nebraska","Scotts Bluff County",3,73,330,150,180
050,31,157,"Nebraska","Scotts Bluff County",3,74,343,160,183
050,31,157,"Nebraska","Scotts Bluff County",3,75,256,117,139
050,31,157,"Nebraska","Scotts Bluff County",3,76,272,119,153
050,31,157,"Nebraska","Scotts Bluff County",3,77,266,112,154
050,31,157,"Nebraska","Scotts Bluff County",3,78,265,117,148
050,31,157,"Nebraska","Scotts Bluff County",3,79,208,77,131
050,31,157,"Nebraska","Scotts Bluff County",3,80,181,72,109
050,31,157,"Nebraska","Scotts Bluff County",3,81,161,62,99
050,31,157,"Nebraska","Scotts Bluff County",3,82,158,73,85
050,31,157,"Nebraska","Scotts Bluff County",3,83,151,57,94
050,31,157,"Nebraska","Scotts Bluff County",3,84,177,66,111
050,31,157,"Nebraska","Scotts Bluff County",3,85,1062,351,711
050,31,157,"Nebraska","Scotts Bluff County",4,0,421,228,193
050,31,157,"Nebraska","Scotts Bluff County",4,1,475,238,237
050,31,157,"Nebraska","Scotts Bluff County",4,2,405,206,199
050,31,157,"Nebraska","Scotts Bluff County",4,3,439,237,202
050,31,157,"Nebraska","Scotts Bluff County",4,4,471,239,232
050,31,157,"Nebraska","Scotts Bluff County",4,5,450,228,222
050,31,157,"Nebraska","Scotts Bluff County",4,6,472,235,237
050,31,157,"Nebraska","Scotts Bluff County",4,7,455,236,219
050,31,157,"Nebraska","Scotts Bluff County",4,8,460,240,220
050,31,157,"Nebraska","Scotts Bluff County",4,9,488,251,237
050,31,157,"Nebraska","Scotts Bluff County",4,10,465,242,223
050,31,157,"Nebraska","Scotts Bluff County",4,11,492,266,226
050,31,157,"Nebraska","Scotts Bluff County",4,12,533,284,249
050,31,157,"Nebraska","Scotts Bluff County",4,13,499,252,247
050,31,157,"Nebraska","Scotts Bluff County",4,14,538,268,270
050,31,157,"Nebraska","Scotts Bluff County",4,15,553,262,291
050,31,157,"Nebraska","Scotts Bluff County",4,16,528,269,259
050,31,157,"Nebraska","Scotts Bluff County",4,17,524,266,258
050,31,157,"Nebraska","Scotts Bluff County",4,18,464,242,222
050,31,157,"Nebraska","Scotts Bluff County",4,19,429,222,207
050,31,157,"Nebraska","Scotts Bluff County",4,20,433,214,219
050,31,157,"Nebraska","Scotts Bluff County",4,21,404,228,176
050,31,157,"Nebraska","Scotts Bluff County",4,22,413,212,201
050,31,157,"Nebraska","Scotts Bluff County",4,23,387,197,190
050,31,157,"Nebraska","Scotts Bluff County",4,24,376,188,188
050,31,157,"Nebraska","Scotts Bluff County",4,25,363,180,183
050,31,157,"Nebraska","Scotts Bluff County",4,26,401,202,199
050,31,157,"Nebraska","Scotts Bluff County",4,27,386,192,194
050,31,157,"Nebraska","Scotts Bluff County",4,28,413,211,202
050,31,157,"Nebraska","Scotts Bluff County",4,29,411,215,196
050,31,157,"Nebraska","Scotts Bluff County",4,30,439,229,210
050,31,157,"Nebraska","Scotts Bluff County",4,31,439,211,228
050,31,157,"Nebraska","Scotts Bluff County",4,32,441,221,220
050,31,157,"Nebraska","Scotts Bluff County",4,33,400,213,187
050,31,157,"Nebraska","Scotts Bluff County",4,34,394,204,190
050,31,157,"Nebraska","Scotts Bluff County",4,35,406,188,218
050,31,157,"Nebraska","Scotts Bluff County",4,36,411,192,219
050,31,157,"Nebraska","Scotts Bluff County",4,37,393,184,209
050,31,157,"Nebraska","Scotts Bluff County",4,38,439,210,229
050,31,157,"Nebraska","Scotts Bluff County",4,39,439,199,240
050,31,157,"Nebraska","Scotts Bluff County",4,40,455,232,223
050,31,157,"Nebraska","Scotts Bluff County",4,41,428,218,210
050,31,157,"Nebraska","Scotts Bluff County",4,42,444,218,226
050,31,157,"Nebraska","Scotts Bluff County",4,43,417,206,211
050,31,157,"Nebraska","Scotts Bluff County",4,44,406,195,211
050,31,157,"Nebraska","Scotts Bluff County",4,45,399,193,206
050,31,157,"Nebraska","Scotts Bluff County",4,46,421,222,199
050,31,157,"Nebraska","Scotts Bluff County",4,47,378,198,180
050,31,157,"Nebraska","Scotts Bluff County",4,48,385,197,188
050,31,157,"Nebraska","Scotts Bluff County",4,49,387,188,199
050,31,157,"Nebraska","Scotts Bluff County",4,50,400,200,200
050,31,157,"Nebraska","Scotts Bluff County",4,51,406,203,203
050,31,157,"Nebraska","Scotts Bluff County",4,52,396,182,214
050,31,157,"Nebraska","Scotts Bluff County",4,53,370,173,197
050,31,157,"Nebraska","Scotts Bluff County",4,54,352,179,173
050,31,157,"Nebraska","Scotts Bluff County",4,55,358,179,179
050,31,157,"Nebraska","Scotts Bluff County",4,56,385,191,194
050,31,157,"Nebraska","Scotts Bluff County",4,57,436,220,216
050,31,157,"Nebraska","Scotts Bluff County",4,58,476,236,240
050,31,157,"Nebraska","Scotts Bluff County",4,59,480,239,241
050,31,157,"Nebraska","Scotts Bluff County",4,60,465,227,238
050,31,157,"Nebraska","Scotts Bluff County",4,61,473,222,251
050,31,157,"Nebraska","Scotts Bluff County",4,62,463,236,227
050,31,157,"Nebraska","Scotts Bluff County",4,63,469,243,226
050,31,157,"Nebraska","Scotts Bluff County",4,64,503,253,250
050,31,157,"Nebraska","Scotts Bluff County",4,65,487,226,261
050,31,157,"Nebraska","Scotts Bluff County",4,66,461,218,243
050,31,157,"Nebraska","Scotts Bluff County",4,67,455,219,236
050,31,157,"Nebraska","Scotts Bluff County",4,68,468,223,245
050,31,157,"Nebraska","Scotts Bluff County",4,69,448,214,234
050,31,157,"Nebraska","Scotts Bluff County",4,70,432,188,244
050,31,157,"Nebraska","Scotts Bluff County",4,71,422,193,229
050,31,157,"Nebraska","Scotts Bluff County",4,72,382,183,199
050,31,157,"Nebraska","Scotts Bluff County",4,73,351,165,186
050,31,157,"Nebraska","Scotts Bluff County",4,74,314,146,168
050,31,157,"Nebraska","Scotts Bluff County",4,75,344,148,196
050,31,157,"Nebraska","Scotts Bluff County",4,76,253,117,136
050,31,157,"Nebraska","Scotts Bluff County",4,77,262,105,157
050,31,157,"Nebraska","Scotts Bluff County",4,78,253,103,150
050,31,157,"Nebraska","Scotts Bluff County",4,79,243,106,137
050,31,157,"Nebraska","Scotts Bluff County",4,80,188,73,115
050,31,157,"Nebraska","Scotts Bluff County",4,81,161,57,104
050,31,157,"Nebraska","Scotts Bluff County",4,82,159,70,89
050,31,157,"Nebraska","Scotts Bluff County",4,83,144,65,79
050,31,157,"Nebraska","Scotts Bluff County",4,84,164,55,109
050,31,157,"Nebraska","Scotts Bluff County",4,85,1077,354,723
050,31,157,"Nebraska","Scotts Bluff County",5,0,428,235,193
050,31,157,"Nebraska","Scotts Bluff County",5,1,423,224,199
050,31,157,"Nebraska","Scotts Bluff County",5,2,454,223,231
050,31,157,"Nebraska","Scotts Bluff County",5,3,408,203,205
050,31,157,"Nebraska","Scotts Bluff County",5,4,426,231,195
050,31,157,"Nebraska","Scotts Bluff County",5,5,467,240,227
050,31,157,"Nebraska","Scotts Bluff County",5,6,473,233,240
050,31,157,"Nebraska","Scotts Bluff County",5,7,466,237,229
050,31,157,"Nebraska","Scotts Bluff County",5,8,464,243,221
050,31,157,"Nebraska","Scotts Bluff County",5,9,465,242,223
050,31,157,"Nebraska","Scotts Bluff County",5,10,489,243,246
050,31,157,"Nebraska","Scotts Bluff County",5,11,469,237,232
050,31,157,"Nebraska","Scotts Bluff County",5,12,489,264,225
050,31,157,"Nebraska","Scotts Bluff County",5,13,521,286,235
050,31,157,"Nebraska","Scotts Bluff County",5,14,483,244,239
050,31,157,"Nebraska","Scotts Bluff County",5,15,541,265,276
050,31,157,"Nebraska","Scotts Bluff County",5,16,562,277,285
050,31,157,"Nebraska","Scotts Bluff County",5,17,518,265,253
050,31,157,"Nebraska","Scotts Bluff County",5,18,479,244,235
050,31,157,"Nebraska","Scotts Bluff County",5,19,424,226,198
050,31,157,"Nebraska","Scotts Bluff County",5,20,431,229,202
050,31,157,"Nebraska","Scotts Bluff County",5,21,397,187,210
050,31,157,"Nebraska","Scotts Bluff County",5,22,421,234,187
050,31,157,"Nebraska","Scotts Bluff County",5,23,405,205,200
050,31,157,"Nebraska","Scotts Bluff County",5,24,385,196,189
050,31,157,"Nebraska","Scotts Bluff County",5,25,375,183,192
050,31,157,"Nebraska","Scotts Bluff County",5,26,375,180,195
050,31,157,"Nebraska","Scotts Bluff County",5,27,393,194,199
050,31,157,"Nebraska","Scotts Bluff County",5,28,397,195,202
050,31,157,"Nebraska","Scotts Bluff County",5,29,439,219,220
050,31,157,"Nebraska","Scotts Bluff County",5,30,414,221,193
050,31,157,"Nebraska","Scotts Bluff County",5,31,429,219,210
050,31,157,"Nebraska","Scotts Bluff County",5,32,437,208,229
050,31,157,"Nebraska","Scotts Bluff County",5,33,438,222,216
050,31,157,"Nebraska","Scotts Bluff County",5,34,391,210,181
050,31,157,"Nebraska","Scotts Bluff County",5,35,396,206,190
050,31,157,"Nebraska","Scotts Bluff County",5,36,399,188,211
050,31,157,"Nebraska","Scotts Bluff County",5,37,404,188,216
050,31,157,"Nebraska","Scotts Bluff County",5,38,396,178,218
050,31,157,"Nebraska","Scotts Bluff County",5,39,425,212,213
050,31,157,"Nebraska","Scotts Bluff County",5,40,434,193,241
050,31,157,"Nebraska","Scotts Bluff County",5,41,459,239,220
050,31,157,"Nebraska","Scotts Bluff County",5,42,419,209,210
050,31,157,"Nebraska","Scotts Bluff County",5,43,430,208,222
050,31,157,"Nebraska","Scotts Bluff County",5,44,404,196,208
050,31,157,"Nebraska","Scotts Bluff County",5,45,416,197,219
050,31,157,"Nebraska","Scotts Bluff County",5,46,403,198,205
050,31,157,"Nebraska","Scotts Bluff County",5,47,411,219,192
050,31,157,"Nebraska","Scotts Bluff County",5,48,392,200,192
050,31,157,"Nebraska","Scotts Bluff County",5,49,385,200,185
050,31,157,"Nebraska","Scotts Bluff County",5,50,397,196,201
050,31,157,"Nebraska","Scotts Bluff County",5,51,398,201,197
050,31,157,"Nebraska","Scotts Bluff County",5,52,406,194,212
050,31,157,"Nebraska","Scotts Bluff County",5,53,403,185,218
050,31,157,"Nebraska","Scotts Bluff County",5,54,387,179,208
050,31,157,"Nebraska","Scotts Bluff County",5,55,350,179,171
050,31,157,"Nebraska","Scotts Bluff County",5,56,357,183,174
050,31,157,"Nebraska","Scotts Bluff County",5,57,381,186,195
050,31,157,"Nebraska","Scotts Bluff County",5,58,437,216,221
050,31,157,"Nebraska","Scotts Bluff County",5,59,465,227,238
050,31,157,"Nebraska","Scotts Bluff County",5,60,477,237,240
050,31,157,"Nebraska","Scotts Bluff County",5,61,460,224,236
050,31,157,"Nebraska","Scotts Bluff County",5,62,466,218,248
050,31,157,"Nebraska","Scotts Bluff County",5,63,454,229,225
050,31,157,"Nebraska","Scotts Bluff County",5,64,458,241,217
050,31,157,"Nebraska","Scotts Bluff County",5,65,488,246,242
050,31,157,"Nebraska","Scotts Bluff County",5,66,480,222,258
050,31,157,"Nebraska","Scotts Bluff County",5,67,451,213,238
050,31,157,"Nebraska","Scotts Bluff County",5,68,446,214,232
050,31,157,"Nebraska","Scotts Bluff County",5,69,460,219,241
050,31,157,"Nebraska","Scotts Bluff County",5,70,450,212,238
050,31,157,"Nebraska","Scotts Bluff County",5,71,435,186,249
050,31,157,"Nebraska","Scotts Bluff County",5,72,418,196,222
050,31,157,"Nebraska","Scotts Bluff County",5,73,379,187,192
050,31,157,"Nebraska","Scotts Bluff County",5,74,334,155,179
050,31,157,"Nebraska","Scotts Bluff County",5,75,320,139,181
050,31,157,"Nebraska","Scotts Bluff County",5,76,344,155,189
050,31,157,"Nebraska","Scotts Bluff County",5,77,238,103,135
050,31,157,"Nebraska","Scotts Bluff County",5,78,252,101,151
050,31,157,"Nebraska","Scotts Bluff County",5,79,234,94,140
050,31,157,"Nebraska","Scotts Bluff County",5,80,222,98,124
050,31,157,"Nebraska","Scotts Bluff County",5,81,172,60,112
050,31,157,"Nebraska","Scotts Bluff County",5,82,159,63,96
050,31,157,"Nebraska","Scotts Bluff County",5,83,146,59,87
050,31,157,"Nebraska","Scotts Bluff County",5,84,154,61,93
050,31,157,"Nebraska","Scotts Bluff County",5,85,1072,347,725
050,31,159,"Nebraska","Seward County",1,0,190,98,92
050,31,159,"Nebraska","Seward County",1,1,202,106,96
050,31,159,"Nebraska","Seward County",1,2,197,114,83
050,31,159,"Nebraska","Seward County",1,3,214,116,98
050,31,159,"Nebraska","Seward County",1,4,206,100,106
050,31,159,"Nebraska","Seward County",1,5,240,124,116
050,31,159,"Nebraska","Seward County",1,6,212,113,99
050,31,159,"Nebraska","Seward County",1,7,240,123,117
050,31,159,"Nebraska","Seward County",1,8,251,120,131
050,31,159,"Nebraska","Seward County",1,9,261,127,134
050,31,159,"Nebraska","Seward County",1,10,246,132,114
050,31,159,"Nebraska","Seward County",1,11,241,122,119
050,31,159,"Nebraska","Seward County",1,12,262,130,132
050,31,159,"Nebraska","Seward County",1,13,236,124,112
050,31,159,"Nebraska","Seward County",1,14,248,133,115
050,31,159,"Nebraska","Seward County",1,15,257,136,121
050,31,159,"Nebraska","Seward County",1,16,258,134,124
050,31,159,"Nebraska","Seward County",1,17,243,107,136
050,31,159,"Nebraska","Seward County",1,18,321,165,156
050,31,159,"Nebraska","Seward County",1,19,515,327,188
050,31,159,"Nebraska","Seward County",1,20,454,265,189
050,31,159,"Nebraska","Seward County",1,21,358,184,174
050,31,159,"Nebraska","Seward County",1,22,256,135,121
050,31,159,"Nebraska","Seward County",1,23,199,111,88
050,31,159,"Nebraska","Seward County",1,24,188,94,94
050,31,159,"Nebraska","Seward County",1,25,166,83,83
050,31,159,"Nebraska","Seward County",1,26,148,80,68
050,31,159,"Nebraska","Seward County",1,27,172,84,88
050,31,159,"Nebraska","Seward County",1,28,159,90,69
050,31,159,"Nebraska","Seward County",1,29,176,92,84
050,31,159,"Nebraska","Seward County",1,30,171,95,76
050,31,159,"Nebraska","Seward County",1,31,182,95,87
050,31,159,"Nebraska","Seward County",1,32,205,100,105
050,31,159,"Nebraska","Seward County",1,33,209,105,104
050,31,159,"Nebraska","Seward County",1,34,202,103,99
050,31,159,"Nebraska","Seward County",1,35,208,112,96
050,31,159,"Nebraska","Seward County",1,36,231,137,94
050,31,159,"Nebraska","Seward County",1,37,222,116,106
050,31,159,"Nebraska","Seward County",1,38,202,97,105
050,31,159,"Nebraska","Seward County",1,39,216,98,118
050,31,159,"Nebraska","Seward County",1,40,235,118,117
050,31,159,"Nebraska","Seward County",1,41,231,117,114
050,31,159,"Nebraska","Seward County",1,42,196,109,87
050,31,159,"Nebraska","Seward County",1,43,176,87,89
050,31,159,"Nebraska","Seward County",1,44,181,93,88
050,31,159,"Nebraska","Seward County",1,45,189,105,84
050,31,159,"Nebraska","Seward County",1,46,166,86,80
050,31,159,"Nebraska","Seward County",1,47,189,91,98
050,31,159,"Nebraska","Seward County",1,48,199,107,92
050,31,159,"Nebraska","Seward County",1,49,178,97,81
050,31,159,"Nebraska","Seward County",1,50,204,115,89
050,31,159,"Nebraska","Seward County",1,51,203,102,101
050,31,159,"Nebraska","Seward County",1,52,178,93,85
050,31,159,"Nebraska","Seward County",1,53,183,96,87
050,31,159,"Nebraska","Seward County",1,54,200,102,98
050,31,159,"Nebraska","Seward County",1,55,229,120,109
050,31,159,"Nebraska","Seward County",1,56,254,135,119
050,31,159,"Nebraska","Seward County",1,57,235,129,106
050,31,159,"Nebraska","Seward County",1,58,251,123,128
050,31,159,"Nebraska","Seward County",1,59,226,109,117
050,31,159,"Nebraska","Seward County",1,60,224,102,122
050,31,159,"Nebraska","Seward County",1,61,231,115,116
050,31,159,"Nebraska","Seward County",1,62,238,127,111
050,31,159,"Nebraska","Seward County",1,63,207,109,98
050,31,159,"Nebraska","Seward County",1,64,221,118,103
050,31,159,"Nebraska","Seward County",1,65,221,117,104
050,31,159,"Nebraska","Seward County",1,66,199,100,99
050,31,159,"Nebraska","Seward County",1,67,198,97,101
050,31,159,"Nebraska","Seward County",1,68,184,91,93
050,31,159,"Nebraska","Seward County",1,69,150,76,74
050,31,159,"Nebraska","Seward County",1,70,161,82,79
050,31,159,"Nebraska","Seward County",1,71,170,87,83
050,31,159,"Nebraska","Seward County",1,72,168,91,77
050,31,159,"Nebraska","Seward County",1,73,158,74,84
050,31,159,"Nebraska","Seward County",1,74,119,57,62
050,31,159,"Nebraska","Seward County",1,75,108,52,56
050,31,159,"Nebraska","Seward County",1,76,115,58,57
050,31,159,"Nebraska","Seward County",1,77,103,48,55
050,31,159,"Nebraska","Seward County",1,78,101,47,54
050,31,159,"Nebraska","Seward County",1,79,73,35,38
050,31,159,"Nebraska","Seward County",1,80,71,36,35
050,31,159,"Nebraska","Seward County",1,81,80,41,39
050,31,159,"Nebraska","Seward County",1,82,81,36,45
050,31,159,"Nebraska","Seward County",1,83,77,36,41
050,31,159,"Nebraska","Seward County",1,84,75,36,39
050,31,159,"Nebraska","Seward County",1,85,408,149,259
050,31,159,"Nebraska","Seward County",2,0,206,102,104
050,31,159,"Nebraska","Seward County",2,1,199,104,95
050,31,159,"Nebraska","Seward County",2,2,199,111,88
050,31,159,"Nebraska","Seward County",2,3,211,115,96
050,31,159,"Nebraska","Seward County",2,4,209,105,104
050,31,159,"Nebraska","Seward County",2,5,232,119,113
050,31,159,"Nebraska","Seward County",2,6,219,116,103
050,31,159,"Nebraska","Seward County",2,7,235,121,114
050,31,159,"Nebraska","Seward County",2,8,249,120,129
050,31,159,"Nebraska","Seward County",2,9,257,125,132
050,31,159,"Nebraska","Seward County",2,10,251,131,120
050,31,159,"Nebraska","Seward County",2,11,243,124,119
050,31,159,"Nebraska","Seward County",2,12,256,128,128
050,31,159,"Nebraska","Seward County",2,13,243,125,118
050,31,159,"Nebraska","Seward County",2,14,246,131,115
050,31,159,"Nebraska","Seward County",2,15,254,135,119
050,31,159,"Nebraska","Seward County",2,16,258,134,124
050,31,159,"Nebraska","Seward County",2,17,246,113,133
050,31,159,"Nebraska","Seward County",2,18,319,161,158
050,31,159,"Nebraska","Seward County",2,19,513,323,190
050,31,159,"Nebraska","Seward County",2,20,455,265,190
050,31,159,"Nebraska","Seward County",2,21,359,185,174
050,31,159,"Nebraska","Seward County",2,22,254,135,119
050,31,159,"Nebraska","Seward County",2,23,204,112,92
050,31,159,"Nebraska","Seward County",2,24,186,94,92
050,31,159,"Nebraska","Seward County",2,25,165,84,81
050,31,159,"Nebraska","Seward County",2,26,151,80,71
050,31,159,"Nebraska","Seward County",2,27,167,85,82
050,31,159,"Nebraska","Seward County",2,28,168,91,77
050,31,159,"Nebraska","Seward County",2,29,173,91,82
050,31,159,"Nebraska","Seward County",2,30,176,95,81
050,31,159,"Nebraska","Seward County",2,31,182,97,85
050,31,159,"Nebraska","Seward County",2,32,200,98,102
050,31,159,"Nebraska","Seward County",2,33,206,103,103
050,31,159,"Nebraska","Seward County",2,34,202,103,99
050,31,159,"Nebraska","Seward County",2,35,209,112,97
050,31,159,"Nebraska","Seward County",2,36,224,130,94
050,31,159,"Nebraska","Seward County",2,37,223,120,103
050,31,159,"Nebraska","Seward County",2,38,208,103,105
050,31,159,"Nebraska","Seward County",2,39,213,99,114
050,31,159,"Nebraska","Seward County",2,40,231,114,117
050,31,159,"Nebraska","Seward County",2,41,233,118,115
050,31,159,"Nebraska","Seward County",2,42,202,109,93
050,31,159,"Nebraska","Seward County",2,43,184,94,90
050,31,159,"Nebraska","Seward County",2,44,178,92,86
050,31,159,"Nebraska","Seward County",2,45,188,103,85
050,31,159,"Nebraska","Seward County",2,46,173,92,81
050,31,159,"Nebraska","Seward County",2,47,183,90,93
050,31,159,"Nebraska","Seward County",2,48,198,105,93
050,31,159,"Nebraska","Seward County",2,49,185,100,85
050,31,159,"Nebraska","Seward County",2,50,197,110,87
050,31,159,"Nebraska","Seward County",2,51,202,104,98
050,31,159,"Nebraska","Seward County",2,52,182,95,87
050,31,159,"Nebraska","Seward County",2,53,179,94,85
050,31,159,"Nebraska","Seward County",2,54,194,98,96
050,31,159,"Nebraska","Seward County",2,55,218,115,103
050,31,159,"Nebraska","Seward County",2,56,247,131,116
050,31,159,"Nebraska","Seward County",2,57,239,129,110
050,31,159,"Nebraska","Seward County",2,58,248,125,123
050,31,159,"Nebraska","Seward County",2,59,229,111,118
050,31,159,"Nebraska","Seward County",2,60,224,103,121
050,31,159,"Nebraska","Seward County",2,61,227,111,116
050,31,159,"Nebraska","Seward County",2,62,235,123,112
050,31,159,"Nebraska","Seward County",2,63,216,115,101
050,31,159,"Nebraska","Seward County",2,64,215,115,100
050,31,159,"Nebraska","Seward County",2,65,221,117,104
050,31,159,"Nebraska","Seward County",2,66,203,104,99
050,31,159,"Nebraska","Seward County",2,67,198,98,100
050,31,159,"Nebraska","Seward County",2,68,186,92,94
050,31,159,"Nebraska","Seward County",2,69,158,79,79
050,31,159,"Nebraska","Seward County",2,70,157,80,77
050,31,159,"Nebraska","Seward County",2,71,168,84,84
050,31,159,"Nebraska","Seward County",2,72,165,89,76
050,31,159,"Nebraska","Seward County",2,73,170,83,87
050,31,159,"Nebraska","Seward County",2,74,121,58,63
050,31,159,"Nebraska","Seward County",2,75,109,52,57
050,31,159,"Nebraska","Seward County",2,76,109,54,55
050,31,159,"Nebraska","Seward County",2,77,109,52,57
050,31,159,"Nebraska","Seward County",2,78,100,47,53
050,31,159,"Nebraska","Seward County",2,79,79,37,42
050,31,159,"Nebraska","Seward County",2,80,70,35,35
050,31,159,"Nebraska","Seward County",2,81,78,40,38
050,31,159,"Nebraska","Seward County",2,82,81,37,44
050,31,159,"Nebraska","Seward County",2,83,76,36,40
050,31,159,"Nebraska","Seward County",2,84,73,35,38
050,31,159,"Nebraska","Seward County",2,85,410,152,258
050,31,159,"Nebraska","Seward County",3,0,170,91,79
050,31,159,"Nebraska","Seward County",3,1,202,103,99
050,31,159,"Nebraska","Seward County",3,2,204,104,100
050,31,159,"Nebraska","Seward County",3,3,205,118,87
050,31,159,"Nebraska","Seward County",3,4,214,122,92
050,31,159,"Nebraska","Seward County",3,5,216,107,109
050,31,159,"Nebraska","Seward County",3,6,239,122,117
050,31,159,"Nebraska","Seward County",3,7,230,121,109
050,31,159,"Nebraska","Seward County",3,8,227,115,112
050,31,159,"Nebraska","Seward County",3,9,246,115,131
050,31,159,"Nebraska","Seward County",3,10,256,125,131
050,31,159,"Nebraska","Seward County",3,11,250,135,115
050,31,159,"Nebraska","Seward County",3,12,247,127,120
050,31,159,"Nebraska","Seward County",3,13,253,127,126
050,31,159,"Nebraska","Seward County",3,14,252,124,128
050,31,159,"Nebraska","Seward County",3,15,237,127,110
050,31,159,"Nebraska","Seward County",3,16,250,132,118
050,31,159,"Nebraska","Seward County",3,17,257,131,126
050,31,159,"Nebraska","Seward County",3,18,316,155,161
050,31,159,"Nebraska","Seward County",3,19,500,305,195
050,31,159,"Nebraska","Seward County",3,20,425,246,179
050,31,159,"Nebraska","Seward County",3,21,348,182,166
050,31,159,"Nebraska","Seward County",3,22,234,129,105
050,31,159,"Nebraska","Seward County",3,23,217,121,96
050,31,159,"Nebraska","Seward County",3,24,188,100,88
050,31,159,"Nebraska","Seward County",3,25,166,90,76
050,31,159,"Nebraska","Seward County",3,26,160,80,80
050,31,159,"Nebraska","Seward County",3,27,165,80,85
050,31,159,"Nebraska","Seward County",3,28,172,86,86
050,31,159,"Nebraska","Seward County",3,29,160,89,71
050,31,159,"Nebraska","Seward County",3,30,169,82,87
050,31,159,"Nebraska","Seward County",3,31,189,101,88
050,31,159,"Nebraska","Seward County",3,32,188,106,82
050,31,159,"Nebraska","Seward County",3,33,198,98,100
050,31,159,"Nebraska","Seward County",3,34,199,95,104
050,31,159,"Nebraska","Seward County",3,35,211,104,107
050,31,159,"Nebraska","Seward County",3,36,225,124,101
050,31,159,"Nebraska","Seward County",3,37,227,133,94
050,31,159,"Nebraska","Seward County",3,38,222,119,103
050,31,159,"Nebraska","Seward County",3,39,214,108,106
050,31,159,"Nebraska","Seward County",3,40,215,100,115
050,31,159,"Nebraska","Seward County",3,41,234,115,119
050,31,159,"Nebraska","Seward County",3,42,231,116,115
050,31,159,"Nebraska","Seward County",3,43,207,115,92
050,31,159,"Nebraska","Seward County",3,44,186,94,92
050,31,159,"Nebraska","Seward County",3,45,179,93,86
050,31,159,"Nebraska","Seward County",3,46,189,103,86
050,31,159,"Nebraska","Seward County",3,47,170,90,80
050,31,159,"Nebraska","Seward County",3,48,183,86,97
050,31,159,"Nebraska","Seward County",3,49,202,107,95
050,31,159,"Nebraska","Seward County",3,50,188,102,86
050,31,159,"Nebraska","Seward County",3,51,198,112,86
050,31,159,"Nebraska","Seward County",3,52,205,109,96
050,31,159,"Nebraska","Seward County",3,53,177,93,84
050,31,159,"Nebraska","Seward County",3,54,186,97,89
050,31,159,"Nebraska","Seward County",3,55,195,99,96
050,31,159,"Nebraska","Seward County",3,56,217,112,105
050,31,159,"Nebraska","Seward County",3,57,237,125,112
050,31,159,"Nebraska","Seward County",3,58,238,131,107
050,31,159,"Nebraska","Seward County",3,59,249,127,122
050,31,159,"Nebraska","Seward County",3,60,227,106,121
050,31,159,"Nebraska","Seward County",3,61,226,106,120
050,31,159,"Nebraska","Seward County",3,62,224,110,114
050,31,159,"Nebraska","Seward County",3,63,234,120,114
050,31,159,"Nebraska","Seward County",3,64,213,110,103
050,31,159,"Nebraska","Seward County",3,65,209,110,99
050,31,159,"Nebraska","Seward County",3,66,217,116,101
050,31,159,"Nebraska","Seward County",3,67,192,99,93
050,31,159,"Nebraska","Seward County",3,68,195,98,97
050,31,159,"Nebraska","Seward County",3,69,180,90,90
050,31,159,"Nebraska","Seward County",3,70,159,80,79
050,31,159,"Nebraska","Seward County",3,71,150,76,74
050,31,159,"Nebraska","Seward County",3,72,161,81,80
050,31,159,"Nebraska","Seward County",3,73,163,87,76
050,31,159,"Nebraska","Seward County",3,74,166,86,80
050,31,159,"Nebraska","Seward County",3,75,117,55,62
050,31,159,"Nebraska","Seward County",3,76,105,49,56
050,31,159,"Nebraska","Seward County",3,77,109,54,55
050,31,159,"Nebraska","Seward County",3,78,110,51,59
050,31,159,"Nebraska","Seward County",3,79,99,47,52
050,31,159,"Nebraska","Seward County",3,80,81,35,46
050,31,159,"Nebraska","Seward County",3,81,64,32,32
050,31,159,"Nebraska","Seward County",3,82,74,39,35
050,31,159,"Nebraska","Seward County",3,83,75,34,41
050,31,159,"Nebraska","Seward County",3,84,72,33,39
050,31,159,"Nebraska","Seward County",3,85,400,148,252
050,31,159,"Nebraska","Seward County",4,0,172,88,84
050,31,159,"Nebraska","Seward County",4,1,176,89,87
050,31,159,"Nebraska","Seward County",4,2,211,106,105
050,31,159,"Nebraska","Seward County",4,3,210,100,110
050,31,159,"Nebraska","Seward County",4,4,217,127,90
050,31,159,"Nebraska","Seward County",4,5,218,124,94
050,31,159,"Nebraska","Seward County",4,6,208,106,102
050,31,159,"Nebraska","Seward County",4,7,237,122,115
050,31,159,"Nebraska","Seward County",4,8,237,119,118
050,31,159,"Nebraska","Seward County",4,9,234,118,116
050,31,159,"Nebraska","Seward County",4,10,249,120,129
050,31,159,"Nebraska","Seward County",4,11,267,133,134
050,31,159,"Nebraska","Seward County",4,12,253,136,117
050,31,159,"Nebraska","Seward County",4,13,249,130,119
050,31,159,"Nebraska","Seward County",4,14,267,131,136
050,31,159,"Nebraska","Seward County",4,15,241,122,119
050,31,159,"Nebraska","Seward County",4,16,247,135,112
050,31,159,"Nebraska","Seward County",4,17,252,130,122
050,31,159,"Nebraska","Seward County",4,18,331,174,157
050,31,159,"Nebraska","Seward County",4,19,513,312,201
050,31,159,"Nebraska","Seward County",4,20,455,258,197
050,31,159,"Nebraska","Seward County",4,21,352,179,173
050,31,159,"Nebraska","Seward County",4,22,242,132,110
050,31,159,"Nebraska","Seward County",4,23,192,112,80
050,31,159,"Nebraska","Seward County",4,24,191,102,89
050,31,159,"Nebraska","Seward County",4,25,168,84,84
050,31,159,"Nebraska","Seward County",4,26,163,95,68
050,31,159,"Nebraska","Seward County",4,27,164,84,80
050,31,159,"Nebraska","Seward County",4,28,169,84,85
050,31,159,"Nebraska","Seward County",4,29,189,93,96
050,31,159,"Nebraska","Seward County",4,30,173,94,79
050,31,159,"Nebraska","Seward County",4,31,180,87,93
050,31,159,"Nebraska","Seward County",4,32,171,91,80
050,31,159,"Nebraska","Seward County",4,33,193,103,90
050,31,159,"Nebraska","Seward County",4,34,192,90,102
050,31,159,"Nebraska","Seward County",4,35,201,103,98
050,31,159,"Nebraska","Seward County",4,36,208,105,103
050,31,159,"Nebraska","Seward County",4,37,229,120,109
050,31,159,"Nebraska","Seward County",4,38,223,132,91
050,31,159,"Nebraska","Seward County",4,39,223,119,104
050,31,159,"Nebraska","Seward County",4,40,222,114,108
050,31,159,"Nebraska","Seward County",4,41,218,99,119
050,31,159,"Nebraska","Seward County",4,42,222,110,112
050,31,159,"Nebraska","Seward County",4,43,237,117,120
050,31,159,"Nebraska","Seward County",4,44,203,110,93
050,31,159,"Nebraska","Seward County",4,45,186,93,93
050,31,159,"Nebraska","Seward County",4,46,182,92,90
050,31,159,"Nebraska","Seward County",4,47,187,102,85
050,31,159,"Nebraska","Seward County",4,48,176,90,86
050,31,159,"Nebraska","Seward County",4,49,178,87,91
050,31,159,"Nebraska","Seward County",4,50,202,110,92
050,31,159,"Nebraska","Seward County",4,51,191,106,85
050,31,159,"Nebraska","Seward County",4,52,198,111,87
050,31,159,"Nebraska","Seward County",4,53,212,115,97
050,31,159,"Nebraska","Seward County",4,54,181,93,88
050,31,159,"Nebraska","Seward County",4,55,177,92,85
050,31,159,"Nebraska","Seward County",4,56,198,104,94
050,31,159,"Nebraska","Seward County",4,57,212,109,103
050,31,159,"Nebraska","Seward County",4,58,235,122,113
050,31,159,"Nebraska","Seward County",4,59,236,128,108
050,31,159,"Nebraska","Seward County",4,60,254,124,130
050,31,159,"Nebraska","Seward County",4,61,215,102,113
050,31,159,"Nebraska","Seward County",4,62,222,102,120
050,31,159,"Nebraska","Seward County",4,63,218,109,109
050,31,159,"Nebraska","Seward County",4,64,239,127,112
050,31,159,"Nebraska","Seward County",4,65,216,112,104
050,31,159,"Nebraska","Seward County",4,66,203,104,99
050,31,159,"Nebraska","Seward County",4,67,209,114,95
050,31,159,"Nebraska","Seward County",4,68,187,95,92
050,31,159,"Nebraska","Seward County",4,69,190,96,94
050,31,159,"Nebraska","Seward County",4,70,184,93,91
050,31,159,"Nebraska","Seward County",4,71,162,80,82
050,31,159,"Nebraska","Seward County",4,72,147,72,75
050,31,159,"Nebraska","Seward County",4,73,156,74,82
050,31,159,"Nebraska","Seward County",4,74,161,85,76
050,31,159,"Nebraska","Seward County",4,75,159,81,78
050,31,159,"Nebraska","Seward County",4,76,116,59,57
050,31,159,"Nebraska","Seward County",4,77,102,48,54
050,31,159,"Nebraska","Seward County",4,78,103,48,55
050,31,159,"Nebraska","Seward County",4,79,105,50,55
050,31,159,"Nebraska","Seward County",4,80,91,41,50
050,31,159,"Nebraska","Seward County",4,81,73,32,41
050,31,159,"Nebraska","Seward County",4,82,59,29,30
050,31,159,"Nebraska","Seward County",4,83,66,33,33
050,31,159,"Nebraska","Seward County",4,84,70,28,42
050,31,159,"Nebraska","Seward County",4,85,398,148,250
050,31,159,"Nebraska","Seward County",5,0,170,87,83
050,31,159,"Nebraska","Seward County",5,1,182,89,93
050,31,159,"Nebraska","Seward County",5,2,182,89,93
050,31,159,"Nebraska","Seward County",5,3,212,102,110
050,31,159,"Nebraska","Seward County",5,4,214,99,115
050,31,159,"Nebraska","Seward County",5,5,225,129,96
050,31,159,"Nebraska","Seward County",5,6,200,119,81
050,31,159,"Nebraska","Seward County",5,7,217,110,107
050,31,159,"Nebraska","Seward County",5,8,249,129,120
050,31,159,"Nebraska","Seward County",5,9,231,117,114
050,31,159,"Nebraska","Seward County",5,10,239,123,116
050,31,159,"Nebraska","Seward County",5,11,248,119,129
050,31,159,"Nebraska","Seward County",5,12,261,132,129
050,31,159,"Nebraska","Seward County",5,13,255,136,119
050,31,159,"Nebraska","Seward County",5,14,245,129,116
050,31,159,"Nebraska","Seward County",5,15,261,129,132
050,31,159,"Nebraska","Seward County",5,16,247,123,124
050,31,159,"Nebraska","Seward County",5,17,243,125,118
050,31,159,"Nebraska","Seward County",5,18,335,180,155
050,31,159,"Nebraska","Seward County",5,19,534,334,200
050,31,159,"Nebraska","Seward County",5,20,468,258,210
050,31,159,"Nebraska","Seward County",5,21,372,189,183
050,31,159,"Nebraska","Seward County",5,22,248,140,108
050,31,159,"Nebraska","Seward County",5,23,206,111,95
050,31,159,"Nebraska","Seward County",5,24,182,105,77
050,31,159,"Nebraska","Seward County",5,25,172,92,80
050,31,159,"Nebraska","Seward County",5,26,149,74,75
050,31,159,"Nebraska","Seward County",5,27,167,95,72
050,31,159,"Nebraska","Seward County",5,28,159,83,76
050,31,159,"Nebraska","Seward County",5,29,172,86,86
050,31,159,"Nebraska","Seward County",5,30,183,86,97
050,31,159,"Nebraska","Seward County",5,31,178,98,80
050,31,159,"Nebraska","Seward County",5,32,195,91,104
050,31,159,"Nebraska","Seward County",5,33,185,96,89
050,31,159,"Nebraska","Seward County",5,34,203,106,97
050,31,159,"Nebraska","Seward County",5,35,193,92,101
050,31,159,"Nebraska","Seward County",5,36,205,107,98
050,31,159,"Nebraska","Seward County",5,37,202,104,98
050,31,159,"Nebraska","Seward County",5,38,223,115,108
050,31,159,"Nebraska","Seward County",5,39,229,135,94
050,31,159,"Nebraska","Seward County",5,40,228,126,102
050,31,159,"Nebraska","Seward County",5,41,218,117,101
050,31,159,"Nebraska","Seward County",5,42,215,101,114
050,31,159,"Nebraska","Seward County",5,43,230,112,118
050,31,159,"Nebraska","Seward County",5,44,239,120,119
050,31,159,"Nebraska","Seward County",5,45,206,112,94
050,31,159,"Nebraska","Seward County",5,46,185,94,91
050,31,159,"Nebraska","Seward County",5,47,182,93,89
050,31,159,"Nebraska","Seward County",5,48,191,102,89
050,31,159,"Nebraska","Seward County",5,49,177,91,86
050,31,159,"Nebraska","Seward County",5,50,169,78,91
050,31,159,"Nebraska","Seward County",5,51,201,108,93
050,31,159,"Nebraska","Seward County",5,52,194,106,88
050,31,159,"Nebraska","Seward County",5,53,204,116,88
050,31,159,"Nebraska","Seward County",5,54,209,111,98
050,31,159,"Nebraska","Seward County",5,55,173,90,83
050,31,159,"Nebraska","Seward County",5,56,177,91,86
050,31,159,"Nebraska","Seward County",5,57,189,97,92
050,31,159,"Nebraska","Seward County",5,58,217,110,107
050,31,159,"Nebraska","Seward County",5,59,239,126,113
050,31,159,"Nebraska","Seward County",5,60,228,122,106
050,31,159,"Nebraska","Seward County",5,61,243,120,123
050,31,159,"Nebraska","Seward County",5,62,220,105,115
050,31,159,"Nebraska","Seward County",5,63,217,105,112
050,31,159,"Nebraska","Seward County",5,64,223,109,114
050,31,159,"Nebraska","Seward County",5,65,244,128,116
050,31,159,"Nebraska","Seward County",5,66,214,108,106
050,31,159,"Nebraska","Seward County",5,67,203,102,101
050,31,159,"Nebraska","Seward County",5,68,209,114,95
050,31,159,"Nebraska","Seward County",5,69,182,93,89
050,31,159,"Nebraska","Seward County",5,70,191,99,92
050,31,159,"Nebraska","Seward County",5,71,181,92,89
050,31,159,"Nebraska","Seward County",5,72,158,79,79
050,31,159,"Nebraska","Seward County",5,73,142,68,74
050,31,159,"Nebraska","Seward County",5,74,151,73,78
050,31,159,"Nebraska","Seward County",5,75,159,80,79
050,31,159,"Nebraska","Seward County",5,76,152,79,73
050,31,159,"Nebraska","Seward County",5,77,120,60,60
050,31,159,"Nebraska","Seward County",5,78,95,42,53
050,31,159,"Nebraska","Seward County",5,79,100,45,55
050,31,159,"Nebraska","Seward County",5,80,98,46,52
050,31,159,"Nebraska","Seward County",5,81,86,38,48
050,31,159,"Nebraska","Seward County",5,82,63,29,34
050,31,159,"Nebraska","Seward County",5,83,51,24,27
050,31,159,"Nebraska","Seward County",5,84,59,26,33
050,31,159,"Nebraska","Seward County",5,85,398,144,254
050,31,161,"Nebraska","Sheridan County",1,0,61,30,31
050,31,161,"Nebraska","Sheridan County",1,1,58,30,28
050,31,161,"Nebraska","Sheridan County",1,2,62,37,25
050,31,161,"Nebraska","Sheridan County",1,3,72,38,34
050,31,161,"Nebraska","Sheridan County",1,4,52,33,19
050,31,161,"Nebraska","Sheridan County",1,5,57,28,29
050,31,161,"Nebraska","Sheridan County",1,6,63,31,32
050,31,161,"Nebraska","Sheridan County",1,7,57,27,30
050,31,161,"Nebraska","Sheridan County",1,8,62,30,32
050,31,161,"Nebraska","Sheridan County",1,9,51,25,26
050,31,161,"Nebraska","Sheridan County",1,10,62,34,28
050,31,161,"Nebraska","Sheridan County",1,11,57,28,29
050,31,161,"Nebraska","Sheridan County",1,12,63,29,34
050,31,161,"Nebraska","Sheridan County",1,13,64,33,31
050,31,161,"Nebraska","Sheridan County",1,14,67,34,33
050,31,161,"Nebraska","Sheridan County",1,15,73,48,25
050,31,161,"Nebraska","Sheridan County",1,16,66,38,28
050,31,161,"Nebraska","Sheridan County",1,17,66,31,35
050,31,161,"Nebraska","Sheridan County",1,18,56,30,26
050,31,161,"Nebraska","Sheridan County",1,19,50,26,24
050,31,161,"Nebraska","Sheridan County",1,20,52,30,22
050,31,161,"Nebraska","Sheridan County",1,21,44,24,20
050,31,161,"Nebraska","Sheridan County",1,22,51,28,23
050,31,161,"Nebraska","Sheridan County",1,23,56,23,33
050,31,161,"Nebraska","Sheridan County",1,24,55,27,28
050,31,161,"Nebraska","Sheridan County",1,25,46,24,22
050,31,161,"Nebraska","Sheridan County",1,26,42,22,20
050,31,161,"Nebraska","Sheridan County",1,27,47,26,21
050,31,161,"Nebraska","Sheridan County",1,28,48,28,20
050,31,161,"Nebraska","Sheridan County",1,29,42,21,21
050,31,161,"Nebraska","Sheridan County",1,30,43,25,18
050,31,161,"Nebraska","Sheridan County",1,31,41,23,18
050,31,161,"Nebraska","Sheridan County",1,32,51,24,27
050,31,161,"Nebraska","Sheridan County",1,33,54,28,26
050,31,161,"Nebraska","Sheridan County",1,34,44,23,21
050,31,161,"Nebraska","Sheridan County",1,35,49,23,26
050,31,161,"Nebraska","Sheridan County",1,36,53,30,23
050,31,161,"Nebraska","Sheridan County",1,37,54,28,26
050,31,161,"Nebraska","Sheridan County",1,38,59,26,33
050,31,161,"Nebraska","Sheridan County",1,39,67,34,33
050,31,161,"Nebraska","Sheridan County",1,40,58,27,31
050,31,161,"Nebraska","Sheridan County",1,41,47,19,28
050,31,161,"Nebraska","Sheridan County",1,42,50,25,25
050,31,161,"Nebraska","Sheridan County",1,43,58,35,23
050,31,161,"Nebraska","Sheridan County",1,44,47,28,19
050,31,161,"Nebraska","Sheridan County",1,45,47,26,21
050,31,161,"Nebraska","Sheridan County",1,46,43,22,21
050,31,161,"Nebraska","Sheridan County",1,47,56,28,28
050,31,161,"Nebraska","Sheridan County",1,48,51,26,25
050,31,161,"Nebraska","Sheridan County",1,49,59,29,30
050,31,161,"Nebraska","Sheridan County",1,50,65,31,34
050,31,161,"Nebraska","Sheridan County",1,51,66,41,25
050,31,161,"Nebraska","Sheridan County",1,52,64,31,33
050,31,161,"Nebraska","Sheridan County",1,53,69,40,29
050,31,161,"Nebraska","Sheridan County",1,54,46,27,19
050,31,161,"Nebraska","Sheridan County",1,55,61,38,23
050,31,161,"Nebraska","Sheridan County",1,56,64,42,22
050,31,161,"Nebraska","Sheridan County",1,57,61,36,25
050,31,161,"Nebraska","Sheridan County",1,58,59,31,28
050,31,161,"Nebraska","Sheridan County",1,59,62,31,31
050,31,161,"Nebraska","Sheridan County",1,60,71,31,40
050,31,161,"Nebraska","Sheridan County",1,61,89,40,49
050,31,161,"Nebraska","Sheridan County",1,62,91,44,47
050,31,161,"Nebraska","Sheridan County",1,63,79,36,43
050,31,161,"Nebraska","Sheridan County",1,64,75,34,41
050,31,161,"Nebraska","Sheridan County",1,65,80,35,45
050,31,161,"Nebraska","Sheridan County",1,66,74,33,41
050,31,161,"Nebraska","Sheridan County",1,67,87,40,47
050,31,161,"Nebraska","Sheridan County",1,68,88,45,43
050,31,161,"Nebraska","Sheridan County",1,69,82,50,32
050,31,161,"Nebraska","Sheridan County",1,70,83,48,35
050,31,161,"Nebraska","Sheridan County",1,71,75,38,37
050,31,161,"Nebraska","Sheridan County",1,72,72,31,41
050,31,161,"Nebraska","Sheridan County",1,73,70,32,38
050,31,161,"Nebraska","Sheridan County",1,74,45,22,23
050,31,161,"Nebraska","Sheridan County",1,75,44,23,21
050,31,161,"Nebraska","Sheridan County",1,76,45,21,24
050,31,161,"Nebraska","Sheridan County",1,77,50,24,26
050,31,161,"Nebraska","Sheridan County",1,78,40,13,27
050,31,161,"Nebraska","Sheridan County",1,79,38,14,24
050,31,161,"Nebraska","Sheridan County",1,80,41,15,26
050,31,161,"Nebraska","Sheridan County",1,81,41,16,25
050,31,161,"Nebraska","Sheridan County",1,82,32,12,20
050,31,161,"Nebraska","Sheridan County",1,83,33,14,19
050,31,161,"Nebraska","Sheridan County",1,84,29,10,19
050,31,161,"Nebraska","Sheridan County",1,85,221,73,148
050,31,161,"Nebraska","Sheridan County",2,0,56,29,27
050,31,161,"Nebraska","Sheridan County",2,1,57,29,28
050,31,161,"Nebraska","Sheridan County",2,2,60,35,25
050,31,161,"Nebraska","Sheridan County",2,3,70,38,32
050,31,161,"Nebraska","Sheridan County",2,4,55,33,22
050,31,161,"Nebraska","Sheridan County",2,5,56,29,27
050,31,161,"Nebraska","Sheridan County",2,6,63,31,32
050,31,161,"Nebraska","Sheridan County",2,7,56,26,30
050,31,161,"Nebraska","Sheridan County",2,8,61,29,32
050,31,161,"Nebraska","Sheridan County",2,9,53,27,26
050,31,161,"Nebraska","Sheridan County",2,10,59,31,28
050,31,161,"Nebraska","Sheridan County",2,11,56,28,28
050,31,161,"Nebraska","Sheridan County",2,12,62,29,33
050,31,161,"Nebraska","Sheridan County",2,13,63,31,32
050,31,161,"Nebraska","Sheridan County",2,14,67,34,33
050,31,161,"Nebraska","Sheridan County",2,15,71,44,27
050,31,161,"Nebraska","Sheridan County",2,16,69,41,28
050,31,161,"Nebraska","Sheridan County",2,17,66,33,33
050,31,161,"Nebraska","Sheridan County",2,18,56,29,27
050,31,161,"Nebraska","Sheridan County",2,19,49,26,23
050,31,161,"Nebraska","Sheridan County",2,20,52,30,22
050,31,161,"Nebraska","Sheridan County",2,21,47,26,21
050,31,161,"Nebraska","Sheridan County",2,22,50,27,23
050,31,161,"Nebraska","Sheridan County",2,23,55,25,30
050,31,161,"Nebraska","Sheridan County",2,24,55,26,29
050,31,161,"Nebraska","Sheridan County",2,25,48,25,23
050,31,161,"Nebraska","Sheridan County",2,26,43,21,22
050,31,161,"Nebraska","Sheridan County",2,27,46,25,21
050,31,161,"Nebraska","Sheridan County",2,28,48,27,21
050,31,161,"Nebraska","Sheridan County",2,29,42,22,20
050,31,161,"Nebraska","Sheridan County",2,30,42,24,18
050,31,161,"Nebraska","Sheridan County",2,31,42,24,18
050,31,161,"Nebraska","Sheridan County",2,32,49,25,24
050,31,161,"Nebraska","Sheridan County",2,33,55,29,26
050,31,161,"Nebraska","Sheridan County",2,34,47,25,22
050,31,161,"Nebraska","Sheridan County",2,35,48,23,25
050,31,161,"Nebraska","Sheridan County",2,36,51,27,24
050,31,161,"Nebraska","Sheridan County",2,37,52,27,25
050,31,161,"Nebraska","Sheridan County",2,38,58,26,32
050,31,161,"Nebraska","Sheridan County",2,39,66,32,34
050,31,161,"Nebraska","Sheridan County",2,40,61,29,32
050,31,161,"Nebraska","Sheridan County",2,41,48,20,28
050,31,161,"Nebraska","Sheridan County",2,42,48,24,24
050,31,161,"Nebraska","Sheridan County",2,43,57,33,24
050,31,161,"Nebraska","Sheridan County",2,44,48,29,19
050,31,161,"Nebraska","Sheridan County",2,45,47,27,20
050,31,161,"Nebraska","Sheridan County",2,46,44,23,21
050,31,161,"Nebraska","Sheridan County",2,47,52,26,26
050,31,161,"Nebraska","Sheridan County",2,48,53,27,26
050,31,161,"Nebraska","Sheridan County",2,49,59,30,29
050,31,161,"Nebraska","Sheridan County",2,50,62,30,32
050,31,161,"Nebraska","Sheridan County",2,51,66,39,27
050,31,161,"Nebraska","Sheridan County",2,52,65,34,31
050,31,161,"Nebraska","Sheridan County",2,53,69,39,30
050,31,161,"Nebraska","Sheridan County",2,54,51,31,20
050,31,161,"Nebraska","Sheridan County",2,55,58,36,22
050,31,161,"Nebraska","Sheridan County",2,56,64,41,23
050,31,161,"Nebraska","Sheridan County",2,57,61,37,24
050,31,161,"Nebraska","Sheridan County",2,58,58,32,26
050,31,161,"Nebraska","Sheridan County",2,59,62,31,31
050,31,161,"Nebraska","Sheridan County",2,60,68,31,37
050,31,161,"Nebraska","Sheridan County",2,61,85,38,47
050,31,161,"Nebraska","Sheridan County",2,62,88,42,46
050,31,161,"Nebraska","Sheridan County",2,63,83,39,44
050,31,161,"Nebraska","Sheridan County",2,64,74,34,40
050,31,161,"Nebraska","Sheridan County",2,65,78,34,44
050,31,161,"Nebraska","Sheridan County",2,66,74,33,41
050,31,161,"Nebraska","Sheridan County",2,67,84,39,45
050,31,161,"Nebraska","Sheridan County",2,68,85,43,42
050,31,161,"Nebraska","Sheridan County",2,69,83,49,34
050,31,161,"Nebraska","Sheridan County",2,70,82,47,35
050,31,161,"Nebraska","Sheridan County",2,71,78,40,38
050,31,161,"Nebraska","Sheridan County",2,72,70,31,39
050,31,161,"Nebraska","Sheridan County",2,73,73,34,39
050,31,161,"Nebraska","Sheridan County",2,74,48,23,25
050,31,161,"Nebraska","Sheridan County",2,75,44,23,21
050,31,161,"Nebraska","Sheridan County",2,76,44,21,23
050,31,161,"Nebraska","Sheridan County",2,77,49,24,25
050,31,161,"Nebraska","Sheridan County",2,78,40,14,26
050,31,161,"Nebraska","Sheridan County",2,79,39,15,24
050,31,161,"Nebraska","Sheridan County",2,80,40,13,27
050,31,161,"Nebraska","Sheridan County",2,81,39,15,24
050,31,161,"Nebraska","Sheridan County",2,82,34,13,21
050,31,161,"Nebraska","Sheridan County",2,83,33,13,20
050,31,161,"Nebraska","Sheridan County",2,84,30,12,18
050,31,161,"Nebraska","Sheridan County",2,85,217,71,146
050,31,161,"Nebraska","Sheridan County",3,0,53,37,16
050,31,161,"Nebraska","Sheridan County",3,1,58,27,31
050,31,161,"Nebraska","Sheridan County",3,2,61,32,29
050,31,161,"Nebraska","Sheridan County",3,3,58,31,27
050,31,161,"Nebraska","Sheridan County",3,4,69,38,31
050,31,161,"Nebraska","Sheridan County",3,5,63,40,23
050,31,161,"Nebraska","Sheridan County",3,6,59,29,30
050,31,161,"Nebraska","Sheridan County",3,7,62,30,32
050,31,161,"Nebraska","Sheridan County",3,8,62,28,34
050,31,161,"Nebraska","Sheridan County",3,9,63,31,32
050,31,161,"Nebraska","Sheridan County",3,10,49,28,21
050,31,161,"Nebraska","Sheridan County",3,11,57,29,28
050,31,161,"Nebraska","Sheridan County",3,12,60,29,31
050,31,161,"Nebraska","Sheridan County",3,13,60,25,35
050,31,161,"Nebraska","Sheridan County",3,14,62,31,31
050,31,161,"Nebraska","Sheridan County",3,15,61,29,32
050,31,161,"Nebraska","Sheridan County",3,16,71,44,27
050,31,161,"Nebraska","Sheridan County",3,17,67,39,28
050,31,161,"Nebraska","Sheridan County",3,18,60,32,28
050,31,161,"Nebraska","Sheridan County",3,19,46,24,22
050,31,161,"Nebraska","Sheridan County",3,20,49,29,20
050,31,161,"Nebraska","Sheridan County",3,21,53,31,22
050,31,161,"Nebraska","Sheridan County",3,22,54,28,26
050,31,161,"Nebraska","Sheridan County",3,23,50,27,23
050,31,161,"Nebraska","Sheridan County",3,24,57,23,34
050,31,161,"Nebraska","Sheridan County",3,25,48,25,23
050,31,161,"Nebraska","Sheridan County",3,26,51,28,23
050,31,161,"Nebraska","Sheridan County",3,27,36,15,21
050,31,161,"Nebraska","Sheridan County",3,28,55,31,24
050,31,161,"Nebraska","Sheridan County",3,29,43,25,18
050,31,161,"Nebraska","Sheridan County",3,30,45,23,22
050,31,161,"Nebraska","Sheridan County",3,31,47,27,20
050,31,161,"Nebraska","Sheridan County",3,32,46,24,22
050,31,161,"Nebraska","Sheridan County",3,33,45,21,24
050,31,161,"Nebraska","Sheridan County",3,34,57,32,25
050,31,161,"Nebraska","Sheridan County",3,35,44,23,21
050,31,161,"Nebraska","Sheridan County",3,36,48,22,26
050,31,161,"Nebraska","Sheridan County",3,37,55,30,25
050,31,161,"Nebraska","Sheridan County",3,38,58,32,26
050,31,161,"Nebraska","Sheridan County",3,39,61,27,34
050,31,161,"Nebraska","Sheridan County",3,40,59,30,29
050,31,161,"Nebraska","Sheridan County",3,41,59,29,30
050,31,161,"Nebraska","Sheridan County",3,42,51,21,30
050,31,161,"Nebraska","Sheridan County",3,43,50,26,24
050,31,161,"Nebraska","Sheridan County",3,44,57,33,24
050,31,161,"Nebraska","Sheridan County",3,45,49,30,19
050,31,161,"Nebraska","Sheridan County",3,46,47,27,20
050,31,161,"Nebraska","Sheridan County",3,47,40,21,19
050,31,161,"Nebraska","Sheridan County",3,48,55,28,27
050,31,161,"Nebraska","Sheridan County",3,49,62,29,33
050,31,161,"Nebraska","Sheridan County",3,50,59,33,26
050,31,161,"Nebraska","Sheridan County",3,51,62,29,33
050,31,161,"Nebraska","Sheridan County",3,52,72,42,30
050,31,161,"Nebraska","Sheridan County",3,53,59,30,29
050,31,161,"Nebraska","Sheridan County",3,54,69,40,29
050,31,161,"Nebraska","Sheridan County",3,55,50,31,19
050,31,161,"Nebraska","Sheridan County",3,56,59,37,22
050,31,161,"Nebraska","Sheridan County",3,57,64,40,24
050,31,161,"Nebraska","Sheridan County",3,58,61,37,24
050,31,161,"Nebraska","Sheridan County",3,59,59,33,26
050,31,161,"Nebraska","Sheridan County",3,60,56,28,28
050,31,161,"Nebraska","Sheridan County",3,61,75,32,43
050,31,161,"Nebraska","Sheridan County",3,62,84,38,46
050,31,161,"Nebraska","Sheridan County",3,63,86,42,44
050,31,161,"Nebraska","Sheridan County",3,64,84,43,41
050,31,161,"Nebraska","Sheridan County",3,65,74,36,38
050,31,161,"Nebraska","Sheridan County",3,66,77,34,43
050,31,161,"Nebraska","Sheridan County",3,67,74,34,40
050,31,161,"Nebraska","Sheridan County",3,68,83,39,44
050,31,161,"Nebraska","Sheridan County",3,69,81,40,41
050,31,161,"Nebraska","Sheridan County",3,70,81,47,34
050,31,161,"Nebraska","Sheridan County",3,71,81,45,36
050,31,161,"Nebraska","Sheridan County",3,72,74,39,35
050,31,161,"Nebraska","Sheridan County",3,73,69,31,38
050,31,161,"Nebraska","Sheridan County",3,74,64,27,37
050,31,161,"Nebraska","Sheridan County",3,75,46,24,22
050,31,161,"Nebraska","Sheridan County",3,76,45,21,24
050,31,161,"Nebraska","Sheridan County",3,77,40,20,20
050,31,161,"Nebraska","Sheridan County",3,78,52,25,27
050,31,161,"Nebraska","Sheridan County",3,79,39,17,22
050,31,161,"Nebraska","Sheridan County",3,80,35,8,27
050,31,161,"Nebraska","Sheridan County",3,81,38,12,26
050,31,161,"Nebraska","Sheridan County",3,82,31,13,18
050,31,161,"Nebraska","Sheridan County",3,83,32,13,19
050,31,161,"Nebraska","Sheridan County",3,84,25,13,12
050,31,161,"Nebraska","Sheridan County",3,85,211,68,143
050,31,161,"Nebraska","Sheridan County",4,0,50,25,25
050,31,161,"Nebraska","Sheridan County",4,1,57,41,16
050,31,161,"Nebraska","Sheridan County",4,2,65,30,35
050,31,161,"Nebraska","Sheridan County",4,3,57,30,27
050,31,161,"Nebraska","Sheridan County",4,4,57,29,28
050,31,161,"Nebraska","Sheridan County",4,5,72,38,34
050,31,161,"Nebraska","Sheridan County",4,6,62,39,23
050,31,161,"Nebraska","Sheridan County",4,7,62,30,32
050,31,161,"Nebraska","Sheridan County",4,8,59,29,30
050,31,161,"Nebraska","Sheridan County",4,9,57,28,29
050,31,161,"Nebraska","Sheridan County",4,10,60,29,31
050,31,161,"Nebraska","Sheridan County",4,11,46,24,22
050,31,161,"Nebraska","Sheridan County",4,12,55,29,26
050,31,161,"Nebraska","Sheridan County",4,13,61,30,31
050,31,161,"Nebraska","Sheridan County",4,14,56,24,32
050,31,161,"Nebraska","Sheridan County",4,15,63,32,31
050,31,161,"Nebraska","Sheridan County",4,16,60,28,32
050,31,161,"Nebraska","Sheridan County",4,17,67,44,23
050,31,161,"Nebraska","Sheridan County",4,18,58,35,23
050,31,161,"Nebraska","Sheridan County",4,19,45,26,19
050,31,161,"Nebraska","Sheridan County",4,20,45,23,22
050,31,161,"Nebraska","Sheridan County",4,21,42,24,18
050,31,161,"Nebraska","Sheridan County",4,22,54,29,25
050,31,161,"Nebraska","Sheridan County",4,23,50,25,25
050,31,161,"Nebraska","Sheridan County",4,24,58,30,28
050,31,161,"Nebraska","Sheridan County",4,25,57,20,37
050,31,161,"Nebraska","Sheridan County",4,26,48,26,22
050,31,161,"Nebraska","Sheridan County",4,27,51,27,24
050,31,161,"Nebraska","Sheridan County",4,28,33,13,20
050,31,161,"Nebraska","Sheridan County",4,29,48,25,23
050,31,161,"Nebraska","Sheridan County",4,30,44,26,18
050,31,161,"Nebraska","Sheridan County",4,31,40,21,19
050,31,161,"Nebraska","Sheridan County",4,32,42,22,20
050,31,161,"Nebraska","Sheridan County",4,33,46,24,22
050,31,161,"Nebraska","Sheridan County",4,34,47,23,24
050,31,161,"Nebraska","Sheridan County",4,35,57,34,23
050,31,161,"Nebraska","Sheridan County",4,36,42,22,20
050,31,161,"Nebraska","Sheridan County",4,37,54,28,26
050,31,161,"Nebraska","Sheridan County",4,38,51,25,26
050,31,161,"Nebraska","Sheridan County",4,39,59,34,25
050,31,161,"Nebraska","Sheridan County",4,40,63,28,35
050,31,161,"Nebraska","Sheridan County",4,41,58,29,29
050,31,161,"Nebraska","Sheridan County",4,42,59,29,30
050,31,161,"Nebraska","Sheridan County",4,43,48,24,24
050,31,161,"Nebraska","Sheridan County",4,44,48,25,23
050,31,161,"Nebraska","Sheridan County",4,45,54,32,22
050,31,161,"Nebraska","Sheridan County",4,46,49,29,20
050,31,161,"Nebraska","Sheridan County",4,47,51,30,21
050,31,161,"Nebraska","Sheridan County",4,48,41,21,20
050,31,161,"Nebraska","Sheridan County",4,49,56,27,29
050,31,161,"Nebraska","Sheridan County",4,50,60,29,31
050,31,161,"Nebraska","Sheridan County",4,51,58,33,25
050,31,161,"Nebraska","Sheridan County",4,52,65,32,33
050,31,161,"Nebraska","Sheridan County",4,53,69,39,30
050,31,161,"Nebraska","Sheridan County",4,54,62,33,29
050,31,161,"Nebraska","Sheridan County",4,55,70,40,30
050,31,161,"Nebraska","Sheridan County",4,56,48,30,18
050,31,161,"Nebraska","Sheridan County",4,57,60,37,23
050,31,161,"Nebraska","Sheridan County",4,58,67,42,25
050,31,161,"Nebraska","Sheridan County",4,59,68,40,28
050,31,161,"Nebraska","Sheridan County",4,60,54,31,23
050,31,161,"Nebraska","Sheridan County",4,61,56,27,29
050,31,161,"Nebraska","Sheridan County",4,62,74,32,42
050,31,161,"Nebraska","Sheridan County",4,63,79,33,46
050,31,161,"Nebraska","Sheridan County",4,64,87,43,44
050,31,161,"Nebraska","Sheridan County",4,65,81,41,40
050,31,161,"Nebraska","Sheridan County",4,66,73,38,35
050,31,161,"Nebraska","Sheridan County",4,67,77,34,43
050,31,161,"Nebraska","Sheridan County",4,68,72,32,40
050,31,161,"Nebraska","Sheridan County",4,69,83,40,43
050,31,161,"Nebraska","Sheridan County",4,70,83,42,41
050,31,161,"Nebraska","Sheridan County",4,71,81,46,35
050,31,161,"Nebraska","Sheridan County",4,72,77,43,34
050,31,161,"Nebraska","Sheridan County",4,73,72,37,35
050,31,161,"Nebraska","Sheridan County",4,74,67,30,37
050,31,161,"Nebraska","Sheridan County",4,75,62,26,36
050,31,161,"Nebraska","Sheridan County",4,76,43,20,23
050,31,161,"Nebraska","Sheridan County",4,77,39,19,20
050,31,161,"Nebraska","Sheridan County",4,78,40,19,21
050,31,161,"Nebraska","Sheridan County",4,79,53,28,25
050,31,161,"Nebraska","Sheridan County",4,80,35,10,25
050,31,161,"Nebraska","Sheridan County",4,81,33,7,26
050,31,161,"Nebraska","Sheridan County",4,82,33,10,23
050,31,161,"Nebraska","Sheridan County",4,83,31,13,18
050,31,161,"Nebraska","Sheridan County",4,84,26,11,15
050,31,161,"Nebraska","Sheridan County",4,85,204,66,138
050,31,161,"Nebraska","Sheridan County",5,0,46,25,21
050,31,161,"Nebraska","Sheridan County",5,1,53,26,27
050,31,161,"Nebraska","Sheridan County",5,2,56,40,16
050,31,161,"Nebraska","Sheridan County",5,3,64,33,31
050,31,161,"Nebraska","Sheridan County",5,4,54,28,26
050,31,161,"Nebraska","Sheridan County",5,5,56,26,30
050,31,161,"Nebraska","Sheridan County",5,6,63,35,28
050,31,161,"Nebraska","Sheridan County",5,7,65,42,23
050,31,161,"Nebraska","Sheridan County",5,8,65,31,34
050,31,161,"Nebraska","Sheridan County",5,9,59,30,29
050,31,161,"Nebraska","Sheridan County",5,10,52,26,26
050,31,161,"Nebraska","Sheridan County",5,11,60,29,31
050,31,161,"Nebraska","Sheridan County",5,12,50,29,21
050,31,161,"Nebraska","Sheridan County",5,13,62,34,28
050,31,161,"Nebraska","Sheridan County",5,14,58,30,28
050,31,161,"Nebraska","Sheridan County",5,15,61,27,34
050,31,161,"Nebraska","Sheridan County",5,16,59,28,31
050,31,161,"Nebraska","Sheridan County",5,17,58,30,28
050,31,161,"Nebraska","Sheridan County",5,18,59,38,21
050,31,161,"Nebraska","Sheridan County",5,19,44,26,18
050,31,161,"Nebraska","Sheridan County",5,20,52,26,26
050,31,161,"Nebraska","Sheridan County",5,21,43,25,18
050,31,161,"Nebraska","Sheridan County",5,22,42,25,17
050,31,161,"Nebraska","Sheridan County",5,23,48,26,22
050,31,161,"Nebraska","Sheridan County",5,24,45,23,22
050,31,161,"Nebraska","Sheridan County",5,25,55,34,21
050,31,161,"Nebraska","Sheridan County",5,26,59,20,39
050,31,161,"Nebraska","Sheridan County",5,27,49,24,25
050,31,161,"Nebraska","Sheridan County",5,28,53,26,27
050,31,161,"Nebraska","Sheridan County",5,29,25,12,13
050,31,161,"Nebraska","Sheridan County",5,30,51,29,22
050,31,161,"Nebraska","Sheridan County",5,31,39,24,15
050,31,161,"Nebraska","Sheridan County",5,32,39,22,17
050,31,161,"Nebraska","Sheridan County",5,33,36,19,17
050,31,161,"Nebraska","Sheridan County",5,34,39,20,19
050,31,161,"Nebraska","Sheridan County",5,35,46,21,25
050,31,161,"Nebraska","Sheridan County",5,36,52,30,22
050,31,161,"Nebraska","Sheridan County",5,37,44,24,20
050,31,161,"Nebraska","Sheridan County",5,38,49,27,22
050,31,161,"Nebraska","Sheridan County",5,39,48,24,24
050,31,161,"Nebraska","Sheridan County",5,40,52,27,25
050,31,161,"Nebraska","Sheridan County",5,41,64,28,36
050,31,161,"Nebraska","Sheridan County",5,42,59,29,30
050,31,161,"Nebraska","Sheridan County",5,43,61,30,31
050,31,161,"Nebraska","Sheridan County",5,44,45,22,23
050,31,161,"Nebraska","Sheridan County",5,45,57,28,29
050,31,161,"Nebraska","Sheridan County",5,46,57,34,23
050,31,161,"Nebraska","Sheridan County",5,47,53,30,23
050,31,161,"Nebraska","Sheridan County",5,48,49,27,22
050,31,161,"Nebraska","Sheridan County",5,49,42,21,21
050,31,161,"Nebraska","Sheridan County",5,50,57,28,29
050,31,161,"Nebraska","Sheridan County",5,51,55,26,29
050,31,161,"Nebraska","Sheridan County",5,52,63,32,31
050,31,161,"Nebraska","Sheridan County",5,53,63,33,30
050,31,161,"Nebraska","Sheridan County",5,54,68,38,30
050,31,161,"Nebraska","Sheridan County",5,55,56,29,27
050,31,161,"Nebraska","Sheridan County",5,56,64,35,29
050,31,161,"Nebraska","Sheridan County",5,57,46,26,20
050,31,161,"Nebraska","Sheridan County",5,58,61,38,23
050,31,161,"Nebraska","Sheridan County",5,59,66,42,24
050,31,161,"Nebraska","Sheridan County",5,60,71,41,30
050,31,161,"Nebraska","Sheridan County",5,61,57,31,26
050,31,161,"Nebraska","Sheridan County",5,62,57,27,30
050,31,161,"Nebraska","Sheridan County",5,63,74,32,42
050,31,161,"Nebraska","Sheridan County",5,64,80,35,45
050,31,161,"Nebraska","Sheridan County",5,65,87,41,46
050,31,161,"Nebraska","Sheridan County",5,66,83,42,41
050,31,161,"Nebraska","Sheridan County",5,67,72,35,37
050,31,161,"Nebraska","Sheridan County",5,68,74,32,42
050,31,161,"Nebraska","Sheridan County",5,69,72,35,37
050,31,161,"Nebraska","Sheridan County",5,70,83,43,40
050,31,161,"Nebraska","Sheridan County",5,71,81,38,43
050,31,161,"Nebraska","Sheridan County",5,72,76,46,30
050,31,161,"Nebraska","Sheridan County",5,73,80,44,36
050,31,161,"Nebraska","Sheridan County",5,74,71,36,35
050,31,161,"Nebraska","Sheridan County",5,75,64,27,37
050,31,161,"Nebraska","Sheridan County",5,76,58,22,36
050,31,161,"Nebraska","Sheridan County",5,77,38,19,19
050,31,161,"Nebraska","Sheridan County",5,78,40,19,21
050,31,161,"Nebraska","Sheridan County",5,79,40,23,17
050,31,161,"Nebraska","Sheridan County",5,80,46,18,28
050,31,161,"Nebraska","Sheridan County",5,81,33,9,24
050,31,161,"Nebraska","Sheridan County",5,82,26,5,21
050,31,161,"Nebraska","Sheridan County",5,83,34,10,24
050,31,161,"Nebraska","Sheridan County",5,84,26,12,14
050,31,161,"Nebraska","Sheridan County",5,85,209,66,143
050,31,163,"Nebraska","Sherman County",1,0,34,17,17
050,31,163,"Nebraska","Sherman County",1,1,37,19,18
050,31,163,"Nebraska","Sherman County",1,2,37,21,16
050,31,163,"Nebraska","Sherman County",1,3,28,12,16
050,31,163,"Nebraska","Sherman County",1,4,26,10,16
050,31,163,"Nebraska","Sherman County",1,5,24,12,12
050,31,163,"Nebraska","Sherman County",1,6,36,23,13
050,31,163,"Nebraska","Sherman County",1,7,31,18,13
050,31,163,"Nebraska","Sherman County",1,8,30,18,12
050,31,163,"Nebraska","Sherman County",1,9,37,21,16
050,31,163,"Nebraska","Sherman County",1,10,43,25,18
050,31,163,"Nebraska","Sherman County",1,11,40,22,18
050,31,163,"Nebraska","Sherman County",1,12,38,19,19
050,31,163,"Nebraska","Sherman County",1,13,40,18,22
050,31,163,"Nebraska","Sherman County",1,14,36,16,20
050,31,163,"Nebraska","Sherman County",1,15,40,15,25
050,31,163,"Nebraska","Sherman County",1,16,42,21,21
050,31,163,"Nebraska","Sherman County",1,17,41,21,20
050,31,163,"Nebraska","Sherman County",1,18,33,17,16
050,31,163,"Nebraska","Sherman County",1,19,20,8,12
050,31,163,"Nebraska","Sherman County",1,20,28,14,14
050,31,163,"Nebraska","Sherman County",1,21,26,13,13
050,31,163,"Nebraska","Sherman County",1,22,27,15,12
050,31,163,"Nebraska","Sherman County",1,23,22,14,8
050,31,163,"Nebraska","Sherman County",1,24,21,11,10
050,31,163,"Nebraska","Sherman County",1,25,37,17,20
050,31,163,"Nebraska","Sherman County",1,26,24,13,11
050,31,163,"Nebraska","Sherman County",1,27,34,18,16
050,31,163,"Nebraska","Sherman County",1,28,29,15,14
050,31,163,"Nebraska","Sherman County",1,29,24,13,11
050,31,163,"Nebraska","Sherman County",1,30,28,16,12
050,31,163,"Nebraska","Sherman County",1,31,24,11,13
050,31,163,"Nebraska","Sherman County",1,32,21,7,14
050,31,163,"Nebraska","Sherman County",1,33,25,10,15
050,31,163,"Nebraska","Sherman County",1,34,29,15,14
050,31,163,"Nebraska","Sherman County",1,35,30,16,14
050,31,163,"Nebraska","Sherman County",1,36,28,12,16
050,31,163,"Nebraska","Sherman County",1,37,29,15,14
050,31,163,"Nebraska","Sherman County",1,38,27,12,15
050,31,163,"Nebraska","Sherman County",1,39,21,13,8
050,31,163,"Nebraska","Sherman County",1,40,28,14,14
050,31,163,"Nebraska","Sherman County",1,41,25,17,8
050,31,163,"Nebraska","Sherman County",1,42,26,17,9
050,31,163,"Nebraska","Sherman County",1,43,27,16,11
050,31,163,"Nebraska","Sherman County",1,44,25,11,14
050,31,163,"Nebraska","Sherman County",1,45,31,16,15
050,31,163,"Nebraska","Sherman County",1,46,28,17,11
050,31,163,"Nebraska","Sherman County",1,47,34,18,16
050,31,163,"Nebraska","Sherman County",1,48,37,19,18
050,31,163,"Nebraska","Sherman County",1,49,24,10,14
050,31,163,"Nebraska","Sherman County",1,50,31,14,17
050,31,163,"Nebraska","Sherman County",1,51,32,13,19
050,31,163,"Nebraska","Sherman County",1,52,37,15,22
050,31,163,"Nebraska","Sherman County",1,53,35,13,22
050,31,163,"Nebraska","Sherman County",1,54,39,17,22
050,31,163,"Nebraska","Sherman County",1,55,41,22,19
050,31,163,"Nebraska","Sherman County",1,56,38,21,17
050,31,163,"Nebraska","Sherman County",1,57,37,18,19
050,31,163,"Nebraska","Sherman County",1,58,42,18,24
050,31,163,"Nebraska","Sherman County",1,59,57,31,26
050,31,163,"Nebraska","Sherman County",1,60,51,29,22
050,31,163,"Nebraska","Sherman County",1,61,53,29,24
050,31,163,"Nebraska","Sherman County",1,62,49,23,26
050,31,163,"Nebraska","Sherman County",1,63,48,22,26
050,31,163,"Nebraska","Sherman County",1,64,52,25,27
050,31,163,"Nebraska","Sherman County",1,65,53,28,25
050,31,163,"Nebraska","Sherman County",1,66,52,28,24
050,31,163,"Nebraska","Sherman County",1,67,42,26,16
050,31,163,"Nebraska","Sherman County",1,68,56,29,27
050,31,163,"Nebraska","Sherman County",1,69,47,20,27
050,31,163,"Nebraska","Sherman County",1,70,40,23,17
050,31,163,"Nebraska","Sherman County",1,71,35,20,15
050,31,163,"Nebraska","Sherman County",1,72,35,17,18
050,31,163,"Nebraska","Sherman County",1,73,50,31,19
050,31,163,"Nebraska","Sherman County",1,74,33,16,17
050,31,163,"Nebraska","Sherman County",1,75,31,15,16
050,31,163,"Nebraska","Sherman County",1,76,33,10,23
050,31,163,"Nebraska","Sherman County",1,77,26,12,14
050,31,163,"Nebraska","Sherman County",1,78,18,7,11
050,31,163,"Nebraska","Sherman County",1,79,20,11,9
050,31,163,"Nebraska","Sherman County",1,80,24,12,12
050,31,163,"Nebraska","Sherman County",1,81,24,10,14
050,31,163,"Nebraska","Sherman County",1,82,20,5,15
050,31,163,"Nebraska","Sherman County",1,83,23,9,14
050,31,163,"Nebraska","Sherman County",1,84,21,8,13
050,31,163,"Nebraska","Sherman County",1,85,122,47,75
050,31,163,"Nebraska","Sherman County",2,0,32,16,16
050,31,163,"Nebraska","Sherman County",2,1,37,19,18
050,31,163,"Nebraska","Sherman County",2,2,37,21,16
050,31,163,"Nebraska","Sherman County",2,3,31,15,16
050,31,163,"Nebraska","Sherman County",2,4,25,9,16
050,31,163,"Nebraska","Sherman County",2,5,25,12,13
050,31,163,"Nebraska","Sherman County",2,6,34,20,14
050,31,163,"Nebraska","Sherman County",2,7,33,20,13
050,31,163,"Nebraska","Sherman County",2,8,31,18,13
050,31,163,"Nebraska","Sherman County",2,9,37,21,16
050,31,163,"Nebraska","Sherman County",2,10,41,24,17
050,31,163,"Nebraska","Sherman County",2,11,41,23,18
050,31,163,"Nebraska","Sherman County",2,12,39,20,19
050,31,163,"Nebraska","Sherman County",2,13,38,17,21
050,31,163,"Nebraska","Sherman County",2,14,37,17,20
050,31,163,"Nebraska","Sherman County",2,15,40,15,25
050,31,163,"Nebraska","Sherman County",2,16,40,19,21
050,31,163,"Nebraska","Sherman County",2,17,40,20,20
050,31,163,"Nebraska","Sherman County",2,18,33,17,16
050,31,163,"Nebraska","Sherman County",2,19,22,10,12
050,31,163,"Nebraska","Sherman County",2,20,27,13,14
050,31,163,"Nebraska","Sherman County",2,21,26,13,13
050,31,163,"Nebraska","Sherman County",2,22,28,15,13
050,31,163,"Nebraska","Sherman County",2,23,24,15,9
050,31,163,"Nebraska","Sherman County",2,24,22,12,10
050,31,163,"Nebraska","Sherman County",2,25,31,15,16
050,31,163,"Nebraska","Sherman County",2,26,27,14,13
050,31,163,"Nebraska","Sherman County",2,27,32,17,15
050,31,163,"Nebraska","Sherman County",2,28,30,16,14
050,31,163,"Nebraska","Sherman County",2,29,25,13,12
050,31,163,"Nebraska","Sherman County",2,30,27,15,12
050,31,163,"Nebraska","Sherman County",2,31,26,12,14
050,31,163,"Nebraska","Sherman County",2,32,21,8,13
050,31,163,"Nebraska","Sherman County",2,33,24,9,15
050,31,163,"Nebraska","Sherman County",2,34,28,14,14
050,31,163,"Nebraska","Sherman County",2,35,31,17,14
050,31,163,"Nebraska","Sherman County",2,36,29,13,16
050,31,163,"Nebraska","Sherman County",2,37,30,15,15
050,31,163,"Nebraska","Sherman County",2,38,27,12,15
050,31,163,"Nebraska","Sherman County",2,39,23,13,10
050,31,163,"Nebraska","Sherman County",2,40,27,14,13
050,31,163,"Nebraska","Sherman County",2,41,25,16,9
050,31,163,"Nebraska","Sherman County",2,42,26,17,9
050,31,163,"Nebraska","Sherman County",2,43,27,16,11
050,31,163,"Nebraska","Sherman County",2,44,24,11,13
050,31,163,"Nebraska","Sherman County",2,45,29,15,14
050,31,163,"Nebraska","Sherman County",2,46,29,17,12
050,31,163,"Nebraska","Sherman County",2,47,33,18,15
050,31,163,"Nebraska","Sherman County",2,48,35,18,17
050,31,163,"Nebraska","Sherman County",2,49,27,12,15
050,31,163,"Nebraska","Sherman County",2,50,30,13,17
050,31,163,"Nebraska","Sherman County",2,51,31,13,18
050,31,163,"Nebraska","Sherman County",2,52,35,14,21
050,31,163,"Nebraska","Sherman County",2,53,35,14,21
050,31,163,"Nebraska","Sherman County",2,54,39,16,23
050,31,163,"Nebraska","Sherman County",2,55,41,21,20
050,31,163,"Nebraska","Sherman County",2,56,39,21,18
050,31,163,"Nebraska","Sherman County",2,57,38,19,19
050,31,163,"Nebraska","Sherman County",2,58,41,18,23
050,31,163,"Nebraska","Sherman County",2,59,55,29,26
050,31,163,"Nebraska","Sherman County",2,60,52,29,23
050,31,163,"Nebraska","Sherman County",2,61,53,30,23
050,31,163,"Nebraska","Sherman County",2,62,50,24,26
050,31,163,"Nebraska","Sherman County",2,63,48,23,25
050,31,163,"Nebraska","Sherman County",2,64,51,24,27
050,31,163,"Nebraska","Sherman County",2,65,53,27,26
050,31,163,"Nebraska","Sherman County",2,66,52,28,24
050,31,163,"Nebraska","Sherman County",2,67,45,27,18
050,31,163,"Nebraska","Sherman County",2,68,52,28,24
050,31,163,"Nebraska","Sherman County",2,69,47,22,25
050,31,163,"Nebraska","Sherman County",2,70,42,23,19
050,31,163,"Nebraska","Sherman County",2,71,36,21,15
050,31,163,"Nebraska","Sherman County",2,72,34,17,17
050,31,163,"Nebraska","Sherman County",2,73,49,29,20
050,31,163,"Nebraska","Sherman County",2,74,34,18,16
050,31,163,"Nebraska","Sherman County",2,75,32,16,16
050,31,163,"Nebraska","Sherman County",2,76,32,11,21
050,31,163,"Nebraska","Sherman County",2,77,27,11,16
050,31,163,"Nebraska","Sherman County",2,78,20,8,12
050,31,163,"Nebraska","Sherman County",2,79,18,9,9
050,31,163,"Nebraska","Sherman County",2,80,23,12,11
050,31,163,"Nebraska","Sherman County",2,81,22,9,13
050,31,163,"Nebraska","Sherman County",2,82,21,6,15
050,31,163,"Nebraska","Sherman County",2,83,22,8,14
050,31,163,"Nebraska","Sherman County",2,84,20,7,13
050,31,163,"Nebraska","Sherman County",2,85,124,49,75
050,31,163,"Nebraska","Sherman County",3,0,34,21,13
050,31,163,"Nebraska","Sherman County",3,1,24,11,13
050,31,163,"Nebraska","Sherman County",3,2,40,20,20
050,31,163,"Nebraska","Sherman County",3,3,40,25,15
050,31,163,"Nebraska","Sherman County",3,4,32,19,13
050,31,163,"Nebraska","Sherman County",3,5,28,11,17
050,31,163,"Nebraska","Sherman County",3,6,26,14,12
050,31,163,"Nebraska","Sherman County",3,7,35,22,13
050,31,163,"Nebraska","Sherman County",3,8,34,23,11
050,31,163,"Nebraska","Sherman County",3,9,30,17,13
050,31,163,"Nebraska","Sherman County",3,10,37,20,17
050,31,163,"Nebraska","Sherman County",3,11,44,25,19
050,31,163,"Nebraska","Sherman County",3,12,41,22,19
050,31,163,"Nebraska","Sherman County",3,13,37,21,16
050,31,163,"Nebraska","Sherman County",3,14,40,18,22
050,31,163,"Nebraska","Sherman County",3,15,41,18,23
050,31,163,"Nebraska","Sherman County",3,16,42,18,24
050,31,163,"Nebraska","Sherman County",3,17,40,21,19
050,31,163,"Nebraska","Sherman County",3,18,31,17,14
050,31,163,"Nebraska","Sherman County",3,19,26,15,11
050,31,163,"Nebraska","Sherman County",3,20,28,11,17
050,31,163,"Nebraska","Sherman County",3,21,29,15,14
050,31,163,"Nebraska","Sherman County",3,22,26,11,15
050,31,163,"Nebraska","Sherman County",3,23,27,15,12
050,31,163,"Nebraska","Sherman County",3,24,23,15,8
050,31,163,"Nebraska","Sherman County",3,25,23,12,11
050,31,163,"Nebraska","Sherman County",3,26,34,18,16
050,31,163,"Nebraska","Sherman County",3,27,34,17,17
050,31,163,"Nebraska","Sherman County",3,28,30,16,14
050,31,163,"Nebraska","Sherman County",3,29,33,18,15
050,31,163,"Nebraska","Sherman County",3,30,24,11,13
050,31,163,"Nebraska","Sherman County",3,31,30,16,14
050,31,163,"Nebraska","Sherman County",3,32,29,12,17
050,31,163,"Nebraska","Sherman County",3,33,18,8,10
050,31,163,"Nebraska","Sherman County",3,34,29,10,19
050,31,163,"Nebraska","Sherman County",3,35,28,12,16
050,31,163,"Nebraska","Sherman County",3,36,32,18,14
050,31,163,"Nebraska","Sherman County",3,37,29,13,16
050,31,163,"Nebraska","Sherman County",3,38,32,15,17
050,31,163,"Nebraska","Sherman County",3,39,23,10,13
050,31,163,"Nebraska","Sherman County",3,40,22,12,10
050,31,163,"Nebraska","Sherman County",3,41,26,14,12
050,31,163,"Nebraska","Sherman County",3,42,25,15,10
050,31,163,"Nebraska","Sherman County",3,43,29,17,12
050,31,163,"Nebraska","Sherman County",3,44,30,19,11
050,31,163,"Nebraska","Sherman County",3,45,25,12,13
050,31,163,"Nebraska","Sherman County",3,46,28,14,14
050,31,163,"Nebraska","Sherman County",3,47,32,20,12
050,31,163,"Nebraska","Sherman County",3,48,34,19,15
050,31,163,"Nebraska","Sherman County",3,49,36,18,18
050,31,163,"Nebraska","Sherman County",3,50,28,13,15
050,31,163,"Nebraska","Sherman County",3,51,30,13,17
050,31,163,"Nebraska","Sherman County",3,52,32,14,18
050,31,163,"Nebraska","Sherman County",3,53,35,14,21
050,31,163,"Nebraska","Sherman County",3,54,35,13,22
050,31,163,"Nebraska","Sherman County",3,55,39,16,23
050,31,163,"Nebraska","Sherman County",3,56,44,23,21
050,31,163,"Nebraska","Sherman County",3,57,38,21,17
050,31,163,"Nebraska","Sherman County",3,58,38,19,19
050,31,163,"Nebraska","Sherman County",3,59,42,19,23
050,31,163,"Nebraska","Sherman County",3,60,53,27,26
050,31,163,"Nebraska","Sherman County",3,61,52,30,22
050,31,163,"Nebraska","Sherman County",3,62,57,31,26
050,31,163,"Nebraska","Sherman County",3,63,51,24,27
050,31,163,"Nebraska","Sherman County",3,64,48,23,25
050,31,163,"Nebraska","Sherman County",3,65,53,24,29
050,31,163,"Nebraska","Sherman County",3,66,53,27,26
050,31,163,"Nebraska","Sherman County",3,67,52,29,23
050,31,163,"Nebraska","Sherman County",3,68,46,27,19
050,31,163,"Nebraska","Sherman County",3,69,49,28,21
050,31,163,"Nebraska","Sherman County",3,70,44,22,22
050,31,163,"Nebraska","Sherman County",3,71,40,20,20
050,31,163,"Nebraska","Sherman County",3,72,36,20,16
050,31,163,"Nebraska","Sherman County",3,73,31,15,16
050,31,163,"Nebraska","Sherman County",3,74,46,28,18
050,31,163,"Nebraska","Sherman County",3,75,33,18,15
050,31,163,"Nebraska","Sherman County",3,76,29,15,14
050,31,163,"Nebraska","Sherman County",3,77,30,11,19
050,31,163,"Nebraska","Sherman County",3,78,28,13,15
050,31,163,"Nebraska","Sherman County",3,79,16,6,10
050,31,163,"Nebraska","Sherman County",3,80,19,9,10
050,31,163,"Nebraska","Sherman County",3,81,20,10,10
050,31,163,"Nebraska","Sherman County",3,82,19,8,11
050,31,163,"Nebraska","Sherman County",3,83,22,6,16
050,31,163,"Nebraska","Sherman County",3,84,19,7,12
050,31,163,"Nebraska","Sherman County",3,85,109,43,66
050,31,163,"Nebraska","Sherman County",4,0,32,18,14
050,31,163,"Nebraska","Sherman County",4,1,36,23,13
050,31,163,"Nebraska","Sherman County",4,2,25,14,11
050,31,163,"Nebraska","Sherman County",4,3,43,22,21
050,31,163,"Nebraska","Sherman County",4,4,41,26,15
050,31,163,"Nebraska","Sherman County",4,5,36,22,14
050,31,163,"Nebraska","Sherman County",4,6,31,13,18
050,31,163,"Nebraska","Sherman County",4,7,29,16,13
050,31,163,"Nebraska","Sherman County",4,8,38,24,14
050,31,163,"Nebraska","Sherman County",4,9,40,24,16
050,31,163,"Nebraska","Sherman County",4,10,32,18,14
050,31,163,"Nebraska","Sherman County",4,11,38,20,18
050,31,163,"Nebraska","Sherman County",4,12,47,25,22
050,31,163,"Nebraska","Sherman County",4,13,39,21,18
050,31,163,"Nebraska","Sherman County",4,14,38,20,18
050,31,163,"Nebraska","Sherman County",4,15,40,19,21
050,31,163,"Nebraska","Sherman County",4,16,43,17,26
050,31,163,"Nebraska","Sherman County",4,17,42,18,24
050,31,163,"Nebraska","Sherman County",4,18,34,20,14
050,31,163,"Nebraska","Sherman County",4,19,21,13,8
050,31,163,"Nebraska","Sherman County",4,20,28,16,12
050,31,163,"Nebraska","Sherman County",4,21,27,12,15
050,31,163,"Nebraska","Sherman County",4,22,31,16,15
050,31,163,"Nebraska","Sherman County",4,23,19,9,10
050,31,163,"Nebraska","Sherman County",4,24,28,18,10
050,31,163,"Nebraska","Sherman County",4,25,22,14,8
050,31,163,"Nebraska","Sherman County",4,26,24,13,11
050,31,163,"Nebraska","Sherman County",4,27,32,17,15
050,31,163,"Nebraska","Sherman County",4,28,36,18,18
050,31,163,"Nebraska","Sherman County",4,29,31,17,14
050,31,163,"Nebraska","Sherman County",4,30,34,18,16
050,31,163,"Nebraska","Sherman County",4,31,28,13,15
050,31,163,"Nebraska","Sherman County",4,32,31,15,16
050,31,163,"Nebraska","Sherman County",4,33,30,13,17
050,31,163,"Nebraska","Sherman County",4,34,20,8,12
050,31,163,"Nebraska","Sherman County",4,35,33,14,19
050,31,163,"Nebraska","Sherman County",4,36,27,11,16
050,31,163,"Nebraska","Sherman County",4,37,34,19,15
050,31,163,"Nebraska","Sherman County",4,38,31,14,17
050,31,163,"Nebraska","Sherman County",4,39,37,18,19
050,31,163,"Nebraska","Sherman County",4,40,26,11,15
050,31,163,"Nebraska","Sherman County",4,41,24,12,12
050,31,163,"Nebraska","Sherman County",4,42,28,15,13
050,31,163,"Nebraska","Sherman County",4,43,26,18,8
050,31,163,"Nebraska","Sherman County",4,44,32,20,12
050,31,163,"Nebraska","Sherman County",4,45,32,21,11
050,31,163,"Nebraska","Sherman County",4,46,26,12,14
050,31,163,"Nebraska","Sherman County",4,47,28,14,14
050,31,163,"Nebraska","Sherman County",4,48,30,17,13
050,31,163,"Nebraska","Sherman County",4,49,31,19,12
050,31,163,"Nebraska","Sherman County",4,50,36,18,18
050,31,163,"Nebraska","Sherman County",4,51,27,12,15
050,31,163,"Nebraska","Sherman County",4,52,29,12,17
050,31,163,"Nebraska","Sherman County",4,53,32,14,18
050,31,163,"Nebraska","Sherman County",4,54,34,14,20
050,31,163,"Nebraska","Sherman County",4,55,31,11,20
050,31,163,"Nebraska","Sherman County",4,56,38,16,22
050,31,163,"Nebraska","Sherman County",4,57,43,23,20
050,31,163,"Nebraska","Sherman County",4,58,37,21,16
050,31,163,"Nebraska","Sherman County",4,59,40,20,20
050,31,163,"Nebraska","Sherman County",4,60,40,18,22
050,31,163,"Nebraska","Sherman County",4,61,53,28,25
050,31,163,"Nebraska","Sherman County",4,62,50,28,22
050,31,163,"Nebraska","Sherman County",4,63,54,28,26
050,31,163,"Nebraska","Sherman County",4,64,53,25,28
050,31,163,"Nebraska","Sherman County",4,65,48,21,27
050,31,163,"Nebraska","Sherman County",4,66,54,25,29
050,31,163,"Nebraska","Sherman County",4,67,57,29,28
050,31,163,"Nebraska","Sherman County",4,68,55,28,27
050,31,163,"Nebraska","Sherman County",4,69,41,26,15
050,31,163,"Nebraska","Sherman County",4,70,49,29,20
050,31,163,"Nebraska","Sherman County",4,71,43,22,21
050,31,163,"Nebraska","Sherman County",4,72,38,19,19
050,31,163,"Nebraska","Sherman County",4,73,34,19,15
050,31,163,"Nebraska","Sherman County",4,74,32,16,16
050,31,163,"Nebraska","Sherman County",4,75,47,28,19
050,31,163,"Nebraska","Sherman County",4,76,32,16,16
050,31,163,"Nebraska","Sherman County",4,77,26,15,11
050,31,163,"Nebraska","Sherman County",4,78,33,12,21
050,31,163,"Nebraska","Sherman County",4,79,24,11,13
050,31,163,"Nebraska","Sherman County",4,80,18,7,11
050,31,163,"Nebraska","Sherman County",4,81,18,8,10
050,31,163,"Nebraska","Sherman County",4,82,20,9,11
050,31,163,"Nebraska","Sherman County",4,83,18,6,12
050,31,163,"Nebraska","Sherman County",4,84,19,4,15
050,31,163,"Nebraska","Sherman County",4,85,112,41,71
050,31,163,"Nebraska","Sherman County",5,0,32,18,14
050,31,163,"Nebraska","Sherman County",5,1,26,14,12
050,31,163,"Nebraska","Sherman County",5,2,39,24,15
050,31,163,"Nebraska","Sherman County",5,3,27,14,13
050,31,163,"Nebraska","Sherman County",5,4,40,21,19
050,31,163,"Nebraska","Sherman County",5,5,40,25,15
050,31,163,"Nebraska","Sherman County",5,6,36,22,14
050,31,163,"Nebraska","Sherman County",5,7,28,10,18
050,31,163,"Nebraska","Sherman County",5,8,27,12,15
050,31,163,"Nebraska","Sherman County",5,9,36,24,12
050,31,163,"Nebraska","Sherman County",5,10,38,23,15
050,31,163,"Nebraska","Sherman County",5,11,33,19,14
050,31,163,"Nebraska","Sherman County",5,12,38,21,17
050,31,163,"Nebraska","Sherman County",5,13,49,29,20
050,31,163,"Nebraska","Sherman County",5,14,41,23,18
050,31,163,"Nebraska","Sherman County",5,15,39,18,21
050,31,163,"Nebraska","Sherman County",5,16,41,20,21
050,31,163,"Nebraska","Sherman County",5,17,46,20,26
050,31,163,"Nebraska","Sherman County",5,18,30,13,17
050,31,163,"Nebraska","Sherman County",5,19,24,13,11
050,31,163,"Nebraska","Sherman County",5,20,24,15,9
050,31,163,"Nebraska","Sherman County",5,21,30,18,12
050,31,163,"Nebraska","Sherman County",5,22,25,11,14
050,31,163,"Nebraska","Sherman County",5,23,36,20,16
050,31,163,"Nebraska","Sherman County",5,24,23,11,12
050,31,163,"Nebraska","Sherman County",5,25,25,16,9
050,31,163,"Nebraska","Sherman County",5,26,21,13,8
050,31,163,"Nebraska","Sherman County",5,27,25,14,11
050,31,163,"Nebraska","Sherman County",5,28,31,18,13
050,31,163,"Nebraska","Sherman County",5,29,31,14,17
050,31,163,"Nebraska","Sherman County",5,30,31,16,15
050,31,163,"Nebraska","Sherman County",5,31,34,18,16
050,31,163,"Nebraska","Sherman County",5,32,26,12,14
050,31,163,"Nebraska","Sherman County",5,33,32,16,16
050,31,163,"Nebraska","Sherman County",5,34,26,11,15
050,31,163,"Nebraska","Sherman County",5,35,21,9,12
050,31,163,"Nebraska","Sherman County",5,36,31,14,17
050,31,163,"Nebraska","Sherman County",5,37,29,12,17
050,31,163,"Nebraska","Sherman County",5,38,37,19,18
050,31,163,"Nebraska","Sherman County",5,39,31,14,17
050,31,163,"Nebraska","Sherman County",5,40,37,18,19
050,31,163,"Nebraska","Sherman County",5,41,28,10,18
050,31,163,"Nebraska","Sherman County",5,42,24,12,12
050,31,163,"Nebraska","Sherman County",5,43,30,17,13
050,31,163,"Nebraska","Sherman County",5,44,31,20,11
050,31,163,"Nebraska","Sherman County",5,45,31,20,11
050,31,163,"Nebraska","Sherman County",5,46,32,22,10
050,31,163,"Nebraska","Sherman County",5,47,25,11,14
050,31,163,"Nebraska","Sherman County",5,48,31,16,15
050,31,163,"Nebraska","Sherman County",5,49,28,17,11
050,31,163,"Nebraska","Sherman County",5,50,28,16,12
050,31,163,"Nebraska","Sherman County",5,51,36,17,19
050,31,163,"Nebraska","Sherman County",5,52,29,12,17
050,31,163,"Nebraska","Sherman County",5,53,29,12,17
050,31,163,"Nebraska","Sherman County",5,54,32,14,18
050,31,163,"Nebraska","Sherman County",5,55,36,16,20
050,31,163,"Nebraska","Sherman County",5,56,31,11,20
050,31,163,"Nebraska","Sherman County",5,57,35,14,21
050,31,163,"Nebraska","Sherman County",5,58,42,22,20
050,31,163,"Nebraska","Sherman County",5,59,40,22,18
050,31,163,"Nebraska","Sherman County",5,60,35,16,19
050,31,163,"Nebraska","Sherman County",5,61,40,18,22
050,31,163,"Nebraska","Sherman County",5,62,52,25,27
050,31,163,"Nebraska","Sherman County",5,63,49,28,21
050,31,163,"Nebraska","Sherman County",5,64,54,28,26
050,31,163,"Nebraska","Sherman County",5,65,56,26,30
050,31,163,"Nebraska","Sherman County",5,66,47,21,26
050,31,163,"Nebraska","Sherman County",5,67,54,26,28
050,31,163,"Nebraska","Sherman County",5,68,57,28,29
050,31,163,"Nebraska","Sherman County",5,69,48,24,24
050,31,163,"Nebraska","Sherman County",5,70,43,27,16
050,31,163,"Nebraska","Sherman County",5,71,47,27,20
050,31,163,"Nebraska","Sherman County",5,72,43,21,22
050,31,163,"Nebraska","Sherman County",5,73,37,19,18
050,31,163,"Nebraska","Sherman County",5,74,35,19,16
050,31,163,"Nebraska","Sherman County",5,75,31,16,15
050,31,163,"Nebraska","Sherman County",5,76,45,26,19
050,31,163,"Nebraska","Sherman County",5,77,31,17,14
050,31,163,"Nebraska","Sherman County",5,78,28,16,12
050,31,163,"Nebraska","Sherman County",5,79,29,10,19
050,31,163,"Nebraska","Sherman County",5,80,25,11,14
050,31,163,"Nebraska","Sherman County",5,81,17,5,12
050,31,163,"Nebraska","Sherman County",5,82,18,8,10
050,31,163,"Nebraska","Sherman County",5,83,21,9,12
050,31,163,"Nebraska","Sherman County",5,84,16,5,11
050,31,163,"Nebraska","Sherman County",5,85,111,38,73
050,31,165,"Nebraska","Sioux County",1,0,7,3,4
050,31,165,"Nebraska","Sioux County",1,1,10,5,5
050,31,165,"Nebraska","Sioux County",1,2,14,10,4
050,31,165,"Nebraska","Sioux County",1,3,10,6,4
050,31,165,"Nebraska","Sioux County",1,4,9,4,5
050,31,165,"Nebraska","Sioux County",1,5,6,2,4
050,31,165,"Nebraska","Sioux County",1,6,8,5,3
050,31,165,"Nebraska","Sioux County",1,7,7,4,3
050,31,165,"Nebraska","Sioux County",1,8,10,6,4
050,31,165,"Nebraska","Sioux County",1,9,8,3,5
050,31,165,"Nebraska","Sioux County",1,10,9,6,3
050,31,165,"Nebraska","Sioux County",1,11,12,9,3
050,31,165,"Nebraska","Sioux County",1,12,14,11,3
050,31,165,"Nebraska","Sioux County",1,13,13,6,7
050,31,165,"Nebraska","Sioux County",1,14,14,6,8
050,31,165,"Nebraska","Sioux County",1,15,13,8,5
050,31,165,"Nebraska","Sioux County",1,16,15,7,8
050,31,165,"Nebraska","Sioux County",1,17,15,8,7
050,31,165,"Nebraska","Sioux County",1,18,12,8,4
050,31,165,"Nebraska","Sioux County",1,19,11,5,6
050,31,165,"Nebraska","Sioux County",1,20,12,4,8
050,31,165,"Nebraska","Sioux County",1,21,11,6,5
050,31,165,"Nebraska","Sioux County",1,22,14,9,5
050,31,165,"Nebraska","Sioux County",1,23,10,5,5
050,31,165,"Nebraska","Sioux County",1,24,15,8,7
050,31,165,"Nebraska","Sioux County",1,25,12,5,7
050,31,165,"Nebraska","Sioux County",1,26,11,7,4
050,31,165,"Nebraska","Sioux County",1,27,10,5,5
050,31,165,"Nebraska","Sioux County",1,28,6,4,2
050,31,165,"Nebraska","Sioux County",1,29,4,2,2
050,31,165,"Nebraska","Sioux County",1,30,9,5,4
050,31,165,"Nebraska","Sioux County",1,31,5,2,3
050,31,165,"Nebraska","Sioux County",1,32,5,3,2
050,31,165,"Nebraska","Sioux County",1,33,8,4,4
050,31,165,"Nebraska","Sioux County",1,34,11,5,6
050,31,165,"Nebraska","Sioux County",1,35,14,8,6
050,31,165,"Nebraska","Sioux County",1,36,13,4,9
050,31,165,"Nebraska","Sioux County",1,37,14,8,6
050,31,165,"Nebraska","Sioux County",1,38,14,9,5
050,31,165,"Nebraska","Sioux County",1,39,9,5,4
050,31,165,"Nebraska","Sioux County",1,40,10,4,6
050,31,165,"Nebraska","Sioux County",1,41,10,5,5
050,31,165,"Nebraska","Sioux County",1,42,10,6,4
050,31,165,"Nebraska","Sioux County",1,43,10,6,4
050,31,165,"Nebraska","Sioux County",1,44,11,7,4
050,31,165,"Nebraska","Sioux County",1,45,15,9,6
050,31,165,"Nebraska","Sioux County",1,46,9,2,7
050,31,165,"Nebraska","Sioux County",1,47,9,3,6
050,31,165,"Nebraska","Sioux County",1,48,14,7,7
050,31,165,"Nebraska","Sioux County",1,49,8,4,4
050,31,165,"Nebraska","Sioux County",1,50,10,4,6
050,31,165,"Nebraska","Sioux County",1,51,9,6,3
050,31,165,"Nebraska","Sioux County",1,52,11,5,6
050,31,165,"Nebraska","Sioux County",1,53,12,4,8
050,31,165,"Nebraska","Sioux County",1,54,18,8,10
050,31,165,"Nebraska","Sioux County",1,55,16,7,9
050,31,165,"Nebraska","Sioux County",1,56,10,7,3
050,31,165,"Nebraska","Sioux County",1,57,20,13,7
050,31,165,"Nebraska","Sioux County",1,58,30,18,12
050,31,165,"Nebraska","Sioux County",1,59,24,15,9
050,31,165,"Nebraska","Sioux County",1,60,20,10,10
050,31,165,"Nebraska","Sioux County",1,61,19,9,10
050,31,165,"Nebraska","Sioux County",1,62,19,10,9
050,31,165,"Nebraska","Sioux County",1,63,20,11,9
050,31,165,"Nebraska","Sioux County",1,64,25,16,9
050,31,165,"Nebraska","Sioux County",1,65,24,13,11
050,31,165,"Nebraska","Sioux County",1,66,25,17,8
050,31,165,"Nebraska","Sioux County",1,67,21,13,8
050,31,165,"Nebraska","Sioux County",1,68,24,12,12
050,31,165,"Nebraska","Sioux County",1,69,21,11,10
050,31,165,"Nebraska","Sioux County",1,70,18,13,5
050,31,165,"Nebraska","Sioux County",1,71,19,10,9
050,31,165,"Nebraska","Sioux County",1,72,16,6,10
050,31,165,"Nebraska","Sioux County",1,73,12,4,8
050,31,165,"Nebraska","Sioux County",1,74,8,5,3
050,31,165,"Nebraska","Sioux County",1,75,12,7,5
050,31,165,"Nebraska","Sioux County",1,76,11,6,5
050,31,165,"Nebraska","Sioux County",1,77,12,6,6
050,31,165,"Nebraska","Sioux County",1,78,9,4,5
050,31,165,"Nebraska","Sioux County",1,79,8,3,5
050,31,165,"Nebraska","Sioux County",1,80,8,3,5
050,31,165,"Nebraska","Sioux County",1,81,8,5,3
050,31,165,"Nebraska","Sioux County",1,82,7,4,3
050,31,165,"Nebraska","Sioux County",1,83,6,3,3
050,31,165,"Nebraska","Sioux County",1,84,5,2,3
050,31,165,"Nebraska","Sioux County",1,85,64,34,30
050,31,165,"Nebraska","Sioux County",2,0,9,5,4
050,31,165,"Nebraska","Sioux County",2,1,10,5,5
050,31,165,"Nebraska","Sioux County",2,2,13,9,4
050,31,165,"Nebraska","Sioux County",2,3,11,7,4
050,31,165,"Nebraska","Sioux County",2,4,9,4,5
050,31,165,"Nebraska","Sioux County",2,5,7,3,4
050,31,165,"Nebraska","Sioux County",2,6,8,5,3
050,31,165,"Nebraska","Sioux County",2,7,7,4,3
050,31,165,"Nebraska","Sioux County",2,8,9,5,4
050,31,165,"Nebraska","Sioux County",2,9,9,4,5
050,31,165,"Nebraska","Sioux County",2,10,9,6,3
050,31,165,"Nebraska","Sioux County",2,11,12,9,3
050,31,165,"Nebraska","Sioux County",2,12,14,11,3
050,31,165,"Nebraska","Sioux County",2,13,13,7,6
050,31,165,"Nebraska","Sioux County",2,14,13,6,7
050,31,165,"Nebraska","Sioux County",2,15,13,7,6
050,31,165,"Nebraska","Sioux County",2,16,15,7,8
050,31,165,"Nebraska","Sioux County",2,17,15,8,7
050,31,165,"Nebraska","Sioux County",2,18,12,8,4
050,31,165,"Nebraska","Sioux County",2,19,11,6,5
050,31,165,"Nebraska","Sioux County",2,20,13,5,8
050,31,165,"Nebraska","Sioux County",2,21,11,6,5
050,31,165,"Nebraska","Sioux County",2,22,13,8,5
050,31,165,"Nebraska","Sioux County",2,23,11,6,5
050,31,165,"Nebraska","Sioux County",2,24,15,8,7
050,31,165,"Nebraska","Sioux County",2,25,12,5,7
050,31,165,"Nebraska","Sioux County",2,26,11,6,5
050,31,165,"Nebraska","Sioux County",2,27,10,5,5
050,31,165,"Nebraska","Sioux County",2,28,7,4,3
050,31,165,"Nebraska","Sioux County",2,29,4,2,2
050,31,165,"Nebraska","Sioux County",2,30,8,4,4
050,31,165,"Nebraska","Sioux County",2,31,6,3,3
050,31,165,"Nebraska","Sioux County",2,32,5,3,2
050,31,165,"Nebraska","Sioux County",2,33,8,4,4
050,31,165,"Nebraska","Sioux County",2,34,10,4,6
050,31,165,"Nebraska","Sioux County",2,35,15,8,7
050,31,165,"Nebraska","Sioux County",2,36,14,5,9
050,31,165,"Nebraska","Sioux County",2,37,14,7,7
050,31,165,"Nebraska","Sioux County",2,38,14,9,5
050,31,165,"Nebraska","Sioux County",2,39,10,6,4
050,31,165,"Nebraska","Sioux County",2,40,10,4,6
050,31,165,"Nebraska","Sioux County",2,41,10,5,5
050,31,165,"Nebraska","Sioux County",2,42,9,5,4
050,31,165,"Nebraska","Sioux County",2,43,10,6,4
050,31,165,"Nebraska","Sioux County",2,44,11,7,4
050,31,165,"Nebraska","Sioux County",2,45,15,9,6
050,31,165,"Nebraska","Sioux County",2,46,10,3,7
050,31,165,"Nebraska","Sioux County",2,47,9,3,6
050,31,165,"Nebraska","Sioux County",2,48,13,6,7
050,31,165,"Nebraska","Sioux County",2,49,10,5,5
050,31,165,"Nebraska","Sioux County",2,50,10,4,6
050,31,165,"Nebraska","Sioux County",2,51,10,6,4
050,31,165,"Nebraska","Sioux County",2,52,10,5,5
050,31,165,"Nebraska","Sioux County",2,53,13,5,8
050,31,165,"Nebraska","Sioux County",2,54,17,8,9
050,31,165,"Nebraska","Sioux County",2,55,18,8,10
050,31,165,"Nebraska","Sioux County",2,56,11,7,4
050,31,165,"Nebraska","Sioux County",2,57,18,12,6
050,31,165,"Nebraska","Sioux County",2,58,28,17,11
050,31,165,"Nebraska","Sioux County",2,59,26,16,10
050,31,165,"Nebraska","Sioux County",2,60,21,11,10
050,31,165,"Nebraska","Sioux County",2,61,19,9,10
050,31,165,"Nebraska","Sioux County",2,62,19,10,9
050,31,165,"Nebraska","Sioux County",2,63,20,11,9
050,31,165,"Nebraska","Sioux County",2,64,24,15,9
050,31,165,"Nebraska","Sioux County",2,65,24,14,10
050,31,165,"Nebraska","Sioux County",2,66,25,16,9
050,31,165,"Nebraska","Sioux County",2,67,22,14,8
050,31,165,"Nebraska","Sioux County",2,68,23,12,11
050,31,165,"Nebraska","Sioux County",2,69,23,12,11
050,31,165,"Nebraska","Sioux County",2,70,18,12,6
050,31,165,"Nebraska","Sioux County",2,71,18,10,8
050,31,165,"Nebraska","Sioux County",2,72,16,7,9
050,31,165,"Nebraska","Sioux County",2,73,14,5,9
050,31,165,"Nebraska","Sioux County",2,74,8,4,4
050,31,165,"Nebraska","Sioux County",2,75,12,7,5
050,31,165,"Nebraska","Sioux County",2,76,10,5,5
050,31,165,"Nebraska","Sioux County",2,77,12,6,6
050,31,165,"Nebraska","Sioux County",2,78,8,3,5
050,31,165,"Nebraska","Sioux County",2,79,8,3,5
050,31,165,"Nebraska","Sioux County",2,80,8,3,5
050,31,165,"Nebraska","Sioux County",2,81,9,5,4
050,31,165,"Nebraska","Sioux County",2,82,7,4,3
050,31,165,"Nebraska","Sioux County",2,83,6,3,3
050,31,165,"Nebraska","Sioux County",2,84,5,2,3
050,31,165,"Nebraska","Sioux County",2,85,63,34,29
050,31,165,"Nebraska","Sioux County",3,0,9,4,5
050,31,165,"Nebraska","Sioux County",3,1,9,5,4
050,31,165,"Nebraska","Sioux County",3,2,16,8,8
050,31,165,"Nebraska","Sioux County",3,3,14,10,4
050,31,165,"Nebraska","Sioux County",3,4,12,6,6
050,31,165,"Nebraska","Sioux County",3,5,10,4,6
050,31,165,"Nebraska","Sioux County",3,6,5,2,3
050,31,165,"Nebraska","Sioux County",3,7,9,6,3
050,31,165,"Nebraska","Sioux County",3,8,8,4,4
050,31,165,"Nebraska","Sioux County",3,9,10,6,4
050,31,165,"Nebraska","Sioux County",3,10,9,4,5
050,31,165,"Nebraska","Sioux County",3,11,10,7,3
050,31,165,"Nebraska","Sioux County",3,12,12,9,3
050,31,165,"Nebraska","Sioux County",3,13,13,9,4
050,31,165,"Nebraska","Sioux County",3,14,14,8,6
050,31,165,"Nebraska","Sioux County",3,15,16,7,9
050,31,165,"Nebraska","Sioux County",3,16,11,7,4
050,31,165,"Nebraska","Sioux County",3,17,15,7,8
050,31,165,"Nebraska","Sioux County",3,18,13,7,6
050,31,165,"Nebraska","Sioux County",3,19,9,6,3
050,31,165,"Nebraska","Sioux County",3,20,11,7,4
050,31,165,"Nebraska","Sioux County",3,21,11,4,7
050,31,165,"Nebraska","Sioux County",3,22,15,6,9
050,31,165,"Nebraska","Sioux County",3,23,11,8,3
050,31,165,"Nebraska","Sioux County",3,24,13,6,7
050,31,165,"Nebraska","Sioux County",3,25,19,9,10
050,31,165,"Nebraska","Sioux County",3,26,14,6,8
050,31,165,"Nebraska","Sioux County",3,27,10,5,5
050,31,165,"Nebraska","Sioux County",3,28,10,6,4
050,31,165,"Nebraska","Sioux County",3,29,7,4,3
050,31,165,"Nebraska","Sioux County",3,30,4,2,2
050,31,165,"Nebraska","Sioux County",3,31,8,4,4
050,31,165,"Nebraska","Sioux County",3,32,8,5,3
050,31,165,"Nebraska","Sioux County",3,33,5,2,3
050,31,165,"Nebraska","Sioux County",3,34,9,4,5
050,31,165,"Nebraska","Sioux County",3,35,11,4,7
050,31,165,"Nebraska","Sioux County",3,36,15,8,7
050,31,165,"Nebraska","Sioux County",3,37,15,6,9
050,31,165,"Nebraska","Sioux County",3,38,15,7,8
050,31,165,"Nebraska","Sioux County",3,39,13,8,5
050,31,165,"Nebraska","Sioux County",3,40,8,4,4
050,31,165,"Nebraska","Sioux County",3,41,9,3,6
050,31,165,"Nebraska","Sioux County",3,42,10,5,5
050,31,165,"Nebraska","Sioux County",3,43,10,5,5
050,31,165,"Nebraska","Sioux County",3,44,9,5,4
050,31,165,"Nebraska","Sioux County",3,45,11,8,3
050,31,165,"Nebraska","Sioux County",3,46,16,10,6
050,31,165,"Nebraska","Sioux County",3,47,11,4,7
050,31,165,"Nebraska","Sioux County",3,48,11,4,7
050,31,165,"Nebraska","Sioux County",3,49,14,7,7
050,31,165,"Nebraska","Sioux County",3,50,10,5,5
050,31,165,"Nebraska","Sioux County",3,51,8,4,4
050,31,165,"Nebraska","Sioux County",3,52,11,6,5
050,31,165,"Nebraska","Sioux County",3,53,13,7,6
050,31,165,"Nebraska","Sioux County",3,54,12,5,7
050,31,165,"Nebraska","Sioux County",3,55,16,7,9
050,31,165,"Nebraska","Sioux County",3,56,18,8,10
050,31,165,"Nebraska","Sioux County",3,57,11,7,4
050,31,165,"Nebraska","Sioux County",3,58,18,12,6
050,31,165,"Nebraska","Sioux County",3,59,28,17,11
050,31,165,"Nebraska","Sioux County",3,60,26,16,10
050,31,165,"Nebraska","Sioux County",3,61,21,11,10
050,31,165,"Nebraska","Sioux County",3,62,19,9,10
050,31,165,"Nebraska","Sioux County",3,63,17,8,9
050,31,165,"Nebraska","Sioux County",3,64,20,11,9
050,31,165,"Nebraska","Sioux County",3,65,24,15,9
050,31,165,"Nebraska","Sioux County",3,66,21,11,10
050,31,165,"Nebraska","Sioux County",3,67,25,16,9
050,31,165,"Nebraska","Sioux County",3,68,19,12,7
050,31,165,"Nebraska","Sioux County",3,69,22,12,10
050,31,165,"Nebraska","Sioux County",3,70,23,12,11
050,31,165,"Nebraska","Sioux County",3,71,16,12,4
050,31,165,"Nebraska","Sioux County",3,72,18,10,8
050,31,165,"Nebraska","Sioux County",3,73,16,7,9
050,31,165,"Nebraska","Sioux County",3,74,15,6,9
050,31,165,"Nebraska","Sioux County",3,75,8,4,4
050,31,165,"Nebraska","Sioux County",3,76,11,7,4
050,31,165,"Nebraska","Sioux County",3,77,10,5,5
050,31,165,"Nebraska","Sioux County",3,78,12,6,6
050,31,165,"Nebraska","Sioux County",3,79,6,3,3
050,31,165,"Nebraska","Sioux County",3,80,8,3,5
050,31,165,"Nebraska","Sioux County",3,81,8,3,5
050,31,165,"Nebraska","Sioux County",3,82,9,5,4
050,31,165,"Nebraska","Sioux County",3,83,7,4,3
050,31,165,"Nebraska","Sioux County",3,84,6,3,3
050,31,165,"Nebraska","Sioux County",3,85,57,31,26
050,31,165,"Nebraska","Sioux County",4,0,12,6,6
050,31,165,"Nebraska","Sioux County",4,1,9,4,5
050,31,165,"Nebraska","Sioux County",4,2,8,3,5
050,31,165,"Nebraska","Sioux County",4,3,13,6,7
050,31,165,"Nebraska","Sioux County",4,4,11,8,3
050,31,165,"Nebraska","Sioux County",4,5,9,7,2
050,31,165,"Nebraska","Sioux County",4,6,8,4,4
050,31,165,"Nebraska","Sioux County",4,7,5,2,3
050,31,165,"Nebraska","Sioux County",4,8,10,6,4
050,31,165,"Nebraska","Sioux County",4,9,6,3,3
050,31,165,"Nebraska","Sioux County",4,10,11,7,4
050,31,165,"Nebraska","Sioux County",4,11,9,4,5
050,31,165,"Nebraska","Sioux County",4,12,11,6,5
050,31,165,"Nebraska","Sioux County",4,13,12,9,3
050,31,165,"Nebraska","Sioux County",4,14,12,7,5
050,31,165,"Nebraska","Sioux County",4,15,15,5,10
050,31,165,"Nebraska","Sioux County",4,16,14,5,9
050,31,165,"Nebraska","Sioux County",4,17,12,7,5
050,31,165,"Nebraska","Sioux County",4,18,12,6,6
050,31,165,"Nebraska","Sioux County",4,19,10,6,4
050,31,165,"Nebraska","Sioux County",4,20,10,6,4
050,31,165,"Nebraska","Sioux County",4,21,11,7,4
050,31,165,"Nebraska","Sioux County",4,22,13,4,9
050,31,165,"Nebraska","Sioux County",4,23,8,4,4
050,31,165,"Nebraska","Sioux County",4,24,10,7,3
050,31,165,"Nebraska","Sioux County",4,25,13,6,7
050,31,165,"Nebraska","Sioux County",4,26,19,9,10
050,31,165,"Nebraska","Sioux County",4,27,13,5,8
050,31,165,"Nebraska","Sioux County",4,28,9,6,3
050,31,165,"Nebraska","Sioux County",4,29,10,5,5
050,31,165,"Nebraska","Sioux County",4,30,9,4,5
050,31,165,"Nebraska","Sioux County",4,31,7,4,3
050,31,165,"Nebraska","Sioux County",4,32,9,4,5
050,31,165,"Nebraska","Sioux County",4,33,7,5,2
050,31,165,"Nebraska","Sioux County",4,34,5,2,3
050,31,165,"Nebraska","Sioux County",4,35,11,7,4
050,31,165,"Nebraska","Sioux County",4,36,11,4,7
050,31,165,"Nebraska","Sioux County",4,37,15,8,7
050,31,165,"Nebraska","Sioux County",4,38,14,6,8
050,31,165,"Nebraska","Sioux County",4,39,13,7,6
050,31,165,"Nebraska","Sioux County",4,40,14,8,6
050,31,165,"Nebraska","Sioux County",4,41,10,4,6
050,31,165,"Nebraska","Sioux County",4,42,11,4,7
050,31,165,"Nebraska","Sioux County",4,43,9,4,5
050,31,165,"Nebraska","Sioux County",4,44,9,5,4
050,31,165,"Nebraska","Sioux County",4,45,9,6,3
050,31,165,"Nebraska","Sioux County",4,46,8,6,2
050,31,165,"Nebraska","Sioux County",4,47,15,9,6
050,31,165,"Nebraska","Sioux County",4,48,11,4,7
050,31,165,"Nebraska","Sioux County",4,49,12,5,7
050,31,165,"Nebraska","Sioux County",4,50,14,7,7
050,31,165,"Nebraska","Sioux County",4,51,11,5,6
050,31,165,"Nebraska","Sioux County",4,52,8,4,4
050,31,165,"Nebraska","Sioux County",4,53,13,8,5
050,31,165,"Nebraska","Sioux County",4,54,13,7,6
050,31,165,"Nebraska","Sioux County",4,55,12,5,7
050,31,165,"Nebraska","Sioux County",4,56,16,7,9
050,31,165,"Nebraska","Sioux County",4,57,16,6,10
050,31,165,"Nebraska","Sioux County",4,58,12,7,5
050,31,165,"Nebraska","Sioux County",4,59,18,12,6
050,31,165,"Nebraska","Sioux County",4,60,25,14,11
050,31,165,"Nebraska","Sioux County",4,61,25,16,9
050,31,165,"Nebraska","Sioux County",4,62,20,11,9
050,31,165,"Nebraska","Sioux County",4,63,21,11,10
050,31,165,"Nebraska","Sioux County",4,64,17,8,9
050,31,165,"Nebraska","Sioux County",4,65,18,9,9
050,31,165,"Nebraska","Sioux County",4,66,23,14,9
050,31,165,"Nebraska","Sioux County",4,67,21,11,10
050,31,165,"Nebraska","Sioux County",4,68,26,17,9
050,31,165,"Nebraska","Sioux County",4,69,19,12,7
050,31,165,"Nebraska","Sioux County",4,70,21,12,9
050,31,165,"Nebraska","Sioux County",4,71,22,11,11
050,31,165,"Nebraska","Sioux County",4,72,16,12,4
050,31,165,"Nebraska","Sioux County",4,73,17,10,7
050,31,165,"Nebraska","Sioux County",4,74,16,7,9
050,31,165,"Nebraska","Sioux County",4,75,15,6,9
050,31,165,"Nebraska","Sioux County",4,76,9,4,5
050,31,165,"Nebraska","Sioux County",4,77,12,7,5
050,31,165,"Nebraska","Sioux County",4,78,10,5,5
050,31,165,"Nebraska","Sioux County",4,79,11,5,6
050,31,165,"Nebraska","Sioux County",4,80,6,2,4
050,31,165,"Nebraska","Sioux County",4,81,9,4,5
050,31,165,"Nebraska","Sioux County",4,82,8,3,5
050,31,165,"Nebraska","Sioux County",4,83,8,5,3
050,31,165,"Nebraska","Sioux County",4,84,8,5,3
050,31,165,"Nebraska","Sioux County",4,85,57,30,27
050,31,165,"Nebraska","Sioux County",5,0,12,6,6
050,31,165,"Nebraska","Sioux County",5,1,16,6,10
050,31,165,"Nebraska","Sioux County",5,2,9,5,4
050,31,165,"Nebraska","Sioux County",5,3,8,3,5
050,31,165,"Nebraska","Sioux County",5,4,13,6,7
050,31,165,"Nebraska","Sioux County",5,5,10,7,3
050,31,165,"Nebraska","Sioux County",5,6,11,8,3
050,31,165,"Nebraska","Sioux County",5,7,10,5,5
050,31,165,"Nebraska","Sioux County",5,8,5,2,3
050,31,165,"Nebraska","Sioux County",5,9,10,5,5
050,31,165,"Nebraska","Sioux County",5,10,9,5,4
050,31,165,"Nebraska","Sioux County",5,11,12,8,4
050,31,165,"Nebraska","Sioux County",5,12,8,3,5
050,31,165,"Nebraska","Sioux County",5,13,11,6,5
050,31,165,"Nebraska","Sioux County",5,14,15,10,5
050,31,165,"Nebraska","Sioux County",5,15,17,7,10
050,31,165,"Nebraska","Sioux County",5,16,16,5,11
050,31,165,"Nebraska","Sioux County",5,17,15,6,9
050,31,165,"Nebraska","Sioux County",5,18,10,6,4
050,31,165,"Nebraska","Sioux County",5,19,11,5,6
050,31,165,"Nebraska","Sioux County",5,20,8,5,3
050,31,165,"Nebraska","Sioux County",5,21,10,6,4
050,31,165,"Nebraska","Sioux County",5,22,14,7,7
050,31,165,"Nebraska","Sioux County",5,23,12,5,7
050,31,165,"Nebraska","Sioux County",5,24,8,4,4
050,31,165,"Nebraska","Sioux County",5,25,14,8,6
050,31,165,"Nebraska","Sioux County",5,26,16,9,7
050,31,165,"Nebraska","Sioux County",5,27,20,10,10
050,31,165,"Nebraska","Sioux County",5,28,14,6,8
050,31,165,"Nebraska","Sioux County",5,29,8,5,3
050,31,165,"Nebraska","Sioux County",5,30,12,7,5
050,31,165,"Nebraska","Sioux County",5,31,9,4,5
050,31,165,"Nebraska","Sioux County",5,32,6,4,2
050,31,165,"Nebraska","Sioux County",5,33,10,5,5
050,31,165,"Nebraska","Sioux County",5,34,9,7,2
050,31,165,"Nebraska","Sioux County",5,35,5,2,3
050,31,165,"Nebraska","Sioux County",5,36,11,7,4
050,31,165,"Nebraska","Sioux County",5,37,12,4,8
050,31,165,"Nebraska","Sioux County",5,38,14,7,7
050,31,165,"Nebraska","Sioux County",5,39,14,6,8
050,31,165,"Nebraska","Sioux County",5,40,12,7,5
050,31,165,"Nebraska","Sioux County",5,41,15,9,6
050,31,165,"Nebraska","Sioux County",5,42,10,4,6
050,31,165,"Nebraska","Sioux County",5,43,10,3,7
050,31,165,"Nebraska","Sioux County",5,44,10,4,6
050,31,165,"Nebraska","Sioux County",5,45,9,5,4
050,31,165,"Nebraska","Sioux County",5,46,9,6,3
050,31,165,"Nebraska","Sioux County",5,47,7,5,2
050,31,165,"Nebraska","Sioux County",5,48,17,11,6
050,31,165,"Nebraska","Sioux County",5,49,11,4,7
050,31,165,"Nebraska","Sioux County",5,50,12,5,7
050,31,165,"Nebraska","Sioux County",5,51,16,9,7
050,31,165,"Nebraska","Sioux County",5,52,11,5,6
050,31,165,"Nebraska","Sioux County",5,53,8,4,4
050,31,165,"Nebraska","Sioux County",5,54,14,8,6
050,31,165,"Nebraska","Sioux County",5,55,13,7,6
050,31,165,"Nebraska","Sioux County",5,56,12,5,7
050,31,165,"Nebraska","Sioux County",5,57,16,7,9
050,31,165,"Nebraska","Sioux County",5,58,16,6,10
050,31,165,"Nebraska","Sioux County",5,59,14,9,5
050,31,165,"Nebraska","Sioux County",5,60,13,10,3
050,31,165,"Nebraska","Sioux County",5,61,25,14,11
050,31,165,"Nebraska","Sioux County",5,62,24,15,9
050,31,165,"Nebraska","Sioux County",5,63,20,11,9
050,31,165,"Nebraska","Sioux County",5,64,23,13,10
050,31,165,"Nebraska","Sioux County",5,65,12,6,6
050,31,165,"Nebraska","Sioux County",5,66,20,11,9
050,31,165,"Nebraska","Sioux County",5,67,23,13,10
050,31,165,"Nebraska","Sioux County",5,68,20,11,9
050,31,165,"Nebraska","Sioux County",5,69,26,17,9
050,31,165,"Nebraska","Sioux County",5,70,19,12,7
050,31,165,"Nebraska","Sioux County",5,71,19,11,8
050,31,165,"Nebraska","Sioux County",5,72,22,11,11
050,31,165,"Nebraska","Sioux County",5,73,15,12,3
050,31,165,"Nebraska","Sioux County",5,74,17,10,7
050,31,165,"Nebraska","Sioux County",5,75,16,7,9
050,31,165,"Nebraska","Sioux County",5,76,15,6,9
050,31,165,"Nebraska","Sioux County",5,77,9,4,5
050,31,165,"Nebraska","Sioux County",5,78,12,7,5
050,31,165,"Nebraska","Sioux County",5,79,10,5,5
050,31,165,"Nebraska","Sioux County",5,80,10,4,6
050,31,165,"Nebraska","Sioux County",5,81,7,2,5
050,31,165,"Nebraska","Sioux County",5,82,9,4,5
050,31,165,"Nebraska","Sioux County",5,83,7,3,4
050,31,165,"Nebraska","Sioux County",5,84,8,5,3
050,31,165,"Nebraska","Sioux County",5,85,57,28,29
050,31,167,"Nebraska","Stanton County",1,0,77,40,37
050,31,167,"Nebraska","Stanton County",1,1,85,42,43
050,31,167,"Nebraska","Stanton County",1,2,71,36,35
050,31,167,"Nebraska","Stanton County",1,3,67,30,37
050,31,167,"Nebraska","Stanton County",1,4,70,34,36
050,31,167,"Nebraska","Stanton County",1,5,76,36,40
050,31,167,"Nebraska","Stanton County",1,6,73,40,33
050,31,167,"Nebraska","Stanton County",1,7,68,41,27
050,31,167,"Nebraska","Stanton County",1,8,83,46,37
050,31,167,"Nebraska","Stanton County",1,9,80,41,39
050,31,167,"Nebraska","Stanton County",1,10,82,49,33
050,31,167,"Nebraska","Stanton County",1,11,83,45,38
050,31,167,"Nebraska","Stanton County",1,12,89,45,44
050,31,167,"Nebraska","Stanton County",1,13,93,47,46
050,31,167,"Nebraska","Stanton County",1,14,81,40,41
050,31,167,"Nebraska","Stanton County",1,15,79,37,42
050,31,167,"Nebraska","Stanton County",1,16,85,45,40
050,31,167,"Nebraska","Stanton County",1,17,85,42,43
050,31,167,"Nebraska","Stanton County",1,18,78,38,40
050,31,167,"Nebraska","Stanton County",1,19,60,31,29
050,31,167,"Nebraska","Stanton County",1,20,43,24,19
050,31,167,"Nebraska","Stanton County",1,21,56,27,29
050,31,167,"Nebraska","Stanton County",1,22,62,27,35
050,31,167,"Nebraska","Stanton County",1,23,65,38,27
050,31,167,"Nebraska","Stanton County",1,24,52,25,27
050,31,167,"Nebraska","Stanton County",1,25,62,29,33
050,31,167,"Nebraska","Stanton County",1,26,58,27,31
050,31,167,"Nebraska","Stanton County",1,27,58,32,26
050,31,167,"Nebraska","Stanton County",1,28,67,32,35
050,31,167,"Nebraska","Stanton County",1,29,62,31,31
050,31,167,"Nebraska","Stanton County",1,30,61,33,28
050,31,167,"Nebraska","Stanton County",1,31,64,37,27
050,31,167,"Nebraska","Stanton County",1,32,59,32,27
050,31,167,"Nebraska","Stanton County",1,33,65,34,31
050,31,167,"Nebraska","Stanton County",1,34,75,43,32
050,31,167,"Nebraska","Stanton County",1,35,59,32,27
050,31,167,"Nebraska","Stanton County",1,36,67,36,31
050,31,167,"Nebraska","Stanton County",1,37,69,37,32
050,31,167,"Nebraska","Stanton County",1,38,84,39,45
050,31,167,"Nebraska","Stanton County",1,39,71,30,41
050,31,167,"Nebraska","Stanton County",1,40,78,43,35
050,31,167,"Nebraska","Stanton County",1,41,64,39,25
050,31,167,"Nebraska","Stanton County",1,42,67,33,34
050,31,167,"Nebraska","Stanton County",1,43,63,34,29
050,31,167,"Nebraska","Stanton County",1,44,65,38,27
050,31,167,"Nebraska","Stanton County",1,45,57,27,30
050,31,167,"Nebraska","Stanton County",1,46,60,29,31
050,31,167,"Nebraska","Stanton County",1,47,52,27,25
050,31,167,"Nebraska","Stanton County",1,48,70,37,33
050,31,167,"Nebraska","Stanton County",1,49,78,41,37
050,31,167,"Nebraska","Stanton County",1,50,72,38,34
050,31,167,"Nebraska","Stanton County",1,51,65,34,31
050,31,167,"Nebraska","Stanton County",1,52,64,33,31
050,31,167,"Nebraska","Stanton County",1,53,68,39,29
050,31,167,"Nebraska","Stanton County",1,54,78,43,35
050,31,167,"Nebraska","Stanton County",1,55,80,44,36
050,31,167,"Nebraska","Stanton County",1,56,82,40,42
050,31,167,"Nebraska","Stanton County",1,57,89,39,50
050,31,167,"Nebraska","Stanton County",1,58,89,43,46
050,31,167,"Nebraska","Stanton County",1,59,93,46,47
050,31,167,"Nebraska","Stanton County",1,60,92,47,45
050,31,167,"Nebraska","Stanton County",1,61,99,56,43
050,31,167,"Nebraska","Stanton County",1,62,95,45,50
050,31,167,"Nebraska","Stanton County",1,63,78,44,34
050,31,167,"Nebraska","Stanton County",1,64,78,44,34
050,31,167,"Nebraska","Stanton County",1,65,85,41,44
050,31,167,"Nebraska","Stanton County",1,66,82,39,43
050,31,167,"Nebraska","Stanton County",1,67,77,39,38
050,31,167,"Nebraska","Stanton County",1,68,74,34,40
050,31,167,"Nebraska","Stanton County",1,69,65,31,34
050,31,167,"Nebraska","Stanton County",1,70,57,26,31
050,31,167,"Nebraska","Stanton County",1,71,62,30,32
050,31,167,"Nebraska","Stanton County",1,72,58,29,29
050,31,167,"Nebraska","Stanton County",1,73,49,24,25
050,31,167,"Nebraska","Stanton County",1,74,36,18,18
050,31,167,"Nebraska","Stanton County",1,75,45,25,20
050,31,167,"Nebraska","Stanton County",1,76,33,16,17
050,31,167,"Nebraska","Stanton County",1,77,38,14,24
050,31,167,"Nebraska","Stanton County",1,78,36,15,21
050,31,167,"Nebraska","Stanton County",1,79,28,15,13
050,31,167,"Nebraska","Stanton County",1,80,32,16,16
050,31,167,"Nebraska","Stanton County",1,81,35,16,19
050,31,167,"Nebraska","Stanton County",1,82,35,14,21
050,31,167,"Nebraska","Stanton County",1,83,33,15,18
050,31,167,"Nebraska","Stanton County",1,84,26,9,17
050,31,167,"Nebraska","Stanton County",1,85,164,72,92
050,31,167,"Nebraska","Stanton County",2,0,72,34,38
050,31,167,"Nebraska","Stanton County",2,1,82,41,41
050,31,167,"Nebraska","Stanton County",2,2,72,36,36
050,31,167,"Nebraska","Stanton County",2,3,67,31,36
050,31,167,"Nebraska","Stanton County",2,4,72,35,37
050,31,167,"Nebraska","Stanton County",2,5,76,36,40
050,31,167,"Nebraska","Stanton County",2,6,74,40,34
050,31,167,"Nebraska","Stanton County",2,7,70,41,29
050,31,167,"Nebraska","Stanton County",2,8,79,44,35
050,31,167,"Nebraska","Stanton County",2,9,78,41,37
050,31,167,"Nebraska","Stanton County",2,10,81,47,34
050,31,167,"Nebraska","Stanton County",2,11,82,44,38
050,31,167,"Nebraska","Stanton County",2,12,87,45,42
050,31,167,"Nebraska","Stanton County",2,13,92,47,45
050,31,167,"Nebraska","Stanton County",2,14,84,42,42
050,31,167,"Nebraska","Stanton County",2,15,79,37,42
050,31,167,"Nebraska","Stanton County",2,16,83,43,40
050,31,167,"Nebraska","Stanton County",2,17,83,42,41
050,31,167,"Nebraska","Stanton County",2,18,77,38,39
050,31,167,"Nebraska","Stanton County",2,19,60,30,30
050,31,167,"Nebraska","Stanton County",2,20,49,27,22
050,31,167,"Nebraska","Stanton County",2,21,53,26,27
050,31,167,"Nebraska","Stanton County",2,22,60,27,33
050,31,167,"Nebraska","Stanton County",2,23,63,34,29
050,31,167,"Nebraska","Stanton County",2,24,54,27,27
050,31,167,"Nebraska","Stanton County",2,25,59,27,32
050,31,167,"Nebraska","Stanton County",2,26,58,28,30
050,31,167,"Nebraska","Stanton County",2,27,59,31,28
050,31,167,"Nebraska","Stanton County",2,28,66,32,34
050,31,167,"Nebraska","Stanton County",2,29,62,30,32
050,31,167,"Nebraska","Stanton County",2,30,60,32,28
050,31,167,"Nebraska","Stanton County",2,31,64,37,27
050,31,167,"Nebraska","Stanton County",2,32,61,34,27
050,31,167,"Nebraska","Stanton County",2,33,63,33,30
050,31,167,"Nebraska","Stanton County",2,34,73,41,32
050,31,167,"Nebraska","Stanton County",2,35,64,35,29
050,31,167,"Nebraska","Stanton County",2,36,65,35,30
050,31,167,"Nebraska","Stanton County",2,37,68,36,32
050,31,167,"Nebraska","Stanton County",2,38,80,38,42
050,31,167,"Nebraska","Stanton County",2,39,73,32,41
050,31,167,"Nebraska","Stanton County",2,40,77,40,37
050,31,167,"Nebraska","Stanton County",2,41,65,39,26
050,31,167,"Nebraska","Stanton County",2,42,67,35,32
050,31,167,"Nebraska","Stanton County",2,43,65,35,30
050,31,167,"Nebraska","Stanton County",2,44,64,37,27
050,31,167,"Nebraska","Stanton County",2,45,59,30,29
050,31,167,"Nebraska","Stanton County",2,46,58,28,30
050,31,167,"Nebraska","Stanton County",2,47,55,28,27
050,31,167,"Nebraska","Stanton County",2,48,65,35,30
050,31,167,"Nebraska","Stanton County",2,49,76,40,36
050,31,167,"Nebraska","Stanton County",2,50,73,39,34
050,31,167,"Nebraska","Stanton County",2,51,66,34,32
050,31,167,"Nebraska","Stanton County",2,52,64,33,31
050,31,167,"Nebraska","Stanton County",2,53,66,37,29
050,31,167,"Nebraska","Stanton County",2,54,77,43,34
050,31,167,"Nebraska","Stanton County",2,55,79,43,36
050,31,167,"Nebraska","Stanton County",2,56,83,42,41
050,31,167,"Nebraska","Stanton County",2,57,88,40,48
050,31,167,"Nebraska","Stanton County",2,58,90,43,47
050,31,167,"Nebraska","Stanton County",2,59,93,46,47
050,31,167,"Nebraska","Stanton County",2,60,92,47,45
050,31,167,"Nebraska","Stanton County",2,61,95,52,43
050,31,167,"Nebraska","Stanton County",2,62,95,47,48
050,31,167,"Nebraska","Stanton County",2,63,83,45,38
050,31,167,"Nebraska","Stanton County",2,64,76,43,33
050,31,167,"Nebraska","Stanton County",2,65,82,41,41
050,31,167,"Nebraska","Stanton County",2,66,82,39,43
050,31,167,"Nebraska","Stanton County",2,67,78,39,39
050,31,167,"Nebraska","Stanton County",2,68,75,35,40
050,31,167,"Nebraska","Stanton County",2,69,66,31,35
050,31,167,"Nebraska","Stanton County",2,70,59,27,32
050,31,167,"Nebraska","Stanton County",2,71,61,29,32
050,31,167,"Nebraska","Stanton County",2,72,58,29,29
050,31,167,"Nebraska","Stanton County",2,73,52,25,27
050,31,167,"Nebraska","Stanton County",2,74,36,18,18
050,31,167,"Nebraska","Stanton County",2,75,43,23,20
050,31,167,"Nebraska","Stanton County",2,76,35,18,17
050,31,167,"Nebraska","Stanton County",2,77,38,15,23
050,31,167,"Nebraska","Stanton County",2,78,36,15,21
050,31,167,"Nebraska","Stanton County",2,79,30,15,15
050,31,167,"Nebraska","Stanton County",2,80,31,16,15
050,31,167,"Nebraska","Stanton County",2,81,34,16,18
050,31,167,"Nebraska","Stanton County",2,82,35,14,21
050,31,167,"Nebraska","Stanton County",2,83,33,14,19
050,31,167,"Nebraska","Stanton County",2,84,26,9,17
050,31,167,"Nebraska","Stanton County",2,85,164,71,93
050,31,167,"Nebraska","Stanton County",3,0,72,33,39
050,31,167,"Nebraska","Stanton County",3,1,80,33,47
050,31,167,"Nebraska","Stanton County",3,2,84,40,44
050,31,167,"Nebraska","Stanton County",3,3,79,40,39
050,31,167,"Nebraska","Stanton County",3,4,67,29,38
050,31,167,"Nebraska","Stanton County",3,5,69,32,37
050,31,167,"Nebraska","Stanton County",3,6,77,37,40
050,31,167,"Nebraska","Stanton County",3,7,75,40,35
050,31,167,"Nebraska","Stanton County",3,8,66,42,24
050,31,167,"Nebraska","Stanton County",3,9,81,48,33
050,31,167,"Nebraska","Stanton County",3,10,80,43,37
050,31,167,"Nebraska","Stanton County",3,11,78,48,30
050,31,167,"Nebraska","Stanton County",3,12,79,41,38
050,31,167,"Nebraska","Stanton County",3,13,83,43,40
050,31,167,"Nebraska","Stanton County",3,14,96,50,46
050,31,167,"Nebraska","Stanton County",3,15,83,40,43
050,31,167,"Nebraska","Stanton County",3,16,72,32,40
050,31,167,"Nebraska","Stanton County",3,17,88,50,38
050,31,167,"Nebraska","Stanton County",3,18,72,39,33
050,31,167,"Nebraska","Stanton County",3,19,62,31,31
050,31,167,"Nebraska","Stanton County",3,20,62,30,32
050,31,167,"Nebraska","Stanton County",3,21,47,25,22
050,31,167,"Nebraska","Stanton County",3,22,49,25,24
050,31,167,"Nebraska","Stanton County",3,23,61,28,33
050,31,167,"Nebraska","Stanton County",3,24,60,34,26
050,31,167,"Nebraska","Stanton County",3,25,58,25,33
050,31,167,"Nebraska","Stanton County",3,26,54,28,26
050,31,167,"Nebraska","Stanton County",3,27,67,34,33
050,31,167,"Nebraska","Stanton County",3,28,60,32,28
050,31,167,"Nebraska","Stanton County",3,29,64,30,34
050,31,167,"Nebraska","Stanton County",3,30,59,29,30
050,31,167,"Nebraska","Stanton County",3,31,62,33,29
050,31,167,"Nebraska","Stanton County",3,32,66,38,28
050,31,167,"Nebraska","Stanton County",3,33,64,34,30
050,31,167,"Nebraska","Stanton County",3,34,67,36,31
050,31,167,"Nebraska","Stanton County",3,35,70,39,31
050,31,167,"Nebraska","Stanton County",3,36,66,37,29
050,31,167,"Nebraska","Stanton County",3,37,67,35,32
050,31,167,"Nebraska","Stanton County",3,38,67,35,32
050,31,167,"Nebraska","Stanton County",3,39,85,43,42
050,31,167,"Nebraska","Stanton County",3,40,74,37,37
050,31,167,"Nebraska","Stanton County",3,41,83,45,38
050,31,167,"Nebraska","Stanton County",3,42,65,39,26
050,31,167,"Nebraska","Stanton County",3,43,70,36,34
050,31,167,"Nebraska","Stanton County",3,44,66,36,30
050,31,167,"Nebraska","Stanton County",3,45,62,35,27
050,31,167,"Nebraska","Stanton County",3,46,58,31,27
050,31,167,"Nebraska","Stanton County",3,47,59,29,30
050,31,167,"Nebraska","Stanton County",3,48,54,27,27
050,31,167,"Nebraska","Stanton County",3,49,65,35,30
050,31,167,"Nebraska","Stanton County",3,50,76,40,36
050,31,167,"Nebraska","Stanton County",3,51,72,38,34
050,31,167,"Nebraska","Stanton County",3,52,65,35,30
050,31,167,"Nebraska","Stanton County",3,53,62,33,29
050,31,167,"Nebraska","Stanton County",3,54,62,33,29
050,31,167,"Nebraska","Stanton County",3,55,76,42,34
050,31,167,"Nebraska","Stanton County",3,56,78,42,36
050,31,167,"Nebraska","Stanton County",3,57,81,38,43
050,31,167,"Nebraska","Stanton County",3,58,81,36,45
050,31,167,"Nebraska","Stanton County",3,59,90,43,47
050,31,167,"Nebraska","Stanton County",3,60,98,51,47
050,31,167,"Nebraska","Stanton County",3,61,95,50,45
050,31,167,"Nebraska","Stanton County",3,62,94,51,43
050,31,167,"Nebraska","Stanton County",3,63,90,46,44
050,31,167,"Nebraska","Stanton County",3,64,87,49,38
050,31,167,"Nebraska","Stanton County",3,65,83,47,36
050,31,167,"Nebraska","Stanton County",3,66,80,40,40
050,31,167,"Nebraska","Stanton County",3,67,83,41,42
050,31,167,"Nebraska","Stanton County",3,68,77,39,38
050,31,167,"Nebraska","Stanton County",3,69,75,34,41
050,31,167,"Nebraska","Stanton County",3,70,63,30,33
050,31,167,"Nebraska","Stanton County",3,71,61,28,33
050,31,167,"Nebraska","Stanton County",3,72,59,29,30
050,31,167,"Nebraska","Stanton County",3,73,59,29,30
050,31,167,"Nebraska","Stanton County",3,74,52,25,27
050,31,167,"Nebraska","Stanton County",3,75,35,17,18
050,31,167,"Nebraska","Stanton County",3,76,40,22,18
050,31,167,"Nebraska","Stanton County",3,77,33,17,16
050,31,167,"Nebraska","Stanton County",3,78,32,14,18
050,31,167,"Nebraska","Stanton County",3,79,32,13,19
050,31,167,"Nebraska","Stanton County",3,80,31,16,15
050,31,167,"Nebraska","Stanton County",3,81,29,14,15
050,31,167,"Nebraska","Stanton County",3,82,32,16,16
050,31,167,"Nebraska","Stanton County",3,83,34,14,20
050,31,167,"Nebraska","Stanton County",3,84,30,12,18
050,31,167,"Nebraska","Stanton County",3,85,156,66,90
050,31,167,"Nebraska","Stanton County",4,0,56,28,28
050,31,167,"Nebraska","Stanton County",4,1,76,29,47
050,31,167,"Nebraska","Stanton County",4,2,79,35,44
050,31,167,"Nebraska","Stanton County",4,3,82,38,44
050,31,167,"Nebraska","Stanton County",4,4,80,40,40
050,31,167,"Nebraska","Stanton County",4,5,69,32,37
050,31,167,"Nebraska","Stanton County",4,6,70,34,36
050,31,167,"Nebraska","Stanton County",4,7,78,35,43
050,31,167,"Nebraska","Stanton County",4,8,76,39,37
050,31,167,"Nebraska","Stanton County",4,9,67,42,25
050,31,167,"Nebraska","Stanton County",4,10,77,46,31
050,31,167,"Nebraska","Stanton County",4,11,85,46,39
050,31,167,"Nebraska","Stanton County",4,12,77,47,30
050,31,167,"Nebraska","Stanton County",4,13,86,46,40
050,31,167,"Nebraska","Stanton County",4,14,89,44,45
050,31,167,"Nebraska","Stanton County",4,15,89,47,42
050,31,167,"Nebraska","Stanton County",4,16,78,39,39
050,31,167,"Nebraska","Stanton County",4,17,70,32,38
050,31,167,"Nebraska","Stanton County",4,18,73,42,31
050,31,167,"Nebraska","Stanton County",4,19,56,28,28
050,31,167,"Nebraska","Stanton County",4,20,58,28,30
050,31,167,"Nebraska","Stanton County",4,21,58,23,35
050,31,167,"Nebraska","Stanton County",4,22,46,27,19
050,31,167,"Nebraska","Stanton County",4,23,45,22,23
050,31,167,"Nebraska","Stanton County",4,24,60,29,31
050,31,167,"Nebraska","Stanton County",4,25,57,31,26
050,31,167,"Nebraska","Stanton County",4,26,59,26,33
050,31,167,"Nebraska","Stanton County",4,27,60,32,28
050,31,167,"Nebraska","Stanton County",4,28,69,34,35
050,31,167,"Nebraska","Stanton County",4,29,60,34,26
050,31,167,"Nebraska","Stanton County",4,30,65,28,37
050,31,167,"Nebraska","Stanton County",4,31,57,28,29
050,31,167,"Nebraska","Stanton County",4,32,67,36,31
050,31,167,"Nebraska","Stanton County",4,33,69,38,31
050,31,167,"Nebraska","Stanton County",4,34,63,34,29
050,31,167,"Nebraska","Stanton County",4,35,61,33,28
050,31,167,"Nebraska","Stanton County",4,36,72,43,29
050,31,167,"Nebraska","Stanton County",4,37,65,37,28
050,31,167,"Nebraska","Stanton County",4,38,62,34,28
050,31,167,"Nebraska","Stanton County",4,39,66,33,33
050,31,167,"Nebraska","Stanton County",4,40,80,38,42
050,31,167,"Nebraska","Stanton County",4,41,68,34,34
050,31,167,"Nebraska","Stanton County",4,42,86,48,38
050,31,167,"Nebraska","Stanton County",4,43,64,38,26
050,31,167,"Nebraska","Stanton County",4,44,67,36,31
050,31,167,"Nebraska","Stanton County",4,45,61,32,29
050,31,167,"Nebraska","Stanton County",4,46,58,31,27
050,31,167,"Nebraska","Stanton County",4,47,64,38,26
050,31,167,"Nebraska","Stanton County",4,48,57,28,29
050,31,167,"Nebraska","Stanton County",4,49,51,27,24
050,31,167,"Nebraska","Stanton County",4,50,64,35,29
050,31,167,"Nebraska","Stanton County",4,51,74,39,35
050,31,167,"Nebraska","Stanton County",4,52,76,40,36
050,31,167,"Nebraska","Stanton County",4,53,66,35,31
050,31,167,"Nebraska","Stanton County",4,54,62,32,30
050,31,167,"Nebraska","Stanton County",4,55,58,30,28
050,31,167,"Nebraska","Stanton County",4,56,78,43,35
050,31,167,"Nebraska","Stanton County",4,57,75,42,33
050,31,167,"Nebraska","Stanton County",4,58,78,35,43
050,31,167,"Nebraska","Stanton County",4,59,76,32,44
050,31,167,"Nebraska","Stanton County",4,60,92,45,47
050,31,167,"Nebraska","Stanton County",4,61,96,49,47
050,31,167,"Nebraska","Stanton County",4,62,92,50,42
050,31,167,"Nebraska","Stanton County",4,63,90,46,44
050,31,167,"Nebraska","Stanton County",4,64,87,45,42
050,31,167,"Nebraska","Stanton County",4,65,84,48,36
050,31,167,"Nebraska","Stanton County",4,66,83,46,37
050,31,167,"Nebraska","Stanton County",4,67,79,41,38
050,31,167,"Nebraska","Stanton County",4,68,82,39,43
050,31,167,"Nebraska","Stanton County",4,69,74,38,36
050,31,167,"Nebraska","Stanton County",4,70,75,33,42
050,31,167,"Nebraska","Stanton County",4,71,62,31,31
050,31,167,"Nebraska","Stanton County",4,72,61,29,32
050,31,167,"Nebraska","Stanton County",4,73,56,29,27
050,31,167,"Nebraska","Stanton County",4,74,58,28,30
050,31,167,"Nebraska","Stanton County",4,75,46,21,25
050,31,167,"Nebraska","Stanton County",4,76,35,17,18
050,31,167,"Nebraska","Stanton County",4,77,35,18,17
050,31,167,"Nebraska","Stanton County",4,78,34,18,16
050,31,167,"Nebraska","Stanton County",4,79,32,14,18
050,31,167,"Nebraska","Stanton County",4,80,31,14,17
050,31,167,"Nebraska","Stanton County",4,81,30,15,15
050,31,167,"Nebraska","Stanton County",4,82,24,13,11
050,31,167,"Nebraska","Stanton County",4,83,32,16,16
050,31,167,"Nebraska","Stanton County",4,84,33,13,20
050,31,167,"Nebraska","Stanton County",4,85,167,71,96
050,31,167,"Nebraska","Stanton County",5,0,62,30,32
050,31,167,"Nebraska","Stanton County",5,1,58,25,33
050,31,167,"Nebraska","Stanton County",5,2,81,33,48
050,31,167,"Nebraska","Stanton County",5,3,85,41,44
050,31,167,"Nebraska","Stanton County",5,4,81,39,42
050,31,167,"Nebraska","Stanton County",5,5,81,40,41
050,31,167,"Nebraska","Stanton County",5,6,74,34,40
050,31,167,"Nebraska","Stanton County",5,7,71,34,37
050,31,167,"Nebraska","Stanton County",5,8,76,36,40
050,31,167,"Nebraska","Stanton County",5,9,82,44,38
050,31,167,"Nebraska","Stanton County",5,10,69,45,24
050,31,167,"Nebraska","Stanton County",5,11,76,46,30
050,31,167,"Nebraska","Stanton County",5,12,85,45,40
050,31,167,"Nebraska","Stanton County",5,13,80,49,31
050,31,167,"Nebraska","Stanton County",5,14,87,45,42
050,31,167,"Nebraska","Stanton County",5,15,93,46,47
050,31,167,"Nebraska","Stanton County",5,16,92,48,44
050,31,167,"Nebraska","Stanton County",5,17,80,40,40
050,31,167,"Nebraska","Stanton County",5,18,62,30,32
050,31,167,"Nebraska","Stanton County",5,19,53,30,23
050,31,167,"Nebraska","Stanton County",5,20,59,30,29
050,31,167,"Nebraska","Stanton County",5,21,57,27,30
050,31,167,"Nebraska","Stanton County",5,22,55,21,34
050,31,167,"Nebraska","Stanton County",5,23,52,31,21
050,31,167,"Nebraska","Stanton County",5,24,50,26,24
050,31,167,"Nebraska","Stanton County",5,25,59,27,32
050,31,167,"Nebraska","Stanton County",5,26,57,33,24
050,31,167,"Nebraska","Stanton County",5,27,60,26,34
050,31,167,"Nebraska","Stanton County",5,28,63,33,30
050,31,167,"Nebraska","Stanton County",5,29,75,37,38
050,31,167,"Nebraska","Stanton County",5,30,60,31,29
050,31,167,"Nebraska","Stanton County",5,31,66,27,39
050,31,167,"Nebraska","Stanton County",5,32,59,29,30
050,31,167,"Nebraska","Stanton County",5,33,68,37,31
050,31,167,"Nebraska","Stanton County",5,34,73,41,32
050,31,167,"Nebraska","Stanton County",5,35,72,40,32
050,31,167,"Nebraska","Stanton County",5,36,58,28,30
050,31,167,"Nebraska","Stanton County",5,37,80,46,34
050,31,167,"Nebraska","Stanton County",5,38,70,40,30
050,31,167,"Nebraska","Stanton County",5,39,61,35,26
050,31,167,"Nebraska","Stanton County",5,40,65,33,32
050,31,167,"Nebraska","Stanton County",5,41,83,38,45
050,31,167,"Nebraska","Stanton County",5,42,71,35,36
050,31,167,"Nebraska","Stanton County",5,43,80,43,37
050,31,167,"Nebraska","Stanton County",5,44,63,39,24
050,31,167,"Nebraska","Stanton County",5,45,68,37,31
050,31,167,"Nebraska","Stanton County",5,46,62,32,30
050,31,167,"Nebraska","Stanton County",5,47,65,39,26
050,31,167,"Nebraska","Stanton County",5,48,62,35,27
050,31,167,"Nebraska","Stanton County",5,49,57,29,28
050,31,167,"Nebraska","Stanton County",5,50,52,28,24
050,31,167,"Nebraska","Stanton County",5,51,66,37,29
050,31,167,"Nebraska","Stanton County",5,52,75,40,35
050,31,167,"Nebraska","Stanton County",5,53,77,40,37
050,31,167,"Nebraska","Stanton County",5,54,65,35,30
050,31,167,"Nebraska","Stanton County",5,55,60,32,28
050,31,167,"Nebraska","Stanton County",5,56,58,30,28
050,31,167,"Nebraska","Stanton County",5,57,79,44,35
050,31,167,"Nebraska","Stanton County",5,58,75,41,34
050,31,167,"Nebraska","Stanton County",5,59,81,38,43
050,31,167,"Nebraska","Stanton County",5,60,75,33,42
050,31,167,"Nebraska","Stanton County",5,61,94,46,48
050,31,167,"Nebraska","Stanton County",5,62,91,45,46
050,31,167,"Nebraska","Stanton County",5,63,92,49,43
050,31,167,"Nebraska","Stanton County",5,64,90,45,45
050,31,167,"Nebraska","Stanton County",5,65,84,44,40
050,31,167,"Nebraska","Stanton County",5,66,85,48,37
050,31,167,"Nebraska","Stanton County",5,67,88,48,40
050,31,167,"Nebraska","Stanton County",5,68,79,39,40
050,31,167,"Nebraska","Stanton County",5,69,82,38,44
050,31,167,"Nebraska","Stanton County",5,70,73,37,36
050,31,167,"Nebraska","Stanton County",5,71,75,34,41
050,31,167,"Nebraska","Stanton County",5,72,57,30,27
050,31,167,"Nebraska","Stanton County",5,73,59,29,30
050,31,167,"Nebraska","Stanton County",5,74,57,29,28
050,31,167,"Nebraska","Stanton County",5,75,50,23,27
050,31,167,"Nebraska","Stanton County",5,76,46,21,25
050,31,167,"Nebraska","Stanton County",5,77,34,15,19
050,31,167,"Nebraska","Stanton County",5,78,33,18,15
050,31,167,"Nebraska","Stanton County",5,79,37,18,19
050,31,167,"Nebraska","Stanton County",5,80,31,13,18
050,31,167,"Nebraska","Stanton County",5,81,29,12,17
050,31,167,"Nebraska","Stanton County",5,82,28,14,14
050,31,167,"Nebraska","Stanton County",5,83,24,13,11
050,31,167,"Nebraska","Stanton County",5,84,30,14,16
050,31,167,"Nebraska","Stanton County",5,85,187,80,107
050,31,169,"Nebraska","Thayer County",1,0,49,25,24
050,31,169,"Nebraska","Thayer County",1,1,47,24,23
050,31,169,"Nebraska","Thayer County",1,2,48,24,24
050,31,169,"Nebraska","Thayer County",1,3,67,35,32
050,31,169,"Nebraska","Thayer County",1,4,78,41,37
050,31,169,"Nebraska","Thayer County",1,5,75,36,39
050,31,169,"Nebraska","Thayer County",1,6,70,42,28
050,31,169,"Nebraska","Thayer County",1,7,65,28,37
050,31,169,"Nebraska","Thayer County",1,8,63,33,30
050,31,169,"Nebraska","Thayer County",1,9,66,32,34
050,31,169,"Nebraska","Thayer County",1,10,72,35,37
050,31,169,"Nebraska","Thayer County",1,11,60,23,37
050,31,169,"Nebraska","Thayer County",1,12,71,35,36
050,31,169,"Nebraska","Thayer County",1,13,74,39,35
050,31,169,"Nebraska","Thayer County",1,14,71,34,37
050,31,169,"Nebraska","Thayer County",1,15,76,36,40
050,31,169,"Nebraska","Thayer County",1,16,67,30,37
050,31,169,"Nebraska","Thayer County",1,17,65,37,28
050,31,169,"Nebraska","Thayer County",1,18,53,29,24
050,31,169,"Nebraska","Thayer County",1,19,48,25,23
050,31,169,"Nebraska","Thayer County",1,20,46,24,22
050,31,169,"Nebraska","Thayer County",1,21,53,25,28
050,31,169,"Nebraska","Thayer County",1,22,50,25,25
050,31,169,"Nebraska","Thayer County",1,23,46,23,23
050,31,169,"Nebraska","Thayer County",1,24,38,19,19
050,31,169,"Nebraska","Thayer County",1,25,44,22,22
050,31,169,"Nebraska","Thayer County",1,26,44,22,22
050,31,169,"Nebraska","Thayer County",1,27,63,31,32
050,31,169,"Nebraska","Thayer County",1,28,51,27,24
050,31,169,"Nebraska","Thayer County",1,29,40,22,18
050,31,169,"Nebraska","Thayer County",1,30,45,23,22
050,31,169,"Nebraska","Thayer County",1,31,40,22,18
050,31,169,"Nebraska","Thayer County",1,32,39,20,19
050,31,169,"Nebraska","Thayer County",1,33,53,30,23
050,31,169,"Nebraska","Thayer County",1,34,45,22,23
050,31,169,"Nebraska","Thayer County",1,35,54,26,28
050,31,169,"Nebraska","Thayer County",1,36,56,29,27
050,31,169,"Nebraska","Thayer County",1,37,53,27,26
050,31,169,"Nebraska","Thayer County",1,38,48,23,25
050,31,169,"Nebraska","Thayer County",1,39,52,21,31
050,31,169,"Nebraska","Thayer County",1,40,55,33,22
050,31,169,"Nebraska","Thayer County",1,41,45,27,18
050,31,169,"Nebraska","Thayer County",1,42,47,25,22
050,31,169,"Nebraska","Thayer County",1,43,53,30,23
050,31,169,"Nebraska","Thayer County",1,44,55,32,23
050,31,169,"Nebraska","Thayer County",1,45,54,33,21
050,31,169,"Nebraska","Thayer County",1,46,55,32,23
050,31,169,"Nebraska","Thayer County",1,47,51,26,25
050,31,169,"Nebraska","Thayer County",1,48,50,27,23
050,31,169,"Nebraska","Thayer County",1,49,52,26,26
050,31,169,"Nebraska","Thayer County",1,50,57,30,27
050,31,169,"Nebraska","Thayer County",1,51,59,32,27
050,31,169,"Nebraska","Thayer County",1,52,64,29,35
050,31,169,"Nebraska","Thayer County",1,53,60,27,33
050,31,169,"Nebraska","Thayer County",1,54,63,28,35
050,31,169,"Nebraska","Thayer County",1,55,72,32,40
050,31,169,"Nebraska","Thayer County",1,56,64,32,32
050,31,169,"Nebraska","Thayer County",1,57,77,41,36
050,31,169,"Nebraska","Thayer County",1,58,73,39,34
050,31,169,"Nebraska","Thayer County",1,59,77,42,35
050,31,169,"Nebraska","Thayer County",1,60,70,39,31
050,31,169,"Nebraska","Thayer County",1,61,70,36,34
050,31,169,"Nebraska","Thayer County",1,62,78,43,35
050,31,169,"Nebraska","Thayer County",1,63,75,39,36
050,31,169,"Nebraska","Thayer County",1,64,74,36,38
050,31,169,"Nebraska","Thayer County",1,65,79,43,36
050,31,169,"Nebraska","Thayer County",1,66,77,42,35
050,31,169,"Nebraska","Thayer County",1,67,73,36,37
050,31,169,"Nebraska","Thayer County",1,68,72,32,40
050,31,169,"Nebraska","Thayer County",1,69,67,31,36
050,31,169,"Nebraska","Thayer County",1,70,71,36,35
050,31,169,"Nebraska","Thayer County",1,71,72,32,40
050,31,169,"Nebraska","Thayer County",1,72,73,38,35
050,31,169,"Nebraska","Thayer County",1,73,56,28,28
050,31,169,"Nebraska","Thayer County",1,74,46,23,23
050,31,169,"Nebraska","Thayer County",1,75,43,23,20
050,31,169,"Nebraska","Thayer County",1,76,46,20,26
050,31,169,"Nebraska","Thayer County",1,77,43,18,25
050,31,169,"Nebraska","Thayer County",1,78,34,14,20
050,31,169,"Nebraska","Thayer County",1,79,37,18,19
050,31,169,"Nebraska","Thayer County",1,80,30,13,17
050,31,169,"Nebraska","Thayer County",1,81,44,20,24
050,31,169,"Nebraska","Thayer County",1,82,31,16,15
050,31,169,"Nebraska","Thayer County",1,83,34,16,18
050,31,169,"Nebraska","Thayer County",1,84,24,9,15
050,31,169,"Nebraska","Thayer County",1,85,186,67,119
050,31,169,"Nebraska","Thayer County",2,0,46,21,25
050,31,169,"Nebraska","Thayer County",2,1,48,24,24
050,31,169,"Nebraska","Thayer County",2,2,48,25,23
050,31,169,"Nebraska","Thayer County",2,3,64,33,31
050,31,169,"Nebraska","Thayer County",2,4,77,40,37
050,31,169,"Nebraska","Thayer County",2,5,74,37,37
050,31,169,"Nebraska","Thayer County",2,6,70,40,30
050,31,169,"Nebraska","Thayer County",2,7,66,31,35
050,31,169,"Nebraska","Thayer County",2,8,63,32,31
050,31,169,"Nebraska","Thayer County",2,9,65,32,33
050,31,169,"Nebraska","Thayer County",2,10,72,35,37
050,31,169,"Nebraska","Thayer County",2,11,63,26,37
050,31,169,"Nebraska","Thayer County",2,12,71,34,37
050,31,169,"Nebraska","Thayer County",2,13,72,38,34
050,31,169,"Nebraska","Thayer County",2,14,71,34,37
050,31,169,"Nebraska","Thayer County",2,15,73,34,39
050,31,169,"Nebraska","Thayer County",2,16,68,32,36
050,31,169,"Nebraska","Thayer County",2,17,64,34,30
050,31,169,"Nebraska","Thayer County",2,18,52,29,23
050,31,169,"Nebraska","Thayer County",2,19,47,24,23
050,31,169,"Nebraska","Thayer County",2,20,48,24,24
050,31,169,"Nebraska","Thayer County",2,21,54,27,27
050,31,169,"Nebraska","Thayer County",2,22,50,25,25
050,31,169,"Nebraska","Thayer County",2,23,46,23,23
050,31,169,"Nebraska","Thayer County",2,24,38,19,19
050,31,169,"Nebraska","Thayer County",2,25,42,21,21
050,31,169,"Nebraska","Thayer County",2,26,46,23,23
050,31,169,"Nebraska","Thayer County",2,27,56,27,29
050,31,169,"Nebraska","Thayer County",2,28,53,27,26
050,31,169,"Nebraska","Thayer County",2,29,41,23,18
050,31,169,"Nebraska","Thayer County",2,30,44,23,21
050,31,169,"Nebraska","Thayer County",2,31,42,23,19
050,31,169,"Nebraska","Thayer County",2,32,40,21,19
050,31,169,"Nebraska","Thayer County",2,33,49,27,22
050,31,169,"Nebraska","Thayer County",2,34,47,24,23
050,31,169,"Nebraska","Thayer County",2,35,52,25,27
050,31,169,"Nebraska","Thayer County",2,36,55,28,27
050,31,169,"Nebraska","Thayer County",2,37,54,28,26
050,31,169,"Nebraska","Thayer County",2,38,50,24,26
050,31,169,"Nebraska","Thayer County",2,39,51,22,29
050,31,169,"Nebraska","Thayer County",2,40,55,30,25
050,31,169,"Nebraska","Thayer County",2,41,47,28,19
050,31,169,"Nebraska","Thayer County",2,42,45,24,21
050,31,169,"Nebraska","Thayer County",2,43,52,29,23
050,31,169,"Nebraska","Thayer County",2,44,54,31,23
050,31,169,"Nebraska","Thayer County",2,45,55,33,22
050,31,169,"Nebraska","Thayer County",2,46,56,32,24
050,31,169,"Nebraska","Thayer County",2,47,51,27,24
050,31,169,"Nebraska","Thayer County",2,48,50,27,23
050,31,169,"Nebraska","Thayer County",2,49,52,27,25
050,31,169,"Nebraska","Thayer County",2,50,57,30,27
050,31,169,"Nebraska","Thayer County",2,51,58,31,27
050,31,169,"Nebraska","Thayer County",2,52,61,29,32
050,31,169,"Nebraska","Thayer County",2,53,61,28,33
050,31,169,"Nebraska","Thayer County",2,54,62,28,34
050,31,169,"Nebraska","Thayer County",2,55,72,32,40
050,31,169,"Nebraska","Thayer County",2,56,67,33,34
050,31,169,"Nebraska","Thayer County",2,57,74,39,35
050,31,169,"Nebraska","Thayer County",2,58,73,39,34
050,31,169,"Nebraska","Thayer County",2,59,76,41,35
050,31,169,"Nebraska","Thayer County",2,60,72,40,32
050,31,169,"Nebraska","Thayer County",2,61,70,37,33
050,31,169,"Nebraska","Thayer County",2,62,75,41,34
050,31,169,"Nebraska","Thayer County",2,63,78,42,36
050,31,169,"Nebraska","Thayer County",2,64,74,36,38
050,31,169,"Nebraska","Thayer County",2,65,78,41,37
050,31,169,"Nebraska","Thayer County",2,66,78,43,35
050,31,169,"Nebraska","Thayer County",2,67,73,37,36
050,31,169,"Nebraska","Thayer County",2,68,71,32,39
050,31,169,"Nebraska","Thayer County",2,69,70,32,38
050,31,169,"Nebraska","Thayer County",2,70,68,34,34
050,31,169,"Nebraska","Thayer County",2,71,72,33,39
050,31,169,"Nebraska","Thayer County",2,72,72,36,36
050,31,169,"Nebraska","Thayer County",2,73,63,32,31
050,31,169,"Nebraska","Thayer County",2,74,45,23,22
050,31,169,"Nebraska","Thayer County",2,75,42,22,20
050,31,169,"Nebraska","Thayer County",2,76,44,20,24
050,31,169,"Nebraska","Thayer County",2,77,45,19,26
050,31,169,"Nebraska","Thayer County",2,78,36,15,21
050,31,169,"Nebraska","Thayer County",2,79,36,16,20
050,31,169,"Nebraska","Thayer County",2,80,31,14,17
050,31,169,"Nebraska","Thayer County",2,81,42,19,23
050,31,169,"Nebraska","Thayer County",2,82,33,16,17
050,31,169,"Nebraska","Thayer County",2,83,33,16,17
050,31,169,"Nebraska","Thayer County",2,84,25,11,14
050,31,169,"Nebraska","Thayer County",2,85,184,65,119
050,31,169,"Nebraska","Thayer County",3,0,47,22,25
050,31,169,"Nebraska","Thayer County",3,1,42,17,25
050,31,169,"Nebraska","Thayer County",3,2,44,22,22
050,31,169,"Nebraska","Thayer County",3,3,45,24,21
050,31,169,"Nebraska","Thayer County",3,4,53,26,27
050,31,169,"Nebraska","Thayer County",3,5,76,42,34
050,31,169,"Nebraska","Thayer County",3,6,69,32,37
050,31,169,"Nebraska","Thayer County",3,7,71,38,33
050,31,169,"Nebraska","Thayer County",3,8,68,33,35
050,31,169,"Nebraska","Thayer County",3,9,62,31,31
050,31,169,"Nebraska","Thayer County",3,10,65,33,32
050,31,169,"Nebraska","Thayer County",3,11,72,35,37
050,31,169,"Nebraska","Thayer County",3,12,59,26,33
050,31,169,"Nebraska","Thayer County",3,13,70,33,37
050,31,169,"Nebraska","Thayer County",3,14,71,39,32
050,31,169,"Nebraska","Thayer County",3,15,68,34,34
050,31,169,"Nebraska","Thayer County",3,16,69,30,39
050,31,169,"Nebraska","Thayer County",3,17,66,29,37
050,31,169,"Nebraska","Thayer County",3,18,51,29,22
050,31,169,"Nebraska","Thayer County",3,19,43,23,20
050,31,169,"Nebraska","Thayer County",3,20,52,28,24
050,31,169,"Nebraska","Thayer County",3,21,47,20,27
050,31,169,"Nebraska","Thayer County",3,22,52,28,24
050,31,169,"Nebraska","Thayer County",3,23,48,23,25
050,31,169,"Nebraska","Thayer County",3,24,41,21,20
050,31,169,"Nebraska","Thayer County",3,25,42,24,18
050,31,169,"Nebraska","Thayer County",3,26,40,19,21
050,31,169,"Nebraska","Thayer County",3,27,39,18,21
050,31,169,"Nebraska","Thayer County",3,28,55,28,27
050,31,169,"Nebraska","Thayer County",3,29,46,26,20
050,31,169,"Nebraska","Thayer County",3,30,51,27,24
050,31,169,"Nebraska","Thayer County",3,31,47,25,22
050,31,169,"Nebraska","Thayer County",3,32,45,26,19
050,31,169,"Nebraska","Thayer County",3,33,41,23,18
050,31,169,"Nebraska","Thayer County",3,34,48,25,23
050,31,169,"Nebraska","Thayer County",3,35,44,21,23
050,31,169,"Nebraska","Thayer County",3,36,52,25,27
050,31,169,"Nebraska","Thayer County",3,37,54,29,25
050,31,169,"Nebraska","Thayer County",3,38,56,29,27
050,31,169,"Nebraska","Thayer County",3,39,50,24,26
050,31,169,"Nebraska","Thayer County",3,40,50,20,30
050,31,169,"Nebraska","Thayer County",3,41,55,29,26
050,31,169,"Nebraska","Thayer County",3,42,48,29,19
050,31,169,"Nebraska","Thayer County",3,43,45,27,18
050,31,169,"Nebraska","Thayer County",3,44,51,29,22
050,31,169,"Nebraska","Thayer County",3,45,52,30,22
050,31,169,"Nebraska","Thayer County",3,46,56,34,22
050,31,169,"Nebraska","Thayer County",3,47,56,31,25
050,31,169,"Nebraska","Thayer County",3,48,52,27,25
050,31,169,"Nebraska","Thayer County",3,49,50,27,23
050,31,169,"Nebraska","Thayer County",3,50,54,27,27
050,31,169,"Nebraska","Thayer County",3,51,59,30,29
050,31,169,"Nebraska","Thayer County",3,52,57,32,25
050,31,169,"Nebraska","Thayer County",3,53,62,29,33
050,31,169,"Nebraska","Thayer County",3,54,62,29,33
050,31,169,"Nebraska","Thayer County",3,55,63,28,35
050,31,169,"Nebraska","Thayer County",3,56,74,34,40
050,31,169,"Nebraska","Thayer County",3,57,63,29,34
050,31,169,"Nebraska","Thayer County",3,58,76,41,35
050,31,169,"Nebraska","Thayer County",3,59,73,39,34
050,31,169,"Nebraska","Thayer County",3,60,76,41,35
050,31,169,"Nebraska","Thayer County",3,61,72,40,32
050,31,169,"Nebraska","Thayer County",3,62,65,36,29
050,31,169,"Nebraska","Thayer County",3,63,79,44,35
050,31,169,"Nebraska","Thayer County",3,64,77,40,37
050,31,169,"Nebraska","Thayer County",3,65,70,34,36
050,31,169,"Nebraska","Thayer County",3,66,75,40,35
050,31,169,"Nebraska","Thayer County",3,67,77,42,35
050,31,169,"Nebraska","Thayer County",3,68,68,34,34
050,31,169,"Nebraska","Thayer County",3,69,72,32,40
050,31,169,"Nebraska","Thayer County",3,70,63,28,35
050,31,169,"Nebraska","Thayer County",3,71,64,32,32
050,31,169,"Nebraska","Thayer County",3,72,70,34,36
050,31,169,"Nebraska","Thayer County",3,73,73,35,38
050,31,169,"Nebraska","Thayer County",3,74,57,28,29
050,31,169,"Nebraska","Thayer County",3,75,41,20,21
050,31,169,"Nebraska","Thayer County",3,76,35,19,16
050,31,169,"Nebraska","Thayer County",3,77,40,20,20
050,31,169,"Nebraska","Thayer County",3,78,43,18,25
050,31,169,"Nebraska","Thayer County",3,79,34,14,20
050,31,169,"Nebraska","Thayer County",3,80,30,15,15
050,31,169,"Nebraska","Thayer County",3,81,33,16,17
050,31,169,"Nebraska","Thayer County",3,82,33,14,19
050,31,169,"Nebraska","Thayer County",3,83,33,17,16
050,31,169,"Nebraska","Thayer County",3,84,28,15,13
050,31,169,"Nebraska","Thayer County",3,85,161,55,106
050,31,169,"Nebraska","Thayer County",4,0,52,26,26
050,31,169,"Nebraska","Thayer County",4,1,49,24,25
050,31,169,"Nebraska","Thayer County",4,2,45,19,26
050,31,169,"Nebraska","Thayer County",4,3,46,21,25
050,31,169,"Nebraska","Thayer County",4,4,46,23,23
050,31,169,"Nebraska","Thayer County",4,5,59,29,30
050,31,169,"Nebraska","Thayer County",4,6,76,40,36
050,31,169,"Nebraska","Thayer County",4,7,69,32,37
050,31,169,"Nebraska","Thayer County",4,8,69,39,30
050,31,169,"Nebraska","Thayer County",4,9,66,31,35
050,31,169,"Nebraska","Thayer County",4,10,59,32,27
050,31,169,"Nebraska","Thayer County",4,11,68,31,37
050,31,169,"Nebraska","Thayer County",4,12,75,36,39
050,31,169,"Nebraska","Thayer County",4,13,59,26,33
050,31,169,"Nebraska","Thayer County",4,14,71,33,38
050,31,169,"Nebraska","Thayer County",4,15,65,35,30
050,31,169,"Nebraska","Thayer County",4,16,68,33,35
050,31,169,"Nebraska","Thayer County",4,17,69,32,37
050,31,169,"Nebraska","Thayer County",4,18,51,25,26
050,31,169,"Nebraska","Thayer County",4,19,39,24,15
050,31,169,"Nebraska","Thayer County",4,20,41,24,17
050,31,169,"Nebraska","Thayer County",4,21,54,28,26
050,31,169,"Nebraska","Thayer County",4,22,52,21,31
050,31,169,"Nebraska","Thayer County",4,23,50,24,26
050,31,169,"Nebraska","Thayer County",4,24,51,25,26
050,31,169,"Nebraska","Thayer County",4,25,38,20,18
050,31,169,"Nebraska","Thayer County",4,26,48,27,21
050,31,169,"Nebraska","Thayer County",4,27,35,16,19
050,31,169,"Nebraska","Thayer County",4,28,41,21,20
050,31,169,"Nebraska","Thayer County",4,29,50,25,25
050,31,169,"Nebraska","Thayer County",4,30,52,28,24
050,31,169,"Nebraska","Thayer County",4,31,51,27,24
050,31,169,"Nebraska","Thayer County",4,32,51,25,26
050,31,169,"Nebraska","Thayer County",4,33,43,25,18
050,31,169,"Nebraska","Thayer County",4,34,42,23,19
050,31,169,"Nebraska","Thayer County",4,35,47,22,25
050,31,169,"Nebraska","Thayer County",4,36,42,20,22
050,31,169,"Nebraska","Thayer County",4,37,53,26,27
050,31,169,"Nebraska","Thayer County",4,38,57,30,27
050,31,169,"Nebraska","Thayer County",4,39,53,25,28
050,31,169,"Nebraska","Thayer County",4,40,53,27,26
050,31,169,"Nebraska","Thayer County",4,41,46,21,25
050,31,169,"Nebraska","Thayer County",4,42,54,28,26
050,31,169,"Nebraska","Thayer County",4,43,49,30,19
050,31,169,"Nebraska","Thayer County",4,44,46,27,19
050,31,169,"Nebraska","Thayer County",4,45,51,29,22
050,31,169,"Nebraska","Thayer County",4,46,46,26,20
050,31,169,"Nebraska","Thayer County",4,47,54,33,21
050,31,169,"Nebraska","Thayer County",4,48,55,30,25
050,31,169,"Nebraska","Thayer County",4,49,53,27,26
050,31,169,"Nebraska","Thayer County",4,50,54,27,27
050,31,169,"Nebraska","Thayer County",4,51,55,27,28
050,31,169,"Nebraska","Thayer County",4,52,63,33,30
050,31,169,"Nebraska","Thayer County",4,53,60,34,26
050,31,169,"Nebraska","Thayer County",4,54,60,30,30
050,31,169,"Nebraska","Thayer County",4,55,66,30,36
050,31,169,"Nebraska","Thayer County",4,56,61,29,32
050,31,169,"Nebraska","Thayer County",4,57,73,33,40
050,31,169,"Nebraska","Thayer County",4,58,65,29,36
050,31,169,"Nebraska","Thayer County",4,59,76,42,34
050,31,169,"Nebraska","Thayer County",4,60,75,40,35
050,31,169,"Nebraska","Thayer County",4,61,77,42,35
050,31,169,"Nebraska","Thayer County",4,62,69,37,32
050,31,169,"Nebraska","Thayer County",4,63,66,38,28
050,31,169,"Nebraska","Thayer County",4,64,76,40,36
050,31,169,"Nebraska","Thayer County",4,65,74,38,36
050,31,169,"Nebraska","Thayer County",4,66,70,36,34
050,31,169,"Nebraska","Thayer County",4,67,75,37,38
050,31,169,"Nebraska","Thayer County",4,68,77,43,34
050,31,169,"Nebraska","Thayer County",4,69,73,37,36
050,31,169,"Nebraska","Thayer County",4,70,67,30,37
050,31,169,"Nebraska","Thayer County",4,71,61,27,34
050,31,169,"Nebraska","Thayer County",4,72,64,33,31
050,31,169,"Nebraska","Thayer County",4,73,72,36,36
050,31,169,"Nebraska","Thayer County",4,74,65,29,36
050,31,169,"Nebraska","Thayer County",4,75,55,26,29
050,31,169,"Nebraska","Thayer County",4,76,38,18,20
050,31,169,"Nebraska","Thayer County",4,77,35,21,14
050,31,169,"Nebraska","Thayer County",4,78,34,18,16
050,31,169,"Nebraska","Thayer County",4,79,39,15,24
050,31,169,"Nebraska","Thayer County",4,80,30,13,17
050,31,169,"Nebraska","Thayer County",4,81,33,17,16
050,31,169,"Nebraska","Thayer County",4,82,27,11,16
050,31,169,"Nebraska","Thayer County",4,83,30,13,17
050,31,169,"Nebraska","Thayer County",4,84,28,14,14
050,31,169,"Nebraska","Thayer County",4,85,152,53,99
050,31,169,"Nebraska","Thayer County",5,0,50,25,25
050,31,169,"Nebraska","Thayer County",5,1,51,28,23
050,31,169,"Nebraska","Thayer County",5,2,48,24,24
050,31,169,"Nebraska","Thayer County",5,3,46,19,27
050,31,169,"Nebraska","Thayer County",5,4,48,24,24
050,31,169,"Nebraska","Thayer County",5,5,48,27,21
050,31,169,"Nebraska","Thayer County",5,6,63,30,33
050,31,169,"Nebraska","Thayer County",5,7,75,41,34
050,31,169,"Nebraska","Thayer County",5,8,65,32,33
050,31,169,"Nebraska","Thayer County",5,9,73,39,34
050,31,169,"Nebraska","Thayer County",5,10,70,32,38
050,31,169,"Nebraska","Thayer County",5,11,67,37,30
050,31,169,"Nebraska","Thayer County",5,12,64,28,36
050,31,169,"Nebraska","Thayer County",5,13,79,41,38
050,31,169,"Nebraska","Thayer County",5,14,62,28,34
050,31,169,"Nebraska","Thayer County",5,15,69,33,36
050,31,169,"Nebraska","Thayer County",5,16,66,35,31
050,31,169,"Nebraska","Thayer County",5,17,65,31,34
050,31,169,"Nebraska","Thayer County",5,18,56,26,30
050,31,169,"Nebraska","Thayer County",5,19,44,23,21
050,31,169,"Nebraska","Thayer County",5,20,49,31,18
050,31,169,"Nebraska","Thayer County",5,21,36,21,15
050,31,169,"Nebraska","Thayer County",5,22,54,31,23
050,31,169,"Nebraska","Thayer County",5,23,55,21,34
050,31,169,"Nebraska","Thayer County",5,24,42,21,21
050,31,169,"Nebraska","Thayer County",5,25,45,21,24
050,31,169,"Nebraska","Thayer County",5,26,40,19,21
050,31,169,"Nebraska","Thayer County",5,27,48,25,23
050,31,169,"Nebraska","Thayer County",5,28,34,16,18
050,31,169,"Nebraska","Thayer County",5,29,35,16,19
050,31,169,"Nebraska","Thayer County",5,30,54,26,28
050,31,169,"Nebraska","Thayer County",5,31,50,27,23
050,31,169,"Nebraska","Thayer County",5,32,52,29,23
050,31,169,"Nebraska","Thayer County",5,33,52,26,26
050,31,169,"Nebraska","Thayer County",5,34,44,25,19
050,31,169,"Nebraska","Thayer County",5,35,43,22,21
050,31,169,"Nebraska","Thayer County",5,36,49,23,26
050,31,169,"Nebraska","Thayer County",5,37,43,20,23
050,31,169,"Nebraska","Thayer County",5,38,55,28,27
050,31,169,"Nebraska","Thayer County",5,39,58,31,27
050,31,169,"Nebraska","Thayer County",5,40,52,23,29
050,31,169,"Nebraska","Thayer County",5,41,53,27,26
050,31,169,"Nebraska","Thayer County",5,42,48,25,23
050,31,169,"Nebraska","Thayer County",5,43,57,33,24
050,31,169,"Nebraska","Thayer County",5,44,48,28,20
050,31,169,"Nebraska","Thayer County",5,45,46,27,19
050,31,169,"Nebraska","Thayer County",5,46,47,26,21
050,31,169,"Nebraska","Thayer County",5,47,46,26,20
050,31,169,"Nebraska","Thayer County",5,48,52,30,22
050,31,169,"Nebraska","Thayer County",5,49,54,30,24
050,31,169,"Nebraska","Thayer County",5,50,55,28,27
050,31,169,"Nebraska","Thayer County",5,51,55,26,29
050,31,169,"Nebraska","Thayer County",5,52,56,28,28
050,31,169,"Nebraska","Thayer County",5,53,62,32,30
050,31,169,"Nebraska","Thayer County",5,54,62,33,29
050,31,169,"Nebraska","Thayer County",5,55,59,29,30
050,31,169,"Nebraska","Thayer County",5,56,67,33,34
050,31,169,"Nebraska","Thayer County",5,57,58,26,32
050,31,169,"Nebraska","Thayer County",5,58,75,33,42
050,31,169,"Nebraska","Thayer County",5,59,65,29,36
050,31,169,"Nebraska","Thayer County",5,60,75,43,32
050,31,169,"Nebraska","Thayer County",5,61,78,41,37
050,31,169,"Nebraska","Thayer County",5,62,76,41,35
050,31,169,"Nebraska","Thayer County",5,63,69,38,31
050,31,169,"Nebraska","Thayer County",5,64,62,34,28
050,31,169,"Nebraska","Thayer County",5,65,71,37,34
050,31,169,"Nebraska","Thayer County",5,66,74,39,35
050,31,169,"Nebraska","Thayer County",5,67,70,35,35
050,31,169,"Nebraska","Thayer County",5,68,76,38,38
050,31,169,"Nebraska","Thayer County",5,69,81,44,37
050,31,169,"Nebraska","Thayer County",5,70,67,35,32
050,31,169,"Nebraska","Thayer County",5,71,67,30,37
050,31,169,"Nebraska","Thayer County",5,72,62,28,34
050,31,169,"Nebraska","Thayer County",5,73,66,34,32
050,31,169,"Nebraska","Thayer County",5,74,66,32,34
050,31,169,"Nebraska","Thayer County",5,75,64,30,34
050,31,169,"Nebraska","Thayer County",5,76,50,23,27
050,31,169,"Nebraska","Thayer County",5,77,37,18,19
050,31,169,"Nebraska","Thayer County",5,78,29,18,11
050,31,169,"Nebraska","Thayer County",5,79,32,16,16
050,31,169,"Nebraska","Thayer County",5,80,36,14,22
050,31,169,"Nebraska","Thayer County",5,81,30,14,16
050,31,169,"Nebraska","Thayer County",5,82,26,12,14
050,31,169,"Nebraska","Thayer County",5,83,24,11,13
050,31,169,"Nebraska","Thayer County",5,84,26,10,16
050,31,169,"Nebraska","Thayer County",5,85,151,53,98
050,31,171,"Nebraska","Thomas County",1,0,6,3,3
050,31,171,"Nebraska","Thomas County",1,1,6,3,3
050,31,171,"Nebraska","Thomas County",1,2,9,4,5
050,31,171,"Nebraska","Thomas County",1,3,8,4,4
050,31,171,"Nebraska","Thomas County",1,4,5,3,2
050,31,171,"Nebraska","Thomas County",1,5,8,3,5
050,31,171,"Nebraska","Thomas County",1,6,9,2,7
050,31,171,"Nebraska","Thomas County",1,7,5,3,2
050,31,171,"Nebraska","Thomas County",1,8,11,5,6
050,31,171,"Nebraska","Thomas County",1,9,17,10,7
050,31,171,"Nebraska","Thomas County",1,10,9,6,3
050,31,171,"Nebraska","Thomas County",1,11,11,6,5
050,31,171,"Nebraska","Thomas County",1,12,9,4,5
050,31,171,"Nebraska","Thomas County",1,13,14,8,6
050,31,171,"Nebraska","Thomas County",1,14,5,2,3
050,31,171,"Nebraska","Thomas County",1,15,10,4,6
050,31,171,"Nebraska","Thomas County",1,16,10,6,4
050,31,171,"Nebraska","Thomas County",1,17,10,7,3
050,31,171,"Nebraska","Thomas County",1,18,6,5,1
050,31,171,"Nebraska","Thomas County",1,19,7,5,2
050,31,171,"Nebraska","Thomas County",1,20,4,3,1
050,31,171,"Nebraska","Thomas County",1,21,5,3,2
050,31,171,"Nebraska","Thomas County",1,22,8,6,2
050,31,171,"Nebraska","Thomas County",1,23,6,4,2
050,31,171,"Nebraska","Thomas County",1,24,6,3,3
050,31,171,"Nebraska","Thomas County",1,25,2,0,2
050,31,171,"Nebraska","Thomas County",1,26,4,2,2
050,31,171,"Nebraska","Thomas County",1,27,7,4,3
050,31,171,"Nebraska","Thomas County",1,28,7,4,3
050,31,171,"Nebraska","Thomas County",1,29,4,2,2
050,31,171,"Nebraska","Thomas County",1,30,9,3,6
050,31,171,"Nebraska","Thomas County",1,31,7,4,3
050,31,171,"Nebraska","Thomas County",1,32,7,4,3
050,31,171,"Nebraska","Thomas County",1,33,9,5,4
050,31,171,"Nebraska","Thomas County",1,34,11,6,5
050,31,171,"Nebraska","Thomas County",1,35,6,3,3
050,31,171,"Nebraska","Thomas County",1,36,5,2,3
050,31,171,"Nebraska","Thomas County",1,37,5,4,1
050,31,171,"Nebraska","Thomas County",1,38,4,3,1
050,31,171,"Nebraska","Thomas County",1,39,8,5,3
050,31,171,"Nebraska","Thomas County",1,40,8,3,5
050,31,171,"Nebraska","Thomas County",1,41,4,1,3
050,31,171,"Nebraska","Thomas County",1,42,7,3,4
050,31,171,"Nebraska","Thomas County",1,43,8,5,3
050,31,171,"Nebraska","Thomas County",1,44,6,3,3
050,31,171,"Nebraska","Thomas County",1,45,10,3,7
050,31,171,"Nebraska","Thomas County",1,46,8,3,5
050,31,171,"Nebraska","Thomas County",1,47,9,6,3
050,31,171,"Nebraska","Thomas County",1,48,8,4,4
050,31,171,"Nebraska","Thomas County",1,49,4,1,3
050,31,171,"Nebraska","Thomas County",1,50,7,4,3
050,31,171,"Nebraska","Thomas County",1,51,6,5,1
050,31,171,"Nebraska","Thomas County",1,52,7,3,4
050,31,171,"Nebraska","Thomas County",1,53,8,3,5
050,31,171,"Nebraska","Thomas County",1,54,10,5,5
050,31,171,"Nebraska","Thomas County",1,55,7,4,3
050,31,171,"Nebraska","Thomas County",1,56,8,4,4
050,31,171,"Nebraska","Thomas County",1,57,6,2,4
050,31,171,"Nebraska","Thomas County",1,58,7,4,3
050,31,171,"Nebraska","Thomas County",1,59,7,4,3
050,31,171,"Nebraska","Thomas County",1,60,5,2,3
050,31,171,"Nebraska","Thomas County",1,61,6,2,4
050,31,171,"Nebraska","Thomas County",1,62,9,5,4
050,31,171,"Nebraska","Thomas County",1,63,10,5,5
050,31,171,"Nebraska","Thomas County",1,64,16,8,8
050,31,171,"Nebraska","Thomas County",1,65,15,6,9
050,31,171,"Nebraska","Thomas County",1,66,11,7,4
050,31,171,"Nebraska","Thomas County",1,67,16,10,6
050,31,171,"Nebraska","Thomas County",1,68,14,6,8
050,31,171,"Nebraska","Thomas County",1,69,13,9,4
050,31,171,"Nebraska","Thomas County",1,70,10,6,4
050,31,171,"Nebraska","Thomas County",1,71,8,3,5
050,31,171,"Nebraska","Thomas County",1,72,6,3,3
050,31,171,"Nebraska","Thomas County",1,73,6,2,4
050,31,171,"Nebraska","Thomas County",1,74,8,3,5
050,31,171,"Nebraska","Thomas County",1,75,7,3,4
050,31,171,"Nebraska","Thomas County",1,76,9,4,5
050,31,171,"Nebraska","Thomas County",1,77,7,3,4
050,31,171,"Nebraska","Thomas County",1,78,6,3,3
050,31,171,"Nebraska","Thomas County",1,79,6,4,2
050,31,171,"Nebraska","Thomas County",1,80,4,2,2
050,31,171,"Nebraska","Thomas County",1,81,4,2,2
050,31,171,"Nebraska","Thomas County",1,82,5,3,2
050,31,171,"Nebraska","Thomas County",1,83,2,2,0
050,31,171,"Nebraska","Thomas County",1,84,2,1,1
050,31,171,"Nebraska","Thomas County",1,85,20,5,15
050,31,171,"Nebraska","Thomas County",2,0,6,2,4
050,31,171,"Nebraska","Thomas County",2,1,6,3,3
050,31,171,"Nebraska","Thomas County",2,2,9,4,5
050,31,171,"Nebraska","Thomas County",2,3,8,4,4
050,31,171,"Nebraska","Thomas County",2,4,6,3,3
050,31,171,"Nebraska","Thomas County",2,5,8,3,5
050,31,171,"Nebraska","Thomas County",2,6,9,2,7
050,31,171,"Nebraska","Thomas County",2,7,6,3,3
050,31,171,"Nebraska","Thomas County",2,8,11,6,5
050,31,171,"Nebraska","Thomas County",2,9,15,9,6
050,31,171,"Nebraska","Thomas County",2,10,10,7,3
050,31,171,"Nebraska","Thomas County",2,11,11,6,5
050,31,171,"Nebraska","Thomas County",2,12,10,5,5
050,31,171,"Nebraska","Thomas County",2,13,12,7,5
050,31,171,"Nebraska","Thomas County",2,14,7,3,4
050,31,171,"Nebraska","Thomas County",2,15,10,4,6
050,31,171,"Nebraska","Thomas County",2,16,9,5,4
050,31,171,"Nebraska","Thomas County",2,17,10,7,3
050,31,171,"Nebraska","Thomas County",2,18,6,5,1
050,31,171,"Nebraska","Thomas County",2,19,7,5,2
050,31,171,"Nebraska","Thomas County",2,20,4,3,1
050,31,171,"Nebraska","Thomas County",2,21,5,3,2
050,31,171,"Nebraska","Thomas County",2,22,8,6,2
050,31,171,"Nebraska","Thomas County",2,23,6,4,2
050,31,171,"Nebraska","Thomas County",2,24,5,2,3
050,31,171,"Nebraska","Thomas County",2,25,3,1,2
050,31,171,"Nebraska","Thomas County",2,26,4,2,2
050,31,171,"Nebraska","Thomas County",2,27,7,4,3
050,31,171,"Nebraska","Thomas County",2,28,7,4,3
050,31,171,"Nebraska","Thomas County",2,29,4,2,2
050,31,171,"Nebraska","Thomas County",2,30,8,3,5
050,31,171,"Nebraska","Thomas County",2,31,6,3,3
050,31,171,"Nebraska","Thomas County",2,32,7,4,3
050,31,171,"Nebraska","Thomas County",2,33,9,5,4
050,31,171,"Nebraska","Thomas County",2,34,11,6,5
050,31,171,"Nebraska","Thomas County",2,35,7,4,3
050,31,171,"Nebraska","Thomas County",2,36,5,2,3
050,31,171,"Nebraska","Thomas County",2,37,6,4,2
050,31,171,"Nebraska","Thomas County",2,38,5,4,1
050,31,171,"Nebraska","Thomas County",2,39,7,5,2
050,31,171,"Nebraska","Thomas County",2,40,8,3,5
050,31,171,"Nebraska","Thomas County",2,41,5,2,3
050,31,171,"Nebraska","Thomas County",2,42,6,2,4
050,31,171,"Nebraska","Thomas County",2,43,9,5,4
050,31,171,"Nebraska","Thomas County",2,44,6,3,3
050,31,171,"Nebraska","Thomas County",2,45,10,3,7
050,31,171,"Nebraska","Thomas County",2,46,10,4,6
050,31,171,"Nebraska","Thomas County",2,47,8,5,3
050,31,171,"Nebraska","Thomas County",2,48,8,4,4
050,31,171,"Nebraska","Thomas County",2,49,5,2,3
050,31,171,"Nebraska","Thomas County",2,50,7,4,3
050,31,171,"Nebraska","Thomas County",2,51,7,5,2
050,31,171,"Nebraska","Thomas County",2,52,6,3,3
050,31,171,"Nebraska","Thomas County",2,53,8,3,5
050,31,171,"Nebraska","Thomas County",2,54,9,4,5
050,31,171,"Nebraska","Thomas County",2,55,7,4,3
050,31,171,"Nebraska","Thomas County",2,56,8,4,4
050,31,171,"Nebraska","Thomas County",2,57,6,2,4
050,31,171,"Nebraska","Thomas County",2,58,7,4,3
050,31,171,"Nebraska","Thomas County",2,59,7,4,3
050,31,171,"Nebraska","Thomas County",2,60,5,2,3
050,31,171,"Nebraska","Thomas County",2,61,6,2,4
050,31,171,"Nebraska","Thomas County",2,62,8,4,4
050,31,171,"Nebraska","Thomas County",2,63,10,5,5
050,31,171,"Nebraska","Thomas County",2,64,14,7,7
050,31,171,"Nebraska","Thomas County",2,65,16,7,9
050,31,171,"Nebraska","Thomas County",2,66,13,7,6
050,31,171,"Nebraska","Thomas County",2,67,16,10,6
050,31,171,"Nebraska","Thomas County",2,68,14,7,7
050,31,171,"Nebraska","Thomas County",2,69,13,8,5
050,31,171,"Nebraska","Thomas County",2,70,10,6,4
050,31,171,"Nebraska","Thomas County",2,71,9,4,5
050,31,171,"Nebraska","Thomas County",2,72,6,3,3
050,31,171,"Nebraska","Thomas County",2,73,6,2,4
050,31,171,"Nebraska","Thomas County",2,74,7,3,4
050,31,171,"Nebraska","Thomas County",2,75,7,3,4
050,31,171,"Nebraska","Thomas County",2,76,9,4,5
050,31,171,"Nebraska","Thomas County",2,77,7,3,4
050,31,171,"Nebraska","Thomas County",2,78,6,3,3
050,31,171,"Nebraska","Thomas County",2,79,6,4,2
050,31,171,"Nebraska","Thomas County",2,80,4,2,2
050,31,171,"Nebraska","Thomas County",2,81,4,2,2
050,31,171,"Nebraska","Thomas County",2,82,5,3,2
050,31,171,"Nebraska","Thomas County",2,83,2,2,0
050,31,171,"Nebraska","Thomas County",2,84,2,1,1
050,31,171,"Nebraska","Thomas County",2,85,19,4,15
050,31,171,"Nebraska","Thomas County",3,0,7,4,3
050,31,171,"Nebraska","Thomas County",3,1,6,2,4
050,31,171,"Nebraska","Thomas County",3,2,7,3,4
050,31,171,"Nebraska","Thomas County",3,3,9,4,5
050,31,171,"Nebraska","Thomas County",3,4,7,2,5
050,31,171,"Nebraska","Thomas County",3,5,5,2,3
050,31,171,"Nebraska","Thomas County",3,6,9,3,6
050,31,171,"Nebraska","Thomas County",3,7,7,1,6
050,31,171,"Nebraska","Thomas County",3,8,6,3,3
050,31,171,"Nebraska","Thomas County",3,9,12,7,5
050,31,171,"Nebraska","Thomas County",3,10,15,9,6
050,31,171,"Nebraska","Thomas County",3,11,10,7,3
050,31,171,"Nebraska","Thomas County",3,12,11,5,6
050,31,171,"Nebraska","Thomas County",3,13,11,6,5
050,31,171,"Nebraska","Thomas County",3,14,11,6,5
050,31,171,"Nebraska","Thomas County",3,15,7,3,4
050,31,171,"Nebraska","Thomas County",3,16,12,5,7
050,31,171,"Nebraska","Thomas County",3,17,10,6,4
050,31,171,"Nebraska","Thomas County",3,18,9,6,3
050,31,171,"Nebraska","Thomas County",3,19,4,3,1
050,31,171,"Nebraska","Thomas County",3,20,8,6,2
050,31,171,"Nebraska","Thomas County",3,21,5,4,1
050,31,171,"Nebraska","Thomas County",3,22,5,3,2
050,31,171,"Nebraska","Thomas County",3,23,7,5,2
050,31,171,"Nebraska","Thomas County",3,24,8,4,4
050,31,171,"Nebraska","Thomas County",3,25,10,5,5
050,31,171,"Nebraska","Thomas County",3,26,3,1,2
050,31,171,"Nebraska","Thomas County",3,27,4,2,2
050,31,171,"Nebraska","Thomas County",3,28,8,5,3
050,31,171,"Nebraska","Thomas County",3,29,7,3,4
050,31,171,"Nebraska","Thomas County",3,30,2,2,0
050,31,171,"Nebraska","Thomas County",3,31,9,3,6
050,31,171,"Nebraska","Thomas County",3,32,6,3,3
050,31,171,"Nebraska","Thomas County",3,33,7,4,3
050,31,171,"Nebraska","Thomas County",3,34,8,5,3
050,31,171,"Nebraska","Thomas County",3,35,11,7,4
050,31,171,"Nebraska","Thomas County",3,36,8,4,4
050,31,171,"Nebraska","Thomas County",3,37,5,2,3
050,31,171,"Nebraska","Thomas County",3,38,6,4,2
050,31,171,"Nebraska","Thomas County",3,39,5,4,1
050,31,171,"Nebraska","Thomas County",3,40,7,5,2
050,31,171,"Nebraska","Thomas County",3,41,7,3,4
050,31,171,"Nebraska","Thomas County",3,42,6,2,4
050,31,171,"Nebraska","Thomas County",3,43,6,2,4
050,31,171,"Nebraska","Thomas County",3,44,8,4,4
050,31,171,"Nebraska","Thomas County",3,45,6,3,3
050,31,171,"Nebraska","Thomas County",3,46,10,3,7
050,31,171,"Nebraska","Thomas County",3,47,10,4,6
050,31,171,"Nebraska","Thomas County",3,48,7,4,3
050,31,171,"Nebraska","Thomas County",3,49,7,4,3
050,31,171,"Nebraska","Thomas County",3,50,5,2,3
050,31,171,"Nebraska","Thomas County",3,51,7,4,3
050,31,171,"Nebraska","Thomas County",3,52,7,5,2
050,31,171,"Nebraska","Thomas County",3,53,5,3,2
050,31,171,"Nebraska","Thomas County",3,54,8,3,5
050,31,171,"Nebraska","Thomas County",3,55,9,4,5
050,31,171,"Nebraska","Thomas County",3,56,7,4,3
050,31,171,"Nebraska","Thomas County",3,57,8,4,4
050,31,171,"Nebraska","Thomas County",3,58,8,4,4
050,31,171,"Nebraska","Thomas County",3,59,7,4,3
050,31,171,"Nebraska","Thomas County",3,60,7,4,3
050,31,171,"Nebraska","Thomas County",3,61,4,2,2
050,31,171,"Nebraska","Thomas County",3,62,6,2,4
050,31,171,"Nebraska","Thomas County",3,63,8,4,4
050,31,171,"Nebraska","Thomas County",3,64,10,5,5
050,31,171,"Nebraska","Thomas County",3,65,14,7,7
050,31,171,"Nebraska","Thomas County",3,66,17,8,9
050,31,171,"Nebraska","Thomas County",3,67,11,6,5
050,31,171,"Nebraska","Thomas County",3,68,16,10,6
050,31,171,"Nebraska","Thomas County",3,69,14,7,7
050,31,171,"Nebraska","Thomas County",3,70,12,7,5
050,31,171,"Nebraska","Thomas County",3,71,9,6,3
050,31,171,"Nebraska","Thomas County",3,72,10,5,5
050,31,171,"Nebraska","Thomas County",3,73,6,3,3
050,31,171,"Nebraska","Thomas County",3,74,6,2,4
050,31,171,"Nebraska","Thomas County",3,75,7,3,4
050,31,171,"Nebraska","Thomas County",3,76,7,3,4
050,31,171,"Nebraska","Thomas County",3,77,9,4,5
050,31,171,"Nebraska","Thomas County",3,78,6,2,4
050,31,171,"Nebraska","Thomas County",3,79,5,2,3
050,31,171,"Nebraska","Thomas County",3,80,6,4,2
050,31,171,"Nebraska","Thomas County",3,81,5,2,3
050,31,171,"Nebraska","Thomas County",3,82,4,2,2
050,31,171,"Nebraska","Thomas County",3,83,5,3,2
050,31,171,"Nebraska","Thomas County",3,84,1,1,0
050,31,171,"Nebraska","Thomas County",3,85,19,3,16
050,31,171,"Nebraska","Thomas County",4,0,7,1,6
050,31,171,"Nebraska","Thomas County",4,1,5,2,3
050,31,171,"Nebraska","Thomas County",4,2,6,2,4
050,31,171,"Nebraska","Thomas County",4,3,4,2,2
050,31,171,"Nebraska","Thomas County",4,4,10,5,5
050,31,171,"Nebraska","Thomas County",4,5,6,0,6
050,31,171,"Nebraska","Thomas County",4,6,6,2,4
050,31,171,"Nebraska","Thomas County",4,7,8,3,5
050,31,171,"Nebraska","Thomas County",4,8,9,1,8
050,31,171,"Nebraska","Thomas County",4,9,6,3,3
050,31,171,"Nebraska","Thomas County",4,10,12,7,5
050,31,171,"Nebraska","Thomas County",4,11,14,8,6
050,31,171,"Nebraska","Thomas County",4,12,6,6,0
050,31,171,"Nebraska","Thomas County",4,13,12,5,7
050,31,171,"Nebraska","Thomas County",4,14,9,5,4
050,31,171,"Nebraska","Thomas County",4,15,10,6,4
050,31,171,"Nebraska","Thomas County",4,16,7,3,4
050,31,171,"Nebraska","Thomas County",4,17,12,5,7
050,31,171,"Nebraska","Thomas County",4,18,7,4,3
050,31,171,"Nebraska","Thomas County",4,19,7,5,2
050,31,171,"Nebraska","Thomas County",4,20,5,4,1
050,31,171,"Nebraska","Thomas County",4,21,9,7,2
050,31,171,"Nebraska","Thomas County",4,22,5,4,1
050,31,171,"Nebraska","Thomas County",4,23,6,4,2
050,31,171,"Nebraska","Thomas County",4,24,7,4,3
050,31,171,"Nebraska","Thomas County",4,25,8,5,3
050,31,171,"Nebraska","Thomas County",4,26,11,5,6
050,31,171,"Nebraska","Thomas County",4,27,4,3,1
050,31,171,"Nebraska","Thomas County",4,28,4,1,3
050,31,171,"Nebraska","Thomas County",4,29,9,5,4
050,31,171,"Nebraska","Thomas County",4,30,5,3,2
050,31,171,"Nebraska","Thomas County",4,31,3,3,0
050,31,171,"Nebraska","Thomas County",4,32,7,3,4
050,31,171,"Nebraska","Thomas County",4,33,7,2,5
050,31,171,"Nebraska","Thomas County",4,34,7,3,4
050,31,171,"Nebraska","Thomas County",4,35,7,4,3
050,31,171,"Nebraska","Thomas County",4,36,10,7,3
050,31,171,"Nebraska","Thomas County",4,37,8,5,3
050,31,171,"Nebraska","Thomas County",4,38,4,1,3
050,31,171,"Nebraska","Thomas County",4,39,6,4,2
050,31,171,"Nebraska","Thomas County",4,40,5,4,1
050,31,171,"Nebraska","Thomas County",4,41,7,5,2
050,31,171,"Nebraska","Thomas County",4,42,7,3,4
050,31,171,"Nebraska","Thomas County",4,43,6,2,4
050,31,171,"Nebraska","Thomas County",4,44,6,2,4
050,31,171,"Nebraska","Thomas County",4,45,10,6,4
050,31,171,"Nebraska","Thomas County",4,46,7,3,4
050,31,171,"Nebraska","Thomas County",4,47,10,3,7
050,31,171,"Nebraska","Thomas County",4,48,10,4,6
050,31,171,"Nebraska","Thomas County",4,49,7,4,3
050,31,171,"Nebraska","Thomas County",4,50,8,4,4
050,31,171,"Nebraska","Thomas County",4,51,5,2,3
050,31,171,"Nebraska","Thomas County",4,52,7,4,3
050,31,171,"Nebraska","Thomas County",4,53,6,4,2
050,31,171,"Nebraska","Thomas County",4,54,5,3,2
050,31,171,"Nebraska","Thomas County",4,55,8,3,5
050,31,171,"Nebraska","Thomas County",4,56,8,3,5
050,31,171,"Nebraska","Thomas County",4,57,7,4,3
050,31,171,"Nebraska","Thomas County",4,58,8,4,4
050,31,171,"Nebraska","Thomas County",4,59,8,4,4
050,31,171,"Nebraska","Thomas County",4,60,5,2,3
050,31,171,"Nebraska","Thomas County",4,61,7,4,3
050,31,171,"Nebraska","Thomas County",4,62,4,2,2
050,31,171,"Nebraska","Thomas County",4,63,6,2,4
050,31,171,"Nebraska","Thomas County",4,64,7,4,3
050,31,171,"Nebraska","Thomas County",4,65,10,5,5
050,31,171,"Nebraska","Thomas County",4,66,15,8,7
050,31,171,"Nebraska","Thomas County",4,67,18,9,9
050,31,171,"Nebraska","Thomas County",4,68,12,7,5
050,31,171,"Nebraska","Thomas County",4,69,13,7,6
050,31,171,"Nebraska","Thomas County",4,70,14,6,8
050,31,171,"Nebraska","Thomas County",4,71,12,7,5
050,31,171,"Nebraska","Thomas County",4,72,9,6,3
050,31,171,"Nebraska","Thomas County",4,73,10,5,5
050,31,171,"Nebraska","Thomas County",4,74,6,3,3
050,31,171,"Nebraska","Thomas County",4,75,6,2,4
050,31,171,"Nebraska","Thomas County",4,76,7,3,4
050,31,171,"Nebraska","Thomas County",4,77,7,3,4
050,31,171,"Nebraska","Thomas County",4,78,9,4,5
050,31,171,"Nebraska","Thomas County",4,79,6,2,4
050,31,171,"Nebraska","Thomas County",4,80,5,2,3
050,31,171,"Nebraska","Thomas County",4,81,6,4,2
050,31,171,"Nebraska","Thomas County",4,82,5,2,3
050,31,171,"Nebraska","Thomas County",4,83,3,2,1
050,31,171,"Nebraska","Thomas County",4,84,2,1,1
050,31,171,"Nebraska","Thomas County",4,85,21,3,18
050,31,171,"Nebraska","Thomas County",5,0,8,2,6
050,31,171,"Nebraska","Thomas County",5,1,7,1,6
050,31,171,"Nebraska","Thomas County",5,2,9,5,4
050,31,171,"Nebraska","Thomas County",5,3,6,2,4
050,31,171,"Nebraska","Thomas County",5,4,7,4,3
050,31,171,"Nebraska","Thomas County",5,5,10,4,6
050,31,171,"Nebraska","Thomas County",5,6,5,0,5
050,31,171,"Nebraska","Thomas County",5,7,7,3,4
050,31,171,"Nebraska","Thomas County",5,8,6,3,3
050,31,171,"Nebraska","Thomas County",5,9,8,1,7
050,31,171,"Nebraska","Thomas County",5,10,11,3,8
050,31,171,"Nebraska","Thomas County",5,11,9,5,4
050,31,171,"Nebraska","Thomas County",5,12,12,6,6
050,31,171,"Nebraska","Thomas County",5,13,6,6,0
050,31,171,"Nebraska","Thomas County",5,14,13,6,7
050,31,171,"Nebraska","Thomas County",5,15,10,6,4
050,31,171,"Nebraska","Thomas County",5,16,10,6,4
050,31,171,"Nebraska","Thomas County",5,17,8,3,5
050,31,171,"Nebraska","Thomas County",5,18,11,5,6
050,31,171,"Nebraska","Thomas County",5,19,6,4,2
050,31,171,"Nebraska","Thomas County",5,20,7,5,2
050,31,171,"Nebraska","Thomas County",5,21,5,4,1
050,31,171,"Nebraska","Thomas County",5,22,12,8,4
050,31,171,"Nebraska","Thomas County",5,23,4,4,0
050,31,171,"Nebraska","Thomas County",5,24,4,1,3
050,31,171,"Nebraska","Thomas County",5,25,6,3,3
050,31,171,"Nebraska","Thomas County",5,26,12,5,7
050,31,171,"Nebraska","Thomas County",5,27,8,3,5
050,31,171,"Nebraska","Thomas County",5,28,4,3,1
050,31,171,"Nebraska","Thomas County",5,29,4,0,4
050,31,171,"Nebraska","Thomas County",5,30,11,5,6
050,31,171,"Nebraska","Thomas County",5,31,5,3,2
050,31,171,"Nebraska","Thomas County",5,32,5,5,0
050,31,171,"Nebraska","Thomas County",5,33,6,3,3
050,31,171,"Nebraska","Thomas County",5,34,8,3,5
050,31,171,"Nebraska","Thomas County",5,35,6,2,4
050,31,171,"Nebraska","Thomas County",5,36,7,4,3
050,31,171,"Nebraska","Thomas County",5,37,10,7,3
050,31,171,"Nebraska","Thomas County",5,38,9,6,3
050,31,171,"Nebraska","Thomas County",5,39,4,1,3
050,31,171,"Nebraska","Thomas County",5,40,7,4,3
050,31,171,"Nebraska","Thomas County",5,41,5,4,1
050,31,171,"Nebraska","Thomas County",5,42,6,4,2
050,31,171,"Nebraska","Thomas County",5,43,6,3,3
050,31,171,"Nebraska","Thomas County",5,44,9,5,4
050,31,171,"Nebraska","Thomas County",5,45,7,3,4
050,31,171,"Nebraska","Thomas County",5,46,9,5,4
050,31,171,"Nebraska","Thomas County",5,47,8,3,5
050,31,171,"Nebraska","Thomas County",5,48,10,3,7
050,31,171,"Nebraska","Thomas County",5,49,12,6,6
050,31,171,"Nebraska","Thomas County",5,50,7,4,3
050,31,171,"Nebraska","Thomas County",5,51,9,4,5
050,31,171,"Nebraska","Thomas County",5,52,8,2,6
050,31,171,"Nebraska","Thomas County",5,53,7,4,3
050,31,171,"Nebraska","Thomas County",5,54,7,4,3
050,31,171,"Nebraska","Thomas County",5,55,5,3,2
050,31,171,"Nebraska","Thomas County",5,56,7,2,5
050,31,171,"Nebraska","Thomas County",5,57,5,0,5
050,31,171,"Nebraska","Thomas County",5,58,7,4,3
050,31,171,"Nebraska","Thomas County",5,59,8,3,5
050,31,171,"Nebraska","Thomas County",5,60,7,3,4
050,31,171,"Nebraska","Thomas County",5,61,5,2,3
050,31,171,"Nebraska","Thomas County",5,62,7,4,3
050,31,171,"Nebraska","Thomas County",5,63,7,4,3
050,31,171,"Nebraska","Thomas County",5,64,6,2,4
050,31,171,"Nebraska","Thomas County",5,65,7,4,3
050,31,171,"Nebraska","Thomas County",5,66,10,5,5
050,31,171,"Nebraska","Thomas County",5,67,13,6,7
050,31,171,"Nebraska","Thomas County",5,68,17,9,8
050,31,171,"Nebraska","Thomas County",5,69,11,6,5
050,31,171,"Nebraska","Thomas County",5,70,12,6,6
050,31,171,"Nebraska","Thomas County",5,71,13,6,7
050,31,171,"Nebraska","Thomas County",5,72,12,7,5
050,31,171,"Nebraska","Thomas County",5,73,7,4,3
050,31,171,"Nebraska","Thomas County",5,74,10,5,5
050,31,171,"Nebraska","Thomas County",5,75,6,3,3
050,31,171,"Nebraska","Thomas County",5,76,7,2,5
050,31,171,"Nebraska","Thomas County",5,77,7,3,4
050,31,171,"Nebraska","Thomas County",5,78,7,3,4
050,31,171,"Nebraska","Thomas County",5,79,9,4,5
050,31,171,"Nebraska","Thomas County",5,80,6,2,4
050,31,171,"Nebraska","Thomas County",5,81,5,2,3
050,31,171,"Nebraska","Thomas County",5,82,6,4,2
050,31,171,"Nebraska","Thomas County",5,83,3,2,1
050,31,171,"Nebraska","Thomas County",5,84,1,1,0
050,31,171,"Nebraska","Thomas County",5,85,21,3,18
050,31,173,"Nebraska","Thurston County",1,0,121,62,59
050,31,173,"Nebraska","Thurston County",1,1,126,64,62
050,31,173,"Nebraska","Thurston County",1,2,132,69,63
050,31,173,"Nebraska","Thurston County",1,3,117,65,52
050,31,173,"Nebraska","Thurston County",1,4,134,63,71
050,31,173,"Nebraska","Thurston County",1,5,138,68,70
050,31,173,"Nebraska","Thurston County",1,6,133,61,72
050,31,173,"Nebraska","Thurston County",1,7,113,57,56
050,31,173,"Nebraska","Thurston County",1,8,123,65,58
050,31,173,"Nebraska","Thurston County",1,9,117,53,64
050,31,173,"Nebraska","Thurston County",1,10,132,62,70
050,31,173,"Nebraska","Thurston County",1,11,143,70,73
050,31,173,"Nebraska","Thurston County",1,12,144,74,70
050,31,173,"Nebraska","Thurston County",1,13,143,84,59
050,31,173,"Nebraska","Thurston County",1,14,137,79,58
050,31,173,"Nebraska","Thurston County",1,15,135,71,64
050,31,173,"Nebraska","Thurston County",1,16,127,68,59
050,31,173,"Nebraska","Thurston County",1,17,123,62,61
050,31,173,"Nebraska","Thurston County",1,18,106,53,53
050,31,173,"Nebraska","Thurston County",1,19,111,55,56
050,31,173,"Nebraska","Thurston County",1,20,109,53,56
050,31,173,"Nebraska","Thurston County",1,21,96,48,48
050,31,173,"Nebraska","Thurston County",1,22,89,50,39
050,31,173,"Nebraska","Thurston County",1,23,85,45,40
050,31,173,"Nebraska","Thurston County",1,24,85,37,48
050,31,173,"Nebraska","Thurston County",1,25,80,43,37
050,31,173,"Nebraska","Thurston County",1,26,93,44,49
050,31,173,"Nebraska","Thurston County",1,27,98,45,53
050,31,173,"Nebraska","Thurston County",1,28,110,62,48
050,31,173,"Nebraska","Thurston County",1,29,96,55,41
050,31,173,"Nebraska","Thurston County",1,30,81,40,41
050,31,173,"Nebraska","Thurston County",1,31,84,43,41
050,31,173,"Nebraska","Thurston County",1,32,73,41,32
050,31,173,"Nebraska","Thurston County",1,33,65,32,33
050,31,173,"Nebraska","Thurston County",1,34,72,40,32
050,31,173,"Nebraska","Thurston County",1,35,81,50,31
050,31,173,"Nebraska","Thurston County",1,36,68,36,32
050,31,173,"Nebraska","Thurston County",1,37,57,27,30
050,31,173,"Nebraska","Thurston County",1,38,72,43,29
050,31,173,"Nebraska","Thurston County",1,39,76,41,35
050,31,173,"Nebraska","Thurston County",1,40,79,36,43
050,31,173,"Nebraska","Thurston County",1,41,70,36,34
050,31,173,"Nebraska","Thurston County",1,42,59,29,30
050,31,173,"Nebraska","Thurston County",1,43,68,35,33
050,31,173,"Nebraska","Thurston County",1,44,60,27,33
050,31,173,"Nebraska","Thurston County",1,45,52,21,31
050,31,173,"Nebraska","Thurston County",1,46,49,24,25
050,31,173,"Nebraska","Thurston County",1,47,61,27,34
050,31,173,"Nebraska","Thurston County",1,48,63,22,41
050,31,173,"Nebraska","Thurston County",1,49,65,29,36
050,31,173,"Nebraska","Thurston County",1,50,65,34,31
050,31,173,"Nebraska","Thurston County",1,51,63,32,31
050,31,173,"Nebraska","Thurston County",1,52,62,31,31
050,31,173,"Nebraska","Thurston County",1,53,66,28,38
050,31,173,"Nebraska","Thurston County",1,54,74,29,45
050,31,173,"Nebraska","Thurston County",1,55,79,37,42
050,31,173,"Nebraska","Thurston County",1,56,68,35,33
050,31,173,"Nebraska","Thurston County",1,57,77,40,37
050,31,173,"Nebraska","Thurston County",1,58,77,36,41
050,31,173,"Nebraska","Thurston County",1,59,79,38,41
050,31,173,"Nebraska","Thurston County",1,60,84,39,45
050,31,173,"Nebraska","Thurston County",1,61,82,46,36
050,31,173,"Nebraska","Thurston County",1,62,64,31,33
050,31,173,"Nebraska","Thurston County",1,63,73,34,39
050,31,173,"Nebraska","Thurston County",1,64,76,44,32
050,31,173,"Nebraska","Thurston County",1,65,70,40,30
050,31,173,"Nebraska","Thurston County",1,66,56,32,24
050,31,173,"Nebraska","Thurston County",1,67,57,25,32
050,31,173,"Nebraska","Thurston County",1,68,51,26,25
050,31,173,"Nebraska","Thurston County",1,69,59,31,28
050,31,173,"Nebraska","Thurston County",1,70,46,25,21
050,31,173,"Nebraska","Thurston County",1,71,41,23,18
050,31,173,"Nebraska","Thurston County",1,72,43,18,25
050,31,173,"Nebraska","Thurston County",1,73,48,20,28
050,31,173,"Nebraska","Thurston County",1,74,32,15,17
050,31,173,"Nebraska","Thurston County",1,75,26,9,17
050,31,173,"Nebraska","Thurston County",1,76,29,13,16
050,31,173,"Nebraska","Thurston County",1,77,32,17,15
050,31,173,"Nebraska","Thurston County",1,78,27,13,14
050,31,173,"Nebraska","Thurston County",1,79,19,9,10
050,31,173,"Nebraska","Thurston County",1,80,24,15,9
050,31,173,"Nebraska","Thurston County",1,81,24,14,10
050,31,173,"Nebraska","Thurston County",1,82,23,11,12
050,31,173,"Nebraska","Thurston County",1,83,13,5,8
050,31,173,"Nebraska","Thurston County",1,84,11,3,8
050,31,173,"Nebraska","Thurston County",1,85,108,34,74
050,31,173,"Nebraska","Thurston County",2,0,119,62,57
050,31,173,"Nebraska","Thurston County",2,1,122,62,60
050,31,173,"Nebraska","Thurston County",2,2,130,68,62
050,31,173,"Nebraska","Thurston County",2,3,123,67,56
050,31,173,"Nebraska","Thurston County",2,4,129,63,66
050,31,173,"Nebraska","Thurston County",2,5,139,68,71
050,31,173,"Nebraska","Thurston County",2,6,135,63,72
050,31,173,"Nebraska","Thurston County",2,7,118,58,60
050,31,173,"Nebraska","Thurston County",2,8,121,62,59
050,31,173,"Nebraska","Thurston County",2,9,118,56,62
050,31,173,"Nebraska","Thurston County",2,10,127,59,68
050,31,173,"Nebraska","Thurston County",2,11,138,66,72
050,31,173,"Nebraska","Thurston County",2,12,147,74,73
050,31,173,"Nebraska","Thurston County",2,13,142,80,62
050,31,173,"Nebraska","Thurston County",2,14,137,80,57
050,31,173,"Nebraska","Thurston County",2,15,136,73,63
050,31,173,"Nebraska","Thurston County",2,16,130,69,61
050,31,173,"Nebraska","Thurston County",2,17,121,62,59
050,31,173,"Nebraska","Thurston County",2,18,106,54,52
050,31,173,"Nebraska","Thurston County",2,19,108,54,54
050,31,173,"Nebraska","Thurston County",2,20,109,53,56
050,31,173,"Nebraska","Thurston County",2,21,97,48,49
050,31,173,"Nebraska","Thurston County",2,22,90,50,40
050,31,173,"Nebraska","Thurston County",2,23,87,46,41
050,31,173,"Nebraska","Thurston County",2,24,84,39,45
050,31,173,"Nebraska","Thurston County",2,25,81,41,40
050,31,173,"Nebraska","Thurston County",2,26,92,44,48
050,31,173,"Nebraska","Thurston County",2,27,98,46,52
050,31,173,"Nebraska","Thurston County",2,28,108,58,50
050,31,173,"Nebraska","Thurston County",2,29,97,55,42
050,31,173,"Nebraska","Thurston County",2,30,86,45,41
050,31,173,"Nebraska","Thurston County",2,31,81,42,39
050,31,173,"Nebraska","Thurston County",2,32,73,39,34
050,31,173,"Nebraska","Thurston County",2,33,66,34,32
050,31,173,"Nebraska","Thurston County",2,34,71,39,32
050,31,173,"Nebraska","Thurston County",2,35,80,48,32
050,31,173,"Nebraska","Thurston County",2,36,70,39,31
050,31,173,"Nebraska","Thurston County",2,37,60,30,30
050,31,173,"Nebraska","Thurston County",2,38,69,40,29
050,31,173,"Nebraska","Thurston County",2,39,74,40,34
050,31,173,"Nebraska","Thurston County",2,40,79,37,42
050,31,173,"Nebraska","Thurston County",2,41,73,37,36
050,31,173,"Nebraska","Thurston County",2,42,61,30,31
050,31,173,"Nebraska","Thurston County",2,43,67,34,33
050,31,173,"Nebraska","Thurston County",2,44,62,29,33
050,31,173,"Nebraska","Thurston County",2,45,54,23,31
050,31,173,"Nebraska","Thurston County",2,46,50,24,26
050,31,173,"Nebraska","Thurston County",2,47,56,24,32
050,31,173,"Nebraska","Thurston County",2,48,61,22,39
050,31,173,"Nebraska","Thurston County",2,49,64,28,36
050,31,173,"Nebraska","Thurston County",2,50,65,33,32
050,31,173,"Nebraska","Thurston County",2,51,62,31,31
050,31,173,"Nebraska","Thurston County",2,52,62,31,31
050,31,173,"Nebraska","Thurston County",2,53,66,29,37
050,31,173,"Nebraska","Thurston County",2,54,69,28,41
050,31,173,"Nebraska","Thurston County",2,55,80,37,43
050,31,173,"Nebraska","Thurston County",2,56,69,35,34
050,31,173,"Nebraska","Thurston County",2,57,75,39,36
050,31,173,"Nebraska","Thurston County",2,58,76,35,41
050,31,173,"Nebraska","Thurston County",2,59,78,38,40
050,31,173,"Nebraska","Thurston County",2,60,83,39,44
050,31,173,"Nebraska","Thurston County",2,61,82,44,38
050,31,173,"Nebraska","Thurston County",2,62,69,34,35
050,31,173,"Nebraska","Thurston County",2,63,74,35,39
050,31,173,"Nebraska","Thurston County",2,64,70,37,33
050,31,173,"Nebraska","Thurston County",2,65,71,41,30
050,31,173,"Nebraska","Thurston County",2,66,59,34,25
050,31,173,"Nebraska","Thurston County",2,67,56,25,31
050,31,173,"Nebraska","Thurston County",2,68,50,25,25
050,31,173,"Nebraska","Thurston County",2,69,57,30,27
050,31,173,"Nebraska","Thurston County",2,70,50,27,23
050,31,173,"Nebraska","Thurston County",2,71,41,23,18
050,31,173,"Nebraska","Thurston County",2,72,38,19,19
050,31,173,"Nebraska","Thurston County",2,73,49,21,28
050,31,173,"Nebraska","Thurston County",2,74,32,14,18
050,31,173,"Nebraska","Thurston County",2,75,27,10,17
050,31,173,"Nebraska","Thurston County",2,76,27,12,15
050,31,173,"Nebraska","Thurston County",2,77,32,16,16
050,31,173,"Nebraska","Thurston County",2,78,29,14,15
050,31,173,"Nebraska","Thurston County",2,79,20,10,10
050,31,173,"Nebraska","Thurston County",2,80,22,13,9
050,31,173,"Nebraska","Thurston County",2,81,24,14,10
050,31,173,"Nebraska","Thurston County",2,82,19,11,8
050,31,173,"Nebraska","Thurston County",2,83,15,6,9
050,31,173,"Nebraska","Thurston County",2,84,12,3,9
050,31,173,"Nebraska","Thurston County",2,85,108,34,74
050,31,173,"Nebraska","Thurston County",3,0,135,65,70
050,31,173,"Nebraska","Thurston County",3,1,102,64,38
050,31,173,"Nebraska","Thurston County",3,2,122,62,60
050,31,173,"Nebraska","Thurston County",3,3,128,68,60
050,31,173,"Nebraska","Thurston County",3,4,123,65,58
050,31,173,"Nebraska","Thurston County",3,5,125,59,66
050,31,173,"Nebraska","Thurston County",3,6,142,70,72
050,31,173,"Nebraska","Thurston County",3,7,129,59,70
050,31,173,"Nebraska","Thurston County",3,8,109,55,54
050,31,173,"Nebraska","Thurston County",3,9,117,59,58
050,31,173,"Nebraska","Thurston County",3,10,115,58,57
050,31,173,"Nebraska","Thurston County",3,11,123,56,67
050,31,173,"Nebraska","Thurston County",3,12,141,68,73
050,31,173,"Nebraska","Thurston County",3,13,144,78,66
050,31,173,"Nebraska","Thurston County",3,14,139,77,62
050,31,173,"Nebraska","Thurston County",3,15,138,79,59
050,31,173,"Nebraska","Thurston County",3,16,126,65,61
050,31,173,"Nebraska","Thurston County",3,17,128,66,62
050,31,173,"Nebraska","Thurston County",3,18,112,56,56
050,31,173,"Nebraska","Thurston County",3,19,90,48,42
050,31,173,"Nebraska","Thurston County",3,20,108,48,60
050,31,173,"Nebraska","Thurston County",3,21,108,53,55
050,31,173,"Nebraska","Thurston County",3,22,91,43,48
050,31,173,"Nebraska","Thurston County",3,23,86,48,38
050,31,173,"Nebraska","Thurston County",3,24,82,42,40
050,31,173,"Nebraska","Thurston County",3,25,76,34,42
050,31,173,"Nebraska","Thurston County",3,26,78,41,37
050,31,173,"Nebraska","Thurston County",3,27,86,44,42
050,31,173,"Nebraska","Thurston County",3,28,96,48,48
050,31,173,"Nebraska","Thurston County",3,29,102,53,49
050,31,173,"Nebraska","Thurston County",3,30,95,55,40
050,31,173,"Nebraska","Thurston County",3,31,76,41,35
050,31,173,"Nebraska","Thurston County",3,32,78,39,39
050,31,173,"Nebraska","Thurston County",3,33,75,40,35
050,31,173,"Nebraska","Thurston County",3,34,64,32,32
050,31,173,"Nebraska","Thurston County",3,35,68,40,28
050,31,173,"Nebraska","Thurston County",3,36,79,46,33
050,31,173,"Nebraska","Thurston County",3,37,65,34,31
050,31,173,"Nebraska","Thurston County",3,38,56,29,27
050,31,173,"Nebraska","Thurston County",3,39,69,38,31
050,31,173,"Nebraska","Thurston County",3,40,71,40,31
050,31,173,"Nebraska","Thurston County",3,41,74,35,39
050,31,173,"Nebraska","Thurston County",3,42,69,35,34
050,31,173,"Nebraska","Thurston County",3,43,62,31,31
050,31,173,"Nebraska","Thurston County",3,44,66,34,32
050,31,173,"Nebraska","Thurston County",3,45,61,29,32
050,31,173,"Nebraska","Thurston County",3,46,54,25,29
050,31,173,"Nebraska","Thurston County",3,47,46,19,27
050,31,173,"Nebraska","Thurston County",3,48,59,27,32
050,31,173,"Nebraska","Thurston County",3,49,55,21,34
050,31,173,"Nebraska","Thurston County",3,50,61,27,34
050,31,173,"Nebraska","Thurston County",3,51,62,29,33
050,31,173,"Nebraska","Thurston County",3,52,62,32,30
050,31,173,"Nebraska","Thurston County",3,53,61,29,32
050,31,173,"Nebraska","Thurston County",3,54,66,27,39
050,31,173,"Nebraska","Thurston County",3,55,68,31,37
050,31,173,"Nebraska","Thurston County",3,56,75,32,43
050,31,173,"Nebraska","Thurston County",3,57,68,35,33
050,31,173,"Nebraska","Thurston County",3,58,73,35,38
050,31,173,"Nebraska","Thurston County",3,59,71,33,38
050,31,173,"Nebraska","Thurston County",3,60,75,35,40
050,31,173,"Nebraska","Thurston County",3,61,79,36,43
050,31,173,"Nebraska","Thurston County",3,62,77,44,33
050,31,173,"Nebraska","Thurston County",3,63,70,35,35
050,31,173,"Nebraska","Thurston County",3,64,73,34,39
050,31,173,"Nebraska","Thurston County",3,65,68,36,32
050,31,173,"Nebraska","Thurston County",3,66,71,41,30
050,31,173,"Nebraska","Thurston County",3,67,62,33,29
050,31,173,"Nebraska","Thurston County",3,68,50,23,27
050,31,173,"Nebraska","Thurston County",3,69,51,25,26
050,31,173,"Nebraska","Thurston County",3,70,55,30,25
050,31,173,"Nebraska","Thurston County",3,71,47,26,21
050,31,173,"Nebraska","Thurston County",3,72,43,26,17
050,31,173,"Nebraska","Thurston County",3,73,36,19,17
050,31,173,"Nebraska","Thurston County",3,74,47,20,27
050,31,173,"Nebraska","Thurston County",3,75,29,9,20
050,31,173,"Nebraska","Thurston County",3,76,28,12,16
050,31,173,"Nebraska","Thurston County",3,77,21,9,12
050,31,173,"Nebraska","Thurston County",3,78,32,14,18
050,31,173,"Nebraska","Thurston County",3,79,25,13,12
050,31,173,"Nebraska","Thurston County",3,80,21,11,10
050,31,173,"Nebraska","Thurston County",3,81,18,10,8
050,31,173,"Nebraska","Thurston County",3,82,16,9,7
050,31,173,"Nebraska","Thurston County",3,83,16,11,5
050,31,173,"Nebraska","Thurston County",3,84,15,3,12
050,31,173,"Nebraska","Thurston County",3,85,98,30,68
050,31,173,"Nebraska","Thurston County",4,0,124,69,55
050,31,173,"Nebraska","Thurston County",4,1,126,53,73
050,31,173,"Nebraska","Thurston County",4,2,96,57,39
050,31,173,"Nebraska","Thurston County",4,3,123,62,61
050,31,173,"Nebraska","Thurston County",4,4,124,65,59
050,31,173,"Nebraska","Thurston County",4,5,116,63,53
050,31,173,"Nebraska","Thurston County",4,6,123,58,65
050,31,173,"Nebraska","Thurston County",4,7,144,71,73
050,31,173,"Nebraska","Thurston County",4,8,128,60,68
050,31,173,"Nebraska","Thurston County",4,9,113,56,57
050,31,173,"Nebraska","Thurston County",4,10,120,59,61
050,31,173,"Nebraska","Thurston County",4,11,108,54,54
050,31,173,"Nebraska","Thurston County",4,12,124,57,67
050,31,173,"Nebraska","Thurston County",4,13,142,73,69
050,31,173,"Nebraska","Thurston County",4,14,149,80,69
050,31,173,"Nebraska","Thurston County",4,15,141,78,63
050,31,173,"Nebraska","Thurston County",4,16,137,78,59
050,31,173,"Nebraska","Thurston County",4,17,134,72,62
050,31,173,"Nebraska","Thurston County",4,18,113,56,57
050,31,173,"Nebraska","Thurston County",4,19,98,50,48
050,31,173,"Nebraska","Thurston County",4,20,87,47,40
050,31,173,"Nebraska","Thurston County",4,21,105,50,55
050,31,173,"Nebraska","Thurston County",4,22,105,49,56
050,31,173,"Nebraska","Thurston County",4,23,91,44,47
050,31,173,"Nebraska","Thurston County",4,24,88,52,36
050,31,173,"Nebraska","Thurston County",4,25,83,48,35
050,31,173,"Nebraska","Thurston County",4,26,69,31,38
050,31,173,"Nebraska","Thurston County",4,27,82,43,39
050,31,173,"Nebraska","Thurston County",4,28,84,42,42
050,31,173,"Nebraska","Thurston County",4,29,88,41,47
050,31,173,"Nebraska","Thurston County",4,30,95,51,44
050,31,173,"Nebraska","Thurston County",4,31,88,52,36
050,31,173,"Nebraska","Thurston County",4,32,76,38,38
050,31,173,"Nebraska","Thurston County",4,33,73,35,38
050,31,173,"Nebraska","Thurston County",4,34,72,38,34
050,31,173,"Nebraska","Thurston County",4,35,63,29,34
050,31,173,"Nebraska","Thurston County",4,36,67,39,28
050,31,173,"Nebraska","Thurston County",4,37,79,48,31
050,31,173,"Nebraska","Thurston County",4,38,66,35,31
050,31,173,"Nebraska","Thurston County",4,39,49,25,24
050,31,173,"Nebraska","Thurston County",4,40,70,37,33
050,31,173,"Nebraska","Thurston County",4,41,67,38,29
050,31,173,"Nebraska","Thurston County",4,42,71,33,38
050,31,173,"Nebraska","Thurston County",4,43,71,37,34
050,31,173,"Nebraska","Thurston County",4,44,59,29,30
050,31,173,"Nebraska","Thurston County",4,45,68,33,35
050,31,173,"Nebraska","Thurston County",4,46,63,34,29
050,31,173,"Nebraska","Thurston County",4,47,51,23,28
050,31,173,"Nebraska","Thurston County",4,48,51,20,31
050,31,173,"Nebraska","Thurston County",4,49,62,29,33
050,31,173,"Nebraska","Thurston County",4,50,55,21,34
050,31,173,"Nebraska","Thurston County",4,51,57,23,34
050,31,173,"Nebraska","Thurston County",4,52,61,28,33
050,31,173,"Nebraska","Thurston County",4,53,66,34,32
050,31,173,"Nebraska","Thurston County",4,54,58,27,31
050,31,173,"Nebraska","Thurston County",4,55,66,29,37
050,31,173,"Nebraska","Thurston County",4,56,65,28,37
050,31,173,"Nebraska","Thurston County",4,57,80,34,46
050,31,173,"Nebraska","Thurston County",4,58,66,32,34
050,31,173,"Nebraska","Thurston County",4,59,68,31,37
050,31,173,"Nebraska","Thurston County",4,60,71,33,38
050,31,173,"Nebraska","Thurston County",4,61,68,32,36
050,31,173,"Nebraska","Thurston County",4,62,76,33,43
050,31,173,"Nebraska","Thurston County",4,63,76,44,32
050,31,173,"Nebraska","Thurston County",4,64,65,33,32
050,31,173,"Nebraska","Thurston County",4,65,66,33,33
050,31,173,"Nebraska","Thurston County",4,66,62,34,28
050,31,173,"Nebraska","Thurston County",4,67,70,38,32
050,31,173,"Nebraska","Thurston County",4,68,59,33,26
050,31,173,"Nebraska","Thurston County",4,69,49,22,27
050,31,173,"Nebraska","Thurston County",4,70,47,21,26
050,31,173,"Nebraska","Thurston County",4,71,52,29,23
050,31,173,"Nebraska","Thurston County",4,72,44,25,19
050,31,173,"Nebraska","Thurston County",4,73,42,25,17
050,31,173,"Nebraska","Thurston County",4,74,32,16,16
050,31,173,"Nebraska","Thurston County",4,75,36,14,22
050,31,173,"Nebraska","Thurston County",4,76,29,10,19
050,31,173,"Nebraska","Thurston County",4,77,20,8,12
050,31,173,"Nebraska","Thurston County",4,78,18,5,13
050,31,173,"Nebraska","Thurston County",4,79,28,13,15
050,31,173,"Nebraska","Thurston County",4,80,26,13,13
050,31,173,"Nebraska","Thurston County",4,81,18,9,9
050,31,173,"Nebraska","Thurston County",4,82,16,9,7
050,31,173,"Nebraska","Thurston County",4,83,15,9,6
050,31,173,"Nebraska","Thurston County",4,84,17,10,7
050,31,173,"Nebraska","Thurston County",4,85,85,26,59
050,31,173,"Nebraska","Thurston County",5,0,131,72,59
050,31,173,"Nebraska","Thurston County",5,1,116,67,49
050,31,173,"Nebraska","Thurston County",5,2,129,53,76
050,31,173,"Nebraska","Thurston County",5,3,104,63,41
050,31,173,"Nebraska","Thurston County",5,4,128,68,60
050,31,173,"Nebraska","Thurston County",5,5,128,67,61
050,31,173,"Nebraska","Thurston County",5,6,115,65,50
050,31,173,"Nebraska","Thurston County",5,7,127,64,63
050,31,173,"Nebraska","Thurston County",5,8,131,68,63
050,31,173,"Nebraska","Thurston County",5,9,134,63,71
050,31,173,"Nebraska","Thurston County",5,10,107,54,53
050,31,173,"Nebraska","Thurston County",5,11,120,58,62
050,31,173,"Nebraska","Thurston County",5,12,106,55,51
050,31,173,"Nebraska","Thurston County",5,13,123,56,67
050,31,173,"Nebraska","Thurston County",5,14,148,75,73
050,31,173,"Nebraska","Thurston County",5,15,148,78,70
050,31,173,"Nebraska","Thurston County",5,16,142,79,63
050,31,173,"Nebraska","Thurston County",5,17,136,76,60
050,31,173,"Nebraska","Thurston County",5,18,123,67,56
050,31,173,"Nebraska","Thurston County",5,19,107,55,52
050,31,173,"Nebraska","Thurston County",5,20,101,49,52
050,31,173,"Nebraska","Thurston County",5,21,84,44,40
050,31,173,"Nebraska","Thurston County",5,22,100,46,54
050,31,173,"Nebraska","Thurston County",5,23,105,50,55
050,31,173,"Nebraska","Thurston County",5,24,79,37,42
050,31,173,"Nebraska","Thurston County",5,25,86,46,40
050,31,173,"Nebraska","Thurston County",5,26,82,44,38
050,31,173,"Nebraska","Thurston County",5,27,65,28,37
050,31,173,"Nebraska","Thurston County",5,28,82,43,39
050,31,173,"Nebraska","Thurston County",5,29,91,49,42
050,31,173,"Nebraska","Thurston County",5,30,89,41,48
050,31,173,"Nebraska","Thurston County",5,31,97,51,46
050,31,173,"Nebraska","Thurston County",5,32,88,53,35
050,31,173,"Nebraska","Thurston County",5,33,84,39,45
050,31,173,"Nebraska","Thurston County",5,34,81,42,39
050,31,173,"Nebraska","Thurston County",5,35,69,36,33
050,31,173,"Nebraska","Thurston County",5,36,65,34,31
050,31,173,"Nebraska","Thurston County",5,37,70,43,27
050,31,173,"Nebraska","Thurston County",5,38,75,47,28
050,31,173,"Nebraska","Thurston County",5,39,64,34,30
050,31,173,"Nebraska","Thurston County",5,40,54,30,24
050,31,173,"Nebraska","Thurston County",5,41,66,31,35
050,31,173,"Nebraska","Thurston County",5,42,65,37,28
050,31,173,"Nebraska","Thurston County",5,43,76,36,40
050,31,173,"Nebraska","Thurston County",5,44,70,37,33
050,31,173,"Nebraska","Thurston County",5,45,58,29,29
050,31,173,"Nebraska","Thurston County",5,46,66,32,34
050,31,173,"Nebraska","Thurston County",5,47,63,32,31
050,31,173,"Nebraska","Thurston County",5,48,54,22,32
050,31,173,"Nebraska","Thurston County",5,49,49,22,27
050,31,173,"Nebraska","Thurston County",5,50,60,27,33
050,31,173,"Nebraska","Thurston County",5,51,51,19,32
050,31,173,"Nebraska","Thurston County",5,52,53,21,32
050,31,173,"Nebraska","Thurston County",5,53,62,29,33
050,31,173,"Nebraska","Thurston County",5,54,66,34,32
050,31,173,"Nebraska","Thurston County",5,55,60,31,29
050,31,173,"Nebraska","Thurston County",5,56,63,27,36
050,31,173,"Nebraska","Thurston County",5,57,64,27,37
050,31,173,"Nebraska","Thurston County",5,58,78,34,44
050,31,173,"Nebraska","Thurston County",5,59,57,28,29
050,31,173,"Nebraska","Thurston County",5,60,68,31,37
050,31,173,"Nebraska","Thurston County",5,61,65,29,36
050,31,173,"Nebraska","Thurston County",5,62,67,33,34
050,31,173,"Nebraska","Thurston County",5,63,77,32,45
050,31,173,"Nebraska","Thurston County",5,64,75,44,31
050,31,173,"Nebraska","Thurston County",5,65,62,32,30
050,31,173,"Nebraska","Thurston County",5,66,65,32,33
050,31,173,"Nebraska","Thurston County",5,67,63,33,30
050,31,173,"Nebraska","Thurston County",5,68,66,36,30
050,31,173,"Nebraska","Thurston County",5,69,55,31,24
050,31,173,"Nebraska","Thurston County",5,70,50,23,27
050,31,173,"Nebraska","Thurston County",5,71,44,19,25
050,31,173,"Nebraska","Thurston County",5,72,49,27,22
050,31,173,"Nebraska","Thurston County",5,73,42,25,17
050,31,173,"Nebraska","Thurston County",5,74,41,24,17
050,31,173,"Nebraska","Thurston County",5,75,21,9,12
050,31,173,"Nebraska","Thurston County",5,76,34,13,21
050,31,173,"Nebraska","Thurston County",5,77,24,7,17
050,31,173,"Nebraska","Thurston County",5,78,16,4,12
050,31,173,"Nebraska","Thurston County",5,79,12,3,9
050,31,173,"Nebraska","Thurston County",5,80,26,13,13
050,31,173,"Nebraska","Thurston County",5,81,23,12,11
050,31,173,"Nebraska","Thurston County",5,82,16,8,8
050,31,173,"Nebraska","Thurston County",5,83,14,8,6
050,31,173,"Nebraska","Thurston County",5,84,15,8,7
050,31,173,"Nebraska","Thurston County",5,85,72,26,46
050,31,175,"Nebraska","Valley County",1,0,50,25,25
050,31,175,"Nebraska","Valley County",1,1,48,21,27
050,31,175,"Nebraska","Valley County",1,2,45,20,25
050,31,175,"Nebraska","Valley County",1,3,51,22,29
050,31,175,"Nebraska","Valley County",1,4,47,19,28
050,31,175,"Nebraska","Valley County",1,5,58,28,30
050,31,175,"Nebraska","Valley County",1,6,60,35,25
050,31,175,"Nebraska","Valley County",1,7,52,29,23
050,31,175,"Nebraska","Valley County",1,8,60,28,32
050,31,175,"Nebraska","Valley County",1,9,59,25,34
050,31,175,"Nebraska","Valley County",1,10,54,32,22
050,31,175,"Nebraska","Valley County",1,11,48,27,21
050,31,175,"Nebraska","Valley County",1,12,60,36,24
050,31,175,"Nebraska","Valley County",1,13,55,26,29
050,31,175,"Nebraska","Valley County",1,14,51,29,22
050,31,175,"Nebraska","Valley County",1,15,51,27,24
050,31,175,"Nebraska","Valley County",1,16,58,28,30
050,31,175,"Nebraska","Valley County",1,17,61,32,29
050,31,175,"Nebraska","Valley County",1,18,48,23,25
050,31,175,"Nebraska","Valley County",1,19,36,17,19
050,31,175,"Nebraska","Valley County",1,20,32,17,15
050,31,175,"Nebraska","Valley County",1,21,33,18,15
050,31,175,"Nebraska","Valley County",1,22,38,19,19
050,31,175,"Nebraska","Valley County",1,23,38,19,19
050,31,175,"Nebraska","Valley County",1,24,36,18,18
050,31,175,"Nebraska","Valley County",1,25,39,18,21
050,31,175,"Nebraska","Valley County",1,26,42,21,21
050,31,175,"Nebraska","Valley County",1,27,38,16,22
050,31,175,"Nebraska","Valley County",1,28,36,18,18
050,31,175,"Nebraska","Valley County",1,29,32,17,15
050,31,175,"Nebraska","Valley County",1,30,41,19,22
050,31,175,"Nebraska","Valley County",1,31,39,19,20
050,31,175,"Nebraska","Valley County",1,32,34,18,16
050,31,175,"Nebraska","Valley County",1,33,36,18,18
050,31,175,"Nebraska","Valley County",1,34,47,25,22
050,31,175,"Nebraska","Valley County",1,35,41,20,21
050,31,175,"Nebraska","Valley County",1,36,39,16,23
050,31,175,"Nebraska","Valley County",1,37,52,25,27
050,31,175,"Nebraska","Valley County",1,38,44,20,24
050,31,175,"Nebraska","Valley County",1,39,52,28,24
050,31,175,"Nebraska","Valley County",1,40,45,25,20
050,31,175,"Nebraska","Valley County",1,41,48,21,27
050,31,175,"Nebraska","Valley County",1,42,35,15,20
050,31,175,"Nebraska","Valley County",1,43,34,21,13
050,31,175,"Nebraska","Valley County",1,44,36,20,16
050,31,175,"Nebraska","Valley County",1,45,39,20,19
050,31,175,"Nebraska","Valley County",1,46,45,23,22
050,31,175,"Nebraska","Valley County",1,47,45,26,19
050,31,175,"Nebraska","Valley County",1,48,48,30,18
050,31,175,"Nebraska","Valley County",1,49,47,26,21
050,31,175,"Nebraska","Valley County",1,50,37,17,20
050,31,175,"Nebraska","Valley County",1,51,42,18,24
050,31,175,"Nebraska","Valley County",1,52,47,24,23
050,31,175,"Nebraska","Valley County",1,53,50,26,24
050,31,175,"Nebraska","Valley County",1,54,56,34,22
050,31,175,"Nebraska","Valley County",1,55,56,31,25
050,31,175,"Nebraska","Valley County",1,56,60,33,27
050,31,175,"Nebraska","Valley County",1,57,56,26,30
050,31,175,"Nebraska","Valley County",1,58,65,28,37
050,31,175,"Nebraska","Valley County",1,59,56,25,31
050,31,175,"Nebraska","Valley County",1,60,47,25,22
050,31,175,"Nebraska","Valley County",1,61,59,31,28
050,31,175,"Nebraska","Valley County",1,62,58,29,29
050,31,175,"Nebraska","Valley County",1,63,58,26,32
050,31,175,"Nebraska","Valley County",1,64,58,30,28
050,31,175,"Nebraska","Valley County",1,65,51,26,25
050,31,175,"Nebraska","Valley County",1,66,59,33,26
050,31,175,"Nebraska","Valley County",1,67,67,36,31
050,31,175,"Nebraska","Valley County",1,68,51,25,26
050,31,175,"Nebraska","Valley County",1,69,54,29,25
050,31,175,"Nebraska","Valley County",1,70,52,26,26
050,31,175,"Nebraska","Valley County",1,71,41,16,25
050,31,175,"Nebraska","Valley County",1,72,58,23,35
050,31,175,"Nebraska","Valley County",1,73,65,32,33
050,31,175,"Nebraska","Valley County",1,74,46,21,25
050,31,175,"Nebraska","Valley County",1,75,44,20,24
050,31,175,"Nebraska","Valley County",1,76,42,26,16
050,31,175,"Nebraska","Valley County",1,77,34,18,16
050,31,175,"Nebraska","Valley County",1,78,38,19,19
050,31,175,"Nebraska","Valley County",1,79,34,15,19
050,31,175,"Nebraska","Valley County",1,80,28,14,14
050,31,175,"Nebraska","Valley County",1,81,26,14,12
050,31,175,"Nebraska","Valley County",1,82,29,15,14
050,31,175,"Nebraska","Valley County",1,83,19,7,12
050,31,175,"Nebraska","Valley County",1,84,22,9,13
050,31,175,"Nebraska","Valley County",1,85,129,52,77
050,31,175,"Nebraska","Valley County",2,0,48,26,22
050,31,175,"Nebraska","Valley County",2,1,48,22,26
050,31,175,"Nebraska","Valley County",2,2,47,21,26
050,31,175,"Nebraska","Valley County",2,3,49,21,28
050,31,175,"Nebraska","Valley County",2,4,49,20,29
050,31,175,"Nebraska","Valley County",2,5,55,26,29
050,31,175,"Nebraska","Valley County",2,6,59,33,26
050,31,175,"Nebraska","Valley County",2,7,54,30,24
050,31,175,"Nebraska","Valley County",2,8,57,28,29
050,31,175,"Nebraska","Valley County",2,9,59,26,33
050,31,175,"Nebraska","Valley County",2,10,56,31,25
050,31,175,"Nebraska","Valley County",2,11,49,28,21
050,31,175,"Nebraska","Valley County",2,12,58,34,24
050,31,175,"Nebraska","Valley County",2,13,56,28,28
050,31,175,"Nebraska","Valley County",2,14,51,28,23
050,31,175,"Nebraska","Valley County",2,15,52,28,24
050,31,175,"Nebraska","Valley County",2,16,56,27,29
050,31,175,"Nebraska","Valley County",2,17,61,31,30
050,31,175,"Nebraska","Valley County",2,18,48,24,24
050,31,175,"Nebraska","Valley County",2,19,35,17,18
050,31,175,"Nebraska","Valley County",2,20,33,17,16
050,31,175,"Nebraska","Valley County",2,21,33,18,15
050,31,175,"Nebraska","Valley County",2,22,39,20,19
050,31,175,"Nebraska","Valley County",2,23,39,20,19
050,31,175,"Nebraska","Valley County",2,24,37,19,18
050,31,175,"Nebraska","Valley County",2,25,38,18,20
050,31,175,"Nebraska","Valley County",2,26,42,20,22
050,31,175,"Nebraska","Valley County",2,27,39,17,22
050,31,175,"Nebraska","Valley County",2,28,37,17,20
050,31,175,"Nebraska","Valley County",2,29,33,17,16
050,31,175,"Nebraska","Valley County",2,30,40,19,21
050,31,175,"Nebraska","Valley County",2,31,40,19,21
050,31,175,"Nebraska","Valley County",2,32,35,19,16
050,31,175,"Nebraska","Valley County",2,33,36,18,18
050,31,175,"Nebraska","Valley County",2,34,45,24,21
050,31,175,"Nebraska","Valley County",2,35,42,21,21
050,31,175,"Nebraska","Valley County",2,36,39,17,22
050,31,175,"Nebraska","Valley County",2,37,50,24,26
050,31,175,"Nebraska","Valley County",2,38,45,21,24
050,31,175,"Nebraska","Valley County",2,39,50,26,24
050,31,175,"Nebraska","Valley County",2,40,47,25,22
050,31,175,"Nebraska","Valley County",2,41,48,22,26
050,31,175,"Nebraska","Valley County",2,42,38,16,22
050,31,175,"Nebraska","Valley County",2,43,34,19,15
050,31,175,"Nebraska","Valley County",2,44,35,20,15
050,31,175,"Nebraska","Valley County",2,45,40,21,19
050,31,175,"Nebraska","Valley County",2,46,43,22,21
050,31,175,"Nebraska","Valley County",2,47,45,25,20
050,31,175,"Nebraska","Valley County",2,48,47,29,18
050,31,175,"Nebraska","Valley County",2,49,48,27,21
050,31,175,"Nebraska","Valley County",2,50,40,20,20
050,31,175,"Nebraska","Valley County",2,51,39,17,22
050,31,175,"Nebraska","Valley County",2,52,45,22,23
050,31,175,"Nebraska","Valley County",2,53,50,26,24
050,31,175,"Nebraska","Valley County",2,54,54,32,22
050,31,175,"Nebraska","Valley County",2,55,56,32,24
050,31,175,"Nebraska","Valley County",2,56,60,33,27
050,31,175,"Nebraska","Valley County",2,57,57,28,29
050,31,175,"Nebraska","Valley County",2,58,63,27,36
050,31,175,"Nebraska","Valley County",2,59,58,25,33
050,31,175,"Nebraska","Valley County",2,60,49,26,23
050,31,175,"Nebraska","Valley County",2,61,55,29,26
050,31,175,"Nebraska","Valley County",2,62,57,29,28
050,31,175,"Nebraska","Valley County",2,63,59,27,32
050,31,175,"Nebraska","Valley County",2,64,57,29,28
050,31,175,"Nebraska","Valley County",2,65,53,27,26
050,31,175,"Nebraska","Valley County",2,66,57,31,26
050,31,175,"Nebraska","Valley County",2,67,64,35,29
050,31,175,"Nebraska","Valley County",2,68,54,27,27
050,31,175,"Nebraska","Valley County",2,69,52,27,25
050,31,175,"Nebraska","Valley County",2,70,51,25,26
050,31,175,"Nebraska","Valley County",2,71,44,19,25
050,31,175,"Nebraska","Valley County",2,72,53,21,32
050,31,175,"Nebraska","Valley County",2,73,68,32,36
050,31,175,"Nebraska","Valley County",2,74,47,22,25
050,31,175,"Nebraska","Valley County",2,75,45,20,25
050,31,175,"Nebraska","Valley County",2,76,42,24,18
050,31,175,"Nebraska","Valley County",2,77,37,21,16
050,31,175,"Nebraska","Valley County",2,78,36,19,17
050,31,175,"Nebraska","Valley County",2,79,35,16,19
050,31,175,"Nebraska","Valley County",2,80,28,15,13
050,31,175,"Nebraska","Valley County",2,81,26,13,13
050,31,175,"Nebraska","Valley County",2,82,28,15,13
050,31,175,"Nebraska","Valley County",2,83,22,9,13
050,31,175,"Nebraska","Valley County",2,84,22,9,13
050,31,175,"Nebraska","Valley County",2,85,130,53,77
050,31,175,"Nebraska","Valley County",3,0,52,23,29
050,31,175,"Nebraska","Valley County",3,1,48,26,22
050,31,175,"Nebraska","Valley County",3,2,49,25,24
050,31,175,"Nebraska","Valley County",3,3,45,20,25
050,31,175,"Nebraska","Valley County",3,4,49,20,29
050,31,175,"Nebraska","Valley County",3,5,45,21,24
050,31,175,"Nebraska","Valley County",3,6,54,26,28
050,31,175,"Nebraska","Valley County",3,7,59,32,27
050,31,175,"Nebraska","Valley County",3,8,57,30,27
050,31,175,"Nebraska","Valley County",3,9,59,33,26
050,31,175,"Nebraska","Valley County",3,10,63,24,39
050,31,175,"Nebraska","Valley County",3,11,54,29,25
050,31,175,"Nebraska","Valley County",3,12,49,26,23
050,31,175,"Nebraska","Valley County",3,13,59,33,26
050,31,175,"Nebraska","Valley County",3,14,52,25,27
050,31,175,"Nebraska","Valley County",3,15,51,28,23
050,31,175,"Nebraska","Valley County",3,16,54,29,25
050,31,175,"Nebraska","Valley County",3,17,55,26,29
050,31,175,"Nebraska","Valley County",3,18,53,28,25
050,31,175,"Nebraska","Valley County",3,19,36,17,19
050,31,175,"Nebraska","Valley County",3,20,36,18,18
050,31,175,"Nebraska","Valley County",3,21,36,19,17
050,31,175,"Nebraska","Valley County",3,22,34,18,16
050,31,175,"Nebraska","Valley County",3,23,44,21,23
050,31,175,"Nebraska","Valley County",3,24,35,19,16
050,31,175,"Nebraska","Valley County",3,25,39,21,18
050,31,175,"Nebraska","Valley County",3,26,38,15,23
050,31,175,"Nebraska","Valley County",3,27,47,21,26
050,31,175,"Nebraska","Valley County",3,28,42,19,23
050,31,175,"Nebraska","Valley County",3,29,39,18,21
050,31,175,"Nebraska","Valley County",3,30,36,19,17
050,31,175,"Nebraska","Valley County",3,31,39,20,19
050,31,175,"Nebraska","Valley County",3,32,43,20,23
050,31,175,"Nebraska","Valley County",3,33,34,17,17
050,31,175,"Nebraska","Valley County",3,34,40,20,20
050,31,175,"Nebraska","Valley County",3,35,45,25,20
050,31,175,"Nebraska","Valley County",3,36,43,23,20
050,31,175,"Nebraska","Valley County",3,37,39,17,22
050,31,175,"Nebraska","Valley County",3,38,49,24,25
050,31,175,"Nebraska","Valley County",3,39,47,22,25
050,31,175,"Nebraska","Valley County",3,40,52,27,25
050,31,175,"Nebraska","Valley County",3,41,45,22,23
050,31,175,"Nebraska","Valley County",3,42,47,22,25
050,31,175,"Nebraska","Valley County",3,43,40,17,23
050,31,175,"Nebraska","Valley County",3,44,32,18,14
050,31,175,"Nebraska","Valley County",3,45,37,22,15
050,31,175,"Nebraska","Valley County",3,46,37,20,17
050,31,175,"Nebraska","Valley County",3,47,43,21,22
050,31,175,"Nebraska","Valley County",3,48,44,25,19
050,31,175,"Nebraska","Valley County",3,49,50,31,19
050,31,175,"Nebraska","Valley County",3,50,46,25,21
050,31,175,"Nebraska","Valley County",3,51,39,20,19
050,31,175,"Nebraska","Valley County",3,52,39,17,22
050,31,175,"Nebraska","Valley County",3,53,44,20,24
050,31,175,"Nebraska","Valley County",3,54,49,27,22
050,31,175,"Nebraska","Valley County",3,55,55,32,23
050,31,175,"Nebraska","Valley County",3,56,58,33,25
050,31,175,"Nebraska","Valley County",3,57,61,36,25
050,31,175,"Nebraska","Valley County",3,58,60,31,29
050,31,175,"Nebraska","Valley County",3,59,62,27,35
050,31,175,"Nebraska","Valley County",3,60,54,23,31
050,31,175,"Nebraska","Valley County",3,61,44,23,21
050,31,175,"Nebraska","Valley County",3,62,56,30,26
050,31,175,"Nebraska","Valley County",3,63,58,29,29
050,31,175,"Nebraska","Valley County",3,64,60,25,35
050,31,175,"Nebraska","Valley County",3,65,54,28,26
050,31,175,"Nebraska","Valley County",3,66,51,27,24
050,31,175,"Nebraska","Valley County",3,67,58,32,26
050,31,175,"Nebraska","Valley County",3,68,61,33,28
050,31,175,"Nebraska","Valley County",3,69,49,23,26
050,31,175,"Nebraska","Valley County",3,70,52,26,26
050,31,175,"Nebraska","Valley County",3,71,54,25,29
050,31,175,"Nebraska","Valley County",3,72,43,19,24
050,31,175,"Nebraska","Valley County",3,73,54,23,31
050,31,175,"Nebraska","Valley County",3,74,63,28,35
050,31,175,"Nebraska","Valley County",3,75,47,21,26
050,31,175,"Nebraska","Valley County",3,76,45,20,25
050,31,175,"Nebraska","Valley County",3,77,38,22,16
050,31,175,"Nebraska","Valley County",3,78,35,18,17
050,31,175,"Nebraska","Valley County",3,79,39,21,18
050,31,175,"Nebraska","Valley County",3,80,31,14,17
050,31,175,"Nebraska","Valley County",3,81,30,15,15
050,31,175,"Nebraska","Valley County",3,82,24,14,10
050,31,175,"Nebraska","Valley County",3,83,26,14,12
050,31,175,"Nebraska","Valley County",3,84,20,10,10
050,31,175,"Nebraska","Valley County",3,85,128,53,75
050,31,175,"Nebraska","Valley County",4,0,50,27,23
050,31,175,"Nebraska","Valley County",4,1,52,26,26
050,31,175,"Nebraska","Valley County",4,2,47,25,22
050,31,175,"Nebraska","Valley County",4,3,50,25,25
050,31,175,"Nebraska","Valley County",4,4,43,18,25
050,31,175,"Nebraska","Valley County",4,5,52,21,31
050,31,175,"Nebraska","Valley County",4,6,46,22,24
050,31,175,"Nebraska","Valley County",4,7,58,29,29
050,31,175,"Nebraska","Valley County",4,8,58,31,27
050,31,175,"Nebraska","Valley County",4,9,54,30,24
050,31,175,"Nebraska","Valley County",4,10,59,31,28
050,31,175,"Nebraska","Valley County",4,11,64,24,40
050,31,175,"Nebraska","Valley County",4,12,55,28,27
050,31,175,"Nebraska","Valley County",4,13,52,28,24
050,31,175,"Nebraska","Valley County",4,14,64,36,28
050,31,175,"Nebraska","Valley County",4,15,53,25,28
050,31,175,"Nebraska","Valley County",4,16,48,28,20
050,31,175,"Nebraska","Valley County",4,17,52,30,22
050,31,175,"Nebraska","Valley County",4,18,49,23,26
050,31,175,"Nebraska","Valley County",4,19,42,21,21
050,31,175,"Nebraska","Valley County",4,20,38,20,18
050,31,175,"Nebraska","Valley County",4,21,34,17,17
050,31,175,"Nebraska","Valley County",4,22,37,18,19
050,31,175,"Nebraska","Valley County",4,23,29,15,14
050,31,175,"Nebraska","Valley County",4,24,45,22,23
050,31,175,"Nebraska","Valley County",4,25,41,25,16
050,31,175,"Nebraska","Valley County",4,26,40,20,20
050,31,175,"Nebraska","Valley County",4,27,35,15,20
050,31,175,"Nebraska","Valley County",4,28,48,22,26
050,31,175,"Nebraska","Valley County",4,29,44,21,23
050,31,175,"Nebraska","Valley County",4,30,41,19,22
050,31,175,"Nebraska","Valley County",4,31,39,22,17
050,31,175,"Nebraska","Valley County",4,32,44,23,21
050,31,175,"Nebraska","Valley County",4,33,45,26,19
050,31,175,"Nebraska","Valley County",4,34,31,16,15
050,31,175,"Nebraska","Valley County",4,35,36,16,20
050,31,175,"Nebraska","Valley County",4,36,45,24,21
050,31,175,"Nebraska","Valley County",4,37,45,24,21
050,31,175,"Nebraska","Valley County",4,38,44,21,23
050,31,175,"Nebraska","Valley County",4,39,50,25,25
050,31,175,"Nebraska","Valley County",4,40,48,23,25
050,31,175,"Nebraska","Valley County",4,41,48,24,24
050,31,175,"Nebraska","Valley County",4,42,45,22,23
050,31,175,"Nebraska","Valley County",4,43,44,20,24
050,31,175,"Nebraska","Valley County",4,44,40,17,23
050,31,175,"Nebraska","Valley County",4,45,33,17,16
050,31,175,"Nebraska","Valley County",4,46,42,23,19
050,31,175,"Nebraska","Valley County",4,47,36,18,18
050,31,175,"Nebraska","Valley County",4,48,43,20,23
050,31,175,"Nebraska","Valley County",4,49,46,26,20
050,31,175,"Nebraska","Valley County",4,50,44,30,14
050,31,175,"Nebraska","Valley County",4,51,49,28,21
050,31,175,"Nebraska","Valley County",4,52,39,20,19
050,31,175,"Nebraska","Valley County",4,53,44,23,21
050,31,175,"Nebraska","Valley County",4,54,43,21,22
050,31,175,"Nebraska","Valley County",4,55,46,24,22
050,31,175,"Nebraska","Valley County",4,56,55,32,23
050,31,175,"Nebraska","Valley County",4,57,52,30,22
050,31,175,"Nebraska","Valley County",4,58,54,33,21
050,31,175,"Nebraska","Valley County",4,59,59,30,29
050,31,175,"Nebraska","Valley County",4,60,60,25,35
050,31,175,"Nebraska","Valley County",4,61,53,23,30
050,31,175,"Nebraska","Valley County",4,62,44,24,20
050,31,175,"Nebraska","Valley County",4,63,59,30,29
050,31,175,"Nebraska","Valley County",4,64,58,29,29
050,31,175,"Nebraska","Valley County",4,65,61,26,35
050,31,175,"Nebraska","Valley County",4,66,54,28,26
050,31,175,"Nebraska","Valley County",4,67,49,25,24
050,31,175,"Nebraska","Valley County",4,68,58,31,27
050,31,175,"Nebraska","Valley County",4,69,63,34,29
050,31,175,"Nebraska","Valley County",4,70,52,26,26
050,31,175,"Nebraska","Valley County",4,71,54,25,29
050,31,175,"Nebraska","Valley County",4,72,52,25,27
050,31,175,"Nebraska","Valley County",4,73,41,20,21
050,31,175,"Nebraska","Valley County",4,74,49,20,29
050,31,175,"Nebraska","Valley County",4,75,62,25,37
050,31,175,"Nebraska","Valley County",4,76,46,20,26
050,31,175,"Nebraska","Valley County",4,77,44,21,23
050,31,175,"Nebraska","Valley County",4,78,38,22,16
050,31,175,"Nebraska","Valley County",4,79,33,17,16
050,31,175,"Nebraska","Valley County",4,80,34,19,15
050,31,175,"Nebraska","Valley County",4,81,31,13,18
050,31,175,"Nebraska","Valley County",4,82,29,16,13
050,31,175,"Nebraska","Valley County",4,83,21,11,10
050,31,175,"Nebraska","Valley County",4,84,23,14,9
050,31,175,"Nebraska","Valley County",4,85,121,48,73
050,31,175,"Nebraska","Valley County",5,0,51,26,25
050,31,175,"Nebraska","Valley County",5,1,53,24,29
050,31,175,"Nebraska","Valley County",5,2,57,29,28
050,31,175,"Nebraska","Valley County",5,3,49,29,20
050,31,175,"Nebraska","Valley County",5,4,45,24,21
050,31,175,"Nebraska","Valley County",5,5,44,20,24
050,31,175,"Nebraska","Valley County",5,6,48,20,28
050,31,175,"Nebraska","Valley County",5,7,44,19,25
050,31,175,"Nebraska","Valley County",5,8,55,26,29
050,31,175,"Nebraska","Valley County",5,9,58,31,27
050,31,175,"Nebraska","Valley County",5,10,53,29,24
050,31,175,"Nebraska","Valley County",5,11,57,29,28
050,31,175,"Nebraska","Valley County",5,12,62,23,39
050,31,175,"Nebraska","Valley County",5,13,54,29,25
050,31,175,"Nebraska","Valley County",5,14,52,28,24
050,31,175,"Nebraska","Valley County",5,15,62,36,26
050,31,175,"Nebraska","Valley County",5,16,49,23,26
050,31,175,"Nebraska","Valley County",5,17,49,28,21
050,31,175,"Nebraska","Valley County",5,18,38,24,14
050,31,175,"Nebraska","Valley County",5,19,35,18,17
050,31,175,"Nebraska","Valley County",5,20,44,21,23
050,31,175,"Nebraska","Valley County",5,21,38,18,20
050,31,175,"Nebraska","Valley County",5,22,36,16,20
050,31,175,"Nebraska","Valley County",5,23,36,17,19
050,31,175,"Nebraska","Valley County",5,24,37,19,18
050,31,175,"Nebraska","Valley County",5,25,43,22,21
050,31,175,"Nebraska","Valley County",5,26,40,23,17
050,31,175,"Nebraska","Valley County",5,27,38,19,19
050,31,175,"Nebraska","Valley County",5,28,35,18,17
050,31,175,"Nebraska","Valley County",5,29,49,23,26
050,31,175,"Nebraska","Valley County",5,30,42,19,23
050,31,175,"Nebraska","Valley County",5,31,43,21,22
050,31,175,"Nebraska","Valley County",5,32,39,19,20
050,31,175,"Nebraska","Valley County",5,33,42,22,20
050,31,175,"Nebraska","Valley County",5,34,46,27,19
050,31,175,"Nebraska","Valley County",5,35,30,16,14
050,31,175,"Nebraska","Valley County",5,36,37,17,20
050,31,175,"Nebraska","Valley County",5,37,45,24,21
050,31,175,"Nebraska","Valley County",5,38,46,24,22
050,31,175,"Nebraska","Valley County",5,39,44,19,25
050,31,175,"Nebraska","Valley County",5,40,48,23,25
050,31,175,"Nebraska","Valley County",5,41,51,26,25
050,31,175,"Nebraska","Valley County",5,42,47,24,23
050,31,175,"Nebraska","Valley County",5,43,44,23,21
050,31,175,"Nebraska","Valley County",5,44,39,17,22
050,31,175,"Nebraska","Valley County",5,45,36,17,19
050,31,175,"Nebraska","Valley County",5,46,32,16,16
050,31,175,"Nebraska","Valley County",5,47,41,22,19
050,31,175,"Nebraska","Valley County",5,48,35,18,17
050,31,175,"Nebraska","Valley County",5,49,42,21,21
050,31,175,"Nebraska","Valley County",5,50,45,25,20
050,31,175,"Nebraska","Valley County",5,51,43,30,13
050,31,175,"Nebraska","Valley County",5,52,48,27,21
050,31,175,"Nebraska","Valley County",5,53,39,20,19
050,31,175,"Nebraska","Valley County",5,54,44,23,21
050,31,175,"Nebraska","Valley County",5,55,47,22,25
050,31,175,"Nebraska","Valley County",5,56,46,25,21
050,31,175,"Nebraska","Valley County",5,57,54,32,22
050,31,175,"Nebraska","Valley County",5,58,56,33,23
050,31,175,"Nebraska","Valley County",5,59,56,32,24
050,31,175,"Nebraska","Valley County",5,60,57,28,29
050,31,175,"Nebraska","Valley County",5,61,59,23,36
050,31,175,"Nebraska","Valley County",5,62,53,23,30
050,31,175,"Nebraska","Valley County",5,63,44,24,20
050,31,175,"Nebraska","Valley County",5,64,58,29,29
050,31,175,"Nebraska","Valley County",5,65,59,30,29
050,31,175,"Nebraska","Valley County",5,66,59,25,34
050,31,175,"Nebraska","Valley County",5,67,53,28,25
050,31,175,"Nebraska","Valley County",5,68,46,24,22
050,31,175,"Nebraska","Valley County",5,69,60,33,27
050,31,175,"Nebraska","Valley County",5,70,61,33,28
050,31,175,"Nebraska","Valley County",5,71,49,24,25
050,31,175,"Nebraska","Valley County",5,72,53,25,28
050,31,175,"Nebraska","Valley County",5,73,52,26,26
050,31,175,"Nebraska","Valley County",5,74,34,17,17
050,31,175,"Nebraska","Valley County",5,75,48,17,31
050,31,175,"Nebraska","Valley County",5,76,62,25,37
050,31,175,"Nebraska","Valley County",5,77,44,19,25
050,31,175,"Nebraska","Valley County",5,78,45,20,25
050,31,175,"Nebraska","Valley County",5,79,37,21,16
050,31,175,"Nebraska","Valley County",5,80,29,15,14
050,31,175,"Nebraska","Valley County",5,81,34,19,15
050,31,175,"Nebraska","Valley County",5,82,30,13,17
050,31,175,"Nebraska","Valley County",5,83,26,13,13
050,31,175,"Nebraska","Valley County",5,84,18,11,7
050,31,175,"Nebraska","Valley County",5,85,124,51,73
050,31,177,"Nebraska","Washington County",1,0,199,103,96
050,31,177,"Nebraska","Washington County",1,1,221,123,98
050,31,177,"Nebraska","Washington County",1,2,214,117,97
050,31,177,"Nebraska","Washington County",1,3,230,120,110
050,31,177,"Nebraska","Washington County",1,4,270,144,126
050,31,177,"Nebraska","Washington County",1,5,286,159,127
050,31,177,"Nebraska","Washington County",1,6,282,134,148
050,31,177,"Nebraska","Washington County",1,7,286,142,144
050,31,177,"Nebraska","Washington County",1,8,284,144,140
050,31,177,"Nebraska","Washington County",1,9,289,148,141
050,31,177,"Nebraska","Washington County",1,10,321,172,149
050,31,177,"Nebraska","Washington County",1,11,297,158,139
050,31,177,"Nebraska","Washington County",1,12,323,166,157
050,31,177,"Nebraska","Washington County",1,13,332,175,157
050,31,177,"Nebraska","Washington County",1,14,310,157,153
050,31,177,"Nebraska","Washington County",1,15,278,140,138
050,31,177,"Nebraska","Washington County",1,16,318,160,158
050,31,177,"Nebraska","Washington County",1,17,332,173,159
050,31,177,"Nebraska","Washington County",1,18,276,147,129
050,31,177,"Nebraska","Washington County",1,19,202,110,92
050,31,177,"Nebraska","Washington County",1,20,218,118,100
050,31,177,"Nebraska","Washington County",1,21,218,116,102
050,31,177,"Nebraska","Washington County",1,22,232,114,118
050,31,177,"Nebraska","Washington County",1,23,188,87,101
050,31,177,"Nebraska","Washington County",1,24,198,108,90
050,31,177,"Nebraska","Washington County",1,25,196,98,98
050,31,177,"Nebraska","Washington County",1,26,185,93,92
050,31,177,"Nebraska","Washington County",1,27,201,96,105
050,31,177,"Nebraska","Washington County",1,28,182,88,94
050,31,177,"Nebraska","Washington County",1,29,189,93,96
050,31,177,"Nebraska","Washington County",1,30,195,92,103
050,31,177,"Nebraska","Washington County",1,31,182,95,87
050,31,177,"Nebraska","Washington County",1,32,202,104,98
050,31,177,"Nebraska","Washington County",1,33,220,111,109
050,31,177,"Nebraska","Washington County",1,34,240,125,115
050,31,177,"Nebraska","Washington County",1,35,236,121,115
050,31,177,"Nebraska","Washington County",1,36,278,133,145
050,31,177,"Nebraska","Washington County",1,37,296,150,146
050,31,177,"Nebraska","Washington County",1,38,274,145,129
050,31,177,"Nebraska","Washington County",1,39,286,146,140
050,31,177,"Nebraska","Washington County",1,40,295,159,136
050,31,177,"Nebraska","Washington County",1,41,289,144,145
050,31,177,"Nebraska","Washington County",1,42,264,140,124
050,31,177,"Nebraska","Washington County",1,43,261,140,121
050,31,177,"Nebraska","Washington County",1,44,247,125,122
050,31,177,"Nebraska","Washington County",1,45,223,112,111
050,31,177,"Nebraska","Washington County",1,46,221,108,113
050,31,177,"Nebraska","Washington County",1,47,264,134,130
050,31,177,"Nebraska","Washington County",1,48,279,135,144
050,31,177,"Nebraska","Washington County",1,49,286,155,131
050,31,177,"Nebraska","Washington County",1,50,248,125,123
050,31,177,"Nebraska","Washington County",1,51,245,119,126
050,31,177,"Nebraska","Washington County",1,52,255,128,127
050,31,177,"Nebraska","Washington County",1,53,268,133,135
050,31,177,"Nebraska","Washington County",1,54,290,144,146
050,31,177,"Nebraska","Washington County",1,55,337,165,172
050,31,177,"Nebraska","Washington County",1,56,335,167,168
050,31,177,"Nebraska","Washington County",1,57,335,162,173
050,31,177,"Nebraska","Washington County",1,58,331,163,168
050,31,177,"Nebraska","Washington County",1,59,318,162,156
050,31,177,"Nebraska","Washington County",1,60,318,170,148
050,31,177,"Nebraska","Washington County",1,61,304,160,144
050,31,177,"Nebraska","Washington County",1,62,302,163,139
050,31,177,"Nebraska","Washington County",1,63,279,142,137
050,31,177,"Nebraska","Washington County",1,64,276,133,143
050,31,177,"Nebraska","Washington County",1,65,284,137,147
050,31,177,"Nebraska","Washington County",1,66,288,136,152
050,31,177,"Nebraska","Washington County",1,67,241,125,116
050,31,177,"Nebraska","Washington County",1,68,249,131,118
050,31,177,"Nebraska","Washington County",1,69,244,118,126
050,31,177,"Nebraska","Washington County",1,70,237,114,123
050,31,177,"Nebraska","Washington County",1,71,230,108,122
050,31,177,"Nebraska","Washington County",1,72,235,117,118
050,31,177,"Nebraska","Washington County",1,73,222,118,104
050,31,177,"Nebraska","Washington County",1,74,155,78,77
050,31,177,"Nebraska","Washington County",1,75,155,76,79
050,31,177,"Nebraska","Washington County",1,76,138,66,72
050,31,177,"Nebraska","Washington County",1,77,136,66,70
050,31,177,"Nebraska","Washington County",1,78,105,49,56
050,31,177,"Nebraska","Washington County",1,79,94,38,56
050,31,177,"Nebraska","Washington County",1,80,86,33,53
050,31,177,"Nebraska","Washington County",1,81,83,34,49
050,31,177,"Nebraska","Washington County",1,82,76,39,37
050,31,177,"Nebraska","Washington County",1,83,69,29,40
050,31,177,"Nebraska","Washington County",1,84,78,33,45
050,31,177,"Nebraska","Washington County",1,85,421,141,280
050,31,177,"Nebraska","Washington County",2,0,202,110,92
050,31,177,"Nebraska","Washington County",2,1,217,120,97
050,31,177,"Nebraska","Washington County",2,2,218,118,100
050,31,177,"Nebraska","Washington County",2,3,231,122,109
050,31,177,"Nebraska","Washington County",2,4,266,142,124
050,31,177,"Nebraska","Washington County",2,5,282,155,127
050,31,177,"Nebraska","Washington County",2,6,286,142,144
050,31,177,"Nebraska","Washington County",2,7,284,139,145
050,31,177,"Nebraska","Washington County",2,8,287,145,142
050,31,177,"Nebraska","Washington County",2,9,289,148,141
050,31,177,"Nebraska","Washington County",2,10,313,166,147
050,31,177,"Nebraska","Washington County",2,11,305,161,144
050,31,177,"Nebraska","Washington County",2,12,320,165,155
050,31,177,"Nebraska","Washington County",2,13,330,172,158
050,31,177,"Nebraska","Washington County",2,14,313,159,154
050,31,177,"Nebraska","Washington County",2,15,285,142,143
050,31,177,"Nebraska","Washington County",2,16,307,155,152
050,31,177,"Nebraska","Washington County",2,17,332,172,160
050,31,177,"Nebraska","Washington County",2,18,277,148,129
050,31,177,"Nebraska","Washington County",2,19,210,114,96
050,31,177,"Nebraska","Washington County",2,20,221,120,101
050,31,177,"Nebraska","Washington County",2,21,224,119,105
050,31,177,"Nebraska","Washington County",2,22,228,114,114
050,31,177,"Nebraska","Washington County",2,23,203,98,105
050,31,177,"Nebraska","Washington County",2,24,198,104,94
050,31,177,"Nebraska","Washington County",2,25,198,102,96
050,31,177,"Nebraska","Washington County",2,26,188,95,93
050,31,177,"Nebraska","Washington County",2,27,195,94,101
050,31,177,"Nebraska","Washington County",2,28,187,89,98
050,31,177,"Nebraska","Washington County",2,29,188,91,97
050,31,177,"Nebraska","Washington County",2,30,196,93,103
050,31,177,"Nebraska","Washington County",2,31,186,95,91
050,31,177,"Nebraska","Washington County",2,32,199,102,97
050,31,177,"Nebraska","Washington County",2,33,219,110,109
050,31,177,"Nebraska","Washington County",2,34,234,120,114
050,31,177,"Nebraska","Washington County",2,35,240,123,117
050,31,177,"Nebraska","Washington County",2,36,271,131,140
050,31,177,"Nebraska","Washington County",2,37,296,149,147
050,31,177,"Nebraska","Washington County",2,38,283,148,135
050,31,177,"Nebraska","Washington County",2,39,285,148,137
050,31,177,"Nebraska","Washington County",2,40,295,157,138
050,31,177,"Nebraska","Washington County",2,41,290,147,143
050,31,177,"Nebraska","Washington County",2,42,269,141,128
050,31,177,"Nebraska","Washington County",2,43,267,143,124
050,31,177,"Nebraska","Washington County",2,44,249,128,121
050,31,177,"Nebraska","Washington County",2,45,231,117,114
050,31,177,"Nebraska","Washington County",2,46,222,109,113
050,31,177,"Nebraska","Washington County",2,47,253,128,125
050,31,177,"Nebraska","Washington County",2,48,277,136,141
050,31,177,"Nebraska","Washington County",2,49,287,151,136
050,31,177,"Nebraska","Washington County",2,50,258,133,125
050,31,177,"Nebraska","Washington County",2,51,244,120,124
050,31,177,"Nebraska","Washington County",2,52,253,126,127
050,31,177,"Nebraska","Washington County",2,53,267,132,135
050,31,177,"Nebraska","Washington County",2,54,284,140,144
050,31,177,"Nebraska","Washington County",2,55,327,161,166
050,31,177,"Nebraska","Washington County",2,56,338,168,170
050,31,177,"Nebraska","Washington County",2,57,334,163,171
050,31,177,"Nebraska","Washington County",2,58,330,161,169
050,31,177,"Nebraska","Washington County",2,59,321,162,159
050,31,177,"Nebraska","Washington County",2,60,318,168,150
050,31,177,"Nebraska","Washington County",2,61,306,162,144
050,31,177,"Nebraska","Washington County",2,62,300,161,139
050,31,177,"Nebraska","Washington County",2,63,288,148,140
050,31,177,"Nebraska","Washington County",2,64,273,133,140
050,31,177,"Nebraska","Washington County",2,65,282,136,146
050,31,177,"Nebraska","Washington County",2,66,287,136,151
050,31,177,"Nebraska","Washington County",2,67,249,126,123
050,31,177,"Nebraska","Washington County",2,68,246,130,116
050,31,177,"Nebraska","Washington County",2,69,245,120,125
050,31,177,"Nebraska","Washington County",2,70,237,113,124
050,31,177,"Nebraska","Washington County",2,71,232,109,123
050,31,177,"Nebraska","Washington County",2,72,227,111,116
050,31,177,"Nebraska","Washington County",2,73,236,123,113
050,31,177,"Nebraska","Washington County",2,74,161,82,79
050,31,177,"Nebraska","Washington County",2,75,156,77,79
050,31,177,"Nebraska","Washington County",2,76,141,68,73
050,31,177,"Nebraska","Washington County",2,77,138,67,71
050,31,177,"Nebraska","Washington County",2,78,110,51,59
050,31,177,"Nebraska","Washington County",2,79,95,41,54
050,31,177,"Nebraska","Washington County",2,80,87,34,53
050,31,177,"Nebraska","Washington County",2,81,83,34,49
050,31,177,"Nebraska","Washington County",2,82,76,36,40
050,31,177,"Nebraska","Washington County",2,83,68,30,38
050,31,177,"Nebraska","Washington County",2,84,75,30,45
050,31,177,"Nebraska","Washington County",2,85,422,142,280
050,31,177,"Nebraska","Washington County",3,0,201,102,99
050,31,177,"Nebraska","Washington County",3,1,199,107,92
050,31,177,"Nebraska","Washington County",3,2,223,121,102
050,31,177,"Nebraska","Washington County",3,3,229,123,106
050,31,177,"Nebraska","Washington County",3,4,245,128,117
050,31,177,"Nebraska","Washington County",3,5,281,146,135
050,31,177,"Nebraska","Washington County",3,6,288,161,127
050,31,177,"Nebraska","Washington County",3,7,292,148,144
050,31,177,"Nebraska","Washington County",3,8,284,140,144
050,31,177,"Nebraska","Washington County",3,9,301,149,152
050,31,177,"Nebraska","Washington County",3,10,287,147,140
050,31,177,"Nebraska","Washington County",3,11,316,166,150
050,31,177,"Nebraska","Washington County",3,12,300,162,138
050,31,177,"Nebraska","Washington County",3,13,329,165,164
050,31,177,"Nebraska","Washington County",3,14,326,171,155
050,31,177,"Nebraska","Washington County",3,15,307,160,147
050,31,177,"Nebraska","Washington County",3,16,297,151,146
050,31,177,"Nebraska","Washington County",3,17,307,155,152
050,31,177,"Nebraska","Washington County",3,18,284,151,133
050,31,177,"Nebraska","Washington County",3,19,211,112,99
050,31,177,"Nebraska","Washington County",3,20,233,125,108
050,31,177,"Nebraska","Washington County",3,21,227,126,101
050,31,177,"Nebraska","Washington County",3,22,229,119,110
050,31,177,"Nebraska","Washington County",3,23,231,114,117
050,31,177,"Nebraska","Washington County",3,24,186,91,95
050,31,177,"Nebraska","Washington County",3,25,199,98,101
050,31,177,"Nebraska","Washington County",3,26,189,101,88
050,31,177,"Nebraska","Washington County",3,27,193,102,91
050,31,177,"Nebraska","Washington County",3,28,195,92,103
050,31,177,"Nebraska","Washington County",3,29,192,96,96
050,31,177,"Nebraska","Washington County",3,30,189,88,101
050,31,177,"Nebraska","Washington County",3,31,218,104,114
050,31,177,"Nebraska","Washington County",3,32,193,104,89
050,31,177,"Nebraska","Washington County",3,33,212,108,104
050,31,177,"Nebraska","Washington County",3,34,227,116,111
050,31,177,"Nebraska","Washington County",3,35,239,127,112
050,31,177,"Nebraska","Washington County",3,36,266,134,132
050,31,177,"Nebraska","Washington County",3,37,274,133,141
050,31,177,"Nebraska","Washington County",3,38,304,153,151
050,31,177,"Nebraska","Washington County",3,39,281,152,129
050,31,177,"Nebraska","Washington County",3,40,290,148,142
050,31,177,"Nebraska","Washington County",3,41,302,158,144
050,31,177,"Nebraska","Washington County",3,42,301,155,146
050,31,177,"Nebraska","Washington County",3,43,266,145,121
050,31,177,"Nebraska","Washington County",3,44,271,145,126
050,31,177,"Nebraska","Washington County",3,45,258,133,125
050,31,177,"Nebraska","Washington County",3,46,235,117,118
050,31,177,"Nebraska","Washington County",3,47,221,107,114
050,31,177,"Nebraska","Washington County",3,48,243,123,120
050,31,177,"Nebraska","Washington County",3,49,280,136,144
050,31,177,"Nebraska","Washington County",3,50,288,154,134
050,31,177,"Nebraska","Washington County",3,51,254,134,120
050,31,177,"Nebraska","Washington County",3,52,243,120,123
050,31,177,"Nebraska","Washington County",3,53,249,124,125
050,31,177,"Nebraska","Washington County",3,54,265,129,136
050,31,177,"Nebraska","Washington County",3,55,286,144,142
050,31,177,"Nebraska","Washington County",3,56,322,158,164
050,31,177,"Nebraska","Washington County",3,57,340,165,175
050,31,177,"Nebraska","Washington County",3,58,327,159,168
050,31,177,"Nebraska","Washington County",3,59,328,164,164
050,31,177,"Nebraska","Washington County",3,60,311,155,156
050,31,177,"Nebraska","Washington County",3,61,314,168,146
050,31,177,"Nebraska","Washington County",3,62,304,157,147
050,31,177,"Nebraska","Washington County",3,63,307,166,141
050,31,177,"Nebraska","Washington County",3,64,295,153,142
050,31,177,"Nebraska","Washington County",3,65,262,131,131
050,31,177,"Nebraska","Washington County",3,66,277,136,141
050,31,177,"Nebraska","Washington County",3,67,280,130,150
050,31,177,"Nebraska","Washington County",3,68,243,124,119
050,31,177,"Nebraska","Washington County",3,69,237,123,114
050,31,177,"Nebraska","Washington County",3,70,233,115,118
050,31,177,"Nebraska","Washington County",3,71,229,110,119
050,31,177,"Nebraska","Washington County",3,72,220,104,116
050,31,177,"Nebraska","Washington County",3,73,219,106,113
050,31,177,"Nebraska","Washington County",3,74,224,115,109
050,31,177,"Nebraska","Washington County",3,75,147,75,72
050,31,177,"Nebraska","Washington County",3,76,155,75,80
050,31,177,"Nebraska","Washington County",3,77,137,66,71
050,31,177,"Nebraska","Washington County",3,78,132,64,68
050,31,177,"Nebraska","Washington County",3,79,106,49,57
050,31,177,"Nebraska","Washington County",3,80,98,42,56
050,31,177,"Nebraska","Washington County",3,81,83,33,50
050,31,177,"Nebraska","Washington County",3,82,76,29,47
050,31,177,"Nebraska","Washington County",3,83,71,33,38
050,31,177,"Nebraska","Washington County",3,84,67,26,41
050,31,177,"Nebraska","Washington County",3,85,411,141,270
050,31,177,"Nebraska","Washington County",4,0,201,108,93
050,31,177,"Nebraska","Washington County",4,1,192,94,98
050,31,177,"Nebraska","Washington County",4,2,227,126,101
050,31,177,"Nebraska","Washington County",4,3,232,128,104
050,31,177,"Nebraska","Washington County",4,4,244,132,112
050,31,177,"Nebraska","Washington County",4,5,251,131,120
050,31,177,"Nebraska","Washington County",4,6,284,154,130
050,31,177,"Nebraska","Washington County",4,7,312,176,136
050,31,177,"Nebraska","Washington County",4,8,297,152,145
050,31,177,"Nebraska","Washington County",4,9,289,139,150
050,31,177,"Nebraska","Washington County",4,10,305,153,152
050,31,177,"Nebraska","Washington County",4,11,287,144,143
050,31,177,"Nebraska","Washington County",4,12,324,169,155
050,31,177,"Nebraska","Washington County",4,13,302,163,139
050,31,177,"Nebraska","Washington County",4,14,339,169,170
050,31,177,"Nebraska","Washington County",4,15,328,173,155
050,31,177,"Nebraska","Washington County",4,16,320,169,151
050,31,177,"Nebraska","Washington County",4,17,282,141,141
050,31,177,"Nebraska","Washington County",4,18,249,130,119
050,31,177,"Nebraska","Washington County",4,19,218,115,103
050,31,177,"Nebraska","Washington County",4,20,229,124,105
050,31,177,"Nebraska","Washington County",4,21,230,120,110
050,31,177,"Nebraska","Washington County",4,22,244,135,109
050,31,177,"Nebraska","Washington County",4,23,225,118,107
050,31,177,"Nebraska","Washington County",4,24,224,109,115
050,31,177,"Nebraska","Washington County",4,25,195,95,100
050,31,177,"Nebraska","Washington County",4,26,198,96,102
050,31,177,"Nebraska","Washington County",4,27,195,107,88
050,31,177,"Nebraska","Washington County",4,28,203,106,97
050,31,177,"Nebraska","Washington County",4,29,199,96,103
050,31,177,"Nebraska","Washington County",4,30,197,95,102
050,31,177,"Nebraska","Washington County",4,31,190,90,100
050,31,177,"Nebraska","Washington County",4,32,229,109,120
050,31,177,"Nebraska","Washington County",4,33,210,113,97
050,31,177,"Nebraska","Washington County",4,34,223,112,111
050,31,177,"Nebraska","Washington County",4,35,245,127,118
050,31,177,"Nebraska","Washington County",4,36,259,142,117
050,31,177,"Nebraska","Washington County",4,37,277,138,139
050,31,177,"Nebraska","Washington County",4,38,282,136,146
050,31,177,"Nebraska","Washington County",4,39,321,164,157
050,31,177,"Nebraska","Washington County",4,40,286,156,130
050,31,177,"Nebraska","Washington County",4,41,292,153,139
050,31,177,"Nebraska","Washington County",4,42,297,156,141
050,31,177,"Nebraska","Washington County",4,43,297,156,141
050,31,177,"Nebraska","Washington County",4,44,275,147,128
050,31,177,"Nebraska","Washington County",4,45,270,144,126
050,31,177,"Nebraska","Washington County",4,46,257,129,128
050,31,177,"Nebraska","Washington County",4,47,237,123,114
050,31,177,"Nebraska","Washington County",4,48,223,109,114
050,31,177,"Nebraska","Washington County",4,49,251,129,122
050,31,177,"Nebraska","Washington County",4,50,281,132,149
050,31,177,"Nebraska","Washington County",4,51,290,155,135
050,31,177,"Nebraska","Washington County",4,52,251,134,117
050,31,177,"Nebraska","Washington County",4,53,236,117,119
050,31,177,"Nebraska","Washington County",4,54,257,128,129
050,31,177,"Nebraska","Washington County",4,55,264,127,137
050,31,177,"Nebraska","Washington County",4,56,278,140,138
050,31,177,"Nebraska","Washington County",4,57,318,160,158
050,31,177,"Nebraska","Washington County",4,58,333,160,173
050,31,177,"Nebraska","Washington County",4,59,330,163,167
050,31,177,"Nebraska","Washington County",4,60,323,160,163
050,31,177,"Nebraska","Washington County",4,61,304,150,154
050,31,177,"Nebraska","Washington County",4,62,317,172,145
050,31,177,"Nebraska","Washington County",4,63,290,150,140
050,31,177,"Nebraska","Washington County",4,64,309,168,141
050,31,177,"Nebraska","Washington County",4,65,297,154,143
050,31,177,"Nebraska","Washington County",4,66,263,136,127
050,31,177,"Nebraska","Washington County",4,67,277,134,143
050,31,177,"Nebraska","Washington County",4,68,283,131,152
050,31,177,"Nebraska","Washington County",4,69,230,119,111
050,31,177,"Nebraska","Washington County",4,70,227,119,108
050,31,177,"Nebraska","Washington County",4,71,227,111,116
050,31,177,"Nebraska","Washington County",4,72,232,108,124
050,31,177,"Nebraska","Washington County",4,73,212,96,116
050,31,177,"Nebraska","Washington County",4,74,202,96,106
050,31,177,"Nebraska","Washington County",4,75,216,108,108
050,31,177,"Nebraska","Washington County",4,76,143,73,70
050,31,177,"Nebraska","Washington County",4,77,148,74,74
050,31,177,"Nebraska","Washington County",4,78,130,61,69
050,31,177,"Nebraska","Washington County",4,79,121,59,62
050,31,177,"Nebraska","Washington County",4,80,110,49,61
050,31,177,"Nebraska","Washington County",4,81,90,38,52
050,31,177,"Nebraska","Washington County",4,82,76,29,47
050,31,177,"Nebraska","Washington County",4,83,69,23,46
050,31,177,"Nebraska","Washington County",4,84,72,28,44
050,31,177,"Nebraska","Washington County",4,85,418,137,281
050,31,177,"Nebraska","Washington County",5,0,204,112,92
050,31,177,"Nebraska","Washington County",5,1,211,107,104
050,31,177,"Nebraska","Washington County",5,2,197,96,101
050,31,177,"Nebraska","Washington County",5,3,232,129,103
050,31,177,"Nebraska","Washington County",5,4,233,122,111
050,31,177,"Nebraska","Washington County",5,5,270,149,121
050,31,177,"Nebraska","Washington County",5,6,266,139,127
050,31,177,"Nebraska","Washington County",5,7,291,158,133
050,31,177,"Nebraska","Washington County",5,8,307,175,132
050,31,177,"Nebraska","Washington County",5,9,303,151,152
050,31,177,"Nebraska","Washington County",5,10,288,146,142
050,31,177,"Nebraska","Washington County",5,11,305,153,152
050,31,177,"Nebraska","Washington County",5,12,285,145,140
050,31,177,"Nebraska","Washington County",5,13,307,163,144
050,31,177,"Nebraska","Washington County",5,14,294,156,138
050,31,177,"Nebraska","Washington County",5,15,334,170,164
050,31,177,"Nebraska","Washington County",5,16,316,168,148
050,31,177,"Nebraska","Washington County",5,17,316,165,151
050,31,177,"Nebraska","Washington County",5,18,236,122,114
050,31,177,"Nebraska","Washington County",5,19,201,109,92
050,31,177,"Nebraska","Washington County",5,20,231,126,105
050,31,177,"Nebraska","Washington County",5,21,221,123,98
050,31,177,"Nebraska","Washington County",5,22,236,120,116
050,31,177,"Nebraska","Washington County",5,23,248,137,111
050,31,177,"Nebraska","Washington County",5,24,214,114,100
050,31,177,"Nebraska","Washington County",5,25,219,107,112
050,31,177,"Nebraska","Washington County",5,26,204,102,102
050,31,177,"Nebraska","Washington County",5,27,209,103,106
050,31,177,"Nebraska","Washington County",5,28,204,111,93
050,31,177,"Nebraska","Washington County",5,29,220,114,106
050,31,177,"Nebraska","Washington County",5,30,197,96,101
050,31,177,"Nebraska","Washington County",5,31,210,97,113
050,31,177,"Nebraska","Washington County",5,32,208,94,114
050,31,177,"Nebraska","Washington County",5,33,237,117,120
050,31,177,"Nebraska","Washington County",5,34,205,105,100
050,31,177,"Nebraska","Washington County",5,35,230,119,111
050,31,177,"Nebraska","Washington County",5,36,252,128,124
050,31,177,"Nebraska","Washington County",5,37,259,143,116
050,31,177,"Nebraska","Washington County",5,38,277,140,137
050,31,177,"Nebraska","Washington County",5,39,282,136,146
050,31,177,"Nebraska","Washington County",5,40,319,162,157
050,31,177,"Nebraska","Washington County",5,41,291,162,129
050,31,177,"Nebraska","Washington County",5,42,303,161,142
050,31,177,"Nebraska","Washington County",5,43,296,151,145
050,31,177,"Nebraska","Washington County",5,44,293,154,139
050,31,177,"Nebraska","Washington County",5,45,266,144,122
050,31,177,"Nebraska","Washington County",5,46,266,138,128
050,31,177,"Nebraska","Washington County",5,47,250,130,120
050,31,177,"Nebraska","Washington County",5,48,234,125,109
050,31,177,"Nebraska","Washington County",5,49,233,115,118
050,31,177,"Nebraska","Washington County",5,50,252,130,122
050,31,177,"Nebraska","Washington County",5,51,283,134,149
050,31,177,"Nebraska","Washington County",5,52,294,156,138
050,31,177,"Nebraska","Washington County",5,53,256,135,121
050,31,177,"Nebraska","Washington County",5,54,241,117,124
050,31,177,"Nebraska","Washington County",5,55,249,129,120
050,31,177,"Nebraska","Washington County",5,56,254,125,129
050,31,177,"Nebraska","Washington County",5,57,278,145,133
050,31,177,"Nebraska","Washington County",5,58,314,156,158
050,31,177,"Nebraska","Washington County",5,59,319,156,163
050,31,177,"Nebraska","Washington County",5,60,324,162,162
050,31,177,"Nebraska","Washington County",5,61,324,163,161
050,31,177,"Nebraska","Washington County",5,62,301,152,149
050,31,177,"Nebraska","Washington County",5,63,311,164,147
050,31,177,"Nebraska","Washington County",5,64,287,148,139
050,31,177,"Nebraska","Washington County",5,65,307,168,139
050,31,177,"Nebraska","Washington County",5,66,291,149,142
050,31,177,"Nebraska","Washington County",5,67,257,132,125
050,31,177,"Nebraska","Washington County",5,68,269,131,138
050,31,177,"Nebraska","Washington County",5,69,272,124,148
050,31,177,"Nebraska","Washington County",5,70,222,114,108
050,31,177,"Nebraska","Washington County",5,71,222,117,105
050,31,177,"Nebraska","Washington County",5,72,219,107,112
050,31,177,"Nebraska","Washington County",5,73,228,102,126
050,31,177,"Nebraska","Washington County",5,74,205,95,110
050,31,177,"Nebraska","Washington County",5,75,198,94,104
050,31,177,"Nebraska","Washington County",5,76,208,106,102
050,31,177,"Nebraska","Washington County",5,77,138,71,67
050,31,177,"Nebraska","Washington County",5,78,139,68,71
050,31,177,"Nebraska","Washington County",5,79,116,55,61
050,31,177,"Nebraska","Washington County",5,80,122,61,61
050,31,177,"Nebraska","Washington County",5,81,101,43,58
050,31,177,"Nebraska","Washington County",5,82,79,34,45
050,31,177,"Nebraska","Washington County",5,83,70,22,48
050,31,177,"Nebraska","Washington County",5,84,66,16,50
050,31,177,"Nebraska","Washington County",5,85,426,140,286
050,31,179,"Nebraska","Wayne County",1,0,96,49,47
050,31,179,"Nebraska","Wayne County",1,1,100,42,58
050,31,179,"Nebraska","Wayne County",1,2,104,52,52
050,31,179,"Nebraska","Wayne County",1,3,109,53,56
050,31,179,"Nebraska","Wayne County",1,4,110,49,61
050,31,179,"Nebraska","Wayne County",1,5,106,50,56
050,31,179,"Nebraska","Wayne County",1,6,104,47,57
050,31,179,"Nebraska","Wayne County",1,7,107,58,49
050,31,179,"Nebraska","Wayne County",1,8,96,58,38
050,31,179,"Nebraska","Wayne County",1,9,110,66,44
050,31,179,"Nebraska","Wayne County",1,10,120,72,48
050,31,179,"Nebraska","Wayne County",1,11,112,63,49
050,31,179,"Nebraska","Wayne County",1,12,127,65,62
050,31,179,"Nebraska","Wayne County",1,13,104,60,44
050,31,179,"Nebraska","Wayne County",1,14,113,58,55
050,31,179,"Nebraska","Wayne County",1,15,110,58,52
050,31,179,"Nebraska","Wayne County",1,16,121,57,64
050,31,179,"Nebraska","Wayne County",1,17,105,62,43
050,31,179,"Nebraska","Wayne County",1,18,256,105,151
050,31,179,"Nebraska","Wayne County",1,19,544,250,294
050,31,179,"Nebraska","Wayne County",1,20,459,206,253
050,31,179,"Nebraska","Wayne County",1,21,408,214,194
050,31,179,"Nebraska","Wayne County",1,22,303,159,144
050,31,179,"Nebraska","Wayne County",1,23,181,103,78
050,31,179,"Nebraska","Wayne County",1,24,128,67,61
050,31,179,"Nebraska","Wayne County",1,25,122,56,66
050,31,179,"Nebraska","Wayne County",1,26,94,51,43
050,31,179,"Nebraska","Wayne County",1,27,96,54,42
050,31,179,"Nebraska","Wayne County",1,28,109,73,36
050,31,179,"Nebraska","Wayne County",1,29,110,68,42
050,31,179,"Nebraska","Wayne County",1,30,114,53,61
050,31,179,"Nebraska","Wayne County",1,31,83,46,37
050,31,179,"Nebraska","Wayne County",1,32,100,56,44
050,31,179,"Nebraska","Wayne County",1,33,86,46,40
050,31,179,"Nebraska","Wayne County",1,34,90,42,48
050,31,179,"Nebraska","Wayne County",1,35,81,48,33
050,31,179,"Nebraska","Wayne County",1,36,93,52,41
050,31,179,"Nebraska","Wayne County",1,37,95,44,51
050,31,179,"Nebraska","Wayne County",1,38,95,43,52
050,31,179,"Nebraska","Wayne County",1,39,97,48,49
050,31,179,"Nebraska","Wayne County",1,40,103,52,51
050,31,179,"Nebraska","Wayne County",1,41,99,53,46
050,31,179,"Nebraska","Wayne County",1,42,92,51,41
050,31,179,"Nebraska","Wayne County",1,43,103,45,58
050,31,179,"Nebraska","Wayne County",1,44,98,45,53
050,31,179,"Nebraska","Wayne County",1,45,86,44,42
050,31,179,"Nebraska","Wayne County",1,46,80,42,38
050,31,179,"Nebraska","Wayne County",1,47,79,47,32
050,31,179,"Nebraska","Wayne County",1,48,88,48,40
050,31,179,"Nebraska","Wayne County",1,49,97,54,43
050,31,179,"Nebraska","Wayne County",1,50,91,48,43
050,31,179,"Nebraska","Wayne County",1,51,90,50,40
050,31,179,"Nebraska","Wayne County",1,52,95,54,41
050,31,179,"Nebraska","Wayne County",1,53,100,53,47
050,31,179,"Nebraska","Wayne County",1,54,104,52,52
050,31,179,"Nebraska","Wayne County",1,55,99,44,55
050,31,179,"Nebraska","Wayne County",1,56,92,33,59
050,31,179,"Nebraska","Wayne County",1,57,107,48,59
050,31,179,"Nebraska","Wayne County",1,58,119,63,56
050,31,179,"Nebraska","Wayne County",1,59,116,66,50
050,31,179,"Nebraska","Wayne County",1,60,120,68,52
050,31,179,"Nebraska","Wayne County",1,61,100,52,48
050,31,179,"Nebraska","Wayne County",1,62,106,55,51
050,31,179,"Nebraska","Wayne County",1,63,119,60,59
050,31,179,"Nebraska","Wayne County",1,64,115,63,52
050,31,179,"Nebraska","Wayne County",1,65,119,71,48
050,31,179,"Nebraska","Wayne County",1,66,102,54,48
050,31,179,"Nebraska","Wayne County",1,67,87,40,47
050,31,179,"Nebraska","Wayne County",1,68,95,51,44
050,31,179,"Nebraska","Wayne County",1,69,82,43,39
050,31,179,"Nebraska","Wayne County",1,70,73,35,38
050,31,179,"Nebraska","Wayne County",1,71,69,37,32
050,31,179,"Nebraska","Wayne County",1,72,67,37,30
050,31,179,"Nebraska","Wayne County",1,73,64,33,31
050,31,179,"Nebraska","Wayne County",1,74,50,26,24
050,31,179,"Nebraska","Wayne County",1,75,48,24,24
050,31,179,"Nebraska","Wayne County",1,76,58,26,32
050,31,179,"Nebraska","Wayne County",1,77,60,32,28
050,31,179,"Nebraska","Wayne County",1,78,48,22,26
050,31,179,"Nebraska","Wayne County",1,79,41,20,21
050,31,179,"Nebraska","Wayne County",1,80,37,17,20
050,31,179,"Nebraska","Wayne County",1,81,36,17,19
050,31,179,"Nebraska","Wayne County",1,82,40,21,19
050,31,179,"Nebraska","Wayne County",1,83,32,14,18
050,31,179,"Nebraska","Wayne County",1,84,31,17,14
050,31,179,"Nebraska","Wayne County",1,85,264,90,174
050,31,179,"Nebraska","Wayne County",2,0,95,44,51
050,31,179,"Nebraska","Wayne County",2,1,100,44,56
050,31,179,"Nebraska","Wayne County",2,2,104,49,55
050,31,179,"Nebraska","Wayne County",2,3,105,51,54
050,31,179,"Nebraska","Wayne County",2,4,107,49,58
050,31,179,"Nebraska","Wayne County",2,5,107,50,57
050,31,179,"Nebraska","Wayne County",2,6,106,48,58
050,31,179,"Nebraska","Wayne County",2,7,104,54,50
050,31,179,"Nebraska","Wayne County",2,8,100,59,41
050,31,179,"Nebraska","Wayne County",2,9,106,63,43
050,31,179,"Nebraska","Wayne County",2,10,117,70,47
050,31,179,"Nebraska","Wayne County",2,11,113,65,48
050,31,179,"Nebraska","Wayne County",2,12,125,66,59
050,31,179,"Nebraska","Wayne County",2,13,112,63,49
050,31,179,"Nebraska","Wayne County",2,14,110,58,52
050,31,179,"Nebraska","Wayne County",2,15,111,59,52
050,31,179,"Nebraska","Wayne County",2,16,119,57,62
050,31,179,"Nebraska","Wayne County",2,17,106,60,46
050,31,179,"Nebraska","Wayne County",2,18,255,104,151
050,31,179,"Nebraska","Wayne County",2,19,544,252,292
050,31,179,"Nebraska","Wayne County",2,20,459,205,254
050,31,179,"Nebraska","Wayne County",2,21,407,213,194
050,31,179,"Nebraska","Wayne County",2,22,305,161,144
050,31,179,"Nebraska","Wayne County",2,23,178,102,76
050,31,179,"Nebraska","Wayne County",2,24,130,66,64
050,31,179,"Nebraska","Wayne County",2,25,121,60,61
050,31,179,"Nebraska","Wayne County",2,26,98,52,46
050,31,179,"Nebraska","Wayne County",2,27,94,53,41
050,31,179,"Nebraska","Wayne County",2,28,107,69,38
050,31,179,"Nebraska","Wayne County",2,29,106,66,40
050,31,179,"Nebraska","Wayne County",2,30,114,57,57
050,31,179,"Nebraska","Wayne County",2,31,91,48,43
050,31,179,"Nebraska","Wayne County",2,32,95,55,40
050,31,179,"Nebraska","Wayne County",2,33,90,49,41
050,31,179,"Nebraska","Wayne County",2,34,87,42,45
050,31,179,"Nebraska","Wayne County",2,35,84,47,37
050,31,179,"Nebraska","Wayne County",2,36,87,49,38
050,31,179,"Nebraska","Wayne County",2,37,96,47,49
050,31,179,"Nebraska","Wayne County",2,38,94,43,51
050,31,179,"Nebraska","Wayne County",2,39,98,48,50
050,31,179,"Nebraska","Wayne County",2,40,103,51,52
050,31,179,"Nebraska","Wayne County",2,41,99,51,48
050,31,179,"Nebraska","Wayne County",2,42,93,51,42
050,31,179,"Nebraska","Wayne County",2,43,103,48,55
050,31,179,"Nebraska","Wayne County",2,44,99,45,54
050,31,179,"Nebraska","Wayne County",2,45,87,43,44
050,31,179,"Nebraska","Wayne County",2,46,80,42,38
050,31,179,"Nebraska","Wayne County",2,47,79,46,33
050,31,179,"Nebraska","Wayne County",2,48,86,48,38
050,31,179,"Nebraska","Wayne County",2,49,96,54,42
050,31,179,"Nebraska","Wayne County",2,50,95,51,44
050,31,179,"Nebraska","Wayne County",2,51,89,49,40
050,31,179,"Nebraska","Wayne County",2,52,95,54,41
050,31,179,"Nebraska","Wayne County",2,53,99,53,46
050,31,179,"Nebraska","Wayne County",2,54,104,53,51
050,31,179,"Nebraska","Wayne County",2,55,100,46,54
050,31,179,"Nebraska","Wayne County",2,56,95,36,59
050,31,179,"Nebraska","Wayne County",2,57,103,45,58
050,31,179,"Nebraska","Wayne County",2,58,115,59,56
050,31,179,"Nebraska","Wayne County",2,59,118,66,52
050,31,179,"Nebraska","Wayne County",2,60,119,68,51
050,31,179,"Nebraska","Wayne County",2,61,104,55,49
050,31,179,"Nebraska","Wayne County",2,62,106,55,51
050,31,179,"Nebraska","Wayne County",2,63,117,60,57
050,31,179,"Nebraska","Wayne County",2,64,114,61,53
050,31,179,"Nebraska","Wayne County",2,65,119,70,49
050,31,179,"Nebraska","Wayne County",2,66,105,57,48
050,31,179,"Nebraska","Wayne County",2,67,90,43,47
050,31,179,"Nebraska","Wayne County",2,68,92,48,44
050,31,179,"Nebraska","Wayne County",2,69,86,45,41
050,31,179,"Nebraska","Wayne County",2,70,75,36,39
050,31,179,"Nebraska","Wayne County",2,71,71,37,34
050,31,179,"Nebraska","Wayne County",2,72,66,36,30
050,31,179,"Nebraska","Wayne County",2,73,68,36,32
050,31,179,"Nebraska","Wayne County",2,74,48,24,24
050,31,179,"Nebraska","Wayne County",2,75,49,25,24
050,31,179,"Nebraska","Wayne County",2,76,55,26,29
050,31,179,"Nebraska","Wayne County",2,77,61,31,30
050,31,179,"Nebraska","Wayne County",2,78,50,24,26
050,31,179,"Nebraska","Wayne County",2,79,42,20,22
050,31,179,"Nebraska","Wayne County",2,80,36,17,19
050,31,179,"Nebraska","Wayne County",2,81,36,17,19
050,31,179,"Nebraska","Wayne County",2,82,38,19,19
050,31,179,"Nebraska","Wayne County",2,83,33,15,18
050,31,179,"Nebraska","Wayne County",2,84,30,15,15
050,31,179,"Nebraska","Wayne County",2,85,261,92,169
050,31,179,"Nebraska","Wayne County",3,0,106,55,51
050,31,179,"Nebraska","Wayne County",3,1,93,47,46
050,31,179,"Nebraska","Wayne County",3,2,103,55,48
050,31,179,"Nebraska","Wayne County",3,3,109,51,58
050,31,179,"Nebraska","Wayne County",3,4,107,50,57
050,31,179,"Nebraska","Wayne County",3,5,115,53,62
050,31,179,"Nebraska","Wayne County",3,6,106,51,55
050,31,179,"Nebraska","Wayne County",3,7,108,48,60
050,31,179,"Nebraska","Wayne County",3,8,105,56,49
050,31,179,"Nebraska","Wayne County",3,9,99,56,43
050,31,179,"Nebraska","Wayne County",3,10,104,61,43
050,31,179,"Nebraska","Wayne County",3,11,120,72,48
050,31,179,"Nebraska","Wayne County",3,12,113,68,45
050,31,179,"Nebraska","Wayne County",3,13,134,68,66
050,31,179,"Nebraska","Wayne County",3,14,113,63,50
050,31,179,"Nebraska","Wayne County",3,15,109,56,53
050,31,179,"Nebraska","Wayne County",3,16,110,58,52
050,31,179,"Nebraska","Wayne County",3,17,124,57,67
050,31,179,"Nebraska","Wayne County",3,18,276,112,164
050,31,179,"Nebraska","Wayne County",3,19,573,267,306
050,31,179,"Nebraska","Wayne County",3,20,461,198,263
050,31,179,"Nebraska","Wayne County",3,21,428,219,209
050,31,179,"Nebraska","Wayne County",3,22,315,172,143
050,31,179,"Nebraska","Wayne County",3,23,175,105,70
050,31,179,"Nebraska","Wayne County",3,24,127,57,70
050,31,179,"Nebraska","Wayne County",3,25,113,62,51
050,31,179,"Nebraska","Wayne County",3,26,113,58,55
050,31,179,"Nebraska","Wayne County",3,27,95,54,41
050,31,179,"Nebraska","Wayne County",3,28,106,59,47
050,31,179,"Nebraska","Wayne County",3,29,107,68,39
050,31,179,"Nebraska","Wayne County",3,30,112,68,44
050,31,179,"Nebraska","Wayne County",3,31,119,59,60
050,31,179,"Nebraska","Wayne County",3,32,90,47,43
050,31,179,"Nebraska","Wayne County",3,33,94,54,40
050,31,179,"Nebraska","Wayne County",3,34,95,53,42
050,31,179,"Nebraska","Wayne County",3,35,87,44,43
050,31,179,"Nebraska","Wayne County",3,36,88,47,41
050,31,179,"Nebraska","Wayne County",3,37,92,52,40
050,31,179,"Nebraska","Wayne County",3,38,97,50,47
050,31,179,"Nebraska","Wayne County",3,39,94,37,57
050,31,179,"Nebraska","Wayne County",3,40,100,51,49
050,31,179,"Nebraska","Wayne County",3,41,100,50,50
050,31,179,"Nebraska","Wayne County",3,42,100,51,49
050,31,179,"Nebraska","Wayne County",3,43,91,53,38
050,31,179,"Nebraska","Wayne County",3,44,99,47,52
050,31,179,"Nebraska","Wayne County",3,45,98,43,55
050,31,179,"Nebraska","Wayne County",3,46,90,43,47
050,31,179,"Nebraska","Wayne County",3,47,81,43,38
050,31,179,"Nebraska","Wayne County",3,48,75,42,33
050,31,179,"Nebraska","Wayne County",3,49,91,50,41
050,31,179,"Nebraska","Wayne County",3,50,89,47,42
050,31,179,"Nebraska","Wayne County",3,51,102,55,47
050,31,179,"Nebraska","Wayne County",3,52,93,52,41
050,31,179,"Nebraska","Wayne County",3,53,94,51,43
050,31,179,"Nebraska","Wayne County",3,54,92,51,41
050,31,179,"Nebraska","Wayne County",3,55,98,52,46
050,31,179,"Nebraska","Wayne County",3,56,104,46,58
050,31,179,"Nebraska","Wayne County",3,57,98,38,60
050,31,179,"Nebraska","Wayne County",3,58,105,44,61
050,31,179,"Nebraska","Wayne County",3,59,119,62,57
050,31,179,"Nebraska","Wayne County",3,60,119,68,51
050,31,179,"Nebraska","Wayne County",3,61,115,66,49
050,31,179,"Nebraska","Wayne County",3,62,102,55,47
050,31,179,"Nebraska","Wayne County",3,63,106,56,50
050,31,179,"Nebraska","Wayne County",3,64,110,55,55
050,31,179,"Nebraska","Wayne County",3,65,109,55,54
050,31,179,"Nebraska","Wayne County",3,66,119,72,47
050,31,179,"Nebraska","Wayne County",3,67,102,55,47
050,31,179,"Nebraska","Wayne County",3,68,89,42,47
050,31,179,"Nebraska","Wayne County",3,69,86,43,43
050,31,179,"Nebraska","Wayne County",3,70,86,44,42
050,31,179,"Nebraska","Wayne County",3,71,77,37,40
050,31,179,"Nebraska","Wayne County",3,72,68,35,33
050,31,179,"Nebraska","Wayne County",3,73,68,41,27
050,31,179,"Nebraska","Wayne County",3,74,66,34,32
050,31,179,"Nebraska","Wayne County",3,75,49,24,25
050,31,179,"Nebraska","Wayne County",3,76,48,23,25
050,31,179,"Nebraska","Wayne County",3,77,54,25,29
050,31,179,"Nebraska","Wayne County",3,78,62,31,31
050,31,179,"Nebraska","Wayne County",3,79,48,22,26
050,31,179,"Nebraska","Wayne County",3,80,40,19,21
050,31,179,"Nebraska","Wayne County",3,81,38,17,21
050,31,179,"Nebraska","Wayne County",3,82,32,14,18
050,31,179,"Nebraska","Wayne County",3,83,33,18,15
050,31,179,"Nebraska","Wayne County",3,84,34,13,21
050,31,179,"Nebraska","Wayne County",3,85,250,99,151
050,31,179,"Nebraska","Wayne County",4,0,106,56,50
050,31,179,"Nebraska","Wayne County",4,1,109,58,51
050,31,179,"Nebraska","Wayne County",4,2,90,44,46
050,31,179,"Nebraska","Wayne County",4,3,105,50,55
050,31,179,"Nebraska","Wayne County",4,4,110,50,60
050,31,179,"Nebraska","Wayne County",4,5,110,55,55
050,31,179,"Nebraska","Wayne County",4,6,122,57,65
050,31,179,"Nebraska","Wayne County",4,7,113,51,62
050,31,179,"Nebraska","Wayne County",4,8,118,57,61
050,31,179,"Nebraska","Wayne County",4,9,109,58,51
050,31,179,"Nebraska","Wayne County",4,10,103,59,44
050,31,179,"Nebraska","Wayne County",4,11,107,61,46
050,31,179,"Nebraska","Wayne County",4,12,127,74,53
050,31,179,"Nebraska","Wayne County",4,13,116,70,46
050,31,179,"Nebraska","Wayne County",4,14,132,70,62
050,31,179,"Nebraska","Wayne County",4,15,113,59,54
050,31,179,"Nebraska","Wayne County",4,16,115,60,55
050,31,179,"Nebraska","Wayne County",4,17,106,54,52
050,31,179,"Nebraska","Wayne County",4,18,283,106,177
050,31,179,"Nebraska","Wayne County",4,19,588,275,313
050,31,179,"Nebraska","Wayne County",4,20,479,215,264
050,31,179,"Nebraska","Wayne County",4,21,403,206,197
050,31,179,"Nebraska","Wayne County",4,22,321,178,143
050,31,179,"Nebraska","Wayne County",4,23,166,100,66
050,31,179,"Nebraska","Wayne County",4,24,109,53,56
050,31,179,"Nebraska","Wayne County",4,25,116,56,60
050,31,179,"Nebraska","Wayne County",4,26,94,52,42
050,31,179,"Nebraska","Wayne County",4,27,105,51,54
050,31,179,"Nebraska","Wayne County",4,28,93,53,40
050,31,179,"Nebraska","Wayne County",4,29,96,57,39
050,31,179,"Nebraska","Wayne County",4,30,108,68,40
050,31,179,"Nebraska","Wayne County",4,31,108,66,42
050,31,179,"Nebraska","Wayne County",4,32,114,54,60
050,31,179,"Nebraska","Wayne County",4,33,88,46,42
050,31,179,"Nebraska","Wayne County",4,34,100,58,42
050,31,179,"Nebraska","Wayne County",4,35,96,56,40
050,31,179,"Nebraska","Wayne County",4,36,89,44,45
050,31,179,"Nebraska","Wayne County",4,37,90,50,40
050,31,179,"Nebraska","Wayne County",4,38,94,52,42
050,31,179,"Nebraska","Wayne County",4,39,100,54,46
050,31,179,"Nebraska","Wayne County",4,40,97,40,57
050,31,179,"Nebraska","Wayne County",4,41,101,49,52
050,31,179,"Nebraska","Wayne County",4,42,101,50,51
050,31,179,"Nebraska","Wayne County",4,43,101,53,48
050,31,179,"Nebraska","Wayne County",4,44,85,51,34
050,31,179,"Nebraska","Wayne County",4,45,96,45,51
050,31,179,"Nebraska","Wayne County",4,46,102,46,56
050,31,179,"Nebraska","Wayne County",4,47,89,43,46
050,31,179,"Nebraska","Wayne County",4,48,80,41,39
050,31,179,"Nebraska","Wayne County",4,49,74,41,33
050,31,179,"Nebraska","Wayne County",4,50,97,54,43
050,31,179,"Nebraska","Wayne County",4,51,89,45,44
050,31,179,"Nebraska","Wayne County",4,52,95,49,46
050,31,179,"Nebraska","Wayne County",4,53,86,52,34
050,31,179,"Nebraska","Wayne County",4,54,98,54,44
050,31,179,"Nebraska","Wayne County",4,55,91,49,42
050,31,179,"Nebraska","Wayne County",4,56,96,49,47
050,31,179,"Nebraska","Wayne County",4,57,107,47,60
050,31,179,"Nebraska","Wayne County",4,58,94,38,56
050,31,179,"Nebraska","Wayne County",4,59,107,47,60
050,31,179,"Nebraska","Wayne County",4,60,115,61,54
050,31,179,"Nebraska","Wayne County",4,61,119,68,51
050,31,179,"Nebraska","Wayne County",4,62,114,66,48
050,31,179,"Nebraska","Wayne County",4,63,101,55,46
050,31,179,"Nebraska","Wayne County",4,64,107,57,50
050,31,179,"Nebraska","Wayne County",4,65,112,56,56
050,31,179,"Nebraska","Wayne County",4,66,105,54,51
050,31,179,"Nebraska","Wayne County",4,67,113,67,46
050,31,179,"Nebraska","Wayne County",4,68,103,55,48
050,31,179,"Nebraska","Wayne County",4,69,90,43,47
050,31,179,"Nebraska","Wayne County",4,70,87,44,43
050,31,179,"Nebraska","Wayne County",4,71,84,44,40
050,31,179,"Nebraska","Wayne County",4,72,73,34,39
050,31,179,"Nebraska","Wayne County",4,73,70,37,33
050,31,179,"Nebraska","Wayne County",4,74,64,37,27
050,31,179,"Nebraska","Wayne County",4,75,67,32,35
050,31,179,"Nebraska","Wayne County",4,76,48,24,24
050,31,179,"Nebraska","Wayne County",4,77,44,20,24
050,31,179,"Nebraska","Wayne County",4,78,56,28,28
050,31,179,"Nebraska","Wayne County",4,79,62,30,32
050,31,179,"Nebraska","Wayne County",4,80,45,22,23
050,31,179,"Nebraska","Wayne County",4,81,43,20,23
050,31,179,"Nebraska","Wayne County",4,82,34,17,17
050,31,179,"Nebraska","Wayne County",4,83,27,12,15
050,31,179,"Nebraska","Wayne County",4,84,35,18,17
050,31,179,"Nebraska","Wayne County",4,85,244,96,148
050,31,179,"Nebraska","Wayne County",5,0,106,57,49
050,31,179,"Nebraska","Wayne County",5,1,108,61,47
050,31,179,"Nebraska","Wayne County",5,2,106,57,49
050,31,179,"Nebraska","Wayne County",5,3,93,46,47
050,31,179,"Nebraska","Wayne County",5,4,107,51,56
050,31,179,"Nebraska","Wayne County",5,5,107,50,57
050,31,179,"Nebraska","Wayne County",5,6,108,54,54
050,31,179,"Nebraska","Wayne County",5,7,121,57,64
050,31,179,"Nebraska","Wayne County",5,8,117,54,63
050,31,179,"Nebraska","Wayne County",5,9,118,59,59
050,31,179,"Nebraska","Wayne County",5,10,107,57,50
050,31,179,"Nebraska","Wayne County",5,11,114,66,48
050,31,179,"Nebraska","Wayne County",5,12,109,63,46
050,31,179,"Nebraska","Wayne County",5,13,128,72,56
050,31,179,"Nebraska","Wayne County",5,14,119,71,48
050,31,179,"Nebraska","Wayne County",5,15,134,71,63
050,31,179,"Nebraska","Wayne County",5,16,124,62,62
050,31,179,"Nebraska","Wayne County",5,17,116,59,57
050,31,179,"Nebraska","Wayne County",5,18,274,106,168
050,31,179,"Nebraska","Wayne County",5,19,594,268,326
050,31,179,"Nebraska","Wayne County",5,20,476,212,264
050,31,179,"Nebraska","Wayne County",5,21,415,218,197
050,31,179,"Nebraska","Wayne County",5,22,307,168,139
050,31,179,"Nebraska","Wayne County",5,23,168,104,64
050,31,179,"Nebraska","Wayne County",5,24,113,60,53
050,31,179,"Nebraska","Wayne County",5,25,94,46,48
050,31,179,"Nebraska","Wayne County",5,26,95,44,51
050,31,179,"Nebraska","Wayne County",5,27,102,51,51
050,31,179,"Nebraska","Wayne County",5,28,100,47,53
050,31,179,"Nebraska","Wayne County",5,29,86,48,38
050,31,179,"Nebraska","Wayne County",5,30,95,54,41
050,31,179,"Nebraska","Wayne County",5,31,97,53,44
050,31,179,"Nebraska","Wayne County",5,32,106,61,45
050,31,179,"Nebraska","Wayne County",5,33,117,54,63
050,31,179,"Nebraska","Wayne County",5,34,84,43,41
050,31,179,"Nebraska","Wayne County",5,35,97,57,40
050,31,179,"Nebraska","Wayne County",5,36,89,50,39
050,31,179,"Nebraska","Wayne County",5,37,94,46,48
050,31,179,"Nebraska","Wayne County",5,38,90,49,41
050,31,179,"Nebraska","Wayne County",5,39,89,50,39
050,31,179,"Nebraska","Wayne County",5,40,98,51,47
050,31,179,"Nebraska","Wayne County",5,41,96,38,58
050,31,179,"Nebraska","Wayne County",5,42,102,48,54
050,31,179,"Nebraska","Wayne County",5,43,104,54,50
050,31,179,"Nebraska","Wayne County",5,44,100,54,46
050,31,179,"Nebraska","Wayne County",5,45,87,51,36
050,31,179,"Nebraska","Wayne County",5,46,99,46,53
050,31,179,"Nebraska","Wayne County",5,47,101,46,55
050,31,179,"Nebraska","Wayne County",5,48,88,43,45
050,31,179,"Nebraska","Wayne County",5,49,78,40,38
050,31,179,"Nebraska","Wayne County",5,50,74,41,33
050,31,179,"Nebraska","Wayne County",5,51,91,53,38
050,31,179,"Nebraska","Wayne County",5,52,88,47,41
050,31,179,"Nebraska","Wayne County",5,53,94,50,44
050,31,179,"Nebraska","Wayne County",5,54,89,52,37
050,31,179,"Nebraska","Wayne County",5,55,100,57,43
050,31,179,"Nebraska","Wayne County",5,56,89,48,41
050,31,179,"Nebraska","Wayne County",5,57,93,48,45
050,31,179,"Nebraska","Wayne County",5,58,104,43,61
050,31,179,"Nebraska","Wayne County",5,59,99,42,57
050,31,179,"Nebraska","Wayne County",5,60,104,47,57
050,31,179,"Nebraska","Wayne County",5,61,112,59,53
050,31,179,"Nebraska","Wayne County",5,62,117,66,51
050,31,179,"Nebraska","Wayne County",5,63,114,66,48
050,31,179,"Nebraska","Wayne County",5,64,99,53,46
050,31,179,"Nebraska","Wayne County",5,65,104,54,50
050,31,179,"Nebraska","Wayne County",5,66,108,57,51
050,31,179,"Nebraska","Wayne County",5,67,101,51,50
050,31,179,"Nebraska","Wayne County",5,68,111,64,47
050,31,179,"Nebraska","Wayne County",5,69,103,55,48
050,31,179,"Nebraska","Wayne County",5,70,82,39,43
050,31,179,"Nebraska","Wayne County",5,71,85,42,43
050,31,179,"Nebraska","Wayne County",5,72,83,43,40
050,31,179,"Nebraska","Wayne County",5,73,75,36,39
050,31,179,"Nebraska","Wayne County",5,74,66,31,35
050,31,179,"Nebraska","Wayne County",5,75,66,37,29
050,31,179,"Nebraska","Wayne County",5,76,66,33,33
050,31,179,"Nebraska","Wayne County",5,77,45,22,23
050,31,179,"Nebraska","Wayne County",5,78,45,21,24
050,31,179,"Nebraska","Wayne County",5,79,53,26,27
050,31,179,"Nebraska","Wayne County",5,80,60,30,30
050,31,179,"Nebraska","Wayne County",5,81,46,22,24
050,31,179,"Nebraska","Wayne County",5,82,39,19,20
050,31,179,"Nebraska","Wayne County",5,83,29,16,13
050,31,179,"Nebraska","Wayne County",5,84,27,11,16
050,31,179,"Nebraska","Wayne County",5,85,236,99,137
050,31,181,"Nebraska","Webster County",1,0,42,21,21
050,31,181,"Nebraska","Webster County",1,1,39,21,18
050,31,181,"Nebraska","Webster County",1,2,36,19,17
050,31,181,"Nebraska","Webster County",1,3,29,16,13
050,31,181,"Nebraska","Webster County",1,4,39,21,18
050,31,181,"Nebraska","Webster County",1,5,39,26,13
050,31,181,"Nebraska","Webster County",1,6,31,20,11
050,31,181,"Nebraska","Webster County",1,7,43,25,18
050,31,181,"Nebraska","Webster County",1,8,48,31,17
050,31,181,"Nebraska","Webster County",1,9,43,20,23
050,31,181,"Nebraska","Webster County",1,10,56,26,30
050,31,181,"Nebraska","Webster County",1,11,59,35,24
050,31,181,"Nebraska","Webster County",1,12,57,30,27
050,31,181,"Nebraska","Webster County",1,13,43,16,27
050,31,181,"Nebraska","Webster County",1,14,45,19,26
050,31,181,"Nebraska","Webster County",1,15,41,19,22
050,31,181,"Nebraska","Webster County",1,16,45,19,26
050,31,181,"Nebraska","Webster County",1,17,47,22,25
050,31,181,"Nebraska","Webster County",1,18,34,15,19
050,31,181,"Nebraska","Webster County",1,19,28,12,16
050,31,181,"Nebraska","Webster County",1,20,28,13,15
050,31,181,"Nebraska","Webster County",1,21,29,16,13
050,31,181,"Nebraska","Webster County",1,22,33,21,12
050,31,181,"Nebraska","Webster County",1,23,36,20,16
050,31,181,"Nebraska","Webster County",1,24,45,20,25
050,31,181,"Nebraska","Webster County",1,25,36,20,16
050,31,181,"Nebraska","Webster County",1,26,35,22,13
050,31,181,"Nebraska","Webster County",1,27,43,24,19
050,31,181,"Nebraska","Webster County",1,28,43,19,24
050,31,181,"Nebraska","Webster County",1,29,40,20,20
050,31,181,"Nebraska","Webster County",1,30,39,21,18
050,31,181,"Nebraska","Webster County",1,31,38,23,15
050,31,181,"Nebraska","Webster County",1,32,34,16,18
050,31,181,"Nebraska","Webster County",1,33,28,13,15
050,31,181,"Nebraska","Webster County",1,34,31,12,19
050,31,181,"Nebraska","Webster County",1,35,23,14,9
050,31,181,"Nebraska","Webster County",1,36,28,16,12
050,31,181,"Nebraska","Webster County",1,37,28,16,12
050,31,181,"Nebraska","Webster County",1,38,42,23,19
050,31,181,"Nebraska","Webster County",1,39,34,20,14
050,31,181,"Nebraska","Webster County",1,40,36,20,16
050,31,181,"Nebraska","Webster County",1,41,40,22,18
050,31,181,"Nebraska","Webster County",1,42,29,16,13
050,31,181,"Nebraska","Webster County",1,43,35,19,16
050,31,181,"Nebraska","Webster County",1,44,38,18,20
050,31,181,"Nebraska","Webster County",1,45,39,23,16
050,31,181,"Nebraska","Webster County",1,46,34,19,15
050,31,181,"Nebraska","Webster County",1,47,35,16,19
050,31,181,"Nebraska","Webster County",1,48,34,19,15
050,31,181,"Nebraska","Webster County",1,49,42,23,19
050,31,181,"Nebraska","Webster County",1,50,41,17,24
050,31,181,"Nebraska","Webster County",1,51,45,21,24
050,31,181,"Nebraska","Webster County",1,52,43,23,20
050,31,181,"Nebraska","Webster County",1,53,34,15,19
050,31,181,"Nebraska","Webster County",1,54,37,19,18
050,31,181,"Nebraska","Webster County",1,55,47,23,24
050,31,181,"Nebraska","Webster County",1,56,48,21,27
050,31,181,"Nebraska","Webster County",1,57,57,28,29
050,31,181,"Nebraska","Webster County",1,58,55,22,33
050,31,181,"Nebraska","Webster County",1,59,59,31,28
050,31,181,"Nebraska","Webster County",1,60,59,32,27
050,31,181,"Nebraska","Webster County",1,61,54,33,21
050,31,181,"Nebraska","Webster County",1,62,53,32,21
050,31,181,"Nebraska","Webster County",1,63,55,28,27
050,31,181,"Nebraska","Webster County",1,64,60,30,30
050,31,181,"Nebraska","Webster County",1,65,50,26,24
050,31,181,"Nebraska","Webster County",1,66,46,24,22
050,31,181,"Nebraska","Webster County",1,67,49,28,21
050,31,181,"Nebraska","Webster County",1,68,51,31,20
050,31,181,"Nebraska","Webster County",1,69,43,23,20
050,31,181,"Nebraska","Webster County",1,70,43,20,23
050,31,181,"Nebraska","Webster County",1,71,38,22,16
050,31,181,"Nebraska","Webster County",1,72,38,16,22
050,31,181,"Nebraska","Webster County",1,73,38,19,19
050,31,181,"Nebraska","Webster County",1,74,20,10,10
050,31,181,"Nebraska","Webster County",1,75,35,18,17
050,31,181,"Nebraska","Webster County",1,76,29,14,15
050,31,181,"Nebraska","Webster County",1,77,28,13,15
050,31,181,"Nebraska","Webster County",1,78,21,9,12
050,31,181,"Nebraska","Webster County",1,79,24,9,15
050,31,181,"Nebraska","Webster County",1,80,27,8,19
050,31,181,"Nebraska","Webster County",1,81,27,10,17
050,31,181,"Nebraska","Webster County",1,82,23,9,14
050,31,181,"Nebraska","Webster County",1,83,14,3,11
050,31,181,"Nebraska","Webster County",1,84,14,4,10
050,31,181,"Nebraska","Webster County",1,85,94,26,68
050,31,181,"Nebraska","Webster County",2,0,41,20,21
050,31,181,"Nebraska","Webster County",2,1,39,21,18
050,31,181,"Nebraska","Webster County",2,2,36,19,17
050,31,181,"Nebraska","Webster County",2,3,31,17,14
050,31,181,"Nebraska","Webster County",2,4,38,20,18
050,31,181,"Nebraska","Webster County",2,5,38,24,14
050,31,181,"Nebraska","Webster County",2,6,34,22,12
050,31,181,"Nebraska","Webster County",2,7,40,24,16
050,31,181,"Nebraska","Webster County",2,8,45,28,17
050,31,181,"Nebraska","Webster County",2,9,45,23,22
050,31,181,"Nebraska","Webster County",2,10,51,24,27
050,31,181,"Nebraska","Webster County",2,11,58,33,25
050,31,181,"Nebraska","Webster County",2,12,58,32,26
050,31,181,"Nebraska","Webster County",2,13,46,19,27
050,31,181,"Nebraska","Webster County",2,14,44,18,26
050,31,181,"Nebraska","Webster County",2,15,42,19,23
050,31,181,"Nebraska","Webster County",2,16,45,19,26
050,31,181,"Nebraska","Webster County",2,17,47,21,26
050,31,181,"Nebraska","Webster County",2,18,37,17,20
050,31,181,"Nebraska","Webster County",2,19,28,12,16
050,31,181,"Nebraska","Webster County",2,20,28,13,15
050,31,181,"Nebraska","Webster County",2,21,29,16,13
050,31,181,"Nebraska","Webster County",2,22,32,20,12
050,31,181,"Nebraska","Webster County",2,23,37,20,17
050,31,181,"Nebraska","Webster County",2,24,43,20,23
050,31,181,"Nebraska","Webster County",2,25,37,20,17
050,31,181,"Nebraska","Webster County",2,26,35,22,13
050,31,181,"Nebraska","Webster County",2,27,40,22,18
050,31,181,"Nebraska","Webster County",2,28,44,20,24
050,31,181,"Nebraska","Webster County",2,29,41,20,21
050,31,181,"Nebraska","Webster County",2,30,38,21,17
050,31,181,"Nebraska","Webster County",2,31,38,23,15
050,31,181,"Nebraska","Webster County",2,32,36,18,18
050,31,181,"Nebraska","Webster County",2,33,29,14,15
050,31,181,"Nebraska","Webster County",2,34,29,12,17
050,31,181,"Nebraska","Webster County",2,35,26,14,12
050,31,181,"Nebraska","Webster County",2,36,26,15,11
050,31,181,"Nebraska","Webster County",2,37,29,17,12
050,31,181,"Nebraska","Webster County",2,38,38,21,17
050,31,181,"Nebraska","Webster County",2,39,36,21,15
050,31,181,"Nebraska","Webster County",2,40,36,21,15
050,31,181,"Nebraska","Webster County",2,41,39,21,18
050,31,181,"Nebraska","Webster County",2,42,31,17,14
050,31,181,"Nebraska","Webster County",2,43,35,19,16
050,31,181,"Nebraska","Webster County",2,44,36,18,18
050,31,181,"Nebraska","Webster County",2,45,39,22,17
050,31,181,"Nebraska","Webster County",2,46,35,19,16
050,31,181,"Nebraska","Webster County",2,47,36,18,18
050,31,181,"Nebraska","Webster County",2,48,33,18,15
050,31,181,"Nebraska","Webster County",2,49,41,22,19
050,31,181,"Nebraska","Webster County",2,50,40,18,22
050,31,181,"Nebraska","Webster County",2,51,43,19,24
050,31,181,"Nebraska","Webster County",2,52,45,23,22
050,31,181,"Nebraska","Webster County",2,53,35,17,18
050,31,181,"Nebraska","Webster County",2,54,36,18,18
050,31,181,"Nebraska","Webster County",2,55,44,22,22
050,31,181,"Nebraska","Webster County",2,56,47,21,26
050,31,181,"Nebraska","Webster County",2,57,56,27,29
050,31,181,"Nebraska","Webster County",2,58,56,24,32
050,31,181,"Nebraska","Webster County",2,59,58,29,29
050,31,181,"Nebraska","Webster County",2,60,58,31,27
050,31,181,"Nebraska","Webster County",2,61,56,34,22
050,31,181,"Nebraska","Webster County",2,62,53,32,21
050,31,181,"Nebraska","Webster County",2,63,55,30,25
050,31,181,"Nebraska","Webster County",2,64,59,29,30
050,31,181,"Nebraska","Webster County",2,65,52,27,25
050,31,181,"Nebraska","Webster County",2,66,47,25,22
050,31,181,"Nebraska","Webster County",2,67,49,27,22
050,31,181,"Nebraska","Webster County",2,68,51,30,21
050,31,181,"Nebraska","Webster County",2,69,45,25,20
050,31,181,"Nebraska","Webster County",2,70,44,21,23
050,31,181,"Nebraska","Webster County",2,71,40,22,18
050,31,181,"Nebraska","Webster County",2,72,37,17,20
050,31,181,"Nebraska","Webster County",2,73,39,19,20
050,31,181,"Nebraska","Webster County",2,74,22,11,11
050,31,181,"Nebraska","Webster County",2,75,31,16,15
050,31,181,"Nebraska","Webster County",2,76,30,15,15
050,31,181,"Nebraska","Webster County",2,77,29,13,16
050,31,181,"Nebraska","Webster County",2,78,22,10,12
050,31,181,"Nebraska","Webster County",2,79,22,8,14
050,31,181,"Nebraska","Webster County",2,80,26,8,18
050,31,181,"Nebraska","Webster County",2,81,26,9,17
050,31,181,"Nebraska","Webster County",2,82,23,8,15
050,31,181,"Nebraska","Webster County",2,83,14,4,10
050,31,181,"Nebraska","Webster County",2,84,14,4,10
050,31,181,"Nebraska","Webster County",2,85,93,27,66
050,31,181,"Nebraska","Webster County",3,0,45,29,16
050,31,181,"Nebraska","Webster County",3,1,41,16,25
050,31,181,"Nebraska","Webster County",3,2,43,22,21
050,31,181,"Nebraska","Webster County",3,3,40,22,18
050,31,181,"Nebraska","Webster County",3,4,31,16,15
050,31,181,"Nebraska","Webster County",3,5,38,21,17
050,31,181,"Nebraska","Webster County",3,6,38,25,13
050,31,181,"Nebraska","Webster County",3,7,40,26,14
050,31,181,"Nebraska","Webster County",3,8,37,24,13
050,31,181,"Nebraska","Webster County",3,9,46,27,19
050,31,181,"Nebraska","Webster County",3,10,45,24,21
050,31,181,"Nebraska","Webster County",3,11,49,22,27
050,31,181,"Nebraska","Webster County",3,12,58,33,25
050,31,181,"Nebraska","Webster County",3,13,55,30,25
050,31,181,"Nebraska","Webster County",3,14,44,17,27
050,31,181,"Nebraska","Webster County",3,15,52,22,30
050,31,181,"Nebraska","Webster County",3,16,45,19,26
050,31,181,"Nebraska","Webster County",3,17,46,19,27
050,31,181,"Nebraska","Webster County",3,18,39,18,21
050,31,181,"Nebraska","Webster County",3,19,33,14,19
050,31,181,"Nebraska","Webster County",3,20,27,12,15
050,31,181,"Nebraska","Webster County",3,21,32,14,18
050,31,181,"Nebraska","Webster County",3,22,36,20,16
050,31,181,"Nebraska","Webster County",3,23,32,20,12
050,31,181,"Nebraska","Webster County",3,24,35,21,14
050,31,181,"Nebraska","Webster County",3,25,45,23,22
050,31,181,"Nebraska","Webster County",3,26,32,16,16
050,31,181,"Nebraska","Webster County",3,27,34,23,11
050,31,181,"Nebraska","Webster County",3,28,45,22,23
050,31,181,"Nebraska","Webster County",3,29,45,22,23
050,31,181,"Nebraska","Webster County",3,30,47,25,22
050,31,181,"Nebraska","Webster County",3,31,38,22,16
050,31,181,"Nebraska","Webster County",3,32,43,26,17
050,31,181,"Nebraska","Webster County",3,33,32,16,16
050,31,181,"Nebraska","Webster County",3,34,29,14,15
050,31,181,"Nebraska","Webster County",3,35,30,12,18
050,31,181,"Nebraska","Webster County",3,36,26,13,13
050,31,181,"Nebraska","Webster County",3,37,26,15,11
050,31,181,"Nebraska","Webster County",3,38,29,18,11
050,31,181,"Nebraska","Webster County",3,39,39,22,17
050,31,181,"Nebraska","Webster County",3,40,41,24,17
050,31,181,"Nebraska","Webster County",3,41,37,21,16
050,31,181,"Nebraska","Webster County",3,42,36,17,19
050,31,181,"Nebraska","Webster County",3,43,37,21,16
050,31,181,"Nebraska","Webster County",3,44,36,20,16
050,31,181,"Nebraska","Webster County",3,45,36,18,18
050,31,181,"Nebraska","Webster County",3,46,38,22,16
050,31,181,"Nebraska","Webster County",3,47,39,21,18
050,31,181,"Nebraska","Webster County",3,48,33,16,17
050,31,181,"Nebraska","Webster County",3,49,34,17,17
050,31,181,"Nebraska","Webster County",3,50,49,28,21
050,31,181,"Nebraska","Webster County",3,51,39,16,23
050,31,181,"Nebraska","Webster County",3,52,43,20,23
050,31,181,"Nebraska","Webster County",3,53,44,22,22
050,31,181,"Nebraska","Webster County",3,54,37,20,17
050,31,181,"Nebraska","Webster County",3,55,37,18,19
050,31,181,"Nebraska","Webster County",3,56,40,18,22
050,31,181,"Nebraska","Webster County",3,57,48,21,27
050,31,181,"Nebraska","Webster County",3,58,56,29,27
050,31,181,"Nebraska","Webster County",3,59,59,27,32
050,31,181,"Nebraska","Webster County",3,60,58,28,30
050,31,181,"Nebraska","Webster County",3,61,61,33,28
050,31,181,"Nebraska","Webster County",3,62,55,33,22
050,31,181,"Nebraska","Webster County",3,63,50,29,21
050,31,181,"Nebraska","Webster County",3,64,48,27,21
050,31,181,"Nebraska","Webster County",3,65,55,28,27
050,31,181,"Nebraska","Webster County",3,66,47,23,24
050,31,181,"Nebraska","Webster County",3,67,46,25,21
050,31,181,"Nebraska","Webster County",3,68,52,28,24
050,31,181,"Nebraska","Webster County",3,69,52,30,22
050,31,181,"Nebraska","Webster County",3,70,43,24,19
050,31,181,"Nebraska","Webster County",3,71,40,18,22
050,31,181,"Nebraska","Webster County",3,72,36,20,16
050,31,181,"Nebraska","Webster County",3,73,35,17,18
050,31,181,"Nebraska","Webster County",3,74,33,16,17
050,31,181,"Nebraska","Webster County",3,75,22,13,9
050,31,181,"Nebraska","Webster County",3,76,28,12,16
050,31,181,"Nebraska","Webster County",3,77,27,11,16
050,31,181,"Nebraska","Webster County",3,78,29,14,15
050,31,181,"Nebraska","Webster County",3,79,18,6,12
050,31,181,"Nebraska","Webster County",3,80,25,8,17
050,31,181,"Nebraska","Webster County",3,81,24,7,17
050,31,181,"Nebraska","Webster County",3,82,23,8,15
050,31,181,"Nebraska","Webster County",3,83,20,8,12
050,31,181,"Nebraska","Webster County",3,84,9,0,9
050,31,181,"Nebraska","Webster County",3,85,80,21,59
050,31,181,"Nebraska","Webster County",4,0,34,17,17
050,31,181,"Nebraska","Webster County",4,1,48,34,14
050,31,181,"Nebraska","Webster County",4,2,40,18,22
050,31,181,"Nebraska","Webster County",4,3,34,19,15
050,31,181,"Nebraska","Webster County",4,4,39,21,18
050,31,181,"Nebraska","Webster County",4,5,34,17,17
050,31,181,"Nebraska","Webster County",4,6,35,19,16
050,31,181,"Nebraska","Webster County",4,7,39,23,16
050,31,181,"Nebraska","Webster County",4,8,41,26,15
050,31,181,"Nebraska","Webster County",4,9,37,23,14
050,31,181,"Nebraska","Webster County",4,10,45,29,16
050,31,181,"Nebraska","Webster County",4,11,43,23,20
050,31,181,"Nebraska","Webster County",4,12,50,25,25
050,31,181,"Nebraska","Webster County",4,13,51,31,20
050,31,181,"Nebraska","Webster County",4,14,55,30,25
050,31,181,"Nebraska","Webster County",4,15,43,15,28
050,31,181,"Nebraska","Webster County",4,16,50,18,32
050,31,181,"Nebraska","Webster County",4,17,44,20,24
050,31,181,"Nebraska","Webster County",4,18,33,17,16
050,31,181,"Nebraska","Webster County",4,19,28,13,15
050,31,181,"Nebraska","Webster County",4,20,33,15,18
050,31,181,"Nebraska","Webster County",4,21,24,9,15
050,31,181,"Nebraska","Webster County",4,22,37,17,20
050,31,181,"Nebraska","Webster County",4,23,41,25,16
050,31,181,"Nebraska","Webster County",4,24,28,16,12
050,31,181,"Nebraska","Webster County",4,25,30,18,12
050,31,181,"Nebraska","Webster County",4,26,47,19,28
050,31,181,"Nebraska","Webster County",4,27,28,13,15
050,31,181,"Nebraska","Webster County",4,28,35,24,11
050,31,181,"Nebraska","Webster County",4,29,42,19,23
050,31,181,"Nebraska","Webster County",4,30,45,21,24
050,31,181,"Nebraska","Webster County",4,31,52,28,24
050,31,181,"Nebraska","Webster County",4,32,35,20,15
050,31,181,"Nebraska","Webster County",4,33,41,23,18
050,31,181,"Nebraska","Webster County",4,34,32,17,15
050,31,181,"Nebraska","Webster County",4,35,30,14,16
050,31,181,"Nebraska","Webster County",4,36,29,12,17
050,31,181,"Nebraska","Webster County",4,37,24,12,12
050,31,181,"Nebraska","Webster County",4,38,23,12,11
050,31,181,"Nebraska","Webster County",4,39,30,18,12
050,31,181,"Nebraska","Webster County",4,40,40,23,17
050,31,181,"Nebraska","Webster County",4,41,39,22,17
050,31,181,"Nebraska","Webster County",4,42,35,19,16
050,31,181,"Nebraska","Webster County",4,43,37,18,19
050,31,181,"Nebraska","Webster County",4,44,38,21,17
050,31,181,"Nebraska","Webster County",4,45,37,20,17
050,31,181,"Nebraska","Webster County",4,46,34,17,17
050,31,181,"Nebraska","Webster County",4,47,43,25,18
050,31,181,"Nebraska","Webster County",4,48,38,21,17
050,31,181,"Nebraska","Webster County",4,49,31,14,17
050,31,181,"Nebraska","Webster County",4,50,28,14,14
050,31,181,"Nebraska","Webster County",4,51,46,26,20
050,31,181,"Nebraska","Webster County",4,52,41,18,23
050,31,181,"Nebraska","Webster County",4,53,39,20,19
050,31,181,"Nebraska","Webster County",4,54,49,24,25
050,31,181,"Nebraska","Webster County",4,55,38,22,16
050,31,181,"Nebraska","Webster County",4,56,33,15,18
050,31,181,"Nebraska","Webster County",4,57,43,19,24
050,31,181,"Nebraska","Webster County",4,58,48,22,26
050,31,181,"Nebraska","Webster County",4,59,57,28,29
050,31,181,"Nebraska","Webster County",4,60,61,27,34
050,31,181,"Nebraska","Webster County",4,61,61,31,30
050,31,181,"Nebraska","Webster County",4,62,59,32,27
050,31,181,"Nebraska","Webster County",4,63,54,33,21
050,31,181,"Nebraska","Webster County",4,64,52,31,21
050,31,181,"Nebraska","Webster County",4,65,50,28,22
050,31,181,"Nebraska","Webster County",4,66,52,24,28
050,31,181,"Nebraska","Webster County",4,67,46,23,23
050,31,181,"Nebraska","Webster County",4,68,48,25,23
050,31,181,"Nebraska","Webster County",4,69,50,28,22
050,31,181,"Nebraska","Webster County",4,70,49,29,20
050,31,181,"Nebraska","Webster County",4,71,43,22,21
050,31,181,"Nebraska","Webster County",4,72,40,17,23
050,31,181,"Nebraska","Webster County",4,73,36,20,16
050,31,181,"Nebraska","Webster County",4,74,37,16,21
050,31,181,"Nebraska","Webster County",4,75,33,18,15
050,31,181,"Nebraska","Webster County",4,76,21,12,9
050,31,181,"Nebraska","Webster County",4,77,22,9,13
050,31,181,"Nebraska","Webster County",4,78,20,8,12
050,31,181,"Nebraska","Webster County",4,79,29,13,16
050,31,181,"Nebraska","Webster County",4,80,18,5,13
050,31,181,"Nebraska","Webster County",4,81,24,9,15
050,31,181,"Nebraska","Webster County",4,82,23,7,16
050,31,181,"Nebraska","Webster County",4,83,14,5,9
050,31,181,"Nebraska","Webster County",4,84,17,6,11
050,31,181,"Nebraska","Webster County",4,85,77,15,62
050,31,181,"Nebraska","Webster County",5,0,33,17,16
050,31,181,"Nebraska","Webster County",5,1,41,22,19
050,31,181,"Nebraska","Webster County",5,2,41,29,12
050,31,181,"Nebraska","Webster County",5,3,44,21,23
050,31,181,"Nebraska","Webster County",5,4,45,27,18
050,31,181,"Nebraska","Webster County",5,5,37,20,17
050,31,181,"Nebraska","Webster County",5,6,32,16,16
050,31,181,"Nebraska","Webster County",5,7,36,20,16
050,31,181,"Nebraska","Webster County",5,8,38,20,18
050,31,181,"Nebraska","Webster County",5,9,45,28,17
050,31,181,"Nebraska","Webster County",5,10,36,20,16
050,31,181,"Nebraska","Webster County",5,11,48,30,18
050,31,181,"Nebraska","Webster County",5,12,46,24,22
050,31,181,"Nebraska","Webster County",5,13,55,29,26
050,31,181,"Nebraska","Webster County",5,14,50,31,19
050,31,181,"Nebraska","Webster County",5,15,54,28,26
050,31,181,"Nebraska","Webster County",5,16,42,17,25
050,31,181,"Nebraska","Webster County",5,17,50,18,32
050,31,181,"Nebraska","Webster County",5,18,36,17,19
050,31,181,"Nebraska","Webster County",5,19,28,16,12
050,31,181,"Nebraska","Webster County",5,20,29,13,16
050,31,181,"Nebraska","Webster County",5,21,30,15,15
050,31,181,"Nebraska","Webster County",5,22,31,10,21
050,31,181,"Nebraska","Webster County",5,23,35,15,20
050,31,181,"Nebraska","Webster County",5,24,42,23,19
050,31,181,"Nebraska","Webster County",5,25,28,16,12
050,31,181,"Nebraska","Webster County",5,26,30,15,15
050,31,181,"Nebraska","Webster County",5,27,52,23,29
050,31,181,"Nebraska","Webster County",5,28,28,13,15
050,31,181,"Nebraska","Webster County",5,29,35,23,12
050,31,181,"Nebraska","Webster County",5,30,38,19,19
050,31,181,"Nebraska","Webster County",5,31,47,21,26
050,31,181,"Nebraska","Webster County",5,32,52,27,25
050,31,181,"Nebraska","Webster County",5,33,37,19,18
050,31,181,"Nebraska","Webster County",5,34,39,22,17
050,31,181,"Nebraska","Webster County",5,35,34,20,14
050,31,181,"Nebraska","Webster County",5,36,31,13,18
050,31,181,"Nebraska","Webster County",5,37,32,15,17
050,31,181,"Nebraska","Webster County",5,38,24,12,12
050,31,181,"Nebraska","Webster County",5,39,25,13,12
050,31,181,"Nebraska","Webster County",5,40,31,19,12
050,31,181,"Nebraska","Webster County",5,41,37,21,16
050,31,181,"Nebraska","Webster County",5,42,38,22,16
050,31,181,"Nebraska","Webster County",5,43,40,21,19
050,31,181,"Nebraska","Webster County",5,44,39,20,19
050,31,181,"Nebraska","Webster County",5,45,40,22,18
050,31,181,"Nebraska","Webster County",5,46,36,19,17
050,31,181,"Nebraska","Webster County",5,47,37,19,18
050,31,181,"Nebraska","Webster County",5,48,41,24,17
050,31,181,"Nebraska","Webster County",5,49,39,20,19
050,31,181,"Nebraska","Webster County",5,50,31,18,13
050,31,181,"Nebraska","Webster County",5,51,28,14,14
050,31,181,"Nebraska","Webster County",5,52,50,29,21
050,31,181,"Nebraska","Webster County",5,53,39,17,22
050,31,181,"Nebraska","Webster County",5,54,41,21,20
050,31,181,"Nebraska","Webster County",5,55,52,27,25
050,31,181,"Nebraska","Webster County",5,56,37,21,16
050,31,181,"Nebraska","Webster County",5,57,32,14,18
050,31,181,"Nebraska","Webster County",5,58,44,20,24
050,31,181,"Nebraska","Webster County",5,59,46,21,25
050,31,181,"Nebraska","Webster County",5,60,59,26,33
050,31,181,"Nebraska","Webster County",5,61,63,26,37
050,31,181,"Nebraska","Webster County",5,62,58,29,29
050,31,181,"Nebraska","Webster County",5,63,57,32,25
050,31,181,"Nebraska","Webster County",5,64,58,34,24
050,31,181,"Nebraska","Webster County",5,65,52,31,21
050,31,181,"Nebraska","Webster County",5,66,47,26,21
050,31,181,"Nebraska","Webster County",5,67,50,23,27
050,31,181,"Nebraska","Webster County",5,68,48,25,23
050,31,181,"Nebraska","Webster County",5,69,45,23,22
050,31,181,"Nebraska","Webster County",5,70,49,27,22
050,31,181,"Nebraska","Webster County",5,71,46,27,19
050,31,181,"Nebraska","Webster County",5,72,41,21,20
050,31,181,"Nebraska","Webster County",5,73,37,15,22
050,31,181,"Nebraska","Webster County",5,74,34,18,16
050,31,181,"Nebraska","Webster County",5,75,38,17,21
050,31,181,"Nebraska","Webster County",5,76,30,15,15
050,31,181,"Nebraska","Webster County",5,77,18,9,9
050,31,181,"Nebraska","Webster County",5,78,21,9,12
050,31,181,"Nebraska","Webster County",5,79,19,8,11
050,31,181,"Nebraska","Webster County",5,80,29,12,17
050,31,181,"Nebraska","Webster County",5,81,17,5,12
050,31,181,"Nebraska","Webster County",5,82,22,9,13
050,31,181,"Nebraska","Webster County",5,83,16,4,12
050,31,181,"Nebraska","Webster County",5,84,10,4,6
050,31,181,"Nebraska","Webster County",5,85,73,14,59
050,31,183,"Nebraska","Wheeler County",1,0,13,6,7
050,31,183,"Nebraska","Wheeler County",1,1,16,6,10
050,31,183,"Nebraska","Wheeler County",1,2,8,3,5
050,31,183,"Nebraska","Wheeler County",1,3,9,4,5
050,31,183,"Nebraska","Wheeler County",1,4,8,2,6
050,31,183,"Nebraska","Wheeler County",1,5,8,2,6
050,31,183,"Nebraska","Wheeler County",1,6,12,7,5
050,31,183,"Nebraska","Wheeler County",1,7,6,5,1
050,31,183,"Nebraska","Wheeler County",1,8,7,5,2
050,31,183,"Nebraska","Wheeler County",1,9,6,4,2
050,31,183,"Nebraska","Wheeler County",1,10,11,6,5
050,31,183,"Nebraska","Wheeler County",1,11,9,5,4
050,31,183,"Nebraska","Wheeler County",1,12,7,4,3
050,31,183,"Nebraska","Wheeler County",1,13,7,5,2
050,31,183,"Nebraska","Wheeler County",1,14,13,10,3
050,31,183,"Nebraska","Wheeler County",1,15,4,2,2
050,31,183,"Nebraska","Wheeler County",1,16,7,3,4
050,31,183,"Nebraska","Wheeler County",1,17,9,4,5
050,31,183,"Nebraska","Wheeler County",1,18,6,2,4
050,31,183,"Nebraska","Wheeler County",1,19,2,1,1
050,31,183,"Nebraska","Wheeler County",1,20,6,3,3
050,31,183,"Nebraska","Wheeler County",1,21,6,4,2
050,31,183,"Nebraska","Wheeler County",1,22,7,3,4
050,31,183,"Nebraska","Wheeler County",1,23,8,4,4
050,31,183,"Nebraska","Wheeler County",1,24,3,1,2
050,31,183,"Nebraska","Wheeler County",1,25,8,4,4
050,31,183,"Nebraska","Wheeler County",1,26,6,3,3
050,31,183,"Nebraska","Wheeler County",1,27,5,3,2
050,31,183,"Nebraska","Wheeler County",1,28,7,4,3
050,31,183,"Nebraska","Wheeler County",1,29,6,5,1
050,31,183,"Nebraska","Wheeler County",1,30,8,4,4
050,31,183,"Nebraska","Wheeler County",1,31,9,5,4
050,31,183,"Nebraska","Wheeler County",1,32,6,3,3
050,31,183,"Nebraska","Wheeler County",1,33,7,4,3
050,31,183,"Nebraska","Wheeler County",1,34,12,6,6
050,31,183,"Nebraska","Wheeler County",1,35,8,2,6
050,31,183,"Nebraska","Wheeler County",1,36,5,3,2
050,31,183,"Nebraska","Wheeler County",1,37,4,3,1
050,31,183,"Nebraska","Wheeler County",1,38,7,3,4
050,31,183,"Nebraska","Wheeler County",1,39,8,4,4
050,31,183,"Nebraska","Wheeler County",1,40,3,1,2
050,31,183,"Nebraska","Wheeler County",1,41,5,2,3
050,31,183,"Nebraska","Wheeler County",1,42,11,8,3
050,31,183,"Nebraska","Wheeler County",1,43,8,5,3
050,31,183,"Nebraska","Wheeler County",1,44,7,4,3
050,31,183,"Nebraska","Wheeler County",1,45,7,3,4
050,31,183,"Nebraska","Wheeler County",1,46,6,2,4
050,31,183,"Nebraska","Wheeler County",1,47,3,1,2
050,31,183,"Nebraska","Wheeler County",1,48,4,1,3
050,31,183,"Nebraska","Wheeler County",1,49,12,8,4
050,31,183,"Nebraska","Wheeler County",1,50,12,8,4
050,31,183,"Nebraska","Wheeler County",1,51,7,6,1
050,31,183,"Nebraska","Wheeler County",1,52,8,5,3
050,31,183,"Nebraska","Wheeler County",1,53,11,6,5
050,31,183,"Nebraska","Wheeler County",1,54,6,3,3
050,31,183,"Nebraska","Wheeler County",1,55,9,5,4
050,31,183,"Nebraska","Wheeler County",1,56,13,7,6
050,31,183,"Nebraska","Wheeler County",1,57,10,5,5
050,31,183,"Nebraska","Wheeler County",1,58,10,3,7
050,31,183,"Nebraska","Wheeler County",1,59,15,6,9
050,31,183,"Nebraska","Wheeler County",1,60,16,9,7
050,31,183,"Nebraska","Wheeler County",1,61,17,8,9
050,31,183,"Nebraska","Wheeler County",1,62,25,13,12
050,31,183,"Nebraska","Wheeler County",1,63,18,11,7
050,31,183,"Nebraska","Wheeler County",1,64,17,9,8
050,31,183,"Nebraska","Wheeler County",1,65,18,11,7
050,31,183,"Nebraska","Wheeler County",1,66,17,12,5
050,31,183,"Nebraska","Wheeler County",1,67,11,7,4
050,31,183,"Nebraska","Wheeler County",1,68,6,1,5
050,31,183,"Nebraska","Wheeler County",1,69,8,3,5
050,31,183,"Nebraska","Wheeler County",1,70,15,5,10
050,31,183,"Nebraska","Wheeler County",1,71,13,6,7
050,31,183,"Nebraska","Wheeler County",1,72,14,8,6
050,31,183,"Nebraska","Wheeler County",1,73,12,8,4
050,31,183,"Nebraska","Wheeler County",1,74,6,5,1
050,31,183,"Nebraska","Wheeler County",1,75,4,3,1
050,31,183,"Nebraska","Wheeler County",1,76,7,2,5
050,31,183,"Nebraska","Wheeler County",1,77,7,0,7
050,31,183,"Nebraska","Wheeler County",1,78,5,1,4
050,31,183,"Nebraska","Wheeler County",1,79,6,3,3
050,31,183,"Nebraska","Wheeler County",1,80,5,4,1
050,31,183,"Nebraska","Wheeler County",1,81,7,5,2
050,31,183,"Nebraska","Wheeler County",1,82,5,2,3
050,31,183,"Nebraska","Wheeler County",1,83,5,1,4
050,31,183,"Nebraska","Wheeler County",1,84,6,3,3
050,31,183,"Nebraska","Wheeler County",1,85,31,12,19
050,31,183,"Nebraska","Wheeler County",2,0,14,5,9
050,31,183,"Nebraska","Wheeler County",2,1,15,6,9
050,31,183,"Nebraska","Wheeler County",2,2,10,4,6
050,31,183,"Nebraska","Wheeler County",2,3,9,4,5
050,31,183,"Nebraska","Wheeler County",2,4,8,2,6
050,31,183,"Nebraska","Wheeler County",2,5,8,2,6
050,31,183,"Nebraska","Wheeler County",2,6,11,6,5
050,31,183,"Nebraska","Wheeler County",2,7,7,5,2
050,31,183,"Nebraska","Wheeler County",2,8,6,5,1
050,31,183,"Nebraska","Wheeler County",2,9,6,4,2
050,31,183,"Nebraska","Wheeler County",2,10,11,6,5
050,31,183,"Nebraska","Wheeler County",2,11,10,5,5
050,31,183,"Nebraska","Wheeler County",2,12,7,4,3
050,31,183,"Nebraska","Wheeler County",2,13,7,5,2
050,31,183,"Nebraska","Wheeler County",2,14,12,9,3
050,31,183,"Nebraska","Wheeler County",2,15,6,4,2
050,31,183,"Nebraska","Wheeler County",2,16,7,3,4
050,31,183,"Nebraska","Wheeler County",2,17,9,4,5
050,31,183,"Nebraska","Wheeler County",2,18,5,2,3
050,31,183,"Nebraska","Wheeler County",2,19,3,1,2
050,31,183,"Nebraska","Wheeler County",2,20,6,3,3
050,31,183,"Nebraska","Wheeler County",2,21,6,4,2
050,31,183,"Nebraska","Wheeler County",2,22,7,3,4
050,31,183,"Nebraska","Wheeler County",2,23,8,4,4
050,31,183,"Nebraska","Wheeler County",2,24,4,2,2
050,31,183,"Nebraska","Wheeler County",2,25,7,3,4
050,31,183,"Nebraska","Wheeler County",2,26,6,3,3
050,31,183,"Nebraska","Wheeler County",2,27,5,3,2
050,31,183,"Nebraska","Wheeler County",2,28,7,4,3
050,31,183,"Nebraska","Wheeler County",2,29,6,5,1
050,31,183,"Nebraska","Wheeler County",2,30,8,5,3
050,31,183,"Nebraska","Wheeler County",2,31,9,5,4
050,31,183,"Nebraska","Wheeler County",2,32,6,3,3
050,31,183,"Nebraska","Wheeler County",2,33,7,4,3
050,31,183,"Nebraska","Wheeler County",2,34,12,6,6
050,31,183,"Nebraska","Wheeler County",2,35,9,3,6
050,31,183,"Nebraska","Wheeler County",2,36,6,3,3
050,31,183,"Nebraska","Wheeler County",2,37,4,3,1
050,31,183,"Nebraska","Wheeler County",2,38,6,3,3
050,31,183,"Nebraska","Wheeler County",2,39,8,4,4
050,31,183,"Nebraska","Wheeler County",2,40,5,2,3
050,31,183,"Nebraska","Wheeler County",2,41,5,2,3
050,31,183,"Nebraska","Wheeler County",2,42,10,7,3
050,31,183,"Nebraska","Wheeler County",2,43,9,6,3
050,31,183,"Nebraska","Wheeler County",2,44,7,4,3
050,31,183,"Nebraska","Wheeler County",2,45,7,3,4
050,31,183,"Nebraska","Wheeler County",2,46,6,2,4
050,31,183,"Nebraska","Wheeler County",2,47,3,1,2
050,31,183,"Nebraska","Wheeler County",2,48,4,1,3
050,31,183,"Nebraska","Wheeler County",2,49,10,6,4
050,31,183,"Nebraska","Wheeler County",2,50,12,8,4
050,31,183,"Nebraska","Wheeler County",2,51,9,7,2
050,31,183,"Nebraska","Wheeler County",2,52,7,5,2
050,31,183,"Nebraska","Wheeler County",2,53,10,6,4
050,31,183,"Nebraska","Wheeler County",2,54,7,4,3
050,31,183,"Nebraska","Wheeler County",2,55,9,5,4
050,31,183,"Nebraska","Wheeler County",2,56,11,6,5
050,31,183,"Nebraska","Wheeler County",2,57,10,5,5
050,31,183,"Nebraska","Wheeler County",2,58,9,3,6
050,31,183,"Nebraska","Wheeler County",2,59,14,6,8
050,31,183,"Nebraska","Wheeler County",2,60,16,9,7
050,31,183,"Nebraska","Wheeler County",2,61,17,8,9
050,31,183,"Nebraska","Wheeler County",2,62,23,12,11
050,31,183,"Nebraska","Wheeler County",2,63,20,12,8
050,31,183,"Nebraska","Wheeler County",2,64,17,9,8
050,31,183,"Nebraska","Wheeler County",2,65,18,11,7
050,31,183,"Nebraska","Wheeler County",2,66,18,12,6
050,31,183,"Nebraska","Wheeler County",2,67,12,8,4
050,31,183,"Nebraska","Wheeler County",2,68,7,2,5
050,31,183,"Nebraska","Wheeler County",2,69,7,2,5
050,31,183,"Nebraska","Wheeler County",2,70,13,4,9
050,31,183,"Nebraska","Wheeler County",2,71,14,6,8
050,31,183,"Nebraska","Wheeler County",2,72,13,7,6
050,31,183,"Nebraska","Wheeler County",2,73,13,8,5
050,31,183,"Nebraska","Wheeler County",2,74,7,5,2
050,31,183,"Nebraska","Wheeler County",2,75,4,3,1
050,31,183,"Nebraska","Wheeler County",2,76,6,2,4
050,31,183,"Nebraska","Wheeler County",2,77,8,1,7
050,31,183,"Nebraska","Wheeler County",2,78,6,1,5
050,31,183,"Nebraska","Wheeler County",2,79,5,2,3
050,31,183,"Nebraska","Wheeler County",2,80,5,4,1
050,31,183,"Nebraska","Wheeler County",2,81,7,5,2
050,31,183,"Nebraska","Wheeler County",2,82,6,3,3
050,31,183,"Nebraska","Wheeler County",2,83,5,1,4
050,31,183,"Nebraska","Wheeler County",2,84,5,2,3
050,31,183,"Nebraska","Wheeler County",2,85,31,12,19
050,31,183,"Nebraska","Wheeler County",3,0,8,5,3
050,31,183,"Nebraska","Wheeler County",3,1,14,5,9
050,31,183,"Nebraska","Wheeler County",3,2,16,6,10
050,31,183,"Nebraska","Wheeler County",3,3,10,4,6
050,31,183,"Nebraska","Wheeler County",3,4,12,7,5
050,31,183,"Nebraska","Wheeler County",3,5,10,2,8
050,31,183,"Nebraska","Wheeler County",3,6,8,2,6
050,31,183,"Nebraska","Wheeler County",3,7,11,7,4
050,31,183,"Nebraska","Wheeler County",3,8,8,5,3
050,31,183,"Nebraska","Wheeler County",3,9,7,5,2
050,31,183,"Nebraska","Wheeler County",3,10,6,4,2
050,31,183,"Nebraska","Wheeler County",3,11,10,6,4
050,31,183,"Nebraska","Wheeler County",3,12,9,5,4
050,31,183,"Nebraska","Wheeler County",3,13,7,4,3
050,31,183,"Nebraska","Wheeler County",3,14,7,5,2
050,31,183,"Nebraska","Wheeler County",3,15,12,9,3
050,31,183,"Nebraska","Wheeler County",3,16,7,5,2
050,31,183,"Nebraska","Wheeler County",3,17,5,1,4
050,31,183,"Nebraska","Wheeler County",3,18,6,3,3
050,31,183,"Nebraska","Wheeler County",3,19,1,0,1
050,31,183,"Nebraska","Wheeler County",3,20,2,0,2
050,31,183,"Nebraska","Wheeler County",3,21,5,3,2
050,31,183,"Nebraska","Wheeler County",3,22,6,4,2
050,31,183,"Nebraska","Wheeler County",3,23,8,4,4
050,31,183,"Nebraska","Wheeler County",3,24,8,4,4
050,31,183,"Nebraska","Wheeler County",3,25,4,1,3
050,31,183,"Nebraska","Wheeler County",3,26,8,5,3
050,31,183,"Nebraska","Wheeler County",3,27,7,3,4
050,31,183,"Nebraska","Wheeler County",3,28,6,3,3
050,31,183,"Nebraska","Wheeler County",3,29,8,4,4
050,31,183,"Nebraska","Wheeler County",3,30,8,6,2
050,31,183,"Nebraska","Wheeler County",3,31,9,6,3
050,31,183,"Nebraska","Wheeler County",3,32,9,5,4
050,31,183,"Nebraska","Wheeler County",3,33,6,3,3
050,31,183,"Nebraska","Wheeler County",3,34,12,8,4
050,31,183,"Nebraska","Wheeler County",3,35,11,5,6
050,31,183,"Nebraska","Wheeler County",3,36,11,5,6
050,31,183,"Nebraska","Wheeler County",3,37,5,3,2
050,31,183,"Nebraska","Wheeler County",3,38,5,3,2
050,31,183,"Nebraska","Wheeler County",3,39,6,3,3
050,31,183,"Nebraska","Wheeler County",3,40,6,3,3
050,31,183,"Nebraska","Wheeler County",3,41,5,2,3
050,31,183,"Nebraska","Wheeler County",3,42,7,3,4
050,31,183,"Nebraska","Wheeler County",3,43,9,7,2
050,31,183,"Nebraska","Wheeler County",3,44,9,6,3
050,31,183,"Nebraska","Wheeler County",3,45,8,5,3
050,31,183,"Nebraska","Wheeler County",3,46,7,3,4
050,31,183,"Nebraska","Wheeler County",3,47,6,2,4
050,31,183,"Nebraska","Wheeler County",3,48,3,1,2
050,31,183,"Nebraska","Wheeler County",3,49,4,1,3
050,31,183,"Nebraska","Wheeler County",3,50,11,7,4
050,31,183,"Nebraska","Wheeler County",3,51,12,8,4
050,31,183,"Nebraska","Wheeler County",3,52,9,7,2
050,31,183,"Nebraska","Wheeler County",3,53,7,5,2
050,31,183,"Nebraska","Wheeler County",3,54,10,6,4
050,31,183,"Nebraska","Wheeler County",3,55,7,4,3
050,31,183,"Nebraska","Wheeler County",3,56,9,5,4
050,31,183,"Nebraska","Wheeler County",3,57,11,6,5
050,31,183,"Nebraska","Wheeler County",3,58,11,6,5
050,31,183,"Nebraska","Wheeler County",3,59,9,3,6
050,31,183,"Nebraska","Wheeler County",3,60,14,6,8
050,31,183,"Nebraska","Wheeler County",3,61,16,9,7
050,31,183,"Nebraska","Wheeler County",3,62,17,8,9
050,31,183,"Nebraska","Wheeler County",3,63,22,12,10
050,31,183,"Nebraska","Wheeler County",3,64,20,12,8
050,31,183,"Nebraska","Wheeler County",3,65,16,9,7
050,31,183,"Nebraska","Wheeler County",3,66,18,11,7
050,31,183,"Nebraska","Wheeler County",3,67,17,12,5
050,31,183,"Nebraska","Wheeler County",3,68,12,8,4
050,31,183,"Nebraska","Wheeler County",3,69,6,2,4
050,31,183,"Nebraska","Wheeler County",3,70,7,2,5
050,31,183,"Nebraska","Wheeler County",3,71,13,4,9
050,31,183,"Nebraska","Wheeler County",3,72,14,6,8
050,31,183,"Nebraska","Wheeler County",3,73,10,4,6
050,31,183,"Nebraska","Wheeler County",3,74,13,8,5
050,31,183,"Nebraska","Wheeler County",3,75,7,5,2
050,31,183,"Nebraska","Wheeler County",3,76,4,3,1
050,31,183,"Nebraska","Wheeler County",3,77,6,2,4
050,31,183,"Nebraska","Wheeler County",3,78,8,1,7
050,31,183,"Nebraska","Wheeler County",3,79,6,1,5
050,31,183,"Nebraska","Wheeler County",3,80,5,2,3
050,31,183,"Nebraska","Wheeler County",3,81,5,4,1
050,31,183,"Nebraska","Wheeler County",3,82,6,4,2
050,31,183,"Nebraska","Wheeler County",3,83,5,3,2
050,31,183,"Nebraska","Wheeler County",3,84,5,1,4
050,31,183,"Nebraska","Wheeler County",3,85,35,14,21
050,31,183,"Nebraska","Wheeler County",4,0,7,6,1
050,31,183,"Nebraska","Wheeler County",4,1,8,5,3
050,31,183,"Nebraska","Wheeler County",4,2,12,5,7
050,31,183,"Nebraska","Wheeler County",4,3,16,5,11
050,31,183,"Nebraska","Wheeler County",4,4,10,4,6
050,31,183,"Nebraska","Wheeler County",4,5,12,7,5
050,31,183,"Nebraska","Wheeler County",4,6,10,2,8
050,31,183,"Nebraska","Wheeler County",4,7,9,2,7
050,31,183,"Nebraska","Wheeler County",4,8,14,7,7
050,31,183,"Nebraska","Wheeler County",4,9,9,5,4
050,31,183,"Nebraska","Wheeler County",4,10,8,5,3
050,31,183,"Nebraska","Wheeler County",4,11,6,4,2
050,31,183,"Nebraska","Wheeler County",4,12,10,6,4
050,31,183,"Nebraska","Wheeler County",4,13,13,6,7
050,31,183,"Nebraska","Wheeler County",4,14,9,6,3
050,31,183,"Nebraska","Wheeler County",4,15,8,6,2
050,31,183,"Nebraska","Wheeler County",4,16,13,9,4
050,31,183,"Nebraska","Wheeler County",4,17,7,5,2
050,31,183,"Nebraska","Wheeler County",4,18,4,1,3
050,31,183,"Nebraska","Wheeler County",4,19,4,2,2
050,31,183,"Nebraska","Wheeler County",4,20,1,0,1
050,31,183,"Nebraska","Wheeler County",4,21,0,0,0
050,31,183,"Nebraska","Wheeler County",4,22,5,3,2
050,31,183,"Nebraska","Wheeler County",4,23,8,4,4
050,31,183,"Nebraska","Wheeler County",4,24,7,4,3
050,31,183,"Nebraska","Wheeler County",4,25,6,3,3
050,31,183,"Nebraska","Wheeler County",4,26,4,2,2
050,31,183,"Nebraska","Wheeler County",4,27,4,4,0
050,31,183,"Nebraska","Wheeler County",4,28,5,1,4
050,31,183,"Nebraska","Wheeler County",4,29,7,3,4
050,31,183,"Nebraska","Wheeler County",4,30,7,4,3
050,31,183,"Nebraska","Wheeler County",4,31,6,5,1
050,31,183,"Nebraska","Wheeler County",4,32,8,5,3
050,31,183,"Nebraska","Wheeler County",4,33,11,5,6
050,31,183,"Nebraska","Wheeler County",4,34,10,6,4
050,31,183,"Nebraska","Wheeler County",4,35,6,2,4
050,31,183,"Nebraska","Wheeler County",4,36,14,7,7
050,31,183,"Nebraska","Wheeler County",4,37,13,7,6
050,31,183,"Nebraska","Wheeler County",4,38,6,3,3
050,31,183,"Nebraska","Wheeler County",4,39,5,3,2
050,31,183,"Nebraska","Wheeler County",4,40,5,2,3
050,31,183,"Nebraska","Wheeler County",4,41,6,3,3
050,31,183,"Nebraska","Wheeler County",4,42,6,3,3
050,31,183,"Nebraska","Wheeler County",4,43,7,3,4
050,31,183,"Nebraska","Wheeler County",4,44,9,7,2
050,31,183,"Nebraska","Wheeler County",4,45,9,6,3
050,31,183,"Nebraska","Wheeler County",4,46,8,5,3
050,31,183,"Nebraska","Wheeler County",4,47,8,3,5
050,31,183,"Nebraska","Wheeler County",4,48,6,2,4
050,31,183,"Nebraska","Wheeler County",4,49,3,1,2
050,31,183,"Nebraska","Wheeler County",4,50,4,1,3
050,31,183,"Nebraska","Wheeler County",4,51,10,7,3
050,31,183,"Nebraska","Wheeler County",4,52,9,5,4
050,31,183,"Nebraska","Wheeler County",4,53,10,7,3
050,31,183,"Nebraska","Wheeler County",4,54,8,6,2
050,31,183,"Nebraska","Wheeler County",4,55,10,6,4
050,31,183,"Nebraska","Wheeler County",4,56,7,4,3
050,31,183,"Nebraska","Wheeler County",4,57,9,5,4
050,31,183,"Nebraska","Wheeler County",4,58,10,6,4
050,31,183,"Nebraska","Wheeler County",4,59,10,5,5
050,31,183,"Nebraska","Wheeler County",4,60,10,3,7
050,31,183,"Nebraska","Wheeler County",4,61,14,6,8
050,31,183,"Nebraska","Wheeler County",4,62,16,9,7
050,31,183,"Nebraska","Wheeler County",4,63,17,8,9
050,31,183,"Nebraska","Wheeler County",4,64,22,12,10
050,31,183,"Nebraska","Wheeler County",4,65,20,12,8
050,31,183,"Nebraska","Wheeler County",4,66,16,9,7
050,31,183,"Nebraska","Wheeler County",4,67,17,10,7
050,31,183,"Nebraska","Wheeler County",4,68,17,12,5
050,31,183,"Nebraska","Wheeler County",4,69,12,8,4
050,31,183,"Nebraska","Wheeler County",4,70,6,2,4
050,31,183,"Nebraska","Wheeler County",4,71,7,2,5
050,31,183,"Nebraska","Wheeler County",4,72,13,4,9
050,31,183,"Nebraska","Wheeler County",4,73,14,6,8
050,31,183,"Nebraska","Wheeler County",4,74,10,4,6
050,31,183,"Nebraska","Wheeler County",4,75,13,8,5
050,31,183,"Nebraska","Wheeler County",4,76,7,5,2
050,31,183,"Nebraska","Wheeler County",4,77,4,3,1
050,31,183,"Nebraska","Wheeler County",4,78,4,2,2
050,31,183,"Nebraska","Wheeler County",4,79,8,1,7
050,31,183,"Nebraska","Wheeler County",4,80,6,1,5
050,31,183,"Nebraska","Wheeler County",4,81,3,0,3
050,31,183,"Nebraska","Wheeler County",4,82,4,3,1
050,31,183,"Nebraska","Wheeler County",4,83,5,4,1
050,31,183,"Nebraska","Wheeler County",4,84,4,3,1
050,31,183,"Nebraska","Wheeler County",4,85,37,12,25
050,31,183,"Nebraska","Wheeler County",5,0,13,10,3
050,31,183,"Nebraska","Wheeler County",5,1,9,6,3
050,31,183,"Nebraska","Wheeler County",5,2,6,3,3
050,31,183,"Nebraska","Wheeler County",5,3,11,3,8
050,31,183,"Nebraska","Wheeler County",5,4,17,5,12
050,31,183,"Nebraska","Wheeler County",5,5,10,4,6
050,31,183,"Nebraska","Wheeler County",5,6,10,5,5
050,31,183,"Nebraska","Wheeler County",5,7,11,3,8
050,31,183,"Nebraska","Wheeler County",5,8,9,2,7
050,31,183,"Nebraska","Wheeler County",5,9,12,6,6
050,31,183,"Nebraska","Wheeler County",5,10,9,5,4
050,31,183,"Nebraska","Wheeler County",5,11,7,5,2
050,31,183,"Nebraska","Wheeler County",5,12,7,5,2
050,31,183,"Nebraska","Wheeler County",5,13,11,7,4
050,31,183,"Nebraska","Wheeler County",5,14,9,4,5
050,31,183,"Nebraska","Wheeler County",5,15,6,4,2
050,31,183,"Nebraska","Wheeler County",5,16,7,5,2
050,31,183,"Nebraska","Wheeler County",5,17,8,5,3
050,31,183,"Nebraska","Wheeler County",5,18,4,3,1
050,31,183,"Nebraska","Wheeler County",5,19,4,2,2
050,31,183,"Nebraska","Wheeler County",5,20,4,2,2
050,31,183,"Nebraska","Wheeler County",5,21,2,1,1
050,31,183,"Nebraska","Wheeler County",5,22,1,0,1
050,31,183,"Nebraska","Wheeler County",5,23,5,4,1
050,31,183,"Nebraska","Wheeler County",5,24,6,3,3
050,31,183,"Nebraska","Wheeler County",5,25,8,5,3
050,31,183,"Nebraska","Wheeler County",5,26,6,3,3
050,31,183,"Nebraska","Wheeler County",5,27,7,4,3
050,31,183,"Nebraska","Wheeler County",5,28,6,5,1
050,31,183,"Nebraska","Wheeler County",5,29,4,1,3
050,31,183,"Nebraska","Wheeler County",5,30,9,5,4
050,31,183,"Nebraska","Wheeler County",5,31,10,7,3
050,31,183,"Nebraska","Wheeler County",5,32,6,5,1
050,31,183,"Nebraska","Wheeler County",5,33,8,5,3
050,31,183,"Nebraska","Wheeler County",5,34,13,5,8
050,31,183,"Nebraska","Wheeler County",5,35,7,5,2
050,31,183,"Nebraska","Wheeler County",5,36,8,4,4
050,31,183,"Nebraska","Wheeler County",5,37,14,7,7
050,31,183,"Nebraska","Wheeler County",5,38,14,7,7
050,31,183,"Nebraska","Wheeler County",5,39,6,3,3
050,31,183,"Nebraska","Wheeler County",5,40,5,3,2
050,31,183,"Nebraska","Wheeler County",5,41,5,2,3
050,31,183,"Nebraska","Wheeler County",5,42,5,3,2
050,31,183,"Nebraska","Wheeler County",5,43,6,3,3
050,31,183,"Nebraska","Wheeler County",5,44,7,3,4
050,31,183,"Nebraska","Wheeler County",5,45,7,5,2
050,31,183,"Nebraska","Wheeler County",5,46,9,6,3
050,31,183,"Nebraska","Wheeler County",5,47,8,5,3
050,31,183,"Nebraska","Wheeler County",5,48,8,3,5
050,31,183,"Nebraska","Wheeler County",5,49,5,1,4
050,31,183,"Nebraska","Wheeler County",5,50,4,2,2
050,31,183,"Nebraska","Wheeler County",5,51,4,1,3
050,31,183,"Nebraska","Wheeler County",5,52,10,7,3
050,31,183,"Nebraska","Wheeler County",5,53,10,6,4
050,31,183,"Nebraska","Wheeler County",5,54,9,7,2
050,31,183,"Nebraska","Wheeler County",5,55,8,6,2
050,31,183,"Nebraska","Wheeler County",5,56,9,5,4
050,31,183,"Nebraska","Wheeler County",5,57,7,4,3
050,31,183,"Nebraska","Wheeler County",5,58,10,5,5
050,31,183,"Nebraska","Wheeler County",5,59,10,6,4
050,31,183,"Nebraska","Wheeler County",5,60,12,6,6
050,31,183,"Nebraska","Wheeler County",5,61,10,3,7
050,31,183,"Nebraska","Wheeler County",5,62,14,6,8
050,31,183,"Nebraska","Wheeler County",5,63,16,9,7
050,31,183,"Nebraska","Wheeler County",5,64,17,8,9
050,31,183,"Nebraska","Wheeler County",5,65,23,12,11
050,31,183,"Nebraska","Wheeler County",5,66,20,12,8
050,31,183,"Nebraska","Wheeler County",5,67,15,8,7
050,31,183,"Nebraska","Wheeler County",5,68,17,10,7
050,31,183,"Nebraska","Wheeler County",5,69,17,12,5
050,31,183,"Nebraska","Wheeler County",5,70,12,8,4
050,31,183,"Nebraska","Wheeler County",5,71,6,2,4
050,31,183,"Nebraska","Wheeler County",5,72,7,2,5
050,31,183,"Nebraska","Wheeler County",5,73,14,5,9
050,31,183,"Nebraska","Wheeler County",5,74,14,6,8
050,31,183,"Nebraska","Wheeler County",5,75,10,4,6
050,31,183,"Nebraska","Wheeler County",5,76,12,8,4
050,31,183,"Nebraska","Wheeler County",5,77,7,5,2
050,31,183,"Nebraska","Wheeler County",5,78,3,3,0
050,31,183,"Nebraska","Wheeler County",5,79,3,2,1
050,31,183,"Nebraska","Wheeler County",5,80,6,1,5
050,31,183,"Nebraska","Wheeler County",5,81,5,0,5
050,31,183,"Nebraska","Wheeler County",5,82,3,0,3
050,31,183,"Nebraska","Wheeler County",5,83,3,3,0
050,31,183,"Nebraska","Wheeler County",5,84,4,4,0
050,31,183,"Nebraska","Wheeler County",5,85,35,12,23
050,31,185,"Nebraska","York County",1,0,164,85,79
050,31,185,"Nebraska","York County",1,1,159,90,69
050,31,185,"Nebraska","York County",1,2,182,98,84
050,31,185,"Nebraska","York County",1,3,197,100,97
050,31,185,"Nebraska","York County",1,4,179,91,88
050,31,185,"Nebraska","York County",1,5,178,95,83
050,31,185,"Nebraska","York County",1,6,185,99,86
050,31,185,"Nebraska","York County",1,7,157,82,75
050,31,185,"Nebraska","York County",1,8,185,98,87
050,31,185,"Nebraska","York County",1,9,190,97,93
050,31,185,"Nebraska","York County",1,10,195,103,92
050,31,185,"Nebraska","York County",1,11,193,102,91
050,31,185,"Nebraska","York County",1,12,218,111,107
050,31,185,"Nebraska","York County",1,13,214,107,107
050,31,185,"Nebraska","York County",1,14,188,85,103
050,31,185,"Nebraska","York County",1,15,188,103,85
050,31,185,"Nebraska","York County",1,16,177,96,81
050,31,185,"Nebraska","York County",1,17,188,98,90
050,31,185,"Nebraska","York County",1,18,206,117,89
050,31,185,"Nebraska","York County",1,19,225,124,101
050,31,185,"Nebraska","York County",1,20,227,139,88
050,31,185,"Nebraska","York County",1,21,172,99,73
050,31,185,"Nebraska","York County",1,22,186,104,82
050,31,185,"Nebraska","York County",1,23,148,82,66
050,31,185,"Nebraska","York County",1,24,165,84,81
050,31,185,"Nebraska","York County",1,25,166,82,84
050,31,185,"Nebraska","York County",1,26,171,74,97
050,31,185,"Nebraska","York County",1,27,159,86,73
050,31,185,"Nebraska","York County",1,28,187,86,101
050,31,185,"Nebraska","York County",1,29,168,80,88
050,31,185,"Nebraska","York County",1,30,165,77,88
050,31,185,"Nebraska","York County",1,31,152,76,76
050,31,185,"Nebraska","York County",1,32,154,68,86
050,31,185,"Nebraska","York County",1,33,157,66,91
050,31,185,"Nebraska","York County",1,34,185,93,92
050,31,185,"Nebraska","York County",1,35,166,84,82
050,31,185,"Nebraska","York County",1,36,150,86,64
050,31,185,"Nebraska","York County",1,37,161,80,81
050,31,185,"Nebraska","York County",1,38,171,85,86
050,31,185,"Nebraska","York County",1,39,177,85,92
050,31,185,"Nebraska","York County",1,40,150,77,73
050,31,185,"Nebraska","York County",1,41,143,74,69
050,31,185,"Nebraska","York County",1,42,150,77,73
050,31,185,"Nebraska","York County",1,43,153,74,79
050,31,185,"Nebraska","York County",1,44,156,74,82
050,31,185,"Nebraska","York County",1,45,135,69,66
050,31,185,"Nebraska","York County",1,46,134,71,63
050,31,185,"Nebraska","York County",1,47,144,74,70
050,31,185,"Nebraska","York County",1,48,149,73,76
050,31,185,"Nebraska","York County",1,49,150,80,70
050,31,185,"Nebraska","York County",1,50,154,79,75
050,31,185,"Nebraska","York County",1,51,145,64,81
050,31,185,"Nebraska","York County",1,52,129,59,70
050,31,185,"Nebraska","York County",1,53,144,73,71
050,31,185,"Nebraska","York County",1,54,160,81,79
050,31,185,"Nebraska","York County",1,55,172,90,82
050,31,185,"Nebraska","York County",1,56,174,87,87
050,31,185,"Nebraska","York County",1,57,194,92,102
050,31,185,"Nebraska","York County",1,58,195,100,95
050,31,185,"Nebraska","York County",1,59,213,110,103
050,31,185,"Nebraska","York County",1,60,209,104,105
050,31,185,"Nebraska","York County",1,61,204,99,105
050,31,185,"Nebraska","York County",1,62,196,100,96
050,31,185,"Nebraska","York County",1,63,197,102,95
050,31,185,"Nebraska","York County",1,64,190,89,101
050,31,185,"Nebraska","York County",1,65,177,82,95
050,31,185,"Nebraska","York County",1,66,165,82,83
050,31,185,"Nebraska","York County",1,67,181,85,96
050,31,185,"Nebraska","York County",1,68,173,78,95
050,31,185,"Nebraska","York County",1,69,159,70,89
050,31,185,"Nebraska","York County",1,70,149,77,72
050,31,185,"Nebraska","York County",1,71,148,76,72
050,31,185,"Nebraska","York County",1,72,144,69,75
050,31,185,"Nebraska","York County",1,73,148,72,76
050,31,185,"Nebraska","York County",1,74,104,46,58
050,31,185,"Nebraska","York County",1,75,96,42,54
050,31,185,"Nebraska","York County",1,76,107,55,52
050,31,185,"Nebraska","York County",1,77,104,49,55
050,31,185,"Nebraska","York County",1,78,80,38,42
050,31,185,"Nebraska","York County",1,79,76,28,48
050,31,185,"Nebraska","York County",1,80,82,31,51
050,31,185,"Nebraska","York County",1,81,78,30,48
050,31,185,"Nebraska","York County",1,82,83,36,47
050,31,185,"Nebraska","York County",1,83,85,33,52
050,31,185,"Nebraska","York County",1,84,66,26,40
050,31,185,"Nebraska","York County",1,85,426,174,252
050,31,185,"Nebraska","York County",2,0,152,82,70
050,31,185,"Nebraska","York County",2,1,158,88,70
050,31,185,"Nebraska","York County",2,2,176,96,80
050,31,185,"Nebraska","York County",2,3,192,99,93
050,31,185,"Nebraska","York County",2,4,184,94,90
050,31,185,"Nebraska","York County",2,5,177,93,84
050,31,185,"Nebraska","York County",2,6,183,98,85
050,31,185,"Nebraska","York County",2,7,163,87,76
050,31,185,"Nebraska","York County",2,8,178,94,84
050,31,185,"Nebraska","York County",2,9,189,96,93
050,31,185,"Nebraska","York County",2,10,192,101,91
050,31,185,"Nebraska","York County",2,11,191,101,90
050,31,185,"Nebraska","York County",2,12,212,110,102
050,31,185,"Nebraska","York County",2,13,211,104,107
050,31,185,"Nebraska","York County",2,14,196,92,104
050,31,185,"Nebraska","York County",2,15,189,99,90
050,31,185,"Nebraska","York County",2,16,181,98,83
050,31,185,"Nebraska","York County",2,17,185,99,86
050,31,185,"Nebraska","York County",2,18,206,117,89
050,31,185,"Nebraska","York County",2,19,228,128,100
050,31,185,"Nebraska","York County",2,20,228,140,88
050,31,185,"Nebraska","York County",2,21,176,101,75
050,31,185,"Nebraska","York County",2,22,182,103,79
050,31,185,"Nebraska","York County",2,23,149,81,68
050,31,185,"Nebraska","York County",2,24,161,83,78
050,31,185,"Nebraska","York County",2,25,162,80,82
050,31,185,"Nebraska","York County",2,26,172,77,95
050,31,185,"Nebraska","York County",2,27,160,84,76
050,31,185,"Nebraska","York County",2,28,185,87,98
050,31,185,"Nebraska","York County",2,29,169,79,90
050,31,185,"Nebraska","York County",2,30,166,79,87
050,31,185,"Nebraska","York County",2,31,155,75,80
050,31,185,"Nebraska","York County",2,32,153,69,84
050,31,185,"Nebraska","York County",2,33,157,66,91
050,31,185,"Nebraska","York County",2,34,177,86,91
050,31,185,"Nebraska","York County",2,35,172,88,84
050,31,185,"Nebraska","York County",2,36,150,84,66
050,31,185,"Nebraska","York County",2,37,160,82,78
050,31,185,"Nebraska","York County",2,38,167,83,84
050,31,185,"Nebraska","York County",2,39,177,86,91
050,31,185,"Nebraska","York County",2,40,155,80,75
050,31,185,"Nebraska","York County",2,41,143,73,70
050,31,185,"Nebraska","York County",2,42,147,75,72
050,31,185,"Nebraska","York County",2,43,155,77,78
050,31,185,"Nebraska","York County",2,44,156,74,82
050,31,185,"Nebraska","York County",2,45,137,70,67
050,31,185,"Nebraska","York County",2,46,134,71,63
050,31,185,"Nebraska","York County",2,47,140,71,69
050,31,185,"Nebraska","York County",2,48,146,72,74
050,31,185,"Nebraska","York County",2,49,149,77,72
050,31,185,"Nebraska","York County",2,50,153,78,75
050,31,185,"Nebraska","York County",2,51,148,68,80
050,31,185,"Nebraska","York County",2,52,132,60,72
050,31,185,"Nebraska","York County",2,53,141,70,71
050,31,185,"Nebraska","York County",2,54,155,78,77
050,31,185,"Nebraska","York County",2,55,167,87,80
050,31,185,"Nebraska","York County",2,56,174,88,86
050,31,185,"Nebraska","York County",2,57,188,90,98
050,31,185,"Nebraska","York County",2,58,197,99,98
050,31,185,"Nebraska","York County",2,59,212,109,103
050,31,185,"Nebraska","York County",2,60,210,106,104
050,31,185,"Nebraska","York County",2,61,203,100,103
050,31,185,"Nebraska","York County",2,62,198,100,98
050,31,185,"Nebraska","York County",2,63,198,102,96
050,31,185,"Nebraska","York County",2,64,189,91,98
050,31,185,"Nebraska","York County",2,65,178,83,95
050,31,185,"Nebraska","York County",2,66,169,82,87
050,31,185,"Nebraska","York County",2,67,176,84,92
050,31,185,"Nebraska","York County",2,68,173,78,95
050,31,185,"Nebraska","York County",2,69,164,73,91
050,31,185,"Nebraska","York County",2,70,150,74,76
050,31,185,"Nebraska","York County",2,71,147,75,72
050,31,185,"Nebraska","York County",2,72,143,70,73
050,31,185,"Nebraska","York County",2,73,155,74,81
050,31,185,"Nebraska","York County",2,74,108,49,59
050,31,185,"Nebraska","York County",2,75,98,43,55
050,31,185,"Nebraska","York County",2,76,103,51,52
050,31,185,"Nebraska","York County",2,77,107,50,57
050,31,185,"Nebraska","York County",2,78,82,40,42
050,31,185,"Nebraska","York County",2,79,75,29,46
050,31,185,"Nebraska","York County",2,80,83,31,52
050,31,185,"Nebraska","York County",2,81,78,30,48
050,31,185,"Nebraska","York County",2,82,81,34,47
050,31,185,"Nebraska","York County",2,83,85,34,51
050,31,185,"Nebraska","York County",2,84,69,28,41
050,31,185,"Nebraska","York County",2,85,430,175,255
050,31,185,"Nebraska","York County",3,0,164,81,83
050,31,185,"Nebraska","York County",3,1,161,89,72
050,31,185,"Nebraska","York County",3,2,157,86,71
050,31,185,"Nebraska","York County",3,3,174,95,79
050,31,185,"Nebraska","York County",3,4,191,97,94
050,31,185,"Nebraska","York County",3,5,188,91,97
050,31,185,"Nebraska","York County",3,6,172,90,82
050,31,185,"Nebraska","York County",3,7,189,103,86
050,31,185,"Nebraska","York County",3,8,168,87,81
050,31,185,"Nebraska","York County",3,9,179,97,82
050,31,185,"Nebraska","York County",3,10,205,106,99
050,31,185,"Nebraska","York County",3,11,203,104,99
050,31,185,"Nebraska","York County",3,12,202,109,93
050,31,185,"Nebraska","York County",3,13,209,105,104
050,31,185,"Nebraska","York County",3,14,217,106,111
050,31,185,"Nebraska","York County",3,15,207,102,105
050,31,185,"Nebraska","York County",3,16,188,96,92
050,31,185,"Nebraska","York County",3,17,185,100,85
050,31,185,"Nebraska","York County",3,18,203,112,91
050,31,185,"Nebraska","York County",3,19,234,134,100
050,31,185,"Nebraska","York County",3,20,238,143,95
050,31,185,"Nebraska","York County",3,21,194,111,83
050,31,185,"Nebraska","York County",3,22,198,106,92
050,31,185,"Nebraska","York County",3,23,156,85,71
050,31,185,"Nebraska","York County",3,24,154,76,78
050,31,185,"Nebraska","York County",3,25,144,70,74
050,31,185,"Nebraska","York County",3,26,165,73,92
050,31,185,"Nebraska","York County",3,27,174,89,85
050,31,185,"Nebraska","York County",3,28,170,87,83
050,31,185,"Nebraska","York County",3,29,185,90,95
050,31,185,"Nebraska","York County",3,30,170,80,90
050,31,185,"Nebraska","York County",3,31,171,84,87
050,31,185,"Nebraska","York County",3,32,162,74,88
050,31,185,"Nebraska","York County",3,33,161,75,86
050,31,185,"Nebraska","York County",3,34,161,67,94
050,31,185,"Nebraska","York County",3,35,183,90,93
050,31,185,"Nebraska","York County",3,36,174,88,86
050,31,185,"Nebraska","York County",3,37,154,84,70
050,31,185,"Nebraska","York County",3,38,156,79,77
050,31,185,"Nebraska","York County",3,39,183,87,96
050,31,185,"Nebraska","York County",3,40,172,88,84
050,31,185,"Nebraska","York County",3,41,164,79,85
050,31,185,"Nebraska","York County",3,42,138,70,68
050,31,185,"Nebraska","York County",3,43,151,78,73
050,31,185,"Nebraska","York County",3,44,153,75,78
050,31,185,"Nebraska","York County",3,45,146,74,72
050,31,185,"Nebraska","York County",3,46,136,66,70
050,31,185,"Nebraska","York County",3,47,143,75,68
050,31,185,"Nebraska","York County",3,48,138,72,66
050,31,185,"Nebraska","York County",3,49,142,73,69
050,31,185,"Nebraska","York County",3,50,157,78,79
050,31,185,"Nebraska","York County",3,51,164,84,80
050,31,185,"Nebraska","York County",3,52,141,64,77
050,31,185,"Nebraska","York County",3,53,127,59,68
050,31,185,"Nebraska","York County",3,54,141,71,70
050,31,185,"Nebraska","York County",3,55,155,77,78
050,31,185,"Nebraska","York County",3,56,168,88,80
050,31,185,"Nebraska","York County",3,57,168,83,85
050,31,185,"Nebraska","York County",3,58,192,89,103
050,31,185,"Nebraska","York County",3,59,201,102,99
050,31,185,"Nebraska","York County",3,60,209,109,100
050,31,185,"Nebraska","York County",3,61,209,106,103
050,31,185,"Nebraska","York County",3,62,196,95,101
050,31,185,"Nebraska","York County",3,63,198,100,98
050,31,185,"Nebraska","York County",3,64,201,102,99
050,31,185,"Nebraska","York County",3,65,189,95,94
050,31,185,"Nebraska","York County",3,66,169,78,91
050,31,185,"Nebraska","York County",3,67,170,83,87
050,31,185,"Nebraska","York County",3,68,177,84,93
050,31,185,"Nebraska","York County",3,69,167,75,92
050,31,185,"Nebraska","York County",3,70,160,75,85
050,31,185,"Nebraska","York County",3,71,144,72,72
050,31,185,"Nebraska","York County",3,72,142,74,68
050,31,185,"Nebraska","York County",3,73,139,62,77
050,31,185,"Nebraska","York County",3,74,147,71,76
050,31,185,"Nebraska","York County",3,75,104,48,56
050,31,185,"Nebraska","York County",3,76,93,40,53
050,31,185,"Nebraska","York County",3,77,101,47,54
050,31,185,"Nebraska","York County",3,78,99,48,51
050,31,185,"Nebraska","York County",3,79,78,38,40
050,31,185,"Nebraska","York County",3,80,77,29,48
050,31,185,"Nebraska","York County",3,81,75,29,46
050,31,185,"Nebraska","York County",3,82,72,26,46
050,31,185,"Nebraska","York County",3,83,83,32,51
050,31,185,"Nebraska","York County",3,84,77,35,42
050,31,185,"Nebraska","York County",3,85,417,170,247
050,31,185,"Nebraska","York County",4,0,159,84,75
050,31,185,"Nebraska","York County",4,1,158,79,79
050,31,185,"Nebraska","York County",4,2,169,95,74
050,31,185,"Nebraska","York County",4,3,156,84,72
050,31,185,"Nebraska","York County",4,4,176,98,78
050,31,185,"Nebraska","York County",4,5,192,101,91
050,31,185,"Nebraska","York County",4,6,183,88,95
050,31,185,"Nebraska","York County",4,7,176,89,87
050,31,185,"Nebraska","York County",4,8,194,103,91
050,31,185,"Nebraska","York County",4,9,172,86,86
050,31,185,"Nebraska","York County",4,10,190,104,86
050,31,185,"Nebraska","York County",4,11,202,104,98
050,31,185,"Nebraska","York County",4,12,198,105,93
050,31,185,"Nebraska","York County",4,13,200,106,94
050,31,185,"Nebraska","York County",4,14,211,106,105
050,31,185,"Nebraska","York County",4,15,213,108,105
050,31,185,"Nebraska","York County",4,16,204,98,106
050,31,185,"Nebraska","York County",4,17,190,96,94
050,31,185,"Nebraska","York County",4,18,199,110,89
050,31,185,"Nebraska","York County",4,19,228,131,97
050,31,185,"Nebraska","York County",4,20,235,147,88
050,31,185,"Nebraska","York County",4,21,188,111,77
050,31,185,"Nebraska","York County",4,22,209,119,90
050,31,185,"Nebraska","York County",4,23,181,87,94
050,31,185,"Nebraska","York County",4,24,159,79,80
050,31,185,"Nebraska","York County",4,25,150,82,68
050,31,185,"Nebraska","York County",4,26,172,75,97
050,31,185,"Nebraska","York County",4,27,166,78,88
050,31,185,"Nebraska","York County",4,28,183,90,93
050,31,185,"Nebraska","York County",4,29,165,82,83
050,31,185,"Nebraska","York County",4,30,180,91,89
050,31,185,"Nebraska","York County",4,31,179,89,90
050,31,185,"Nebraska","York County",4,32,184,88,96
050,31,185,"Nebraska","York County",4,33,165,74,91
050,31,185,"Nebraska","York County",4,34,163,79,84
050,31,185,"Nebraska","York County",4,35,172,77,95
050,31,185,"Nebraska","York County",4,36,195,96,99
050,31,185,"Nebraska","York County",4,37,180,87,93
050,31,185,"Nebraska","York County",4,38,150,84,66
050,31,185,"Nebraska","York County",4,39,172,84,88
050,31,185,"Nebraska","York County",4,40,174,90,84
050,31,185,"Nebraska","York County",4,41,177,89,88
050,31,185,"Nebraska","York County",4,42,165,81,84
050,31,185,"Nebraska","York County",4,43,138,66,72
050,31,185,"Nebraska","York County",4,44,155,77,78
050,31,185,"Nebraska","York County",4,45,144,75,69
050,31,185,"Nebraska","York County",4,46,148,78,70
050,31,185,"Nebraska","York County",4,47,133,67,66
050,31,185,"Nebraska","York County",4,48,147,74,73
050,31,185,"Nebraska","York County",4,49,130,72,58
050,31,185,"Nebraska","York County",4,50,142,71,71
050,31,185,"Nebraska","York County",4,51,162,83,79
050,31,185,"Nebraska","York County",4,52,154,82,72
050,31,185,"Nebraska","York County",4,53,150,71,79
050,31,185,"Nebraska","York County",4,54,136,66,70
050,31,185,"Nebraska","York County",4,55,145,77,68
050,31,185,"Nebraska","York County",4,56,156,80,76
050,31,185,"Nebraska","York County",4,57,171,87,84
050,31,185,"Nebraska","York County",4,58,170,83,87
050,31,185,"Nebraska","York County",4,59,187,87,100
050,31,185,"Nebraska","York County",4,60,204,105,99
050,31,185,"Nebraska","York County",4,61,202,104,98
050,31,185,"Nebraska","York County",4,62,203,101,102
050,31,185,"Nebraska","York County",4,63,195,96,99
050,31,185,"Nebraska","York County",4,64,193,99,94
050,31,185,"Nebraska","York County",4,65,200,98,102
050,31,185,"Nebraska","York County",4,66,186,92,94
050,31,185,"Nebraska","York County",4,67,163,77,86
050,31,185,"Nebraska","York County",4,68,161,77,84
050,31,185,"Nebraska","York County",4,69,177,84,93
050,31,185,"Nebraska","York County",4,70,161,73,88
050,31,185,"Nebraska","York County",4,71,159,72,87
050,31,185,"Nebraska","York County",4,72,147,75,72
050,31,185,"Nebraska","York County",4,73,142,70,72
050,31,185,"Nebraska","York County",4,74,133,61,72
050,31,185,"Nebraska","York County",4,75,139,67,72
050,31,185,"Nebraska","York County",4,76,104,48,56
050,31,185,"Nebraska","York County",4,77,93,36,57
050,31,185,"Nebraska","York County",4,78,93,45,48
050,31,185,"Nebraska","York County",4,79,101,47,54
050,31,185,"Nebraska","York County",4,80,71,32,39
050,31,185,"Nebraska","York County",4,81,70,28,42
050,31,185,"Nebraska","York County",4,82,69,26,43
050,31,185,"Nebraska","York County",4,83,70,24,46
050,31,185,"Nebraska","York County",4,84,70,29,41
050,31,185,"Nebraska","York County",4,85,404,170,234
050,31,185,"Nebraska","York County",5,0,159,84,75
050,31,185,"Nebraska","York County",5,1,164,82,82
050,31,185,"Nebraska","York County",5,2,153,84,69
050,31,185,"Nebraska","York County",5,3,166,92,74
050,31,185,"Nebraska","York County",5,4,166,93,73
050,31,185,"Nebraska","York County",5,5,177,96,81
050,31,185,"Nebraska","York County",5,6,178,94,84
050,31,185,"Nebraska","York County",5,7,186,94,92
050,31,185,"Nebraska","York County",5,8,196,99,97
050,31,185,"Nebraska","York County",5,9,196,101,95
050,31,185,"Nebraska","York County",5,10,173,90,83
050,31,185,"Nebraska","York County",5,11,191,104,87
050,31,185,"Nebraska","York County",5,12,207,110,97
050,31,185,"Nebraska","York County",5,13,199,102,97
050,31,185,"Nebraska","York County",5,14,198,104,94
050,31,185,"Nebraska","York County",5,15,219,108,111
050,31,185,"Nebraska","York County",5,16,213,108,105
050,31,185,"Nebraska","York County",5,17,211,101,110
050,31,185,"Nebraska","York County",5,18,207,110,97
050,31,185,"Nebraska","York County",5,19,222,124,98
050,31,185,"Nebraska","York County",5,20,221,144,77
050,31,185,"Nebraska","York County",5,21,185,115,70
050,31,185,"Nebraska","York County",5,22,210,121,89
050,31,185,"Nebraska","York County",5,23,178,106,72
050,31,185,"Nebraska","York County",5,24,184,77,107
050,31,185,"Nebraska","York County",5,25,151,82,69
050,31,185,"Nebraska","York County",5,26,172,82,90
050,31,185,"Nebraska","York County",5,27,154,73,81
050,31,185,"Nebraska","York County",5,28,190,83,107
050,31,185,"Nebraska","York County",5,29,170,83,87
050,31,185,"Nebraska","York County",5,30,163,83,80
050,31,185,"Nebraska","York County",5,31,188,97,91
050,31,185,"Nebraska","York County",5,32,189,89,100
050,31,185,"Nebraska","York County",5,33,191,93,98
050,31,185,"Nebraska","York County",5,34,171,75,96
050,31,185,"Nebraska","York County",5,35,156,76,80
050,31,185,"Nebraska","York County",5,36,166,74,92
050,31,185,"Nebraska","York County",5,37,196,104,92
050,31,185,"Nebraska","York County",5,38,171,85,86
050,31,185,"Nebraska","York County",5,39,154,88,66
050,31,185,"Nebraska","York County",5,40,165,83,82
050,31,185,"Nebraska","York County",5,41,174,87,87
050,31,185,"Nebraska","York County",5,42,176,86,90
050,31,185,"Nebraska","York County",5,43,165,80,85
050,31,185,"Nebraska","York County",5,44,153,71,82
050,31,185,"Nebraska","York County",5,45,150,75,75
050,31,185,"Nebraska","York County",5,46,137,71,66
050,31,185,"Nebraska","York County",5,47,159,85,74
050,31,185,"Nebraska","York County",5,48,133,65,68
050,31,185,"Nebraska","York County",5,49,139,75,64
050,31,185,"Nebraska","York County",5,50,136,74,62
050,31,185,"Nebraska","York County",5,51,138,67,71
050,31,185,"Nebraska","York County",5,52,157,78,79
050,31,185,"Nebraska","York County",5,53,153,82,71
050,31,185,"Nebraska","York County",5,54,150,69,81
050,31,185,"Nebraska","York County",5,55,141,68,73
050,31,185,"Nebraska","York County",5,56,145,77,68
050,31,185,"Nebraska","York County",5,57,158,81,77
050,31,185,"Nebraska","York County",5,58,171,87,84
050,31,185,"Nebraska","York County",5,59,170,84,86
050,31,185,"Nebraska","York County",5,60,186,85,101
050,31,185,"Nebraska","York County",5,61,204,104,100
050,31,185,"Nebraska","York County",5,62,204,102,102
050,31,185,"Nebraska","York County",5,63,205,102,103
050,31,185,"Nebraska","York County",5,64,193,94,99
050,31,185,"Nebraska","York County",5,65,185,99,86
050,31,185,"Nebraska","York County",5,66,195,96,99
050,31,185,"Nebraska","York County",5,67,183,91,92
050,31,185,"Nebraska","York County",5,68,160,72,88
050,31,185,"Nebraska","York County",5,69,156,77,79
050,31,185,"Nebraska","York County",5,70,170,77,93
050,31,185,"Nebraska","York County",5,71,159,71,88
050,31,185,"Nebraska","York County",5,72,162,74,88
050,31,185,"Nebraska","York County",5,73,141,67,74
050,31,185,"Nebraska","York County",5,74,138,69,69
050,31,185,"Nebraska","York County",5,75,128,57,71
050,31,185,"Nebraska","York County",5,76,138,67,71
050,31,185,"Nebraska","York County",5,77,104,44,60
050,31,185,"Nebraska","York County",5,78,87,36,51
050,31,185,"Nebraska","York County",5,79,94,44,50
050,31,185,"Nebraska","York County",5,80,99,42,57
050,31,185,"Nebraska","York County",5,81,65,30,35
050,31,185,"Nebraska","York County",5,82,62,26,36
050,31,185,"Nebraska","York County",5,83,68,23,45
050,31,185,"Nebraska","York County",5,84,64,23,41
050,31,185,"Nebraska","York County",5,85,395,164,231

