"SUMLEV","STATE","COUNTY","STNAME","CTYNAME","YEAR","AGE","TOT_POP","TOT_MALE","TOT_FEMALE"
050,24,001,"Maryland","Allegany County",1,0,646,329,317
050,24,001,"Maryland","Allegany County",1,1,633,317,316
050,24,001,"Maryland","Allegany County",1,2,621,329,292
050,24,001,"Maryland","Allegany County",1,3,650,343,307
050,24,001,"Maryland","Allegany County",1,4,634,328,306
050,24,001,"Maryland","Allegany County",1,5,626,334,292
050,24,001,"Maryland","Allegany County",1,6,675,355,320
050,24,001,"Maryland","Allegany County",1,7,651,331,320
050,24,001,"Maryland","Allegany County",1,8,663,319,344
050,24,001,"Maryland","Allegany County",1,9,696,363,333
050,24,001,"Maryland","Allegany County",1,10,687,366,321
050,24,001,"Maryland","Allegany County",1,11,665,356,309
050,24,001,"Maryland","Allegany County",1,12,696,362,334
050,24,001,"Maryland","Allegany County",1,13,709,374,335
050,24,001,"Maryland","Allegany County",1,14,725,398,327
050,24,001,"Maryland","Allegany County",1,15,699,362,337
050,24,001,"Maryland","Allegany County",1,16,712,362,350
050,24,001,"Maryland","Allegany County",1,17,736,379,357
050,24,001,"Maryland","Allegany County",1,18,890,454,436
050,24,001,"Maryland","Allegany County",1,19,972,505,467
050,24,001,"Maryland","Allegany County",1,20,1245,597,648
050,24,001,"Maryland","Allegany County",1,21,1260,708,552
050,24,001,"Maryland","Allegany County",1,22,1068,602,466
050,24,001,"Maryland","Allegany County",1,23,873,459,414
050,24,001,"Maryland","Allegany County",1,24,902,514,388
050,24,001,"Maryland","Allegany County",1,25,867,506,361
050,24,001,"Maryland","Allegany County",1,26,846,490,356
050,24,001,"Maryland","Allegany County",1,27,912,533,379
050,24,001,"Maryland","Allegany County",1,28,897,505,392
050,24,001,"Maryland","Allegany County",1,29,914,545,369
050,24,001,"Maryland","Allegany County",1,30,868,549,319
050,24,001,"Maryland","Allegany County",1,31,878,541,337
050,24,001,"Maryland","Allegany County",1,32,886,549,337
050,24,001,"Maryland","Allegany County",1,33,865,537,328
050,24,001,"Maryland","Allegany County",1,34,860,528,332
050,24,001,"Maryland","Allegany County",1,35,826,477,349
050,24,001,"Maryland","Allegany County",1,36,815,457,358
050,24,001,"Maryland","Allegany County",1,37,820,475,345
050,24,001,"Maryland","Allegany County",1,38,845,506,339
050,24,001,"Maryland","Allegany County",1,39,874,507,367
050,24,001,"Maryland","Allegany County",1,40,838,498,340
050,24,001,"Maryland","Allegany County",1,41,810,463,347
050,24,001,"Maryland","Allegany County",1,42,751,442,309
050,24,001,"Maryland","Allegany County",1,43,717,415,302
050,24,001,"Maryland","Allegany County",1,44,756,435,321
050,24,001,"Maryland","Allegany County",1,45,767,434,333
050,24,001,"Maryland","Allegany County",1,46,779,426,353
050,24,001,"Maryland","Allegany County",1,47,787,417,370
050,24,001,"Maryland","Allegany County",1,48,864,461,403
050,24,001,"Maryland","Allegany County",1,49,916,471,445
050,24,001,"Maryland","Allegany County",1,50,888,477,411
050,24,001,"Maryland","Allegany County",1,51,848,466,382
050,24,001,"Maryland","Allegany County",1,52,812,443,369
050,24,001,"Maryland","Allegany County",1,53,884,497,387
050,24,001,"Maryland","Allegany County",1,54,898,482,416
050,24,001,"Maryland","Allegany County",1,55,906,458,448
050,24,001,"Maryland","Allegany County",1,56,890,442,448
050,24,001,"Maryland","Allegany County",1,57,872,443,429
050,24,001,"Maryland","Allegany County",1,58,949,457,492
050,24,001,"Maryland","Allegany County",1,59,997,506,491
050,24,001,"Maryland","Allegany County",1,60,962,483,479
050,24,001,"Maryland","Allegany County",1,61,935,462,473
050,24,001,"Maryland","Allegany County",1,62,954,501,453
050,24,001,"Maryland","Allegany County",1,63,947,468,479
050,24,001,"Maryland","Allegany County",1,64,872,437,435
050,24,001,"Maryland","Allegany County",1,65,856,439,417
050,24,001,"Maryland","Allegany County",1,66,831,407,424
050,24,001,"Maryland","Allegany County",1,67,808,378,430
050,24,001,"Maryland","Allegany County",1,68,831,409,422
050,24,001,"Maryland","Allegany County",1,69,767,369,398
050,24,001,"Maryland","Allegany County",1,70,758,349,409
050,24,001,"Maryland","Allegany County",1,71,759,360,399
050,24,001,"Maryland","Allegany County",1,72,819,391,428
050,24,001,"Maryland","Allegany County",1,73,858,399,459
050,24,001,"Maryland","Allegany County",1,74,575,248,327
050,24,001,"Maryland","Allegany County",1,75,590,268,322
050,24,001,"Maryland","Allegany County",1,76,592,268,324
050,24,001,"Maryland","Allegany County",1,77,559,265,294
050,24,001,"Maryland","Allegany County",1,78,498,214,284
050,24,001,"Maryland","Allegany County",1,79,457,201,256
050,24,001,"Maryland","Allegany County",1,80,421,189,232
050,24,001,"Maryland","Allegany County",1,81,441,183,258
050,24,001,"Maryland","Allegany County",1,82,405,167,238
050,24,001,"Maryland","Allegany County",1,83,348,144,204
050,24,001,"Maryland","Allegany County",1,84,283,127,156
050,24,001,"Maryland","Allegany County",1,85,1746,609,1137
050,24,001,"Maryland","Allegany County",2,0,636,332,304
050,24,001,"Maryland","Allegany County",2,1,628,315,313
050,24,001,"Maryland","Allegany County",2,2,624,328,296
050,24,001,"Maryland","Allegany County",2,3,643,338,305
050,24,001,"Maryland","Allegany County",2,4,640,331,309
050,24,001,"Maryland","Allegany County",2,5,632,336,296
050,24,001,"Maryland","Allegany County",2,6,667,351,316
050,24,001,"Maryland","Allegany County",2,7,655,335,320
050,24,001,"Maryland","Allegany County",2,8,656,322,334
050,24,001,"Maryland","Allegany County",2,9,685,352,333
050,24,001,"Maryland","Allegany County",2,10,690,366,324
050,24,001,"Maryland","Allegany County",2,11,666,356,310
050,24,001,"Maryland","Allegany County",2,12,692,363,329
050,24,001,"Maryland","Allegany County",2,13,703,370,333
050,24,001,"Maryland","Allegany County",2,14,720,394,326
050,24,001,"Maryland","Allegany County",2,15,706,370,336
050,24,001,"Maryland","Allegany County",2,16,714,364,350
050,24,001,"Maryland","Allegany County",2,17,731,378,353
050,24,001,"Maryland","Allegany County",2,18,892,452,440
050,24,001,"Maryland","Allegany County",2,19,961,499,462
050,24,001,"Maryland","Allegany County",2,20,1255,603,652
050,24,001,"Maryland","Allegany County",2,21,1257,707,550
050,24,001,"Maryland","Allegany County",2,22,1068,607,461
050,24,001,"Maryland","Allegany County",2,23,881,465,416
050,24,001,"Maryland","Allegany County",2,24,898,510,388
050,24,001,"Maryland","Allegany County",2,25,862,502,360
050,24,001,"Maryland","Allegany County",2,26,846,491,355
050,24,001,"Maryland","Allegany County",2,27,895,529,366
050,24,001,"Maryland","Allegany County",2,28,890,505,385
050,24,001,"Maryland","Allegany County",2,29,912,537,375
050,24,001,"Maryland","Allegany County",2,30,883,551,332
050,24,001,"Maryland","Allegany County",2,31,867,537,330
050,24,001,"Maryland","Allegany County",2,32,881,546,335
050,24,001,"Maryland","Allegany County",2,33,868,538,330
050,24,001,"Maryland","Allegany County",2,34,861,531,330
050,24,001,"Maryland","Allegany County",2,35,831,483,348
050,24,001,"Maryland","Allegany County",2,36,808,455,353
050,24,001,"Maryland","Allegany County",2,37,821,472,349
050,24,001,"Maryland","Allegany County",2,38,848,505,343
050,24,001,"Maryland","Allegany County",2,39,865,505,360
050,24,001,"Maryland","Allegany County",2,40,850,501,349
050,24,001,"Maryland","Allegany County",2,41,807,464,343
050,24,001,"Maryland","Allegany County",2,42,756,441,315
050,24,001,"Maryland","Allegany County",2,43,723,419,304
050,24,001,"Maryland","Allegany County",2,44,740,428,312
050,24,001,"Maryland","Allegany County",2,45,773,438,335
050,24,001,"Maryland","Allegany County",2,46,778,428,350
050,24,001,"Maryland","Allegany County",2,47,776,414,362
050,24,001,"Maryland","Allegany County",2,48,845,451,394
050,24,001,"Maryland","Allegany County",2,49,900,463,437
050,24,001,"Maryland","Allegany County",2,50,896,475,421
050,24,001,"Maryland","Allegany County",2,51,854,467,387
050,24,001,"Maryland","Allegany County",2,52,810,442,368
050,24,001,"Maryland","Allegany County",2,53,869,488,381
050,24,001,"Maryland","Allegany County",2,54,886,480,406
050,24,001,"Maryland","Allegany County",2,55,895,456,439
050,24,001,"Maryland","Allegany County",2,56,892,444,448
050,24,001,"Maryland","Allegany County",2,57,879,444,435
050,24,001,"Maryland","Allegany County",2,58,921,447,474
050,24,001,"Maryland","Allegany County",2,59,984,494,490
050,24,001,"Maryland","Allegany County",2,60,964,487,477
050,24,001,"Maryland","Allegany County",2,61,936,464,472
050,24,001,"Maryland","Allegany County",2,62,943,486,457
050,24,001,"Maryland","Allegany County",2,63,957,478,479
050,24,001,"Maryland","Allegany County",2,64,877,437,440
050,24,001,"Maryland","Allegany County",2,65,853,433,420
050,24,001,"Maryland","Allegany County",2,66,835,413,422
050,24,001,"Maryland","Allegany County",2,67,806,378,428
050,24,001,"Maryland","Allegany County",2,68,821,400,421
050,24,001,"Maryland","Allegany County",2,69,781,376,405
050,24,001,"Maryland","Allegany County",2,70,752,347,405
050,24,001,"Maryland","Allegany County",2,71,759,357,402
050,24,001,"Maryland","Allegany County",2,72,788,374,414
050,24,001,"Maryland","Allegany County",2,73,890,416,474
050,24,001,"Maryland","Allegany County",2,74,604,267,337
050,24,001,"Maryland","Allegany County",2,75,579,260,319
050,24,001,"Maryland","Allegany County",2,76,584,264,320
050,24,001,"Maryland","Allegany County",2,77,569,269,300
050,24,001,"Maryland","Allegany County",2,78,499,222,277
050,24,001,"Maryland","Allegany County",2,79,460,202,258
050,24,001,"Maryland","Allegany County",2,80,420,185,235
050,24,001,"Maryland","Allegany County",2,81,426,178,248
050,24,001,"Maryland","Allegany County",2,82,410,167,243
050,24,001,"Maryland","Allegany County",2,83,351,144,207
050,24,001,"Maryland","Allegany County",2,84,289,127,162
050,24,001,"Maryland","Allegany County",2,85,1735,609,1126
050,24,001,"Maryland","Allegany County",3,0,623,319,304
050,24,001,"Maryland","Allegany County",3,1,655,335,320
050,24,001,"Maryland","Allegany County",3,2,646,328,318
050,24,001,"Maryland","Allegany County",3,3,645,342,303
050,24,001,"Maryland","Allegany County",3,4,627,328,299
050,24,001,"Maryland","Allegany County",3,5,637,330,307
050,24,001,"Maryland","Allegany County",3,6,625,328,297
050,24,001,"Maryland","Allegany County",3,7,681,349,332
050,24,001,"Maryland","Allegany County",3,8,668,344,324
050,24,001,"Maryland","Allegany County",3,9,670,327,343
050,24,001,"Maryland","Allegany County",3,10,683,344,339
050,24,001,"Maryland","Allegany County",3,11,694,375,319
050,24,001,"Maryland","Allegany County",3,12,658,358,300
050,24,001,"Maryland","Allegany County",3,13,694,359,335
050,24,001,"Maryland","Allegany County",3,14,695,364,331
050,24,001,"Maryland","Allegany County",3,15,721,391,330
050,24,001,"Maryland","Allegany County",3,16,706,369,337
050,24,001,"Maryland","Allegany County",3,17,725,376,349
050,24,001,"Maryland","Allegany County",3,18,904,451,453
050,24,001,"Maryland","Allegany County",3,19,937,487,450
050,24,001,"Maryland","Allegany County",3,20,1252,592,660
050,24,001,"Maryland","Allegany County",3,21,1294,730,564
050,24,001,"Maryland","Allegany County",3,22,1059,617,442
050,24,001,"Maryland","Allegany County",3,23,917,487,430
050,24,001,"Maryland","Allegany County",3,24,890,512,378
050,24,001,"Maryland","Allegany County",3,25,840,487,353
050,24,001,"Maryland","Allegany County",3,26,870,504,366
050,24,001,"Maryland","Allegany County",3,27,864,527,337
050,24,001,"Maryland","Allegany County",3,28,864,509,355
050,24,001,"Maryland","Allegany County",3,29,907,518,389
050,24,001,"Maryland","Allegany County",3,30,923,551,372
050,24,001,"Maryland","Allegany County",3,31,862,528,334
050,24,001,"Maryland","Allegany County",3,32,876,544,332
050,24,001,"Maryland","Allegany County",3,33,893,539,354
050,24,001,"Maryland","Allegany County",3,34,867,538,329
050,24,001,"Maryland","Allegany County",3,35,841,499,342
050,24,001,"Maryland","Allegany County",3,36,819,467,352
050,24,001,"Maryland","Allegany County",3,37,828,474,354
050,24,001,"Maryland","Allegany County",3,38,842,502,340
050,24,001,"Maryland","Allegany County",3,39,854,506,348
050,24,001,"Maryland","Allegany County",3,40,866,500,366
050,24,001,"Maryland","Allegany County",3,41,836,495,341
050,24,001,"Maryland","Allegany County",3,42,811,465,346
050,24,001,"Maryland","Allegany County",3,43,741,427,314
050,24,001,"Maryland","Allegany County",3,44,728,427,301
050,24,001,"Maryland","Allegany County",3,45,742,430,312
050,24,001,"Maryland","Allegany County",3,46,789,446,343
050,24,001,"Maryland","Allegany County",3,47,754,405,349
050,24,001,"Maryland","Allegany County",3,48,770,411,359
050,24,001,"Maryland","Allegany County",3,49,815,423,392
050,24,001,"Maryland","Allegany County",3,50,898,465,433
050,24,001,"Maryland","Allegany County",3,51,879,470,409
050,24,001,"Maryland","Allegany County",3,52,837,450,387
050,24,001,"Maryland","Allegany County",3,53,827,460,367
050,24,001,"Maryland","Allegany County",3,54,850,466,384
050,24,001,"Maryland","Allegany County",3,55,868,460,408
050,24,001,"Maryland","Allegany County",3,56,882,453,429
050,24,001,"Maryland","Allegany County",3,57,879,444,435
050,24,001,"Maryland","Allegany County",3,58,876,434,442
050,24,001,"Maryland","Allegany County",3,59,899,424,475
050,24,001,"Maryland","Allegany County",3,60,982,496,486
050,24,001,"Maryland","Allegany County",3,61,966,498,468
050,24,001,"Maryland","Allegany County",3,62,913,444,469
050,24,001,"Maryland","Allegany County",3,63,945,480,465
050,24,001,"Maryland","Allegany County",3,64,900,445,455
050,24,001,"Maryland","Allegany County",3,65,847,420,427
050,24,001,"Maryland","Allegany County",3,66,838,424,414
050,24,001,"Maryland","Allegany County",3,67,822,403,419
050,24,001,"Maryland","Allegany County",3,68,802,374,428
050,24,001,"Maryland","Allegany County",3,69,793,382,411
050,24,001,"Maryland","Allegany County",3,70,751,351,400
050,24,001,"Maryland","Allegany County",3,71,726,338,388
050,24,001,"Maryland","Allegany County",3,72,739,344,395
050,24,001,"Maryland","Allegany County",3,73,772,362,410
050,24,001,"Maryland","Allegany County",3,74,877,406,471
050,24,001,"Maryland","Allegany County",3,75,564,249,315
050,24,001,"Maryland","Allegany County",3,76,558,247,311
050,24,001,"Maryland","Allegany County",3,77,542,241,301
050,24,001,"Maryland","Allegany County",3,78,547,253,294
050,24,001,"Maryland","Allegany County",3,79,469,205,264
050,24,001,"Maryland","Allegany County",3,80,424,187,237
050,24,001,"Maryland","Allegany County",3,81,399,169,230
050,24,001,"Maryland","Allegany County",3,82,385,152,233
050,24,001,"Maryland","Allegany County",3,83,370,145,225
050,24,001,"Maryland","Allegany County",3,84,310,128,182
050,24,001,"Maryland","Allegany County",3,85,1643,591,1052
050,24,001,"Maryland","Allegany County",4,0,581,309,272
050,24,001,"Maryland","Allegany County",4,1,599,299,300
050,24,001,"Maryland","Allegany County",4,2,671,351,320
050,24,001,"Maryland","Allegany County",4,3,640,315,325
050,24,001,"Maryland","Allegany County",4,4,641,338,303
050,24,001,"Maryland","Allegany County",4,5,641,339,302
050,24,001,"Maryland","Allegany County",4,6,642,328,314
050,24,001,"Maryland","Allegany County",4,7,621,326,295
050,24,001,"Maryland","Allegany County",4,8,688,361,327
050,24,001,"Maryland","Allegany County",4,9,673,350,323
050,24,001,"Maryland","Allegany County",4,10,681,333,348
050,24,001,"Maryland","Allegany County",4,11,686,350,336
050,24,001,"Maryland","Allegany County",4,12,712,383,329
050,24,001,"Maryland","Allegany County",4,13,676,361,315
050,24,001,"Maryland","Allegany County",4,14,712,364,348
050,24,001,"Maryland","Allegany County",4,15,686,350,336
050,24,001,"Maryland","Allegany County",4,16,735,401,334
050,24,001,"Maryland","Allegany County",4,17,720,372,348
050,24,001,"Maryland","Allegany County",4,18,911,452,459
050,24,001,"Maryland","Allegany County",4,19,924,475,449
050,24,001,"Maryland","Allegany County",4,20,1200,573,627
050,24,001,"Maryland","Allegany County",4,21,1278,711,567
050,24,001,"Maryland","Allegany County",4,22,1116,658,458
050,24,001,"Maryland","Allegany County",4,23,879,484,395
050,24,001,"Maryland","Allegany County",4,24,909,505,404
050,24,001,"Maryland","Allegany County",4,25,820,478,342
050,24,001,"Maryland","Allegany County",4,26,831,485,346
050,24,001,"Maryland","Allegany County",4,27,903,550,353
050,24,001,"Maryland","Allegany County",4,28,833,497,336
050,24,001,"Maryland","Allegany County",4,29,878,529,349
050,24,001,"Maryland","Allegany County",4,30,923,535,388
050,24,001,"Maryland","Allegany County",4,31,906,536,370
050,24,001,"Maryland","Allegany County",4,32,863,532,331
050,24,001,"Maryland","Allegany County",4,33,870,527,343
050,24,001,"Maryland","Allegany County",4,34,885,542,343
050,24,001,"Maryland","Allegany County",4,35,846,510,336
050,24,001,"Maryland","Allegany County",4,36,824,482,342
050,24,001,"Maryland","Allegany County",4,37,825,474,351
050,24,001,"Maryland","Allegany County",4,38,841,486,355
050,24,001,"Maryland","Allegany County",4,39,848,492,356
050,24,001,"Maryland","Allegany County",4,40,843,493,350
050,24,001,"Maryland","Allegany County",4,41,845,479,366
050,24,001,"Maryland","Allegany County",4,42,830,478,352
050,24,001,"Maryland","Allegany County",4,43,790,447,343
050,24,001,"Maryland","Allegany County",4,44,742,426,316
050,24,001,"Maryland","Allegany County",4,45,723,427,296
050,24,001,"Maryland","Allegany County",4,46,744,432,312
050,24,001,"Maryland","Allegany County",4,47,756,422,334
050,24,001,"Maryland","Allegany County",4,48,750,400,350
050,24,001,"Maryland","Allegany County",4,49,748,389,359
050,24,001,"Maryland","Allegany County",4,50,817,428,389
050,24,001,"Maryland","Allegany County",4,51,887,462,425
050,24,001,"Maryland","Allegany County",4,52,850,451,399
050,24,001,"Maryland","Allegany County",4,53,846,458,388
050,24,001,"Maryland","Allegany County",4,54,800,434,366
050,24,001,"Maryland","Allegany County",4,55,830,444,386
050,24,001,"Maryland","Allegany County",4,56,856,450,406
050,24,001,"Maryland","Allegany County",4,57,871,446,425
050,24,001,"Maryland","Allegany County",4,58,886,444,442
050,24,001,"Maryland","Allegany County",4,59,845,412,433
050,24,001,"Maryland","Allegany County",4,60,879,416,463
050,24,001,"Maryland","Allegany County",4,61,975,495,480
050,24,001,"Maryland","Allegany County",4,62,936,475,461
050,24,001,"Maryland","Allegany County",4,63,913,437,476
050,24,001,"Maryland","Allegany County",4,64,909,469,440
050,24,001,"Maryland","Allegany County",4,65,881,429,452
050,24,001,"Maryland","Allegany County",4,66,836,413,423
050,24,001,"Maryland","Allegany County",4,67,830,408,422
050,24,001,"Maryland","Allegany County",4,68,824,401,423
050,24,001,"Maryland","Allegany County",4,69,775,353,422
050,24,001,"Maryland","Allegany County",4,70,765,362,403
050,24,001,"Maryland","Allegany County",4,71,724,340,384
050,24,001,"Maryland","Allegany County",4,72,706,324,382
050,24,001,"Maryland","Allegany County",4,73,720,334,386
050,24,001,"Maryland","Allegany County",4,74,753,353,400
050,24,001,"Maryland","Allegany County",4,75,839,386,453
050,24,001,"Maryland","Allegany County",4,76,552,240,312
050,24,001,"Maryland","Allegany County",4,77,527,229,298
050,24,001,"Maryland","Allegany County",4,78,519,226,293
050,24,001,"Maryland","Allegany County",4,79,515,235,280
050,24,001,"Maryland","Allegany County",4,80,441,191,250
050,24,001,"Maryland","Allegany County",4,81,397,168,229
050,24,001,"Maryland","Allegany County",4,82,364,147,217
050,24,001,"Maryland","Allegany County",4,83,342,133,209
050,24,001,"Maryland","Allegany County",4,84,330,124,206
050,24,001,"Maryland","Allegany County",4,85,1637,577,1060
050,24,001,"Maryland","Allegany County",5,0,555,293,262
050,24,001,"Maryland","Allegany County",5,1,613,329,284
050,24,001,"Maryland","Allegany County",5,2,615,308,307
050,24,001,"Maryland","Allegany County",5,3,672,351,321
050,24,001,"Maryland","Allegany County",5,4,637,316,321
050,24,001,"Maryland","Allegany County",5,5,654,343,311
050,24,001,"Maryland","Allegany County",5,6,656,350,306
050,24,001,"Maryland","Allegany County",5,7,650,331,319
050,24,001,"Maryland","Allegany County",5,8,631,339,292
050,24,001,"Maryland","Allegany County",5,9,703,367,336
050,24,001,"Maryland","Allegany County",5,10,680,353,327
050,24,001,"Maryland","Allegany County",5,11,695,346,349
050,24,001,"Maryland","Allegany County",5,12,705,362,343
050,24,001,"Maryland","Allegany County",5,13,713,378,335
050,24,001,"Maryland","Allegany County",5,14,693,366,327
050,24,001,"Maryland","Allegany County",5,15,724,369,355
050,24,001,"Maryland","Allegany County",5,16,702,360,342
050,24,001,"Maryland","Allegany County",5,17,747,409,338
050,24,001,"Maryland","Allegany County",5,18,909,466,443
050,24,001,"Maryland","Allegany County",5,19,941,485,456
050,24,001,"Maryland","Allegany County",5,20,1210,564,646
050,24,001,"Maryland","Allegany County",5,21,1226,697,529
050,24,001,"Maryland","Allegany County",5,22,1097,615,482
050,24,001,"Maryland","Allegany County",5,23,969,537,432
050,24,001,"Maryland","Allegany County",5,24,906,533,373
050,24,001,"Maryland","Allegany County",5,25,832,471,361
050,24,001,"Maryland","Allegany County",5,26,819,489,330
050,24,001,"Maryland","Allegany County",5,27,845,523,322
050,24,001,"Maryland","Allegany County",5,28,867,511,356
050,24,001,"Maryland","Allegany County",5,29,856,522,334
050,24,001,"Maryland","Allegany County",5,30,919,556,363
050,24,001,"Maryland","Allegany County",5,31,901,515,386
050,24,001,"Maryland","Allegany County",5,32,915,540,375
050,24,001,"Maryland","Allegany County",5,33,869,533,336
050,24,001,"Maryland","Allegany County",5,34,872,532,340
050,24,001,"Maryland","Allegany County",5,35,866,516,350
050,24,001,"Maryland","Allegany County",5,36,835,495,340
050,24,001,"Maryland","Allegany County",5,37,844,503,341
050,24,001,"Maryland","Allegany County",5,38,842,499,343
050,24,001,"Maryland","Allegany County",5,39,850,488,362
050,24,001,"Maryland","Allegany County",5,40,838,485,353
050,24,001,"Maryland","Allegany County",5,41,833,473,360
050,24,001,"Maryland","Allegany County",5,42,838,476,362
050,24,001,"Maryland","Allegany County",5,43,809,457,352
050,24,001,"Maryland","Allegany County",5,44,802,449,353
050,24,001,"Maryland","Allegany County",5,45,758,431,327
050,24,001,"Maryland","Allegany County",5,46,741,435,306
050,24,001,"Maryland","Allegany County",5,47,728,415,313
050,24,001,"Maryland","Allegany County",5,48,751,416,335
050,24,001,"Maryland","Allegany County",5,49,719,376,343
050,24,001,"Maryland","Allegany County",5,50,772,398,374
050,24,001,"Maryland","Allegany County",5,51,818,433,385
050,24,001,"Maryland","Allegany County",5,52,868,448,420
050,24,001,"Maryland","Allegany County",5,53,867,468,399
050,24,001,"Maryland","Allegany County",5,54,811,438,373
050,24,001,"Maryland","Allegany County",5,55,788,417,371
050,24,001,"Maryland","Allegany County",5,56,816,436,380
050,24,001,"Maryland","Allegany County",5,57,847,450,397
050,24,001,"Maryland","Allegany County",5,58,862,435,427
050,24,001,"Maryland","Allegany County",5,59,870,421,449
050,24,001,"Maryland","Allegany County",5,60,838,407,431
050,24,001,"Maryland","Allegany County",5,61,888,426,462
050,24,001,"Maryland","Allegany County",5,62,952,479,473
050,24,001,"Maryland","Allegany County",5,63,937,473,464
050,24,001,"Maryland","Allegany County",5,64,894,426,468
050,24,001,"Maryland","Allegany County",5,65,890,457,433
050,24,001,"Maryland","Allegany County",5,66,882,434,448
050,24,001,"Maryland","Allegany County",5,67,806,389,417
050,24,001,"Maryland","Allegany County",5,68,827,403,424
050,24,001,"Maryland","Allegany County",5,69,795,383,412
050,24,001,"Maryland","Allegany County",5,70,744,332,412
050,24,001,"Maryland","Allegany County",5,71,748,354,394
050,24,001,"Maryland","Allegany County",5,72,704,327,377
050,24,001,"Maryland","Allegany County",5,73,694,318,376
050,24,001,"Maryland","Allegany County",5,74,705,325,380
050,24,001,"Maryland","Allegany County",5,75,715,337,378
050,24,001,"Maryland","Allegany County",5,76,822,376,446
050,24,001,"Maryland","Allegany County",5,77,522,223,299
050,24,001,"Maryland","Allegany County",5,78,499,212,287
050,24,001,"Maryland","Allegany County",5,79,496,212,284
050,24,001,"Maryland","Allegany County",5,80,485,224,261
050,24,001,"Maryland","Allegany County",5,81,416,172,244
050,24,001,"Maryland","Allegany County",5,82,362,144,218
050,24,001,"Maryland","Allegany County",5,83,317,125,192
050,24,001,"Maryland","Allegany County",5,84,301,113,188
050,24,001,"Maryland","Allegany County",5,85,1663,565,1098
050,24,003,"Maryland","Anne Arundel County",1,0,6875,3523,3352
050,24,003,"Maryland","Anne Arundel County",1,1,7095,3585,3510
050,24,003,"Maryland","Anne Arundel County",1,2,7255,3655,3600
050,24,003,"Maryland","Anne Arundel County",1,3,7344,3816,3528
050,24,003,"Maryland","Anne Arundel County",1,4,7528,3806,3722
050,24,003,"Maryland","Anne Arundel County",1,5,7558,3807,3751
050,24,003,"Maryland","Anne Arundel County",1,6,7412,3820,3592
050,24,003,"Maryland","Anne Arundel County",1,7,7366,3740,3626
050,24,003,"Maryland","Anne Arundel County",1,8,7609,3831,3778
050,24,003,"Maryland","Anne Arundel County",1,9,7711,3884,3827
050,24,003,"Maryland","Anne Arundel County",1,10,7761,3988,3773
050,24,003,"Maryland","Anne Arundel County",1,11,7647,3904,3743
050,24,003,"Maryland","Anne Arundel County",1,12,7927,4139,3788
050,24,003,"Maryland","Anne Arundel County",1,13,7828,4078,3750
050,24,003,"Maryland","Anne Arundel County",1,14,7485,3815,3670
050,24,003,"Maryland","Anne Arundel County",1,15,7362,3652,3710
050,24,003,"Maryland","Anne Arundel County",1,16,7409,3719,3690
050,24,003,"Maryland","Anne Arundel County",1,17,7281,3697,3584
050,24,003,"Maryland","Anne Arundel County",1,18,6344,3340,3004
050,24,003,"Maryland","Anne Arundel County",1,19,5648,3018,2630
050,24,003,"Maryland","Anne Arundel County",1,20,6304,3402,2902
050,24,003,"Maryland","Anne Arundel County",1,21,6577,3526,3051
050,24,003,"Maryland","Anne Arundel County",1,22,6736,3553,3183
050,24,003,"Maryland","Anne Arundel County",1,23,6899,3595,3304
050,24,003,"Maryland","Anne Arundel County",1,24,7005,3639,3366
050,24,003,"Maryland","Anne Arundel County",1,25,7276,3825,3451
050,24,003,"Maryland","Anne Arundel County",1,26,7369,3870,3499
050,24,003,"Maryland","Anne Arundel County",1,27,7752,3975,3777
050,24,003,"Maryland","Anne Arundel County",1,28,8000,4036,3964
050,24,003,"Maryland","Anne Arundel County",1,29,8278,4155,4123
050,24,003,"Maryland","Anne Arundel County",1,30,8544,4236,4308
050,24,003,"Maryland","Anne Arundel County",1,31,8494,4268,4226
050,24,003,"Maryland","Anne Arundel County",1,32,8622,4225,4397
050,24,003,"Maryland","Anne Arundel County",1,33,8766,4281,4485
050,24,003,"Maryland","Anne Arundel County",1,34,8942,4489,4453
050,24,003,"Maryland","Anne Arundel County",1,35,8839,4468,4371
050,24,003,"Maryland","Anne Arundel County",1,36,8644,4304,4340
050,24,003,"Maryland","Anne Arundel County",1,37,8672,4333,4339
050,24,003,"Maryland","Anne Arundel County",1,38,8608,4370,4238
050,24,003,"Maryland","Anne Arundel County",1,39,8604,4340,4264
050,24,003,"Maryland","Anne Arundel County",1,40,8342,4234,4108
050,24,003,"Maryland","Anne Arundel County",1,41,7887,3961,3926
050,24,003,"Maryland","Anne Arundel County",1,42,7693,3845,3848
050,24,003,"Maryland","Anne Arundel County",1,43,7363,3714,3649
050,24,003,"Maryland","Anne Arundel County",1,44,7145,3589,3556
050,24,003,"Maryland","Anne Arundel County",1,45,7090,3560,3530
050,24,003,"Maryland","Anne Arundel County",1,46,6872,3441,3431
050,24,003,"Maryland","Anne Arundel County",1,47,7132,3527,3605
050,24,003,"Maryland","Anne Arundel County",1,48,7644,3721,3923
050,24,003,"Maryland","Anne Arundel County",1,49,8082,3992,4090
050,24,003,"Maryland","Anne Arundel County",1,50,7995,3972,4023
050,24,003,"Maryland","Anne Arundel County",1,51,7786,3842,3944
050,24,003,"Maryland","Anne Arundel County",1,52,7728,3753,3975
050,24,003,"Maryland","Anne Arundel County",1,53,7930,3849,4081
050,24,003,"Maryland","Anne Arundel County",1,54,8226,4025,4201
050,24,003,"Maryland","Anne Arundel County",1,55,8690,4254,4436
050,24,003,"Maryland","Anne Arundel County",1,56,8749,4326,4423
050,24,003,"Maryland","Anne Arundel County",1,57,8548,4178,4370
050,24,003,"Maryland","Anne Arundel County",1,58,8467,4106,4361
050,24,003,"Maryland","Anne Arundel County",1,59,8250,3968,4282
050,24,003,"Maryland","Anne Arundel County",1,60,7975,3926,4049
050,24,003,"Maryland","Anne Arundel County",1,61,7728,3779,3949
050,24,003,"Maryland","Anne Arundel County",1,62,7424,3673,3751
050,24,003,"Maryland","Anne Arundel County",1,63,6975,3399,3576
050,24,003,"Maryland","Anne Arundel County",1,64,6742,3271,3471
050,24,003,"Maryland","Anne Arundel County",1,65,6589,3161,3428
050,24,003,"Maryland","Anne Arundel County",1,66,6201,2927,3274
050,24,003,"Maryland","Anne Arundel County",1,67,5855,2813,3042
050,24,003,"Maryland","Anne Arundel County",1,68,5576,2616,2960
050,24,003,"Maryland","Anne Arundel County",1,69,5096,2348,2748
050,24,003,"Maryland","Anne Arundel County",1,70,5036,2310,2726
050,24,003,"Maryland","Anne Arundel County",1,71,4990,2275,2715
050,24,003,"Maryland","Anne Arundel County",1,72,5126,2342,2784
050,24,003,"Maryland","Anne Arundel County",1,73,5242,2437,2805
050,24,003,"Maryland","Anne Arundel County",1,74,3611,1634,1977
050,24,003,"Maryland","Anne Arundel County",1,75,3634,1646,1988
050,24,003,"Maryland","Anne Arundel County",1,76,3511,1596,1915
050,24,003,"Maryland","Anne Arundel County",1,77,3525,1629,1896
050,24,003,"Maryland","Anne Arundel County",1,78,2994,1375,1619
050,24,003,"Maryland","Anne Arundel County",1,79,2626,1187,1439
050,24,003,"Maryland","Anne Arundel County",1,80,2378,1057,1321
050,24,003,"Maryland","Anne Arundel County",1,81,2240,958,1282
050,24,003,"Maryland","Anne Arundel County",1,82,1931,793,1138
050,24,003,"Maryland","Anne Arundel County",1,83,1666,696,970
050,24,003,"Maryland","Anne Arundel County",1,84,1514,622,892
050,24,003,"Maryland","Anne Arundel County",1,85,9090,3272,5818
050,24,003,"Maryland","Anne Arundel County",2,0,6920,3516,3404
050,24,003,"Maryland","Anne Arundel County",2,1,7050,3575,3475
050,24,003,"Maryland","Anne Arundel County",2,2,7228,3650,3578
050,24,003,"Maryland","Anne Arundel County",2,3,7310,3768,3542
050,24,003,"Maryland","Anne Arundel County",2,4,7506,3819,3687
050,24,003,"Maryland","Anne Arundel County",2,5,7574,3826,3748
050,24,003,"Maryland","Anne Arundel County",2,6,7478,3831,3647
050,24,003,"Maryland","Anne Arundel County",2,7,7396,3768,3628
050,24,003,"Maryland","Anne Arundel County",2,8,7544,3803,3741
050,24,003,"Maryland","Anne Arundel County",2,9,7689,3877,3812
050,24,003,"Maryland","Anne Arundel County",2,10,7742,3960,3782
050,24,003,"Maryland","Anne Arundel County",2,11,7663,3918,3745
050,24,003,"Maryland","Anne Arundel County",2,12,7896,4101,3795
050,24,003,"Maryland","Anne Arundel County",2,13,7839,4080,3759
050,24,003,"Maryland","Anne Arundel County",2,14,7559,3874,3685
050,24,003,"Maryland","Anne Arundel County",2,15,7400,3694,3706
050,24,003,"Maryland","Anne Arundel County",2,16,7409,3710,3699
050,24,003,"Maryland","Anne Arundel County",2,17,7312,3705,3607
050,24,003,"Maryland","Anne Arundel County",2,18,6350,3345,3005
050,24,003,"Maryland","Anne Arundel County",2,19,5673,3032,2641
050,24,003,"Maryland","Anne Arundel County",2,20,6341,3408,2933
050,24,003,"Maryland","Anne Arundel County",2,21,6564,3507,3057
050,24,003,"Maryland","Anne Arundel County",2,22,6755,3564,3191
050,24,003,"Maryland","Anne Arundel County",2,23,6927,3607,3320
050,24,003,"Maryland","Anne Arundel County",2,24,7021,3654,3367
050,24,003,"Maryland","Anne Arundel County",2,25,7261,3815,3446
050,24,003,"Maryland","Anne Arundel County",2,26,7401,3890,3511
050,24,003,"Maryland","Anne Arundel County",2,27,7719,3985,3734
050,24,003,"Maryland","Anne Arundel County",2,28,7977,4040,3937
050,24,003,"Maryland","Anne Arundel County",2,29,8251,4141,4110
050,24,003,"Maryland","Anne Arundel County",2,30,8577,4260,4317
050,24,003,"Maryland","Anne Arundel County",2,31,8529,4267,4262
050,24,003,"Maryland","Anne Arundel County",2,32,8605,4235,4370
050,24,003,"Maryland","Anne Arundel County",2,33,8742,4273,4469
050,24,003,"Maryland","Anne Arundel County",2,34,8926,4462,4464
050,24,003,"Maryland","Anne Arundel County",2,35,8921,4497,4424
050,24,003,"Maryland","Anne Arundel County",2,36,8649,4328,4321
050,24,003,"Maryland","Anne Arundel County",2,37,8684,4339,4345
050,24,003,"Maryland","Anne Arundel County",2,38,8668,4395,4273
050,24,003,"Maryland","Anne Arundel County",2,39,8569,4333,4236
050,24,003,"Maryland","Anne Arundel County",2,40,8454,4286,4168
050,24,003,"Maryland","Anne Arundel County",2,41,7989,4012,3977
050,24,003,"Maryland","Anne Arundel County",2,42,7710,3856,3854
050,24,003,"Maryland","Anne Arundel County",2,43,7485,3759,3726
050,24,003,"Maryland","Anne Arundel County",2,44,7117,3571,3546
050,24,003,"Maryland","Anne Arundel County",2,45,7119,3587,3532
050,24,003,"Maryland","Anne Arundel County",2,46,6909,3466,3443
050,24,003,"Maryland","Anne Arundel County",2,47,7049,3491,3558
050,24,003,"Maryland","Anne Arundel County",2,48,7504,3659,3845
050,24,003,"Maryland","Anne Arundel County",2,49,8013,3950,4063
050,24,003,"Maryland","Anne Arundel County",2,50,8013,3979,4034
050,24,003,"Maryland","Anne Arundel County",2,51,7796,3856,3940
050,24,003,"Maryland","Anne Arundel County",2,52,7712,3756,3956
050,24,003,"Maryland","Anne Arundel County",2,53,7866,3817,4049
050,24,003,"Maryland","Anne Arundel County",2,54,8118,3965,4153
050,24,003,"Maryland","Anne Arundel County",2,55,8561,4188,4373
050,24,003,"Maryland","Anne Arundel County",2,56,8722,4302,4420
050,24,003,"Maryland","Anne Arundel County",2,57,8590,4215,4375
050,24,003,"Maryland","Anne Arundel County",2,58,8465,4107,4358
050,24,003,"Maryland","Anne Arundel County",2,59,8296,4002,4294
050,24,003,"Maryland","Anne Arundel County",2,60,8007,3915,4092
050,24,003,"Maryland","Anne Arundel County",2,61,7735,3789,3946
050,24,003,"Maryland","Anne Arundel County",2,62,7443,3671,3772
050,24,003,"Maryland","Anne Arundel County",2,63,7099,3471,3628
050,24,003,"Maryland","Anne Arundel County",2,64,6719,3259,3460
050,24,003,"Maryland","Anne Arundel County",2,65,6592,3168,3424
050,24,003,"Maryland","Anne Arundel County",2,66,6275,2972,3303
050,24,003,"Maryland","Anne Arundel County",2,67,5890,2816,3074
050,24,003,"Maryland","Anne Arundel County",2,68,5584,2628,2956
050,24,003,"Maryland","Anne Arundel County",2,69,5216,2415,2801
050,24,003,"Maryland","Anne Arundel County",2,70,5020,2301,2719
050,24,003,"Maryland","Anne Arundel County",2,71,4973,2264,2709
050,24,003,"Maryland","Anne Arundel County",2,72,4990,2274,2716
050,24,003,"Maryland","Anne Arundel County",2,73,5408,2500,2908
050,24,003,"Maryland","Anne Arundel County",2,74,3750,1704,2046
050,24,003,"Maryland","Anne Arundel County",2,75,3604,1629,1975
050,24,003,"Maryland","Anne Arundel County",2,76,3483,1582,1901
050,24,003,"Maryland","Anne Arundel County",2,77,3565,1638,1927
050,24,003,"Maryland","Anne Arundel County",2,78,3024,1389,1635
050,24,003,"Maryland","Anne Arundel County",2,79,2667,1209,1458
050,24,003,"Maryland","Anne Arundel County",2,80,2412,1070,1342
050,24,003,"Maryland","Anne Arundel County",2,81,2219,959,1260
050,24,003,"Maryland","Anne Arundel County",2,82,1991,826,1165
050,24,003,"Maryland","Anne Arundel County",2,83,1701,706,995
050,24,003,"Maryland","Anne Arundel County",2,84,1534,632,902
050,24,003,"Maryland","Anne Arundel County",2,85,9092,3282,5810
050,24,003,"Maryland","Anne Arundel County",3,0,6692,3329,3363
050,24,003,"Maryland","Anne Arundel County",3,1,7132,3604,3528
050,24,003,"Maryland","Anne Arundel County",3,2,7177,3628,3549
050,24,003,"Maryland","Anne Arundel County",3,3,7276,3656,3620
050,24,003,"Maryland","Anne Arundel County",3,4,7308,3762,3546
050,24,003,"Maryland","Anne Arundel County",3,5,7507,3848,3659
050,24,003,"Maryland","Anne Arundel County",3,6,7584,3843,3741
050,24,003,"Maryland","Anne Arundel County",3,7,7452,3837,3615
050,24,003,"Maryland","Anne Arundel County",3,8,7397,3789,3608
050,24,003,"Maryland","Anne Arundel County",3,9,7509,3783,3726
050,24,003,"Maryland","Anne Arundel County",3,10,7594,3818,3776
050,24,003,"Maryland","Anne Arundel County",3,11,7723,3947,3776
050,24,003,"Maryland","Anne Arundel County",3,12,7669,3899,3770
050,24,003,"Maryland","Anne Arundel County",3,13,7867,4106,3761
050,24,003,"Maryland","Anne Arundel County",3,14,7768,4052,3716
050,24,003,"Maryland","Anne Arundel County",3,15,7513,3839,3674
050,24,003,"Maryland","Anne Arundel County",3,16,7358,3679,3679
050,24,003,"Maryland","Anne Arundel County",3,17,7376,3697,3679
050,24,003,"Maryland","Anne Arundel County",3,18,6420,3355,3065
050,24,003,"Maryland","Anne Arundel County",3,19,5609,2999,2610
050,24,003,"Maryland","Anne Arundel County",3,20,6230,3316,2914
050,24,003,"Maryland","Anne Arundel County",3,21,6793,3619,3174
050,24,003,"Maryland","Anne Arundel County",3,22,6739,3572,3167
050,24,003,"Maryland","Anne Arundel County",3,23,6852,3565,3287
050,24,003,"Maryland","Anne Arundel County",3,24,7066,3704,3362
050,24,003,"Maryland","Anne Arundel County",3,25,7265,3738,3527
050,24,003,"Maryland","Anne Arundel County",3,26,7582,3935,3647
050,24,003,"Maryland","Anne Arundel County",3,27,7604,3976,3628
050,24,003,"Maryland","Anne Arundel County",3,28,7913,4053,3860
050,24,003,"Maryland","Anne Arundel County",3,29,8181,4113,4068
050,24,003,"Maryland","Anne Arundel County",3,30,8365,4165,4200
050,24,003,"Maryland","Anne Arundel County",3,31,8759,4357,4402
050,24,003,"Maryland","Anne Arundel County",3,32,8760,4361,4399
050,24,003,"Maryland","Anne Arundel County",3,33,8877,4373,4504
050,24,003,"Maryland","Anne Arundel County",3,34,8911,4419,4492
050,24,003,"Maryland","Anne Arundel County",3,35,9005,4551,4454
050,24,003,"Maryland","Anne Arundel County",3,36,9014,4552,4462
050,24,003,"Maryland","Anne Arundel County",3,37,8726,4381,4345
050,24,003,"Maryland","Anne Arundel County",3,38,8682,4404,4278
050,24,003,"Maryland","Anne Arundel County",3,39,8683,4391,4292
050,24,003,"Maryland","Anne Arundel County",3,40,8480,4222,4258
050,24,003,"Maryland","Anne Arundel County",3,41,8518,4303,4215
050,24,003,"Maryland","Anne Arundel County",3,42,8020,4086,3934
050,24,003,"Maryland","Anne Arundel County",3,43,7775,3880,3895
050,24,003,"Maryland","Anne Arundel County",3,44,7476,3734,3742
050,24,003,"Maryland","Anne Arundel County",3,45,7058,3524,3534
050,24,003,"Maryland","Anne Arundel County",3,46,7092,3583,3509
050,24,003,"Maryland","Anne Arundel County",3,47,6869,3429,3440
050,24,003,"Maryland","Anne Arundel County",3,48,7013,3432,3581
050,24,003,"Maryland","Anne Arundel County",3,49,7521,3688,3833
050,24,003,"Maryland","Anne Arundel County",3,50,7987,3972,4015
050,24,003,"Maryland","Anne Arundel County",3,51,7974,3978,3996
050,24,003,"Maryland","Anne Arundel County",3,52,7710,3795,3915
050,24,003,"Maryland","Anne Arundel County",3,53,7676,3706,3970
050,24,003,"Maryland","Anne Arundel County",3,54,7760,3754,4006
050,24,003,"Maryland","Anne Arundel County",3,55,8085,3938,4147
050,24,003,"Maryland","Anne Arundel County",3,56,8503,4185,4318
050,24,003,"Maryland","Anne Arundel County",3,57,8624,4264,4360
050,24,003,"Maryland","Anne Arundel County",3,58,8456,4149,4307
050,24,003,"Maryland","Anne Arundel County",3,59,8298,3999,4299
050,24,003,"Maryland","Anne Arundel County",3,60,8085,3876,4209
050,24,003,"Maryland","Anne Arundel County",3,61,7872,3836,4036
050,24,003,"Maryland","Anne Arundel County",3,62,7517,3655,3862
050,24,003,"Maryland","Anne Arundel County",3,63,7181,3531,3650
050,24,003,"Maryland","Anne Arundel County",3,64,6884,3331,3553
050,24,003,"Maryland","Anne Arundel County",3,65,6588,3164,3424
050,24,003,"Maryland","Anne Arundel County",3,66,6449,3099,3350
050,24,003,"Maryland","Anne Arundel County",3,67,6126,2889,3237
050,24,003,"Maryland","Anne Arundel County",3,68,5786,2735,3051
050,24,003,"Maryland","Anne Arundel County",3,69,5488,2568,2920
050,24,003,"Maryland","Anne Arundel County",3,70,5098,2336,2762
050,24,003,"Maryland","Anne Arundel County",3,71,4875,2217,2658
050,24,003,"Maryland","Anne Arundel County",3,72,4824,2178,2646
050,24,003,"Maryland","Anne Arundel County",3,73,4849,2190,2659
050,24,003,"Maryland","Anne Arundel County",3,74,5258,2417,2841
050,24,003,"Maryland","Anne Arundel County",3,75,3658,1665,1993
050,24,003,"Maryland","Anne Arundel County",3,76,3471,1555,1916
050,24,003,"Maryland","Anne Arundel County",3,77,3378,1524,1854
050,24,003,"Maryland","Anne Arundel County",3,78,3433,1564,1869
050,24,003,"Maryland","Anne Arundel County",3,79,2899,1335,1564
050,24,003,"Maryland","Anne Arundel County",3,80,2544,1142,1402
050,24,003,"Maryland","Anne Arundel County",3,81,2279,984,1295
050,24,003,"Maryland","Anne Arundel County",3,82,2083,902,1181
050,24,003,"Maryland","Anne Arundel County",3,83,1861,762,1099
050,24,003,"Maryland","Anne Arundel County",3,84,1586,654,932
050,24,003,"Maryland","Anne Arundel County",3,85,9180,3332,5848
050,24,003,"Maryland","Anne Arundel County",4,0,6972,3519,3453
050,24,003,"Maryland","Anne Arundel County",4,1,6888,3520,3368
050,24,003,"Maryland","Anne Arundel County",4,2,7183,3654,3529
050,24,003,"Maryland","Anne Arundel County",4,3,7230,3667,3563
050,24,003,"Maryland","Anne Arundel County",4,4,7294,3675,3619
050,24,003,"Maryland","Anne Arundel County",4,5,7317,3751,3566
050,24,003,"Maryland","Anne Arundel County",4,6,7574,3859,3715
050,24,003,"Maryland","Anne Arundel County",4,7,7538,3834,3704
050,24,003,"Maryland","Anne Arundel County",4,8,7469,3849,3620
050,24,003,"Maryland","Anne Arundel County",4,9,7367,3766,3601
050,24,003,"Maryland","Anne Arundel County",4,10,7474,3745,3729
050,24,003,"Maryland","Anne Arundel County",4,11,7566,3795,3771
050,24,003,"Maryland","Anne Arundel County",4,12,7735,3996,3739
050,24,003,"Maryland","Anne Arundel County",4,13,7658,3902,3756
050,24,003,"Maryland","Anne Arundel County",4,14,7862,4122,3740
050,24,003,"Maryland","Anne Arundel County",4,15,7786,4050,3736
050,24,003,"Maryland","Anne Arundel County",4,16,7521,3848,3673
050,24,003,"Maryland","Anne Arundel County",4,17,7435,3754,3681
050,24,003,"Maryland","Anne Arundel County",4,18,6446,3365,3081
050,24,003,"Maryland","Anne Arundel County",4,19,5494,2934,2560
050,24,003,"Maryland","Anne Arundel County",4,20,6049,3242,2807
050,24,003,"Maryland","Anne Arundel County",4,21,6533,3439,3094
050,24,003,"Maryland","Anne Arundel County",4,22,6942,3614,3328
050,24,003,"Maryland","Anne Arundel County",4,23,6733,3572,3161
050,24,003,"Maryland","Anne Arundel County",4,24,6900,3588,3312
050,24,003,"Maryland","Anne Arundel County",4,25,7217,3741,3476
050,24,003,"Maryland","Anne Arundel County",4,26,7189,3659,3530
050,24,003,"Maryland","Anne Arundel County",4,27,7606,3936,3670
050,24,003,"Maryland","Anne Arundel County",4,28,7687,3988,3699
050,24,003,"Maryland","Anne Arundel County",4,29,7998,4061,3937
050,24,003,"Maryland","Anne Arundel County",4,30,8387,4196,4191
050,24,003,"Maryland","Anne Arundel County",4,31,8633,4309,4324
050,24,003,"Maryland","Anne Arundel County",4,32,8945,4428,4517
050,24,003,"Maryland","Anne Arundel County",4,33,8882,4409,4473
050,24,003,"Maryland","Anne Arundel County",4,34,8980,4430,4550
050,24,003,"Maryland","Anne Arundel County",4,35,8971,4427,4544
050,24,003,"Maryland","Anne Arundel County",4,36,9123,4604,4519
050,24,003,"Maryland","Anne Arundel County",4,37,9006,4539,4467
050,24,003,"Maryland","Anne Arundel County",4,38,8790,4453,4337
050,24,003,"Maryland","Anne Arundel County",4,39,8685,4357,4328
050,24,003,"Maryland","Anne Arundel County",4,40,8656,4382,4274
050,24,003,"Maryland","Anne Arundel County",4,41,8484,4263,4221
050,24,003,"Maryland","Anne Arundel County",4,42,8490,4302,4188
050,24,003,"Maryland","Anne Arundel County",4,43,7999,4085,3914
050,24,003,"Maryland","Anne Arundel County",4,44,7733,3829,3904
050,24,003,"Maryland","Anne Arundel County",4,45,7353,3671,3682
050,24,003,"Maryland","Anne Arundel County",4,46,7034,3534,3500
050,24,003,"Maryland","Anne Arundel County",4,47,6953,3473,3480
050,24,003,"Maryland","Anne Arundel County",4,48,6818,3381,3437
050,24,003,"Maryland","Anne Arundel County",4,49,7018,3431,3587
050,24,003,"Maryland","Anne Arundel County",4,50,7445,3647,3798
050,24,003,"Maryland","Anne Arundel County",4,51,7964,3980,3984
050,24,003,"Maryland","Anne Arundel County",4,52,7817,3884,3933
050,24,003,"Maryland","Anne Arundel County",4,53,7636,3767,3869
050,24,003,"Maryland","Anne Arundel County",4,54,7546,3634,3912
050,24,003,"Maryland","Anne Arundel County",4,55,7684,3728,3956
050,24,003,"Maryland","Anne Arundel County",4,56,7967,3894,4073
050,24,003,"Maryland","Anne Arundel County",4,57,8351,4112,4239
050,24,003,"Maryland","Anne Arundel County",4,58,8439,4161,4278
050,24,003,"Maryland","Anne Arundel County",4,59,8280,4057,4223
050,24,003,"Maryland","Anne Arundel County",4,60,8133,3902,4231
050,24,003,"Maryland","Anne Arundel County",4,61,7907,3798,4109
050,24,003,"Maryland","Anne Arundel County",4,62,7691,3741,3950
050,24,003,"Maryland","Anne Arundel County",4,63,7253,3519,3734
050,24,003,"Maryland","Anne Arundel County",4,64,7049,3471,3578
050,24,003,"Maryland","Anne Arundel County",4,65,6781,3252,3529
050,24,003,"Maryland","Anne Arundel County",4,66,6418,3094,3324
050,24,003,"Maryland","Anne Arundel County",4,67,6241,2954,3287
050,24,003,"Maryland","Anne Arundel County",4,68,5997,2804,3193
050,24,003,"Maryland","Anne Arundel County",4,69,5592,2631,2961
050,24,003,"Maryland","Anne Arundel County",4,70,5371,2502,2869
050,24,003,"Maryland","Anne Arundel County",4,71,5001,2262,2739
050,24,003,"Maryland","Anne Arundel County",4,72,4777,2167,2610
050,24,003,"Maryland","Anne Arundel County",4,73,4693,2106,2587
050,24,003,"Maryland","Anne Arundel County",4,74,4762,2144,2618
050,24,003,"Maryland","Anne Arundel County",4,75,5106,2329,2777
050,24,003,"Maryland","Anne Arundel County",4,76,3532,1593,1939
050,24,003,"Maryland","Anne Arundel County",4,77,3396,1509,1887
050,24,003,"Maryland","Anne Arundel County",4,78,3277,1465,1812
050,24,003,"Maryland","Anne Arundel County",4,79,3301,1486,1815
050,24,003,"Maryland","Anne Arundel County",4,80,2778,1277,1501
050,24,003,"Maryland","Anne Arundel County",4,81,2383,1049,1334
050,24,003,"Maryland","Anne Arundel County",4,82,2161,926,1235
050,24,003,"Maryland","Anne Arundel County",4,83,1936,834,1102
050,24,003,"Maryland","Anne Arundel County",4,84,1720,694,1026
050,24,003,"Maryland","Anne Arundel County",4,85,9359,3446,5913
050,24,003,"Maryland","Anne Arundel County",5,0,6908,3493,3415
050,24,003,"Maryland","Anne Arundel County",5,1,6958,3502,3456
050,24,003,"Maryland","Anne Arundel County",5,2,6952,3574,3378
050,24,003,"Maryland","Anne Arundel County",5,3,7209,3696,3513
050,24,003,"Maryland","Anne Arundel County",5,4,7216,3684,3532
050,24,003,"Maryland","Anne Arundel County",5,5,7296,3662,3634
050,24,003,"Maryland","Anne Arundel County",5,6,7372,3787,3585
050,24,003,"Maryland","Anne Arundel County",5,7,7567,3873,3694
050,24,003,"Maryland","Anne Arundel County",5,8,7500,3818,3682
050,24,003,"Maryland","Anne Arundel County",5,9,7479,3879,3600
050,24,003,"Maryland","Anne Arundel County",5,10,7366,3759,3607
050,24,003,"Maryland","Anne Arundel County",5,11,7552,3799,3753
050,24,003,"Maryland","Anne Arundel County",5,12,7557,3808,3749
050,24,003,"Maryland","Anne Arundel County",5,13,7773,4026,3747
050,24,003,"Maryland","Anne Arundel County",5,14,7669,3909,3760
050,24,003,"Maryland","Anne Arundel County",5,15,7844,4101,3743
050,24,003,"Maryland","Anne Arundel County",5,16,7777,4045,3732
050,24,003,"Maryland","Anne Arundel County",5,17,7555,3848,3707
050,24,003,"Maryland","Anne Arundel County",5,18,6484,3407,3077
050,24,003,"Maryland","Anne Arundel County",5,19,5583,2964,2619
050,24,003,"Maryland","Anne Arundel County",5,20,6072,3213,2859
050,24,003,"Maryland","Anne Arundel County",5,21,6418,3412,3006
050,24,003,"Maryland","Anne Arundel County",5,22,6830,3526,3304
050,24,003,"Maryland","Anne Arundel County",5,23,7079,3656,3423
050,24,003,"Maryland","Anne Arundel County",5,24,6802,3564,3238
050,24,003,"Maryland","Anne Arundel County",5,25,6911,3550,3361
050,24,003,"Maryland","Anne Arundel County",5,26,7238,3774,3464
050,24,003,"Maryland","Anne Arundel County",5,27,7256,3703,3553
050,24,003,"Maryland","Anne Arundel County",5,28,7642,3888,3754
050,24,003,"Maryland","Anne Arundel County",5,29,7771,4040,3731
050,24,003,"Maryland","Anne Arundel County",5,30,8045,4042,4003
050,24,003,"Maryland","Anne Arundel County",5,31,8559,4245,4314
050,24,003,"Maryland","Anne Arundel County",5,32,8717,4299,4418
050,24,003,"Maryland","Anne Arundel County",5,33,8919,4377,4542
050,24,003,"Maryland","Anne Arundel County",5,34,9021,4484,4537
050,24,003,"Maryland","Anne Arundel County",5,35,8932,4391,4541
050,24,003,"Maryland","Anne Arundel County",5,36,8998,4459,4539
050,24,003,"Maryland","Anne Arundel County",5,37,9144,4614,4530
050,24,003,"Maryland","Anne Arundel County",5,38,8972,4532,4440
050,24,003,"Maryland","Anne Arundel County",5,39,8684,4397,4287
050,24,003,"Maryland","Anne Arundel County",5,40,8614,4279,4335
050,24,003,"Maryland","Anne Arundel County",5,41,8662,4427,4235
050,24,003,"Maryland","Anne Arundel County",5,42,8498,4303,4195
050,24,003,"Maryland","Anne Arundel County",5,43,8446,4297,4149
050,24,003,"Maryland","Anne Arundel County",5,44,7948,4014,3934
050,24,003,"Maryland","Anne Arundel County",5,45,7575,3776,3799
050,24,003,"Maryland","Anne Arundel County",5,46,7266,3644,3622
050,24,003,"Maryland","Anne Arundel County",5,47,7005,3504,3501
050,24,003,"Maryland","Anne Arundel County",5,48,6923,3435,3488
050,24,003,"Maryland","Anne Arundel County",5,49,6753,3342,3411
050,24,003,"Maryland","Anne Arundel County",5,50,7017,3425,3592
050,24,003,"Maryland","Anne Arundel County",5,51,7418,3664,3754
050,24,003,"Maryland","Anne Arundel County",5,52,7845,3895,3950
050,24,003,"Maryland","Anne Arundel County",5,53,7738,3832,3906
050,24,003,"Maryland","Anne Arundel County",5,54,7581,3730,3851
050,24,003,"Maryland","Anne Arundel County",5,55,7474,3605,3869
050,24,003,"Maryland","Anne Arundel County",5,56,7633,3721,3912
050,24,003,"Maryland","Anne Arundel County",5,57,7904,3890,4014
050,24,003,"Maryland","Anne Arundel County",5,58,8256,4086,4170
050,24,003,"Maryland","Anne Arundel County",5,59,8272,4071,4201
050,24,003,"Maryland","Anne Arundel County",5,60,8078,3934,4144
050,24,003,"Maryland","Anne Arundel County",5,61,7922,3781,4141
050,24,003,"Maryland","Anne Arundel County",5,62,7710,3693,4017
050,24,003,"Maryland","Anne Arundel County",5,63,7446,3600,3846
050,24,003,"Maryland","Anne Arundel County",5,64,7084,3404,3680
050,24,003,"Maryland","Anne Arundel County",5,65,6939,3398,3541
050,24,003,"Maryland","Anne Arundel County",5,66,6639,3175,3464
050,24,003,"Maryland","Anne Arundel County",5,67,6260,2998,3262
050,24,003,"Maryland","Anne Arundel County",5,68,6106,2862,3244
050,24,003,"Maryland","Anne Arundel County",5,69,5890,2721,3169
050,24,003,"Maryland","Anne Arundel County",5,70,5486,2570,2916
050,24,003,"Maryland","Anne Arundel County",5,71,5287,2459,2828
050,24,003,"Maryland","Anne Arundel County",5,72,4891,2202,2689
050,24,003,"Maryland","Anne Arundel County",5,73,4678,2122,2556
050,24,003,"Maryland","Anne Arundel County",5,74,4583,2039,2544
050,24,003,"Maryland","Anne Arundel County",5,75,4654,2086,2568
050,24,003,"Maryland","Anne Arundel County",5,76,4937,2231,2706
050,24,003,"Maryland","Anne Arundel County",5,77,3468,1559,1909
050,24,003,"Maryland","Anne Arundel County",5,78,3279,1439,1840
050,24,003,"Maryland","Anne Arundel County",5,79,3139,1391,1748
050,24,003,"Maryland","Anne Arundel County",5,80,3184,1428,1756
050,24,003,"Maryland","Anne Arundel County",5,81,2634,1207,1427
050,24,003,"Maryland","Anne Arundel County",5,82,2257,988,1269
050,24,003,"Maryland","Anne Arundel County",5,83,2028,859,1169
050,24,003,"Maryland","Anne Arundel County",5,84,1817,782,1035
050,24,003,"Maryland","Anne Arundel County",5,85,9731,3593,6138
050,24,005,"Maryland","Baltimore County",1,0,9980,5089,4891
050,24,005,"Maryland","Baltimore County",1,1,10124,5154,4970
050,24,005,"Maryland","Baltimore County",1,2,10166,5144,5022
050,24,005,"Maryland","Baltimore County",1,3,10126,5087,5039
050,24,005,"Maryland","Baltimore County",1,4,10347,5251,5096
050,24,005,"Maryland","Baltimore County",1,5,10312,5215,5097
050,24,005,"Maryland","Baltimore County",1,6,10061,5079,4982
050,24,005,"Maryland","Baltimore County",1,7,10076,5125,4951
050,24,005,"Maryland","Baltimore County",1,8,10415,5320,5095
050,24,005,"Maryland","Baltimore County",1,9,10562,5454,5108
050,24,005,"Maryland","Baltimore County",1,10,10673,5477,5196
050,24,005,"Maryland","Baltimore County",1,11,11004,5641,5363
050,24,005,"Maryland","Baltimore County",1,12,11205,5714,5491
050,24,005,"Maryland","Baltimore County",1,13,11178,5613,5565
050,24,005,"Maryland","Baltimore County",1,14,10921,5513,5408
050,24,005,"Maryland","Baltimore County",1,15,10638,5408,5230
050,24,005,"Maryland","Baltimore County",1,16,10720,5524,5196
050,24,005,"Maryland","Baltimore County",1,17,10611,5471,5140
050,24,005,"Maryland","Baltimore County",1,18,11852,5864,5988
050,24,005,"Maryland","Baltimore County",1,19,11794,5648,6146
050,24,005,"Maryland","Baltimore County",1,20,10925,5398,5527
050,24,005,"Maryland","Baltimore County",1,21,10373,5079,5294
050,24,005,"Maryland","Baltimore County",1,22,9906,4911,4995
050,24,005,"Maryland","Baltimore County",1,23,9748,4740,5008
050,24,005,"Maryland","Baltimore County",1,24,10048,4843,5205
050,24,005,"Maryland","Baltimore County",1,25,10420,5121,5299
050,24,005,"Maryland","Baltimore County",1,26,10700,5164,5536
050,24,005,"Maryland","Baltimore County",1,27,10992,5359,5633
050,24,005,"Maryland","Baltimore County",1,28,11100,5339,5761
050,24,005,"Maryland","Baltimore County",1,29,11665,5572,6093
050,24,005,"Maryland","Baltimore County",1,30,11975,5712,6263
050,24,005,"Maryland","Baltimore County",1,31,11867,5731,6136
050,24,005,"Maryland","Baltimore County",1,32,11975,5752,6223
050,24,005,"Maryland","Baltimore County",1,33,11781,5699,6082
050,24,005,"Maryland","Baltimore County",1,34,11693,5638,6055
050,24,005,"Maryland","Baltimore County",1,35,11459,5448,6011
050,24,005,"Maryland","Baltimore County",1,36,11526,5485,6041
050,24,005,"Maryland","Baltimore County",1,37,11456,5373,6083
050,24,005,"Maryland","Baltimore County",1,38,11309,5422,5887
050,24,005,"Maryland","Baltimore County",1,39,11259,5394,5865
050,24,005,"Maryland","Baltimore County",1,40,10771,5153,5618
050,24,005,"Maryland","Baltimore County",1,41,10408,5016,5392
050,24,005,"Maryland","Baltimore County",1,42,10287,4889,5398
050,24,005,"Maryland","Baltimore County",1,43,9855,4663,5192
050,24,005,"Maryland","Baltimore County",1,44,9762,4584,5178
050,24,005,"Maryland","Baltimore County",1,45,9775,4621,5154
050,24,005,"Maryland","Baltimore County",1,46,9528,4526,5002
050,24,005,"Maryland","Baltimore County",1,47,9968,4731,5237
050,24,005,"Maryland","Baltimore County",1,48,10510,5016,5494
050,24,005,"Maryland","Baltimore County",1,49,11136,5275,5861
050,24,005,"Maryland","Baltimore County",1,50,10814,5115,5699
050,24,005,"Maryland","Baltimore County",1,51,10647,5090,5557
050,24,005,"Maryland","Baltimore County",1,52,10673,5125,5548
050,24,005,"Maryland","Baltimore County",1,53,10904,5224,5680
050,24,005,"Maryland","Baltimore County",1,54,11095,5319,5776
050,24,005,"Maryland","Baltimore County",1,55,11535,5490,6045
050,24,005,"Maryland","Baltimore County",1,56,11745,5640,6105
050,24,005,"Maryland","Baltimore County",1,57,11713,5566,6147
050,24,005,"Maryland","Baltimore County",1,58,11763,5606,6157
050,24,005,"Maryland","Baltimore County",1,59,11936,5710,6226
050,24,005,"Maryland","Baltimore County",1,60,11794,5603,6191
050,24,005,"Maryland","Baltimore County",1,61,11835,5586,6249
050,24,005,"Maryland","Baltimore County",1,62,11810,5490,6320
050,24,005,"Maryland","Baltimore County",1,63,11363,5309,6054
050,24,005,"Maryland","Baltimore County",1,64,10867,5097,5770
050,24,005,"Maryland","Baltimore County",1,65,10528,4938,5590
050,24,005,"Maryland","Baltimore County",1,66,9859,4527,5332
050,24,005,"Maryland","Baltimore County",1,67,9523,4372,5151
050,24,005,"Maryland","Baltimore County",1,68,9099,4150,4949
050,24,005,"Maryland","Baltimore County",1,69,8612,3890,4722
050,24,005,"Maryland","Baltimore County",1,70,8235,3672,4563
050,24,005,"Maryland","Baltimore County",1,71,8129,3639,4490
050,24,005,"Maryland","Baltimore County",1,72,8130,3615,4515
050,24,005,"Maryland","Baltimore County",1,73,8007,3595,4412
050,24,005,"Maryland","Baltimore County",1,74,5574,2470,3104
050,24,005,"Maryland","Baltimore County",1,75,5351,2319,3032
050,24,005,"Maryland","Baltimore County",1,76,5224,2228,2996
050,24,005,"Maryland","Baltimore County",1,77,5417,2355,3062
050,24,005,"Maryland","Baltimore County",1,78,4635,1974,2661
050,24,005,"Maryland","Baltimore County",1,79,4020,1653,2367
050,24,005,"Maryland","Baltimore County",1,80,3699,1444,2255
050,24,005,"Maryland","Baltimore County",1,81,3547,1422,2125
050,24,005,"Maryland","Baltimore County",1,82,3347,1348,1999
050,24,005,"Maryland","Baltimore County",1,83,2955,1131,1824
050,24,005,"Maryland","Baltimore County",1,84,2852,1080,1772
050,24,005,"Maryland","Baltimore County",1,85,20375,6815,13560
050,24,005,"Maryland","Baltimore County",2,0,9854,4994,4860
050,24,005,"Maryland","Baltimore County",2,1,10078,5128,4950
050,24,005,"Maryland","Baltimore County",2,2,10165,5147,5018
050,24,005,"Maryland","Baltimore County",2,3,10106,5083,5023
050,24,005,"Maryland","Baltimore County",2,4,10300,5210,5090
050,24,005,"Maryland","Baltimore County",2,5,10323,5225,5098
050,24,005,"Maryland","Baltimore County",2,6,10138,5125,5013
050,24,005,"Maryland","Baltimore County",2,7,10072,5110,4962
050,24,005,"Maryland","Baltimore County",2,8,10302,5258,5044
050,24,005,"Maryland","Baltimore County",2,9,10503,5410,5093
050,24,005,"Maryland","Baltimore County",2,10,10629,5467,5162
050,24,005,"Maryland","Baltimore County",2,11,10875,5577,5298
050,24,005,"Maryland","Baltimore County",2,12,11205,5717,5488
050,24,005,"Maryland","Baltimore County",2,13,11184,5647,5537
050,24,005,"Maryland","Baltimore County",2,14,10978,5541,5437
050,24,005,"Maryland","Baltimore County",2,15,10705,5436,5269
050,24,005,"Maryland","Baltimore County",2,16,10733,5520,5213
050,24,005,"Maryland","Baltimore County",2,17,10650,5483,5167
050,24,005,"Maryland","Baltimore County",2,18,11822,5829,5993
050,24,005,"Maryland","Baltimore County",2,19,11774,5640,6134
050,24,005,"Maryland","Baltimore County",2,20,11057,5456,5601
050,24,005,"Maryland","Baltimore County",2,21,10378,5079,5299
050,24,005,"Maryland","Baltimore County",2,22,9920,4907,5013
050,24,005,"Maryland","Baltimore County",2,23,9734,4743,4991
050,24,005,"Maryland","Baltimore County",2,24,9952,4805,5147
050,24,005,"Maryland","Baltimore County",2,25,10344,5056,5288
050,24,005,"Maryland","Baltimore County",2,26,10648,5155,5493
050,24,005,"Maryland","Baltimore County",2,27,10919,5304,5615
050,24,005,"Maryland","Baltimore County",2,28,11081,5344,5737
050,24,005,"Maryland","Baltimore County",2,29,11518,5501,6017
050,24,005,"Maryland","Baltimore County",2,30,11936,5693,6243
050,24,005,"Maryland","Baltimore County",2,31,11860,5720,6140
050,24,005,"Maryland","Baltimore County",2,32,11881,5711,6170
050,24,005,"Maryland","Baltimore County",2,33,11792,5692,6100
050,24,005,"Maryland","Baltimore County",2,34,11677,5624,6053
050,24,005,"Maryland","Baltimore County",2,35,11563,5514,6049
050,24,005,"Maryland","Baltimore County",2,36,11423,5434,5989
050,24,005,"Maryland","Baltimore County",2,37,11474,5405,6069
050,24,005,"Maryland","Baltimore County",2,38,11380,5425,5955
050,24,005,"Maryland","Baltimore County",2,39,11212,5369,5843
050,24,005,"Maryland","Baltimore County",2,40,10930,5235,5695
050,24,005,"Maryland","Baltimore County",2,41,10460,5024,5436
050,24,005,"Maryland","Baltimore County",2,42,10236,4885,5351
050,24,005,"Maryland","Baltimore County",2,43,9998,4737,5261
050,24,005,"Maryland","Baltimore County",2,44,9682,4548,5134
050,24,005,"Maryland","Baltimore County",2,45,9820,4626,5194
050,24,005,"Maryland","Baltimore County",2,46,9526,4514,5012
050,24,005,"Maryland","Baltimore County",2,47,9825,4658,5167
050,24,005,"Maryland","Baltimore County",2,48,10382,4946,5436
050,24,005,"Maryland","Baltimore County",2,49,11025,5233,5792
050,24,005,"Maryland","Baltimore County",2,50,10895,5151,5744
050,24,005,"Maryland","Baltimore County",2,51,10618,5067,5551
050,24,005,"Maryland","Baltimore County",2,52,10632,5098,5534
050,24,005,"Maryland","Baltimore County",2,53,10799,5166,5633
050,24,005,"Maryland","Baltimore County",2,54,11010,5282,5728
050,24,005,"Maryland","Baltimore County",2,55,11397,5433,5964
050,24,005,"Maryland","Baltimore County",2,56,11683,5598,6085
050,24,005,"Maryland","Baltimore County",2,57,11690,5570,6120
050,24,005,"Maryland","Baltimore County",2,58,11707,5570,6137
050,24,005,"Maryland","Baltimore County",2,59,11879,5676,6203
050,24,005,"Maryland","Baltimore County",2,60,11786,5604,6182
050,24,005,"Maryland","Baltimore County",2,61,11744,5549,6195
050,24,005,"Maryland","Baltimore County",2,62,11739,5474,6265
050,24,005,"Maryland","Baltimore County",2,63,11487,5353,6134
050,24,005,"Maryland","Baltimore County",2,64,10870,5091,5779
050,24,005,"Maryland","Baltimore County",2,65,10530,4931,5599
050,24,005,"Maryland","Baltimore County",2,66,9979,4599,5380
050,24,005,"Maryland","Baltimore County",2,67,9504,4358,5146
050,24,005,"Maryland","Baltimore County",2,68,9063,4138,4925
050,24,005,"Maryland","Baltimore County",2,69,8713,3933,4780
050,24,005,"Maryland","Baltimore County",2,70,8263,3696,4567
050,24,005,"Maryland","Baltimore County",2,71,8087,3606,4481
050,24,005,"Maryland","Baltimore County",2,72,7947,3527,4420
050,24,005,"Maryland","Baltimore County",2,73,8308,3722,4586
050,24,005,"Maryland","Baltimore County",2,74,5773,2557,3216
050,24,005,"Maryland","Baltimore County",2,75,5367,2335,3032
050,24,005,"Maryland","Baltimore County",2,76,5176,2216,2960
050,24,005,"Maryland","Baltimore County",2,77,5409,2330,3079
050,24,005,"Maryland","Baltimore County",2,78,4696,2005,2691
050,24,005,"Maryland","Baltimore County",2,79,4110,1703,2407
050,24,005,"Maryland","Baltimore County",2,80,3736,1472,2264
050,24,005,"Maryland","Baltimore County",2,81,3502,1392,2110
050,24,005,"Maryland","Baltimore County",2,82,3337,1331,2006
050,24,005,"Maryland","Baltimore County",2,83,2993,1154,1839
050,24,005,"Maryland","Baltimore County",2,84,2813,1068,1745
050,24,005,"Maryland","Baltimore County",2,85,20116,6717,13399
050,24,005,"Maryland","Baltimore County",3,0,9234,4720,4514
050,24,005,"Maryland","Baltimore County",3,1,9918,5006,4912
050,24,005,"Maryland","Baltimore County",3,2,10142,5184,4958
050,24,005,"Maryland","Baltimore County",3,3,10044,5131,4913
050,24,005,"Maryland","Baltimore County",3,4,9953,4999,4954
050,24,005,"Maryland","Baltimore County",3,5,10275,5184,5091
050,24,005,"Maryland","Baltimore County",3,6,10316,5196,5120
050,24,005,"Maryland","Baltimore County",3,7,10140,5096,5044
050,24,005,"Maryland","Baltimore County",3,8,10081,5148,4933
050,24,005,"Maryland","Baltimore County",3,9,10209,5243,4966
050,24,005,"Maryland","Baltimore County",3,10,10419,5384,5035
050,24,005,"Maryland","Baltimore County",3,11,10620,5429,5191
050,24,005,"Maryland","Baltimore County",3,12,10816,5524,5292
050,24,005,"Maryland","Baltimore County",3,13,11227,5746,5481
050,24,005,"Maryland","Baltimore County",3,14,11192,5660,5532
050,24,005,"Maryland","Baltimore County",3,15,10954,5489,5465
050,24,005,"Maryland","Baltimore County",3,16,10780,5507,5273
050,24,005,"Maryland","Baltimore County",3,17,10777,5548,5229
050,24,005,"Maryland","Baltimore County",3,18,12063,5930,6133
050,24,005,"Maryland","Baltimore County",3,19,11672,5608,6064
050,24,005,"Maryland","Baltimore County",3,20,11108,5529,5579
050,24,005,"Maryland","Baltimore County",3,21,10646,5187,5459
050,24,005,"Maryland","Baltimore County",3,22,10099,4951,5148
050,24,005,"Maryland","Baltimore County",3,23,9883,4878,5005
050,24,005,"Maryland","Baltimore County",3,24,9859,4831,5028
050,24,005,"Maryland","Baltimore County",3,25,10162,4872,5290
050,24,005,"Maryland","Baltimore County",3,26,10274,4976,5298
050,24,005,"Maryland","Baltimore County",3,27,10799,5274,5525
050,24,005,"Maryland","Baltimore County",3,28,10881,5257,5624
050,24,005,"Maryland","Baltimore County",3,29,11108,5364,5744
050,24,005,"Maryland","Baltimore County",3,30,11446,5443,6003
050,24,005,"Maryland","Baltimore County",3,31,11965,5691,6274
050,24,005,"Maryland","Baltimore County",3,32,11881,5667,6214
050,24,005,"Maryland","Baltimore County",3,33,11794,5617,6177
050,24,005,"Maryland","Baltimore County",3,34,11777,5719,6058
050,24,005,"Maryland","Baltimore County",3,35,11559,5593,5966
050,24,005,"Maryland","Baltimore County",3,36,11439,5458,5981
050,24,005,"Maryland","Baltimore County",3,37,11285,5318,5967
050,24,005,"Maryland","Baltimore County",3,38,11346,5344,6002
050,24,005,"Maryland","Baltimore County",3,39,11237,5335,5902
050,24,005,"Maryland","Baltimore County",3,40,11142,5337,5805
050,24,005,"Maryland","Baltimore County",3,41,10835,5190,5645
050,24,005,"Maryland","Baltimore County",3,42,10412,4961,5451
050,24,005,"Maryland","Baltimore County",3,43,10060,4771,5289
050,24,005,"Maryland","Baltimore County",3,44,9905,4656,5249
050,24,005,"Maryland","Baltimore County",3,45,9698,4555,5143
050,24,005,"Maryland","Baltimore County",3,46,9730,4571,5159
050,24,005,"Maryland","Baltimore County",3,47,9486,4490,4996
050,24,005,"Maryland","Baltimore County",3,48,9762,4639,5123
050,24,005,"Maryland","Baltimore County",3,49,10300,4904,5396
050,24,005,"Maryland","Baltimore County",3,50,10970,5217,5753
050,24,005,"Maryland","Baltimore County",3,51,10898,5156,5742
050,24,005,"Maryland","Baltimore County",3,52,10474,5006,5468
050,24,005,"Maryland","Baltimore County",3,53,10522,5039,5483
050,24,005,"Maryland","Baltimore County",3,54,10654,5095,5559
050,24,005,"Maryland","Baltimore County",3,55,10877,5212,5665
050,24,005,"Maryland","Baltimore County",3,56,11276,5377,5899
050,24,005,"Maryland","Baltimore County",3,57,11504,5507,5997
050,24,005,"Maryland","Baltimore County",3,58,11477,5442,6035
050,24,005,"Maryland","Baltimore County",3,59,11516,5465,6051
050,24,005,"Maryland","Baltimore County",3,60,11679,5588,6091
050,24,005,"Maryland","Baltimore County",3,61,11577,5499,6078
050,24,005,"Maryland","Baltimore County",3,62,11501,5395,6106
050,24,005,"Maryland","Baltimore County",3,63,11411,5309,6102
050,24,005,"Maryland","Baltimore County",3,64,11217,5198,6019
050,24,005,"Maryland","Baltimore County",3,65,10585,4944,5641
050,24,005,"Maryland","Baltimore County",3,66,10292,4771,5521
050,24,005,"Maryland","Baltimore County",3,67,9752,4459,5293
050,24,005,"Maryland","Baltimore County",3,68,9245,4224,5021
050,24,005,"Maryland","Baltimore County",3,69,8808,3985,4823
050,24,005,"Maryland","Baltimore County",3,70,8477,3811,4666
050,24,005,"Maryland","Baltimore County",3,71,8039,3587,4452
050,24,005,"Maryland","Baltimore County",3,72,7839,3469,4370
050,24,005,"Maryland","Baltimore County",3,73,7765,3420,4345
050,24,005,"Maryland","Baltimore County",3,74,8029,3552,4477
050,24,005,"Maryland","Baltimore County",3,75,5579,2457,3122
050,24,005,"Maryland","Baltimore County",3,76,5186,2226,2960
050,24,005,"Maryland","Baltimore County",3,77,4940,2082,2858
050,24,005,"Maryland","Baltimore County",3,78,5184,2197,2987
050,24,005,"Maryland","Baltimore County",3,79,4522,1919,2603
050,24,005,"Maryland","Baltimore County",3,80,3953,1612,2341
050,24,005,"Maryland","Baltimore County",3,81,3550,1394,2156
050,24,005,"Maryland","Baltimore County",3,82,3230,1262,1968
050,24,005,"Maryland","Baltimore County",3,83,3168,1241,1927
050,24,005,"Maryland","Baltimore County",3,84,2741,1053,1688
050,24,005,"Maryland","Baltimore County",3,85,19544,6523,13021
050,24,005,"Maryland","Baltimore County",4,0,9371,4744,4627
050,24,005,"Maryland","Baltimore County",4,1,9122,4579,4543
050,24,005,"Maryland","Baltimore County",4,2,9891,4989,4902
050,24,005,"Maryland","Baltimore County",4,3,9909,5090,4819
050,24,005,"Maryland","Baltimore County",4,4,9955,5059,4896
050,24,005,"Maryland","Baltimore County",4,5,9867,4948,4919
050,24,005,"Maryland","Baltimore County",4,6,10206,5145,5061
050,24,005,"Maryland","Baltimore County",4,7,10281,5168,5113
050,24,005,"Maryland","Baltimore County",4,8,10128,5074,5054
050,24,005,"Maryland","Baltimore County",4,9,10007,5100,4907
050,24,005,"Maryland","Baltimore County",4,10,10154,5210,4944
050,24,005,"Maryland","Baltimore County",4,11,10391,5348,5043
050,24,005,"Maryland","Baltimore County",4,12,10562,5390,5172
050,24,005,"Maryland","Baltimore County",4,13,10819,5545,5274
050,24,005,"Maryland","Baltimore County",4,14,11231,5716,5515
050,24,005,"Maryland","Baltimore County",4,15,11146,5660,5486
050,24,005,"Maryland","Baltimore County",4,16,11032,5544,5488
050,24,005,"Maryland","Baltimore County",4,17,10808,5504,5304
050,24,005,"Maryland","Baltimore County",4,18,11958,5916,6042
050,24,005,"Maryland","Baltimore County",4,19,11581,5584,5997
050,24,005,"Maryland","Baltimore County",4,20,10764,5358,5406
050,24,005,"Maryland","Baltimore County",4,21,10543,5178,5365
050,24,005,"Maryland","Baltimore County",4,22,10266,4999,5267
050,24,005,"Maryland","Baltimore County",4,23,9947,4822,5125
050,24,005,"Maryland","Baltimore County",4,24,9896,4884,5012
050,24,005,"Maryland","Baltimore County",4,25,9833,4782,5051
050,24,005,"Maryland","Baltimore County",4,26,10165,4853,5312
050,24,005,"Maryland","Baltimore County",4,27,10334,4968,5366
050,24,005,"Maryland","Baltimore County",4,28,10685,5197,5488
050,24,005,"Maryland","Baltimore County",4,29,10825,5261,5564
050,24,005,"Maryland","Baltimore County",4,30,11127,5304,5823
050,24,005,"Maryland","Baltimore County",4,31,11473,5419,6054
050,24,005,"Maryland","Baltimore County",4,32,11797,5623,6174
050,24,005,"Maryland","Baltimore County",4,33,11776,5635,6141
050,24,005,"Maryland","Baltimore County",4,34,11736,5564,6172
050,24,005,"Maryland","Baltimore County",4,35,11695,5670,6025
050,24,005,"Maryland","Baltimore County",4,36,11533,5585,5948
050,24,005,"Maryland","Baltimore County",4,37,11291,5369,5922
050,24,005,"Maryland","Baltimore County",4,38,11140,5210,5930
050,24,005,"Maryland","Baltimore County",4,39,11242,5266,5976
050,24,005,"Maryland","Baltimore County",4,40,11107,5261,5846
050,24,005,"Maryland","Baltimore County",4,41,11032,5314,5718
050,24,005,"Maryland","Baltimore County",4,42,10805,5190,5615
050,24,005,"Maryland","Baltimore County",4,43,10250,4860,5390
050,24,005,"Maryland","Baltimore County",4,44,9907,4697,5210
050,24,005,"Maryland","Baltimore County",4,45,9818,4618,5200
050,24,005,"Maryland","Baltimore County",4,46,9594,4487,5107
050,24,005,"Maryland","Baltimore County",4,47,9716,4571,5145
050,24,005,"Maryland","Baltimore County",4,48,9369,4441,4928
050,24,005,"Maryland","Baltimore County",4,49,9624,4535,5089
050,24,005,"Maryland","Baltimore County",4,50,10196,4833,5363
050,24,005,"Maryland","Baltimore County",4,51,10899,5202,5697
050,24,005,"Maryland","Baltimore County",4,52,10763,5096,5667
050,24,005,"Maryland","Baltimore County",4,53,10444,4976,5468
050,24,005,"Maryland","Baltimore County",4,54,10470,5044,5426
050,24,005,"Maryland","Baltimore County",4,55,10592,5083,5509
050,24,005,"Maryland","Baltimore County",4,56,10740,5162,5578
050,24,005,"Maryland","Baltimore County",4,57,11081,5284,5797
050,24,005,"Maryland","Baltimore County",4,58,11289,5405,5884
050,24,005,"Maryland","Baltimore County",4,59,11254,5313,5941
050,24,005,"Maryland","Baltimore County",4,60,11364,5371,5993
050,24,005,"Maryland","Baltimore County",4,61,11477,5481,5996
050,24,005,"Maryland","Baltimore County",4,62,11378,5387,5991
050,24,005,"Maryland","Baltimore County",4,63,11221,5285,5936
050,24,005,"Maryland","Baltimore County",4,64,11146,5159,5987
050,24,005,"Maryland","Baltimore County",4,65,10977,5022,5955
050,24,005,"Maryland","Baltimore County",4,66,10254,4751,5503
050,24,005,"Maryland","Baltimore County",4,67,9992,4600,5392
050,24,005,"Maryland","Baltimore County",4,68,9409,4310,5099
050,24,005,"Maryland","Baltimore County",4,69,8986,4077,4909
050,24,005,"Maryland","Baltimore County",4,70,8547,3855,4692
050,24,005,"Maryland","Baltimore County",4,71,8245,3665,4580
050,24,005,"Maryland","Baltimore County",4,72,7801,3458,4343
050,24,005,"Maryland","Baltimore County",4,73,7664,3376,4288
050,24,005,"Maryland","Baltimore County",4,74,7543,3273,4270
050,24,005,"Maryland","Baltimore County",4,75,7797,3398,4399
050,24,005,"Maryland","Baltimore County",4,76,5429,2356,3073
050,24,005,"Maryland","Baltimore County",4,77,4998,2120,2878
050,24,005,"Maryland","Baltimore County",4,78,4790,1986,2804
050,24,005,"Maryland","Baltimore County",4,79,4966,2098,2868
050,24,005,"Maryland","Baltimore County",4,80,4332,1802,2530
050,24,005,"Maryland","Baltimore County",4,81,3773,1541,2232
050,24,005,"Maryland","Baltimore County",4,82,3325,1267,2058
050,24,005,"Maryland","Baltimore County",4,83,3078,1167,1911
050,24,005,"Maryland","Baltimore County",4,84,2908,1142,1766
050,24,005,"Maryland","Baltimore County",4,85,19149,6455,12694
050,24,005,"Maryland","Baltimore County",5,0,9333,4726,4607
050,24,005,"Maryland","Baltimore County",5,1,9499,4788,4711
050,24,005,"Maryland","Baltimore County",5,2,9225,4642,4583
050,24,005,"Maryland","Baltimore County",5,3,9828,4971,4857
050,24,005,"Maryland","Baltimore County",5,4,9807,5033,4774
050,24,005,"Maryland","Baltimore County",5,5,9975,5066,4909
050,24,005,"Maryland","Baltimore County",5,6,9832,4951,4881
050,24,005,"Maryland","Baltimore County",5,7,10172,5146,5026
050,24,005,"Maryland","Baltimore County",5,8,10276,5164,5112
050,24,005,"Maryland","Baltimore County",5,9,10052,5053,4999
050,24,005,"Maryland","Baltimore County",5,10,9938,5074,4864
050,24,005,"Maryland","Baltimore County",5,11,10123,5148,4975
050,24,005,"Maryland","Baltimore County",5,12,10353,5353,5000
050,24,005,"Maryland","Baltimore County",5,13,10576,5386,5190
050,24,005,"Maryland","Baltimore County",5,14,10821,5568,5253
050,24,005,"Maryland","Baltimore County",5,15,11099,5632,5467
050,24,005,"Maryland","Baltimore County",5,16,11199,5727,5472
050,24,005,"Maryland","Baltimore County",5,17,11049,5542,5507
050,24,005,"Maryland","Baltimore County",5,18,11961,5831,6130
050,24,005,"Maryland","Baltimore County",5,19,11651,5631,6020
050,24,005,"Maryland","Baltimore County",5,20,10808,5402,5406
050,24,005,"Maryland","Baltimore County",5,21,10298,5100,5198
050,24,005,"Maryland","Baltimore County",5,22,10240,5018,5222
050,24,005,"Maryland","Baltimore County",5,23,10085,4841,5244
050,24,005,"Maryland","Baltimore County",5,24,10070,4846,5224
050,24,005,"Maryland","Baltimore County",5,25,9878,4818,5060
050,24,005,"Maryland","Baltimore County",5,26,9824,4720,5104
050,24,005,"Maryland","Baltimore County",5,27,10224,4820,5404
050,24,005,"Maryland","Baltimore County",5,28,10335,5012,5323
050,24,005,"Maryland","Baltimore County",5,29,10789,5172,5617
050,24,005,"Maryland","Baltimore County",5,30,10870,5225,5645
050,24,005,"Maryland","Baltimore County",5,31,11227,5296,5931
050,24,005,"Maryland","Baltimore County",5,32,11477,5391,6086
050,24,005,"Maryland","Baltimore County",5,33,11859,5655,6204
050,24,005,"Maryland","Baltimore County",5,34,11776,5648,6128
050,24,005,"Maryland","Baltimore County",5,35,11794,5584,6210
050,24,005,"Maryland","Baltimore County",5,36,11637,5629,6008
050,24,005,"Maryland","Baltimore County",5,37,11540,5587,5953
050,24,005,"Maryland","Baltimore County",5,38,11110,5285,5825
050,24,005,"Maryland","Baltimore County",5,39,11089,5140,5949
050,24,005,"Maryland","Baltimore County",5,40,11145,5225,5920
050,24,005,"Maryland","Baltimore County",5,41,11104,5286,5818
050,24,005,"Maryland","Baltimore County",5,42,10968,5283,5685
050,24,005,"Maryland","Baltimore County",5,43,10734,5146,5588
050,24,005,"Maryland","Baltimore County",5,44,10192,4815,5377
050,24,005,"Maryland","Baltimore County",5,45,9972,4721,5251
050,24,005,"Maryland","Baltimore County",5,46,9720,4570,5150
050,24,005,"Maryland","Baltimore County",5,47,9605,4478,5127
050,24,005,"Maryland","Baltimore County",5,48,9607,4549,5058
050,24,005,"Maryland","Baltimore County",5,49,9353,4425,4928
050,24,005,"Maryland","Baltimore County",5,50,9578,4486,5092
050,24,005,"Maryland","Baltimore County",5,51,10090,4803,5287
050,24,005,"Maryland","Baltimore County",5,52,10788,5177,5611
050,24,005,"Maryland","Baltimore County",5,53,10679,5062,5617
050,24,005,"Maryland","Baltimore County",5,54,10311,4925,5386
050,24,005,"Maryland","Baltimore County",5,55,10383,4987,5396
050,24,005,"Maryland","Baltimore County",5,56,10469,5014,5455
050,24,005,"Maryland","Baltimore County",5,57,10612,5085,5527
050,24,005,"Maryland","Baltimore County",5,58,10932,5163,5769
050,24,005,"Maryland","Baltimore County",5,59,11123,5317,5806
050,24,005,"Maryland","Baltimore County",5,60,11091,5223,5868
050,24,005,"Maryland","Baltimore County",5,61,11167,5271,5896
050,24,005,"Maryland","Baltimore County",5,62,11290,5380,5910
050,24,005,"Maryland","Baltimore County",5,63,11157,5288,5869
050,24,005,"Maryland","Baltimore County",5,64,11015,5174,5841
050,24,005,"Maryland","Baltimore County",5,65,10925,5016,5909
050,24,005,"Maryland","Baltimore County",5,66,10762,4896,5866
050,24,005,"Maryland","Baltimore County",5,67,10004,4627,5377
050,24,005,"Maryland","Baltimore County",5,68,9739,4475,5264
050,24,005,"Maryland","Baltimore County",5,69,9216,4202,5014
050,24,005,"Maryland","Baltimore County",5,70,8771,3952,4819
050,24,005,"Maryland","Baltimore County",5,71,8338,3742,4596
050,24,005,"Maryland","Baltimore County",5,72,8009,3540,4469
050,24,005,"Maryland","Baltimore County",5,73,7604,3369,4235
050,24,005,"Maryland","Baltimore County",5,74,7440,3249,4191
050,24,005,"Maryland","Baltimore County",5,75,7333,3134,4199
050,24,005,"Maryland","Baltimore County",5,76,7556,3273,4283
050,24,005,"Maryland","Baltimore County",5,77,5237,2256,2981
050,24,005,"Maryland","Baltimore County",5,78,4857,2042,2815
050,24,005,"Maryland","Baltimore County",5,79,4610,1916,2694
050,24,005,"Maryland","Baltimore County",5,80,4743,1971,2772
050,24,005,"Maryland","Baltimore County",5,81,4122,1711,2411
050,24,005,"Maryland","Baltimore County",5,82,3545,1428,2117
050,24,005,"Maryland","Baltimore County",5,83,3182,1195,1987
050,24,005,"Maryland","Baltimore County",5,84,2828,1084,1744
050,24,005,"Maryland","Baltimore County",5,85,19098,6532,12566
050,24,009,"Maryland","Calvert County",1,0,875,447,428
050,24,009,"Maryland","Calvert County",1,1,917,481,436
050,24,009,"Maryland","Calvert County",1,2,965,507,458
050,24,009,"Maryland","Calvert County",1,3,1072,540,532
050,24,009,"Maryland","Calvert County",1,4,1114,575,539
050,24,009,"Maryland","Calvert County",1,5,1127,586,541
050,24,009,"Maryland","Calvert County",1,6,1154,589,565
050,24,009,"Maryland","Calvert County",1,7,1154,600,554
050,24,009,"Maryland","Calvert County",1,8,1205,618,587
050,24,009,"Maryland","Calvert County",1,9,1235,652,583
050,24,009,"Maryland","Calvert County",1,10,1255,655,600
050,24,009,"Maryland","Calvert County",1,11,1258,654,604
050,24,009,"Maryland","Calvert County",1,12,1361,699,662
050,24,009,"Maryland","Calvert County",1,13,1369,704,665
050,24,009,"Maryland","Calvert County",1,14,1350,685,665
050,24,009,"Maryland","Calvert County",1,15,1380,697,683
050,24,009,"Maryland","Calvert County",1,16,1421,724,697
050,24,009,"Maryland","Calvert County",1,17,1396,695,701
050,24,009,"Maryland","Calvert County",1,18,1212,633,579
050,24,009,"Maryland","Calvert County",1,19,944,509,435
050,24,009,"Maryland","Calvert County",1,20,1007,516,491
050,24,009,"Maryland","Calvert County",1,21,1068,544,524
050,24,009,"Maryland","Calvert County",1,22,1059,540,519
050,24,009,"Maryland","Calvert County",1,23,1025,528,497
050,24,009,"Maryland","Calvert County",1,24,1007,545,462
050,24,009,"Maryland","Calvert County",1,25,1053,555,498
050,24,009,"Maryland","Calvert County",1,26,1025,548,477
050,24,009,"Maryland","Calvert County",1,27,1000,504,496
050,24,009,"Maryland","Calvert County",1,28,989,492,497
050,24,009,"Maryland","Calvert County",1,29,1045,537,508
050,24,009,"Maryland","Calvert County",1,30,1063,553,510
050,24,009,"Maryland","Calvert County",1,31,1079,535,544
050,24,009,"Maryland","Calvert County",1,32,1095,529,566
050,24,009,"Maryland","Calvert County",1,33,1153,563,590
050,24,009,"Maryland","Calvert County",1,34,1180,596,584
050,24,009,"Maryland","Calvert County",1,35,1141,558,583
050,24,009,"Maryland","Calvert County",1,36,1221,621,600
050,24,009,"Maryland","Calvert County",1,37,1255,614,641
050,24,009,"Maryland","Calvert County",1,38,1249,615,634
050,24,009,"Maryland","Calvert County",1,39,1245,623,622
050,24,009,"Maryland","Calvert County",1,40,1240,606,634
050,24,009,"Maryland","Calvert County",1,41,1152,585,567
050,24,009,"Maryland","Calvert County",1,42,1091,554,537
050,24,009,"Maryland","Calvert County",1,43,1046,526,520
050,24,009,"Maryland","Calvert County",1,44,1049,527,522
050,24,009,"Maryland","Calvert County",1,45,1044,499,545
050,24,009,"Maryland","Calvert County",1,46,1035,491,544
050,24,009,"Maryland","Calvert County",1,47,1117,561,556
050,24,009,"Maryland","Calvert County",1,48,1245,599,646
050,24,009,"Maryland","Calvert County",1,49,1322,629,693
050,24,009,"Maryland","Calvert County",1,50,1335,655,680
050,24,009,"Maryland","Calvert County",1,51,1370,670,700
050,24,009,"Maryland","Calvert County",1,52,1386,693,693
050,24,009,"Maryland","Calvert County",1,53,1482,753,729
050,24,009,"Maryland","Calvert County",1,54,1476,749,727
050,24,009,"Maryland","Calvert County",1,55,1597,793,804
050,24,009,"Maryland","Calvert County",1,56,1618,795,823
050,24,009,"Maryland","Calvert County",1,57,1598,773,825
050,24,009,"Maryland","Calvert County",1,58,1573,802,771
050,24,009,"Maryland","Calvert County",1,59,1504,754,750
050,24,009,"Maryland","Calvert County",1,60,1434,714,720
050,24,009,"Maryland","Calvert County",1,61,1349,677,672
050,24,009,"Maryland","Calvert County",1,62,1308,650,658
050,24,009,"Maryland","Calvert County",1,63,1243,607,636
050,24,009,"Maryland","Calvert County",1,64,1124,549,575
050,24,009,"Maryland","Calvert County",1,65,1094,516,578
050,24,009,"Maryland","Calvert County",1,66,1049,515,534
050,24,009,"Maryland","Calvert County",1,67,985,469,516
050,24,009,"Maryland","Calvert County",1,68,895,453,442
050,24,009,"Maryland","Calvert County",1,69,837,419,418
050,24,009,"Maryland","Calvert County",1,70,771,383,388
050,24,009,"Maryland","Calvert County",1,71,787,380,407
050,24,009,"Maryland","Calvert County",1,72,810,391,419
050,24,009,"Maryland","Calvert County",1,73,800,380,420
050,24,009,"Maryland","Calvert County",1,74,613,294,319
050,24,009,"Maryland","Calvert County",1,75,606,286,320
050,24,009,"Maryland","Calvert County",1,76,584,278,306
050,24,009,"Maryland","Calvert County",1,77,574,268,306
050,24,009,"Maryland","Calvert County",1,78,485,231,254
050,24,009,"Maryland","Calvert County",1,79,396,184,212
050,24,009,"Maryland","Calvert County",1,80,367,163,204
050,24,009,"Maryland","Calvert County",1,81,358,155,203
050,24,009,"Maryland","Calvert County",1,82,319,137,182
050,24,009,"Maryland","Calvert County",1,83,279,111,168
050,24,009,"Maryland","Calvert County",1,84,226,82,144
050,24,009,"Maryland","Calvert County",1,85,1493,523,970
050,24,009,"Maryland","Calvert County",2,0,899,455,444
050,24,009,"Maryland","Calvert County",2,1,917,481,436
050,24,009,"Maryland","Calvert County",2,2,972,509,463
050,24,009,"Maryland","Calvert County",2,3,1057,535,522
050,24,009,"Maryland","Calvert County",2,4,1119,574,545
050,24,009,"Maryland","Calvert County",2,5,1133,591,542
050,24,009,"Maryland","Calvert County",2,6,1151,593,558
050,24,009,"Maryland","Calvert County",2,7,1159,599,560
050,24,009,"Maryland","Calvert County",2,8,1195,615,580
050,24,009,"Maryland","Calvert County",2,9,1236,648,588
050,24,009,"Maryland","Calvert County",2,10,1253,656,597
050,24,009,"Maryland","Calvert County",2,11,1262,657,605
050,24,009,"Maryland","Calvert County",2,12,1351,696,655
050,24,009,"Maryland","Calvert County",2,13,1371,703,668
050,24,009,"Maryland","Calvert County",2,14,1355,690,665
050,24,009,"Maryland","Calvert County",2,15,1376,698,678
050,24,009,"Maryland","Calvert County",2,16,1415,718,697
050,24,009,"Maryland","Calvert County",2,17,1401,705,696
050,24,009,"Maryland","Calvert County",2,18,1199,626,573
050,24,009,"Maryland","Calvert County",2,19,960,513,447
050,24,009,"Maryland","Calvert County",2,20,1019,530,489
050,24,009,"Maryland","Calvert County",2,21,1058,540,518
050,24,009,"Maryland","Calvert County",2,22,1065,545,520
050,24,009,"Maryland","Calvert County",2,23,1029,531,498
050,24,009,"Maryland","Calvert County",2,24,1008,537,471
050,24,009,"Maryland","Calvert County",2,25,1039,552,487
050,24,009,"Maryland","Calvert County",2,26,1035,551,484
050,24,009,"Maryland","Calvert County",2,27,1012,515,497
050,24,009,"Maryland","Calvert County",2,28,1002,498,504
050,24,009,"Maryland","Calvert County",2,29,1039,531,508
050,24,009,"Maryland","Calvert County",2,30,1073,558,515
050,24,009,"Maryland","Calvert County",2,31,1081,543,538
050,24,009,"Maryland","Calvert County",2,32,1097,531,566
050,24,009,"Maryland","Calvert County",2,33,1147,560,587
050,24,009,"Maryland","Calvert County",2,34,1175,589,586
050,24,009,"Maryland","Calvert County",2,35,1169,577,592
050,24,009,"Maryland","Calvert County",2,36,1207,611,596
050,24,009,"Maryland","Calvert County",2,37,1260,624,636
050,24,009,"Maryland","Calvert County",2,38,1259,618,641
050,24,009,"Maryland","Calvert County",2,39,1248,620,628
050,24,009,"Maryland","Calvert County",2,40,1250,613,637
050,24,009,"Maryland","Calvert County",2,41,1182,595,587
050,24,009,"Maryland","Calvert County",2,42,1103,562,541
050,24,009,"Maryland","Calvert County",2,43,1064,536,528
050,24,009,"Maryland","Calvert County",2,44,1042,524,518
050,24,009,"Maryland","Calvert County",2,45,1055,510,545
050,24,009,"Maryland","Calvert County",2,46,1038,493,545
050,24,009,"Maryland","Calvert County",2,47,1096,543,553
050,24,009,"Maryland","Calvert County",2,48,1216,591,625
050,24,009,"Maryland","Calvert County",2,49,1308,627,681
050,24,009,"Maryland","Calvert County",2,50,1332,649,683
050,24,009,"Maryland","Calvert County",2,51,1354,662,692
050,24,009,"Maryland","Calvert County",2,52,1374,682,692
050,24,009,"Maryland","Calvert County",2,53,1452,736,716
050,24,009,"Maryland","Calvert County",2,54,1469,746,723
050,24,009,"Maryland","Calvert County",2,55,1558,774,784
050,24,009,"Maryland","Calvert County",2,56,1614,795,819
050,24,009,"Maryland","Calvert County",2,57,1593,776,817
050,24,009,"Maryland","Calvert County",2,58,1567,791,776
050,24,009,"Maryland","Calvert County",2,59,1516,762,754
050,24,009,"Maryland","Calvert County",2,60,1442,719,723
050,24,009,"Maryland","Calvert County",2,61,1355,678,677
050,24,009,"Maryland","Calvert County",2,62,1305,645,660
050,24,009,"Maryland","Calvert County",2,63,1261,616,645
050,24,009,"Maryland","Calvert County",2,64,1138,554,584
050,24,009,"Maryland","Calvert County",2,65,1095,522,573
050,24,009,"Maryland","Calvert County",2,66,1062,514,548
050,24,009,"Maryland","Calvert County",2,67,992,478,514
050,24,009,"Maryland","Calvert County",2,68,907,452,455
050,24,009,"Maryland","Calvert County",2,69,855,429,426
050,24,009,"Maryland","Calvert County",2,70,784,390,394
050,24,009,"Maryland","Calvert County",2,71,784,382,402
050,24,009,"Maryland","Calvert County",2,72,784,376,408
050,24,009,"Maryland","Calvert County",2,73,834,396,438
050,24,009,"Maryland","Calvert County",2,74,615,294,321
050,24,009,"Maryland","Calvert County",2,75,605,286,319
050,24,009,"Maryland","Calvert County",2,76,578,275,303
050,24,009,"Maryland","Calvert County",2,77,579,272,307
050,24,009,"Maryland","Calvert County",2,78,495,235,260
050,24,009,"Maryland","Calvert County",2,79,412,193,219
050,24,009,"Maryland","Calvert County",2,80,369,163,206
050,24,009,"Maryland","Calvert County",2,81,348,151,197
050,24,009,"Maryland","Calvert County",2,82,325,141,184
050,24,009,"Maryland","Calvert County",2,83,283,113,170
050,24,009,"Maryland","Calvert County",2,84,233,88,145
050,24,009,"Maryland","Calvert County",2,85,1489,524,965
050,24,009,"Maryland","Calvert County",3,0,942,461,481
050,24,009,"Maryland","Calvert County",3,1,958,488,470
050,24,009,"Maryland","Calvert County",3,2,1000,516,484
050,24,009,"Maryland","Calvert County",3,3,1029,539,490
050,24,009,"Maryland","Calvert County",3,4,1127,565,562
050,24,009,"Maryland","Calvert County",3,5,1157,579,578
050,24,009,"Maryland","Calvert County",3,6,1209,606,603
050,24,009,"Maryland","Calvert County",3,7,1196,621,575
050,24,009,"Maryland","Calvert County",3,8,1223,623,600
050,24,009,"Maryland","Calvert County",3,9,1220,636,584
050,24,009,"Maryland","Calvert County",3,10,1280,666,614
050,24,009,"Maryland","Calvert County",3,11,1278,682,596
050,24,009,"Maryland","Calvert County",3,12,1325,703,622
050,24,009,"Maryland","Calvert County",3,13,1353,687,666
050,24,009,"Maryland","Calvert County",3,14,1397,718,679
050,24,009,"Maryland","Calvert County",3,15,1371,702,669
050,24,009,"Maryland","Calvert County",3,16,1415,720,695
050,24,009,"Maryland","Calvert County",3,17,1405,701,704
050,24,009,"Maryland","Calvert County",3,18,1211,628,583
050,24,009,"Maryland","Calvert County",3,19,978,514,464
050,24,009,"Maryland","Calvert County",3,20,1026,539,487
050,24,009,"Maryland","Calvert County",3,21,1058,538,520
050,24,009,"Maryland","Calvert County",3,22,1082,545,537
050,24,009,"Maryland","Calvert County",3,23,1053,554,499
050,24,009,"Maryland","Calvert County",3,24,1029,545,484
050,24,009,"Maryland","Calvert County",3,25,1013,544,469
050,24,009,"Maryland","Calvert County",3,26,1044,539,505
050,24,009,"Maryland","Calvert County",3,27,1056,552,504
050,24,009,"Maryland","Calvert County",3,28,1028,521,507
050,24,009,"Maryland","Calvert County",3,29,1039,508,531
050,24,009,"Maryland","Calvert County",3,30,1100,557,543
050,24,009,"Maryland","Calvert County",3,31,1119,575,544
050,24,009,"Maryland","Calvert County",3,32,1137,560,577
050,24,009,"Maryland","Calvert County",3,33,1156,577,579
050,24,009,"Maryland","Calvert County",3,34,1208,593,615
050,24,009,"Maryland","Calvert County",3,35,1245,629,616
050,24,009,"Maryland","Calvert County",3,36,1240,605,635
050,24,009,"Maryland","Calvert County",3,37,1271,638,633
050,24,009,"Maryland","Calvert County",3,38,1340,664,676
050,24,009,"Maryland","Calvert County",3,39,1308,652,656
050,24,009,"Maryland","Calvert County",3,40,1266,627,639
050,24,009,"Maryland","Calvert County",3,41,1310,639,671
050,24,009,"Maryland","Calvert County",3,42,1226,613,613
050,24,009,"Maryland","Calvert County",3,43,1148,581,567
050,24,009,"Maryland","Calvert County",3,44,1078,539,539
050,24,009,"Maryland","Calvert County",3,45,1069,547,522
050,24,009,"Maryland","Calvert County",3,46,1073,521,552
050,24,009,"Maryland","Calvert County",3,47,1056,505,551
050,24,009,"Maryland","Calvert County",3,48,1119,565,554
050,24,009,"Maryland","Calvert County",3,49,1188,579,609
050,24,009,"Maryland","Calvert County",3,50,1301,632,669
050,24,009,"Maryland","Calvert County",3,51,1324,649,675
050,24,009,"Maryland","Calvert County",3,52,1329,649,680
050,24,009,"Maryland","Calvert County",3,53,1372,682,690
050,24,009,"Maryland","Calvert County",3,54,1434,725,709
050,24,009,"Maryland","Calvert County",3,55,1449,734,715
050,24,009,"Maryland","Calvert County",3,56,1563,791,772
050,24,009,"Maryland","Calvert County",3,57,1598,796,802
050,24,009,"Maryland","Calvert County",3,58,1572,764,808
050,24,009,"Maryland","Calvert County",3,59,1501,747,754
050,24,009,"Maryland","Calvert County",3,60,1492,737,755
050,24,009,"Maryland","Calvert County",3,61,1405,705,700
050,24,009,"Maryland","Calvert County",3,62,1320,654,666
050,24,009,"Maryland","Calvert County",3,63,1245,618,627
050,24,009,"Maryland","Calvert County",3,64,1224,602,622
050,24,009,"Maryland","Calvert County",3,65,1110,532,578
050,24,009,"Maryland","Calvert County",3,66,1066,498,568
050,24,009,"Maryland","Calvert County",3,67,1032,493,539
050,24,009,"Maryland","Calvert County",3,68,977,462,515
050,24,009,"Maryland","Calvert County",3,69,880,439,441
050,24,009,"Maryland","Calvert County",3,70,837,412,425
050,24,009,"Maryland","Calvert County",3,71,761,379,382
050,24,009,"Maryland","Calvert County",3,72,770,365,405
050,24,009,"Maryland","Calvert County",3,73,770,367,403
050,24,009,"Maryland","Calvert County",3,74,812,376,436
050,24,009,"Maryland","Calvert County",3,75,599,282,317
050,24,009,"Maryland","Calvert County",3,76,591,279,312
050,24,009,"Maryland","Calvert County",3,77,563,267,296
050,24,009,"Maryland","Calvert County",3,78,552,254,298
050,24,009,"Maryland","Calvert County",3,79,474,221,253
050,24,009,"Maryland","Calvert County",3,80,400,179,221
050,24,009,"Maryland","Calvert County",3,81,355,159,196
050,24,009,"Maryland","Calvert County",3,82,326,140,186
050,24,009,"Maryland","Calvert County",3,83,315,135,180
050,24,009,"Maryland","Calvert County",3,84,263,110,153
050,24,009,"Maryland","Calvert County",3,85,1492,531,961
050,24,009,"Maryland","Calvert County",4,0,971,504,467
050,24,009,"Maryland","Calvert County",4,1,964,483,481
050,24,009,"Maryland","Calvert County",4,2,1005,509,496
050,24,009,"Maryland","Calvert County",4,3,1000,512,488
050,24,009,"Maryland","Calvert County",4,4,1081,569,512
050,24,009,"Maryland","Calvert County",4,5,1157,593,564
050,24,009,"Maryland","Calvert County",4,6,1191,605,586
050,24,009,"Maryland","Calvert County",4,7,1240,611,629
050,24,009,"Maryland","Calvert County",4,8,1229,634,595
050,24,009,"Maryland","Calvert County",4,9,1246,635,611
050,24,009,"Maryland","Calvert County",4,10,1243,641,602
050,24,009,"Maryland","Calvert County",4,11,1333,682,651
050,24,009,"Maryland","Calvert County",4,12,1310,683,627
050,24,009,"Maryland","Calvert County",4,13,1323,693,630
050,24,009,"Maryland","Calvert County",4,14,1379,697,682
050,24,009,"Maryland","Calvert County",4,15,1429,732,697
050,24,009,"Maryland","Calvert County",4,16,1373,709,664
050,24,009,"Maryland","Calvert County",4,17,1364,693,671
050,24,009,"Maryland","Calvert County",4,18,1185,606,579
050,24,009,"Maryland","Calvert County",4,19,929,481,448
050,24,009,"Maryland","Calvert County",4,20,1005,515,490
050,24,009,"Maryland","Calvert County",4,21,1034,535,499
050,24,009,"Maryland","Calvert County",4,22,1075,543,532
050,24,009,"Maryland","Calvert County",4,23,1070,553,517
050,24,009,"Maryland","Calvert County",4,24,1047,563,484
050,24,009,"Maryland","Calvert County",4,25,1001,526,475
050,24,009,"Maryland","Calvert County",4,26,990,505,485
050,24,009,"Maryland","Calvert County",4,27,1050,532,518
050,24,009,"Maryland","Calvert County",4,28,1064,555,509
050,24,009,"Maryland","Calvert County",4,29,1054,525,529
050,24,009,"Maryland","Calvert County",4,30,1055,509,546
050,24,009,"Maryland","Calvert County",4,31,1133,595,538
050,24,009,"Maryland","Calvert County",4,32,1160,593,567
050,24,009,"Maryland","Calvert County",4,33,1180,586,594
050,24,009,"Maryland","Calvert County",4,34,1228,596,632
050,24,009,"Maryland","Calvert County",4,35,1256,621,635
050,24,009,"Maryland","Calvert County",4,36,1317,663,654
050,24,009,"Maryland","Calvert County",4,37,1290,642,648
050,24,009,"Maryland","Calvert County",4,38,1324,668,656
050,24,009,"Maryland","Calvert County",4,39,1368,676,692
050,24,009,"Maryland","Calvert County",4,40,1350,683,667
050,24,009,"Maryland","Calvert County",4,41,1283,646,637
050,24,009,"Maryland","Calvert County",4,42,1328,645,683
050,24,009,"Maryland","Calvert County",4,43,1218,600,618
050,24,009,"Maryland","Calvert County",4,44,1137,584,553
050,24,009,"Maryland","Calvert County",4,45,1088,542,546
050,24,009,"Maryland","Calvert County",4,46,1079,552,527
050,24,009,"Maryland","Calvert County",4,47,1087,526,561
050,24,009,"Maryland","Calvert County",4,48,1045,505,540
050,24,009,"Maryland","Calvert County",4,49,1115,568,547
050,24,009,"Maryland","Calvert County",4,50,1202,593,609
050,24,009,"Maryland","Calvert County",4,51,1289,619,670
050,24,009,"Maryland","Calvert County",4,52,1301,644,657
050,24,009,"Maryland","Calvert County",4,53,1324,639,685
050,24,009,"Maryland","Calvert County",4,54,1364,669,695
050,24,009,"Maryland","Calvert County",4,55,1401,699,702
050,24,009,"Maryland","Calvert County",4,56,1413,710,703
050,24,009,"Maryland","Calvert County",4,57,1559,785,774
050,24,009,"Maryland","Calvert County",4,58,1546,779,767
050,24,009,"Maryland","Calvert County",4,59,1550,754,796
050,24,009,"Maryland","Calvert County",4,60,1459,725,734
050,24,009,"Maryland","Calvert County",4,61,1470,743,727
050,24,009,"Maryland","Calvert County",4,62,1363,672,691
050,24,009,"Maryland","Calvert County",4,63,1282,649,633
050,24,009,"Maryland","Calvert County",4,64,1201,598,603
050,24,009,"Maryland","Calvert County",4,65,1193,578,615
050,24,009,"Maryland","Calvert County",4,66,1066,508,558
050,24,009,"Maryland","Calvert County",4,67,1046,485,561
050,24,009,"Maryland","Calvert County",4,68,995,461,534
050,24,009,"Maryland","Calvert County",4,69,956,445,511
050,24,009,"Maryland","Calvert County",4,70,854,422,432
050,24,009,"Maryland","Calvert County",4,71,816,403,413
050,24,009,"Maryland","Calvert County",4,72,748,370,378
050,24,009,"Maryland","Calvert County",4,73,739,349,390
050,24,009,"Maryland","Calvert County",4,74,730,339,391
050,24,009,"Maryland","Calvert County",4,75,807,372,435
050,24,009,"Maryland","Calvert County",4,76,578,274,304
050,24,009,"Maryland","Calvert County",4,77,569,261,308
050,24,009,"Maryland","Calvert County",4,78,536,250,286
050,24,009,"Maryland","Calvert County",4,79,516,233,283
050,24,009,"Maryland","Calvert County",4,80,447,203,244
050,24,009,"Maryland","Calvert County",4,81,377,166,211
050,24,009,"Maryland","Calvert County",4,82,340,151,189
050,24,009,"Maryland","Calvert County",4,83,314,131,183
050,24,009,"Maryland","Calvert County",4,84,282,122,160
050,24,009,"Maryland","Calvert County",4,85,1543,567,976
050,24,009,"Maryland","Calvert County",5,0,949,492,457
050,24,009,"Maryland","Calvert County",5,1,1060,551,509
050,24,009,"Maryland","Calvert County",5,2,1004,499,505
050,24,009,"Maryland","Calvert County",5,3,1030,519,511
050,24,009,"Maryland","Calvert County",5,4,1044,534,510
050,24,009,"Maryland","Calvert County",5,5,1108,593,515
050,24,009,"Maryland","Calvert County",5,6,1167,590,577
050,24,009,"Maryland","Calvert County",5,7,1237,636,601
050,24,009,"Maryland","Calvert County",5,8,1245,631,614
050,24,009,"Maryland","Calvert County",5,9,1248,637,611
050,24,009,"Maryland","Calvert County",5,10,1250,635,615
050,24,009,"Maryland","Calvert County",5,11,1267,640,627
050,24,009,"Maryland","Calvert County",5,12,1335,680,655
050,24,009,"Maryland","Calvert County",5,13,1308,689,619
050,24,009,"Maryland","Calvert County",5,14,1330,702,628
050,24,009,"Maryland","Calvert County",5,15,1382,692,690
050,24,009,"Maryland","Calvert County",5,16,1418,728,690
050,24,009,"Maryland","Calvert County",5,17,1401,720,681
050,24,009,"Maryland","Calvert County",5,18,1165,603,562
050,24,009,"Maryland","Calvert County",5,19,934,475,459
050,24,009,"Maryland","Calvert County",5,20,992,522,470
050,24,009,"Maryland","Calvert County",5,21,1029,517,512
050,24,009,"Maryland","Calvert County",5,22,1088,552,536
050,24,009,"Maryland","Calvert County",5,23,1067,557,510
050,24,009,"Maryland","Calvert County",5,24,1021,538,483
050,24,009,"Maryland","Calvert County",5,25,1008,536,472
050,24,009,"Maryland","Calvert County",5,26,1002,527,475
050,24,009,"Maryland","Calvert County",5,27,1001,525,476
050,24,009,"Maryland","Calvert County",5,28,1040,516,524
050,24,009,"Maryland","Calvert County",5,29,1058,547,511
050,24,009,"Maryland","Calvert County",5,30,1074,539,535
050,24,009,"Maryland","Calvert County",5,31,1061,517,544
050,24,009,"Maryland","Calvert County",5,32,1147,587,560
050,24,009,"Maryland","Calvert County",5,33,1170,599,571
050,24,009,"Maryland","Calvert County",5,34,1216,602,614
050,24,009,"Maryland","Calvert County",5,35,1255,607,648
050,24,009,"Maryland","Calvert County",5,36,1320,644,676
050,24,009,"Maryland","Calvert County",5,37,1356,691,665
050,24,009,"Maryland","Calvert County",5,38,1275,626,649
050,24,009,"Maryland","Calvert County",5,39,1358,682,676
050,24,009,"Maryland","Calvert County",5,40,1350,661,689
050,24,009,"Maryland","Calvert County",5,41,1368,701,667
050,24,009,"Maryland","Calvert County",5,42,1296,658,638
050,24,009,"Maryland","Calvert County",5,43,1342,648,694
050,24,009,"Maryland","Calvert County",5,44,1222,595,627
050,24,009,"Maryland","Calvert County",5,45,1145,583,562
050,24,009,"Maryland","Calvert County",5,46,1092,546,546
050,24,009,"Maryland","Calvert County",5,47,1072,534,538
050,24,009,"Maryland","Calvert County",5,48,1081,523,558
050,24,009,"Maryland","Calvert County",5,49,1032,506,526
050,24,009,"Maryland","Calvert County",5,50,1092,568,524
050,24,009,"Maryland","Calvert County",5,51,1199,595,604
050,24,009,"Maryland","Calvert County",5,52,1277,613,664
050,24,009,"Maryland","Calvert County",5,53,1290,630,660
050,24,009,"Maryland","Calvert County",5,54,1289,627,662
050,24,009,"Maryland","Calvert County",5,55,1354,663,691
050,24,009,"Maryland","Calvert County",5,56,1392,688,704
050,24,009,"Maryland","Calvert County",5,57,1398,702,696
050,24,009,"Maryland","Calvert County",5,58,1527,780,747
050,24,009,"Maryland","Calvert County",5,59,1522,766,756
050,24,009,"Maryland","Calvert County",5,60,1524,737,787
050,24,009,"Maryland","Calvert County",5,61,1418,707,711
050,24,009,"Maryland","Calvert County",5,62,1443,726,717
050,24,009,"Maryland","Calvert County",5,63,1325,648,677
050,24,009,"Maryland","Calvert County",5,64,1221,614,607
050,24,009,"Maryland","Calvert County",5,65,1166,585,581
050,24,009,"Maryland","Calvert County",5,66,1175,565,610
050,24,009,"Maryland","Calvert County",5,67,1051,500,551
050,24,009,"Maryland","Calvert County",5,68,1026,467,559
050,24,009,"Maryland","Calvert County",5,69,973,446,527
050,24,009,"Maryland","Calvert County",5,70,927,434,493
050,24,009,"Maryland","Calvert County",5,71,832,410,422
050,24,009,"Maryland","Calvert County",5,72,805,397,408
050,24,009,"Maryland","Calvert County",5,73,741,369,372
050,24,009,"Maryland","Calvert County",5,74,711,330,381
050,24,009,"Maryland","Calvert County",5,75,724,336,388
050,24,009,"Maryland","Calvert County",5,76,797,377,420
050,24,009,"Maryland","Calvert County",5,77,564,264,300
050,24,009,"Maryland","Calvert County",5,78,538,245,293
050,24,009,"Maryland","Calvert County",5,79,510,231,279
050,24,009,"Maryland","Calvert County",5,80,489,214,275
050,24,009,"Maryland","Calvert County",5,81,423,188,235
050,24,009,"Maryland","Calvert County",5,82,367,165,202
050,24,009,"Maryland","Calvert County",5,83,332,140,192
050,24,009,"Maryland","Calvert County",5,84,282,121,161
050,24,009,"Maryland","Calvert County",5,85,1604,610,994
050,24,011,"Maryland","Caroline County",1,0,425,218,207
050,24,011,"Maryland","Caroline County",1,1,411,216,195
050,24,011,"Maryland","Caroline County",1,2,400,211,189
050,24,011,"Maryland","Caroline County",1,3,419,217,202
050,24,011,"Maryland","Caroline County",1,4,416,194,222
050,24,011,"Maryland","Caroline County",1,5,431,233,198
050,24,011,"Maryland","Caroline County",1,6,419,229,190
050,24,011,"Maryland","Caroline County",1,7,445,221,224
050,24,011,"Maryland","Caroline County",1,8,443,223,220
050,24,011,"Maryland","Caroline County",1,9,461,236,225
050,24,011,"Maryland","Caroline County",1,10,417,215,202
050,24,011,"Maryland","Caroline County",1,11,443,232,211
050,24,011,"Maryland","Caroline County",1,12,479,225,254
050,24,011,"Maryland","Caroline County",1,13,479,238,241
050,24,011,"Maryland","Caroline County",1,14,479,235,244
050,24,011,"Maryland","Caroline County",1,15,466,238,228
050,24,011,"Maryland","Caroline County",1,16,463,228,235
050,24,011,"Maryland","Caroline County",1,17,440,212,228
050,24,011,"Maryland","Caroline County",1,18,404,211,193
050,24,011,"Maryland","Caroline County",1,19,323,170,153
050,24,011,"Maryland","Caroline County",1,20,308,160,148
050,24,011,"Maryland","Caroline County",1,21,338,171,167
050,24,011,"Maryland","Caroline County",1,22,348,172,176
050,24,011,"Maryland","Caroline County",1,23,356,174,182
050,24,011,"Maryland","Caroline County",1,24,347,176,171
050,24,011,"Maryland","Caroline County",1,25,388,185,203
050,24,011,"Maryland","Caroline County",1,26,380,183,197
050,24,011,"Maryland","Caroline County",1,27,393,203,190
050,24,011,"Maryland","Caroline County",1,28,401,180,221
050,24,011,"Maryland","Caroline County",1,29,447,213,234
050,24,011,"Maryland","Caroline County",1,30,456,218,238
050,24,011,"Maryland","Caroline County",1,31,461,235,226
050,24,011,"Maryland","Caroline County",1,32,427,207,220
050,24,011,"Maryland","Caroline County",1,33,419,228,191
050,24,011,"Maryland","Caroline County",1,34,437,225,212
050,24,011,"Maryland","Caroline County",1,35,392,198,194
050,24,011,"Maryland","Caroline County",1,36,427,208,219
050,24,011,"Maryland","Caroline County",1,37,418,211,207
050,24,011,"Maryland","Caroline County",1,38,386,192,194
050,24,011,"Maryland","Caroline County",1,39,412,204,208
050,24,011,"Maryland","Caroline County",1,40,400,189,211
050,24,011,"Maryland","Caroline County",1,41,368,188,180
050,24,011,"Maryland","Caroline County",1,42,422,207,215
050,24,011,"Maryland","Caroline County",1,43,401,184,217
050,24,011,"Maryland","Caroline County",1,44,352,162,190
050,24,011,"Maryland","Caroline County",1,45,342,162,180
050,24,011,"Maryland","Caroline County",1,46,391,186,205
050,24,011,"Maryland","Caroline County",1,47,396,209,187
050,24,011,"Maryland","Caroline County",1,48,432,234,198
050,24,011,"Maryland","Caroline County",1,49,461,249,212
050,24,011,"Maryland","Caroline County",1,50,433,208,225
050,24,011,"Maryland","Caroline County",1,51,444,215,229
050,24,011,"Maryland","Caroline County",1,52,445,205,240
050,24,011,"Maryland","Caroline County",1,53,449,211,238
050,24,011,"Maryland","Caroline County",1,54,481,236,245
050,24,011,"Maryland","Caroline County",1,55,478,233,245
050,24,011,"Maryland","Caroline County",1,56,497,265,232
050,24,011,"Maryland","Caroline County",1,57,512,251,261
050,24,011,"Maryland","Caroline County",1,58,536,255,281
050,24,011,"Maryland","Caroline County",1,59,497,252,245
050,24,011,"Maryland","Caroline County",1,60,505,237,268
050,24,011,"Maryland","Caroline County",1,61,483,242,241
050,24,011,"Maryland","Caroline County",1,62,493,251,242
050,24,011,"Maryland","Caroline County",1,63,467,229,238
050,24,011,"Maryland","Caroline County",1,64,429,198,231
050,24,011,"Maryland","Caroline County",1,65,423,200,223
050,24,011,"Maryland","Caroline County",1,66,393,201,192
050,24,011,"Maryland","Caroline County",1,67,354,176,178
050,24,011,"Maryland","Caroline County",1,68,347,163,184
050,24,011,"Maryland","Caroline County",1,69,301,140,161
050,24,011,"Maryland","Caroline County",1,70,301,131,170
050,24,011,"Maryland","Caroline County",1,71,339,170,169
050,24,011,"Maryland","Caroline County",1,72,314,157,157
050,24,011,"Maryland","Caroline County",1,73,327,156,171
050,24,011,"Maryland","Caroline County",1,74,234,116,118
050,24,011,"Maryland","Caroline County",1,75,237,111,126
050,24,011,"Maryland","Caroline County",1,76,230,109,121
050,24,011,"Maryland","Caroline County",1,77,205,97,108
050,24,011,"Maryland","Caroline County",1,78,178,75,103
050,24,011,"Maryland","Caroline County",1,79,174,77,97
050,24,011,"Maryland","Caroline County",1,80,160,68,92
050,24,011,"Maryland","Caroline County",1,81,143,70,73
050,24,011,"Maryland","Caroline County",1,82,138,66,72
050,24,011,"Maryland","Caroline County",1,83,110,47,63
050,24,011,"Maryland","Caroline County",1,84,106,39,67
050,24,011,"Maryland","Caroline County",1,85,560,180,380
050,24,011,"Maryland","Caroline County",2,0,409,210,199
050,24,011,"Maryland","Caroline County",2,1,410,214,196
050,24,011,"Maryland","Caroline County",2,2,407,215,192
050,24,011,"Maryland","Caroline County",2,3,419,216,203
050,24,011,"Maryland","Caroline County",2,4,417,202,215
050,24,011,"Maryland","Caroline County",2,5,426,225,201
050,24,011,"Maryland","Caroline County",2,6,423,230,193
050,24,011,"Maryland","Caroline County",2,7,433,219,214
050,24,011,"Maryland","Caroline County",2,8,440,221,219
050,24,011,"Maryland","Caroline County",2,9,455,233,222
050,24,011,"Maryland","Caroline County",2,10,429,222,207
050,24,011,"Maryland","Caroline County",2,11,435,227,208
050,24,011,"Maryland","Caroline County",2,12,472,229,243
050,24,011,"Maryland","Caroline County",2,13,477,234,243
050,24,011,"Maryland","Caroline County",2,14,477,235,242
050,24,011,"Maryland","Caroline County",2,15,471,238,233
050,24,011,"Maryland","Caroline County",2,16,465,231,234
050,24,011,"Maryland","Caroline County",2,17,447,219,228
050,24,011,"Maryland","Caroline County",2,18,397,205,192
050,24,011,"Maryland","Caroline County",2,19,325,171,154
050,24,011,"Maryland","Caroline County",2,20,320,167,153
050,24,011,"Maryland","Caroline County",2,21,335,171,164
050,24,011,"Maryland","Caroline County",2,22,350,173,177
050,24,011,"Maryland","Caroline County",2,23,356,176,180
050,24,011,"Maryland","Caroline County",2,24,353,178,175
050,24,011,"Maryland","Caroline County",2,25,384,186,198
050,24,011,"Maryland","Caroline County",2,26,381,182,199
050,24,011,"Maryland","Caroline County",2,27,389,197,192
050,24,011,"Maryland","Caroline County",2,28,400,186,214
050,24,011,"Maryland","Caroline County",2,29,439,207,232
050,24,011,"Maryland","Caroline County",2,30,457,218,239
050,24,011,"Maryland","Caroline County",2,31,459,233,226
050,24,011,"Maryland","Caroline County",2,32,431,210,221
050,24,011,"Maryland","Caroline County",2,33,419,219,200
050,24,011,"Maryland","Caroline County",2,34,428,223,205
050,24,011,"Maryland","Caroline County",2,35,404,206,198
050,24,011,"Maryland","Caroline County",2,36,420,207,213
050,24,011,"Maryland","Caroline County",2,37,419,209,210
050,24,011,"Maryland","Caroline County",2,38,400,199,201
050,24,011,"Maryland","Caroline County",2,39,404,200,204
050,24,011,"Maryland","Caroline County",2,40,399,192,207
050,24,011,"Maryland","Caroline County",2,41,376,186,190
050,24,011,"Maryland","Caroline County",2,42,406,200,206
050,24,011,"Maryland","Caroline County",2,43,406,190,216
050,24,011,"Maryland","Caroline County",2,44,361,167,194
050,24,011,"Maryland","Caroline County",2,45,347,163,184
050,24,011,"Maryland","Caroline County",2,46,382,180,202
050,24,011,"Maryland","Caroline County",2,47,386,198,188
050,24,011,"Maryland","Caroline County",2,48,417,224,193
050,24,011,"Maryland","Caroline County",2,49,459,249,210
050,24,011,"Maryland","Caroline County",2,50,442,218,224
050,24,011,"Maryland","Caroline County",2,51,442,214,228
050,24,011,"Maryland","Caroline County",2,52,446,206,240
050,24,011,"Maryland","Caroline County",2,53,448,208,240
050,24,011,"Maryland","Caroline County",2,54,470,227,243
050,24,011,"Maryland","Caroline County",2,55,477,234,243
050,24,011,"Maryland","Caroline County",2,56,494,258,236
050,24,011,"Maryland","Caroline County",2,57,507,253,254
050,24,011,"Maryland","Caroline County",2,58,531,256,275
050,24,011,"Maryland","Caroline County",2,59,506,252,254
050,24,011,"Maryland","Caroline County",2,60,507,242,265
050,24,011,"Maryland","Caroline County",2,61,482,239,243
050,24,011,"Maryland","Caroline County",2,62,485,247,238
050,24,011,"Maryland","Caroline County",2,63,471,235,236
050,24,011,"Maryland","Caroline County",2,64,434,203,231
050,24,011,"Maryland","Caroline County",2,65,421,199,222
050,24,011,"Maryland","Caroline County",2,66,401,202,199
050,24,011,"Maryland","Caroline County",2,67,360,182,178
050,24,011,"Maryland","Caroline County",2,68,348,165,183
050,24,011,"Maryland","Caroline County",2,69,312,145,167
050,24,011,"Maryland","Caroline County",2,70,302,134,168
050,24,011,"Maryland","Caroline County",2,71,325,159,166
050,24,011,"Maryland","Caroline County",2,72,314,157,157
050,24,011,"Maryland","Caroline County",2,73,338,164,174
050,24,011,"Maryland","Caroline County",2,74,239,116,123
050,24,011,"Maryland","Caroline County",2,75,236,110,126
050,24,011,"Maryland","Caroline County",2,76,231,109,122
050,24,011,"Maryland","Caroline County",2,77,212,101,111
050,24,011,"Maryland","Caroline County",2,78,177,75,102
050,24,011,"Maryland","Caroline County",2,79,170,75,95
050,24,011,"Maryland","Caroline County",2,80,161,68,93
050,24,011,"Maryland","Caroline County",2,81,141,67,74
050,24,011,"Maryland","Caroline County",2,82,136,67,69
050,24,011,"Maryland","Caroline County",2,83,114,50,64
050,24,011,"Maryland","Caroline County",2,84,107,41,66
050,24,011,"Maryland","Caroline County",2,85,562,179,383
050,24,011,"Maryland","Caroline County",3,0,429,207,222
050,24,011,"Maryland","Caroline County",3,1,406,208,198
050,24,011,"Maryland","Caroline County",3,2,406,197,209
050,24,011,"Maryland","Caroline County",3,3,425,227,198
050,24,011,"Maryland","Caroline County",3,4,418,217,201
050,24,011,"Maryland","Caroline County",3,5,413,199,214
050,24,011,"Maryland","Caroline County",3,6,430,228,202
050,24,011,"Maryland","Caroline County",3,7,431,233,198
050,24,011,"Maryland","Caroline County",3,8,427,216,211
050,24,011,"Maryland","Caroline County",3,9,447,229,218
050,24,011,"Maryland","Caroline County",3,10,470,246,224
050,24,011,"Maryland","Caroline County",3,11,426,219,207
050,24,011,"Maryland","Caroline County",3,12,441,220,221
050,24,011,"Maryland","Caroline County",3,13,478,224,254
050,24,011,"Maryland","Caroline County",3,14,492,242,250
050,24,011,"Maryland","Caroline County",3,15,469,229,240
050,24,011,"Maryland","Caroline County",3,16,454,228,226
050,24,011,"Maryland","Caroline County",3,17,463,233,230
050,24,011,"Maryland","Caroline County",3,18,385,190,195
050,24,011,"Maryland","Caroline County",3,19,337,176,161
050,24,011,"Maryland","Caroline County",3,20,354,185,169
050,24,011,"Maryland","Caroline County",3,21,343,176,167
050,24,011,"Maryland","Caroline County",3,22,356,174,182
050,24,011,"Maryland","Caroline County",3,23,357,173,184
050,24,011,"Maryland","Caroline County",3,24,362,177,185
050,24,011,"Maryland","Caroline County",3,25,380,194,186
050,24,011,"Maryland","Caroline County",3,26,388,197,191
050,24,011,"Maryland","Caroline County",3,27,371,181,190
050,24,011,"Maryland","Caroline County",3,28,393,205,188
050,24,011,"Maryland","Caroline County",3,29,408,196,212
050,24,011,"Maryland","Caroline County",3,30,435,193,242
050,24,011,"Maryland","Caroline County",3,31,490,228,262
050,24,011,"Maryland","Caroline County",3,32,433,211,222
050,24,011,"Maryland","Caroline County",3,33,450,222,228
050,24,011,"Maryland","Caroline County",3,34,430,230,200
050,24,011,"Maryland","Caroline County",3,35,424,221,203
050,24,011,"Maryland","Caroline County",3,36,413,214,199
050,24,011,"Maryland","Caroline County",3,37,414,205,209
050,24,011,"Maryland","Caroline County",3,38,427,213,214
050,24,011,"Maryland","Caroline County",3,39,414,205,209
050,24,011,"Maryland","Caroline County",3,40,398,197,201
050,24,011,"Maryland","Caroline County",3,41,404,194,210
050,24,011,"Maryland","Caroline County",3,42,375,191,184
050,24,011,"Maryland","Caroline County",3,43,407,195,212
050,24,011,"Maryland","Caroline County",3,44,415,192,223
050,24,011,"Maryland","Caroline County",3,45,353,163,190
050,24,011,"Maryland","Caroline County",3,46,377,176,201
050,24,011,"Maryland","Caroline County",3,47,368,173,195
050,24,011,"Maryland","Caroline County",3,48,388,197,191
050,24,011,"Maryland","Caroline County",3,49,418,232,186
050,24,011,"Maryland","Caroline County",3,50,455,239,216
050,24,011,"Maryland","Caroline County",3,51,441,224,217
050,24,011,"Maryland","Caroline County",3,52,415,198,217
050,24,011,"Maryland","Caroline County",3,53,446,207,239
050,24,011,"Maryland","Caroline County",3,54,434,201,233
050,24,011,"Maryland","Caroline County",3,55,470,233,237
050,24,011,"Maryland","Caroline County",3,56,479,227,252
050,24,011,"Maryland","Caroline County",3,57,493,253,240
050,24,011,"Maryland","Caroline County",3,58,510,252,258
050,24,011,"Maryland","Caroline County",3,59,529,256,273
050,24,011,"Maryland","Caroline County",3,60,511,258,253
050,24,011,"Maryland","Caroline County",3,61,497,243,254
050,24,011,"Maryland","Caroline County",3,62,481,234,247
050,24,011,"Maryland","Caroline County",3,63,473,241,232
050,24,011,"Maryland","Caroline County",3,64,481,234,247
050,24,011,"Maryland","Caroline County",3,65,426,197,229
050,24,011,"Maryland","Caroline County",3,66,410,197,213
050,24,011,"Maryland","Caroline County",3,67,394,197,197
050,24,011,"Maryland","Caroline County",3,68,357,172,185
050,24,011,"Maryland","Caroline County",3,69,326,155,171
050,24,011,"Maryland","Caroline County",3,70,309,144,165
050,24,011,"Maryland","Caroline County",3,71,295,128,167
050,24,011,"Maryland","Caroline County",3,72,319,157,162
050,24,011,"Maryland","Caroline County",3,73,291,141,150
050,24,011,"Maryland","Caroline County",3,74,330,152,178
050,24,011,"Maryland","Caroline County",3,75,228,108,120
050,24,011,"Maryland","Caroline County",3,76,232,108,124
050,24,011,"Maryland","Caroline County",3,77,219,109,110
050,24,011,"Maryland","Caroline County",3,78,195,83,112
050,24,011,"Maryland","Caroline County",3,79,168,72,96
050,24,011,"Maryland","Caroline County",3,80,162,68,94
050,24,011,"Maryland","Caroline County",3,81,142,61,81
050,24,011,"Maryland","Caroline County",3,82,131,61,70
050,24,011,"Maryland","Caroline County",3,83,121,61,60
050,24,011,"Maryland","Caroline County",3,84,115,44,71
050,24,011,"Maryland","Caroline County",3,85,552,172,380
050,24,011,"Maryland","Caroline County",4,0,435,222,213
050,24,011,"Maryland","Caroline County",4,1,430,205,225
050,24,011,"Maryland","Caroline County",4,2,411,206,205
050,24,011,"Maryland","Caroline County",4,3,419,205,214
050,24,011,"Maryland","Caroline County",4,4,418,226,192
050,24,011,"Maryland","Caroline County",4,5,414,214,200
050,24,011,"Maryland","Caroline County",4,6,409,205,204
050,24,011,"Maryland","Caroline County",4,7,448,227,221
050,24,011,"Maryland","Caroline County",4,8,427,231,196
050,24,011,"Maryland","Caroline County",4,9,421,209,212
050,24,011,"Maryland","Caroline County",4,10,456,230,226
050,24,011,"Maryland","Caroline County",4,11,456,242,214
050,24,011,"Maryland","Caroline County",4,12,440,222,218
050,24,011,"Maryland","Caroline County",4,13,463,237,226
050,24,011,"Maryland","Caroline County",4,14,474,224,250
050,24,011,"Maryland","Caroline County",4,15,493,241,252
050,24,011,"Maryland","Caroline County",4,16,478,235,243
050,24,011,"Maryland","Caroline County",4,17,441,222,219
050,24,011,"Maryland","Caroline County",4,18,388,202,186
050,24,011,"Maryland","Caroline County",4,19,321,162,159
050,24,011,"Maryland","Caroline County",4,20,353,182,171
050,24,011,"Maryland","Caroline County",4,21,343,174,169
050,24,011,"Maryland","Caroline County",4,22,335,164,171
050,24,011,"Maryland","Caroline County",4,23,364,177,187
050,24,011,"Maryland","Caroline County",4,24,369,173,196
050,24,011,"Maryland","Caroline County",4,25,350,167,183
050,24,011,"Maryland","Caroline County",4,26,355,184,171
050,24,011,"Maryland","Caroline County",4,27,394,206,188
050,24,011,"Maryland","Caroline County",4,28,371,180,191
050,24,011,"Maryland","Caroline County",4,29,406,209,197
050,24,011,"Maryland","Caroline County",4,30,415,207,208
050,24,011,"Maryland","Caroline County",4,31,440,210,230
050,24,011,"Maryland","Caroline County",4,32,484,214,270
050,24,011,"Maryland","Caroline County",4,33,436,214,222
050,24,011,"Maryland","Caroline County",4,34,454,230,224
050,24,011,"Maryland","Caroline County",4,35,432,230,202
050,24,011,"Maryland","Caroline County",4,36,441,221,220
050,24,011,"Maryland","Caroline County",4,37,405,211,194
050,24,011,"Maryland","Caroline County",4,38,423,206,217
050,24,011,"Maryland","Caroline County",4,39,443,213,230
050,24,011,"Maryland","Caroline County",4,40,417,210,207
050,24,011,"Maryland","Caroline County",4,41,409,205,204
050,24,011,"Maryland","Caroline County",4,42,409,197,212
050,24,011,"Maryland","Caroline County",4,43,355,177,178
050,24,011,"Maryland","Caroline County",4,44,407,193,214
050,24,011,"Maryland","Caroline County",4,45,407,191,216
050,24,011,"Maryland","Caroline County",4,46,381,176,205
050,24,011,"Maryland","Caroline County",4,47,357,167,190
050,24,011,"Maryland","Caroline County",4,48,375,178,197
050,24,011,"Maryland","Caroline County",4,49,407,206,201
050,24,011,"Maryland","Caroline County",4,50,417,227,190
050,24,011,"Maryland","Caroline County",4,51,453,244,209
050,24,011,"Maryland","Caroline County",4,52,440,226,214
050,24,011,"Maryland","Caroline County",4,53,405,196,209
050,24,011,"Maryland","Caroline County",4,54,442,200,242
050,24,011,"Maryland","Caroline County",4,55,436,205,231
050,24,011,"Maryland","Caroline County",4,56,473,237,236
050,24,011,"Maryland","Caroline County",4,57,477,222,255
050,24,011,"Maryland","Caroline County",4,58,497,256,241
050,24,011,"Maryland","Caroline County",4,59,502,249,253
050,24,011,"Maryland","Caroline County",4,60,536,248,288
050,24,011,"Maryland","Caroline County",4,61,497,257,240
050,24,011,"Maryland","Caroline County",4,62,493,245,248
050,24,011,"Maryland","Caroline County",4,63,478,229,249
050,24,011,"Maryland","Caroline County",4,64,469,234,235
050,24,011,"Maryland","Caroline County",4,65,471,226,245
050,24,011,"Maryland","Caroline County",4,66,410,196,214
050,24,011,"Maryland","Caroline County",4,67,403,192,211
050,24,011,"Maryland","Caroline County",4,68,384,188,196
050,24,011,"Maryland","Caroline County",4,69,337,166,171
050,24,011,"Maryland","Caroline County",4,70,324,152,172
050,24,011,"Maryland","Caroline County",4,71,295,133,162
050,24,011,"Maryland","Caroline County",4,72,288,127,161
050,24,011,"Maryland","Caroline County",4,73,293,144,149
050,24,011,"Maryland","Caroline County",4,74,278,135,143
050,24,011,"Maryland","Caroline County",4,75,313,141,172
050,24,011,"Maryland","Caroline County",4,76,224,103,121
050,24,011,"Maryland","Caroline County",4,77,218,106,112
050,24,011,"Maryland","Caroline County",4,78,197,92,105
050,24,011,"Maryland","Caroline County",4,79,178,69,109
050,24,011,"Maryland","Caroline County",4,80,154,60,94
050,24,011,"Maryland","Caroline County",4,81,141,59,82
050,24,011,"Maryland","Caroline County",4,82,139,63,76
050,24,011,"Maryland","Caroline County",4,83,113,53,60
050,24,011,"Maryland","Caroline County",4,84,118,53,65
050,24,011,"Maryland","Caroline County",4,85,555,162,393
050,24,011,"Maryland","Caroline County",5,0,432,222,210
050,24,011,"Maryland","Caroline County",5,1,431,220,211
050,24,011,"Maryland","Caroline County",5,2,445,214,231
050,24,011,"Maryland","Caroline County",5,3,414,206,208
050,24,011,"Maryland","Caroline County",5,4,420,213,207
050,24,011,"Maryland","Caroline County",5,5,418,225,193
050,24,011,"Maryland","Caroline County",5,6,410,215,195
050,24,011,"Maryland","Caroline County",5,7,398,195,203
050,24,011,"Maryland","Caroline County",5,8,464,242,222
050,24,011,"Maryland","Caroline County",5,9,422,228,194
050,24,011,"Maryland","Caroline County",5,10,423,211,212
050,24,011,"Maryland","Caroline County",5,11,471,235,236
050,24,011,"Maryland","Caroline County",5,12,464,251,213
050,24,011,"Maryland","Caroline County",5,13,451,230,221
050,24,011,"Maryland","Caroline County",5,14,476,242,234
050,24,011,"Maryland","Caroline County",5,15,477,227,250
050,24,011,"Maryland","Caroline County",5,16,485,234,251
050,24,011,"Maryland","Caroline County",5,17,474,231,243
050,24,011,"Maryland","Caroline County",5,18,385,201,184
050,24,011,"Maryland","Caroline County",5,19,326,174,152
050,24,011,"Maryland","Caroline County",5,20,362,179,183
050,24,011,"Maryland","Caroline County",5,21,368,183,185
050,24,011,"Maryland","Caroline County",5,22,360,186,174
050,24,011,"Maryland","Caroline County",5,23,339,161,178
050,24,011,"Maryland","Caroline County",5,24,354,177,177
050,24,011,"Maryland","Caroline County",5,25,375,171,204
050,24,011,"Maryland","Caroline County",5,26,359,169,190
050,24,011,"Maryland","Caroline County",5,27,366,184,182
050,24,011,"Maryland","Caroline County",5,28,395,205,190
050,24,011,"Maryland","Caroline County",5,29,358,178,180
050,24,011,"Maryland","Caroline County",5,30,412,207,205
050,24,011,"Maryland","Caroline County",5,31,428,212,216
050,24,011,"Maryland","Caroline County",5,32,418,188,230
050,24,011,"Maryland","Caroline County",5,33,489,225,264
050,24,011,"Maryland","Caroline County",5,34,449,224,225
050,24,011,"Maryland","Caroline County",5,35,456,224,232
050,24,011,"Maryland","Caroline County",5,36,459,249,210
050,24,011,"Maryland","Caroline County",5,37,445,224,221
050,24,011,"Maryland","Caroline County",5,38,425,216,209
050,24,011,"Maryland","Caroline County",5,39,430,214,216
050,24,011,"Maryland","Caroline County",5,40,439,211,228
050,24,011,"Maryland","Caroline County",5,41,427,217,210
050,24,011,"Maryland","Caroline County",5,42,413,211,202
050,24,011,"Maryland","Caroline County",5,43,409,196,213
050,24,011,"Maryland","Caroline County",5,44,369,189,180
050,24,011,"Maryland","Caroline County",5,45,398,188,210
050,24,011,"Maryland","Caroline County",5,46,431,204,227
050,24,011,"Maryland","Caroline County",5,47,345,163,182
050,24,011,"Maryland","Caroline County",5,48,353,164,189
050,24,011,"Maryland","Caroline County",5,49,371,182,189
050,24,011,"Maryland","Caroline County",5,50,411,195,216
050,24,011,"Maryland","Caroline County",5,51,424,235,189
050,24,011,"Maryland","Caroline County",5,52,447,241,206
050,24,011,"Maryland","Caroline County",5,53,453,231,222
050,24,011,"Maryland","Caroline County",5,54,410,195,215
050,24,011,"Maryland","Caroline County",5,55,442,204,238
050,24,011,"Maryland","Caroline County",5,56,439,207,232
050,24,011,"Maryland","Caroline County",5,57,469,233,236
050,24,011,"Maryland","Caroline County",5,58,477,222,255
050,24,011,"Maryland","Caroline County",5,59,485,253,232
050,24,011,"Maryland","Caroline County",5,60,494,239,255
050,24,011,"Maryland","Caroline County",5,61,521,244,277
050,24,011,"Maryland","Caroline County",5,62,484,249,235
050,24,011,"Maryland","Caroline County",5,63,484,237,247
050,24,011,"Maryland","Caroline County",5,64,470,227,243
050,24,011,"Maryland","Caroline County",5,65,455,226,229
050,24,011,"Maryland","Caroline County",5,66,467,226,241
050,24,011,"Maryland","Caroline County",5,67,406,194,212
050,24,011,"Maryland","Caroline County",5,68,403,187,216
050,24,011,"Maryland","Caroline County",5,69,372,189,183
050,24,011,"Maryland","Caroline County",5,70,332,165,167
050,24,011,"Maryland","Caroline County",5,71,311,144,167
050,24,011,"Maryland","Caroline County",5,72,290,129,161
050,24,011,"Maryland","Caroline County",5,73,261,114,147
050,24,011,"Maryland","Caroline County",5,74,286,140,146
050,24,011,"Maryland","Caroline County",5,75,264,126,138
050,24,011,"Maryland","Caroline County",5,76,312,139,173
050,24,011,"Maryland","Caroline County",5,77,215,104,111
050,24,011,"Maryland","Caroline County",5,78,202,91,111
050,24,011,"Maryland","Caroline County",5,79,178,77,101
050,24,011,"Maryland","Caroline County",5,80,170,60,110
050,24,011,"Maryland","Caroline County",5,81,139,54,85
050,24,011,"Maryland","Caroline County",5,82,138,56,82
050,24,011,"Maryland","Caroline County",5,83,127,56,71
050,24,011,"Maryland","Caroline County",5,84,110,44,66
050,24,011,"Maryland","Caroline County",5,85,557,170,387
050,24,013,"Maryland","Carroll County",1,0,1722,882,840
050,24,013,"Maryland","Carroll County",1,1,1794,933,861
050,24,013,"Maryland","Carroll County",1,2,1894,984,910
050,24,013,"Maryland","Carroll County",1,3,1971,989,982
050,24,013,"Maryland","Carroll County",1,4,2044,1067,977
050,24,013,"Maryland","Carroll County",1,5,2087,1086,1001
050,24,013,"Maryland","Carroll County",1,6,2047,1080,967
050,24,013,"Maryland","Carroll County",1,7,2044,1034,1010
050,24,013,"Maryland","Carroll County",1,8,2081,1074,1007
050,24,013,"Maryland","Carroll County",1,9,2057,1087,970
050,24,013,"Maryland","Carroll County",1,10,2097,1090,1007
050,24,013,"Maryland","Carroll County",1,11,2136,1089,1047
050,24,013,"Maryland","Carroll County",1,12,2250,1171,1079
050,24,013,"Maryland","Carroll County",1,13,2263,1152,1111
050,24,013,"Maryland","Carroll County",1,14,2264,1137,1127
050,24,013,"Maryland","Carroll County",1,15,2346,1202,1144
050,24,013,"Maryland","Carroll County",1,16,2385,1198,1187
050,24,013,"Maryland","Carroll County",1,17,2433,1209,1224
050,24,013,"Maryland","Carroll County",1,18,2285,1186,1099
050,24,013,"Maryland","Carroll County",1,19,2044,1072,972
050,24,013,"Maryland","Carroll County",1,20,2070,1086,984
050,24,013,"Maryland","Carroll County",1,21,2104,1057,1047
050,24,013,"Maryland","Carroll County",1,22,1996,1012,984
050,24,013,"Maryland","Carroll County",1,23,1849,931,918
050,24,013,"Maryland","Carroll County",1,24,1815,943,872
050,24,013,"Maryland","Carroll County",1,25,1842,929,913
050,24,013,"Maryland","Carroll County",1,26,1787,917,870
050,24,013,"Maryland","Carroll County",1,27,1821,966,855
050,24,013,"Maryland","Carroll County",1,28,1826,956,870
050,24,013,"Maryland","Carroll County",1,29,1917,955,962
050,24,013,"Maryland","Carroll County",1,30,2023,1023,1000
050,24,013,"Maryland","Carroll County",1,31,1980,1032,948
050,24,013,"Maryland","Carroll County",1,32,2024,1037,987
050,24,013,"Maryland","Carroll County",1,33,2114,1095,1019
050,24,013,"Maryland","Carroll County",1,34,2218,1136,1082
050,24,013,"Maryland","Carroll County",1,35,2273,1165,1108
050,24,013,"Maryland","Carroll County",1,36,2243,1135,1108
050,24,013,"Maryland","Carroll County",1,37,2248,1142,1106
050,24,013,"Maryland","Carroll County",1,38,2225,1121,1104
050,24,013,"Maryland","Carroll County",1,39,2194,1088,1106
050,24,013,"Maryland","Carroll County",1,40,2099,1043,1056
050,24,013,"Maryland","Carroll County",1,41,1989,986,1003
050,24,013,"Maryland","Carroll County",1,42,1963,1003,960
050,24,013,"Maryland","Carroll County",1,43,1982,1022,960
050,24,013,"Maryland","Carroll County",1,44,1874,952,922
050,24,013,"Maryland","Carroll County",1,45,1921,961,960
050,24,013,"Maryland","Carroll County",1,46,1957,956,1001
050,24,013,"Maryland","Carroll County",1,47,2048,1031,1017
050,24,013,"Maryland","Carroll County",1,48,2302,1140,1162
050,24,013,"Maryland","Carroll County",1,49,2541,1264,1277
050,24,013,"Maryland","Carroll County",1,50,2460,1232,1228
050,24,013,"Maryland","Carroll County",1,51,2612,1332,1280
050,24,013,"Maryland","Carroll County",1,52,2587,1277,1310
050,24,013,"Maryland","Carroll County",1,53,2696,1314,1382
050,24,013,"Maryland","Carroll County",1,54,2762,1368,1394
050,24,013,"Maryland","Carroll County",1,55,2872,1411,1461
050,24,013,"Maryland","Carroll County",1,56,2966,1454,1512
050,24,013,"Maryland","Carroll County",1,57,2926,1457,1469
050,24,013,"Maryland","Carroll County",1,58,2861,1480,1381
050,24,013,"Maryland","Carroll County",1,59,2772,1395,1377
050,24,013,"Maryland","Carroll County",1,60,2683,1361,1322
050,24,013,"Maryland","Carroll County",1,61,2557,1265,1292
050,24,013,"Maryland","Carroll County",1,62,2413,1229,1184
050,24,013,"Maryland","Carroll County",1,63,2273,1130,1143
050,24,013,"Maryland","Carroll County",1,64,2155,1078,1077
050,24,013,"Maryland","Carroll County",1,65,2122,1056,1066
050,24,013,"Maryland","Carroll County",1,66,2018,992,1026
050,24,013,"Maryland","Carroll County",1,67,1964,955,1009
050,24,013,"Maryland","Carroll County",1,68,1815,901,914
050,24,013,"Maryland","Carroll County",1,69,1685,819,866
050,24,013,"Maryland","Carroll County",1,70,1561,732,829
050,24,013,"Maryland","Carroll County",1,71,1605,748,857
050,24,013,"Maryland","Carroll County",1,72,1719,818,901
050,24,013,"Maryland","Carroll County",1,73,1809,859,950
050,24,013,"Maryland","Carroll County",1,74,1228,569,659
050,24,013,"Maryland","Carroll County",1,75,1204,532,672
050,24,013,"Maryland","Carroll County",1,76,1178,520,658
050,24,013,"Maryland","Carroll County",1,77,1220,544,676
050,24,013,"Maryland","Carroll County",1,78,1042,451,591
050,24,013,"Maryland","Carroll County",1,79,897,382,515
050,24,013,"Maryland","Carroll County",1,80,819,354,465
050,24,013,"Maryland","Carroll County",1,81,742,314,428
050,24,013,"Maryland","Carroll County",1,82,658,262,396
050,24,013,"Maryland","Carroll County",1,83,604,232,372
050,24,013,"Maryland","Carroll County",1,84,559,226,333
050,24,013,"Maryland","Carroll County",1,85,3362,1183,2179
050,24,013,"Maryland","Carroll County",2,0,1764,908,856
050,24,013,"Maryland","Carroll County",2,1,1789,930,859
050,24,013,"Maryland","Carroll County",2,2,1891,981,910
050,24,013,"Maryland","Carroll County",2,3,1954,993,961
050,24,013,"Maryland","Carroll County",2,4,2050,1061,989
050,24,013,"Maryland","Carroll County",2,5,2088,1086,1002
050,24,013,"Maryland","Carroll County",2,6,2075,1090,985
050,24,013,"Maryland","Carroll County",2,7,2058,1054,1004
050,24,013,"Maryland","Carroll County",2,8,2076,1068,1008
050,24,013,"Maryland","Carroll County",2,9,2072,1089,983
050,24,013,"Maryland","Carroll County",2,10,2094,1090,1004
050,24,013,"Maryland","Carroll County",2,11,2131,1091,1040
050,24,013,"Maryland","Carroll County",2,12,2242,1160,1082
050,24,013,"Maryland","Carroll County",2,13,2258,1156,1102
050,24,013,"Maryland","Carroll County",2,14,2266,1142,1124
050,24,013,"Maryland","Carroll County",2,15,2330,1191,1139
050,24,013,"Maryland","Carroll County",2,16,2388,1209,1179
050,24,013,"Maryland","Carroll County",2,17,2425,1208,1217
050,24,013,"Maryland","Carroll County",2,18,2267,1169,1098
050,24,013,"Maryland","Carroll County",2,19,2039,1063,976
050,24,013,"Maryland","Carroll County",2,20,2094,1096,998
050,24,013,"Maryland","Carroll County",2,21,2100,1062,1038
050,24,013,"Maryland","Carroll County",2,22,1988,1010,978
050,24,013,"Maryland","Carroll County",2,23,1860,940,920
050,24,013,"Maryland","Carroll County",2,24,1812,936,876
050,24,013,"Maryland","Carroll County",2,25,1820,921,899
050,24,013,"Maryland","Carroll County",2,26,1793,920,873
050,24,013,"Maryland","Carroll County",2,27,1809,954,855
050,24,013,"Maryland","Carroll County",2,28,1837,966,871
050,24,013,"Maryland","Carroll County",2,29,1903,959,944
050,24,013,"Maryland","Carroll County",2,30,2024,1019,1005
050,24,013,"Maryland","Carroll County",2,31,2007,1038,969
050,24,013,"Maryland","Carroll County",2,32,2025,1041,984
050,24,013,"Maryland","Carroll County",2,33,2102,1086,1016
050,24,013,"Maryland","Carroll County",2,34,2211,1134,1077
050,24,013,"Maryland","Carroll County",2,35,2288,1173,1115
050,24,013,"Maryland","Carroll County",2,36,2258,1148,1110
050,24,013,"Maryland","Carroll County",2,37,2260,1146,1114
050,24,013,"Maryland","Carroll County",2,38,2251,1134,1117
050,24,013,"Maryland","Carroll County",2,39,2203,1095,1108
050,24,013,"Maryland","Carroll County",2,40,2150,1066,1084
050,24,013,"Maryland","Carroll County",2,41,2028,1006,1022
050,24,013,"Maryland","Carroll County",2,42,1967,996,971
050,24,013,"Maryland","Carroll County",2,43,1997,1027,970
050,24,013,"Maryland","Carroll County",2,44,1888,965,923
050,24,013,"Maryland","Carroll County",2,45,1920,966,954
050,24,013,"Maryland","Carroll County",2,46,1943,958,985
050,24,013,"Maryland","Carroll County",2,47,2022,1012,1010
050,24,013,"Maryland","Carroll County",2,48,2233,1112,1121
050,24,013,"Maryland","Carroll County",2,49,2495,1242,1253
050,24,013,"Maryland","Carroll County",2,50,2476,1237,1239
050,24,013,"Maryland","Carroll County",2,51,2568,1307,1261
050,24,013,"Maryland","Carroll County",2,52,2570,1280,1290
050,24,013,"Maryland","Carroll County",2,53,2661,1300,1361
050,24,013,"Maryland","Carroll County",2,54,2728,1345,1383
050,24,013,"Maryland","Carroll County",2,55,2832,1391,1441
050,24,013,"Maryland","Carroll County",2,56,2947,1442,1505
050,24,013,"Maryland","Carroll County",2,57,2927,1453,1474
050,24,013,"Maryland","Carroll County",2,58,2855,1461,1394
050,24,013,"Maryland","Carroll County",2,59,2790,1415,1375
050,24,013,"Maryland","Carroll County",2,60,2683,1361,1322
050,24,013,"Maryland","Carroll County",2,61,2555,1274,1281
050,24,013,"Maryland","Carroll County",2,62,2438,1230,1208
050,24,013,"Maryland","Carroll County",2,63,2309,1156,1153
050,24,013,"Maryland","Carroll County",2,64,2157,1074,1083
050,24,013,"Maryland","Carroll County",2,65,2109,1049,1060
050,24,013,"Maryland","Carroll County",2,66,2040,1004,1036
050,24,013,"Maryland","Carroll County",2,67,1962,956,1006
050,24,013,"Maryland","Carroll County",2,68,1828,901,927
050,24,013,"Maryland","Carroll County",2,69,1719,838,881
050,24,013,"Maryland","Carroll County",2,70,1562,739,823
050,24,013,"Maryland","Carroll County",2,71,1586,739,847
050,24,013,"Maryland","Carroll County",2,72,1645,778,867
050,24,013,"Maryland","Carroll County",2,73,1866,886,980
050,24,013,"Maryland","Carroll County",2,74,1272,589,683
050,24,013,"Maryland","Carroll County",2,75,1205,537,668
050,24,013,"Maryland","Carroll County",2,76,1161,513,648
050,24,013,"Maryland","Carroll County",2,77,1226,542,684
050,24,013,"Maryland","Carroll County",2,78,1060,461,599
050,24,013,"Maryland","Carroll County",2,79,917,389,528
050,24,013,"Maryland","Carroll County",2,80,824,361,463
050,24,013,"Maryland","Carroll County",2,81,747,321,426
050,24,013,"Maryland","Carroll County",2,82,673,271,402
050,24,013,"Maryland","Carroll County",2,83,600,231,369
050,24,013,"Maryland","Carroll County",2,84,562,225,337
050,24,013,"Maryland","Carroll County",2,85,3336,1185,2151
050,24,013,"Maryland","Carroll County",3,0,1713,879,834
050,24,013,"Maryland","Carroll County",3,1,1889,971,918
050,24,013,"Maryland","Carroll County",3,2,1877,982,895
050,24,013,"Maryland","Carroll County",3,3,1971,1027,944
050,24,013,"Maryland","Carroll County",3,4,2075,1055,1020
050,24,013,"Maryland","Carroll County",3,5,2128,1097,1031
050,24,013,"Maryland","Carroll County",3,6,2174,1134,1040
050,24,013,"Maryland","Carroll County",3,7,2146,1139,1007
050,24,013,"Maryland","Carroll County",3,8,2113,1071,1042
050,24,013,"Maryland","Carroll County",3,9,2104,1083,1021
050,24,013,"Maryland","Carroll County",3,10,2109,1090,1019
050,24,013,"Maryland","Carroll County",3,11,2101,1094,1007
050,24,013,"Maryland","Carroll County",3,12,2179,1115,1064
050,24,013,"Maryland","Carroll County",3,13,2300,1181,1119
050,24,013,"Maryland","Carroll County",3,14,2288,1172,1116
050,24,013,"Maryland","Carroll County",3,15,2300,1171,1129
050,24,013,"Maryland","Carroll County",3,16,2350,1215,1135
050,24,013,"Maryland","Carroll County",3,17,2418,1222,1196
050,24,013,"Maryland","Carroll County",3,18,2278,1168,1110
050,24,013,"Maryland","Carroll County",3,19,1994,1021,973
050,24,013,"Maryland","Carroll County",3,20,2135,1098,1037
050,24,013,"Maryland","Carroll County",3,21,2154,1098,1056
050,24,013,"Maryland","Carroll County",3,22,1999,1031,968
050,24,013,"Maryland","Carroll County",3,23,1884,963,921
050,24,013,"Maryland","Carroll County",3,24,1827,948,879
050,24,013,"Maryland","Carroll County",3,25,1737,920,817
050,24,013,"Maryland","Carroll County",3,26,1826,922,904
050,24,013,"Maryland","Carroll County",3,27,1790,903,887
050,24,013,"Maryland","Carroll County",3,28,1792,938,854
050,24,013,"Maryland","Carroll County",3,29,1934,1007,927
050,24,013,"Maryland","Carroll County",3,30,1970,992,978
050,24,013,"Maryland","Carroll County",3,31,2090,1044,1046
050,24,013,"Maryland","Carroll County",3,32,2162,1128,1034
050,24,013,"Maryland","Carroll County",3,33,2133,1097,1036
050,24,013,"Maryland","Carroll County",3,34,2220,1130,1090
050,24,013,"Maryland","Carroll County",3,35,2287,1178,1109
050,24,013,"Maryland","Carroll County",3,36,2374,1238,1136
050,24,013,"Maryland","Carroll County",3,37,2312,1184,1128
050,24,013,"Maryland","Carroll County",3,38,2311,1178,1133
050,24,013,"Maryland","Carroll County",3,39,2324,1170,1154
050,24,013,"Maryland","Carroll County",3,40,2265,1136,1129
050,24,013,"Maryland","Carroll County",3,41,2211,1105,1106
050,24,013,"Maryland","Carroll County",3,42,2060,1016,1044
050,24,013,"Maryland","Carroll County",3,43,2010,1018,992
050,24,013,"Maryland","Carroll County",3,44,2039,1048,991
050,24,013,"Maryland","Carroll County",3,45,1931,988,943
050,24,013,"Maryland","Carroll County",3,46,1938,987,951
050,24,013,"Maryland","Carroll County",3,47,1934,948,986
050,24,013,"Maryland","Carroll County",3,48,2019,1007,1012
050,24,013,"Maryland","Carroll County",3,49,2269,1130,1139
050,24,013,"Maryland","Carroll County",3,50,2457,1219,1238
050,24,013,"Maryland","Carroll County",3,51,2490,1260,1230
050,24,013,"Maryland","Carroll County",3,52,2545,1295,1250
050,24,013,"Maryland","Carroll County",3,53,2541,1267,1274
050,24,013,"Maryland","Carroll County",3,54,2621,1287,1334
050,24,013,"Maryland","Carroll County",3,55,2688,1329,1359
050,24,013,"Maryland","Carroll County",3,56,2806,1383,1423
050,24,013,"Maryland","Carroll County",3,57,2914,1418,1496
050,24,013,"Maryland","Carroll County",3,58,2881,1449,1432
050,24,013,"Maryland","Carroll County",3,59,2782,1415,1367
050,24,013,"Maryland","Carroll County",3,60,2739,1386,1353
050,24,013,"Maryland","Carroll County",3,61,2635,1327,1308
050,24,013,"Maryland","Carroll County",3,62,2495,1226,1269
050,24,013,"Maryland","Carroll County",3,63,2369,1190,1179
050,24,013,"Maryland","Carroll County",3,64,2274,1131,1143
050,24,013,"Maryland","Carroll County",3,65,2106,1043,1063
050,24,013,"Maryland","Carroll County",3,66,2076,1024,1052
050,24,013,"Maryland","Carroll County",3,67,2021,990,1031
050,24,013,"Maryland","Carroll County",3,68,1909,931,978
050,24,013,"Maryland","Carroll County",3,69,1770,873,897
050,24,013,"Maryland","Carroll County",3,70,1651,799,852
050,24,013,"Maryland","Carroll County",3,71,1537,719,818
050,24,013,"Maryland","Carroll County",3,72,1559,723,836
050,24,013,"Maryland","Carroll County",3,73,1636,777,859
050,24,013,"Maryland","Carroll County",3,74,1787,838,949
050,24,013,"Maryland","Carroll County",3,75,1227,563,664
050,24,013,"Maryland","Carroll County",3,76,1177,520,657
050,24,013,"Maryland","Carroll County",3,77,1081,467,614
050,24,013,"Maryland","Carroll County",3,78,1183,519,664
050,24,013,"Maryland","Carroll County",3,79,1001,429,572
050,24,013,"Maryland","Carroll County",3,80,871,367,504
050,24,013,"Maryland","Carroll County",3,81,809,350,459
050,24,013,"Maryland","Carroll County",3,82,714,298,416
050,24,013,"Maryland","Carroll County",3,83,647,245,402
050,24,013,"Maryland","Carroll County",3,84,563,213,350
050,24,013,"Maryland","Carroll County",3,85,3307,1181,2126
050,24,013,"Maryland","Carroll County",4,0,1802,906,896
050,24,013,"Maryland","Carroll County",4,1,1817,928,889
050,24,013,"Maryland","Carroll County",4,2,1971,1015,956
050,24,013,"Maryland","Carroll County",4,3,1997,1043,954
050,24,013,"Maryland","Carroll County",4,4,2047,1068,979
050,24,013,"Maryland","Carroll County",4,5,2132,1086,1046
050,24,013,"Maryland","Carroll County",4,6,2224,1156,1068
050,24,013,"Maryland","Carroll County",4,7,2247,1161,1086
050,24,013,"Maryland","Carroll County",4,8,2233,1196,1037
050,24,013,"Maryland","Carroll County",4,9,2160,1091,1069
050,24,013,"Maryland","Carroll County",4,10,2153,1108,1045
050,24,013,"Maryland","Carroll County",4,11,2190,1139,1051
050,24,013,"Maryland","Carroll County",4,12,2168,1133,1035
050,24,013,"Maryland","Carroll County",4,13,2227,1125,1102
050,24,013,"Maryland","Carroll County",4,14,2327,1184,1143
050,24,013,"Maryland","Carroll County",4,15,2332,1180,1152
050,24,013,"Maryland","Carroll County",4,16,2316,1177,1139
050,24,013,"Maryland","Carroll County",4,17,2382,1232,1150
050,24,013,"Maryland","Carroll County",4,18,2251,1159,1092
050,24,013,"Maryland","Carroll County",4,19,1954,990,964
050,24,013,"Maryland","Carroll County",4,20,2023,1047,976
050,24,013,"Maryland","Carroll County",4,21,2166,1075,1091
050,24,013,"Maryland","Carroll County",4,22,2066,1065,1001
050,24,013,"Maryland","Carroll County",4,23,1927,999,928
050,24,013,"Maryland","Carroll County",4,24,1836,945,891
050,24,013,"Maryland","Carroll County",4,25,1755,923,832
050,24,013,"Maryland","Carroll County",4,26,1701,920,781
050,24,013,"Maryland","Carroll County",4,27,1792,893,899
050,24,013,"Maryland","Carroll County",4,28,1833,912,921
050,24,013,"Maryland","Carroll County",4,29,1853,959,894
050,24,013,"Maryland","Carroll County",4,30,1980,1054,926
050,24,013,"Maryland","Carroll County",4,31,2044,1021,1023
050,24,013,"Maryland","Carroll County",4,32,2195,1081,1114
050,24,013,"Maryland","Carroll County",4,33,2239,1161,1078
050,24,013,"Maryland","Carroll County",4,34,2271,1164,1107
050,24,013,"Maryland","Carroll County",4,35,2297,1160,1137
050,24,013,"Maryland","Carroll County",4,36,2411,1239,1172
050,24,013,"Maryland","Carroll County",4,37,2430,1274,1156
050,24,013,"Maryland","Carroll County",4,38,2391,1227,1164
050,24,013,"Maryland","Carroll County",4,39,2354,1211,1143
050,24,013,"Maryland","Carroll County",4,40,2405,1212,1193
050,24,013,"Maryland","Carroll County",4,41,2267,1129,1138
050,24,013,"Maryland","Carroll County",4,42,2234,1125,1109
050,24,013,"Maryland","Carroll County",4,43,2124,1052,1072
050,24,013,"Maryland","Carroll County",4,44,2050,1027,1023
050,24,013,"Maryland","Carroll County",4,45,2059,1067,992
050,24,013,"Maryland","Carroll County",4,46,1980,1026,954
050,24,013,"Maryland","Carroll County",4,47,1955,980,975
050,24,013,"Maryland","Carroll County",4,48,1943,939,1004
050,24,013,"Maryland","Carroll County",4,49,2044,1027,1017
050,24,013,"Maryland","Carroll County",4,50,2248,1117,1131
050,24,013,"Maryland","Carroll County",4,51,2468,1247,1221
050,24,013,"Maryland","Carroll County",4,52,2452,1249,1203
050,24,013,"Maryland","Carroll County",4,53,2526,1276,1250
050,24,013,"Maryland","Carroll County",4,54,2504,1250,1254
050,24,013,"Maryland","Carroll County",4,55,2583,1270,1313
050,24,013,"Maryland","Carroll County",4,56,2661,1313,1348
050,24,013,"Maryland","Carroll County",4,57,2737,1358,1379
050,24,013,"Maryland","Carroll County",4,58,2863,1385,1478
050,24,013,"Maryland","Carroll County",4,59,2842,1426,1416
050,24,013,"Maryland","Carroll County",4,60,2699,1369,1330
050,24,013,"Maryland","Carroll County",4,61,2674,1361,1313
050,24,013,"Maryland","Carroll County",4,62,2565,1276,1289
050,24,013,"Maryland","Carroll County",4,63,2397,1169,1228
050,24,013,"Maryland","Carroll County",4,64,2325,1163,1162
050,24,013,"Maryland","Carroll County",4,65,2196,1099,1097
050,24,013,"Maryland","Carroll County",4,66,2057,1012,1045
050,24,013,"Maryland","Carroll County",4,67,2026,987,1039
050,24,013,"Maryland","Carroll County",4,68,1961,946,1015
050,24,013,"Maryland","Carroll County",4,69,1842,893,949
050,24,013,"Maryland","Carroll County",4,70,1702,841,861
050,24,013,"Maryland","Carroll County",4,71,1627,771,856
050,24,013,"Maryland","Carroll County",4,72,1508,711,797
050,24,013,"Maryland","Carroll County",4,73,1554,718,836
050,24,013,"Maryland","Carroll County",4,74,1555,723,832
050,24,013,"Maryland","Carroll County",4,75,1719,806,913
050,24,013,"Maryland","Carroll County",4,76,1187,540,647
050,24,013,"Maryland","Carroll County",4,77,1117,483,634
050,24,013,"Maryland","Carroll County",4,78,1047,450,597
050,24,013,"Maryland","Carroll County",4,79,1111,467,644
050,24,013,"Maryland","Carroll County",4,80,952,410,542
050,24,013,"Maryland","Carroll County",4,81,854,357,497
050,24,013,"Maryland","Carroll County",4,82,778,329,449
050,24,013,"Maryland","Carroll County",4,83,689,269,420
050,24,013,"Maryland","Carroll County",4,84,606,221,385
050,24,013,"Maryland","Carroll County",4,85,3285,1157,2128
050,24,013,"Maryland","Carroll County",5,0,1788,898,890
050,24,013,"Maryland","Carroll County",5,1,1857,945,912
050,24,013,"Maryland","Carroll County",5,2,1925,992,933
050,24,013,"Maryland","Carroll County",5,3,2031,1039,992
050,24,013,"Maryland","Carroll County",5,4,2080,1082,998
050,24,013,"Maryland","Carroll County",5,5,2139,1108,1031
050,24,013,"Maryland","Carroll County",5,6,2176,1106,1070
050,24,013,"Maryland","Carroll County",5,7,2277,1181,1096
050,24,013,"Maryland","Carroll County",5,8,2288,1173,1115
050,24,013,"Maryland","Carroll County",5,9,2291,1230,1061
050,24,013,"Maryland","Carroll County",5,10,2232,1123,1109
050,24,013,"Maryland","Carroll County",5,11,2223,1129,1094
050,24,013,"Maryland","Carroll County",5,12,2265,1175,1090
050,24,013,"Maryland","Carroll County",5,13,2206,1150,1056
050,24,013,"Maryland","Carroll County",5,14,2290,1139,1151
050,24,013,"Maryland","Carroll County",5,15,2374,1230,1144
050,24,013,"Maryland","Carroll County",5,16,2372,1194,1178
050,24,013,"Maryland","Carroll County",5,17,2363,1204,1159
050,24,013,"Maryland","Carroll County",5,18,2210,1172,1038
050,24,013,"Maryland","Carroll County",5,19,1948,983,965
050,24,013,"Maryland","Carroll County",5,20,2023,1008,1015
050,24,013,"Maryland","Carroll County",5,21,2087,1052,1035
050,24,013,"Maryland","Carroll County",5,22,2071,1042,1029
050,24,013,"Maryland","Carroll County",5,23,1942,1037,905
050,24,013,"Maryland","Carroll County",5,24,1849,977,872
050,24,013,"Maryland","Carroll County",5,25,1737,894,843
050,24,013,"Maryland","Carroll County",5,26,1718,894,824
050,24,013,"Maryland","Carroll County",5,27,1686,913,773
050,24,013,"Maryland","Carroll County",5,28,1782,893,889
050,24,013,"Maryland","Carroll County",5,29,1854,927,927
050,24,013,"Maryland","Carroll County",5,30,1915,978,937
050,24,013,"Maryland","Carroll County",5,31,2043,1060,983
050,24,013,"Maryland","Carroll County",5,32,2137,1059,1078
050,24,013,"Maryland","Carroll County",5,33,2270,1117,1153
050,24,013,"Maryland","Carroll County",5,34,2328,1183,1145
050,24,013,"Maryland","Carroll County",5,35,2340,1177,1163
050,24,013,"Maryland","Carroll County",5,36,2435,1238,1197
050,24,013,"Maryland","Carroll County",5,37,2478,1262,1216
050,24,013,"Maryland","Carroll County",5,38,2522,1317,1205
050,24,013,"Maryland","Carroll County",5,39,2447,1256,1191
050,24,013,"Maryland","Carroll County",5,40,2414,1256,1158
050,24,013,"Maryland","Carroll County",5,41,2449,1234,1215
050,24,013,"Maryland","Carroll County",5,42,2282,1132,1150
050,24,013,"Maryland","Carroll County",5,43,2273,1148,1125
050,24,013,"Maryland","Carroll County",5,44,2160,1075,1085
050,24,013,"Maryland","Carroll County",5,45,2091,1040,1051
050,24,013,"Maryland","Carroll County",5,46,2098,1093,1005
050,24,013,"Maryland","Carroll County",5,47,1994,1032,962
050,24,013,"Maryland","Carroll County",5,48,1968,991,977
050,24,013,"Maryland","Carroll County",5,49,1980,951,1029
050,24,013,"Maryland","Carroll County",5,50,2041,1020,1021
050,24,013,"Maryland","Carroll County",5,51,2252,1136,1116
050,24,013,"Maryland","Carroll County",5,52,2424,1227,1197
050,24,013,"Maryland","Carroll County",5,53,2453,1235,1218
050,24,013,"Maryland","Carroll County",5,54,2486,1264,1222
050,24,013,"Maryland","Carroll County",5,55,2467,1230,1237
050,24,013,"Maryland","Carroll County",5,56,2514,1237,1277
050,24,013,"Maryland","Carroll County",5,57,2636,1301,1335
050,24,013,"Maryland","Carroll County",5,58,2693,1334,1359
050,24,013,"Maryland","Carroll County",5,59,2803,1359,1444
050,24,013,"Maryland","Carroll County",5,60,2770,1386,1384
050,24,013,"Maryland","Carroll County",5,61,2656,1353,1303
050,24,013,"Maryland","Carroll County",5,62,2607,1329,1278
050,24,013,"Maryland","Carroll County",5,63,2470,1223,1247
050,24,013,"Maryland","Carroll County",5,64,2349,1140,1209
050,24,013,"Maryland","Carroll County",5,65,2291,1125,1166
050,24,013,"Maryland","Carroll County",5,66,2160,1060,1100
050,24,013,"Maryland","Carroll County",5,67,2017,978,1039
050,24,013,"Maryland","Carroll County",5,68,1984,967,1017
050,24,013,"Maryland","Carroll County",5,69,1906,914,992
050,24,013,"Maryland","Carroll County",5,70,1786,862,924
050,24,013,"Maryland","Carroll County",5,71,1665,814,851
050,24,013,"Maryland","Carroll County",5,72,1587,758,829
050,24,013,"Maryland","Carroll County",5,73,1496,704,792
050,24,013,"Maryland","Carroll County",5,74,1489,685,804
050,24,013,"Maryland","Carroll County",5,75,1519,698,821
050,24,013,"Maryland","Carroll County",5,76,1677,789,888
050,24,013,"Maryland","Carroll County",5,77,1133,507,626
050,24,013,"Maryland","Carroll County",5,78,1091,467,624
050,24,013,"Maryland","Carroll County",5,79,994,412,582
050,24,013,"Maryland","Carroll County",5,80,1056,446,610
050,24,013,"Maryland","Carroll County",5,81,931,401,530
050,24,013,"Maryland","Carroll County",5,82,805,326,479
050,24,013,"Maryland","Carroll County",5,83,759,308,451
050,24,013,"Maryland","Carroll County",5,84,650,250,400
050,24,013,"Maryland","Carroll County",5,85,3314,1157,2157
050,24,015,"Maryland","Cecil County",1,0,1158,592,566
050,24,015,"Maryland","Cecil County",1,1,1159,592,567
050,24,015,"Maryland","Cecil County",1,2,1190,610,580
050,24,015,"Maryland","Cecil County",1,3,1182,626,556
050,24,015,"Maryland","Cecil County",1,4,1194,623,571
050,24,015,"Maryland","Cecil County",1,5,1169,583,586
050,24,015,"Maryland","Cecil County",1,6,1205,606,599
050,24,015,"Maryland","Cecil County",1,7,1223,616,607
050,24,015,"Maryland","Cecil County",1,8,1275,628,647
050,24,015,"Maryland","Cecil County",1,9,1297,679,618
050,24,015,"Maryland","Cecil County",1,10,1368,718,650
050,24,015,"Maryland","Cecil County",1,11,1421,725,696
050,24,015,"Maryland","Cecil County",1,12,1470,759,711
050,24,015,"Maryland","Cecil County",1,13,1419,767,652
050,24,015,"Maryland","Cecil County",1,14,1417,718,699
050,24,015,"Maryland","Cecil County",1,15,1462,758,704
050,24,015,"Maryland","Cecil County",1,16,1411,700,711
050,24,015,"Maryland","Cecil County",1,17,1470,753,717
050,24,015,"Maryland","Cecil County",1,18,1261,668,593
050,24,015,"Maryland","Cecil County",1,19,997,511,486
050,24,015,"Maryland","Cecil County",1,20,1109,600,509
050,24,015,"Maryland","Cecil County",1,21,1134,576,558
050,24,015,"Maryland","Cecil County",1,22,1134,582,552
050,24,015,"Maryland","Cecil County",1,23,1189,601,588
050,24,015,"Maryland","Cecil County",1,24,1187,594,593
050,24,015,"Maryland","Cecil County",1,25,1179,610,569
050,24,015,"Maryland","Cecil County",1,26,1314,652,662
050,24,015,"Maryland","Cecil County",1,27,1304,640,664
050,24,015,"Maryland","Cecil County",1,28,1327,637,690
050,24,015,"Maryland","Cecil County",1,29,1384,691,693
050,24,015,"Maryland","Cecil County",1,30,1400,706,694
050,24,015,"Maryland","Cecil County",1,31,1359,680,679
050,24,015,"Maryland","Cecil County",1,32,1318,654,664
050,24,015,"Maryland","Cecil County",1,33,1326,670,656
050,24,015,"Maryland","Cecil County",1,34,1331,672,659
050,24,015,"Maryland","Cecil County",1,35,1271,639,632
050,24,015,"Maryland","Cecil County",1,36,1206,596,610
050,24,015,"Maryland","Cecil County",1,37,1250,615,635
050,24,015,"Maryland","Cecil County",1,38,1219,616,603
050,24,015,"Maryland","Cecil County",1,39,1266,639,627
050,24,015,"Maryland","Cecil County",1,40,1245,614,631
050,24,015,"Maryland","Cecil County",1,41,1251,609,642
050,24,015,"Maryland","Cecil County",1,42,1244,611,633
050,24,015,"Maryland","Cecil County",1,43,1197,588,609
050,24,015,"Maryland","Cecil County",1,44,1190,567,623
050,24,015,"Maryland","Cecil County",1,45,1195,589,606
050,24,015,"Maryland","Cecil County",1,46,1189,601,588
050,24,015,"Maryland","Cecil County",1,47,1242,624,618
050,24,015,"Maryland","Cecil County",1,48,1390,671,719
050,24,015,"Maryland","Cecil County",1,49,1504,727,777
050,24,015,"Maryland","Cecil County",1,50,1504,740,764
050,24,015,"Maryland","Cecil County",1,51,1517,775,742
050,24,015,"Maryland","Cecil County",1,52,1444,710,734
050,24,015,"Maryland","Cecil County",1,53,1547,769,778
050,24,015,"Maryland","Cecil County",1,54,1633,823,810
050,24,015,"Maryland","Cecil County",1,55,1672,852,820
050,24,015,"Maryland","Cecil County",1,56,1671,830,841
050,24,015,"Maryland","Cecil County",1,57,1691,852,839
050,24,015,"Maryland","Cecil County",1,58,1667,848,819
050,24,015,"Maryland","Cecil County",1,59,1582,824,758
050,24,015,"Maryland","Cecil County",1,60,1569,796,773
050,24,015,"Maryland","Cecil County",1,61,1582,784,798
050,24,015,"Maryland","Cecil County",1,62,1508,766,742
050,24,015,"Maryland","Cecil County",1,63,1416,709,707
050,24,015,"Maryland","Cecil County",1,64,1379,680,699
050,24,015,"Maryland","Cecil County",1,65,1312,658,654
050,24,015,"Maryland","Cecil County",1,66,1241,594,647
050,24,015,"Maryland","Cecil County",1,67,1195,582,613
050,24,015,"Maryland","Cecil County",1,68,1096,530,566
050,24,015,"Maryland","Cecil County",1,69,1045,496,549
050,24,015,"Maryland","Cecil County",1,70,1001,491,510
050,24,015,"Maryland","Cecil County",1,71,968,466,502
050,24,015,"Maryland","Cecil County",1,72,993,498,495
050,24,015,"Maryland","Cecil County",1,73,1057,505,552
050,24,015,"Maryland","Cecil County",1,74,682,332,350
050,24,015,"Maryland","Cecil County",1,75,649,303,346
050,24,015,"Maryland","Cecil County",1,76,633,305,328
050,24,015,"Maryland","Cecil County",1,77,653,317,336
050,24,015,"Maryland","Cecil County",1,78,530,248,282
050,24,015,"Maryland","Cecil County",1,79,473,234,239
050,24,015,"Maryland","Cecil County",1,80,418,196,222
050,24,015,"Maryland","Cecil County",1,81,370,168,202
050,24,015,"Maryland","Cecil County",1,82,342,158,184
050,24,015,"Maryland","Cecil County",1,83,288,129,159
050,24,015,"Maryland","Cecil County",1,84,282,122,160
050,24,015,"Maryland","Cecil County",1,85,1512,572,940
050,24,015,"Maryland","Cecil County",2,0,1148,581,567
050,24,015,"Maryland","Cecil County",2,1,1156,589,567
050,24,015,"Maryland","Cecil County",2,2,1184,605,579
050,24,015,"Maryland","Cecil County",2,3,1180,622,558
050,24,015,"Maryland","Cecil County",2,4,1197,629,568
050,24,015,"Maryland","Cecil County",2,5,1181,595,586
050,24,015,"Maryland","Cecil County",2,6,1199,602,597
050,24,015,"Maryland","Cecil County",2,7,1219,614,605
050,24,015,"Maryland","Cecil County",2,8,1259,623,636
050,24,015,"Maryland","Cecil County",2,9,1299,671,628
050,24,015,"Maryland","Cecil County",2,10,1352,706,646
050,24,015,"Maryland","Cecil County",2,11,1405,723,682
050,24,015,"Maryland","Cecil County",2,12,1465,758,707
050,24,015,"Maryland","Cecil County",2,13,1438,768,670
050,24,015,"Maryland","Cecil County",2,14,1420,730,690
050,24,015,"Maryland","Cecil County",2,15,1455,751,704
050,24,015,"Maryland","Cecil County",2,16,1432,717,715
050,24,015,"Maryland","Cecil County",2,17,1455,740,715
050,24,015,"Maryland","Cecil County",2,18,1247,658,589
050,24,015,"Maryland","Cecil County",2,19,1006,522,484
050,24,015,"Maryland","Cecil County",2,20,1113,594,519
050,24,015,"Maryland","Cecil County",2,21,1138,585,553
050,24,015,"Maryland","Cecil County",2,22,1157,591,566
050,24,015,"Maryland","Cecil County",2,23,1189,603,586
050,24,015,"Maryland","Cecil County",2,24,1185,600,585
050,24,015,"Maryland","Cecil County",2,25,1187,609,578
050,24,015,"Maryland","Cecil County",2,26,1286,646,640
050,24,015,"Maryland","Cecil County",2,27,1311,641,670
050,24,015,"Maryland","Cecil County",2,28,1331,645,686
050,24,015,"Maryland","Cecil County",2,29,1371,679,692
050,24,015,"Maryland","Cecil County",2,30,1402,704,698
050,24,015,"Maryland","Cecil County",2,31,1369,685,684
050,24,015,"Maryland","Cecil County",2,32,1333,663,670
050,24,015,"Maryland","Cecil County",2,33,1329,667,662
050,24,015,"Maryland","Cecil County",2,34,1338,676,662
050,24,015,"Maryland","Cecil County",2,35,1291,649,642
050,24,015,"Maryland","Cecil County",2,36,1217,604,613
050,24,015,"Maryland","Cecil County",2,37,1244,614,630
050,24,015,"Maryland","Cecil County",2,38,1233,623,610
050,24,015,"Maryland","Cecil County",2,39,1251,631,620
050,24,015,"Maryland","Cecil County",2,40,1258,623,635
050,24,015,"Maryland","Cecil County",2,41,1248,610,638
050,24,015,"Maryland","Cecil County",2,42,1243,611,632
050,24,015,"Maryland","Cecil County",2,43,1222,598,624
050,24,015,"Maryland","Cecil County",2,44,1189,573,616
050,24,015,"Maryland","Cecil County",2,45,1203,587,616
050,24,015,"Maryland","Cecil County",2,46,1189,597,592
050,24,015,"Maryland","Cecil County",2,47,1229,620,609
050,24,015,"Maryland","Cecil County",2,48,1354,659,695
050,24,015,"Maryland","Cecil County",2,49,1486,718,768
050,24,015,"Maryland","Cecil County",2,50,1509,739,770
050,24,015,"Maryland","Cecil County",2,51,1503,761,742
050,24,015,"Maryland","Cecil County",2,52,1459,727,732
050,24,015,"Maryland","Cecil County",2,53,1519,750,769
050,24,015,"Maryland","Cecil County",2,54,1609,808,801
050,24,015,"Maryland","Cecil County",2,55,1659,840,819
050,24,015,"Maryland","Cecil County",2,56,1675,839,836
050,24,015,"Maryland","Cecil County",2,57,1689,845,844
050,24,015,"Maryland","Cecil County",2,58,1668,845,823
050,24,015,"Maryland","Cecil County",2,59,1610,835,775
050,24,015,"Maryland","Cecil County",2,60,1568,795,773
050,24,015,"Maryland","Cecil County",2,61,1571,780,791
050,24,015,"Maryland","Cecil County",2,62,1514,765,749
050,24,015,"Maryland","Cecil County",2,63,1445,723,722
050,24,015,"Maryland","Cecil County",2,64,1375,678,697
050,24,015,"Maryland","Cecil County",2,65,1315,656,659
050,24,015,"Maryland","Cecil County",2,66,1257,607,650
050,24,015,"Maryland","Cecil County",2,67,1193,578,615
050,24,015,"Maryland","Cecil County",2,68,1102,536,566
050,24,015,"Maryland","Cecil County",2,69,1061,506,555
050,24,015,"Maryland","Cecil County",2,70,999,488,511
050,24,015,"Maryland","Cecil County",2,71,968,466,502
050,24,015,"Maryland","Cecil County",2,72,962,476,486
050,24,015,"Maryland","Cecil County",2,73,1082,523,559
050,24,015,"Maryland","Cecil County",2,74,719,346,373
050,24,015,"Maryland","Cecil County",2,75,654,305,349
050,24,015,"Maryland","Cecil County",2,76,622,301,321
050,24,015,"Maryland","Cecil County",2,77,660,319,341
050,24,015,"Maryland","Cecil County",2,78,542,255,287
050,24,015,"Maryland","Cecil County",2,79,478,233,245
050,24,015,"Maryland","Cecil County",2,80,422,200,222
050,24,015,"Maryland","Cecil County",2,81,365,165,200
050,24,015,"Maryland","Cecil County",2,82,344,160,184
050,24,015,"Maryland","Cecil County",2,83,297,133,164
050,24,015,"Maryland","Cecil County",2,84,273,119,154
050,24,015,"Maryland","Cecil County",2,85,1519,578,941
050,24,015,"Maryland","Cecil County",3,0,1097,565,532
050,24,015,"Maryland","Cecil County",3,1,1162,589,573
050,24,015,"Maryland","Cecil County",3,2,1157,597,560
050,24,015,"Maryland","Cecil County",3,3,1199,616,583
050,24,015,"Maryland","Cecil County",3,4,1212,629,583
050,24,015,"Maryland","Cecil County",3,5,1215,633,582
050,24,015,"Maryland","Cecil County",3,6,1183,600,583
050,24,015,"Maryland","Cecil County",3,7,1233,632,601
050,24,015,"Maryland","Cecil County",3,8,1209,598,611
050,24,015,"Maryland","Cecil County",3,9,1261,633,628
050,24,015,"Maryland","Cecil County",3,10,1317,672,645
050,24,015,"Maryland","Cecil County",3,11,1351,709,642
050,24,015,"Maryland","Cecil County",3,12,1427,739,688
050,24,015,"Maryland","Cecil County",3,13,1469,761,708
050,24,015,"Maryland","Cecil County",3,14,1441,766,675
050,24,015,"Maryland","Cecil County",3,15,1398,724,674
050,24,015,"Maryland","Cecil County",3,16,1443,741,702
050,24,015,"Maryland","Cecil County",3,17,1413,705,708
050,24,015,"Maryland","Cecil County",3,18,1226,643,583
050,24,015,"Maryland","Cecil County",3,19,1019,542,477
050,24,015,"Maryland","Cecil County",3,20,1103,551,552
050,24,015,"Maryland","Cecil County",3,21,1171,605,566
050,24,015,"Maryland","Cecil County",3,22,1232,625,607
050,24,015,"Maryland","Cecil County",3,23,1248,635,613
050,24,015,"Maryland","Cecil County",3,24,1219,627,592
050,24,015,"Maryland","Cecil County",3,25,1196,609,587
050,24,015,"Maryland","Cecil County",3,26,1220,632,588
050,24,015,"Maryland","Cecil County",3,27,1311,655,656
050,24,015,"Maryland","Cecil County",3,28,1311,642,669
050,24,015,"Maryland","Cecil County",3,29,1358,664,694
050,24,015,"Maryland","Cecil County",3,30,1378,702,676
050,24,015,"Maryland","Cecil County",3,31,1429,722,707
050,24,015,"Maryland","Cecil County",3,32,1354,678,676
050,24,015,"Maryland","Cecil County",3,33,1348,648,700
050,24,015,"Maryland","Cecil County",3,34,1353,674,679
050,24,015,"Maryland","Cecil County",3,35,1355,670,685
050,24,015,"Maryland","Cecil County",3,36,1313,651,662
050,24,015,"Maryland","Cecil County",3,37,1219,616,603
050,24,015,"Maryland","Cecil County",3,38,1263,631,632
050,24,015,"Maryland","Cecil County",3,39,1266,640,626
050,24,015,"Maryland","Cecil County",3,40,1250,631,619
050,24,015,"Maryland","Cecil County",3,41,1247,613,634
050,24,015,"Maryland","Cecil County",3,42,1247,621,626
050,24,015,"Maryland","Cecil County",3,43,1245,603,642
050,24,015,"Maryland","Cecil County",3,44,1218,595,623
050,24,015,"Maryland","Cecil County",3,45,1190,572,618
050,24,015,"Maryland","Cecil County",3,46,1203,600,603
050,24,015,"Maryland","Cecil County",3,47,1170,583,587
050,24,015,"Maryland","Cecil County",3,48,1227,617,610
050,24,015,"Maryland","Cecil County",3,49,1359,661,698
050,24,015,"Maryland","Cecil County",3,50,1496,711,785
050,24,015,"Maryland","Cecil County",3,51,1475,732,743
050,24,015,"Maryland","Cecil County",3,52,1518,768,750
050,24,015,"Maryland","Cecil County",3,53,1452,717,735
050,24,015,"Maryland","Cecil County",3,54,1494,742,752
050,24,015,"Maryland","Cecil County",3,55,1600,802,798
050,24,015,"Maryland","Cecil County",3,56,1643,841,802
050,24,015,"Maryland","Cecil County",3,57,1647,834,813
050,24,015,"Maryland","Cecil County",3,58,1686,841,845
050,24,015,"Maryland","Cecil County",3,59,1638,830,808
050,24,015,"Maryland","Cecil County",3,60,1587,811,776
050,24,015,"Maryland","Cecil County",3,61,1571,796,775
050,24,015,"Maryland","Cecil County",3,62,1550,755,795
050,24,015,"Maryland","Cecil County",3,63,1483,742,741
050,24,015,"Maryland","Cecil County",3,64,1417,701,716
050,24,015,"Maryland","Cecil County",3,65,1336,652,684
050,24,015,"Maryland","Cecil County",3,66,1279,641,638
050,24,015,"Maryland","Cecil County",3,67,1224,599,625
050,24,015,"Maryland","Cecil County",3,68,1152,543,609
050,24,015,"Maryland","Cecil County",3,69,1081,522,559
050,24,015,"Maryland","Cecil County",3,70,1024,481,543
050,24,015,"Maryland","Cecil County",3,71,969,469,500
050,24,015,"Maryland","Cecil County",3,72,947,462,485
050,24,015,"Maryland","Cecil County",3,73,936,464,472
050,24,015,"Maryland","Cecil County",3,74,1040,497,543
050,24,015,"Maryland","Cecil County",3,75,689,321,368
050,24,015,"Maryland","Cecil County",3,76,631,296,335
050,24,015,"Maryland","Cecil County",3,77,594,281,313
050,24,015,"Maryland","Cecil County",3,78,635,305,330
050,24,015,"Maryland","Cecil County",3,79,511,239,272
050,24,015,"Maryland","Cecil County",3,80,459,216,243
050,24,015,"Maryland","Cecil County",3,81,378,171,207
050,24,015,"Maryland","Cecil County",3,82,339,154,185
050,24,015,"Maryland","Cecil County",3,83,314,147,167
050,24,015,"Maryland","Cecil County",3,84,269,124,145
050,24,015,"Maryland","Cecil County",3,85,1557,603,954
050,24,015,"Maryland","Cecil County",4,0,1167,623,544
050,24,015,"Maryland","Cecil County",4,1,1117,594,523
050,24,015,"Maryland","Cecil County",4,2,1222,622,600
050,24,015,"Maryland","Cecil County",4,3,1206,620,586
050,24,015,"Maryland","Cecil County",4,4,1209,630,579
050,24,015,"Maryland","Cecil County",4,5,1258,647,611
050,24,015,"Maryland","Cecil County",4,6,1237,637,600
050,24,015,"Maryland","Cecil County",4,7,1198,610,588
050,24,015,"Maryland","Cecil County",4,8,1284,653,631
050,24,015,"Maryland","Cecil County",4,9,1235,632,603
050,24,015,"Maryland","Cecil County",4,10,1279,634,645
050,24,015,"Maryland","Cecil County",4,11,1321,670,651
050,24,015,"Maryland","Cecil County",4,12,1363,714,649
050,24,015,"Maryland","Cecil County",4,13,1434,748,686
050,24,015,"Maryland","Cecil County",4,14,1497,764,733
050,24,015,"Maryland","Cecil County",4,15,1461,778,683
050,24,015,"Maryland","Cecil County",4,16,1412,726,686
050,24,015,"Maryland","Cecil County",4,17,1482,763,719
050,24,015,"Maryland","Cecil County",4,18,1208,616,592
050,24,015,"Maryland","Cecil County",4,19,944,502,442
050,24,015,"Maryland","Cecil County",4,20,1081,576,505
050,24,015,"Maryland","Cecil County",4,21,1110,548,562
050,24,015,"Maryland","Cecil County",4,22,1225,622,603
050,24,015,"Maryland","Cecil County",4,23,1269,650,619
050,24,015,"Maryland","Cecil County",4,24,1247,638,609
050,24,015,"Maryland","Cecil County",4,25,1223,635,588
050,24,015,"Maryland","Cecil County",4,26,1245,618,627
050,24,015,"Maryland","Cecil County",4,27,1254,642,612
050,24,015,"Maryland","Cecil County",4,28,1328,659,669
050,24,015,"Maryland","Cecil County",4,29,1355,632,723
050,24,015,"Maryland","Cecil County",4,30,1406,712,694
050,24,015,"Maryland","Cecil County",4,31,1424,709,715
050,24,015,"Maryland","Cecil County",4,32,1453,721,732
050,24,015,"Maryland","Cecil County",4,33,1374,695,679
050,24,015,"Maryland","Cecil County",4,34,1390,669,721
050,24,015,"Maryland","Cecil County",4,35,1401,692,709
050,24,015,"Maryland","Cecil County",4,36,1363,675,688
050,24,015,"Maryland","Cecil County",4,37,1352,685,667
050,24,015,"Maryland","Cecil County",4,38,1205,603,602
050,24,015,"Maryland","Cecil County",4,39,1301,664,637
050,24,015,"Maryland","Cecil County",4,40,1271,634,637
050,24,015,"Maryland","Cecil County",4,41,1270,659,611
050,24,015,"Maryland","Cecil County",4,42,1281,632,649
050,24,015,"Maryland","Cecil County",4,43,1229,597,632
050,24,015,"Maryland","Cecil County",4,44,1242,598,644
050,24,015,"Maryland","Cecil County",4,45,1212,605,607
050,24,015,"Maryland","Cecil County",4,46,1248,614,634
050,24,015,"Maryland","Cecil County",4,47,1204,585,619
050,24,015,"Maryland","Cecil County",4,48,1193,601,592
050,24,015,"Maryland","Cecil County",4,49,1207,609,598
050,24,015,"Maryland","Cecil County",4,50,1366,649,717
050,24,015,"Maryland","Cecil County",4,51,1503,717,786
050,24,015,"Maryland","Cecil County",4,52,1496,751,745
050,24,015,"Maryland","Cecil County",4,53,1531,782,749
050,24,015,"Maryland","Cecil County",4,54,1452,717,735
050,24,015,"Maryland","Cecil County",4,55,1472,721,751
050,24,015,"Maryland","Cecil County",4,56,1590,786,804
050,24,015,"Maryland","Cecil County",4,57,1632,836,796
050,24,015,"Maryland","Cecil County",4,58,1637,837,800
050,24,015,"Maryland","Cecil County",4,59,1653,818,835
050,24,015,"Maryland","Cecil County",4,60,1622,824,798
050,24,015,"Maryland","Cecil County",4,61,1578,812,766
050,24,015,"Maryland","Cecil County",4,62,1534,779,755
050,24,015,"Maryland","Cecil County",4,63,1514,729,785
050,24,015,"Maryland","Cecil County",4,64,1463,729,734
050,24,015,"Maryland","Cecil County",4,65,1404,685,719
050,24,015,"Maryland","Cecil County",4,66,1310,638,672
050,24,015,"Maryland","Cecil County",4,67,1256,634,622
050,24,015,"Maryland","Cecil County",4,68,1181,575,606
050,24,015,"Maryland","Cecil County",4,69,1127,528,599
050,24,015,"Maryland","Cecil County",4,70,1062,513,549
050,24,015,"Maryland","Cecil County",4,71,988,456,532
050,24,015,"Maryland","Cecil County",4,72,937,452,485
050,24,015,"Maryland","Cecil County",4,73,929,451,478
050,24,015,"Maryland","Cecil County",4,74,909,446,463
050,24,015,"Maryland","Cecil County",4,75,996,465,531
050,24,015,"Maryland","Cecil County",4,76,677,318,359
050,24,015,"Maryland","Cecil County",4,77,605,280,325
050,24,015,"Maryland","Cecil County",4,78,572,264,308
050,24,015,"Maryland","Cecil County",4,79,585,283,302
050,24,015,"Maryland","Cecil County",4,80,481,216,265
050,24,015,"Maryland","Cecil County",4,81,409,182,227
050,24,015,"Maryland","Cecil County",4,82,358,163,195
050,24,015,"Maryland","Cecil County",4,83,300,133,167
050,24,015,"Maryland","Cecil County",4,84,283,140,143
050,24,015,"Maryland","Cecil County",4,85,1561,627,934
050,24,015,"Maryland","Cecil County",5,0,1134,600,534
050,24,015,"Maryland","Cecil County",5,1,1165,617,548
050,24,015,"Maryland","Cecil County",5,2,1146,604,542
050,24,015,"Maryland","Cecil County",5,3,1260,629,631
050,24,015,"Maryland","Cecil County",5,4,1244,630,614
050,24,015,"Maryland","Cecil County",5,5,1230,643,587
050,24,015,"Maryland","Cecil County",5,6,1257,657,600
050,24,015,"Maryland","Cecil County",5,7,1258,642,616
050,24,015,"Maryland","Cecil County",5,8,1222,625,597
050,24,015,"Maryland","Cecil County",5,9,1276,662,614
050,24,015,"Maryland","Cecil County",5,10,1259,640,619
050,24,015,"Maryland","Cecil County",5,11,1325,646,679
050,24,015,"Maryland","Cecil County",5,12,1352,688,664
050,24,015,"Maryland","Cecil County",5,13,1383,728,655
050,24,015,"Maryland","Cecil County",5,14,1446,752,694
050,24,015,"Maryland","Cecil County",5,15,1507,774,733
050,24,015,"Maryland","Cecil County",5,16,1474,779,695
050,24,015,"Maryland","Cecil County",5,17,1402,713,689
050,24,015,"Maryland","Cecil County",5,18,1242,653,589
050,24,015,"Maryland","Cecil County",5,19,968,498,470
050,24,015,"Maryland","Cecil County",5,20,1054,557,497
050,24,015,"Maryland","Cecil County",5,21,1137,585,552
050,24,015,"Maryland","Cecil County",5,22,1195,570,625
050,24,015,"Maryland","Cecil County",5,23,1268,647,621
050,24,015,"Maryland","Cecil County",5,24,1285,661,624
050,24,015,"Maryland","Cecil County",5,25,1253,628,625
050,24,015,"Maryland","Cecil County",5,26,1266,647,619
050,24,015,"Maryland","Cecil County",5,27,1247,626,621
050,24,015,"Maryland","Cecil County",5,28,1251,639,612
050,24,015,"Maryland","Cecil County",5,29,1341,670,671
050,24,015,"Maryland","Cecil County",5,30,1379,660,719
050,24,015,"Maryland","Cecil County",5,31,1419,722,697
050,24,015,"Maryland","Cecil County",5,32,1482,733,749
050,24,015,"Maryland","Cecil County",5,33,1481,721,760
050,24,015,"Maryland","Cecil County",5,34,1408,693,715
050,24,015,"Maryland","Cecil County",5,35,1397,671,726
050,24,015,"Maryland","Cecil County",5,36,1437,710,727
050,24,015,"Maryland","Cecil County",5,37,1396,688,708
050,24,015,"Maryland","Cecil County",5,38,1372,698,674
050,24,015,"Maryland","Cecil County",5,39,1218,611,607
050,24,015,"Maryland","Cecil County",5,40,1304,671,633
050,24,015,"Maryland","Cecil County",5,41,1286,654,632
050,24,015,"Maryland","Cecil County",5,42,1287,659,628
050,24,015,"Maryland","Cecil County",5,43,1268,624,644
050,24,015,"Maryland","Cecil County",5,44,1243,601,642
050,24,015,"Maryland","Cecil County",5,45,1239,599,640
050,24,015,"Maryland","Cecil County",5,46,1224,606,618
050,24,015,"Maryland","Cecil County",5,47,1238,607,631
050,24,015,"Maryland","Cecil County",5,48,1231,601,630
050,24,015,"Maryland","Cecil County",5,49,1183,591,592
050,24,015,"Maryland","Cecil County",5,50,1191,588,603
050,24,015,"Maryland","Cecil County",5,51,1356,654,702
050,24,015,"Maryland","Cecil County",5,52,1534,747,787
050,24,015,"Maryland","Cecil County",5,53,1499,748,751
050,24,015,"Maryland","Cecil County",5,54,1542,789,753
050,24,015,"Maryland","Cecil County",5,55,1436,704,732
050,24,015,"Maryland","Cecil County",5,56,1490,721,769
050,24,015,"Maryland","Cecil County",5,57,1593,785,808
050,24,015,"Maryland","Cecil County",5,58,1618,824,794
050,24,015,"Maryland","Cecil County",5,59,1599,815,784
050,24,015,"Maryland","Cecil County",5,60,1633,813,820
050,24,015,"Maryland","Cecil County",5,61,1609,810,799
050,24,015,"Maryland","Cecil County",5,62,1571,798,773
050,24,015,"Maryland","Cecil County",5,63,1532,776,756
050,24,015,"Maryland","Cecil County",5,64,1479,699,780
050,24,015,"Maryland","Cecil County",5,65,1444,707,737
050,24,015,"Maryland","Cecil County",5,66,1397,676,721
050,24,015,"Maryland","Cecil County",5,67,1295,628,667
050,24,015,"Maryland","Cecil County",5,68,1210,613,597
050,24,015,"Maryland","Cecil County",5,69,1164,569,595
050,24,015,"Maryland","Cecil County",5,70,1107,521,586
050,24,015,"Maryland","Cecil County",5,71,1038,501,537
050,24,015,"Maryland","Cecil County",5,72,957,444,513
050,24,015,"Maryland","Cecil County",5,73,920,446,474
050,24,015,"Maryland","Cecil County",5,74,894,429,465
050,24,015,"Maryland","Cecil County",5,75,877,426,451
050,24,015,"Maryland","Cecil County",5,76,975,451,524
050,24,015,"Maryland","Cecil County",5,77,656,302,354
050,24,015,"Maryland","Cecil County",5,78,594,269,325
050,24,015,"Maryland","Cecil County",5,79,539,248,291
050,24,015,"Maryland","Cecil County",5,80,561,269,292
050,24,015,"Maryland","Cecil County",5,81,439,192,247
050,24,015,"Maryland","Cecil County",5,82,390,176,214
050,24,015,"Maryland","Cecil County",5,83,327,149,178
050,24,015,"Maryland","Cecil County",5,84,269,122,147
050,24,015,"Maryland","Cecil County",5,85,1598,660,938
050,24,017,"Maryland","Charles County",1,0,1862,944,918
050,24,017,"Maryland","Charles County",1,1,1956,971,985
050,24,017,"Maryland","Charles County",1,2,1943,982,961
050,24,017,"Maryland","Charles County",1,3,1980,999,981
050,24,017,"Maryland","Charles County",1,4,2045,1039,1006
050,24,017,"Maryland","Charles County",1,5,2097,1059,1038
050,24,017,"Maryland","Charles County",1,6,2152,1094,1058
050,24,017,"Maryland","Charles County",1,7,2213,1158,1055
050,24,017,"Maryland","Charles County",1,8,2255,1172,1083
050,24,017,"Maryland","Charles County",1,9,2269,1182,1087
050,24,017,"Maryland","Charles County",1,10,2296,1181,1115
050,24,017,"Maryland","Charles County",1,11,2377,1198,1179
050,24,017,"Maryland","Charles County",1,12,2550,1305,1245
050,24,017,"Maryland","Charles County",1,13,2499,1274,1225
050,24,017,"Maryland","Charles County",1,14,2392,1182,1210
050,24,017,"Maryland","Charles County",1,15,2479,1273,1206
050,24,017,"Maryland","Charles County",1,16,2460,1252,1208
050,24,017,"Maryland","Charles County",1,17,2466,1250,1216
050,24,017,"Maryland","Charles County",1,18,2080,1105,975
050,24,017,"Maryland","Charles County",1,19,1891,982,909
050,24,017,"Maryland","Charles County",1,20,1887,968,919
050,24,017,"Maryland","Charles County",1,21,1976,1032,944
050,24,017,"Maryland","Charles County",1,22,2016,1044,972
050,24,017,"Maryland","Charles County",1,23,2012,1004,1008
050,24,017,"Maryland","Charles County",1,24,2015,1003,1012
050,24,017,"Maryland","Charles County",1,25,2057,1040,1017
050,24,017,"Maryland","Charles County",1,26,2104,1062,1042
050,24,017,"Maryland","Charles County",1,27,2073,1035,1038
050,24,017,"Maryland","Charles County",1,28,2056,1004,1052
050,24,017,"Maryland","Charles County",1,29,2192,1094,1098
050,24,017,"Maryland","Charles County",1,30,2165,1122,1043
050,24,017,"Maryland","Charles County",1,31,2120,1032,1088
050,24,017,"Maryland","Charles County",1,32,2112,1026,1086
050,24,017,"Maryland","Charles County",1,33,2119,1017,1102
050,24,017,"Maryland","Charles County",1,34,2155,1062,1093
050,24,017,"Maryland","Charles County",1,35,2266,1098,1168
050,24,017,"Maryland","Charles County",1,36,2230,1065,1165
050,24,017,"Maryland","Charles County",1,37,2254,1029,1225
050,24,017,"Maryland","Charles County",1,38,2264,1065,1199
050,24,017,"Maryland","Charles County",1,39,2291,1044,1247
050,24,017,"Maryland","Charles County",1,40,2167,1039,1128
050,24,017,"Maryland","Charles County",1,41,2101,1011,1090
050,24,017,"Maryland","Charles County",1,42,2137,1005,1132
050,24,017,"Maryland","Charles County",1,43,2096,952,1144
050,24,017,"Maryland","Charles County",1,44,2087,949,1138
050,24,017,"Maryland","Charles County",1,45,2099,969,1130
050,24,017,"Maryland","Charles County",1,46,2152,989,1163
050,24,017,"Maryland","Charles County",1,47,2321,1068,1253
050,24,017,"Maryland","Charles County",1,48,2471,1127,1344
050,24,017,"Maryland","Charles County",1,49,2706,1282,1424
050,24,017,"Maryland","Charles County",1,50,2614,1232,1382
050,24,017,"Maryland","Charles County",1,51,2532,1198,1334
050,24,017,"Maryland","Charles County",1,52,2541,1184,1357
050,24,017,"Maryland","Charles County",1,53,2615,1252,1363
050,24,017,"Maryland","Charles County",1,54,2683,1306,1377
050,24,017,"Maryland","Charles County",1,55,2735,1303,1432
050,24,017,"Maryland","Charles County",1,56,2721,1303,1418
050,24,017,"Maryland","Charles County",1,57,2618,1283,1335
050,24,017,"Maryland","Charles County",1,58,2554,1237,1317
050,24,017,"Maryland","Charles County",1,59,2452,1231,1221
050,24,017,"Maryland","Charles County",1,60,2263,1097,1166
050,24,017,"Maryland","Charles County",1,61,2133,1040,1093
050,24,017,"Maryland","Charles County",1,62,2029,983,1046
050,24,017,"Maryland","Charles County",1,63,1965,965,1000
050,24,017,"Maryland","Charles County",1,64,1773,860,913
050,24,017,"Maryland","Charles County",1,65,1697,786,911
050,24,017,"Maryland","Charles County",1,66,1499,676,823
050,24,017,"Maryland","Charles County",1,67,1420,629,791
050,24,017,"Maryland","Charles County",1,68,1422,658,764
050,24,017,"Maryland","Charles County",1,69,1324,606,718
050,24,017,"Maryland","Charles County",1,70,1256,554,702
050,24,017,"Maryland","Charles County",1,71,1246,547,699
050,24,017,"Maryland","Charles County",1,72,1195,537,658
050,24,017,"Maryland","Charles County",1,73,1253,577,676
050,24,017,"Maryland","Charles County",1,74,898,402,496
050,24,017,"Maryland","Charles County",1,75,895,411,484
050,24,017,"Maryland","Charles County",1,76,843,381,462
050,24,017,"Maryland","Charles County",1,77,835,369,466
050,24,017,"Maryland","Charles County",1,78,712,325,387
050,24,017,"Maryland","Charles County",1,79,604,257,347
050,24,017,"Maryland","Charles County",1,80,537,222,315
050,24,017,"Maryland","Charles County",1,81,501,200,301
050,24,017,"Maryland","Charles County",1,82,482,195,287
050,24,017,"Maryland","Charles County",1,83,411,169,242
050,24,017,"Maryland","Charles County",1,84,376,154,222
050,24,017,"Maryland","Charles County",1,85,2024,646,1378
050,24,017,"Maryland","Charles County",2,0,1849,931,918
050,24,017,"Maryland","Charles County",2,1,1950,973,977
050,24,017,"Maryland","Charles County",2,2,1963,987,976
050,24,017,"Maryland","Charles County",2,3,1979,999,980
050,24,017,"Maryland","Charles County",2,4,2044,1034,1010
050,24,017,"Maryland","Charles County",2,5,2100,1063,1037
050,24,017,"Maryland","Charles County",2,6,2154,1094,1060
050,24,017,"Maryland","Charles County",2,7,2213,1149,1064
050,24,017,"Maryland","Charles County",2,8,2245,1168,1077
050,24,017,"Maryland","Charles County",2,9,2269,1182,1087
050,24,017,"Maryland","Charles County",2,10,2291,1184,1107
050,24,017,"Maryland","Charles County",2,11,2357,1193,1164
050,24,017,"Maryland","Charles County",2,12,2531,1287,1244
050,24,017,"Maryland","Charles County",2,13,2516,1282,1234
050,24,017,"Maryland","Charles County",2,14,2428,1210,1218
050,24,017,"Maryland","Charles County",2,15,2459,1250,1209
050,24,017,"Maryland","Charles County",2,16,2470,1260,1210
050,24,017,"Maryland","Charles County",2,17,2458,1249,1209
050,24,017,"Maryland","Charles County",2,18,2085,1096,989
050,24,017,"Maryland","Charles County",2,19,1870,977,893
050,24,017,"Maryland","Charles County",2,20,1922,988,934
050,24,017,"Maryland","Charles County",2,21,1952,1014,938
050,24,017,"Maryland","Charles County",2,22,2008,1037,971
050,24,017,"Maryland","Charles County",2,23,2028,1022,1006
050,24,017,"Maryland","Charles County",2,24,2013,1006,1007
050,24,017,"Maryland","Charles County",2,25,2043,1028,1015
050,24,017,"Maryland","Charles County",2,26,2103,1062,1041
050,24,017,"Maryland","Charles County",2,27,2080,1039,1041
050,24,017,"Maryland","Charles County",2,28,2068,1014,1054
050,24,017,"Maryland","Charles County",2,29,2168,1083,1085
050,24,017,"Maryland","Charles County",2,30,2196,1123,1073
050,24,017,"Maryland","Charles County",2,31,2133,1057,1076
050,24,017,"Maryland","Charles County",2,32,2113,1028,1085
050,24,017,"Maryland","Charles County",2,33,2125,1026,1099
050,24,017,"Maryland","Charles County",2,34,2160,1058,1102
050,24,017,"Maryland","Charles County",2,35,2265,1103,1162
050,24,017,"Maryland","Charles County",2,36,2235,1072,1163
050,24,017,"Maryland","Charles County",2,37,2255,1046,1209
050,24,017,"Maryland","Charles County",2,38,2276,1063,1213
050,24,017,"Maryland","Charles County",2,39,2272,1044,1228
050,24,017,"Maryland","Charles County",2,40,2220,1055,1165
050,24,017,"Maryland","Charles County",2,41,2112,1013,1099
050,24,017,"Maryland","Charles County",2,42,2118,1003,1115
050,24,017,"Maryland","Charles County",2,43,2118,971,1147
050,24,017,"Maryland","Charles County",2,44,2070,942,1128
050,24,017,"Maryland","Charles County",2,45,2113,975,1138
050,24,017,"Maryland","Charles County",2,46,2135,981,1154
050,24,017,"Maryland","Charles County",2,47,2270,1042,1228
050,24,017,"Maryland","Charles County",2,48,2437,1115,1322
050,24,017,"Maryland","Charles County",2,49,2655,1246,1409
050,24,017,"Maryland","Charles County",2,50,2631,1241,1390
050,24,017,"Maryland","Charles County",2,51,2525,1188,1337
050,24,017,"Maryland","Charles County",2,52,2538,1186,1352
050,24,017,"Maryland","Charles County",2,53,2588,1233,1355
050,24,017,"Maryland","Charles County",2,54,2657,1286,1371
050,24,017,"Maryland","Charles County",2,55,2721,1300,1421
050,24,017,"Maryland","Charles County",2,56,2723,1303,1420
050,24,017,"Maryland","Charles County",2,57,2631,1279,1352
050,24,017,"Maryland","Charles County",2,58,2563,1247,1316
050,24,017,"Maryland","Charles County",2,59,2471,1228,1243
050,24,017,"Maryland","Charles County",2,60,2294,1121,1173
050,24,017,"Maryland","Charles County",2,61,2146,1047,1099
050,24,017,"Maryland","Charles County",2,62,2039,990,1049
050,24,017,"Maryland","Charles County",2,63,1972,969,1003
050,24,017,"Maryland","Charles County",2,64,1795,872,923
050,24,017,"Maryland","Charles County",2,65,1703,795,908
050,24,017,"Maryland","Charles County",2,66,1534,693,841
050,24,017,"Maryland","Charles County",2,67,1419,630,789
050,24,017,"Maryland","Charles County",2,68,1403,641,762
050,24,017,"Maryland","Charles County",2,69,1347,615,732
050,24,017,"Maryland","Charles County",2,70,1267,561,706
050,24,017,"Maryland","Charles County",2,71,1232,543,689
050,24,017,"Maryland","Charles County",2,72,1183,530,653
050,24,017,"Maryland","Charles County",2,73,1282,587,695
050,24,017,"Maryland","Charles County",2,74,921,415,506
050,24,017,"Maryland","Charles County",2,75,896,406,490
050,24,017,"Maryland","Charles County",2,76,833,377,456
050,24,017,"Maryland","Charles County",2,77,841,369,472
050,24,017,"Maryland","Charles County",2,78,715,324,391
050,24,017,"Maryland","Charles County",2,79,620,268,352
050,24,017,"Maryland","Charles County",2,80,551,226,325
050,24,017,"Maryland","Charles County",2,81,498,200,298
050,24,017,"Maryland","Charles County",2,82,480,190,290
050,24,017,"Maryland","Charles County",2,83,416,169,247
050,24,017,"Maryland","Charles County",2,84,376,149,227
050,24,017,"Maryland","Charles County",2,85,2036,650,1386
050,24,017,"Maryland","Charles County",3,0,1814,902,912
050,24,017,"Maryland","Charles County",3,1,1994,1007,987
050,24,017,"Maryland","Charles County",3,2,1984,992,992
050,24,017,"Maryland","Charles County",3,3,2021,1014,1007
050,24,017,"Maryland","Charles County",3,4,2018,1022,996
050,24,017,"Maryland","Charles County",3,5,2122,1094,1028
050,24,017,"Maryland","Charles County",3,6,2138,1079,1059
050,24,017,"Maryland","Charles County",3,7,2161,1083,1078
050,24,017,"Maryland","Charles County",3,8,2231,1184,1047
050,24,017,"Maryland","Charles County",3,9,2303,1207,1096
050,24,017,"Maryland","Charles County",3,10,2338,1208,1130
050,24,017,"Maryland","Charles County",3,11,2401,1242,1159
050,24,017,"Maryland","Charles County",3,12,2432,1223,1209
050,24,017,"Maryland","Charles County",3,13,2588,1317,1271
050,24,017,"Maryland","Charles County",3,14,2581,1318,1263
050,24,017,"Maryland","Charles County",3,15,2493,1234,1259
050,24,017,"Maryland","Charles County",3,16,2501,1252,1249
050,24,017,"Maryland","Charles County",3,17,2498,1276,1222
050,24,017,"Maryland","Charles County",3,18,2164,1107,1057
050,24,017,"Maryland","Charles County",3,19,1827,967,860
050,24,017,"Maryland","Charles County",3,20,1950,1006,944
050,24,017,"Maryland","Charles County",3,21,1991,1019,972
050,24,017,"Maryland","Charles County",3,22,1980,1008,972
050,24,017,"Maryland","Charles County",3,23,2066,1054,1012
050,24,017,"Maryland","Charles County",3,24,2027,1019,1008
050,24,017,"Maryland","Charles County",3,25,1924,957,967
050,24,017,"Maryland","Charles County",3,26,2037,1025,1012
050,24,017,"Maryland","Charles County",3,27,2096,1050,1046
050,24,017,"Maryland","Charles County",3,28,2074,1041,1033
050,24,017,"Maryland","Charles County",3,29,2153,1044,1109
050,24,017,"Maryland","Charles County",3,30,2198,1106,1092
050,24,017,"Maryland","Charles County",3,31,2269,1159,1110
050,24,017,"Maryland","Charles County",3,32,2231,1099,1132
050,24,017,"Maryland","Charles County",3,33,2182,1026,1156
050,24,017,"Maryland","Charles County",3,34,2226,1090,1136
050,24,017,"Maryland","Charles County",3,35,2255,1093,1162
050,24,017,"Maryland","Charles County",3,36,2345,1130,1215
050,24,017,"Maryland","Charles County",3,37,2328,1079,1249
050,24,017,"Maryland","Charles County",3,38,2289,1074,1215
050,24,017,"Maryland","Charles County",3,39,2324,1094,1230
050,24,017,"Maryland","Charles County",3,40,2294,1061,1233
050,24,017,"Maryland","Charles County",3,41,2269,1076,1193
050,24,017,"Maryland","Charles County",3,42,2175,1028,1147
050,24,017,"Maryland","Charles County",3,43,2163,1036,1127
050,24,017,"Maryland","Charles County",3,44,2161,985,1176
050,24,017,"Maryland","Charles County",3,45,2079,946,1133
050,24,017,"Maryland","Charles County",3,46,2126,983,1143
050,24,017,"Maryland","Charles County",3,47,2139,985,1154
050,24,017,"Maryland","Charles County",3,48,2292,1032,1260
050,24,017,"Maryland","Charles County",3,49,2440,1124,1316
050,24,017,"Maryland","Charles County",3,50,2710,1273,1437
050,24,017,"Maryland","Charles County",3,51,2608,1230,1378
050,24,017,"Maryland","Charles County",3,52,2512,1183,1329
050,24,017,"Maryland","Charles County",3,53,2542,1198,1344
050,24,017,"Maryland","Charles County",3,54,2597,1246,1351
050,24,017,"Maryland","Charles County",3,55,2614,1254,1360
050,24,017,"Maryland","Charles County",3,56,2705,1302,1403
050,24,017,"Maryland","Charles County",3,57,2711,1296,1415
050,24,017,"Maryland","Charles County",3,58,2615,1255,1360
050,24,017,"Maryland","Charles County",3,59,2510,1241,1269
050,24,017,"Maryland","Charles County",3,60,2414,1210,1204
050,24,017,"Maryland","Charles County",3,61,2244,1092,1152
050,24,017,"Maryland","Charles County",3,62,2088,1019,1069
050,24,017,"Maryland","Charles County",3,63,1995,954,1041
050,24,017,"Maryland","Charles County",3,64,1901,942,959
050,24,017,"Maryland","Charles County",3,65,1765,853,912
050,24,017,"Maryland","Charles County",3,66,1683,785,898
050,24,017,"Maryland","Charles County",3,67,1500,652,848
050,24,017,"Maryland","Charles County",3,68,1403,624,779
050,24,017,"Maryland","Charles County",3,69,1360,612,748
050,24,017,"Maryland","Charles County",3,70,1338,608,730
050,24,017,"Maryland","Charles County",3,71,1229,550,679
050,24,017,"Maryland","Charles County",3,72,1205,528,677
050,24,017,"Maryland","Charles County",3,73,1171,509,662
050,24,017,"Maryland","Charles County",3,74,1235,564,671
050,24,017,"Maryland","Charles County",3,75,905,406,499
050,24,017,"Maryland","Charles County",3,76,843,388,455
050,24,017,"Maryland","Charles County",3,77,814,358,456
050,24,017,"Maryland","Charles County",3,78,800,341,459
050,24,017,"Maryland","Charles County",3,79,670,305,365
050,24,017,"Maryland","Charles County",3,80,615,252,363
050,24,017,"Maryland","Charles County",3,81,506,211,295
050,24,017,"Maryland","Charles County",3,82,476,189,287
050,24,017,"Maryland","Charles County",3,83,431,164,267
050,24,017,"Maryland","Charles County",3,84,408,158,250
050,24,017,"Maryland","Charles County",3,85,2112,685,1427
050,24,017,"Maryland","Charles County",4,0,1834,910,924
050,24,017,"Maryland","Charles County",4,1,1876,942,934
050,24,017,"Maryland","Charles County",4,2,2067,1064,1003
050,24,017,"Maryland","Charles County",4,3,2045,1022,1023
050,24,017,"Maryland","Charles County",4,4,2068,1066,1002
050,24,017,"Maryland","Charles County",4,5,2075,1062,1013
050,24,017,"Maryland","Charles County",4,6,2167,1125,1042
050,24,017,"Maryland","Charles County",4,7,2170,1088,1082
050,24,017,"Maryland","Charles County",4,8,2215,1105,1110
050,24,017,"Maryland","Charles County",4,9,2254,1197,1057
050,24,017,"Maryland","Charles County",4,10,2351,1231,1120
050,24,017,"Maryland","Charles County",4,11,2411,1224,1187
050,24,017,"Maryland","Charles County",4,12,2417,1256,1161
050,24,017,"Maryland","Charles County",4,13,2474,1265,1209
050,24,017,"Maryland","Charles County",4,14,2636,1345,1291
050,24,017,"Maryland","Charles County",4,15,2614,1321,1293
050,24,017,"Maryland","Charles County",4,16,2552,1282,1270
050,24,017,"Maryland","Charles County",4,17,2520,1245,1275
050,24,017,"Maryland","Charles County",4,18,2171,1126,1045
050,24,017,"Maryland","Charles County",4,19,1845,954,891
050,24,017,"Maryland","Charles County",4,20,1870,979,891
050,24,017,"Maryland","Charles County",4,21,1981,1052,929
050,24,017,"Maryland","Charles County",4,22,2030,1015,1015
050,24,017,"Maryland","Charles County",4,23,1963,1020,943
050,24,017,"Maryland","Charles County",4,24,2019,1036,983
050,24,017,"Maryland","Charles County",4,25,2022,1023,999
050,24,017,"Maryland","Charles County",4,26,1911,944,967
050,24,017,"Maryland","Charles County",4,27,1966,1011,955
050,24,017,"Maryland","Charles County",4,28,2086,1010,1076
050,24,017,"Maryland","Charles County",4,29,2089,1059,1030
050,24,017,"Maryland","Charles County",4,30,2221,1052,1169
050,24,017,"Maryland","Charles County",4,31,2250,1119,1131
050,24,017,"Maryland","Charles County",4,32,2323,1180,1143
050,24,017,"Maryland","Charles County",4,33,2282,1108,1174
050,24,017,"Maryland","Charles County",4,34,2253,1055,1198
050,24,017,"Maryland","Charles County",4,35,2298,1126,1172
050,24,017,"Maryland","Charles County",4,36,2288,1120,1168
050,24,017,"Maryland","Charles County",4,37,2425,1181,1244
050,24,017,"Maryland","Charles County",4,38,2369,1099,1270
050,24,017,"Maryland","Charles County",4,39,2389,1138,1251
050,24,017,"Maryland","Charles County",4,40,2355,1104,1251
050,24,017,"Maryland","Charles County",4,41,2337,1102,1235
050,24,017,"Maryland","Charles County",4,42,2296,1095,1201
050,24,017,"Maryland","Charles County",4,43,2222,1053,1169
050,24,017,"Maryland","Charles County",4,44,2185,1050,1135
050,24,017,"Maryland","Charles County",4,45,2175,980,1195
050,24,017,"Maryland","Charles County",4,46,2124,956,1168
050,24,017,"Maryland","Charles County",4,47,2146,997,1149
050,24,017,"Maryland","Charles County",4,48,2155,987,1168
050,24,017,"Maryland","Charles County",4,49,2279,1022,1257
050,24,017,"Maryland","Charles County",4,50,2423,1133,1290
050,24,017,"Maryland","Charles County",4,51,2676,1244,1432
050,24,017,"Maryland","Charles County",4,52,2617,1229,1388
050,24,017,"Maryland","Charles County",4,53,2567,1212,1355
050,24,017,"Maryland","Charles County",4,54,2509,1158,1351
050,24,017,"Maryland","Charles County",4,55,2561,1220,1341
050,24,017,"Maryland","Charles County",4,56,2574,1241,1333
050,24,017,"Maryland","Charles County",4,57,2628,1260,1368
050,24,017,"Maryland","Charles County",4,58,2661,1247,1414
050,24,017,"Maryland","Charles County",4,59,2575,1243,1332
050,24,017,"Maryland","Charles County",4,60,2470,1216,1254
050,24,017,"Maryland","Charles County",4,61,2346,1157,1189
050,24,017,"Maryland","Charles County",4,62,2163,1047,1116
050,24,017,"Maryland","Charles County",4,63,2023,979,1044
050,24,017,"Maryland","Charles County",4,64,1918,911,1007
050,24,017,"Maryland","Charles County",4,65,1865,907,958
050,24,017,"Maryland","Charles County",4,66,1716,819,897
050,24,017,"Maryland","Charles County",4,67,1643,754,889
050,24,017,"Maryland","Charles County",4,68,1469,640,829
050,24,017,"Maryland","Charles County",4,69,1362,600,762
050,24,017,"Maryland","Charles County",4,70,1322,583,739
050,24,017,"Maryland","Charles County",4,71,1279,578,701
050,24,017,"Maryland","Charles County",4,72,1184,512,672
050,24,017,"Maryland","Charles County",4,73,1166,505,661
050,24,017,"Maryland","Charles County",4,74,1148,497,651
050,24,017,"Maryland","Charles County",4,75,1204,543,661
050,24,017,"Maryland","Charles County",4,76,870,384,486
050,24,017,"Maryland","Charles County",4,77,825,366,459
050,24,017,"Maryland","Charles County",4,78,778,341,437
050,24,017,"Maryland","Charles County",4,79,748,315,433
050,24,017,"Maryland","Charles County",4,80,644,292,352
050,24,017,"Maryland","Charles County",4,81,579,242,337
050,24,017,"Maryland","Charles County",4,82,469,200,269
050,24,017,"Maryland","Charles County",4,83,432,165,267
050,24,017,"Maryland","Charles County",4,84,410,146,264
050,24,017,"Maryland","Charles County",4,85,2216,741,1475
050,24,017,"Maryland","Charles County",5,0,1728,860,868
050,24,017,"Maryland","Charles County",5,1,1895,937,958
050,24,017,"Maryland","Charles County",5,2,1946,985,961
050,24,017,"Maryland","Charles County",5,3,2083,1057,1026
050,24,017,"Maryland","Charles County",5,4,2010,965,1045
050,24,017,"Maryland","Charles County",5,5,2121,1085,1036
050,24,017,"Maryland","Charles County",5,6,2189,1107,1082
050,24,017,"Maryland","Charles County",5,7,2223,1138,1085
050,24,017,"Maryland","Charles County",5,8,2224,1119,1105
050,24,017,"Maryland","Charles County",5,9,2270,1141,1129
050,24,017,"Maryland","Charles County",5,10,2295,1233,1062
050,24,017,"Maryland","Charles County",5,11,2381,1243,1138
050,24,017,"Maryland","Charles County",5,12,2487,1255,1232
050,24,017,"Maryland","Charles County",5,13,2490,1280,1210
050,24,017,"Maryland","Charles County",5,14,2521,1260,1261
050,24,017,"Maryland","Charles County",5,15,2682,1339,1343
050,24,017,"Maryland","Charles County",5,16,2632,1338,1294
050,24,017,"Maryland","Charles County",5,17,2567,1264,1303
050,24,017,"Maryland","Charles County",5,18,2177,1107,1070
050,24,017,"Maryland","Charles County",5,19,1897,995,902
050,24,017,"Maryland","Charles County",5,20,1941,999,942
050,24,017,"Maryland","Charles County",5,21,1984,1031,953
050,24,017,"Maryland","Charles County",5,22,2023,1042,981
050,24,017,"Maryland","Charles County",5,23,2056,1019,1037
050,24,017,"Maryland","Charles County",5,24,1967,1017,950
050,24,017,"Maryland","Charles County",5,25,1974,1008,966
050,24,017,"Maryland","Charles County",5,26,1976,1012,964
050,24,017,"Maryland","Charles County",5,27,1921,944,977
050,24,017,"Maryland","Charles County",5,28,2008,997,1011
050,24,017,"Maryland","Charles County",5,29,2121,1021,1100
050,24,017,"Maryland","Charles County",5,30,2062,1032,1030
050,24,017,"Maryland","Charles County",5,31,2237,1051,1186
050,24,017,"Maryland","Charles County",5,32,2278,1104,1174
050,24,017,"Maryland","Charles County",5,33,2366,1201,1165
050,24,017,"Maryland","Charles County",5,34,2362,1162,1200
050,24,017,"Maryland","Charles County",5,35,2353,1109,1244
050,24,017,"Maryland","Charles County",5,36,2371,1139,1232
050,24,017,"Maryland","Charles County",5,37,2333,1114,1219
050,24,017,"Maryland","Charles County",5,38,2482,1211,1271
050,24,017,"Maryland","Charles County",5,39,2428,1128,1300
050,24,017,"Maryland","Charles County",5,40,2453,1184,1269
050,24,017,"Maryland","Charles County",5,41,2378,1098,1280
050,24,017,"Maryland","Charles County",5,42,2368,1113,1255
050,24,017,"Maryland","Charles County",5,43,2357,1118,1239
050,24,017,"Maryland","Charles County",5,44,2262,1076,1186
050,24,017,"Maryland","Charles County",5,45,2214,1057,1157
050,24,017,"Maryland","Charles County",5,46,2228,1011,1217
050,24,017,"Maryland","Charles County",5,47,2155,959,1196
050,24,017,"Maryland","Charles County",5,48,2152,1002,1150
050,24,017,"Maryland","Charles County",5,49,2173,1000,1173
050,24,017,"Maryland","Charles County",5,50,2292,1026,1266
050,24,017,"Maryland","Charles County",5,51,2417,1138,1279
050,24,017,"Maryland","Charles County",5,52,2685,1251,1434
050,24,017,"Maryland","Charles County",5,53,2633,1256,1377
050,24,017,"Maryland","Charles County",5,54,2562,1199,1363
050,24,017,"Maryland","Charles County",5,55,2520,1173,1347
050,24,017,"Maryland","Charles County",5,56,2560,1217,1343
050,24,017,"Maryland","Charles County",5,57,2547,1207,1340
050,24,017,"Maryland","Charles County",5,58,2624,1239,1385
050,24,017,"Maryland","Charles County",5,59,2602,1213,1389
050,24,017,"Maryland","Charles County",5,60,2545,1227,1318
050,24,017,"Maryland","Charles County",5,61,2445,1208,1237
050,24,017,"Maryland","Charles County",5,62,2301,1130,1171
050,24,017,"Maryland","Charles County",5,63,2123,1013,1110
050,24,017,"Maryland","Charles County",5,64,1969,944,1025
050,24,017,"Maryland","Charles County",5,65,1917,896,1021
050,24,017,"Maryland","Charles County",5,66,1841,887,954
050,24,017,"Maryland","Charles County",5,67,1687,794,893
050,24,017,"Maryland","Charles County",5,68,1625,742,883
050,24,017,"Maryland","Charles County",5,69,1408,609,799
050,24,017,"Maryland","Charles County",5,70,1338,583,755
050,24,017,"Maryland","Charles County",5,71,1273,562,711
050,24,017,"Maryland","Charles County",5,72,1246,550,696
050,24,017,"Maryland","Charles County",5,73,1161,495,666
050,24,017,"Maryland","Charles County",5,74,1136,487,649
050,24,017,"Maryland","Charles County",5,75,1110,472,638
050,24,017,"Maryland","Charles County",5,76,1159,522,637
050,24,017,"Maryland","Charles County",5,77,838,359,479
050,24,017,"Maryland","Charles County",5,78,799,360,439
050,24,017,"Maryland","Charles County",5,79,742,320,422
050,24,017,"Maryland","Charles County",5,80,740,301,439
050,24,017,"Maryland","Charles County",5,81,608,276,332
050,24,017,"Maryland","Charles County",5,82,547,231,316
050,24,017,"Maryland","Charles County",5,83,412,168,244
050,24,017,"Maryland","Charles County",5,84,413,150,263
050,24,017,"Maryland","Charles County",5,85,2347,773,1574
050,24,019,"Maryland","Dorchester County",1,0,348,172,176
050,24,019,"Maryland","Dorchester County",1,1,352,170,182
050,24,019,"Maryland","Dorchester County",1,2,365,185,180
050,24,019,"Maryland","Dorchester County",1,3,362,177,185
050,24,019,"Maryland","Dorchester County",1,4,367,205,162
050,24,019,"Maryland","Dorchester County",1,5,363,196,167
050,24,019,"Maryland","Dorchester County",1,6,378,185,193
050,24,019,"Maryland","Dorchester County",1,7,386,191,195
050,24,019,"Maryland","Dorchester County",1,8,359,188,171
050,24,019,"Maryland","Dorchester County",1,9,363,195,168
050,24,019,"Maryland","Dorchester County",1,10,387,187,200
050,24,019,"Maryland","Dorchester County",1,11,413,207,206
050,24,019,"Maryland","Dorchester County",1,12,428,210,218
050,24,019,"Maryland","Dorchester County",1,13,409,199,210
050,24,019,"Maryland","Dorchester County",1,14,398,199,199
050,24,019,"Maryland","Dorchester County",1,15,382,201,181
050,24,019,"Maryland","Dorchester County",1,16,400,206,194
050,24,019,"Maryland","Dorchester County",1,17,362,183,179
050,24,019,"Maryland","Dorchester County",1,18,336,173,163
050,24,019,"Maryland","Dorchester County",1,19,287,148,139
050,24,019,"Maryland","Dorchester County",1,20,276,148,128
050,24,019,"Maryland","Dorchester County",1,21,297,159,138
050,24,019,"Maryland","Dorchester County",1,22,323,157,166
050,24,019,"Maryland","Dorchester County",1,23,341,166,175
050,24,019,"Maryland","Dorchester County",1,24,312,158,154
050,24,019,"Maryland","Dorchester County",1,25,352,165,187
050,24,019,"Maryland","Dorchester County",1,26,358,166,192
050,24,019,"Maryland","Dorchester County",1,27,379,161,218
050,24,019,"Maryland","Dorchester County",1,28,419,187,232
050,24,019,"Maryland","Dorchester County",1,29,443,203,240
050,24,019,"Maryland","Dorchester County",1,30,421,203,218
050,24,019,"Maryland","Dorchester County",1,31,413,200,213
050,24,019,"Maryland","Dorchester County",1,32,407,190,217
050,24,019,"Maryland","Dorchester County",1,33,361,170,191
050,24,019,"Maryland","Dorchester County",1,34,377,167,210
050,24,019,"Maryland","Dorchester County",1,35,360,166,194
050,24,019,"Maryland","Dorchester County",1,36,346,161,185
050,24,019,"Maryland","Dorchester County",1,37,361,178,183
050,24,019,"Maryland","Dorchester County",1,38,357,158,199
050,24,019,"Maryland","Dorchester County",1,39,325,151,174
050,24,019,"Maryland","Dorchester County",1,40,317,137,180
050,24,019,"Maryland","Dorchester County",1,41,321,145,176
050,24,019,"Maryland","Dorchester County",1,42,340,155,185
050,24,019,"Maryland","Dorchester County",1,43,342,149,193
050,24,019,"Maryland","Dorchester County",1,44,312,131,181
050,24,019,"Maryland","Dorchester County",1,45,329,157,172
050,24,019,"Maryland","Dorchester County",1,46,341,164,177
050,24,019,"Maryland","Dorchester County",1,47,357,158,199
050,24,019,"Maryland","Dorchester County",1,48,375,173,202
050,24,019,"Maryland","Dorchester County",1,49,398,184,214
050,24,019,"Maryland","Dorchester County",1,50,407,185,222
050,24,019,"Maryland","Dorchester County",1,51,386,185,201
050,24,019,"Maryland","Dorchester County",1,52,406,191,215
050,24,019,"Maryland","Dorchester County",1,53,453,214,239
050,24,019,"Maryland","Dorchester County",1,54,460,223,237
050,24,019,"Maryland","Dorchester County",1,55,491,246,245
050,24,019,"Maryland","Dorchester County",1,56,484,234,250
050,24,019,"Maryland","Dorchester County",1,57,505,249,256
050,24,019,"Maryland","Dorchester County",1,58,502,248,254
050,24,019,"Maryland","Dorchester County",1,59,540,259,281
050,24,019,"Maryland","Dorchester County",1,60,519,250,269
050,24,019,"Maryland","Dorchester County",1,61,558,247,311
050,24,019,"Maryland","Dorchester County",1,62,550,257,293
050,24,019,"Maryland","Dorchester County",1,63,504,239,265
050,24,019,"Maryland","Dorchester County",1,64,495,236,259
050,24,019,"Maryland","Dorchester County",1,65,475,219,256
050,24,019,"Maryland","Dorchester County",1,66,484,226,258
050,24,019,"Maryland","Dorchester County",1,67,463,229,234
050,24,019,"Maryland","Dorchester County",1,68,439,207,232
050,24,019,"Maryland","Dorchester County",1,69,406,178,228
050,24,019,"Maryland","Dorchester County",1,70,405,173,232
050,24,019,"Maryland","Dorchester County",1,71,412,191,221
050,24,019,"Maryland","Dorchester County",1,72,430,211,219
050,24,019,"Maryland","Dorchester County",1,73,411,207,204
050,24,019,"Maryland","Dorchester County",1,74,296,148,148
050,24,019,"Maryland","Dorchester County",1,75,296,129,167
050,24,019,"Maryland","Dorchester County",1,76,302,133,169
050,24,019,"Maryland","Dorchester County",1,77,279,123,156
050,24,019,"Maryland","Dorchester County",1,78,248,113,135
050,24,019,"Maryland","Dorchester County",1,79,223,99,124
050,24,019,"Maryland","Dorchester County",1,80,183,85,98
050,24,019,"Maryland","Dorchester County",1,81,189,89,100
050,24,019,"Maryland","Dorchester County",1,82,175,72,103
050,24,019,"Maryland","Dorchester County",1,83,142,60,82
050,24,019,"Maryland","Dorchester County",1,84,138,56,82
050,24,019,"Maryland","Dorchester County",1,85,768,287,481
050,24,019,"Maryland","Dorchester County",2,0,359,183,176
050,24,019,"Maryland","Dorchester County",2,1,352,172,180
050,24,019,"Maryland","Dorchester County",2,2,360,180,180
050,24,019,"Maryland","Dorchester County",2,3,361,177,184
050,24,019,"Maryland","Dorchester County",2,4,366,197,169
050,24,019,"Maryland","Dorchester County",2,5,364,197,167
050,24,019,"Maryland","Dorchester County",2,6,370,185,185
050,24,019,"Maryland","Dorchester County",2,7,384,188,196
050,24,019,"Maryland","Dorchester County",2,8,364,189,175
050,24,019,"Maryland","Dorchester County",2,9,365,193,172
050,24,019,"Maryland","Dorchester County",2,10,380,186,194
050,24,019,"Maryland","Dorchester County",2,11,407,202,205
050,24,019,"Maryland","Dorchester County",2,12,426,208,218
050,24,019,"Maryland","Dorchester County",2,13,409,201,208
050,24,019,"Maryland","Dorchester County",2,14,400,198,202
050,24,019,"Maryland","Dorchester County",2,15,383,197,186
050,24,019,"Maryland","Dorchester County",2,16,392,203,189
050,24,019,"Maryland","Dorchester County",2,17,368,187,181
050,24,019,"Maryland","Dorchester County",2,18,330,169,161
050,24,019,"Maryland","Dorchester County",2,19,287,148,139
050,24,019,"Maryland","Dorchester County",2,20,287,151,136
050,24,019,"Maryland","Dorchester County",2,21,293,156,137
050,24,019,"Maryland","Dorchester County",2,22,320,158,162
050,24,019,"Maryland","Dorchester County",2,23,341,166,175
050,24,019,"Maryland","Dorchester County",2,24,323,161,162
050,24,019,"Maryland","Dorchester County",2,25,342,165,177
050,24,019,"Maryland","Dorchester County",2,26,358,165,193
050,24,019,"Maryland","Dorchester County",2,27,375,161,214
050,24,019,"Maryland","Dorchester County",2,28,408,180,228
050,24,019,"Maryland","Dorchester County",2,29,436,199,237
050,24,019,"Maryland","Dorchester County",2,30,432,208,224
050,24,019,"Maryland","Dorchester County",2,31,419,204,215
050,24,019,"Maryland","Dorchester County",2,32,411,194,217
050,24,019,"Maryland","Dorchester County",2,33,371,175,196
050,24,019,"Maryland","Dorchester County",2,34,369,167,202
050,24,019,"Maryland","Dorchester County",2,35,365,168,197
050,24,019,"Maryland","Dorchester County",2,36,350,165,185
050,24,019,"Maryland","Dorchester County",2,37,358,175,183
050,24,019,"Maryland","Dorchester County",2,38,356,162,194
050,24,019,"Maryland","Dorchester County",2,39,332,153,179
050,24,019,"Maryland","Dorchester County",2,40,320,141,179
050,24,019,"Maryland","Dorchester County",2,41,319,144,175
050,24,019,"Maryland","Dorchester County",2,42,333,151,182
050,24,019,"Maryland","Dorchester County",2,43,342,150,192
050,24,019,"Maryland","Dorchester County",2,44,317,135,182
050,24,019,"Maryland","Dorchester County",2,45,328,151,177
050,24,019,"Maryland","Dorchester County",2,46,336,161,175
050,24,019,"Maryland","Dorchester County",2,47,354,159,195
050,24,019,"Maryland","Dorchester County",2,48,372,171,201
050,24,019,"Maryland","Dorchester County",2,49,394,182,212
050,24,019,"Maryland","Dorchester County",2,50,406,185,221
050,24,019,"Maryland","Dorchester County",2,51,387,183,204
050,24,019,"Maryland","Dorchester County",2,52,400,189,211
050,24,019,"Maryland","Dorchester County",2,53,443,210,233
050,24,019,"Maryland","Dorchester County",2,54,459,221,238
050,24,019,"Maryland","Dorchester County",2,55,486,240,246
050,24,019,"Maryland","Dorchester County",2,56,487,240,247
050,24,019,"Maryland","Dorchester County",2,57,504,248,256
050,24,019,"Maryland","Dorchester County",2,58,501,245,256
050,24,019,"Maryland","Dorchester County",2,59,532,257,275
050,24,019,"Maryland","Dorchester County",2,60,526,252,274
050,24,019,"Maryland","Dorchester County",2,61,548,246,302
050,24,019,"Maryland","Dorchester County",2,62,548,252,296
050,24,019,"Maryland","Dorchester County",2,63,518,245,273
050,24,019,"Maryland","Dorchester County",2,64,494,234,260
050,24,019,"Maryland","Dorchester County",2,65,479,222,257
050,24,019,"Maryland","Dorchester County",2,66,486,227,259
050,24,019,"Maryland","Dorchester County",2,67,470,229,241
050,24,019,"Maryland","Dorchester County",2,68,434,204,230
050,24,019,"Maryland","Dorchester County",2,69,417,186,231
050,24,019,"Maryland","Dorchester County",2,70,408,176,232
050,24,019,"Maryland","Dorchester County",2,71,409,187,222
050,24,019,"Maryland","Dorchester County",2,72,420,205,215
050,24,019,"Maryland","Dorchester County",2,73,431,216,215
050,24,019,"Maryland","Dorchester County",2,74,303,150,153
050,24,019,"Maryland","Dorchester County",2,75,296,133,163
050,24,019,"Maryland","Dorchester County",2,76,295,130,165
050,24,019,"Maryland","Dorchester County",2,77,285,123,162
050,24,019,"Maryland","Dorchester County",2,78,248,110,138
050,24,019,"Maryland","Dorchester County",2,79,226,100,126
050,24,019,"Maryland","Dorchester County",2,80,189,85,104
050,24,019,"Maryland","Dorchester County",2,81,183,86,97
050,24,019,"Maryland","Dorchester County",2,82,177,76,101
050,24,019,"Maryland","Dorchester County",2,83,148,62,86
050,24,019,"Maryland","Dorchester County",2,84,134,54,80
050,24,019,"Maryland","Dorchester County",2,85,765,283,482
050,24,019,"Maryland","Dorchester County",3,0,342,168,174
050,24,019,"Maryland","Dorchester County",3,1,367,180,187
050,24,019,"Maryland","Dorchester County",3,2,355,180,175
050,24,019,"Maryland","Dorchester County",3,3,353,176,177
050,24,019,"Maryland","Dorchester County",3,4,364,177,187
050,24,019,"Maryland","Dorchester County",3,5,372,196,176
050,24,019,"Maryland","Dorchester County",3,6,366,194,172
050,24,019,"Maryland","Dorchester County",3,7,367,183,184
050,24,019,"Maryland","Dorchester County",3,8,394,194,200
050,24,019,"Maryland","Dorchester County",3,9,365,190,175
050,24,019,"Maryland","Dorchester County",3,10,366,191,175
050,24,019,"Maryland","Dorchester County",3,11,393,194,199
050,24,019,"Maryland","Dorchester County",3,12,417,203,214
050,24,019,"Maryland","Dorchester County",3,13,441,222,219
050,24,019,"Maryland","Dorchester County",3,14,403,200,203
050,24,019,"Maryland","Dorchester County",3,15,400,196,204
050,24,019,"Maryland","Dorchester County",3,16,382,197,185
050,24,019,"Maryland","Dorchester County",3,17,391,205,186
050,24,019,"Maryland","Dorchester County",3,18,323,167,156
050,24,019,"Maryland","Dorchester County",3,19,290,150,140
050,24,019,"Maryland","Dorchester County",3,20,301,157,144
050,24,019,"Maryland","Dorchester County",3,21,305,157,148
050,24,019,"Maryland","Dorchester County",3,22,291,153,138
050,24,019,"Maryland","Dorchester County",3,23,334,168,166
050,24,019,"Maryland","Dorchester County",3,24,331,160,171
050,24,019,"Maryland","Dorchester County",3,25,329,154,175
050,24,019,"Maryland","Dorchester County",3,26,345,170,175
050,24,019,"Maryland","Dorchester County",3,27,363,161,202
050,24,019,"Maryland","Dorchester County",3,28,368,158,210
050,24,019,"Maryland","Dorchester County",3,29,405,176,229
050,24,019,"Maryland","Dorchester County",3,30,431,196,235
050,24,019,"Maryland","Dorchester County",3,31,420,204,216
050,24,019,"Maryland","Dorchester County",3,32,413,201,212
050,24,019,"Maryland","Dorchester County",3,33,412,185,227
050,24,019,"Maryland","Dorchester County",3,34,368,164,204
050,24,019,"Maryland","Dorchester County",3,35,374,165,209
050,24,019,"Maryland","Dorchester County",3,36,384,174,210
050,24,019,"Maryland","Dorchester County",3,37,370,170,200
050,24,019,"Maryland","Dorchester County",3,38,356,169,187
050,24,019,"Maryland","Dorchester County",3,39,352,158,194
050,24,019,"Maryland","Dorchester County",3,40,339,155,184
050,24,019,"Maryland","Dorchester County",3,41,321,142,179
050,24,019,"Maryland","Dorchester County",3,42,328,150,178
050,24,019,"Maryland","Dorchester County",3,43,343,158,185
050,24,019,"Maryland","Dorchester County",3,44,347,157,190
050,24,019,"Maryland","Dorchester County",3,45,319,132,187
050,24,019,"Maryland","Dorchester County",3,46,319,147,172
050,24,019,"Maryland","Dorchester County",3,47,324,157,167
050,24,019,"Maryland","Dorchester County",3,48,352,164,188
050,24,019,"Maryland","Dorchester County",3,49,362,164,198
050,24,019,"Maryland","Dorchester County",3,50,381,173,208
050,24,019,"Maryland","Dorchester County",3,51,401,189,212
050,24,019,"Maryland","Dorchester County",3,52,389,183,206
050,24,019,"Maryland","Dorchester County",3,53,408,191,217
050,24,019,"Maryland","Dorchester County",3,54,440,204,236
050,24,019,"Maryland","Dorchester County",3,55,465,229,236
050,24,019,"Maryland","Dorchester County",3,56,494,236,258
050,24,019,"Maryland","Dorchester County",3,57,490,247,243
050,24,019,"Maryland","Dorchester County",3,58,518,254,264
050,24,019,"Maryland","Dorchester County",3,59,505,249,256
050,24,019,"Maryland","Dorchester County",3,60,531,250,281
050,24,019,"Maryland","Dorchester County",3,61,525,251,274
050,24,019,"Maryland","Dorchester County",3,62,554,256,298
050,24,019,"Maryland","Dorchester County",3,63,549,244,305
050,24,019,"Maryland","Dorchester County",3,64,523,249,274
050,24,019,"Maryland","Dorchester County",3,65,490,234,256
050,24,019,"Maryland","Dorchester County",3,66,480,224,256
050,24,019,"Maryland","Dorchester County",3,67,480,226,254
050,24,019,"Maryland","Dorchester County",3,68,465,227,238
050,24,019,"Maryland","Dorchester County",3,69,419,200,219
050,24,019,"Maryland","Dorchester County",3,70,410,177,233
050,24,019,"Maryland","Dorchester County",3,71,399,168,231
050,24,019,"Maryland","Dorchester County",3,72,406,183,223
050,24,019,"Maryland","Dorchester County",3,73,414,205,209
050,24,019,"Maryland","Dorchester County",3,74,411,200,211
050,24,019,"Maryland","Dorchester County",3,75,294,142,152
050,24,019,"Maryland","Dorchester County",3,76,283,127,156
050,24,019,"Maryland","Dorchester County",3,77,282,121,161
050,24,019,"Maryland","Dorchester County",3,78,272,120,152
050,24,019,"Maryland","Dorchester County",3,79,229,104,125
050,24,019,"Maryland","Dorchester County",3,80,209,92,117
050,24,019,"Maryland","Dorchester County",3,81,178,80,98
050,24,019,"Maryland","Dorchester County",3,82,178,80,98
050,24,019,"Maryland","Dorchester County",3,83,172,74,98
050,24,019,"Maryland","Dorchester County",3,84,128,52,76
050,24,019,"Maryland","Dorchester County",3,85,765,277,488
050,24,019,"Maryland","Dorchester County",4,0,339,169,170
050,24,019,"Maryland","Dorchester County",4,1,364,171,193
050,24,019,"Maryland","Dorchester County",4,2,364,179,185
050,24,019,"Maryland","Dorchester County",4,3,357,182,175
050,24,019,"Maryland","Dorchester County",4,4,355,179,176
050,24,019,"Maryland","Dorchester County",4,5,380,194,186
050,24,019,"Maryland","Dorchester County",4,6,373,195,178
050,24,019,"Maryland","Dorchester County",4,7,371,203,168
050,24,019,"Maryland","Dorchester County",4,8,373,194,179
050,24,019,"Maryland","Dorchester County",4,9,391,189,202
050,24,019,"Maryland","Dorchester County",4,10,379,197,182
050,24,019,"Maryland","Dorchester County",4,11,369,193,176
050,24,019,"Maryland","Dorchester County",4,12,378,183,195
050,24,019,"Maryland","Dorchester County",4,13,403,195,208
050,24,019,"Maryland","Dorchester County",4,14,431,222,209
050,24,019,"Maryland","Dorchester County",4,15,398,191,207
050,24,019,"Maryland","Dorchester County",4,16,391,190,201
050,24,019,"Maryland","Dorchester County",4,17,380,194,186
050,24,019,"Maryland","Dorchester County",4,18,333,181,152
050,24,019,"Maryland","Dorchester County",4,19,268,139,129
050,24,019,"Maryland","Dorchester County",4,20,290,143,147
050,24,019,"Maryland","Dorchester County",4,21,314,162,152
050,24,019,"Maryland","Dorchester County",4,22,312,155,157
050,24,019,"Maryland","Dorchester County",4,23,327,172,155
050,24,019,"Maryland","Dorchester County",4,24,335,169,166
050,24,019,"Maryland","Dorchester County",4,25,342,160,182
050,24,019,"Maryland","Dorchester County",4,26,344,162,182
050,24,019,"Maryland","Dorchester County",4,27,352,172,180
050,24,019,"Maryland","Dorchester County",4,28,364,161,203
050,24,019,"Maryland","Dorchester County",4,29,369,153,216
050,24,019,"Maryland","Dorchester County",4,30,419,183,236
050,24,019,"Maryland","Dorchester County",4,31,439,203,236
050,24,019,"Maryland","Dorchester County",4,32,413,199,214
050,24,019,"Maryland","Dorchester County",4,33,420,204,216
050,24,019,"Maryland","Dorchester County",4,34,399,173,226
050,24,019,"Maryland","Dorchester County",4,35,365,161,204
050,24,019,"Maryland","Dorchester County",4,36,374,161,213
050,24,019,"Maryland","Dorchester County",4,37,383,175,208
050,24,019,"Maryland","Dorchester County",4,38,362,165,197
050,24,019,"Maryland","Dorchester County",4,39,344,161,183
050,24,019,"Maryland","Dorchester County",4,40,342,150,192
050,24,019,"Maryland","Dorchester County",4,41,339,165,174
050,24,019,"Maryland","Dorchester County",4,42,312,139,173
050,24,019,"Maryland","Dorchester County",4,43,332,155,177
050,24,019,"Maryland","Dorchester County",4,44,350,152,198
050,24,019,"Maryland","Dorchester County",4,45,346,154,192
050,24,019,"Maryland","Dorchester County",4,46,320,131,189
050,24,019,"Maryland","Dorchester County",4,47,323,154,169
050,24,019,"Maryland","Dorchester County",4,48,333,168,165
050,24,019,"Maryland","Dorchester County",4,49,346,162,184
050,24,019,"Maryland","Dorchester County",4,50,367,167,200
050,24,019,"Maryland","Dorchester County",4,51,398,181,217
050,24,019,"Maryland","Dorchester County",4,52,411,191,220
050,24,019,"Maryland","Dorchester County",4,53,416,204,212
050,24,019,"Maryland","Dorchester County",4,54,401,183,218
050,24,019,"Maryland","Dorchester County",4,55,438,203,235
050,24,019,"Maryland","Dorchester County",4,56,481,237,244
050,24,019,"Maryland","Dorchester County",4,57,495,237,258
050,24,019,"Maryland","Dorchester County",4,58,483,240,243
050,24,019,"Maryland","Dorchester County",4,59,515,257,258
050,24,019,"Maryland","Dorchester County",4,60,507,247,260
050,24,019,"Maryland","Dorchester County",4,61,535,253,282
050,24,019,"Maryland","Dorchester County",4,62,509,244,265
050,24,019,"Maryland","Dorchester County",4,63,541,255,286
050,24,019,"Maryland","Dorchester County",4,64,538,235,303
050,24,019,"Maryland","Dorchester County",4,65,522,248,274
050,24,019,"Maryland","Dorchester County",4,66,488,237,251
050,24,019,"Maryland","Dorchester County",4,67,477,222,255
050,24,019,"Maryland","Dorchester County",4,68,481,224,257
050,24,019,"Maryland","Dorchester County",4,69,466,231,235
050,24,019,"Maryland","Dorchester County",4,70,413,197,216
050,24,019,"Maryland","Dorchester County",4,71,402,165,237
050,24,019,"Maryland","Dorchester County",4,72,389,159,230
050,24,019,"Maryland","Dorchester County",4,73,389,172,217
050,24,019,"Maryland","Dorchester County",4,74,409,204,205
050,24,019,"Maryland","Dorchester County",4,75,408,190,218
050,24,019,"Maryland","Dorchester County",4,76,274,133,141
050,24,019,"Maryland","Dorchester County",4,77,278,122,156
050,24,019,"Maryland","Dorchester County",4,78,266,118,148
050,24,019,"Maryland","Dorchester County",4,79,248,104,144
050,24,019,"Maryland","Dorchester County",4,80,205,93,112
050,24,019,"Maryland","Dorchester County",4,81,190,83,107
050,24,019,"Maryland","Dorchester County",4,82,172,74,98
050,24,019,"Maryland","Dorchester County",4,83,171,77,94
050,24,019,"Maryland","Dorchester County",4,84,146,59,87
050,24,019,"Maryland","Dorchester County",4,85,747,263,484
050,24,019,"Maryland","Dorchester County",5,0,341,171,170
050,24,019,"Maryland","Dorchester County",5,1,361,174,187
050,24,019,"Maryland","Dorchester County",5,2,356,157,199
050,24,019,"Maryland","Dorchester County",5,3,366,188,178
050,24,019,"Maryland","Dorchester County",5,4,362,174,188
050,24,019,"Maryland","Dorchester County",5,5,361,189,172
050,24,019,"Maryland","Dorchester County",5,6,384,198,186
050,24,019,"Maryland","Dorchester County",5,7,378,198,180
050,24,019,"Maryland","Dorchester County",5,8,380,209,171
050,24,019,"Maryland","Dorchester County",5,9,377,199,178
050,24,019,"Maryland","Dorchester County",5,10,395,194,201
050,24,019,"Maryland","Dorchester County",5,11,375,195,180
050,24,019,"Maryland","Dorchester County",5,12,367,186,181
050,24,019,"Maryland","Dorchester County",5,13,369,180,189
050,24,019,"Maryland","Dorchester County",5,14,392,195,197
050,24,019,"Maryland","Dorchester County",5,15,427,222,205
050,24,019,"Maryland","Dorchester County",5,16,404,201,203
050,24,019,"Maryland","Dorchester County",5,17,388,190,198
050,24,019,"Maryland","Dorchester County",5,18,322,172,150
050,24,019,"Maryland","Dorchester County",5,19,281,151,130
050,24,019,"Maryland","Dorchester County",5,20,294,151,143
050,24,019,"Maryland","Dorchester County",5,21,315,150,165
050,24,019,"Maryland","Dorchester County",5,22,329,161,168
050,24,019,"Maryland","Dorchester County",5,23,355,172,183
050,24,019,"Maryland","Dorchester County",5,24,341,174,167
050,24,019,"Maryland","Dorchester County",5,25,344,172,172
050,24,019,"Maryland","Dorchester County",5,26,367,169,198
050,24,019,"Maryland","Dorchester County",5,27,339,157,182
050,24,019,"Maryland","Dorchester County",5,28,371,185,186
050,24,019,"Maryland","Dorchester County",5,29,397,181,216
050,24,019,"Maryland","Dorchester County",5,30,391,172,219
050,24,019,"Maryland","Dorchester County",5,31,433,192,241
050,24,019,"Maryland","Dorchester County",5,32,452,207,245
050,24,019,"Maryland","Dorchester County",5,33,427,207,220
050,24,019,"Maryland","Dorchester County",5,34,434,209,225
050,24,019,"Maryland","Dorchester County",5,35,397,173,224
050,24,019,"Maryland","Dorchester County",5,36,360,159,201
050,24,019,"Maryland","Dorchester County",5,37,379,163,216
050,24,019,"Maryland","Dorchester County",5,38,383,171,212
050,24,019,"Maryland","Dorchester County",5,39,381,170,211
050,24,019,"Maryland","Dorchester County",5,40,357,172,185
050,24,019,"Maryland","Dorchester County",5,41,333,152,181
050,24,019,"Maryland","Dorchester County",5,42,349,165,184
050,24,019,"Maryland","Dorchester County",5,43,323,145,178
050,24,019,"Maryland","Dorchester County",5,44,326,151,175
050,24,019,"Maryland","Dorchester County",5,45,360,154,206
050,24,019,"Maryland","Dorchester County",5,46,342,154,188
050,24,019,"Maryland","Dorchester County",5,47,318,133,185
050,24,019,"Maryland","Dorchester County",5,48,322,155,167
050,24,019,"Maryland","Dorchester County",5,49,321,156,165
050,24,019,"Maryland","Dorchester County",5,50,338,157,181
050,24,019,"Maryland","Dorchester County",5,51,369,165,204
050,24,019,"Maryland","Dorchester County",5,52,412,180,232
050,24,019,"Maryland","Dorchester County",5,53,416,193,223
050,24,019,"Maryland","Dorchester County",5,54,413,203,210
050,24,019,"Maryland","Dorchester County",5,55,403,187,216
050,24,019,"Maryland","Dorchester County",5,56,441,210,231
050,24,019,"Maryland","Dorchester County",5,57,487,243,244
050,24,019,"Maryland","Dorchester County",5,58,502,239,263
050,24,019,"Maryland","Dorchester County",5,59,486,240,246
050,24,019,"Maryland","Dorchester County",5,60,526,260,266
050,24,019,"Maryland","Dorchester County",5,61,511,253,258
050,24,019,"Maryland","Dorchester County",5,62,524,247,277
050,24,019,"Maryland","Dorchester County",5,63,510,249,261
050,24,019,"Maryland","Dorchester County",5,64,555,257,298
050,24,019,"Maryland","Dorchester County",5,65,550,245,305
050,24,019,"Maryland","Dorchester County",5,66,519,251,268
050,24,019,"Maryland","Dorchester County",5,67,486,234,252
050,24,019,"Maryland","Dorchester County",5,68,472,223,249
050,24,019,"Maryland","Dorchester County",5,69,487,227,260
050,24,019,"Maryland","Dorchester County",5,70,464,228,236
050,24,019,"Maryland","Dorchester County",5,71,402,187,215
050,24,019,"Maryland","Dorchester County",5,72,394,161,233
050,24,019,"Maryland","Dorchester County",5,73,379,157,222
050,24,019,"Maryland","Dorchester County",5,74,374,165,209
050,24,019,"Maryland","Dorchester County",5,75,389,186,203
050,24,019,"Maryland","Dorchester County",5,76,384,182,202
050,24,019,"Maryland","Dorchester County",5,77,274,133,141
050,24,019,"Maryland","Dorchester County",5,78,272,122,150
050,24,019,"Maryland","Dorchester County",5,79,248,108,140
050,24,019,"Maryland","Dorchester County",5,80,223,95,128
050,24,019,"Maryland","Dorchester County",5,81,190,86,104
050,24,019,"Maryland","Dorchester County",5,82,186,80,106
050,24,019,"Maryland","Dorchester County",5,83,168,73,95
050,24,019,"Maryland","Dorchester County",5,84,149,66,83
050,24,019,"Maryland","Dorchester County",5,85,750,254,496
050,24,021,"Maryland","Frederick County",1,0,3041,1545,1496
050,24,021,"Maryland","Frederick County",1,1,3089,1580,1509
050,24,021,"Maryland","Frederick County",1,2,3143,1585,1558
050,24,021,"Maryland","Frederick County",1,3,3345,1675,1670
050,24,021,"Maryland","Frederick County",1,4,3428,1684,1744
050,24,021,"Maryland","Frederick County",1,5,3436,1753,1683
050,24,021,"Maryland","Frederick County",1,6,3450,1788,1662
050,24,021,"Maryland","Frederick County",1,7,3427,1727,1700
050,24,021,"Maryland","Frederick County",1,8,3477,1784,1693
050,24,021,"Maryland","Frederick County",1,9,3557,1833,1724
050,24,021,"Maryland","Frederick County",1,10,3592,1880,1712
050,24,021,"Maryland","Frederick County",1,11,3715,1871,1844
050,24,021,"Maryland","Frederick County",1,12,3950,2026,1924
050,24,021,"Maryland","Frederick County",1,13,3939,2038,1901
050,24,021,"Maryland","Frederick County",1,14,3809,1946,1863
050,24,021,"Maryland","Frederick County",1,15,3733,1876,1857
050,24,021,"Maryland","Frederick County",1,16,3761,1918,1843
050,24,021,"Maryland","Frederick County",1,17,3677,1884,1793
050,24,021,"Maryland","Frederick County",1,18,3681,1856,1825
050,24,021,"Maryland","Frederick County",1,19,3383,1684,1699
050,24,021,"Maryland","Frederick County",1,20,3396,1731,1665
050,24,021,"Maryland","Frederick County",1,21,3388,1655,1733
050,24,021,"Maryland","Frederick County",1,22,3176,1610,1566
050,24,021,"Maryland","Frederick County",1,23,2937,1530,1407
050,24,021,"Maryland","Frederick County",1,24,2950,1514,1436
050,24,021,"Maryland","Frederick County",1,25,3009,1556,1453
050,24,021,"Maryland","Frederick County",1,26,3091,1585,1506
050,24,021,"Maryland","Frederick County",1,27,3177,1619,1558
050,24,021,"Maryland","Frederick County",1,28,3213,1610,1603
050,24,021,"Maryland","Frederick County",1,29,3283,1661,1622
050,24,021,"Maryland","Frederick County",1,30,3436,1748,1688
050,24,021,"Maryland","Frederick County",1,31,3505,1737,1768
050,24,021,"Maryland","Frederick County",1,32,3631,1819,1812
050,24,021,"Maryland","Frederick County",1,33,3745,1891,1854
050,24,021,"Maryland","Frederick County",1,34,3887,1939,1948
050,24,021,"Maryland","Frederick County",1,35,3888,1928,1960
050,24,021,"Maryland","Frederick County",1,36,3910,1997,1913
050,24,021,"Maryland","Frederick County",1,37,3948,1969,1979
050,24,021,"Maryland","Frederick County",1,38,3813,1895,1918
050,24,021,"Maryland","Frederick County",1,39,3823,1904,1919
050,24,021,"Maryland","Frederick County",1,40,3793,1894,1899
050,24,021,"Maryland","Frederick County",1,41,3651,1878,1773
050,24,021,"Maryland","Frederick County",1,42,3644,1837,1807
050,24,021,"Maryland","Frederick County",1,43,3529,1768,1761
050,24,021,"Maryland","Frederick County",1,44,3356,1676,1680
050,24,021,"Maryland","Frederick County",1,45,3326,1674,1652
050,24,021,"Maryland","Frederick County",1,46,3267,1627,1640
050,24,021,"Maryland","Frederick County",1,47,3437,1736,1701
050,24,021,"Maryland","Frederick County",1,48,3750,1886,1864
050,24,021,"Maryland","Frederick County",1,49,4051,2027,2024
050,24,021,"Maryland","Frederick County",1,50,3939,1974,1965
050,24,021,"Maryland","Frederick County",1,51,3790,1924,1866
050,24,021,"Maryland","Frederick County",1,52,3774,1893,1881
050,24,021,"Maryland","Frederick County",1,53,3914,1945,1969
050,24,021,"Maryland","Frederick County",1,54,3965,1986,1979
050,24,021,"Maryland","Frederick County",1,55,4047,2027,2020
050,24,021,"Maryland","Frederick County",1,56,4042,2019,2023
050,24,021,"Maryland","Frederick County",1,57,4103,2032,2071
050,24,021,"Maryland","Frederick County",1,58,4121,2086,2035
050,24,021,"Maryland","Frederick County",1,59,3788,1894,1894
050,24,021,"Maryland","Frederick County",1,60,3623,1767,1856
050,24,021,"Maryland","Frederick County",1,61,3559,1768,1791
050,24,021,"Maryland","Frederick County",1,62,3363,1633,1730
050,24,021,"Maryland","Frederick County",1,63,3127,1525,1602
050,24,021,"Maryland","Frederick County",1,64,3068,1515,1553
050,24,021,"Maryland","Frederick County",1,65,2947,1432,1515
050,24,021,"Maryland","Frederick County",1,66,2836,1373,1463
050,24,021,"Maryland","Frederick County",1,67,2676,1258,1418
050,24,021,"Maryland","Frederick County",1,68,2533,1206,1327
050,24,021,"Maryland","Frederick County",1,69,2384,1117,1267
050,24,021,"Maryland","Frederick County",1,70,2209,1047,1162
050,24,021,"Maryland","Frederick County",1,71,2209,1062,1147
050,24,021,"Maryland","Frederick County",1,72,2296,1107,1189
050,24,021,"Maryland","Frederick County",1,73,2314,1118,1196
050,24,021,"Maryland","Frederick County",1,74,1582,738,844
050,24,021,"Maryland","Frederick County",1,75,1505,693,812
050,24,021,"Maryland","Frederick County",1,76,1491,657,834
050,24,021,"Maryland","Frederick County",1,77,1444,642,802
050,24,021,"Maryland","Frederick County",1,78,1355,580,775
050,24,021,"Maryland","Frederick County",1,79,1191,508,683
050,24,021,"Maryland","Frederick County",1,80,979,426,553
050,24,021,"Maryland","Frederick County",1,81,948,405,543
050,24,021,"Maryland","Frederick County",1,82,883,359,524
050,24,021,"Maryland","Frederick County",1,83,781,339,442
050,24,021,"Maryland","Frederick County",1,84,708,303,405
050,24,021,"Maryland","Frederick County",1,85,4573,1489,3084
050,24,021,"Maryland","Frederick County",2,0,3088,1571,1517
050,24,021,"Maryland","Frederick County",2,1,3106,1590,1516
050,24,021,"Maryland","Frederick County",2,2,3167,1602,1565
050,24,021,"Maryland","Frederick County",2,3,3321,1663,1658
050,24,021,"Maryland","Frederick County",2,4,3441,1695,1746
050,24,021,"Maryland","Frederick County",2,5,3459,1753,1706
050,24,021,"Maryland","Frederick County",2,6,3479,1797,1682
050,24,021,"Maryland","Frederick County",2,7,3457,1753,1704
050,24,021,"Maryland","Frederick County",2,8,3476,1779,1697
050,24,021,"Maryland","Frederick County",2,9,3552,1837,1715
050,24,021,"Maryland","Frederick County",2,10,3600,1876,1724
050,24,021,"Maryland","Frederick County",2,11,3695,1879,1816
050,24,021,"Maryland","Frederick County",2,12,3930,2010,1920
050,24,021,"Maryland","Frederick County",2,13,3956,2046,1910
050,24,021,"Maryland","Frederick County",2,14,3853,1971,1882
050,24,021,"Maryland","Frederick County",2,15,3768,1901,1867
050,24,021,"Maryland","Frederick County",2,16,3772,1918,1854
050,24,021,"Maryland","Frederick County",2,17,3696,1895,1801
050,24,021,"Maryland","Frederick County",2,18,3645,1837,1808
050,24,021,"Maryland","Frederick County",2,19,3393,1691,1702
050,24,021,"Maryland","Frederick County",2,20,3449,1760,1689
050,24,021,"Maryland","Frederick County",2,21,3384,1654,1730
050,24,021,"Maryland","Frederick County",2,22,3196,1616,1580
050,24,021,"Maryland","Frederick County",2,23,2959,1531,1428
050,24,021,"Maryland","Frederick County",2,24,2953,1522,1431
050,24,021,"Maryland","Frederick County",2,25,3002,1550,1452
050,24,021,"Maryland","Frederick County",2,26,3096,1592,1504
050,24,021,"Maryland","Frederick County",2,27,3174,1622,1552
050,24,021,"Maryland","Frederick County",2,28,3225,1623,1602
050,24,021,"Maryland","Frederick County",2,29,3293,1658,1635
050,24,021,"Maryland","Frederick County",2,30,3448,1753,1695
050,24,021,"Maryland","Frederick County",2,31,3504,1745,1759
050,24,021,"Maryland","Frederick County",2,32,3635,1811,1824
050,24,021,"Maryland","Frederick County",2,33,3740,1888,1852
050,24,021,"Maryland","Frederick County",2,34,3880,1939,1941
050,24,021,"Maryland","Frederick County",2,35,3944,1961,1983
050,24,021,"Maryland","Frederick County",2,36,3915,1983,1932
050,24,021,"Maryland","Frederick County",2,37,3979,1990,1989
050,24,021,"Maryland","Frederick County",2,38,3897,1938,1959
050,24,021,"Maryland","Frederick County",2,39,3834,1910,1924
050,24,021,"Maryland","Frederick County",2,40,3862,1938,1924
050,24,021,"Maryland","Frederick County",2,41,3698,1883,1815
050,24,021,"Maryland","Frederick County",2,42,3659,1855,1804
050,24,021,"Maryland","Frederick County",2,43,3596,1803,1793
050,24,021,"Maryland","Frederick County",2,44,3380,1691,1689
050,24,021,"Maryland","Frederick County",2,45,3364,1692,1672
050,24,021,"Maryland","Frederick County",2,46,3282,1638,1644
050,24,021,"Maryland","Frederick County",2,47,3395,1710,1685
050,24,021,"Maryland","Frederick County",2,48,3685,1857,1828
050,24,021,"Maryland","Frederick County",2,49,3989,1995,1994
050,24,021,"Maryland","Frederick County",2,50,3974,1992,1982
050,24,021,"Maryland","Frederick County",2,51,3806,1929,1877
050,24,021,"Maryland","Frederick County",2,52,3777,1900,1877
050,24,021,"Maryland","Frederick County",2,53,3874,1926,1948
050,24,021,"Maryland","Frederick County",2,54,3934,1967,1967
050,24,021,"Maryland","Frederick County",2,55,4017,2010,2007
050,24,021,"Maryland","Frederick County",2,56,4055,2026,2029
050,24,021,"Maryland","Frederick County",2,57,4090,2032,2058
050,24,021,"Maryland","Frederick County",2,58,4095,2059,2036
050,24,021,"Maryland","Frederick County",2,59,3866,1941,1925
050,24,021,"Maryland","Frederick County",2,60,3641,1781,1860
050,24,021,"Maryland","Frederick County",2,61,3550,1753,1797
050,24,021,"Maryland","Frederick County",2,62,3386,1658,1728
050,24,021,"Maryland","Frederick County",2,63,3209,1566,1643
050,24,021,"Maryland","Frederick County",2,64,3058,1505,1553
050,24,021,"Maryland","Frederick County",2,65,2963,1445,1518
050,24,021,"Maryland","Frederick County",2,66,2863,1389,1474
050,24,021,"Maryland","Frederick County",2,67,2704,1279,1425
050,24,021,"Maryland","Frederick County",2,68,2548,1210,1338
050,24,021,"Maryland","Frederick County",2,69,2425,1140,1285
050,24,021,"Maryland","Frederick County",2,70,2245,1057,1188
050,24,021,"Maryland","Frederick County",2,71,2215,1058,1157
050,24,021,"Maryland","Frederick County",2,72,2232,1078,1154
050,24,021,"Maryland","Frederick County",2,73,2411,1161,1250
050,24,021,"Maryland","Frederick County",2,74,1650,772,878
050,24,021,"Maryland","Frederick County",2,75,1524,701,823
050,24,021,"Maryland","Frederick County",2,76,1463,649,814
050,24,021,"Maryland","Frederick County",2,77,1485,660,825
050,24,021,"Maryland","Frederick County",2,78,1345,579,766
050,24,021,"Maryland","Frederick County",2,79,1213,513,700
050,24,021,"Maryland","Frederick County",2,80,1010,441,569
050,24,021,"Maryland","Frederick County",2,81,947,405,542
050,24,021,"Maryland","Frederick County",2,82,889,371,518
050,24,021,"Maryland","Frederick County",2,83,785,331,454
050,24,021,"Maryland","Frederick County",2,84,714,308,406
050,24,021,"Maryland","Frederick County",2,85,4552,1495,3057
050,24,021,"Maryland","Frederick County",3,0,3074,1551,1523
050,24,021,"Maryland","Frederick County",3,1,3297,1709,1588
050,24,021,"Maryland","Frederick County",3,2,3336,1685,1651
050,24,021,"Maryland","Frederick County",3,3,3352,1687,1665
050,24,021,"Maryland","Frederick County",3,4,3495,1722,1773
050,24,021,"Maryland","Frederick County",3,5,3619,1781,1838
050,24,021,"Maryland","Frederick County",3,6,3625,1822,1803
050,24,021,"Maryland","Frederick County",3,7,3603,1845,1758
050,24,021,"Maryland","Frederick County",3,8,3563,1805,1758
050,24,021,"Maryland","Frederick County",3,9,3618,1860,1758
050,24,021,"Maryland","Frederick County",3,10,3698,1902,1796
050,24,021,"Maryland","Frederick County",3,11,3764,1951,1813
050,24,021,"Maryland","Frederick County",3,12,3819,1954,1865
050,24,021,"Maryland","Frederick County",3,13,4040,2065,1975
050,24,021,"Maryland","Frederick County",3,14,4053,2072,1981
050,24,021,"Maryland","Frederick County",3,15,3945,2009,1936
050,24,021,"Maryland","Frederick County",3,16,3805,1900,1905
050,24,021,"Maryland","Frederick County",3,17,3811,1924,1887
050,24,021,"Maryland","Frederick County",3,18,3651,1833,1818
050,24,021,"Maryland","Frederick County",3,19,3362,1687,1675
050,24,021,"Maryland","Frederick County",3,20,3532,1802,1730
050,24,021,"Maryland","Frederick County",3,21,3423,1693,1730
050,24,021,"Maryland","Frederick County",3,22,3294,1643,1651
050,24,021,"Maryland","Frederick County",3,23,3109,1570,1539
050,24,021,"Maryland","Frederick County",3,24,3032,1563,1469
050,24,021,"Maryland","Frederick County",3,25,3097,1570,1527
050,24,021,"Maryland","Frederick County",3,26,3188,1640,1548
050,24,021,"Maryland","Frederick County",3,27,3213,1608,1605
050,24,021,"Maryland","Frederick County",3,28,3389,1721,1668
050,24,021,"Maryland","Frederick County",3,29,3394,1705,1689
050,24,021,"Maryland","Frederick County",3,30,3526,1791,1735
050,24,021,"Maryland","Frederick County",3,31,3654,1847,1807
050,24,021,"Maryland","Frederick County",3,32,3789,1878,1911
050,24,021,"Maryland","Frederick County",3,33,3870,1918,1952
050,24,021,"Maryland","Frederick County",3,34,4005,2038,1967
050,24,021,"Maryland","Frederick County",3,35,4128,2058,2070
050,24,021,"Maryland","Frederick County",3,36,4173,2093,2080
050,24,021,"Maryland","Frederick County",3,37,4117,2074,2043
050,24,021,"Maryland","Frederick County",3,38,4180,2089,2091
050,24,021,"Maryland","Frederick County",3,39,4062,2031,2031
050,24,021,"Maryland","Frederick County",3,40,4092,2059,2033
050,24,021,"Maryland","Frederick County",3,41,3993,2003,1990
050,24,021,"Maryland","Frederick County",3,42,3848,1966,1882
050,24,021,"Maryland","Frederick County",3,43,3788,1930,1858
050,24,021,"Maryland","Frederick County",3,44,3715,1873,1842
050,24,021,"Maryland","Frederick County",3,45,3478,1754,1724
050,24,021,"Maryland","Frederick County",3,46,3451,1728,1723
050,24,021,"Maryland","Frederick County",3,47,3348,1666,1682
050,24,021,"Maryland","Frederick County",3,48,3466,1754,1712
050,24,021,"Maryland","Frederick County",3,49,3724,1874,1850
050,24,021,"Maryland","Frederick County",3,50,4038,2027,2011
050,24,021,"Maryland","Frederick County",3,51,3970,1997,1973
050,24,021,"Maryland","Frederick County",3,52,3849,1968,1881
050,24,021,"Maryland","Frederick County",3,53,3810,1897,1913
050,24,021,"Maryland","Frederick County",3,54,3885,1933,1952
050,24,021,"Maryland","Frederick County",3,55,3943,1958,1985
050,24,021,"Maryland","Frederick County",3,56,4016,2042,1974
050,24,021,"Maryland","Frederick County",3,57,4035,1995,2040
050,24,021,"Maryland","Frederick County",3,58,4020,2000,2020
050,24,021,"Maryland","Frederick County",3,59,4023,2010,2013
050,24,021,"Maryland","Frederick County",3,60,3813,1900,1913
050,24,021,"Maryland","Frederick County",3,61,3587,1746,1841
050,24,021,"Maryland","Frederick County",3,62,3531,1727,1804
050,24,021,"Maryland","Frederick County",3,63,3350,1627,1723
050,24,021,"Maryland","Frederick County",3,64,3174,1539,1635
050,24,021,"Maryland","Frederick County",3,65,3042,1487,1555
050,24,021,"Maryland","Frederick County",3,66,2926,1412,1514
050,24,021,"Maryland","Frederick County",3,67,2816,1366,1450
050,24,021,"Maryland","Frederick County",3,68,2666,1257,1409
050,24,021,"Maryland","Frederick County",3,69,2541,1212,1329
050,24,021,"Maryland","Frederick County",3,70,2411,1130,1281
050,24,021,"Maryland","Frederick County",3,71,2239,1038,1201
050,24,021,"Maryland","Frederick County",3,72,2192,1037,1155
050,24,021,"Maryland","Frederick County",3,73,2203,1070,1133
050,24,021,"Maryland","Frederick County",3,74,2369,1132,1237
050,24,021,"Maryland","Frederick County",3,75,1621,749,872
050,24,021,"Maryland","Frederick County",3,76,1487,675,812
050,24,021,"Maryland","Frederick County",3,77,1425,629,796
050,24,021,"Maryland","Frederick County",3,78,1472,647,825
050,24,021,"Maryland","Frederick County",3,79,1313,552,761
050,24,021,"Maryland","Frederick County",3,80,1156,508,648
050,24,021,"Maryland","Frederick County",3,81,1001,416,585
050,24,021,"Maryland","Frederick County",3,82,909,391,518
050,24,021,"Maryland","Frederick County",3,83,854,354,500
050,24,021,"Maryland","Frederick County",3,84,733,304,429
050,24,021,"Maryland","Frederick County",3,85,4619,1551,3068
050,24,021,"Maryland","Frederick County",4,0,3226,1578,1648
050,24,021,"Maryland","Frederick County",4,1,3229,1640,1589
050,24,021,"Maryland","Frederick County",4,2,3526,1802,1724
050,24,021,"Maryland","Frederick County",4,3,3540,1769,1771
050,24,021,"Maryland","Frederick County",4,4,3611,1797,1814
050,24,021,"Maryland","Frederick County",4,5,3691,1822,1869
050,24,021,"Maryland","Frederick County",4,6,3797,1856,1941
050,24,021,"Maryland","Frederick County",4,7,3822,1920,1902
050,24,021,"Maryland","Frederick County",4,8,3769,1942,1827
050,24,021,"Maryland","Frederick County",4,9,3651,1851,1800
050,24,021,"Maryland","Frederick County",4,10,3734,1907,1827
050,24,021,"Maryland","Frederick County",4,11,3846,1968,1878
050,24,021,"Maryland","Frederick County",4,12,3872,2012,1860
050,24,021,"Maryland","Frederick County",4,13,3917,2000,1917
050,24,021,"Maryland","Frederick County",4,14,4119,2073,2046
050,24,021,"Maryland","Frederick County",4,15,4138,2126,2012
050,24,021,"Maryland","Frederick County",4,16,4006,2019,1987
050,24,021,"Maryland","Frederick County",4,17,3843,1919,1924
050,24,021,"Maryland","Frederick County",4,18,3729,1862,1867
050,24,021,"Maryland","Frederick County",4,19,3293,1660,1633
050,24,021,"Maryland","Frederick County",4,20,3440,1788,1652
050,24,021,"Maryland","Frederick County",4,21,3482,1705,1777
050,24,021,"Maryland","Frederick County",4,22,3327,1684,1643
050,24,021,"Maryland","Frederick County",4,23,3119,1577,1542
050,24,021,"Maryland","Frederick County",4,24,3123,1563,1560
050,24,021,"Maryland","Frederick County",4,25,3053,1586,1467
050,24,021,"Maryland","Frederick County",4,26,3120,1569,1551
050,24,021,"Maryland","Frederick County",4,27,3316,1714,1602
050,24,021,"Maryland","Frederick County",4,28,3296,1648,1648
050,24,021,"Maryland","Frederick County",4,29,3570,1774,1796
050,24,021,"Maryland","Frederick County",4,30,3587,1801,1786
050,24,021,"Maryland","Frederick County",4,31,3739,1877,1862
050,24,021,"Maryland","Frederick County",4,32,3873,1936,1937
050,24,021,"Maryland","Frederick County",4,33,3974,1980,1994
050,24,021,"Maryland","Frederick County",4,34,4079,1977,2102
050,24,021,"Maryland","Frederick County",4,35,4234,2146,2088
050,24,021,"Maryland","Frederick County",4,36,4418,2220,2198
050,24,021,"Maryland","Frederick County",4,37,4453,2233,2220
050,24,021,"Maryland","Frederick County",4,38,4344,2216,2128
050,24,021,"Maryland","Frederick County",4,39,4360,2177,2183
050,24,021,"Maryland","Frederick County",4,40,4242,2143,2099
050,24,021,"Maryland","Frederick County",4,41,4253,2170,2083
050,24,021,"Maryland","Frederick County",4,42,4187,2141,2046
050,24,021,"Maryland","Frederick County",4,43,4002,2041,1961
050,24,021,"Maryland","Frederick County",4,44,3837,1964,1873
050,24,021,"Maryland","Frederick County",4,45,3804,1904,1900
050,24,021,"Maryland","Frederick County",4,46,3539,1773,1766
050,24,021,"Maryland","Frederick County",4,47,3512,1743,1769
050,24,021,"Maryland","Frederick County",4,48,3389,1702,1687
050,24,021,"Maryland","Frederick County",4,49,3534,1786,1748
050,24,021,"Maryland","Frederick County",4,50,3785,1898,1887
050,24,021,"Maryland","Frederick County",4,51,4085,2055,2030
050,24,021,"Maryland","Frederick County",4,52,3959,2002,1957
050,24,021,"Maryland","Frederick County",4,53,3824,1961,1863
050,24,021,"Maryland","Frederick County",4,54,3755,1877,1878
050,24,021,"Maryland","Frederick County",4,55,3848,1921,1927
050,24,021,"Maryland","Frederick County",4,56,3899,1951,1948
050,24,021,"Maryland","Frederick County",4,57,3957,2018,1939
050,24,021,"Maryland","Frederick County",4,58,3992,1978,2014
050,24,021,"Maryland","Frederick County",4,59,3991,1964,2027
050,24,021,"Maryland","Frederick County",4,60,3973,1973,2000
050,24,021,"Maryland","Frederick County",4,61,3763,1872,1891
050,24,021,"Maryland","Frederick County",4,62,3534,1733,1801
050,24,021,"Maryland","Frederick County",4,63,3449,1689,1760
050,24,021,"Maryland","Frederick County",4,64,3302,1578,1724
050,24,021,"Maryland","Frederick County",4,65,3134,1501,1633
050,24,021,"Maryland","Frederick County",4,66,2997,1448,1549
050,24,021,"Maryland","Frederick County",4,67,2908,1369,1539
050,24,021,"Maryland","Frederick County",4,68,2767,1340,1427
050,24,021,"Maryland","Frederick County",4,69,2625,1242,1383
050,24,021,"Maryland","Frederick County",4,70,2515,1184,1331
050,24,021,"Maryland","Frederick County",4,71,2413,1128,1285
050,24,021,"Maryland","Frederick County",4,72,2239,1028,1211
050,24,021,"Maryland","Frederick County",4,73,2175,1027,1148
050,24,021,"Maryland","Frederick County",4,74,2167,1022,1145
050,24,021,"Maryland","Frederick County",4,75,2327,1104,1223
050,24,021,"Maryland","Frederick County",4,76,1571,730,841
050,24,021,"Maryland","Frederick County",4,77,1450,659,791
050,24,021,"Maryland","Frederick County",4,78,1427,623,804
050,24,021,"Maryland","Frederick County",4,79,1433,613,820
050,24,021,"Maryland","Frederick County",4,80,1253,536,717
050,24,021,"Maryland","Frederick County",4,81,1152,491,661
050,24,021,"Maryland","Frederick County",4,82,935,384,551
050,24,021,"Maryland","Frederick County",4,83,882,371,511
050,24,021,"Maryland","Frederick County",4,84,808,328,480
050,24,021,"Maryland","Frederick County",4,85,4681,1592,3089
050,24,021,"Maryland","Frederick County",5,0,3189,1565,1624
050,24,021,"Maryland","Frederick County",5,1,3505,1721,1784
050,24,021,"Maryland","Frederick County",5,2,3359,1703,1656
050,24,021,"Maryland","Frederick County",5,3,3668,1888,1780
050,24,021,"Maryland","Frederick County",5,4,3663,1850,1813
050,24,021,"Maryland","Frederick County",5,5,3753,1883,1870
050,24,021,"Maryland","Frederick County",5,6,3811,1872,1939
050,24,021,"Maryland","Frederick County",5,7,3943,1927,2016
050,24,021,"Maryland","Frederick County",5,8,3975,1993,1982
050,24,021,"Maryland","Frederick County",5,9,3854,2007,1847
050,24,021,"Maryland","Frederick County",5,10,3779,1901,1878
050,24,021,"Maryland","Frederick County",5,11,3783,1918,1865
050,24,021,"Maryland","Frederick County",5,12,3913,2015,1898
050,24,021,"Maryland","Frederick County",5,13,3964,2061,1903
050,24,021,"Maryland","Frederick County",5,14,3994,2017,1977
050,24,021,"Maryland","Frederick County",5,15,4157,2076,2081
050,24,021,"Maryland","Frederick County",5,16,4163,2130,2033
050,24,021,"Maryland","Frederick County",5,17,4090,2026,2064
050,24,021,"Maryland","Frederick County",5,18,3782,1860,1922
050,24,021,"Maryland","Frederick County",5,19,3408,1677,1731
050,24,021,"Maryland","Frederick County",5,20,3416,1782,1634
050,24,021,"Maryland","Frederick County",5,21,3452,1732,1720
050,24,021,"Maryland","Frederick County",5,22,3378,1682,1696
050,24,021,"Maryland","Frederick County",5,23,3146,1587,1559
050,24,021,"Maryland","Frederick County",5,24,3083,1539,1544
050,24,021,"Maryland","Frederick County",5,25,3043,1519,1524
050,24,021,"Maryland","Frederick County",5,26,3079,1602,1477
050,24,021,"Maryland","Frederick County",5,27,3167,1616,1551
050,24,021,"Maryland","Frederick County",5,28,3449,1729,1720
050,24,021,"Maryland","Frederick County",5,29,3440,1673,1767
050,24,021,"Maryland","Frederick County",5,30,3701,1828,1873
050,24,021,"Maryland","Frederick County",5,31,3787,1895,1892
050,24,021,"Maryland","Frederick County",5,32,3979,1976,2003
050,24,021,"Maryland","Frederick County",5,33,4048,2030,2018
050,24,021,"Maryland","Frederick County",5,34,4212,2069,2143
050,24,021,"Maryland","Frederick County",5,35,4339,2109,2230
050,24,021,"Maryland","Frederick County",5,36,4426,2244,2182
050,24,021,"Maryland","Frederick County",5,37,4617,2305,2312
050,24,021,"Maryland","Frederick County",5,38,4639,2316,2323
050,24,021,"Maryland","Frederick County",5,39,4469,2272,2197
050,24,021,"Maryland","Frederick County",5,40,4599,2371,2228
050,24,021,"Maryland","Frederick County",5,41,4342,2213,2129
050,24,021,"Maryland","Frederick County",5,42,4364,2236,2128
050,24,021,"Maryland","Frederick County",5,43,4308,2222,2086
050,24,021,"Maryland","Frederick County",5,44,4039,2063,1976
050,24,021,"Maryland","Frederick County",5,45,3899,2016,1883
050,24,021,"Maryland","Frederick County",5,46,3857,1932,1925
050,24,021,"Maryland","Frederick County",5,47,3589,1817,1772
050,24,021,"Maryland","Frederick County",5,48,3552,1773,1779
050,24,021,"Maryland","Frederick County",5,49,3449,1722,1727
050,24,021,"Maryland","Frederick County",5,50,3556,1809,1747
050,24,021,"Maryland","Frederick County",5,51,3771,1899,1872
050,24,021,"Maryland","Frederick County",5,52,4109,2069,2040
050,24,021,"Maryland","Frederick County",5,53,3972,2003,1969
050,24,021,"Maryland","Frederick County",5,54,3807,1950,1857
050,24,021,"Maryland","Frederick County",5,55,3755,1894,1861
050,24,021,"Maryland","Frederick County",5,56,3812,1910,1902
050,24,021,"Maryland","Frederick County",5,57,3868,1926,1942
050,24,021,"Maryland","Frederick County",5,58,3887,1993,1894
050,24,021,"Maryland","Frederick County",5,59,3982,1950,2032
050,24,021,"Maryland","Frederick County",5,60,3937,1910,2027
050,24,021,"Maryland","Frederick County",5,61,3899,1919,1980
050,24,021,"Maryland","Frederick County",5,62,3713,1837,1876
050,24,021,"Maryland","Frederick County",5,63,3462,1697,1765
050,24,021,"Maryland","Frederick County",5,64,3416,1657,1759
050,24,021,"Maryland","Frederick County",5,65,3238,1551,1687
050,24,021,"Maryland","Frederick County",5,66,3089,1478,1611
050,24,021,"Maryland","Frederick County",5,67,2998,1445,1553
050,24,021,"Maryland","Frederick County",5,68,2881,1355,1526
050,24,021,"Maryland","Frederick County",5,69,2756,1342,1414
050,24,021,"Maryland","Frederick County",5,70,2602,1239,1363
050,24,021,"Maryland","Frederick County",5,71,2478,1158,1320
050,24,021,"Maryland","Frederick County",5,72,2382,1111,1271
050,24,021,"Maryland","Frederick County",5,73,2222,1014,1208
050,24,021,"Maryland","Frederick County",5,74,2138,1002,1136
050,24,021,"Maryland","Frederick County",5,75,2126,1005,1121
050,24,021,"Maryland","Frederick County",5,76,2297,1081,1216
050,24,021,"Maryland","Frederick County",5,77,1531,718,813
050,24,021,"Maryland","Frederick County",5,78,1427,640,787
050,24,021,"Maryland","Frederick County",5,79,1387,594,793
050,24,021,"Maryland","Frederick County",5,80,1358,588,770
050,24,021,"Maryland","Frederick County",5,81,1240,518,722
050,24,021,"Maryland","Frederick County",5,82,1092,464,628
050,24,021,"Maryland","Frederick County",5,83,903,362,541
050,24,021,"Maryland","Frederick County",5,84,828,344,484
050,24,021,"Maryland","Frederick County",5,85,4851,1668,3183
050,24,023,"Maryland","Garrett County",1,0,256,132,124
050,24,023,"Maryland","Garrett County",1,1,261,137,124
050,24,023,"Maryland","Garrett County",1,2,273,135,138
050,24,023,"Maryland","Garrett County",1,3,287,142,145
050,24,023,"Maryland","Garrett County",1,4,287,139,148
050,24,023,"Maryland","Garrett County",1,5,280,141,139
050,24,023,"Maryland","Garrett County",1,6,284,148,136
050,24,023,"Maryland","Garrett County",1,7,274,141,133
050,24,023,"Maryland","Garrett County",1,8,294,138,156
050,24,023,"Maryland","Garrett County",1,9,248,124,124
050,24,023,"Maryland","Garrett County",1,10,273,141,132
050,24,023,"Maryland","Garrett County",1,11,274,133,141
050,24,023,"Maryland","Garrett County",1,12,322,167,155
050,24,023,"Maryland","Garrett County",1,13,313,167,146
050,24,023,"Maryland","Garrett County",1,14,317,167,150
050,24,023,"Maryland","Garrett County",1,15,340,181,159
050,24,023,"Maryland","Garrett County",1,16,337,184,153
050,24,023,"Maryland","Garrett County",1,17,326,178,148
050,24,023,"Maryland","Garrett County",1,18,327,182,145
050,24,023,"Maryland","Garrett County",1,19,268,146,122
050,24,023,"Maryland","Garrett County",1,20,279,152,127
050,24,023,"Maryland","Garrett County",1,21,303,161,142
050,24,023,"Maryland","Garrett County",1,22,309,160,149
050,24,023,"Maryland","Garrett County",1,23,304,161,143
050,24,023,"Maryland","Garrett County",1,24,309,154,155
050,24,023,"Maryland","Garrett County",1,25,315,163,152
050,24,023,"Maryland","Garrett County",1,26,324,166,158
050,24,023,"Maryland","Garrett County",1,27,342,173,169
050,24,023,"Maryland","Garrett County",1,28,325,153,172
050,24,023,"Maryland","Garrett County",1,29,357,181,176
050,24,023,"Maryland","Garrett County",1,30,349,186,163
050,24,023,"Maryland","Garrett County",1,31,321,171,150
050,24,023,"Maryland","Garrett County",1,32,276,142,134
050,24,023,"Maryland","Garrett County",1,33,288,139,149
050,24,023,"Maryland","Garrett County",1,34,296,155,141
050,24,023,"Maryland","Garrett County",1,35,292,143,149
050,24,023,"Maryland","Garrett County",1,36,308,145,163
050,24,023,"Maryland","Garrett County",1,37,308,168,140
050,24,023,"Maryland","Garrett County",1,38,305,142,163
050,24,023,"Maryland","Garrett County",1,39,344,164,180
050,24,023,"Maryland","Garrett County",1,40,354,173,181
050,24,023,"Maryland","Garrett County",1,41,337,177,160
050,24,023,"Maryland","Garrett County",1,42,337,178,159
050,24,023,"Maryland","Garrett County",1,43,310,161,149
050,24,023,"Maryland","Garrett County",1,44,298,155,143
050,24,023,"Maryland","Garrett County",1,45,320,169,151
050,24,023,"Maryland","Garrett County",1,46,327,158,169
050,24,023,"Maryland","Garrett County",1,47,359,155,204
050,24,023,"Maryland","Garrett County",1,48,405,193,212
050,24,023,"Maryland","Garrett County",1,49,396,191,205
050,24,023,"Maryland","Garrett County",1,50,385,183,202
050,24,023,"Maryland","Garrett County",1,51,403,189,214
050,24,023,"Maryland","Garrett County",1,52,385,206,179
050,24,023,"Maryland","Garrett County",1,53,382,201,181
050,24,023,"Maryland","Garrett County",1,54,408,202,206
050,24,023,"Maryland","Garrett County",1,55,456,225,231
050,24,023,"Maryland","Garrett County",1,56,430,231,199
050,24,023,"Maryland","Garrett County",1,57,444,225,219
050,24,023,"Maryland","Garrett County",1,58,490,228,262
050,24,023,"Maryland","Garrett County",1,59,492,237,255
050,24,023,"Maryland","Garrett County",1,60,485,251,234
050,24,023,"Maryland","Garrett County",1,61,492,240,252
050,24,023,"Maryland","Garrett County",1,62,518,255,263
050,24,023,"Maryland","Garrett County",1,63,505,244,261
050,24,023,"Maryland","Garrett County",1,64,434,212,222
050,24,023,"Maryland","Garrett County",1,65,427,216,211
050,24,023,"Maryland","Garrett County",1,66,430,212,218
050,24,023,"Maryland","Garrett County",1,67,419,217,202
050,24,023,"Maryland","Garrett County",1,68,420,209,211
050,24,023,"Maryland","Garrett County",1,69,384,187,197
050,24,023,"Maryland","Garrett County",1,70,370,179,191
050,24,023,"Maryland","Garrett County",1,71,369,180,189
050,24,023,"Maryland","Garrett County",1,72,371,186,185
050,24,023,"Maryland","Garrett County",1,73,373,190,183
050,24,023,"Maryland","Garrett County",1,74,266,124,142
050,24,023,"Maryland","Garrett County",1,75,286,139,147
050,24,023,"Maryland","Garrett County",1,76,269,127,142
050,24,023,"Maryland","Garrett County",1,77,262,128,134
050,24,023,"Maryland","Garrett County",1,78,234,113,121
050,24,023,"Maryland","Garrett County",1,79,174,89,85
050,24,023,"Maryland","Garrett County",1,80,187,86,101
050,24,023,"Maryland","Garrett County",1,81,180,83,97
050,24,023,"Maryland","Garrett County",1,82,162,72,90
050,24,023,"Maryland","Garrett County",1,83,127,64,63
050,24,023,"Maryland","Garrett County",1,84,120,55,65
050,24,023,"Maryland","Garrett County",1,85,730,239,491
050,24,023,"Maryland","Garrett County",2,0,289,150,139
050,24,023,"Maryland","Garrett County",2,1,259,135,124
050,24,023,"Maryland","Garrett County",2,2,269,134,135
050,24,023,"Maryland","Garrett County",2,3,284,141,143
050,24,023,"Maryland","Garrett County",2,4,287,141,146
050,24,023,"Maryland","Garrett County",2,5,282,141,141
050,24,023,"Maryland","Garrett County",2,6,282,145,137
050,24,023,"Maryland","Garrett County",2,7,273,140,133
050,24,023,"Maryland","Garrett County",2,8,288,139,149
050,24,023,"Maryland","Garrett County",2,9,257,127,130
050,24,023,"Maryland","Garrett County",2,10,266,136,130
050,24,023,"Maryland","Garrett County",2,11,274,136,138
050,24,023,"Maryland","Garrett County",2,12,311,158,153
050,24,023,"Maryland","Garrett County",2,13,311,166,145
050,24,023,"Maryland","Garrett County",2,14,314,167,147
050,24,023,"Maryland","Garrett County",2,15,336,179,157
050,24,023,"Maryland","Garrett County",2,16,338,184,154
050,24,023,"Maryland","Garrett County",2,17,330,182,148
050,24,023,"Maryland","Garrett County",2,18,321,178,143
050,24,023,"Maryland","Garrett County",2,19,270,147,123
050,24,023,"Maryland","Garrett County",2,20,282,153,129
050,24,023,"Maryland","Garrett County",2,21,300,160,140
050,24,023,"Maryland","Garrett County",2,22,309,161,148
050,24,023,"Maryland","Garrett County",2,23,307,163,144
050,24,023,"Maryland","Garrett County",2,24,307,156,151
050,24,023,"Maryland","Garrett County",2,25,316,163,153
050,24,023,"Maryland","Garrett County",2,26,323,167,156
050,24,023,"Maryland","Garrett County",2,27,335,170,165
050,24,023,"Maryland","Garrett County",2,28,328,159,169
050,24,023,"Maryland","Garrett County",2,29,348,174,174
050,24,023,"Maryland","Garrett County",2,30,352,185,167
050,24,023,"Maryland","Garrett County",2,31,326,174,152
050,24,023,"Maryland","Garrett County",2,32,286,148,138
050,24,023,"Maryland","Garrett County",2,33,288,142,146
050,24,023,"Maryland","Garrett County",2,34,289,149,140
050,24,023,"Maryland","Garrett County",2,35,294,147,147
050,24,023,"Maryland","Garrett County",2,36,302,144,158
050,24,023,"Maryland","Garrett County",2,37,310,164,146
050,24,023,"Maryland","Garrett County",2,38,306,149,157
050,24,023,"Maryland","Garrett County",2,39,332,158,174
050,24,023,"Maryland","Garrett County",2,40,353,171,182
050,24,023,"Maryland","Garrett County",2,41,340,175,165
050,24,023,"Maryland","Garrett County",2,42,333,176,157
050,24,023,"Maryland","Garrett County",2,43,321,167,154
050,24,023,"Maryland","Garrett County",2,44,298,156,142
050,24,023,"Maryland","Garrett County",2,45,315,166,149
050,24,023,"Maryland","Garrett County",2,46,322,157,165
050,24,023,"Maryland","Garrett County",2,47,353,157,196
050,24,023,"Maryland","Garrett County",2,48,394,185,209
050,24,023,"Maryland","Garrett County",2,49,399,192,207
050,24,023,"Maryland","Garrett County",2,50,388,185,203
050,24,023,"Maryland","Garrett County",2,51,398,188,210
050,24,023,"Maryland","Garrett County",2,52,387,200,187
050,24,023,"Maryland","Garrett County",2,53,384,202,182
050,24,023,"Maryland","Garrett County",2,54,400,201,199
050,24,023,"Maryland","Garrett County",2,55,444,220,224
050,24,023,"Maryland","Garrett County",2,56,434,226,208
050,24,023,"Maryland","Garrett County",2,57,442,228,214
050,24,023,"Maryland","Garrett County",2,58,478,227,251
050,24,023,"Maryland","Garrett County",2,59,496,238,258
050,24,023,"Maryland","Garrett County",2,60,487,248,239
050,24,023,"Maryland","Garrett County",2,61,491,242,249
050,24,023,"Maryland","Garrett County",2,62,510,250,260
050,24,023,"Maryland","Garrett County",2,63,513,250,263
050,24,023,"Maryland","Garrett County",2,64,448,219,229
050,24,023,"Maryland","Garrett County",2,65,429,216,213
050,24,023,"Maryland","Garrett County",2,66,427,213,214
050,24,023,"Maryland","Garrett County",2,67,421,214,207
050,24,023,"Maryland","Garrett County",2,68,419,211,208
050,24,023,"Maryland","Garrett County",2,69,396,194,202
050,24,023,"Maryland","Garrett County",2,70,373,180,193
050,24,023,"Maryland","Garrett County",2,71,365,178,187
050,24,023,"Maryland","Garrett County",2,72,361,178,183
050,24,023,"Maryland","Garrett County",2,73,384,196,188
050,24,023,"Maryland","Garrett County",2,74,269,131,138
050,24,023,"Maryland","Garrett County",2,75,280,135,145
050,24,023,"Maryland","Garrett County",2,76,267,126,141
050,24,023,"Maryland","Garrett County",2,77,270,131,139
050,24,023,"Maryland","Garrett County",2,78,236,113,123
050,24,023,"Maryland","Garrett County",2,79,184,93,91
050,24,023,"Maryland","Garrett County",2,80,184,86,98
050,24,023,"Maryland","Garrett County",2,81,175,82,93
050,24,023,"Maryland","Garrett County",2,82,167,75,92
050,24,023,"Maryland","Garrett County",2,83,131,64,67
050,24,023,"Maryland","Garrett County",2,84,119,54,65
050,24,023,"Maryland","Garrett County",2,85,732,245,487
050,24,023,"Maryland","Garrett County",3,0,233,119,114
050,24,023,"Maryland","Garrett County",3,1,288,157,131
050,24,023,"Maryland","Garrett County",3,2,262,137,125
050,24,023,"Maryland","Garrett County",3,3,276,135,141
050,24,023,"Maryland","Garrett County",3,4,286,137,149
050,24,023,"Maryland","Garrett County",3,5,293,146,147
050,24,023,"Maryland","Garrett County",3,6,281,137,144
050,24,023,"Maryland","Garrett County",3,7,267,133,134
050,24,023,"Maryland","Garrett County",3,8,276,144,132
050,24,023,"Maryland","Garrett County",3,9,286,133,153
050,24,023,"Maryland","Garrett County",3,10,270,131,139
050,24,023,"Maryland","Garrett County",3,11,269,145,124
050,24,023,"Maryland","Garrett County",3,12,279,140,139
050,24,023,"Maryland","Garrett County",3,13,317,165,152
050,24,023,"Maryland","Garrett County",3,14,310,164,146
050,24,023,"Maryland","Garrett County",3,15,321,175,146
050,24,023,"Maryland","Garrett County",3,16,331,176,155
050,24,023,"Maryland","Garrett County",3,17,333,182,151
050,24,023,"Maryland","Garrett County",3,18,318,171,147
050,24,023,"Maryland","Garrett County",3,19,263,144,119
050,24,023,"Maryland","Garrett County",3,20,272,149,123
050,24,023,"Maryland","Garrett County",3,21,287,150,137
050,24,023,"Maryland","Garrett County",3,22,310,165,145
050,24,023,"Maryland","Garrett County",3,23,312,170,142
050,24,023,"Maryland","Garrett County",3,24,314,164,150
050,24,023,"Maryland","Garrett County",3,25,302,157,145
050,24,023,"Maryland","Garrett County",3,26,322,170,152
050,24,023,"Maryland","Garrett County",3,27,326,162,164
050,24,023,"Maryland","Garrett County",3,28,330,167,163
050,24,023,"Maryland","Garrett County",3,29,335,170,165
050,24,023,"Maryland","Garrett County",3,30,357,172,185
050,24,023,"Maryland","Garrett County",3,31,350,185,165
050,24,023,"Maryland","Garrett County",3,32,337,180,157
050,24,023,"Maryland","Garrett County",3,33,291,149,142
050,24,023,"Maryland","Garrett County",3,34,288,140,148
050,24,023,"Maryland","Garrett County",3,35,287,154,133
050,24,023,"Maryland","Garrett County",3,36,296,150,146
050,24,023,"Maryland","Garrett County",3,37,313,150,163
050,24,023,"Maryland","Garrett County",3,38,317,161,156
050,24,023,"Maryland","Garrett County",3,39,308,149,159
050,24,023,"Maryland","Garrett County",3,40,338,161,177
050,24,023,"Maryland","Garrett County",3,41,349,170,179
050,24,023,"Maryland","Garrett County",3,42,340,175,165
050,24,023,"Maryland","Garrett County",3,43,329,168,161
050,24,023,"Maryland","Garrett County",3,44,318,168,150
050,24,023,"Maryland","Garrett County",3,45,289,151,138
050,24,023,"Maryland","Garrett County",3,46,315,165,150
050,24,023,"Maryland","Garrett County",3,47,325,160,165
050,24,023,"Maryland","Garrett County",3,48,361,162,199
050,24,023,"Maryland","Garrett County",3,49,390,181,209
050,24,023,"Maryland","Garrett County",3,50,405,191,214
050,24,023,"Maryland","Garrett County",3,51,390,185,205
050,24,023,"Maryland","Garrett County",3,52,402,187,215
050,24,023,"Maryland","Garrett County",3,53,389,200,189
050,24,023,"Maryland","Garrett County",3,54,384,200,184
050,24,023,"Maryland","Garrett County",3,55,406,205,201
050,24,023,"Maryland","Garrett County",3,56,440,218,222
050,24,023,"Maryland","Garrett County",3,57,436,228,208
050,24,023,"Maryland","Garrett County",3,58,445,228,217
050,24,023,"Maryland","Garrett County",3,59,473,229,244
050,24,023,"Maryland","Garrett County",3,60,503,239,264
050,24,023,"Maryland","Garrett County",3,61,486,245,241
050,24,023,"Maryland","Garrett County",3,62,481,240,241
050,24,023,"Maryland","Garrett County",3,63,509,250,259
050,24,023,"Maryland","Garrett County",3,64,504,246,258
050,24,023,"Maryland","Garrett County",3,65,448,218,230
050,24,023,"Maryland","Garrett County",3,66,427,215,212
050,24,023,"Maryland","Garrett County",3,67,426,212,214
050,24,023,"Maryland","Garrett County",3,68,407,205,202
050,24,023,"Maryland","Garrett County",3,69,412,211,201
050,24,023,"Maryland","Garrett County",3,70,385,185,200
050,24,023,"Maryland","Garrett County",3,71,367,173,194
050,24,023,"Maryland","Garrett County",3,72,353,173,180
050,24,023,"Maryland","Garrett County",3,73,350,174,176
050,24,023,"Maryland","Garrett County",3,74,371,188,183
050,24,023,"Maryland","Garrett County",3,75,256,123,133
050,24,023,"Maryland","Garrett County",3,76,278,135,143
050,24,023,"Maryland","Garrett County",3,77,258,120,138
050,24,023,"Maryland","Garrett County",3,78,257,125,132
050,24,023,"Maryland","Garrett County",3,79,220,107,113
050,24,023,"Maryland","Garrett County",3,80,189,90,99
050,24,023,"Maryland","Garrett County",3,81,160,75,85
050,24,023,"Maryland","Garrett County",3,82,170,76,94
050,24,023,"Maryland","Garrett County",3,83,148,71,77
050,24,023,"Maryland","Garrett County",3,84,126,57,69
050,24,023,"Maryland","Garrett County",3,85,730,263,467
050,24,023,"Maryland","Garrett County",4,0,235,125,110
050,24,023,"Maryland","Garrett County",4,1,251,129,122
050,24,023,"Maryland","Garrett County",4,2,276,152,124
050,24,023,"Maryland","Garrett County",4,3,270,143,127
050,24,023,"Maryland","Garrett County",4,4,273,140,133
050,24,023,"Maryland","Garrett County",4,5,287,139,148
050,24,023,"Maryland","Garrett County",4,6,287,137,150
050,24,023,"Maryland","Garrett County",4,7,271,133,138
050,24,023,"Maryland","Garrett County",4,8,266,136,130
050,24,023,"Maryland","Garrett County",4,9,277,138,139
050,24,023,"Maryland","Garrett County",4,10,279,135,144
050,24,023,"Maryland","Garrett County",4,11,257,125,132
050,24,023,"Maryland","Garrett County",4,12,268,142,126
050,24,023,"Maryland","Garrett County",4,13,273,138,135
050,24,023,"Maryland","Garrett County",4,14,313,159,154
050,24,023,"Maryland","Garrett County",4,15,326,177,149
050,24,023,"Maryland","Garrett County",4,16,314,175,139
050,24,023,"Maryland","Garrett County",4,17,335,181,154
050,24,023,"Maryland","Garrett County",4,18,314,171,143
050,24,023,"Maryland","Garrett County",4,19,261,140,121
050,24,023,"Maryland","Garrett County",4,20,256,138,118
050,24,023,"Maryland","Garrett County",4,21,263,145,118
050,24,023,"Maryland","Garrett County",4,22,297,147,150
050,24,023,"Maryland","Garrett County",4,23,319,168,151
050,24,023,"Maryland","Garrett County",4,24,320,174,146
050,24,023,"Maryland","Garrett County",4,25,309,167,142
050,24,023,"Maryland","Garrett County",4,26,293,150,143
050,24,023,"Maryland","Garrett County",4,27,312,164,148
050,24,023,"Maryland","Garrett County",4,28,315,151,164
050,24,023,"Maryland","Garrett County",4,29,327,161,166
050,24,023,"Maryland","Garrett County",4,30,330,161,169
050,24,023,"Maryland","Garrett County",4,31,347,172,175
050,24,023,"Maryland","Garrett County",4,32,348,187,161
050,24,023,"Maryland","Garrett County",4,33,330,179,151
050,24,023,"Maryland","Garrett County",4,34,284,146,138
050,24,023,"Maryland","Garrett County",4,35,289,139,150
050,24,023,"Maryland","Garrett County",4,36,291,160,131
050,24,023,"Maryland","Garrett County",4,37,303,153,150
050,24,023,"Maryland","Garrett County",4,38,309,145,164
050,24,023,"Maryland","Garrett County",4,39,309,156,153
050,24,023,"Maryland","Garrett County",4,40,308,149,159
050,24,023,"Maryland","Garrett County",4,41,324,151,173
050,24,023,"Maryland","Garrett County",4,42,348,174,174
050,24,023,"Maryland","Garrett County",4,43,335,169,166
050,24,023,"Maryland","Garrett County",4,44,335,172,163
050,24,023,"Maryland","Garrett County",4,45,322,165,157
050,24,023,"Maryland","Garrett County",4,46,294,155,139
050,24,023,"Maryland","Garrett County",4,47,316,167,149
050,24,023,"Maryland","Garrett County",4,48,311,149,162
050,24,023,"Maryland","Garrett County",4,49,360,161,199
050,24,023,"Maryland","Garrett County",4,50,391,183,208
050,24,023,"Maryland","Garrett County",4,51,419,206,213
050,24,023,"Maryland","Garrett County",4,52,391,184,207
050,24,023,"Maryland","Garrett County",4,53,396,181,215
050,24,023,"Maryland","Garrett County",4,54,398,209,189
050,24,023,"Maryland","Garrett County",4,55,389,202,187
050,24,023,"Maryland","Garrett County",4,56,408,206,202
050,24,023,"Maryland","Garrett County",4,57,452,233,219
050,24,023,"Maryland","Garrett County",4,58,425,219,206
050,24,023,"Maryland","Garrett County",4,59,453,229,224
050,24,023,"Maryland","Garrett County",4,60,479,233,246
050,24,023,"Maryland","Garrett County",4,61,518,244,274
050,24,023,"Maryland","Garrett County",4,62,497,252,245
050,24,023,"Maryland","Garrett County",4,63,481,236,245
050,24,023,"Maryland","Garrett County",4,64,515,256,259
050,24,023,"Maryland","Garrett County",4,65,511,250,261
050,24,023,"Maryland","Garrett County",4,66,441,213,228
050,24,023,"Maryland","Garrett County",4,67,422,212,210
050,24,023,"Maryland","Garrett County",4,68,419,205,214
050,24,023,"Maryland","Garrett County",4,69,398,202,196
050,24,023,"Maryland","Garrett County",4,70,398,199,199
050,24,023,"Maryland","Garrett County",4,71,378,183,195
050,24,023,"Maryland","Garrett County",4,72,357,167,190
050,24,023,"Maryland","Garrett County",4,73,342,168,174
050,24,023,"Maryland","Garrett County",4,74,337,166,171
050,24,023,"Maryland","Garrett County",4,75,356,176,180
050,24,023,"Maryland","Garrett County",4,76,240,113,127
050,24,023,"Maryland","Garrett County",4,77,262,129,133
050,24,023,"Maryland","Garrett County",4,78,248,118,130
050,24,023,"Maryland","Garrett County",4,79,240,117,123
050,24,023,"Maryland","Garrett County",4,80,225,104,121
050,24,023,"Maryland","Garrett County",4,81,164,79,85
050,24,023,"Maryland","Garrett County",4,82,157,72,85
050,24,023,"Maryland","Garrett County",4,83,156,73,83
050,24,023,"Maryland","Garrett County",4,84,139,59,80
050,24,023,"Maryland","Garrett County",4,85,749,290,459
050,24,023,"Maryland","Garrett County",5,0,212,115,97
050,24,023,"Maryland","Garrett County",5,1,211,114,97
050,24,023,"Maryland","Garrett County",5,2,243,126,117
050,24,023,"Maryland","Garrett County",5,3,277,149,128
050,24,023,"Maryland","Garrett County",5,4,267,135,132
050,24,023,"Maryland","Garrett County",5,5,274,142,132
050,24,023,"Maryland","Garrett County",5,6,292,142,150
050,24,023,"Maryland","Garrett County",5,7,285,141,144
050,24,023,"Maryland","Garrett County",5,8,275,130,145
050,24,023,"Maryland","Garrett County",5,9,266,131,135
050,24,023,"Maryland","Garrett County",5,10,280,141,139
050,24,023,"Maryland","Garrett County",5,11,284,140,144
050,24,023,"Maryland","Garrett County",5,12,263,124,139
050,24,023,"Maryland","Garrett County",5,13,273,146,127
050,24,023,"Maryland","Garrett County",5,14,268,135,133
050,24,023,"Maryland","Garrett County",5,15,320,169,151
050,24,023,"Maryland","Garrett County",5,16,332,184,148
050,24,023,"Maryland","Garrett County",5,17,321,179,142
050,24,023,"Maryland","Garrett County",5,18,317,170,147
050,24,023,"Maryland","Garrett County",5,19,256,134,122
050,24,023,"Maryland","Garrett County",5,20,257,137,120
050,24,023,"Maryland","Garrett County",5,21,259,138,121
050,24,023,"Maryland","Garrett County",5,22,272,145,127
050,24,023,"Maryland","Garrett County",5,23,288,152,136
050,24,023,"Maryland","Garrett County",5,24,319,176,143
050,24,023,"Maryland","Garrett County",5,25,311,164,147
050,24,023,"Maryland","Garrett County",5,26,305,166,139
050,24,023,"Maryland","Garrett County",5,27,304,153,151
050,24,023,"Maryland","Garrett County",5,28,304,161,143
050,24,023,"Maryland","Garrett County",5,29,312,148,164
050,24,023,"Maryland","Garrett County",5,30,328,159,169
050,24,023,"Maryland","Garrett County",5,31,345,168,177
050,24,023,"Maryland","Garrett County",5,32,346,176,170
050,24,023,"Maryland","Garrett County",5,33,347,189,158
050,24,023,"Maryland","Garrett County",5,34,333,173,160
050,24,023,"Maryland","Garrett County",5,35,282,147,135
050,24,023,"Maryland","Garrett County",5,36,293,145,148
050,24,023,"Maryland","Garrett County",5,37,290,159,131
050,24,023,"Maryland","Garrett County",5,38,285,148,137
050,24,023,"Maryland","Garrett County",5,39,318,150,168
050,24,023,"Maryland","Garrett County",5,40,314,159,155
050,24,023,"Maryland","Garrett County",5,41,315,156,159
050,24,023,"Maryland","Garrett County",5,42,317,153,164
050,24,023,"Maryland","Garrett County",5,43,349,172,177
050,24,023,"Maryland","Garrett County",5,44,331,172,159
050,24,023,"Maryland","Garrett County",5,45,331,169,162
050,24,023,"Maryland","Garrett County",5,46,317,162,155
050,24,023,"Maryland","Garrett County",5,47,290,154,136
050,24,023,"Maryland","Garrett County",5,48,315,167,148
050,24,023,"Maryland","Garrett County",5,49,306,148,158
050,24,023,"Maryland","Garrett County",5,50,355,159,196
050,24,023,"Maryland","Garrett County",5,51,389,183,206
050,24,023,"Maryland","Garrett County",5,52,421,207,214
050,24,023,"Maryland","Garrett County",5,53,398,183,215
050,24,023,"Maryland","Garrett County",5,54,390,175,215
050,24,023,"Maryland","Garrett County",5,55,392,204,188
050,24,023,"Maryland","Garrett County",5,56,385,199,186
050,24,023,"Maryland","Garrett County",5,57,414,210,204
050,24,023,"Maryland","Garrett County",5,58,451,232,219
050,24,023,"Maryland","Garrett County",5,59,424,217,207
050,24,023,"Maryland","Garrett County",5,60,457,236,221
050,24,023,"Maryland","Garrett County",5,61,488,235,253
050,24,023,"Maryland","Garrett County",5,62,518,242,276
050,24,023,"Maryland","Garrett County",5,63,505,257,248
050,24,023,"Maryland","Garrett County",5,64,474,235,239
050,24,023,"Maryland","Garrett County",5,65,512,256,256
050,24,023,"Maryland","Garrett County",5,66,497,245,252
050,24,023,"Maryland","Garrett County",5,67,444,214,230
050,24,023,"Maryland","Garrett County",5,68,420,208,212
050,24,023,"Maryland","Garrett County",5,69,414,203,211
050,24,023,"Maryland","Garrett County",5,70,380,191,189
050,24,023,"Maryland","Garrett County",5,71,400,200,200
050,24,023,"Maryland","Garrett County",5,72,374,175,199
050,24,023,"Maryland","Garrett County",5,73,345,162,183
050,24,023,"Maryland","Garrett County",5,74,323,159,164
050,24,023,"Maryland","Garrett County",5,75,329,161,168
050,24,023,"Maryland","Garrett County",5,76,342,166,176
050,24,023,"Maryland","Garrett County",5,77,231,108,123
050,24,023,"Maryland","Garrett County",5,78,252,125,127
050,24,023,"Maryland","Garrett County",5,79,226,106,120
050,24,023,"Maryland","Garrett County",5,80,243,112,131
050,24,023,"Maryland","Garrett County",5,81,202,95,107
050,24,023,"Maryland","Garrett County",5,82,166,76,90
050,24,023,"Maryland","Garrett County",5,83,142,71,71
050,24,023,"Maryland","Garrett County",5,84,149,65,84
050,24,023,"Maryland","Garrett County",5,85,772,311,461
050,24,025,"Maryland","Harford County",1,0,2687,1373,1314
050,24,025,"Maryland","Harford County",1,1,2772,1418,1354
050,24,025,"Maryland","Harford County",1,2,2867,1492,1375
050,24,025,"Maryland","Harford County",1,3,3064,1565,1499
050,24,025,"Maryland","Harford County",1,4,3098,1568,1530
050,24,025,"Maryland","Harford County",1,5,3315,1685,1630
050,24,025,"Maryland","Harford County",1,6,3214,1646,1568
050,24,025,"Maryland","Harford County",1,7,3154,1627,1527
050,24,025,"Maryland","Harford County",1,8,3186,1630,1556
050,24,025,"Maryland","Harford County",1,9,3245,1661,1584
050,24,025,"Maryland","Harford County",1,10,3355,1697,1658
050,24,025,"Maryland","Harford County",1,11,3537,1790,1747
050,24,025,"Maryland","Harford County",1,12,3632,1869,1763
050,24,025,"Maryland","Harford County",1,13,3603,1890,1713
050,24,025,"Maryland","Harford County",1,14,3548,1850,1698
050,24,025,"Maryland","Harford County",1,15,3489,1807,1682
050,24,025,"Maryland","Harford County",1,16,3580,1826,1754
050,24,025,"Maryland","Harford County",1,17,3602,1864,1738
050,24,025,"Maryland","Harford County",1,18,3038,1640,1398
050,24,025,"Maryland","Harford County",1,19,2528,1382,1146
050,24,025,"Maryland","Harford County",1,20,2699,1418,1281
050,24,025,"Maryland","Harford County",1,21,2829,1450,1379
050,24,025,"Maryland","Harford County",1,22,2876,1425,1451
050,24,025,"Maryland","Harford County",1,23,3037,1504,1533
050,24,025,"Maryland","Harford County",1,24,3066,1562,1504
050,24,025,"Maryland","Harford County",1,25,3064,1578,1486
050,24,025,"Maryland","Harford County",1,26,3078,1536,1542
050,24,025,"Maryland","Harford County",1,27,3092,1537,1555
050,24,025,"Maryland","Harford County",1,28,3111,1559,1552
050,24,025,"Maryland","Harford County",1,29,3172,1581,1591
050,24,025,"Maryland","Harford County",1,30,3248,1595,1653
050,24,025,"Maryland","Harford County",1,31,3108,1545,1563
050,24,025,"Maryland","Harford County",1,32,3260,1603,1657
050,24,025,"Maryland","Harford County",1,33,3406,1681,1725
050,24,025,"Maryland","Harford County",1,34,3478,1772,1706
050,24,025,"Maryland","Harford County",1,35,3523,1752,1771
050,24,025,"Maryland","Harford County",1,36,3560,1713,1847
050,24,025,"Maryland","Harford County",1,37,3655,1836,1819
050,24,025,"Maryland","Harford County",1,38,3590,1792,1798
050,24,025,"Maryland","Harford County",1,39,3546,1710,1836
050,24,025,"Maryland","Harford County",1,40,3365,1630,1735
050,24,025,"Maryland","Harford County",1,41,3205,1557,1648
050,24,025,"Maryland","Harford County",1,42,3215,1591,1624
050,24,025,"Maryland","Harford County",1,43,3101,1558,1543
050,24,025,"Maryland","Harford County",1,44,3069,1531,1538
050,24,025,"Maryland","Harford County",1,45,3077,1509,1568
050,24,025,"Maryland","Harford County",1,46,3079,1506,1573
050,24,025,"Maryland","Harford County",1,47,3169,1571,1598
050,24,025,"Maryland","Harford County",1,48,3503,1729,1774
050,24,025,"Maryland","Harford County",1,49,3776,1841,1935
050,24,025,"Maryland","Harford County",1,50,3604,1746,1858
050,24,025,"Maryland","Harford County",1,51,3591,1746,1845
050,24,025,"Maryland","Harford County",1,52,3655,1808,1847
050,24,025,"Maryland","Harford County",1,53,3687,1802,1885
050,24,025,"Maryland","Harford County",1,54,3815,1873,1942
050,24,025,"Maryland","Harford County",1,55,4110,2041,2069
050,24,025,"Maryland","Harford County",1,56,4129,2040,2089
050,24,025,"Maryland","Harford County",1,57,3994,1981,2013
050,24,025,"Maryland","Harford County",1,58,3970,1971,1999
050,24,025,"Maryland","Harford County",1,59,3958,1926,2032
050,24,025,"Maryland","Harford County",1,60,3872,1884,1988
050,24,025,"Maryland","Harford County",1,61,3815,1868,1947
050,24,025,"Maryland","Harford County",1,62,3631,1780,1851
050,24,025,"Maryland","Harford County",1,63,3446,1685,1761
050,24,025,"Maryland","Harford County",1,64,3288,1619,1669
050,24,025,"Maryland","Harford County",1,65,3137,1502,1635
050,24,025,"Maryland","Harford County",1,66,2908,1356,1552
050,24,025,"Maryland","Harford County",1,67,2927,1375,1552
050,24,025,"Maryland","Harford County",1,68,2827,1355,1472
050,24,025,"Maryland","Harford County",1,69,2562,1212,1350
050,24,025,"Maryland","Harford County",1,70,2467,1149,1318
050,24,025,"Maryland","Harford County",1,71,2430,1137,1293
050,24,025,"Maryland","Harford County",1,72,2538,1175,1363
050,24,025,"Maryland","Harford County",1,73,2566,1217,1349
050,24,025,"Maryland","Harford County",1,74,1734,788,946
050,24,025,"Maryland","Harford County",1,75,1702,747,955
050,24,025,"Maryland","Harford County",1,76,1671,737,934
050,24,025,"Maryland","Harford County",1,77,1693,754,939
050,24,025,"Maryland","Harford County",1,78,1449,648,801
050,24,025,"Maryland","Harford County",1,79,1305,544,761
050,24,025,"Maryland","Harford County",1,80,1112,470,642
050,24,025,"Maryland","Harford County",1,81,1053,444,609
050,24,025,"Maryland","Harford County",1,82,953,389,564
050,24,025,"Maryland","Harford County",1,83,782,316,466
050,24,025,"Maryland","Harford County",1,84,731,310,421
050,24,025,"Maryland","Harford County",1,85,4339,1421,2918
050,24,025,"Maryland","Harford County",2,0,2661,1359,1302
050,24,025,"Maryland","Harford County",2,1,2760,1411,1349
050,24,025,"Maryland","Harford County",2,2,2871,1489,1382
050,24,025,"Maryland","Harford County",2,3,3021,1547,1474
050,24,025,"Maryland","Harford County",2,4,3125,1583,1542
050,24,025,"Maryland","Harford County",2,5,3291,1670,1621
050,24,025,"Maryland","Harford County",2,6,3270,1672,1598
050,24,025,"Maryland","Harford County",2,7,3183,1638,1545
050,24,025,"Maryland","Harford County",2,8,3190,1632,1558
050,24,025,"Maryland","Harford County",2,9,3243,1661,1582
050,24,025,"Maryland","Harford County",2,10,3339,1693,1646
050,24,025,"Maryland","Harford County",2,11,3494,1768,1726
050,24,025,"Maryland","Harford County",2,12,3636,1864,1772
050,24,025,"Maryland","Harford County",2,13,3614,1887,1727
050,24,025,"Maryland","Harford County",2,14,3564,1861,1703
050,24,025,"Maryland","Harford County",2,15,3507,1818,1689
050,24,025,"Maryland","Harford County",2,16,3565,1829,1736
050,24,025,"Maryland","Harford County",2,17,3592,1856,1736
050,24,025,"Maryland","Harford County",2,18,3032,1632,1400
050,24,025,"Maryland","Harford County",2,19,2539,1381,1158
050,24,025,"Maryland","Harford County",2,20,2729,1443,1286
050,24,025,"Maryland","Harford County",2,21,2809,1442,1367
050,24,025,"Maryland","Harford County",2,22,2892,1441,1451
050,24,025,"Maryland","Harford County",2,23,3028,1504,1524
050,24,025,"Maryland","Harford County",2,24,3057,1555,1502
050,24,025,"Maryland","Harford County",2,25,3062,1576,1486
050,24,025,"Maryland","Harford County",2,26,3089,1552,1537
050,24,025,"Maryland","Harford County",2,27,3100,1541,1559
050,24,025,"Maryland","Harford County",2,28,3114,1553,1561
050,24,025,"Maryland","Harford County",2,29,3185,1588,1597
050,24,025,"Maryland","Harford County",2,30,3259,1602,1657
050,24,025,"Maryland","Harford County",2,31,3150,1559,1591
050,24,025,"Maryland","Harford County",2,32,3239,1593,1646
050,24,025,"Maryland","Harford County",2,33,3379,1672,1707
050,24,025,"Maryland","Harford County",2,34,3479,1762,1717
050,24,025,"Maryland","Harford County",2,35,3556,1780,1776
050,24,025,"Maryland","Harford County",2,36,3544,1721,1823
050,24,025,"Maryland","Harford County",2,37,3650,1817,1833
050,24,025,"Maryland","Harford County",2,38,3622,1804,1818
050,24,025,"Maryland","Harford County",2,39,3552,1728,1824
050,24,025,"Maryland","Harford County",2,40,3452,1669,1783
050,24,025,"Maryland","Harford County",2,41,3253,1581,1672
050,24,025,"Maryland","Harford County",2,42,3191,1572,1619
050,24,025,"Maryland","Harford County",2,43,3157,1580,1577
050,24,025,"Maryland","Harford County",2,44,3054,1528,1526
050,24,025,"Maryland","Harford County",2,45,3095,1525,1570
050,24,025,"Maryland","Harford County",2,46,3062,1503,1559
050,24,025,"Maryland","Harford County",2,47,3140,1555,1585
050,24,025,"Maryland","Harford County",2,48,3419,1692,1727
050,24,025,"Maryland","Harford County",2,49,3717,1819,1898
050,24,025,"Maryland","Harford County",2,50,3648,1773,1875
050,24,025,"Maryland","Harford County",2,51,3573,1737,1836
050,24,025,"Maryland","Harford County",2,52,3625,1786,1839
050,24,025,"Maryland","Harford County",2,53,3665,1795,1870
050,24,025,"Maryland","Harford County",2,54,3771,1855,1916
050,24,025,"Maryland","Harford County",2,55,4021,1990,2031
050,24,025,"Maryland","Harford County",2,56,4120,2043,2077
050,24,025,"Maryland","Harford County",2,57,4017,1990,2027
050,24,025,"Maryland","Harford County",2,58,3959,1962,1997
050,24,025,"Maryland","Harford County",2,59,3962,1936,2026
050,24,025,"Maryland","Harford County",2,60,3880,1889,1991
050,24,025,"Maryland","Harford County",2,61,3804,1861,1943
050,24,025,"Maryland","Harford County",2,62,3657,1790,1867
050,24,025,"Maryland","Harford County",2,63,3501,1711,1790
050,24,025,"Maryland","Harford County",2,64,3292,1617,1675
050,24,025,"Maryland","Harford County",2,65,3149,1516,1633
050,24,025,"Maryland","Harford County",2,66,2969,1393,1576
050,24,025,"Maryland","Harford County",2,67,2904,1364,1540
050,24,025,"Maryland","Harford County",2,68,2828,1348,1480
050,24,025,"Maryland","Harford County",2,69,2629,1242,1387
050,24,025,"Maryland","Harford County",2,70,2471,1154,1317
050,24,025,"Maryland","Harford County",2,71,2434,1131,1303
050,24,025,"Maryland","Harford County",2,72,2459,1137,1322
050,24,025,"Maryland","Harford County",2,73,2666,1257,1409
050,24,025,"Maryland","Harford County",2,74,1811,830,981
050,24,025,"Maryland","Harford County",2,75,1703,760,943
050,24,025,"Maryland","Harford County",2,76,1654,731,923
050,24,025,"Maryland","Harford County",2,77,1707,754,953
050,24,025,"Maryland","Harford County",2,78,1462,654,808
050,24,025,"Maryland","Harford County",2,79,1317,555,762
050,24,025,"Maryland","Harford County",2,80,1144,482,662
050,24,025,"Maryland","Harford County",2,81,1045,443,602
050,24,025,"Maryland","Harford County",2,82,961,396,565
050,24,025,"Maryland","Harford County",2,83,814,330,484
050,24,025,"Maryland","Harford County",2,84,730,308,422
050,24,025,"Maryland","Harford County",2,85,4346,1435,2911
050,24,025,"Maryland","Harford County",3,0,2579,1322,1257
050,24,025,"Maryland","Harford County",3,1,2773,1430,1343
050,24,025,"Maryland","Harford County",3,2,2828,1428,1400
050,24,025,"Maryland","Harford County",3,3,2999,1547,1452
050,24,025,"Maryland","Harford County",3,4,3161,1633,1528
050,24,025,"Maryland","Harford County",3,5,3219,1633,1586
050,24,025,"Maryland","Harford County",3,6,3346,1681,1665
050,24,025,"Maryland","Harford County",3,7,3315,1683,1632
050,24,025,"Maryland","Harford County",3,8,3249,1680,1569
050,24,025,"Maryland","Harford County",3,9,3265,1673,1592
050,24,025,"Maryland","Harford County",3,10,3314,1704,1610
050,24,025,"Maryland","Harford County",3,11,3412,1733,1679
050,24,025,"Maryland","Harford County",3,12,3538,1787,1751
050,24,025,"Maryland","Harford County",3,13,3644,1850,1794
050,24,025,"Maryland","Harford County",3,14,3639,1891,1748
050,24,025,"Maryland","Harford County",3,15,3575,1879,1696
050,24,025,"Maryland","Harford County",3,16,3543,1805,1738
050,24,025,"Maryland","Harford County",3,17,3553,1829,1724
050,24,025,"Maryland","Harford County",3,18,3059,1628,1431
050,24,025,"Maryland","Harford County",3,19,2518,1352,1166
050,24,025,"Maryland","Harford County",3,20,2719,1470,1249
050,24,025,"Maryland","Harford County",3,21,2846,1483,1363
050,24,025,"Maryland","Harford County",3,22,2989,1531,1458
050,24,025,"Maryland","Harford County",3,23,3040,1521,1519
050,24,025,"Maryland","Harford County",3,24,3049,1526,1523
050,24,025,"Maryland","Harford County",3,25,3073,1572,1501
050,24,025,"Maryland","Harford County",3,26,3120,1587,1533
050,24,025,"Maryland","Harford County",3,27,3133,1596,1537
050,24,025,"Maryland","Harford County",3,28,3134,1584,1550
050,24,025,"Maryland","Harford County",3,29,3183,1582,1601
050,24,025,"Maryland","Harford County",3,30,3261,1638,1623
050,24,025,"Maryland","Harford County",3,31,3405,1658,1747
050,24,025,"Maryland","Harford County",3,32,3308,1646,1662
050,24,025,"Maryland","Harford County",3,33,3379,1653,1726
050,24,025,"Maryland","Harford County",3,34,3493,1738,1755
050,24,025,"Maryland","Harford County",3,35,3585,1806,1779
050,24,025,"Maryland","Harford County",3,36,3669,1822,1847
050,24,025,"Maryland","Harford County",3,37,3662,1783,1879
050,24,025,"Maryland","Harford County",3,38,3679,1805,1874
050,24,025,"Maryland","Harford County",3,39,3634,1818,1816
050,24,025,"Maryland","Harford County",3,40,3623,1759,1864
050,24,025,"Maryland","Harford County",3,41,3495,1696,1799
050,24,025,"Maryland","Harford County",3,42,3295,1600,1695
050,24,025,"Maryland","Harford County",3,43,3244,1600,1644
050,24,025,"Maryland","Harford County",3,44,3203,1617,1586
050,24,025,"Maryland","Harford County",3,45,3062,1522,1540
050,24,025,"Maryland","Harford County",3,46,3050,1508,1542
050,24,025,"Maryland","Harford County",3,47,3055,1492,1563
050,24,025,"Maryland","Harford County",3,48,3129,1562,1567
050,24,025,"Maryland","Harford County",3,49,3387,1667,1720
050,24,025,"Maryland","Harford County",3,50,3694,1795,1899
050,24,025,"Maryland","Harford County",3,51,3630,1759,1871
050,24,025,"Maryland","Harford County",3,52,3587,1739,1848
050,24,025,"Maryland","Harford County",3,53,3639,1787,1852
050,24,025,"Maryland","Harford County",3,54,3639,1786,1853
050,24,025,"Maryland","Harford County",3,55,3752,1846,1906
050,24,025,"Maryland","Harford County",3,56,3968,1951,2017
050,24,025,"Maryland","Harford County",3,57,4063,1996,2067
050,24,025,"Maryland","Harford County",3,58,4000,1963,2037
050,24,025,"Maryland","Harford County",3,59,3907,1930,1977
050,24,025,"Maryland","Harford County",3,60,3924,1914,2010
050,24,025,"Maryland","Harford County",3,61,3840,1863,1977
050,24,025,"Maryland","Harford County",3,62,3740,1820,1920
050,24,025,"Maryland","Harford County",3,63,3634,1765,1869
050,24,025,"Maryland","Harford County",3,64,3411,1668,1743
050,24,025,"Maryland","Harford County",3,65,3233,1574,1659
050,24,025,"Maryland","Harford County",3,66,3071,1471,1600
050,24,025,"Maryland","Harford County",3,67,2901,1343,1558
050,24,025,"Maryland","Harford County",3,68,2854,1333,1521
050,24,025,"Maryland","Harford County",3,69,2774,1309,1465
050,24,025,"Maryland","Harford County",3,70,2589,1239,1350
050,24,025,"Maryland","Harford County",3,71,2400,1105,1295
050,24,025,"Maryland","Harford County",3,72,2392,1095,1297
050,24,025,"Maryland","Harford County",3,73,2395,1100,1295
050,24,025,"Maryland","Harford County",3,74,2598,1196,1402
050,24,025,"Maryland","Harford County",3,75,1766,807,959
050,24,025,"Maryland","Harford County",3,76,1637,720,917
050,24,025,"Maryland","Harford County",3,77,1586,693,893
050,24,025,"Maryland","Harford County",3,78,1634,715,919
050,24,025,"Maryland","Harford County",3,79,1395,614,781
050,24,025,"Maryland","Harford County",3,80,1222,513,709
050,24,025,"Maryland","Harford County",3,81,1078,451,627
050,24,025,"Maryland","Harford County",3,82,973,406,567
050,24,025,"Maryland","Harford County",3,83,903,367,536
050,24,025,"Maryland","Harford County",3,84,735,306,429
050,24,025,"Maryland","Harford County",3,85,4305,1433,2872
050,24,025,"Maryland","Harford County",4,0,2626,1364,1262
050,24,025,"Maryland","Harford County",4,1,2736,1424,1312
050,24,025,"Maryland","Harford County",4,2,2881,1489,1392
050,24,025,"Maryland","Harford County",4,3,2948,1479,1469
050,24,025,"Maryland","Harford County",4,4,3079,1583,1496
050,24,025,"Maryland","Harford County",4,5,3204,1674,1530
050,24,025,"Maryland","Harford County",4,6,3274,1659,1615
050,24,025,"Maryland","Harford County",4,7,3371,1702,1669
050,24,025,"Maryland","Harford County",4,8,3325,1707,1618
050,24,025,"Maryland","Harford County",4,9,3303,1689,1614
050,24,025,"Maryland","Harford County",4,10,3302,1687,1615
050,24,025,"Maryland","Harford County",4,11,3373,1731,1642
050,24,025,"Maryland","Harford County",4,12,3436,1735,1701
050,24,025,"Maryland","Harford County",4,13,3577,1808,1769
050,24,025,"Maryland","Harford County",4,14,3682,1880,1802
050,24,025,"Maryland","Harford County",4,15,3653,1906,1747
050,24,025,"Maryland","Harford County",4,16,3585,1902,1683
050,24,025,"Maryland","Harford County",4,17,3518,1804,1714
050,24,025,"Maryland","Harford County",4,18,3031,1603,1428
050,24,025,"Maryland","Harford County",4,19,2452,1321,1131
050,24,025,"Maryland","Harford County",4,20,2622,1393,1229
050,24,025,"Maryland","Harford County",4,21,2824,1526,1298
050,24,025,"Maryland","Harford County",4,22,2979,1566,1413
050,24,025,"Maryland","Harford County",4,23,3026,1556,1470
050,24,025,"Maryland","Harford County",4,24,3010,1530,1480
050,24,025,"Maryland","Harford County",4,25,3005,1504,1501
050,24,025,"Maryland","Harford County",4,26,2996,1540,1456
050,24,025,"Maryland","Harford County",4,27,3126,1584,1542
050,24,025,"Maryland","Harford County",4,28,3098,1562,1536
050,24,025,"Maryland","Harford County",4,29,3176,1617,1559
050,24,025,"Maryland","Harford County",4,30,3239,1607,1632
050,24,025,"Maryland","Harford County",4,31,3298,1648,1650
050,24,025,"Maryland","Harford County",4,32,3492,1689,1803
050,24,025,"Maryland","Harford County",4,33,3400,1688,1712
050,24,025,"Maryland","Harford County",4,34,3448,1666,1782
050,24,025,"Maryland","Harford County",4,35,3539,1755,1784
050,24,025,"Maryland","Harford County",4,36,3653,1833,1820
050,24,025,"Maryland","Harford County",4,37,3750,1874,1876
050,24,025,"Maryland","Harford County",4,38,3695,1798,1897
050,24,025,"Maryland","Harford County",4,39,3747,1841,1906
050,24,025,"Maryland","Harford County",4,40,3669,1836,1833
050,24,025,"Maryland","Harford County",4,41,3697,1803,1894
050,24,025,"Maryland","Harford County",4,42,3513,1702,1811
050,24,025,"Maryland","Harford County",4,43,3314,1607,1707
050,24,025,"Maryland","Harford County",4,44,3272,1611,1661
050,24,025,"Maryland","Harford County",4,45,3217,1615,1602
050,24,025,"Maryland","Harford County",4,46,3033,1509,1524
050,24,025,"Maryland","Harford County",4,47,3101,1549,1552
050,24,025,"Maryland","Harford County",4,48,3067,1495,1572
050,24,025,"Maryland","Harford County",4,49,3113,1547,1566
050,24,025,"Maryland","Harford County",4,50,3343,1648,1695
050,24,025,"Maryland","Harford County",4,51,3684,1800,1884
050,24,025,"Maryland","Harford County",4,52,3607,1749,1858
050,24,025,"Maryland","Harford County",4,53,3530,1713,1817
050,24,025,"Maryland","Harford County",4,54,3548,1755,1793
050,24,025,"Maryland","Harford County",4,55,3602,1770,1832
050,24,025,"Maryland","Harford County",4,56,3682,1790,1892
050,24,025,"Maryland","Harford County",4,57,3888,1907,1981
050,24,025,"Maryland","Harford County",4,58,4002,1958,2044
050,24,025,"Maryland","Harford County",4,59,3937,1942,1995
050,24,025,"Maryland","Harford County",4,60,3832,1877,1955
050,24,025,"Maryland","Harford County",4,61,3841,1867,1974
050,24,025,"Maryland","Harford County",4,62,3758,1821,1937
050,24,025,"Maryland","Harford County",4,63,3637,1760,1877
050,24,025,"Maryland","Harford County",4,64,3550,1732,1818
050,24,025,"Maryland","Harford County",4,65,3385,1633,1752
050,24,025,"Maryland","Harford County",4,66,3158,1532,1626
050,24,025,"Maryland","Harford County",4,67,2994,1425,1569
050,24,025,"Maryland","Harford County",4,68,2858,1311,1547
050,24,025,"Maryland","Harford County",4,69,2795,1291,1504
050,24,025,"Maryland","Harford County",4,70,2708,1275,1433
050,24,025,"Maryland","Harford County",4,71,2537,1197,1340
050,24,025,"Maryland","Harford County",4,72,2343,1067,1276
050,24,025,"Maryland","Harford County",4,73,2356,1085,1271
050,24,025,"Maryland","Harford County",4,74,2324,1055,1269
050,24,025,"Maryland","Harford County",4,75,2541,1168,1373
050,24,025,"Maryland","Harford County",4,76,1685,760,925
050,24,025,"Maryland","Harford County",4,77,1574,679,895
050,24,025,"Maryland","Harford County",4,78,1536,667,869
050,24,025,"Maryland","Harford County",4,79,1586,680,906
050,24,025,"Maryland","Harford County",4,80,1322,583,739
050,24,025,"Maryland","Harford County",4,81,1152,477,675
050,24,025,"Maryland","Harford County",4,82,1004,410,594
050,24,025,"Maryland","Harford County",4,83,920,378,542
050,24,025,"Maryland","Harford County",4,84,801,333,468
050,24,025,"Maryland","Harford County",4,85,4320,1459,2861
050,24,025,"Maryland","Harford County",5,0,2602,1353,1249
050,24,025,"Maryland","Harford County",5,1,2719,1429,1290
050,24,025,"Maryland","Harford County",5,2,2800,1439,1361
050,24,025,"Maryland","Harford County",5,3,2929,1515,1414
050,24,025,"Maryland","Harford County",5,4,3004,1518,1486
050,24,025,"Maryland","Harford County",5,5,3120,1597,1523
050,24,025,"Maryland","Harford County",5,6,3252,1688,1564
050,24,025,"Maryland","Harford County",5,7,3337,1712,1625
050,24,025,"Maryland","Harford County",5,8,3396,1717,1679
050,24,025,"Maryland","Harford County",5,9,3387,1726,1661
050,24,025,"Maryland","Harford County",5,10,3296,1678,1618
050,24,025,"Maryland","Harford County",5,11,3341,1701,1640
050,24,025,"Maryland","Harford County",5,12,3401,1736,1665
050,24,025,"Maryland","Harford County",5,13,3440,1746,1694
050,24,025,"Maryland","Harford County",5,14,3598,1813,1785
050,24,025,"Maryland","Harford County",5,15,3702,1888,1814
050,24,025,"Maryland","Harford County",5,16,3661,1908,1753
050,24,025,"Maryland","Harford County",5,17,3609,1907,1702
050,24,025,"Maryland","Harford County",5,18,2955,1564,1391
050,24,025,"Maryland","Harford County",5,19,2466,1307,1159
050,24,025,"Maryland","Harford County",5,20,2657,1400,1257
050,24,025,"Maryland","Harford County",5,21,2777,1446,1331
050,24,025,"Maryland","Harford County",5,22,2977,1579,1398
050,24,025,"Maryland","Harford County",5,23,3050,1598,1452
050,24,025,"Maryland","Harford County",5,24,2980,1546,1434
050,24,025,"Maryland","Harford County",5,25,2972,1511,1461
050,24,025,"Maryland","Harford County",5,26,2988,1517,1471
050,24,025,"Maryland","Harford County",5,27,3039,1547,1492
050,24,025,"Maryland","Harford County",5,28,3144,1604,1540
050,24,025,"Maryland","Harford County",5,29,3086,1545,1541
050,24,025,"Maryland","Harford County",5,30,3219,1635,1584
050,24,025,"Maryland","Harford County",5,31,3260,1629,1631
050,24,025,"Maryland","Harford County",5,32,3370,1672,1698
050,24,025,"Maryland","Harford County",5,33,3557,1711,1846
050,24,025,"Maryland","Harford County",5,34,3490,1732,1758
050,24,025,"Maryland","Harford County",5,35,3508,1679,1829
050,24,025,"Maryland","Harford County",5,36,3581,1801,1780
050,24,025,"Maryland","Harford County",5,37,3682,1832,1850
050,24,025,"Maryland","Harford County",5,38,3814,1919,1895
050,24,025,"Maryland","Harford County",5,39,3696,1784,1912
050,24,025,"Maryland","Harford County",5,40,3785,1844,1941
050,24,025,"Maryland","Harford County",5,41,3713,1857,1856
050,24,025,"Maryland","Harford County",5,42,3761,1841,1920
050,24,025,"Maryland","Harford County",5,43,3510,1691,1819
050,24,025,"Maryland","Harford County",5,44,3314,1600,1714
050,24,025,"Maryland","Harford County",5,45,3272,1594,1678
050,24,025,"Maryland","Harford County",5,46,3223,1622,1601
050,24,025,"Maryland","Harford County",5,47,3043,1513,1530
050,24,025,"Maryland","Harford County",5,48,3084,1534,1550
050,24,025,"Maryland","Harford County",5,49,3064,1493,1571
050,24,025,"Maryland","Harford County",5,50,3101,1547,1554
050,24,025,"Maryland","Harford County",5,51,3340,1647,1693
050,24,025,"Maryland","Harford County",5,52,3703,1807,1896
050,24,025,"Maryland","Harford County",5,53,3598,1760,1838
050,24,025,"Maryland","Harford County",5,54,3496,1690,1806
050,24,025,"Maryland","Harford County",5,55,3498,1727,1771
050,24,025,"Maryland","Harford County",5,56,3593,1787,1806
050,24,025,"Maryland","Harford County",5,57,3593,1744,1849
050,24,025,"Maryland","Harford County",5,58,3831,1875,1956
050,24,025,"Maryland","Harford County",5,59,3958,1916,2042
050,24,025,"Maryland","Harford County",5,60,3853,1908,1945
050,24,025,"Maryland","Harford County",5,61,3774,1835,1939
050,24,025,"Maryland","Harford County",5,62,3772,1823,1949
050,24,025,"Maryland","Harford County",5,63,3675,1773,1902
050,24,025,"Maryland","Harford County",5,64,3542,1699,1843
050,24,025,"Maryland","Harford County",5,65,3520,1715,1805
050,24,025,"Maryland","Harford County",5,66,3305,1591,1714
050,24,025,"Maryland","Harford County",5,67,3107,1506,1601
050,24,025,"Maryland","Harford County",5,68,2940,1403,1537
050,24,025,"Maryland","Harford County",5,69,2804,1279,1525
050,24,025,"Maryland","Harford County",5,70,2738,1273,1465
050,24,025,"Maryland","Harford County",5,71,2658,1226,1432
050,24,025,"Maryland","Harford County",5,72,2499,1178,1321
050,24,025,"Maryland","Harford County",5,73,2304,1054,1250
050,24,025,"Maryland","Harford County",5,74,2316,1053,1263
050,24,025,"Maryland","Harford County",5,75,2292,1044,1248
050,24,025,"Maryland","Harford County",5,76,2482,1127,1355
050,24,025,"Maryland","Harford County",5,77,1628,729,899
050,24,025,"Maryland","Harford County",5,78,1521,645,876
050,24,025,"Maryland","Harford County",5,79,1479,639,840
050,24,025,"Maryland","Harford County",5,80,1495,640,855
050,24,025,"Maryland","Harford County",5,81,1264,552,712
050,24,025,"Maryland","Harford County",5,82,1071,433,638
050,24,025,"Maryland","Harford County",5,83,957,383,574
050,24,025,"Maryland","Harford County",5,84,847,353,494
050,24,025,"Maryland","Harford County",5,85,4459,1517,2942
050,24,027,"Maryland","Howard County",1,0,3402,1738,1664
050,24,027,"Maryland","Howard County",1,1,3556,1835,1721
050,24,027,"Maryland","Howard County",1,2,3765,2015,1750
050,24,027,"Maryland","Howard County",1,3,4019,2075,1944
050,24,027,"Maryland","Howard County",1,4,4241,2145,2096
050,24,027,"Maryland","Howard County",1,5,4437,2288,2149
050,24,027,"Maryland","Howard County",1,6,4400,2292,2108
050,24,027,"Maryland","Howard County",1,7,4514,2289,2225
050,24,027,"Maryland","Howard County",1,8,4535,2331,2204
050,24,027,"Maryland","Howard County",1,9,4685,2437,2248
050,24,027,"Maryland","Howard County",1,10,4800,2408,2392
050,24,027,"Maryland","Howard County",1,11,4855,2475,2380
050,24,027,"Maryland","Howard County",1,12,5052,2592,2460
050,24,027,"Maryland","Howard County",1,13,4989,2598,2391
050,24,027,"Maryland","Howard County",1,14,4921,2546,2375
050,24,027,"Maryland","Howard County",1,15,4960,2542,2418
050,24,027,"Maryland","Howard County",1,16,5111,2604,2507
050,24,027,"Maryland","Howard County",1,17,4969,2534,2435
050,24,027,"Maryland","Howard County",1,18,4165,2166,1999
050,24,027,"Maryland","Howard County",1,19,3458,1825,1633
050,24,027,"Maryland","Howard County",1,20,3565,1852,1713
050,24,027,"Maryland","Howard County",1,21,3559,1832,1727
050,24,027,"Maryland","Howard County",1,22,3697,1863,1834
050,24,027,"Maryland","Howard County",1,23,3718,1905,1813
050,24,027,"Maryland","Howard County",1,24,3721,1942,1779
050,24,027,"Maryland","Howard County",1,25,3803,1980,1823
050,24,027,"Maryland","Howard County",1,26,3836,1946,1890
050,24,027,"Maryland","Howard County",1,27,3772,1922,1850
050,24,027,"Maryland","Howard County",1,28,3783,1923,1860
050,24,027,"Maryland","Howard County",1,29,3922,1974,1948
050,24,027,"Maryland","Howard County",1,30,4025,2032,1993
050,24,027,"Maryland","Howard County",1,31,4023,1986,2037
050,24,027,"Maryland","Howard County",1,32,4108,1984,2124
050,24,027,"Maryland","Howard County",1,33,4208,2014,2194
050,24,027,"Maryland","Howard County",1,34,4431,2132,2299
050,24,027,"Maryland","Howard County",1,35,4559,2132,2427
050,24,027,"Maryland","Howard County",1,36,4769,2254,2515
050,24,027,"Maryland","Howard County",1,37,4902,2327,2575
050,24,027,"Maryland","Howard County",1,38,5037,2453,2584
050,24,027,"Maryland","Howard County",1,39,5124,2490,2634
050,24,027,"Maryland","Howard County",1,40,5007,2407,2600
050,24,027,"Maryland","Howard County",1,41,4873,2378,2495
050,24,027,"Maryland","Howard County",1,42,4717,2318,2399
050,24,027,"Maryland","Howard County",1,43,4641,2240,2401
050,24,027,"Maryland","Howard County",1,44,4624,2253,2371
050,24,027,"Maryland","Howard County",1,45,4580,2223,2357
050,24,027,"Maryland","Howard County",1,46,4447,2178,2269
050,24,027,"Maryland","Howard County",1,47,4539,2219,2320
050,24,027,"Maryland","Howard County",1,48,4731,2325,2406
050,24,027,"Maryland","Howard County",1,49,4937,2447,2490
050,24,027,"Maryland","Howard County",1,50,4746,2308,2438
050,24,027,"Maryland","Howard County",1,51,4682,2233,2449
050,24,027,"Maryland","Howard County",1,52,4544,2210,2334
050,24,027,"Maryland","Howard County",1,53,4526,2212,2314
050,24,027,"Maryland","Howard County",1,54,4646,2240,2406
050,24,027,"Maryland","Howard County",1,55,4813,2414,2399
050,24,027,"Maryland","Howard County",1,56,4978,2469,2509
050,24,027,"Maryland","Howard County",1,57,4786,2337,2449
050,24,027,"Maryland","Howard County",1,58,4525,2228,2297
050,24,027,"Maryland","Howard County",1,59,4509,2245,2264
050,24,027,"Maryland","Howard County",1,60,4375,2186,2189
050,24,027,"Maryland","Howard County",1,61,4216,2106,2110
050,24,027,"Maryland","Howard County",1,62,4062,2031,2031
050,24,027,"Maryland","Howard County",1,63,3754,1883,1871
050,24,027,"Maryland","Howard County",1,64,3609,1743,1866
050,24,027,"Maryland","Howard County",1,65,3466,1678,1788
050,24,027,"Maryland","Howard County",1,66,3260,1570,1690
050,24,027,"Maryland","Howard County",1,67,3132,1487,1645
050,24,027,"Maryland","Howard County",1,68,2974,1443,1531
050,24,027,"Maryland","Howard County",1,69,2834,1329,1505
050,24,027,"Maryland","Howard County",1,70,2738,1290,1448
050,24,027,"Maryland","Howard County",1,71,2652,1238,1414
050,24,027,"Maryland","Howard County",1,72,2730,1278,1452
050,24,027,"Maryland","Howard County",1,73,2724,1277,1447
050,24,027,"Maryland","Howard County",1,74,2019,894,1125
050,24,027,"Maryland","Howard County",1,75,1946,874,1072
050,24,027,"Maryland","Howard County",1,76,1954,858,1096
050,24,027,"Maryland","Howard County",1,77,1899,848,1051
050,24,027,"Maryland","Howard County",1,78,1568,687,881
050,24,027,"Maryland","Howard County",1,79,1353,578,775
050,24,027,"Maryland","Howard County",1,80,1221,523,698
050,24,027,"Maryland","Howard County",1,81,1110,489,621
050,24,027,"Maryland","Howard County",1,82,1025,428,597
050,24,027,"Maryland","Howard County",1,83,890,380,510
050,24,027,"Maryland","Howard County",1,84,767,326,441
050,24,027,"Maryland","Howard County",1,85,4791,1772,3019
050,24,027,"Maryland","Howard County",2,0,3404,1752,1652
050,24,027,"Maryland","Howard County",2,1,3535,1816,1719
050,24,027,"Maryland","Howard County",2,2,3752,1985,1767
050,24,027,"Maryland","Howard County",2,3,3986,2074,1912
050,24,027,"Maryland","Howard County",2,4,4215,2139,2076
050,24,027,"Maryland","Howard County",2,5,4429,2275,2154
050,24,027,"Maryland","Howard County",2,6,4441,2314,2127
050,24,027,"Maryland","Howard County",2,7,4505,2307,2198
050,24,027,"Maryland","Howard County",2,8,4539,2323,2216
050,24,027,"Maryland","Howard County",2,9,4661,2417,2244
050,24,027,"Maryland","Howard County",2,10,4797,2427,2370
050,24,027,"Maryland","Howard County",2,11,4843,2453,2390
050,24,027,"Maryland","Howard County",2,12,5047,2580,2467
050,24,027,"Maryland","Howard County",2,13,5019,2611,2408
050,24,027,"Maryland","Howard County",2,14,4953,2567,2386
050,24,027,"Maryland","Howard County",2,15,4962,2544,2418
050,24,027,"Maryland","Howard County",2,16,5083,2594,2489
050,24,027,"Maryland","Howard County",2,17,5003,2551,2452
050,24,027,"Maryland","Howard County",2,18,4159,2163,1996
050,24,027,"Maryland","Howard County",2,19,3488,1827,1661
050,24,027,"Maryland","Howard County",2,20,3610,1876,1734
050,24,027,"Maryland","Howard County",2,21,3579,1843,1736
050,24,027,"Maryland","Howard County",2,22,3693,1870,1823
050,24,027,"Maryland","Howard County",2,23,3730,1905,1825
050,24,027,"Maryland","Howard County",2,24,3724,1946,1778
050,24,027,"Maryland","Howard County",2,25,3783,1971,1812
050,24,027,"Maryland","Howard County",2,26,3810,1946,1864
050,24,027,"Maryland","Howard County",2,27,3791,1928,1863
050,24,027,"Maryland","Howard County",2,28,3787,1927,1860
050,24,027,"Maryland","Howard County",2,29,3908,1970,1938
050,24,027,"Maryland","Howard County",2,30,4056,2039,2017
050,24,027,"Maryland","Howard County",2,31,4051,2009,2042
050,24,027,"Maryland","Howard County",2,32,4114,1989,2125
050,24,027,"Maryland","Howard County",2,33,4222,2028,2194
050,24,027,"Maryland","Howard County",2,34,4398,2114,2284
050,24,027,"Maryland","Howard County",2,35,4579,2157,2422
050,24,027,"Maryland","Howard County",2,36,4716,2227,2489
050,24,027,"Maryland","Howard County",2,37,4906,2327,2579
050,24,027,"Maryland","Howard County",2,38,5055,2447,2608
050,24,027,"Maryland","Howard County",2,39,5107,2487,2620
050,24,027,"Maryland","Howard County",2,40,5094,2456,2638
050,24,027,"Maryland","Howard County",2,41,4915,2392,2523
050,24,027,"Maryland","Howard County",2,42,4725,2320,2405
050,24,027,"Maryland","Howard County",2,43,4694,2269,2425
050,24,027,"Maryland","Howard County",2,44,4599,2243,2356
050,24,027,"Maryland","Howard County",2,45,4607,2236,2371
050,24,027,"Maryland","Howard County",2,46,4480,2196,2284
050,24,027,"Maryland","Howard County",2,47,4508,2212,2296
050,24,027,"Maryland","Howard County",2,48,4688,2303,2385
050,24,027,"Maryland","Howard County",2,49,4898,2424,2474
050,24,027,"Maryland","Howard County",2,50,4797,2344,2453
050,24,027,"Maryland","Howard County",2,51,4661,2232,2429
050,24,027,"Maryland","Howard County",2,52,4567,2214,2353
050,24,027,"Maryland","Howard County",2,53,4501,2194,2307
050,24,027,"Maryland","Howard County",2,54,4595,2221,2374
050,24,027,"Maryland","Howard County",2,55,4758,2367,2391
050,24,027,"Maryland","Howard County",2,56,4920,2447,2473
050,24,027,"Maryland","Howard County",2,57,4809,2359,2450
050,24,027,"Maryland","Howard County",2,58,4552,2236,2316
050,24,027,"Maryland","Howard County",2,59,4484,2223,2261
050,24,027,"Maryland","Howard County",2,60,4400,2196,2204
050,24,027,"Maryland","Howard County",2,61,4221,2108,2113
050,24,027,"Maryland","Howard County",2,62,4057,2031,2026
050,24,027,"Maryland","Howard County",2,63,3825,1919,1906
050,24,027,"Maryland","Howard County",2,64,3600,1747,1853
050,24,027,"Maryland","Howard County",2,65,3467,1669,1798
050,24,027,"Maryland","Howard County",2,66,3300,1588,1712
050,24,027,"Maryland","Howard County",2,67,3131,1487,1644
050,24,027,"Maryland","Howard County",2,68,2985,1439,1546
050,24,027,"Maryland","Howard County",2,69,2866,1351,1515
050,24,027,"Maryland","Howard County",2,70,2748,1292,1456
050,24,027,"Maryland","Howard County",2,71,2661,1244,1417
050,24,027,"Maryland","Howard County",2,72,2661,1245,1416
050,24,027,"Maryland","Howard County",2,73,2828,1326,1502
050,24,027,"Maryland","Howard County",2,74,2054,922,1132
050,24,027,"Maryland","Howard County",2,75,1964,874,1090
050,24,027,"Maryland","Howard County",2,76,1927,851,1076
050,24,027,"Maryland","Howard County",2,77,1924,856,1068
050,24,027,"Maryland","Howard County",2,78,1613,705,908
050,24,027,"Maryland","Howard County",2,79,1388,593,795
050,24,027,"Maryland","Howard County",2,80,1241,527,714
050,24,027,"Maryland","Howard County",2,81,1120,496,624
050,24,027,"Maryland","Howard County",2,82,1038,434,604
050,24,027,"Maryland","Howard County",2,83,913,383,530
050,24,027,"Maryland","Howard County",2,84,776,333,443
050,24,027,"Maryland","Howard County",2,85,4814,1782,3032
050,24,027,"Maryland","Howard County",3,0,3286,1683,1603
050,24,027,"Maryland","Howard County",3,1,3447,1771,1676
050,24,027,"Maryland","Howard County",3,2,3712,1885,1827
050,24,027,"Maryland","Howard County",3,3,3907,2056,1851
050,24,027,"Maryland","Howard County",3,4,4108,2139,1969
050,24,027,"Maryland","Howard County",3,5,4319,2186,2133
050,24,027,"Maryland","Howard County",3,6,4550,2342,2208
050,24,027,"Maryland","Howard County",3,7,4525,2340,2185
050,24,027,"Maryland","Howard County",3,8,4569,2325,2244
050,24,027,"Maryland","Howard County",3,9,4629,2350,2279
050,24,027,"Maryland","Howard County",3,10,4700,2447,2253
050,24,027,"Maryland","Howard County",3,11,4842,2455,2387
050,24,027,"Maryland","Howard County",3,12,4865,2473,2392
050,24,027,"Maryland","Howard County",3,13,5087,2578,2509
050,24,027,"Maryland","Howard County",3,14,5024,2614,2410
050,24,027,"Maryland","Howard County",3,15,4960,2534,2426
050,24,027,"Maryland","Howard County",3,16,4982,2550,2432
050,24,027,"Maryland","Howard County",3,17,5066,2582,2484
050,24,027,"Maryland","Howard County",3,18,4281,2238,2043
050,24,027,"Maryland","Howard County",3,19,3525,1814,1711
050,24,027,"Maryland","Howard County",3,20,3675,1919,1756
050,24,027,"Maryland","Howard County",3,21,3753,1948,1805
050,24,027,"Maryland","Howard County",3,22,3757,1919,1838
050,24,027,"Maryland","Howard County",3,23,3849,1967,1882
050,24,027,"Maryland","Howard County",3,24,3900,2025,1875
050,24,027,"Maryland","Howard County",3,25,3809,2014,1795
050,24,027,"Maryland","Howard County",3,26,3750,1963,1787
050,24,027,"Maryland","Howard County",3,27,3905,1995,1910
050,24,027,"Maryland","Howard County",3,28,3803,1930,1873
050,24,027,"Maryland","Howard County",3,29,3822,1941,1881
050,24,027,"Maryland","Howard County",3,30,3996,2000,1996
050,24,027,"Maryland","Howard County",3,31,4149,2086,2063
050,24,027,"Maryland","Howard County",3,32,4141,2026,2115
050,24,027,"Maryland","Howard County",3,33,4252,2085,2167
050,24,027,"Maryland","Howard County",3,34,4336,2052,2284
050,24,027,"Maryland","Howard County",3,35,4511,2152,2359
050,24,027,"Maryland","Howard County",3,36,4737,2247,2490
050,24,027,"Maryland","Howard County",3,37,4794,2246,2548
050,24,027,"Maryland","Howard County",3,38,5035,2400,2635
050,24,027,"Maryland","Howard County",3,39,5191,2541,2650
050,24,027,"Maryland","Howard County",3,40,5155,2514,2641
050,24,027,"Maryland","Howard County",3,41,5200,2510,2690
050,24,027,"Maryland","Howard County",3,42,4911,2405,2506
050,24,027,"Maryland","Howard County",3,43,4770,2330,2440
050,24,027,"Maryland","Howard County",3,44,4680,2275,2405
050,24,027,"Maryland","Howard County",3,45,4604,2241,2363
050,24,027,"Maryland","Howard County",3,46,4667,2273,2394
050,24,027,"Maryland","Howard County",3,47,4462,2196,2266
050,24,027,"Maryland","Howard County",3,48,4480,2200,2280
050,24,027,"Maryland","Howard County",3,49,4672,2306,2366
050,24,027,"Maryland","Howard County",3,50,4856,2409,2447
050,24,027,"Maryland","Howard County",3,51,4795,2334,2461
050,24,027,"Maryland","Howard County",3,52,4597,2231,2366
050,24,027,"Maryland","Howard County",3,53,4566,2205,2361
050,24,027,"Maryland","Howard County",3,54,4443,2181,2262
050,24,027,"Maryland","Howard County",3,55,4551,2206,2345
050,24,027,"Maryland","Howard County",3,56,4645,2289,2356
050,24,027,"Maryland","Howard County",3,57,4818,2404,2414
050,24,027,"Maryland","Howard County",3,58,4747,2333,2414
050,24,027,"Maryland","Howard County",3,59,4419,2166,2253
050,24,027,"Maryland","Howard County",3,60,4362,2167,2195
050,24,027,"Maryland","Howard County",3,61,4316,2162,2154
050,24,027,"Maryland","Howard County",3,62,4101,2057,2044
050,24,027,"Maryland","Howard County",3,63,3957,1978,1979
050,24,027,"Maryland","Howard County",3,64,3716,1834,1882
050,24,027,"Maryland","Howard County",3,65,3533,1695,1838
050,24,027,"Maryland","Howard County",3,66,3421,1646,1775
050,24,027,"Maryland","Howard County",3,67,3214,1528,1686
050,24,027,"Maryland","Howard County",3,68,3049,1434,1615
050,24,027,"Maryland","Howard County",3,69,2934,1392,1542
050,24,027,"Maryland","Howard County",3,70,2809,1317,1492
050,24,027,"Maryland","Howard County",3,71,2696,1269,1427
050,24,027,"Maryland","Howard County",3,72,2635,1237,1398
050,24,027,"Maryland","Howard County",3,73,2621,1212,1409
050,24,027,"Maryland","Howard County",3,74,2748,1284,1464
050,24,027,"Maryland","Howard County",3,75,2011,907,1104
050,24,027,"Maryland","Howard County",3,76,1939,856,1083
050,24,027,"Maryland","Howard County",3,77,1880,839,1041
050,24,027,"Maryland","Howard County",3,78,1879,825,1054
050,24,027,"Maryland","Howard County",3,79,1561,681,880
050,24,027,"Maryland","Howard County",3,80,1321,551,770
050,24,027,"Maryland","Howard County",3,81,1180,520,660
050,24,027,"Maryland","Howard County",3,82,1083,453,630
050,24,027,"Maryland","Howard County",3,83,968,398,570
050,24,027,"Maryland","Howard County",3,84,824,348,476
050,24,027,"Maryland","Howard County",3,85,4983,1875,3108
050,24,027,"Maryland","Howard County",4,0,3261,1688,1573
050,24,027,"Maryland","Howard County",4,1,3339,1693,1646
050,24,027,"Maryland","Howard County",4,2,3555,1824,1731
050,24,027,"Maryland","Howard County",4,3,3826,1950,1876
050,24,027,"Maryland","Howard County",4,4,4076,2137,1939
050,24,027,"Maryland","Howard County",4,5,4251,2249,2002
050,24,027,"Maryland","Howard County",4,6,4383,2215,2168
050,24,027,"Maryland","Howard County",4,7,4644,2386,2258
050,24,027,"Maryland","Howard County",4,8,4590,2379,2211
050,24,027,"Maryland","Howard County",4,9,4600,2321,2279
050,24,027,"Maryland","Howard County",4,10,4737,2394,2343
050,24,027,"Maryland","Howard County",4,11,4747,2484,2263
050,24,027,"Maryland","Howard County",4,12,4879,2465,2414
050,24,027,"Maryland","Howard County",4,13,4879,2478,2401
050,24,027,"Maryland","Howard County",4,14,5124,2568,2556
050,24,027,"Maryland","Howard County",4,15,5023,2628,2395
050,24,027,"Maryland","Howard County",4,16,4968,2548,2420
050,24,027,"Maryland","Howard County",4,17,4922,2529,2393
050,24,027,"Maryland","Howard County",4,18,4273,2246,2027
050,24,027,"Maryland","Howard County",4,19,3438,1803,1635
050,24,027,"Maryland","Howard County",4,20,3587,1828,1759
050,24,027,"Maryland","Howard County",4,21,3744,1971,1773
050,24,027,"Maryland","Howard County",4,22,3766,1916,1850
050,24,027,"Maryland","Howard County",4,23,3839,1944,1895
050,24,027,"Maryland","Howard County",4,24,3817,1954,1863
050,24,027,"Maryland","Howard County",4,25,3840,2008,1832
050,24,027,"Maryland","Howard County",4,26,3724,1962,1762
050,24,027,"Maryland","Howard County",4,27,3668,1900,1768
050,24,027,"Maryland","Howard County",4,28,3818,1967,1851
050,24,027,"Maryland","Howard County",4,29,3737,1874,1863
050,24,027,"Maryland","Howard County",4,30,3873,1961,1912
050,24,027,"Maryland","Howard County",4,31,4049,2018,2031
050,24,027,"Maryland","Howard County",4,32,4216,2106,2110
050,24,027,"Maryland","Howard County",4,33,4237,2060,2177
050,24,027,"Maryland","Howard County",4,34,4294,2087,2207
050,24,027,"Maryland","Howard County",4,35,4381,2088,2293
050,24,027,"Maryland","Howard County",4,36,4683,2234,2449
050,24,027,"Maryland","Howard County",4,37,4838,2263,2575
050,24,027,"Maryland","Howard County",4,38,4886,2324,2562
050,24,027,"Maryland","Howard County",4,39,5146,2446,2700
050,24,027,"Maryland","Howard County",4,40,5253,2601,2652
050,24,027,"Maryland","Howard County",4,41,5200,2528,2672
050,24,027,"Maryland","Howard County",4,42,5227,2533,2694
050,24,027,"Maryland","Howard County",4,43,4904,2419,2485
050,24,027,"Maryland","Howard County",4,44,4773,2353,2420
050,24,027,"Maryland","Howard County",4,45,4659,2262,2397
050,24,027,"Maryland","Howard County",4,46,4595,2212,2383
050,24,027,"Maryland","Howard County",4,47,4646,2282,2364
050,24,027,"Maryland","Howard County",4,48,4426,2183,2243
050,24,027,"Maryland","Howard County",4,49,4485,2194,2291
050,24,027,"Maryland","Howard County",4,50,4625,2297,2328
050,24,027,"Maryland","Howard County",4,51,4803,2392,2411
050,24,027,"Maryland","Howard County",4,52,4717,2313,2404
050,24,027,"Maryland","Howard County",4,53,4540,2202,2338
050,24,027,"Maryland","Howard County",4,54,4503,2153,2350
050,24,027,"Maryland","Howard County",4,55,4325,2144,2181
050,24,027,"Maryland","Howard County",4,56,4459,2149,2310
050,24,027,"Maryland","Howard County",4,57,4505,2231,2274
050,24,027,"Maryland","Howard County",4,58,4731,2366,2365
050,24,027,"Maryland","Howard County",4,59,4553,2251,2302
050,24,027,"Maryland","Howard County",4,60,4296,2119,2177
050,24,027,"Maryland","Howard County",4,61,4277,2121,2156
050,24,027,"Maryland","Howard County",4,62,4157,2091,2066
050,24,027,"Maryland","Howard County",4,63,3946,1972,1974
050,24,027,"Maryland","Howard County",4,64,3822,1873,1949
050,24,027,"Maryland","Howard County",4,65,3612,1784,1828
050,24,027,"Maryland","Howard County",4,66,3412,1642,1770
050,24,027,"Maryland","Howard County",4,67,3324,1589,1735
050,24,027,"Maryland","Howard County",4,68,3141,1484,1657
050,24,027,"Maryland","Howard County",4,69,3027,1394,1633
050,24,027,"Maryland","Howard County",4,70,2935,1383,1552
050,24,027,"Maryland","Howard County",4,71,2761,1292,1469
050,24,027,"Maryland","Howard County",4,72,2665,1250,1415
050,24,027,"Maryland","Howard County",4,73,2582,1196,1386
050,24,027,"Maryland","Howard County",4,74,2553,1165,1388
050,24,027,"Maryland","Howard County",4,75,2696,1234,1462
050,24,027,"Maryland","Howard County",4,76,1986,879,1107
050,24,027,"Maryland","Howard County",4,77,1903,847,1056
050,24,027,"Maryland","Howard County",4,78,1810,789,1021
050,24,027,"Maryland","Howard County",4,79,1856,818,1038
050,24,027,"Maryland","Howard County",4,80,1485,640,845
050,24,027,"Maryland","Howard County",4,81,1293,563,730
050,24,027,"Maryland","Howard County",4,82,1150,487,663
050,24,027,"Maryland","Howard County",4,83,1039,433,606
050,24,027,"Maryland","Howard County",4,84,867,362,505
050,24,027,"Maryland","Howard County",4,85,5184,1976,3208
050,24,027,"Maryland","Howard County",5,0,3242,1673,1569
050,24,027,"Maryland","Howard County",5,1,3336,1731,1605
050,24,027,"Maryland","Howard County",5,2,3412,1736,1676
050,24,027,"Maryland","Howard County",5,3,3619,1873,1746
050,24,027,"Maryland","Howard County",5,4,3926,2011,1915
050,24,027,"Maryland","Howard County",5,5,4215,2222,1993
050,24,027,"Maryland","Howard County",5,6,4332,2292,2040
050,24,027,"Maryland","Howard County",5,7,4462,2269,2193
050,24,027,"Maryland","Howard County",5,8,4650,2419,2231
050,24,027,"Maryland","Howard County",5,9,4651,2406,2245
050,24,027,"Maryland","Howard County",5,10,4661,2329,2332
050,24,027,"Maryland","Howard County",5,11,4764,2420,2344
050,24,027,"Maryland","Howard County",5,12,4836,2571,2265
050,24,027,"Maryland","Howard County",5,13,4926,2494,2432
050,24,027,"Maryland","Howard County",5,14,4945,2506,2439
050,24,027,"Maryland","Howard County",5,15,5174,2608,2566
050,24,027,"Maryland","Howard County",5,16,5019,2638,2381
050,24,027,"Maryland","Howard County",5,17,4887,2523,2364
050,24,027,"Maryland","Howard County",5,18,4143,2181,1962
050,24,027,"Maryland","Howard County",5,19,3535,1867,1668
050,24,027,"Maryland","Howard County",5,20,3618,1868,1750
050,24,027,"Maryland","Howard County",5,21,3677,1868,1809
050,24,027,"Maryland","Howard County",5,22,3921,1998,1923
050,24,027,"Maryland","Howard County",5,23,3832,1959,1873
050,24,027,"Maryland","Howard County",5,24,3779,1930,1849
050,24,027,"Maryland","Howard County",5,25,3745,1882,1863
050,24,027,"Maryland","Howard County",5,26,3759,1914,1845
050,24,027,"Maryland","Howard County",5,27,3670,1909,1761
050,24,027,"Maryland","Howard County",5,28,3656,1896,1760
050,24,027,"Maryland","Howard County",5,29,3743,1957,1786
050,24,027,"Maryland","Howard County",5,30,3727,1849,1878
050,24,027,"Maryland","Howard County",5,31,3920,1967,1953
050,24,027,"Maryland","Howard County",5,32,4135,2067,2068
050,24,027,"Maryland","Howard County",5,33,4337,2175,2162
050,24,027,"Maryland","Howard County",5,34,4234,2059,2175
050,24,027,"Maryland","Howard County",5,35,4346,2101,2245
050,24,027,"Maryland","Howard County",5,36,4514,2173,2341
050,24,027,"Maryland","Howard County",5,37,4776,2271,2505
050,24,027,"Maryland","Howard County",5,38,4912,2285,2627
050,24,027,"Maryland","Howard County",5,39,5051,2430,2621
050,24,027,"Maryland","Howard County",5,40,5259,2533,2726
050,24,027,"Maryland","Howard County",5,41,5283,2605,2678
050,24,027,"Maryland","Howard County",5,42,5236,2556,2680
050,24,027,"Maryland","Howard County",5,43,5233,2500,2733
050,24,027,"Maryland","Howard County",5,44,4950,2461,2489
050,24,027,"Maryland","Howard County",5,45,4773,2360,2413
050,24,027,"Maryland","Howard County",5,46,4637,2251,2386
050,24,027,"Maryland","Howard County",5,47,4593,2208,2385
050,24,027,"Maryland","Howard County",5,48,4606,2275,2331
050,24,027,"Maryland","Howard County",5,49,4400,2178,2222
050,24,027,"Maryland","Howard County",5,50,4424,2169,2255
050,24,027,"Maryland","Howard County",5,51,4566,2257,2309
050,24,027,"Maryland","Howard County",5,52,4743,2378,2365
050,24,027,"Maryland","Howard County",5,53,4668,2294,2374
050,24,027,"Maryland","Howard County",5,54,4446,2143,2303
050,24,027,"Maryland","Howard County",5,55,4423,2129,2294
050,24,027,"Maryland","Howard County",5,56,4278,2106,2172
050,24,027,"Maryland","Howard County",5,57,4348,2098,2250
050,24,027,"Maryland","Howard County",5,58,4412,2205,2207
050,24,027,"Maryland","Howard County",5,59,4581,2297,2284
050,24,027,"Maryland","Howard County",5,60,4441,2192,2249
050,24,027,"Maryland","Howard County",5,61,4239,2093,2146
050,24,027,"Maryland","Howard County",5,62,4193,2090,2103
050,24,027,"Maryland","Howard County",5,63,4058,2027,2031
050,24,027,"Maryland","Howard County",5,64,3844,1893,1951
050,24,027,"Maryland","Howard County",5,65,3749,1829,1920
050,24,027,"Maryland","Howard County",5,66,3495,1736,1759
050,24,027,"Maryland","Howard County",5,67,3340,1594,1746
050,24,027,"Maryland","Howard County",5,68,3258,1539,1719
050,24,027,"Maryland","Howard County",5,69,3114,1444,1670
050,24,027,"Maryland","Howard County",5,70,2982,1371,1611
050,24,027,"Maryland","Howard County",5,71,2906,1376,1530
050,24,027,"Maryland","Howard County",5,72,2709,1254,1455
050,24,027,"Maryland","Howard County",5,73,2631,1229,1402
050,24,027,"Maryland","Howard County",5,74,2495,1152,1343
050,24,027,"Maryland","Howard County",5,75,2490,1133,1357
050,24,027,"Maryland","Howard County",5,76,2650,1199,1451
050,24,027,"Maryland","Howard County",5,77,1924,857,1067
050,24,027,"Maryland","Howard County",5,78,1828,785,1043
050,24,027,"Maryland","Howard County",5,79,1750,777,973
050,24,027,"Maryland","Howard County",5,80,1772,779,993
050,24,027,"Maryland","Howard County",5,81,1443,648,795
050,24,027,"Maryland","Howard County",5,82,1257,534,723
050,24,027,"Maryland","Howard County",5,83,1097,453,644
050,24,027,"Maryland","Howard County",5,84,950,395,555
050,24,027,"Maryland","Howard County",5,85,5440,2082,3358
050,24,029,"Maryland","Kent County",1,0,150,76,74
050,24,029,"Maryland","Kent County",1,1,162,87,75
050,24,029,"Maryland","Kent County",1,2,159,84,75
050,24,029,"Maryland","Kent County",1,3,144,78,66
050,24,029,"Maryland","Kent County",1,4,165,88,77
050,24,029,"Maryland","Kent County",1,5,163,75,88
050,24,029,"Maryland","Kent County",1,6,168,81,87
050,24,029,"Maryland","Kent County",1,7,156,88,68
050,24,029,"Maryland","Kent County",1,8,154,71,83
050,24,029,"Maryland","Kent County",1,9,162,80,82
050,24,029,"Maryland","Kent County",1,10,181,76,105
050,24,029,"Maryland","Kent County",1,11,172,82,90
050,24,029,"Maryland","Kent County",1,12,186,94,92
050,24,029,"Maryland","Kent County",1,13,182,86,96
050,24,029,"Maryland","Kent County",1,14,188,95,93
050,24,029,"Maryland","Kent County",1,15,181,96,85
050,24,029,"Maryland","Kent County",1,16,179,94,85
050,24,029,"Maryland","Kent County",1,17,169,93,76
050,24,029,"Maryland","Kent County",1,18,322,142,180
050,24,029,"Maryland","Kent County",1,19,466,212,254
050,24,029,"Maryland","Kent County",1,20,403,187,216
050,24,029,"Maryland","Kent County",1,21,297,128,169
050,24,029,"Maryland","Kent County",1,22,236,122,114
050,24,029,"Maryland","Kent County",1,23,189,102,87
050,24,029,"Maryland","Kent County",1,24,188,108,80
050,24,029,"Maryland","Kent County",1,25,192,100,92
050,24,029,"Maryland","Kent County",1,26,184,91,93
050,24,029,"Maryland","Kent County",1,27,202,111,91
050,24,029,"Maryland","Kent County",1,28,199,113,86
050,24,029,"Maryland","Kent County",1,29,193,103,90
050,24,029,"Maryland","Kent County",1,30,211,103,108
050,24,029,"Maryland","Kent County",1,31,200,97,103
050,24,029,"Maryland","Kent County",1,32,198,96,102
050,24,029,"Maryland","Kent County",1,33,209,103,106
050,24,029,"Maryland","Kent County",1,34,225,109,116
050,24,029,"Maryland","Kent County",1,35,200,108,92
050,24,029,"Maryland","Kent County",1,36,198,104,94
050,24,029,"Maryland","Kent County",1,37,184,91,93
050,24,029,"Maryland","Kent County",1,38,193,95,98
050,24,029,"Maryland","Kent County",1,39,184,97,87
050,24,029,"Maryland","Kent County",1,40,184,93,91
050,24,029,"Maryland","Kent County",1,41,169,88,81
050,24,029,"Maryland","Kent County",1,42,168,79,89
050,24,029,"Maryland","Kent County",1,43,166,91,75
050,24,029,"Maryland","Kent County",1,44,158,81,77
050,24,029,"Maryland","Kent County",1,45,177,89,88
050,24,029,"Maryland","Kent County",1,46,174,89,85
050,24,029,"Maryland","Kent County",1,47,171,83,88
050,24,029,"Maryland","Kent County",1,48,193,96,97
050,24,029,"Maryland","Kent County",1,49,213,121,92
050,24,029,"Maryland","Kent County",1,50,184,88,96
050,24,029,"Maryland","Kent County",1,51,218,100,118
050,24,029,"Maryland","Kent County",1,52,231,110,121
050,24,029,"Maryland","Kent County",1,53,237,108,129
050,24,029,"Maryland","Kent County",1,54,242,114,128
050,24,029,"Maryland","Kent County",1,55,269,134,135
050,24,029,"Maryland","Kent County",1,56,291,158,133
050,24,029,"Maryland","Kent County",1,57,283,137,146
050,24,029,"Maryland","Kent County",1,58,316,153,163
050,24,029,"Maryland","Kent County",1,59,325,154,171
050,24,029,"Maryland","Kent County",1,60,313,149,164
050,24,029,"Maryland","Kent County",1,61,306,142,164
050,24,029,"Maryland","Kent County",1,62,326,153,173
050,24,029,"Maryland","Kent County",1,63,332,141,191
050,24,029,"Maryland","Kent County",1,64,318,140,178
050,24,029,"Maryland","Kent County",1,65,295,137,158
050,24,029,"Maryland","Kent County",1,66,299,140,159
050,24,029,"Maryland","Kent County",1,67,283,136,147
050,24,029,"Maryland","Kent County",1,68,293,137,156
050,24,029,"Maryland","Kent County",1,69,282,123,159
050,24,029,"Maryland","Kent County",1,70,264,122,142
050,24,029,"Maryland","Kent County",1,71,274,141,133
050,24,029,"Maryland","Kent County",1,72,310,148,162
050,24,029,"Maryland","Kent County",1,73,300,135,165
050,24,029,"Maryland","Kent County",1,74,216,101,115
050,24,029,"Maryland","Kent County",1,75,235,106,129
050,24,029,"Maryland","Kent County",1,76,227,112,115
050,24,029,"Maryland","Kent County",1,77,230,110,120
050,24,029,"Maryland","Kent County",1,78,210,94,116
050,24,029,"Maryland","Kent County",1,79,171,81,90
050,24,029,"Maryland","Kent County",1,80,136,65,71
050,24,029,"Maryland","Kent County",1,81,142,63,79
050,24,029,"Maryland","Kent County",1,82,127,58,69
050,24,029,"Maryland","Kent County",1,83,118,56,62
050,24,029,"Maryland","Kent County",1,84,93,39,54
050,24,029,"Maryland","Kent County",1,85,635,226,409
050,24,029,"Maryland","Kent County",2,0,156,77,79
050,24,029,"Maryland","Kent County",2,1,159,84,75
050,24,029,"Maryland","Kent County",2,2,158,84,74
050,24,029,"Maryland","Kent County",2,3,146,80,66
050,24,029,"Maryland","Kent County",2,4,158,85,73
050,24,029,"Maryland","Kent County",2,5,164,78,86
050,24,029,"Maryland","Kent County",2,6,165,78,87
050,24,029,"Maryland","Kent County",2,7,158,86,72
050,24,029,"Maryland","Kent County",2,8,153,74,79
050,24,029,"Maryland","Kent County",2,9,159,76,83
050,24,029,"Maryland","Kent County",2,10,174,75,99
050,24,029,"Maryland","Kent County",2,11,172,80,92
050,24,029,"Maryland","Kent County",2,12,182,90,92
050,24,029,"Maryland","Kent County",2,13,180,86,94
050,24,029,"Maryland","Kent County",2,14,184,91,93
050,24,029,"Maryland","Kent County",2,15,179,94,85
050,24,029,"Maryland","Kent County",2,16,181,96,85
050,24,029,"Maryland","Kent County",2,17,173,93,80
050,24,029,"Maryland","Kent County",2,18,318,141,177
050,24,029,"Maryland","Kent County",2,19,458,207,251
050,24,029,"Maryland","Kent County",2,20,407,189,218
050,24,029,"Maryland","Kent County",2,21,293,128,165
050,24,029,"Maryland","Kent County",2,22,237,121,116
050,24,029,"Maryland","Kent County",2,23,189,101,88
050,24,029,"Maryland","Kent County",2,24,187,108,79
050,24,029,"Maryland","Kent County",2,25,190,101,89
050,24,029,"Maryland","Kent County",2,26,186,93,93
050,24,029,"Maryland","Kent County",2,27,199,107,92
050,24,029,"Maryland","Kent County",2,28,198,110,88
050,24,029,"Maryland","Kent County",2,29,197,107,90
050,24,029,"Maryland","Kent County",2,30,207,104,103
050,24,029,"Maryland","Kent County",2,31,201,98,103
050,24,029,"Maryland","Kent County",2,32,198,96,102
050,24,029,"Maryland","Kent County",2,33,208,102,106
050,24,029,"Maryland","Kent County",2,34,217,104,113
050,24,029,"Maryland","Kent County",2,35,204,107,97
050,24,029,"Maryland","Kent County",2,36,192,101,91
050,24,029,"Maryland","Kent County",2,37,186,94,92
050,24,029,"Maryland","Kent County",2,38,192,93,99
050,24,029,"Maryland","Kent County",2,39,185,96,89
050,24,029,"Maryland","Kent County",2,40,184,94,90
050,24,029,"Maryland","Kent County",2,41,174,90,84
050,24,029,"Maryland","Kent County",2,42,168,82,86
050,24,029,"Maryland","Kent County",2,43,167,87,80
050,24,029,"Maryland","Kent County",2,44,159,84,75
050,24,029,"Maryland","Kent County",2,45,172,87,85
050,24,029,"Maryland","Kent County",2,46,175,89,86
050,24,029,"Maryland","Kent County",2,47,172,84,88
050,24,029,"Maryland","Kent County",2,48,186,93,93
050,24,029,"Maryland","Kent County",2,49,208,113,95
050,24,029,"Maryland","Kent County",2,50,193,96,97
050,24,029,"Maryland","Kent County",2,51,209,97,112
050,24,029,"Maryland","Kent County",2,52,226,107,119
050,24,029,"Maryland","Kent County",2,53,236,107,129
050,24,029,"Maryland","Kent County",2,54,241,111,130
050,24,029,"Maryland","Kent County",2,55,264,130,134
050,24,029,"Maryland","Kent County",2,56,286,152,134
050,24,029,"Maryland","Kent County",2,57,286,143,143
050,24,029,"Maryland","Kent County",2,58,313,152,161
050,24,029,"Maryland","Kent County",2,59,323,155,168
050,24,029,"Maryland","Kent County",2,60,315,150,165
050,24,029,"Maryland","Kent County",2,61,307,143,164
050,24,029,"Maryland","Kent County",2,62,321,151,170
050,24,029,"Maryland","Kent County",2,63,333,144,189
050,24,029,"Maryland","Kent County",2,64,320,139,181
050,24,029,"Maryland","Kent County",2,65,305,139,166
050,24,029,"Maryland","Kent County",2,66,295,139,156
050,24,029,"Maryland","Kent County",2,67,284,135,149
050,24,029,"Maryland","Kent County",2,68,290,138,152
050,24,029,"Maryland","Kent County",2,69,285,126,159
050,24,029,"Maryland","Kent County",2,70,265,120,145
050,24,029,"Maryland","Kent County",2,71,268,133,135
050,24,029,"Maryland","Kent County",2,72,296,143,153
050,24,029,"Maryland","Kent County",2,73,312,142,170
050,24,029,"Maryland","Kent County",2,74,221,102,119
050,24,029,"Maryland","Kent County",2,75,228,102,126
050,24,029,"Maryland","Kent County",2,76,224,107,117
050,24,029,"Maryland","Kent County",2,77,233,112,121
050,24,029,"Maryland","Kent County",2,78,207,92,115
050,24,029,"Maryland","Kent County",2,79,177,84,93
050,24,029,"Maryland","Kent County",2,80,141,66,75
050,24,029,"Maryland","Kent County",2,81,140,63,77
050,24,029,"Maryland","Kent County",2,82,130,59,71
050,24,029,"Maryland","Kent County",2,83,113,53,60
050,24,029,"Maryland","Kent County",2,84,94,42,52
050,24,029,"Maryland","Kent County",2,85,624,225,399
050,24,029,"Maryland","Kent County",3,0,134,72,62
050,24,029,"Maryland","Kent County",3,1,162,86,76
050,24,029,"Maryland","Kent County",3,2,162,90,72
050,24,029,"Maryland","Kent County",3,3,165,88,77
050,24,029,"Maryland","Kent County",3,4,149,85,64
050,24,029,"Maryland","Kent County",3,5,157,82,75
050,24,029,"Maryland","Kent County",3,6,165,80,85
050,24,029,"Maryland","Kent County",3,7,170,79,91
050,24,029,"Maryland","Kent County",3,8,167,94,73
050,24,029,"Maryland","Kent County",3,9,146,73,73
050,24,029,"Maryland","Kent County",3,10,163,85,78
050,24,029,"Maryland","Kent County",3,11,182,79,103
050,24,029,"Maryland","Kent County",3,12,169,81,88
050,24,029,"Maryland","Kent County",3,13,180,88,92
050,24,029,"Maryland","Kent County",3,14,188,91,97
050,24,029,"Maryland","Kent County",3,15,171,88,83
050,24,029,"Maryland","Kent County",3,16,184,96,88
050,24,029,"Maryland","Kent County",3,17,177,93,84
050,24,029,"Maryland","Kent County",3,18,316,137,179
050,24,029,"Maryland","Kent County",3,19,438,198,240
050,24,029,"Maryland","Kent County",3,20,425,197,228
050,24,029,"Maryland","Kent County",3,21,285,125,160
050,24,029,"Maryland","Kent County",3,22,231,114,117
050,24,029,"Maryland","Kent County",3,23,182,95,87
050,24,029,"Maryland","Kent County",3,24,199,110,89
050,24,029,"Maryland","Kent County",3,25,173,99,74
050,24,029,"Maryland","Kent County",3,26,180,96,84
050,24,029,"Maryland","Kent County",3,27,208,101,107
050,24,029,"Maryland","Kent County",3,28,206,115,91
050,24,029,"Maryland","Kent County",3,29,220,121,99
050,24,029,"Maryland","Kent County",3,30,207,119,88
050,24,029,"Maryland","Kent County",3,31,207,98,109
050,24,029,"Maryland","Kent County",3,32,209,108,101
050,24,029,"Maryland","Kent County",3,33,206,94,112
050,24,029,"Maryland","Kent County",3,34,203,105,98
050,24,029,"Maryland","Kent County",3,35,214,102,112
050,24,029,"Maryland","Kent County",3,36,203,101,102
050,24,029,"Maryland","Kent County",3,37,198,105,93
050,24,029,"Maryland","Kent County",3,38,202,102,100
050,24,029,"Maryland","Kent County",3,39,198,101,97
050,24,029,"Maryland","Kent County",3,40,194,97,97
050,24,029,"Maryland","Kent County",3,41,189,98,91
050,24,029,"Maryland","Kent County",3,42,181,96,85
050,24,029,"Maryland","Kent County",3,43,167,83,84
050,24,029,"Maryland","Kent County",3,44,173,89,84
050,24,029,"Maryland","Kent County",3,45,153,80,73
050,24,029,"Maryland","Kent County",3,46,169,85,84
050,24,029,"Maryland","Kent County",3,47,174,88,86
050,24,029,"Maryland","Kent County",3,48,172,86,86
050,24,029,"Maryland","Kent County",3,49,203,97,106
050,24,029,"Maryland","Kent County",3,50,232,128,104
050,24,029,"Maryland","Kent County",3,51,190,92,98
050,24,029,"Maryland","Kent County",3,52,210,97,113
050,24,029,"Maryland","Kent County",3,53,233,108,125
050,24,029,"Maryland","Kent County",3,54,241,113,128
050,24,029,"Maryland","Kent County",3,55,244,110,134
050,24,029,"Maryland","Kent County",3,56,277,135,142
050,24,029,"Maryland","Kent County",3,57,288,147,141
050,24,029,"Maryland","Kent County",3,58,285,144,141
050,24,029,"Maryland","Kent County",3,59,318,152,166
050,24,029,"Maryland","Kent County",3,60,337,157,180
050,24,029,"Maryland","Kent County",3,61,304,143,161
050,24,029,"Maryland","Kent County",3,62,312,144,168
050,24,029,"Maryland","Kent County",3,63,312,147,165
050,24,029,"Maryland","Kent County",3,64,344,156,188
050,24,029,"Maryland","Kent County",3,65,327,139,188
050,24,029,"Maryland","Kent County",3,66,296,131,165
050,24,029,"Maryland","Kent County",3,67,289,130,159
050,24,029,"Maryland","Kent County",3,68,282,131,151
050,24,029,"Maryland","Kent County",3,69,295,142,153
050,24,029,"Maryland","Kent County",3,70,280,126,154
050,24,029,"Maryland","Kent County",3,71,259,116,143
050,24,029,"Maryland","Kent County",3,72,265,128,137
050,24,029,"Maryland","Kent County",3,73,289,142,147
050,24,029,"Maryland","Kent County",3,74,306,139,167
050,24,029,"Maryland","Kent County",3,75,219,96,123
050,24,029,"Maryland","Kent County",3,76,215,98,117
050,24,029,"Maryland","Kent County",3,77,216,96,120
050,24,029,"Maryland","Kent County",3,78,221,108,113
050,24,029,"Maryland","Kent County",3,79,201,91,110
050,24,029,"Maryland","Kent County",3,80,169,77,92
050,24,029,"Maryland","Kent County",3,81,145,66,79
050,24,029,"Maryland","Kent County",3,82,133,62,71
050,24,029,"Maryland","Kent County",3,83,118,49,69
050,24,029,"Maryland","Kent County",3,84,98,48,50
050,24,029,"Maryland","Kent County",3,85,618,228,390
050,24,029,"Maryland","Kent County",4,0,147,62,85
050,24,029,"Maryland","Kent County",4,1,125,69,56
050,24,029,"Maryland","Kent County",4,2,165,82,83
050,24,029,"Maryland","Kent County",4,3,151,85,66
050,24,029,"Maryland","Kent County",4,4,159,82,77
050,24,029,"Maryland","Kent County",4,5,152,86,66
050,24,029,"Maryland","Kent County",4,6,152,84,68
050,24,029,"Maryland","Kent County",4,7,159,83,76
050,24,029,"Maryland","Kent County",4,8,175,82,93
050,24,029,"Maryland","Kent County",4,9,172,91,81
050,24,029,"Maryland","Kent County",4,10,147,73,74
050,24,029,"Maryland","Kent County",4,11,160,84,76
050,24,029,"Maryland","Kent County",4,12,187,85,102
050,24,029,"Maryland","Kent County",4,13,170,83,87
050,24,029,"Maryland","Kent County",4,14,181,89,92
050,24,029,"Maryland","Kent County",4,15,187,92,95
050,24,029,"Maryland","Kent County",4,16,181,95,86
050,24,029,"Maryland","Kent County",4,17,191,101,90
050,24,029,"Maryland","Kent County",4,18,316,140,176
050,24,029,"Maryland","Kent County",4,19,444,193,251
050,24,029,"Maryland","Kent County",4,20,412,184,228
050,24,029,"Maryland","Kent County",4,21,313,144,169
050,24,029,"Maryland","Kent County",4,22,236,119,117
050,24,029,"Maryland","Kent County",4,23,190,98,92
050,24,029,"Maryland","Kent County",4,24,177,93,84
050,24,029,"Maryland","Kent County",4,25,199,117,82
050,24,029,"Maryland","Kent County",4,26,167,90,77
050,24,029,"Maryland","Kent County",4,27,192,101,91
050,24,029,"Maryland","Kent County",4,28,199,95,104
050,24,029,"Maryland","Kent County",4,29,197,114,83
050,24,029,"Maryland","Kent County",4,30,209,115,94
050,24,029,"Maryland","Kent County",4,31,212,114,98
050,24,029,"Maryland","Kent County",4,32,194,98,96
050,24,029,"Maryland","Kent County",4,33,210,114,96
050,24,029,"Maryland","Kent County",4,34,199,89,110
050,24,029,"Maryland","Kent County",4,35,201,106,95
050,24,029,"Maryland","Kent County",4,36,208,104,104
050,24,029,"Maryland","Kent County",4,37,209,107,102
050,24,029,"Maryland","Kent County",4,38,194,101,93
050,24,029,"Maryland","Kent County",4,39,206,101,105
050,24,029,"Maryland","Kent County",4,40,191,94,97
050,24,029,"Maryland","Kent County",4,41,195,99,96
050,24,029,"Maryland","Kent County",4,42,194,105,89
050,24,029,"Maryland","Kent County",4,43,188,100,88
050,24,029,"Maryland","Kent County",4,44,172,84,88
050,24,029,"Maryland","Kent County",4,45,178,93,85
050,24,029,"Maryland","Kent County",4,46,156,80,76
050,24,029,"Maryland","Kent County",4,47,156,74,82
050,24,029,"Maryland","Kent County",4,48,174,87,87
050,24,029,"Maryland","Kent County",4,49,174,91,83
050,24,029,"Maryland","Kent County",4,50,200,98,102
050,24,029,"Maryland","Kent County",4,51,235,131,104
050,24,029,"Maryland","Kent County",4,52,198,96,102
050,24,029,"Maryland","Kent County",4,53,223,103,120
050,24,029,"Maryland","Kent County",4,54,233,103,130
050,24,029,"Maryland","Kent County",4,55,249,113,136
050,24,029,"Maryland","Kent County",4,56,255,117,138
050,24,029,"Maryland","Kent County",4,57,279,130,149
050,24,029,"Maryland","Kent County",4,58,298,153,145
050,24,029,"Maryland","Kent County",4,59,298,146,152
050,24,029,"Maryland","Kent County",4,60,327,155,172
050,24,029,"Maryland","Kent County",4,61,339,160,179
050,24,029,"Maryland","Kent County",4,62,311,145,166
050,24,029,"Maryland","Kent County",4,63,309,138,171
050,24,029,"Maryland","Kent County",4,64,320,144,176
050,24,029,"Maryland","Kent County",4,65,348,164,184
050,24,029,"Maryland","Kent County",4,66,329,137,192
050,24,029,"Maryland","Kent County",4,67,301,132,169
050,24,029,"Maryland","Kent County",4,68,297,133,164
050,24,029,"Maryland","Kent County",4,69,282,129,153
050,24,029,"Maryland","Kent County",4,70,287,145,142
050,24,029,"Maryland","Kent County",4,71,277,118,159
050,24,029,"Maryland","Kent County",4,72,262,113,149
050,24,029,"Maryland","Kent County",4,73,256,126,130
050,24,029,"Maryland","Kent County",4,74,288,142,146
050,24,029,"Maryland","Kent County",4,75,303,139,164
050,24,029,"Maryland","Kent County",4,76,210,91,119
050,24,029,"Maryland","Kent County",4,77,205,91,114
050,24,029,"Maryland","Kent County",4,78,204,90,114
050,24,029,"Maryland","Kent County",4,79,213,102,111
050,24,029,"Maryland","Kent County",4,80,187,82,105
050,24,029,"Maryland","Kent County",4,81,175,75,100
050,24,029,"Maryland","Kent County",4,82,143,68,75
050,24,029,"Maryland","Kent County",4,83,122,55,67
050,24,029,"Maryland","Kent County",4,84,106,45,61
050,24,029,"Maryland","Kent County",4,85,603,234,369
050,24,029,"Maryland","Kent County",5,0,144,61,83
050,24,029,"Maryland","Kent County",5,1,149,72,77
050,24,029,"Maryland","Kent County",5,2,132,71,61
050,24,029,"Maryland","Kent County",5,3,164,83,81
050,24,029,"Maryland","Kent County",5,4,151,83,68
050,24,029,"Maryland","Kent County",5,5,157,80,77
050,24,029,"Maryland","Kent County",5,6,162,94,68
050,24,029,"Maryland","Kent County",5,7,150,86,64
050,24,029,"Maryland","Kent County",5,8,165,86,79
050,24,029,"Maryland","Kent County",5,9,178,81,97
050,24,029,"Maryland","Kent County",5,10,160,85,75
050,24,029,"Maryland","Kent County",5,11,155,79,76
050,24,029,"Maryland","Kent County",5,12,159,83,76
050,24,029,"Maryland","Kent County",5,13,183,83,100
050,24,029,"Maryland","Kent County",5,14,164,84,80
050,24,029,"Maryland","Kent County",5,15,174,85,89
050,24,029,"Maryland","Kent County",5,16,184,87,97
050,24,029,"Maryland","Kent County",5,17,179,90,89
050,24,029,"Maryland","Kent County",5,18,321,142,179
050,24,029,"Maryland","Kent County",5,19,457,201,256
050,24,029,"Maryland","Kent County",5,20,419,175,244
050,24,029,"Maryland","Kent County",5,21,300,133,167
050,24,029,"Maryland","Kent County",5,22,267,140,127
050,24,029,"Maryland","Kent County",5,23,176,93,83
050,24,029,"Maryland","Kent County",5,24,199,100,99
050,24,029,"Maryland","Kent County",5,25,181,88,93
050,24,029,"Maryland","Kent County",5,26,197,106,91
050,24,029,"Maryland","Kent County",5,27,162,92,70
050,24,029,"Maryland","Kent County",5,28,198,101,97
050,24,029,"Maryland","Kent County",5,29,206,103,103
050,24,029,"Maryland","Kent County",5,30,190,107,83
050,24,029,"Maryland","Kent County",5,31,221,118,103
050,24,029,"Maryland","Kent County",5,32,233,135,98
050,24,029,"Maryland","Kent County",5,33,206,105,101
050,24,029,"Maryland","Kent County",5,34,215,108,107
050,24,029,"Maryland","Kent County",5,35,199,91,108
050,24,029,"Maryland","Kent County",5,36,203,108,95
050,24,029,"Maryland","Kent County",5,37,208,105,103
050,24,029,"Maryland","Kent County",5,38,203,102,101
050,24,029,"Maryland","Kent County",5,39,194,104,90
050,24,029,"Maryland","Kent County",5,40,195,94,101
050,24,029,"Maryland","Kent County",5,41,192,93,99
050,24,029,"Maryland","Kent County",5,42,192,97,95
050,24,029,"Maryland","Kent County",5,43,192,99,93
050,24,029,"Maryland","Kent County",5,44,183,102,81
050,24,029,"Maryland","Kent County",5,45,165,82,83
050,24,029,"Maryland","Kent County",5,46,173,92,81
050,24,029,"Maryland","Kent County",5,47,140,70,70
050,24,029,"Maryland","Kent County",5,48,158,77,81
050,24,029,"Maryland","Kent County",5,49,182,94,88
050,24,029,"Maryland","Kent County",5,50,173,89,84
050,24,029,"Maryland","Kent County",5,51,210,99,111
050,24,029,"Maryland","Kent County",5,52,233,131,102
050,24,029,"Maryland","Kent County",5,53,197,93,104
050,24,029,"Maryland","Kent County",5,54,223,100,123
050,24,029,"Maryland","Kent County",5,55,224,98,126
050,24,029,"Maryland","Kent County",5,56,247,113,134
050,24,029,"Maryland","Kent County",5,57,259,117,142
050,24,029,"Maryland","Kent County",5,58,283,138,145
050,24,029,"Maryland","Kent County",5,59,289,145,144
050,24,029,"Maryland","Kent County",5,60,310,147,163
050,24,029,"Maryland","Kent County",5,61,336,160,176
050,24,029,"Maryland","Kent County",5,62,345,168,177
050,24,029,"Maryland","Kent County",5,63,309,142,167
050,24,029,"Maryland","Kent County",5,64,309,134,175
050,24,029,"Maryland","Kent County",5,65,318,147,171
050,24,029,"Maryland","Kent County",5,66,344,161,183
050,24,029,"Maryland","Kent County",5,67,337,139,198
050,24,029,"Maryland","Kent County",5,68,298,134,164
050,24,029,"Maryland","Kent County",5,69,293,126,167
050,24,029,"Maryland","Kent County",5,70,276,128,148
050,24,029,"Maryland","Kent County",5,71,279,134,145
050,24,029,"Maryland","Kent County",5,72,281,117,164
050,24,029,"Maryland","Kent County",5,73,253,111,142
050,24,029,"Maryland","Kent County",5,74,261,132,129
050,24,029,"Maryland","Kent County",5,75,289,139,150
050,24,029,"Maryland","Kent County",5,76,287,130,157
050,24,029,"Maryland","Kent County",5,77,200,83,117
050,24,029,"Maryland","Kent County",5,78,196,88,108
050,24,029,"Maryland","Kent County",5,79,196,83,113
050,24,029,"Maryland","Kent County",5,80,203,95,108
050,24,029,"Maryland","Kent County",5,81,187,78,109
050,24,029,"Maryland","Kent County",5,82,167,73,94
050,24,029,"Maryland","Kent County",5,83,133,60,73
050,24,029,"Maryland","Kent County",5,84,109,49,60
050,24,029,"Maryland","Kent County",5,85,612,239,373
050,24,031,"Maryland","Montgomery County",1,0,12122,6184,5938
050,24,031,"Maryland","Montgomery County",1,1,12400,6270,6130
050,24,031,"Maryland","Montgomery County",1,2,12855,6601,6254
050,24,031,"Maryland","Montgomery County",1,3,13142,6687,6455
050,24,031,"Maryland","Montgomery County",1,4,13343,6746,6597
050,24,031,"Maryland","Montgomery County",1,5,13478,6946,6532
050,24,031,"Maryland","Montgomery County",1,6,13358,6907,6451
050,24,031,"Maryland","Montgomery County",1,7,13700,7049,6651
050,24,031,"Maryland","Montgomery County",1,8,13751,7176,6575
050,24,031,"Maryland","Montgomery County",1,9,13787,7138,6649
050,24,031,"Maryland","Montgomery County",1,10,14132,7363,6769
050,24,031,"Maryland","Montgomery County",1,11,14201,7374,6827
050,24,031,"Maryland","Montgomery County",1,12,14802,7656,7146
050,24,031,"Maryland","Montgomery County",1,13,14639,7603,7036
050,24,031,"Maryland","Montgomery County",1,14,14484,7436,7048
050,24,031,"Maryland","Montgomery County",1,15,14518,7367,7151
050,24,031,"Maryland","Montgomery County",1,16,14624,7443,7181
050,24,031,"Maryland","Montgomery County",1,17,14233,7183,7050
050,24,031,"Maryland","Montgomery County",1,18,12229,6274,5955
050,24,031,"Maryland","Montgomery County",1,19,10817,5595,5222
050,24,031,"Maryland","Montgomery County",1,20,11098,5673,5425
050,24,031,"Maryland","Montgomery County",1,21,11258,5757,5501
050,24,031,"Maryland","Montgomery County",1,22,11664,5808,5856
050,24,031,"Maryland","Montgomery County",1,23,12130,5927,6203
050,24,031,"Maryland","Montgomery County",1,24,12400,6131,6269
050,24,031,"Maryland","Montgomery County",1,25,12290,6037,6253
050,24,031,"Maryland","Montgomery County",1,26,12400,6176,6224
050,24,031,"Maryland","Montgomery County",1,27,12594,6352,6242
050,24,031,"Maryland","Montgomery County",1,28,12314,6207,6107
050,24,031,"Maryland","Montgomery County",1,29,12406,6157,6249
050,24,031,"Maryland","Montgomery County",1,30,12832,6416,6416
050,24,031,"Maryland","Montgomery County",1,31,13260,6496,6764
050,24,031,"Maryland","Montgomery County",1,32,13775,6681,7094
050,24,031,"Maryland","Montgomery County",1,33,14290,6936,7354
050,24,031,"Maryland","Montgomery County",1,34,14510,7065,7445
050,24,031,"Maryland","Montgomery County",1,35,14711,7247,7464
050,24,031,"Maryland","Montgomery County",1,36,14796,7245,7551
050,24,031,"Maryland","Montgomery County",1,37,15033,7366,7667
050,24,031,"Maryland","Montgomery County",1,38,15075,7388,7687
050,24,031,"Maryland","Montgomery County",1,39,15438,7562,7876
050,24,031,"Maryland","Montgomery County",1,40,15222,7525,7697
050,24,031,"Maryland","Montgomery County",1,41,14727,7235,7492
050,24,031,"Maryland","Montgomery County",1,42,14485,7078,7407
050,24,031,"Maryland","Montgomery County",1,43,14309,6894,7415
050,24,031,"Maryland","Montgomery County",1,44,14251,6903,7348
050,24,031,"Maryland","Montgomery County",1,45,14042,6894,7148
050,24,031,"Maryland","Montgomery County",1,46,13754,6655,7099
050,24,031,"Maryland","Montgomery County",1,47,14169,6866,7303
050,24,031,"Maryland","Montgomery County",1,48,14730,7217,7513
050,24,031,"Maryland","Montgomery County",1,49,15349,7472,7877
050,24,031,"Maryland","Montgomery County",1,50,15077,7293,7784
050,24,031,"Maryland","Montgomery County",1,51,14986,7175,7811
050,24,031,"Maryland","Montgomery County",1,52,14501,6981,7520
050,24,031,"Maryland","Montgomery County",1,53,14383,6975,7408
050,24,031,"Maryland","Montgomery County",1,54,14296,6884,7412
050,24,031,"Maryland","Montgomery County",1,55,14830,7098,7732
050,24,031,"Maryland","Montgomery County",1,56,15132,7302,7830
050,24,031,"Maryland","Montgomery County",1,57,14867,7138,7729
050,24,031,"Maryland","Montgomery County",1,58,14638,7038,7600
050,24,031,"Maryland","Montgomery County",1,59,14290,6898,7392
050,24,031,"Maryland","Montgomery County",1,60,13973,6743,7230
050,24,031,"Maryland","Montgomery County",1,61,13846,6689,7157
050,24,031,"Maryland","Montgomery County",1,62,13582,6675,6907
050,24,031,"Maryland","Montgomery County",1,63,13033,6366,6667
050,24,031,"Maryland","Montgomery County",1,64,12502,6010,6492
050,24,031,"Maryland","Montgomery County",1,65,12163,5731,6432
050,24,031,"Maryland","Montgomery County",1,66,11417,5337,6080
050,24,031,"Maryland","Montgomery County",1,67,11038,5126,5912
050,24,031,"Maryland","Montgomery County",1,68,10492,4854,5638
050,24,031,"Maryland","Montgomery County",1,69,9628,4439,5189
050,24,031,"Maryland","Montgomery County",1,70,9357,4324,5033
050,24,031,"Maryland","Montgomery County",1,71,9059,4185,4874
050,24,031,"Maryland","Montgomery County",1,72,8999,4079,4920
050,24,031,"Maryland","Montgomery County",1,73,8765,4028,4737
050,24,031,"Maryland","Montgomery County",1,74,6623,2982,3641
050,24,031,"Maryland","Montgomery County",1,75,6601,2957,3644
050,24,031,"Maryland","Montgomery County",1,76,6441,2839,3602
050,24,031,"Maryland","Montgomery County",1,77,6240,2741,3499
050,24,031,"Maryland","Montgomery County",1,78,5362,2301,3061
050,24,031,"Maryland","Montgomery County",1,79,4827,2058,2769
050,24,031,"Maryland","Montgomery County",1,80,4448,1883,2565
050,24,031,"Maryland","Montgomery County",1,81,4201,1775,2426
050,24,031,"Maryland","Montgomery County",1,82,3892,1670,2222
050,24,031,"Maryland","Montgomery County",1,83,3403,1397,2006
050,24,031,"Maryland","Montgomery County",1,84,3171,1305,1866
050,24,031,"Maryland","Montgomery County",1,85,22075,7829,14246
050,24,031,"Maryland","Montgomery County",2,0,11959,6049,5910
050,24,031,"Maryland","Montgomery County",2,1,12316,6239,6077
050,24,031,"Maryland","Montgomery County",2,2,12744,6515,6229
050,24,031,"Maryland","Montgomery County",2,3,13024,6641,6383
050,24,031,"Maryland","Montgomery County",2,4,13303,6738,6565
050,24,031,"Maryland","Montgomery County",2,5,13449,6905,6544
050,24,031,"Maryland","Montgomery County",2,6,13384,6913,6471
050,24,031,"Maryland","Montgomery County",2,7,13599,7006,6593
050,24,031,"Maryland","Montgomery County",2,8,13693,7117,6576
050,24,031,"Maryland","Montgomery County",2,9,13764,7147,6617
050,24,031,"Maryland","Montgomery County",2,10,14035,7305,6730
050,24,031,"Maryland","Montgomery County",2,11,14114,7331,6783
050,24,031,"Maryland","Montgomery County",2,12,14715,7624,7091
050,24,031,"Maryland","Montgomery County",2,13,14648,7601,7047
050,24,031,"Maryland","Montgomery County",2,14,14514,7471,7043
050,24,031,"Maryland","Montgomery County",2,15,14504,7384,7120
050,24,031,"Maryland","Montgomery County",2,16,14593,7421,7172
050,24,031,"Maryland","Montgomery County",2,17,14304,7228,7076
050,24,031,"Maryland","Montgomery County",2,18,12193,6266,5927
050,24,031,"Maryland","Montgomery County",2,19,10807,5572,5235
050,24,031,"Maryland","Montgomery County",2,20,11268,5757,5511
050,24,031,"Maryland","Montgomery County",2,21,11279,5746,5533
050,24,031,"Maryland","Montgomery County",2,22,11643,5800,5843
050,24,031,"Maryland","Montgomery County",2,23,12110,5932,6178
050,24,031,"Maryland","Montgomery County",2,24,12266,6035,6231
050,24,031,"Maryland","Montgomery County",2,25,12299,6056,6243
050,24,031,"Maryland","Montgomery County",2,26,12379,6149,6230
050,24,031,"Maryland","Montgomery County",2,27,12508,6300,6208
050,24,031,"Maryland","Montgomery County",2,28,12379,6230,6149
050,24,031,"Maryland","Montgomery County",2,29,12380,6165,6215
050,24,031,"Maryland","Montgomery County",2,30,12824,6398,6426
050,24,031,"Maryland","Montgomery County",2,31,13140,6462,6678
050,24,031,"Maryland","Montgomery County",2,32,13663,6653,7010
050,24,031,"Maryland","Montgomery County",2,33,14159,6872,7287
050,24,031,"Maryland","Montgomery County",2,34,14461,7031,7430
050,24,031,"Maryland","Montgomery County",2,35,14748,7244,7504
050,24,031,"Maryland","Montgomery County",2,36,14718,7220,7498
050,24,031,"Maryland","Montgomery County",2,37,14999,7357,7642
050,24,031,"Maryland","Montgomery County",2,38,15108,7408,7700
050,24,031,"Maryland","Montgomery County",2,39,15257,7466,7791
050,24,031,"Maryland","Montgomery County",2,40,15362,7581,7781
050,24,031,"Maryland","Montgomery County",2,41,14810,7287,7523
050,24,031,"Maryland","Montgomery County",2,42,14472,7094,7378
050,24,031,"Maryland","Montgomery County",2,43,14418,6980,7438
050,24,031,"Maryland","Montgomery County",2,44,14145,6847,7298
050,24,031,"Maryland","Montgomery County",2,45,14135,6920,7215
050,24,031,"Maryland","Montgomery County",2,46,13758,6675,7083
050,24,031,"Maryland","Montgomery County",2,47,14031,6803,7228
050,24,031,"Maryland","Montgomery County",2,48,14590,7128,7462
050,24,031,"Maryland","Montgomery County",2,49,15238,7430,7808
050,24,031,"Maryland","Montgomery County",2,50,15150,7339,7811
050,24,031,"Maryland","Montgomery County",2,51,14906,7160,7746
050,24,031,"Maryland","Montgomery County",2,52,14606,7024,7582
050,24,031,"Maryland","Montgomery County",2,53,14346,6948,7398
050,24,031,"Maryland","Montgomery County",2,54,14277,6899,7378
050,24,031,"Maryland","Montgomery County",2,55,14671,7033,7638
050,24,031,"Maryland","Montgomery County",2,56,15045,7247,7798
050,24,031,"Maryland","Montgomery County",2,57,14902,7153,7749
050,24,031,"Maryland","Montgomery County",2,58,14627,7035,7592
050,24,031,"Maryland","Montgomery County",2,59,14315,6908,7407
050,24,031,"Maryland","Montgomery County",2,60,14019,6767,7252
050,24,031,"Maryland","Montgomery County",2,61,13774,6641,7133
050,24,031,"Maryland","Montgomery County",2,62,13535,6627,6908
050,24,031,"Maryland","Montgomery County",2,63,13164,6433,6731
050,24,031,"Maryland","Montgomery County",2,64,12500,6025,6475
050,24,031,"Maryland","Montgomery County",2,65,12168,5753,6415
050,24,031,"Maryland","Montgomery County",2,66,11516,5380,6136
050,24,031,"Maryland","Montgomery County",2,67,11030,5122,5908
050,24,031,"Maryland","Montgomery County",2,68,10505,4861,5644
050,24,031,"Maryland","Montgomery County",2,69,9806,4522,5284
050,24,031,"Maryland","Montgomery County",2,70,9365,4319,5046
050,24,031,"Maryland","Montgomery County",2,71,9063,4181,4882
050,24,031,"Maryland","Montgomery County",2,72,8863,4030,4833
050,24,031,"Maryland","Montgomery County",2,73,9086,4163,4923
050,24,031,"Maryland","Montgomery County",2,74,6759,3057,3702
050,24,031,"Maryland","Montgomery County",2,75,6572,2942,3630
050,24,031,"Maryland","Montgomery County",2,76,6387,2814,3573
050,24,031,"Maryland","Montgomery County",2,77,6337,2776,3561
050,24,031,"Maryland","Montgomery County",2,78,5470,2363,3107
050,24,031,"Maryland","Montgomery County",2,79,4870,2076,2794
050,24,031,"Maryland","Montgomery County",2,80,4490,1894,2596
050,24,031,"Maryland","Montgomery County",2,81,4191,1772,2419
050,24,031,"Maryland","Montgomery County",2,82,3909,1657,2252
050,24,031,"Maryland","Montgomery County",2,83,3441,1425,2016
050,24,031,"Maryland","Montgomery County",2,84,3169,1297,1872
050,24,031,"Maryland","Montgomery County",2,85,21861,7746,14115
050,24,031,"Maryland","Montgomery County",3,0,11292,5879,5413
050,24,031,"Maryland","Montgomery County",3,1,11796,5970,5826
050,24,031,"Maryland","Montgomery County",3,2,12181,6212,5969
050,24,031,"Maryland","Montgomery County",3,3,12625,6470,6155
050,24,031,"Maryland","Montgomery County",3,4,12878,6573,6305
050,24,031,"Maryland","Montgomery County",3,5,13199,6722,6477
050,24,031,"Maryland","Montgomery County",3,6,13265,6809,6456
050,24,031,"Maryland","Montgomery County",3,7,13259,6836,6423
050,24,031,"Maryland","Montgomery County",3,8,13484,6919,6565
050,24,031,"Maryland","Montgomery County",3,9,13542,7043,6499
050,24,031,"Maryland","Montgomery County",3,10,13550,7026,6524
050,24,031,"Maryland","Montgomery County",3,11,13871,7210,6661
050,24,031,"Maryland","Montgomery County",3,12,14002,7255,6747
050,24,031,"Maryland","Montgomery County",3,13,14551,7549,7002
050,24,031,"Maryland","Montgomery County",3,14,14516,7545,6971
050,24,031,"Maryland","Montgomery County",3,15,14450,7416,7034
050,24,031,"Maryland","Montgomery County",3,16,14406,7367,7039
050,24,031,"Maryland","Montgomery County",3,17,14524,7400,7124
050,24,031,"Maryland","Montgomery County",3,18,12362,6395,5967
050,24,031,"Maryland","Montgomery County",3,19,10556,5436,5120
050,24,031,"Maryland","Montgomery County",3,20,11394,5774,5620
050,24,031,"Maryland","Montgomery County",3,21,11615,5865,5750
050,24,031,"Maryland","Montgomery County",3,22,11619,5839,5780
050,24,031,"Maryland","Montgomery County",3,23,12109,5949,6160
050,24,031,"Maryland","Montgomery County",3,24,12132,5966,6166
050,24,031,"Maryland","Montgomery County",3,25,12145,6000,6145
050,24,031,"Maryland","Montgomery County",3,26,12184,6011,6173
050,24,031,"Maryland","Montgomery County",3,27,12240,6130,6110
050,24,031,"Maryland","Montgomery County",3,28,12416,6160,6256
050,24,031,"Maryland","Montgomery County",3,29,12485,6250,6235
050,24,031,"Maryland","Montgomery County",3,30,12493,6200,6293
050,24,031,"Maryland","Montgomery County",3,31,13047,6549,6498
050,24,031,"Maryland","Montgomery County",3,32,13266,6569,6697
050,24,031,"Maryland","Montgomery County",3,33,13812,6702,7110
050,24,031,"Maryland","Montgomery County",3,34,14196,6871,7325
050,24,031,"Maryland","Montgomery County",3,35,14478,7123,7355
050,24,031,"Maryland","Montgomery County",3,36,14696,7188,7508
050,24,031,"Maryland","Montgomery County",3,37,14694,7171,7523
050,24,031,"Maryland","Montgomery County",3,38,14944,7341,7603
050,24,031,"Maryland","Montgomery County",3,39,15000,7342,7658
050,24,031,"Maryland","Montgomery County",3,40,15217,7431,7786
050,24,031,"Maryland","Montgomery County",3,41,15240,7533,7707
050,24,031,"Maryland","Montgomery County",3,42,14732,7234,7498
050,24,031,"Maryland","Montgomery County",3,43,14290,6972,7318
050,24,031,"Maryland","Montgomery County",3,44,14338,6937,7401
050,24,031,"Maryland","Montgomery County",3,45,14003,6811,7192
050,24,031,"Maryland","Montgomery County",3,46,14045,6883,7162
050,24,031,"Maryland","Montgomery County",3,47,13618,6610,7008
050,24,031,"Maryland","Montgomery County",3,48,13862,6720,7142
050,24,031,"Maryland","Montgomery County",3,49,14445,7056,7389
050,24,031,"Maryland","Montgomery County",3,50,15010,7316,7694
050,24,031,"Maryland","Montgomery County",3,51,15000,7282,7718
050,24,031,"Maryland","Montgomery County",3,52,14660,6989,7671
050,24,031,"Maryland","Montgomery County",3,53,14387,6894,7493
050,24,031,"Maryland","Montgomery County",3,54,14168,6874,7294
050,24,031,"Maryland","Montgomery County",3,55,14107,6832,7275
050,24,031,"Maryland","Montgomery County",3,56,14419,6916,7503
050,24,031,"Maryland","Montgomery County",3,57,14782,7101,7681
050,24,031,"Maryland","Montgomery County",3,58,14684,7037,7647
050,24,031,"Maryland","Montgomery County",3,59,14339,6905,7434
050,24,031,"Maryland","Montgomery County",3,60,14041,6770,7271
050,24,031,"Maryland","Montgomery County",3,61,13656,6588,7068
050,24,031,"Maryland","Montgomery County",3,62,13440,6480,6960
050,24,031,"Maryland","Montgomery County",3,63,13172,6437,6735
050,24,031,"Maryland","Montgomery County",3,64,12854,6264,6590
050,24,031,"Maryland","Montgomery County",3,65,12175,5851,6324
050,24,031,"Maryland","Montgomery County",3,66,11757,5541,6216
050,24,031,"Maryland","Montgomery County",3,67,11287,5270,6017
050,24,031,"Maryland","Montgomery County",3,68,10765,4992,5773
050,24,031,"Maryland","Montgomery County",3,69,10223,4704,5519
050,24,031,"Maryland","Montgomery County",3,70,9582,4370,5212
050,24,031,"Maryland","Montgomery County",3,71,9128,4197,4931
050,24,031,"Maryland","Montgomery County",3,72,8897,4075,4822
050,24,031,"Maryland","Montgomery County",3,73,8659,3912,4747
050,24,031,"Maryland","Montgomery County",3,74,8886,4052,4834
050,24,031,"Maryland","Montgomery County",3,75,6644,2979,3665
050,24,031,"Maryland","Montgomery County",3,76,6478,2886,3592
050,24,031,"Maryland","Montgomery County",3,77,6256,2723,3533
050,24,031,"Maryland","Montgomery County",3,78,6155,2697,3458
050,24,031,"Maryland","Montgomery County",3,79,5316,2276,3040
050,24,031,"Maryland","Montgomery County",3,80,4713,1999,2714
050,24,031,"Maryland","Montgomery County",3,81,4358,1836,2522
050,24,031,"Maryland","Montgomery County",3,82,4001,1657,2344
050,24,031,"Maryland","Montgomery County",3,83,3739,1581,2158
050,24,031,"Maryland","Montgomery County",3,84,3299,1342,1957
050,24,031,"Maryland","Montgomery County",3,85,22092,7836,14256
050,24,031,"Maryland","Montgomery County",4,0,11878,6224,5654
050,24,031,"Maryland","Montgomery County",4,1,11142,5858,5284
050,24,031,"Maryland","Montgomery County",4,2,11857,6003,5854
050,24,031,"Maryland","Montgomery County",4,3,12279,6277,6002
050,24,031,"Maryland","Montgomery County",4,4,12567,6455,6112
050,24,031,"Maryland","Montgomery County",4,5,12940,6626,6314
050,24,031,"Maryland","Montgomery County",4,6,13288,6785,6503
050,24,031,"Maryland","Montgomery County",4,7,13194,6727,6467
050,24,031,"Maryland","Montgomery County",4,8,13261,6828,6433
050,24,031,"Maryland","Montgomery County",4,9,13617,6957,6660
050,24,031,"Maryland","Montgomery County",4,10,13464,6997,6467
050,24,031,"Maryland","Montgomery County",4,11,13610,7056,6554
050,24,031,"Maryland","Montgomery County",4,12,13971,7269,6702
050,24,031,"Maryland","Montgomery County",4,13,14043,7277,6766
050,24,031,"Maryland","Montgomery County",4,14,14608,7573,7035
050,24,031,"Maryland","Montgomery County",4,15,14622,7584,7038
050,24,031,"Maryland","Montgomery County",4,16,14395,7390,7005
050,24,031,"Maryland","Montgomery County",4,17,14404,7334,7070
050,24,031,"Maryland","Montgomery County",4,18,12538,6554,5984
050,24,031,"Maryland","Montgomery County",4,19,10452,5402,5050
050,24,031,"Maryland","Montgomery County",4,20,10970,5600,5370
050,24,031,"Maryland","Montgomery County",4,21,11611,5817,5794
050,24,031,"Maryland","Montgomery County",4,22,11788,5859,5929
050,24,031,"Maryland","Montgomery County",4,23,11699,5891,5808
050,24,031,"Maryland","Montgomery County",4,24,11871,5852,6019
050,24,031,"Maryland","Montgomery County",4,25,11834,5774,6060
050,24,031,"Maryland","Montgomery County",4,26,11824,5876,5948
050,24,031,"Maryland","Montgomery County",4,27,12000,5897,6103
050,24,031,"Maryland","Montgomery County",4,28,12099,5987,6112
050,24,031,"Maryland","Montgomery County",4,29,12291,6009,6282
050,24,031,"Maryland","Montgomery County",4,30,12424,6150,6274
050,24,031,"Maryland","Montgomery County",4,31,12575,6229,6346
050,24,031,"Maryland","Montgomery County",4,32,13115,6632,6483
050,24,031,"Maryland","Montgomery County",4,33,13259,6574,6685
050,24,031,"Maryland","Montgomery County",4,34,13928,6753,7175
050,24,031,"Maryland","Montgomery County",4,35,14123,6867,7256
050,24,031,"Maryland","Montgomery County",4,36,14357,7067,7290
050,24,031,"Maryland","Montgomery County",4,37,14707,7209,7498
050,24,031,"Maryland","Montgomery County",4,38,14675,7168,7507
050,24,031,"Maryland","Montgomery County",4,39,14906,7304,7602
050,24,031,"Maryland","Montgomery County",4,40,15108,7381,7727
050,24,031,"Maryland","Montgomery County",4,41,15152,7382,7770
050,24,031,"Maryland","Montgomery County",4,42,15224,7508,7716
050,24,031,"Maryland","Montgomery County",4,43,14675,7185,7490
050,24,031,"Maryland","Montgomery County",4,44,14222,6890,7332
050,24,031,"Maryland","Montgomery County",4,45,14283,6949,7334
050,24,031,"Maryland","Montgomery County",4,46,13952,6796,7156
050,24,031,"Maryland","Montgomery County",4,47,13945,6817,7128
050,24,031,"Maryland","Montgomery County",4,48,13478,6517,6961
050,24,031,"Maryland","Montgomery County",4,49,13813,6693,7120
050,24,031,"Maryland","Montgomery County",4,50,14386,6993,7393
050,24,031,"Maryland","Montgomery County",4,51,14848,7259,7589
050,24,031,"Maryland","Montgomery County",4,52,14810,7158,7652
050,24,031,"Maryland","Montgomery County",4,53,14554,6939,7615
050,24,031,"Maryland","Montgomery County",4,54,14152,6779,7373
050,24,031,"Maryland","Montgomery County",4,55,13992,6793,7199
050,24,031,"Maryland","Montgomery County",4,56,13948,6752,7196
050,24,031,"Maryland","Montgomery County",4,57,14121,6795,7326
050,24,031,"Maryland","Montgomery County",4,58,14474,6980,7494
050,24,031,"Maryland","Montgomery County",4,59,14401,6896,7505
050,24,031,"Maryland","Montgomery County",4,60,13999,6735,7264
050,24,031,"Maryland","Montgomery County",4,61,13656,6573,7083
050,24,031,"Maryland","Montgomery County",4,62,13355,6416,6939
050,24,031,"Maryland","Montgomery County",4,63,13145,6299,6846
050,24,031,"Maryland","Montgomery County",4,64,12845,6276,6569
050,24,031,"Maryland","Montgomery County",4,65,12523,6115,6408
050,24,031,"Maryland","Montgomery County",4,66,11807,5653,6154
050,24,031,"Maryland","Montgomery County",4,67,11464,5365,6099
050,24,031,"Maryland","Montgomery County",4,68,10993,5110,5883
050,24,031,"Maryland","Montgomery County",4,69,10484,4837,5647
050,24,031,"Maryland","Montgomery County",4,70,9931,4532,5399
050,24,031,"Maryland","Montgomery County",4,71,9368,4256,5112
050,24,031,"Maryland","Montgomery County",4,72,8937,4055,4882
050,24,031,"Maryland","Montgomery County",4,73,8700,3954,4746
050,24,031,"Maryland","Montgomery County",4,74,8517,3815,4702
050,24,031,"Maryland","Montgomery County",4,75,8670,3891,4779
050,24,031,"Maryland","Montgomery County",4,76,6516,2915,3601
050,24,031,"Maryland","Montgomery County",4,77,6334,2790,3544
050,24,031,"Maryland","Montgomery County",4,78,6101,2633,3468
050,24,031,"Maryland","Montgomery County",4,79,6027,2613,3414
050,24,031,"Maryland","Montgomery County",4,80,5183,2226,2957
050,24,031,"Maryland","Montgomery County",4,81,4531,1922,2609
050,24,031,"Maryland","Montgomery County",4,82,4176,1762,2414
050,24,031,"Maryland","Montgomery County",4,83,3810,1571,2239
050,24,031,"Maryland","Montgomery County",4,84,3632,1515,2117
050,24,031,"Maryland","Montgomery County",4,85,22639,8142,14497
050,24,031,"Maryland","Montgomery County",5,0,11832,6205,5627
050,24,031,"Maryland","Montgomery County",5,1,11927,6248,5679
050,24,031,"Maryland","Montgomery County",5,2,11243,5860,5383
050,24,031,"Maryland","Montgomery County",5,3,11983,6037,5946
050,24,031,"Maryland","Montgomery County",5,4,12390,6311,6079
050,24,031,"Maryland","Montgomery County",5,5,12773,6599,6174
050,24,031,"Maryland","Montgomery County",5,6,13043,6711,6332
050,24,031,"Maryland","Montgomery County",5,7,13388,6780,6608
050,24,031,"Maryland","Montgomery County",5,8,13249,6746,6503
050,24,031,"Maryland","Montgomery County",5,9,13489,6891,6598
050,24,031,"Maryland","Montgomery County",5,10,13651,6960,6691
050,24,031,"Maryland","Montgomery County",5,11,13578,7064,6514
050,24,031,"Maryland","Montgomery County",5,12,13795,7199,6596
050,24,031,"Maryland","Montgomery County",5,13,14133,7350,6783
050,24,031,"Maryland","Montgomery County",5,14,14225,7372,6853
050,24,031,"Maryland","Montgomery County",5,15,14894,7683,7211
050,24,031,"Maryland","Montgomery County",5,16,14724,7634,7090
050,24,031,"Maryland","Montgomery County",5,17,14442,7410,7032
050,24,031,"Maryland","Montgomery County",5,18,12525,6529,5996
050,24,031,"Maryland","Montgomery County",5,19,10859,5705,5154
050,24,031,"Maryland","Montgomery County",5,20,11190,5765,5425
050,24,031,"Maryland","Montgomery County",5,21,11470,5803,5667
050,24,031,"Maryland","Montgomery County",5,22,11983,5930,6053
050,24,031,"Maryland","Montgomery County",5,23,12041,5940,6101
050,24,031,"Maryland","Montgomery County",5,24,11716,5893,5823
050,24,031,"Maryland","Montgomery County",5,25,11759,5736,6023
050,24,031,"Maryland","Montgomery County",5,26,11806,5815,5991
050,24,031,"Maryland","Montgomery County",5,27,11883,5861,6022
050,24,031,"Maryland","Montgomery County",5,28,11877,5795,6082
050,24,031,"Maryland","Montgomery County",5,29,12211,5951,6260
050,24,031,"Maryland","Montgomery County",5,30,12299,6023,6276
050,24,031,"Maryland","Montgomery County",5,31,12625,6212,6413
050,24,031,"Maryland","Montgomery County",5,32,12700,6332,6368
050,24,031,"Maryland","Montgomery County",5,33,13352,6712,6640
050,24,031,"Maryland","Montgomery County",5,34,13451,6658,6793
050,24,031,"Maryland","Montgomery County",5,35,14088,6811,7277
050,24,031,"Maryland","Montgomery County",5,36,14141,6874,7267
050,24,031,"Maryland","Montgomery County",5,37,14520,7090,7430
050,24,031,"Maryland","Montgomery County",5,38,14881,7371,7510
050,24,031,"Maryland","Montgomery County",5,39,14751,7193,7558
050,24,031,"Maryland","Montgomery County",5,40,14947,7270,7677
050,24,031,"Maryland","Montgomery County",5,41,15059,7345,7714
050,24,031,"Maryland","Montgomery County",5,42,15181,7388,7793
050,24,031,"Maryland","Montgomery County",5,43,15231,7513,7718
050,24,031,"Maryland","Montgomery County",5,44,14649,7124,7525
050,24,031,"Maryland","Montgomery County",5,45,14216,6911,7305
050,24,031,"Maryland","Montgomery County",5,46,14275,6928,7347
050,24,031,"Maryland","Montgomery County",5,47,13994,6798,7196
050,24,031,"Maryland","Montgomery County",5,48,13893,6771,7122
050,24,031,"Maryland","Montgomery County",5,49,13554,6574,6980
050,24,031,"Maryland","Montgomery County",5,50,13783,6691,7092
050,24,031,"Maryland","Montgomery County",5,51,14373,7014,7359
050,24,031,"Maryland","Montgomery County",5,52,14742,7153,7589
050,24,031,"Maryland","Montgomery County",5,53,14707,7102,7605
050,24,031,"Maryland","Montgomery County",5,54,14427,6927,7500
050,24,031,"Maryland","Montgomery County",5,55,14093,6781,7312
050,24,031,"Maryland","Montgomery County",5,56,13823,6721,7102
050,24,031,"Maryland","Montgomery County",5,57,13805,6672,7133
050,24,031,"Maryland","Montgomery County",5,58,13926,6700,7226
050,24,031,"Maryland","Montgomery County",5,59,14256,6875,7381
050,24,031,"Maryland","Montgomery County",5,60,14154,6746,7408
050,24,031,"Maryland","Montgomery County",5,61,13752,6617,7135
050,24,031,"Maryland","Montgomery County",5,62,13407,6445,6962
050,24,031,"Maryland","Montgomery County",5,63,13065,6238,6827
050,24,031,"Maryland","Montgomery County",5,64,12956,6204,6752
050,24,031,"Maryland","Montgomery County",5,65,12618,6137,6481
050,24,031,"Maryland","Montgomery County",5,66,12220,5940,6280
050,24,031,"Maryland","Montgomery County",5,67,11635,5558,6077
050,24,031,"Maryland","Montgomery County",5,68,11212,5219,5993
050,24,031,"Maryland","Montgomery County",5,69,10808,5022,5786
050,24,031,"Maryland","Montgomery County",5,70,10273,4703,5570
050,24,031,"Maryland","Montgomery County",5,71,9856,4486,5370
050,24,031,"Maryland","Montgomery County",5,72,9265,4168,5097
050,24,031,"Maryland","Montgomery County",5,73,8737,3952,4785
050,24,031,"Maryland","Montgomery County",5,74,8582,3880,4702
050,24,031,"Maryland","Montgomery County",5,75,8360,3716,4644
050,24,031,"Maryland","Montgomery County",5,76,8540,3812,4728
050,24,031,"Maryland","Montgomery County",5,77,6377,2830,3547
050,24,031,"Maryland","Montgomery County",5,78,6242,2740,3502
050,24,031,"Maryland","Montgomery County",5,79,5952,2547,3405
050,24,031,"Maryland","Montgomery County",5,80,5900,2543,3357
050,24,031,"Maryland","Montgomery County",5,81,5020,2145,2875
050,24,031,"Maryland","Montgomery County",5,82,4364,1831,2533
050,24,031,"Maryland","Montgomery County",5,83,4039,1696,2343
050,24,031,"Maryland","Montgomery County",5,84,3718,1511,2207
050,24,031,"Maryland","Montgomery County",5,85,23601,8639,14962
050,24,033,"Maryland","Prince George's County",1,0,12492,6370,6122
050,24,033,"Maryland","Prince George's County",1,1,12531,6427,6104
050,24,033,"Maryland","Prince George's County",1,2,12895,6552,6343
050,24,033,"Maryland","Prince George's County",1,3,12629,6425,6204
050,24,033,"Maryland","Prince George's County",1,4,12364,6288,6076
050,24,033,"Maryland","Prince George's County",1,5,12058,6111,5947
050,24,033,"Maryland","Prince George's County",1,6,11871,6077,5794
050,24,033,"Maryland","Prince George's County",1,7,11862,6011,5851
050,24,033,"Maryland","Prince George's County",1,8,12021,6106,5915
050,24,033,"Maryland","Prince George's County",1,9,12111,6167,5944
050,24,033,"Maryland","Prince George's County",1,10,12307,6245,6062
050,24,033,"Maryland","Prince George's County",1,11,12344,6231,6113
050,24,033,"Maryland","Prince George's County",1,12,12498,6402,6096
050,24,033,"Maryland","Prince George's County",1,13,12263,6276,5987
050,24,033,"Maryland","Prince George's County",1,14,11814,5964,5850
050,24,033,"Maryland","Prince George's County",1,15,11499,5775,5724
050,24,033,"Maryland","Prince George's County",1,16,11551,5904,5647
050,24,033,"Maryland","Prince George's County",1,17,11382,5759,5623
050,24,033,"Maryland","Prince George's County",1,18,13158,6700,6458
050,24,033,"Maryland","Prince George's County",1,19,13565,7069,6496
050,24,033,"Maryland","Prince George's County",1,20,12577,6477,6100
050,24,033,"Maryland","Prince George's County",1,21,12053,6064,5989
050,24,033,"Maryland","Prince George's County",1,22,11731,5826,5905
050,24,033,"Maryland","Prince George's County",1,23,12082,5874,6208
050,24,033,"Maryland","Prince George's County",1,24,12460,6159,6301
050,24,033,"Maryland","Prince George's County",1,25,13023,6426,6597
050,24,033,"Maryland","Prince George's County",1,26,13580,6635,6945
050,24,033,"Maryland","Prince George's County",1,27,13826,6805,7021
050,24,033,"Maryland","Prince George's County",1,28,13913,6896,7017
050,24,033,"Maryland","Prince George's County",1,29,14243,7161,7082
050,24,033,"Maryland","Prince George's County",1,30,14405,7551,6854
050,24,033,"Maryland","Prince George's County",1,31,14040,7019,7021
050,24,033,"Maryland","Prince George's County",1,32,14080,6998,7082
050,24,033,"Maryland","Prince George's County",1,33,13853,6819,7034
050,24,033,"Maryland","Prince George's County",1,34,13523,6689,6834
050,24,033,"Maryland","Prince George's County",1,35,13413,6668,6745
050,24,033,"Maryland","Prince George's County",1,36,13283,6679,6604
050,24,033,"Maryland","Prince George's County",1,37,13593,6851,6742
050,24,033,"Maryland","Prince George's County",1,38,13606,6815,6791
050,24,033,"Maryland","Prince George's County",1,39,13673,6788,6885
050,24,033,"Maryland","Prince George's County",1,40,13730,6917,6813
050,24,033,"Maryland","Prince George's County",1,41,13146,6614,6532
050,24,033,"Maryland","Prince George's County",1,42,12880,6460,6420
050,24,033,"Maryland","Prince George's County",1,43,12602,6257,6345
050,24,033,"Maryland","Prince George's County",1,44,11962,5945,6017
050,24,033,"Maryland","Prince George's County",1,45,11937,5946,5991
050,24,033,"Maryland","Prince George's County",1,46,11781,5780,6001
050,24,033,"Maryland","Prince George's County",1,47,12214,5873,6341
050,24,033,"Maryland","Prince George's County",1,48,12950,6242,6708
050,24,033,"Maryland","Prince George's County",1,49,14150,6865,7285
050,24,033,"Maryland","Prince George's County",1,50,13615,6630,6985
050,24,033,"Maryland","Prince George's County",1,51,13121,6241,6880
050,24,033,"Maryland","Prince George's County",1,52,13173,6324,6849
050,24,033,"Maryland","Prince George's County",1,53,13383,6295,7088
050,24,033,"Maryland","Prince George's County",1,54,13795,6433,7362
050,24,033,"Maryland","Prince George's County",1,55,13901,6518,7383
050,24,033,"Maryland","Prince George's County",1,56,13830,6468,7362
050,24,033,"Maryland","Prince George's County",1,57,13682,6440,7242
050,24,033,"Maryland","Prince George's County",1,58,13480,6320,7160
050,24,033,"Maryland","Prince George's County",1,59,13261,6208,7053
050,24,033,"Maryland","Prince George's County",1,60,13117,6246,6871
050,24,033,"Maryland","Prince George's County",1,61,12453,5912,6541
050,24,033,"Maryland","Prince George's County",1,62,11938,5576,6362
050,24,033,"Maryland","Prince George's County",1,63,11335,5201,6134
050,24,033,"Maryland","Prince George's County",1,64,10988,4971,6017
050,24,033,"Maryland","Prince George's County",1,65,10475,4755,5720
050,24,033,"Maryland","Prince George's County",1,66,9949,4453,5496
050,24,033,"Maryland","Prince George's County",1,67,9594,4193,5401
050,24,033,"Maryland","Prince George's County",1,68,9085,3938,5147
050,24,033,"Maryland","Prince George's County",1,69,8691,3721,4970
050,24,033,"Maryland","Prince George's County",1,70,8416,3595,4821
050,24,033,"Maryland","Prince George's County",1,71,8113,3478,4635
050,24,033,"Maryland","Prince George's County",1,72,7763,3328,4435
050,24,033,"Maryland","Prince George's County",1,73,7187,3052,4135
050,24,033,"Maryland","Prince George's County",1,74,5378,2265,3113
050,24,033,"Maryland","Prince George's County",1,75,5256,2218,3038
050,24,033,"Maryland","Prince George's County",1,76,4969,2073,2896
050,24,033,"Maryland","Prince George's County",1,77,4666,1921,2745
050,24,033,"Maryland","Prince George's County",1,78,4052,1653,2399
050,24,033,"Maryland","Prince George's County",1,79,3621,1494,2127
050,24,033,"Maryland","Prince George's County",1,80,3300,1367,1933
050,24,033,"Maryland","Prince George's County",1,81,2872,1171,1701
050,24,033,"Maryland","Prince George's County",1,82,2595,1041,1554
050,24,033,"Maryland","Prince George's County",1,83,2357,938,1419
050,24,033,"Maryland","Prince George's County",1,84,2188,840,1348
050,24,033,"Maryland","Prince George's County",1,85,12092,3940,8152
050,24,033,"Maryland","Prince George's County",2,0,12111,6193,5918
050,24,033,"Maryland","Prince George's County",2,1,12507,6406,6101
050,24,033,"Maryland","Prince George's County",2,2,12785,6508,6277
050,24,033,"Maryland","Prince George's County",2,3,12583,6404,6179
050,24,033,"Maryland","Prince George's County",2,4,12329,6265,6064
050,24,033,"Maryland","Prince George's County",2,5,12091,6135,5956
050,24,033,"Maryland","Prince George's County",2,6,11864,6054,5810
050,24,033,"Maryland","Prince George's County",2,7,11813,5996,5817
050,24,033,"Maryland","Prince George's County",2,8,11907,6043,5864
050,24,033,"Maryland","Prince George's County",2,9,12041,6123,5918
050,24,033,"Maryland","Prince George's County",2,10,12211,6201,6010
050,24,033,"Maryland","Prince George's County",2,11,12221,6178,6043
050,24,033,"Maryland","Prince George's County",2,12,12462,6363,6099
050,24,033,"Maryland","Prince George's County",2,13,12275,6285,5990
050,24,033,"Maryland","Prince George's County",2,14,11864,5999,5865
050,24,033,"Maryland","Prince George's County",2,15,11547,5801,5746
050,24,033,"Maryland","Prince George's County",2,16,11534,5860,5674
050,24,033,"Maryland","Prince George's County",2,17,11361,5756,5605
050,24,033,"Maryland","Prince George's County",2,18,13119,6661,6458
050,24,033,"Maryland","Prince George's County",2,19,13567,7060,6507
050,24,033,"Maryland","Prince George's County",2,20,12677,6524,6153
050,24,033,"Maryland","Prince George's County",2,21,11980,6042,5938
050,24,033,"Maryland","Prince George's County",2,22,11708,5801,5907
050,24,033,"Maryland","Prince George's County",2,23,12031,5882,6149
050,24,033,"Maryland","Prince George's County",2,24,12350,6073,6277
050,24,033,"Maryland","Prince George's County",2,25,12904,6362,6542
050,24,033,"Maryland","Prince George's County",2,26,13460,6596,6864
050,24,033,"Maryland","Prince George's County",2,27,13722,6742,6980
050,24,033,"Maryland","Prince George's County",2,28,13864,6862,7002
050,24,033,"Maryland","Prince George's County",2,29,14126,7101,7025
050,24,033,"Maryland","Prince George's County",2,30,14405,7484,6921
050,24,033,"Maryland","Prince George's County",2,31,14066,7126,6940
050,24,033,"Maryland","Prince George's County",2,32,13981,6956,7025
050,24,033,"Maryland","Prince George's County",2,33,13835,6824,7011
050,24,033,"Maryland","Prince George's County",2,34,13561,6699,6862
050,24,033,"Maryland","Prince George's County",2,35,13461,6693,6768
050,24,033,"Maryland","Prince George's County",2,36,13189,6608,6581
050,24,033,"Maryland","Prince George's County",2,37,13469,6786,6683
050,24,033,"Maryland","Prince George's County",2,38,13638,6841,6797
050,24,033,"Maryland","Prince George's County",2,39,13522,6732,6790
050,24,033,"Maryland","Prince George's County",2,40,13801,6933,6868
050,24,033,"Maryland","Prince George's County",2,41,13224,6647,6577
050,24,033,"Maryland","Prince George's County",2,42,12852,6452,6400
050,24,033,"Maryland","Prince George's County",2,43,12718,6313,6405
050,24,033,"Maryland","Prince George's County",2,44,11993,5957,6036
050,24,033,"Maryland","Prince George's County",2,45,11991,5964,6027
050,24,033,"Maryland","Prince George's County",2,46,11749,5782,5967
050,24,033,"Maryland","Prince George's County",2,47,12079,5841,6238
050,24,033,"Maryland","Prince George's County",2,48,12794,6163,6631
050,24,033,"Maryland","Prince George's County",2,49,13896,6732,7164
050,24,033,"Maryland","Prince George's County",2,50,13733,6681,7052
050,24,033,"Maryland","Prince George's County",2,51,13105,6269,6836
050,24,033,"Maryland","Prince George's County",2,52,13177,6319,6858
050,24,033,"Maryland","Prince George's County",2,53,13233,6245,6988
050,24,033,"Maryland","Prince George's County",2,54,13655,6388,7267
050,24,033,"Maryland","Prince George's County",2,55,13855,6488,7367
050,24,033,"Maryland","Prince George's County",2,56,13843,6482,7361
050,24,033,"Maryland","Prince George's County",2,57,13665,6421,7244
050,24,033,"Maryland","Prince George's County",2,58,13467,6327,7140
050,24,033,"Maryland","Prince George's County",2,59,13231,6194,7037
050,24,033,"Maryland","Prince George's County",2,60,13115,6223,6892
050,24,033,"Maryland","Prince George's County",2,61,12546,5944,6602
050,24,033,"Maryland","Prince George's County",2,62,11912,5586,6326
050,24,033,"Maryland","Prince George's County",2,63,11506,5293,6213
050,24,033,"Maryland","Prince George's County",2,64,10939,4960,5979
050,24,033,"Maryland","Prince George's County",2,65,10518,4754,5764
050,24,033,"Maryland","Prince George's County",2,66,10039,4491,5548
050,24,033,"Maryland","Prince George's County",2,67,9557,4190,5367
050,24,033,"Maryland","Prince George's County",2,68,9076,3934,5142
050,24,033,"Maryland","Prince George's County",2,69,8748,3745,5003
050,24,033,"Maryland","Prince George's County",2,70,8415,3593,4822
050,24,033,"Maryland","Prince George's County",2,71,8080,3452,4628
050,24,033,"Maryland","Prince George's County",2,72,7738,3311,4427
050,24,033,"Maryland","Prince George's County",2,73,7444,3162,4282
050,24,033,"Maryland","Prince George's County",2,74,5503,2303,3200
050,24,033,"Maryland","Prince George's County",2,75,5247,2205,3042
050,24,033,"Maryland","Prince George's County",2,76,4947,2064,2883
050,24,033,"Maryland","Prince George's County",2,77,4720,1939,2781
050,24,033,"Maryland","Prince George's County",2,78,4089,1667,2422
050,24,033,"Maryland","Prince George's County",2,79,3668,1498,2170
050,24,033,"Maryland","Prince George's County",2,80,3320,1359,1961
050,24,033,"Maryland","Prince George's County",2,81,2869,1172,1697
050,24,033,"Maryland","Prince George's County",2,82,2607,1033,1574
050,24,033,"Maryland","Prince George's County",2,83,2354,932,1422
050,24,033,"Maryland","Prince George's County",2,84,2206,848,1358
050,24,033,"Maryland","Prince George's County",2,85,12000,3918,8082
050,24,033,"Maryland","Prince George's County",3,0,10907,5631,5276
050,24,033,"Maryland","Prince George's County",3,1,11943,6079,5864
050,24,033,"Maryland","Prince George's County",3,2,12116,6204,5912
050,24,033,"Maryland","Prince George's County",3,3,12263,6230,6033
050,24,033,"Maryland","Prince George's County",3,4,12177,6198,5979
050,24,033,"Maryland","Prince George's County",3,5,12050,6126,5924
050,24,033,"Maryland","Prince George's County",3,6,11785,6033,5752
050,24,033,"Maryland","Prince George's County",3,7,11618,5906,5712
050,24,033,"Maryland","Prince George's County",3,8,11562,5904,5658
050,24,033,"Maryland","Prince George's County",3,9,11638,5928,5710
050,24,033,"Maryland","Prince George's County",3,10,11785,6017,5768
050,24,033,"Maryland","Prince George's County",3,11,11966,6045,5921
050,24,033,"Maryland","Prince George's County",3,12,11887,6001,5886
050,24,033,"Maryland","Prince George's County",3,13,12223,6240,5983
050,24,033,"Maryland","Prince George's County",3,14,12059,6169,5890
050,24,033,"Maryland","Prince George's County",3,15,11726,5953,5773
050,24,033,"Maryland","Prince George's County",3,16,11438,5739,5699
050,24,033,"Maryland","Prince George's County",3,17,11388,5792,5596
050,24,033,"Maryland","Prince George's County",3,18,13126,6623,6503
050,24,033,"Maryland","Prince George's County",3,19,13570,7052,6518
050,24,033,"Maryland","Prince George's County",3,20,12568,6471,6097
050,24,033,"Maryland","Prince George's County",3,21,11986,6099,5887
050,24,033,"Maryland","Prince George's County",3,22,11324,5626,5698
050,24,033,"Maryland","Prince George's County",3,23,11611,5753,5858
050,24,033,"Maryland","Prince George's County",3,24,11909,5830,6079
050,24,033,"Maryland","Prince George's County",3,25,12362,6084,6278
050,24,033,"Maryland","Prince George's County",3,26,12797,6307,6490
050,24,033,"Maryland","Prince George's County",3,27,13252,6517,6735
050,24,033,"Maryland","Prince George's County",3,28,13442,6631,6811
050,24,033,"Maryland","Prince George's County",3,29,13479,6612,6867
050,24,033,"Maryland","Prince George's County",3,30,13952,7024,6928
050,24,033,"Maryland","Prince George's County",3,31,14176,7430,6746
050,24,033,"Maryland","Prince George's County",3,32,13755,6938,6817
050,24,033,"Maryland","Prince George's County",3,33,13769,6861,6908
050,24,033,"Maryland","Prince George's County",3,34,13474,6657,6817
050,24,033,"Maryland","Prince George's County",3,35,13232,6483,6749
050,24,033,"Maryland","Prince George's County",3,36,13180,6568,6612
050,24,033,"Maryland","Prince George's County",3,37,12923,6482,6441
050,24,033,"Maryland","Prince George's County",3,38,13233,6610,6623
050,24,033,"Maryland","Prince George's County",3,39,13308,6651,6657
050,24,033,"Maryland","Prince George's County",3,40,13292,6649,6643
050,24,033,"Maryland","Prince George's County",3,41,13570,6823,6747
050,24,033,"Maryland","Prince George's County",3,42,12963,6511,6452
050,24,033,"Maryland","Prince George's County",3,43,12661,6302,6359
050,24,033,"Maryland","Prince George's County",3,44,12524,6221,6303
050,24,033,"Maryland","Prince George's County",3,45,11856,5875,5981
050,24,033,"Maryland","Prince George's County",3,46,11850,5884,5966
050,24,033,"Maryland","Prince George's County",3,47,11678,5775,5903
050,24,033,"Maryland","Prince George's County",3,48,11994,5838,6156
050,24,033,"Maryland","Prince George's County",3,49,12645,6080,6565
050,24,033,"Maryland","Prince George's County",3,50,13676,6612,7064
050,24,033,"Maryland","Prince George's County",3,51,13641,6602,7039
050,24,033,"Maryland","Prince George's County",3,52,12956,6211,6745
050,24,033,"Maryland","Prince George's County",3,53,13010,6227,6783
050,24,033,"Maryland","Prince George's County",3,54,13062,6171,6891
050,24,033,"Maryland","Prince George's County",3,55,13430,6272,7158
050,24,033,"Maryland","Prince George's County",3,56,13563,6327,7236
050,24,033,"Maryland","Prince George's County",3,57,13601,6325,7276
050,24,033,"Maryland","Prince George's County",3,58,13393,6288,7105
050,24,033,"Maryland","Prince George's County",3,59,13301,6221,7080
050,24,033,"Maryland","Prince George's County",3,60,13005,6064,6941
050,24,033,"Maryland","Prince George's County",3,61,12888,6073,6815
050,24,033,"Maryland","Prince George's County",3,62,12272,5834,6438
050,24,033,"Maryland","Prince George's County",3,63,11623,5451,6172
050,24,033,"Maryland","Prince George's County",3,64,11236,5159,6077
050,24,033,"Maryland","Prince George's County",3,65,10594,4769,5825
050,24,033,"Maryland","Prince George's County",3,66,10190,4581,5609
050,24,033,"Maryland","Prince George's County",3,67,9759,4348,5411
050,24,033,"Maryland","Prince George's County",3,68,9302,4057,5245
050,24,033,"Maryland","Prince George's County",3,69,8804,3799,5005
050,24,033,"Maryland","Prince George's County",3,70,8551,3649,4902
050,24,033,"Maryland","Prince George's County",3,71,8225,3485,4740
050,24,033,"Maryland","Prince George's County",3,72,7888,3339,4549
050,24,033,"Maryland","Prince George's County",3,73,7472,3169,4303
050,24,033,"Maryland","Prince George's County",3,74,7199,3029,4170
050,24,033,"Maryland","Prince George's County",3,75,5345,2208,3137
050,24,033,"Maryland","Prince George's County",3,76,5089,2137,2952
050,24,033,"Maryland","Prince George's County",3,77,4712,1958,2754
050,24,033,"Maryland","Prince George's County",3,78,4523,1819,2704
050,24,033,"Maryland","Prince George's County",3,79,3877,1565,2312
050,24,033,"Maryland","Prince George's County",3,80,3466,1394,2072
050,24,033,"Maryland","Prince George's County",3,81,3128,1254,1874
050,24,033,"Maryland","Prince George's County",3,82,2726,1101,1625
050,24,033,"Maryland","Prince George's County",3,83,2413,946,1467
050,24,033,"Maryland","Prince George's County",3,84,2238,858,1380
050,24,033,"Maryland","Prince George's County",3,85,12301,4011,8290
050,24,033,"Maryland","Prince George's County",4,0,10971,5644,5327
050,24,033,"Maryland","Prince George's County",4,1,10826,5539,5287
050,24,033,"Maryland","Prince George's County",4,2,11578,5847,5731
050,24,033,"Maryland","Prince George's County",4,3,11751,6019,5732
050,24,033,"Maryland","Prince George's County",4,4,11867,5989,5878
050,24,033,"Maryland","Prince George's County",4,5,11814,6013,5801
050,24,033,"Maryland","Prince George's County",4,6,11674,5955,5719
050,24,033,"Maryland","Prince George's County",4,7,11526,5892,5634
050,24,033,"Maryland","Prince George's County",4,8,11429,5862,5567
050,24,033,"Maryland","Prince George's County",4,9,11408,5834,5574
050,24,033,"Maryland","Prince George's County",4,10,11432,5849,5583
050,24,033,"Maryland","Prince George's County",4,11,11581,5892,5689
050,24,033,"Maryland","Prince George's County",4,12,11731,5908,5823
050,24,033,"Maryland","Prince George's County",4,13,11698,5905,5793
050,24,033,"Maryland","Prince George's County",4,14,12081,6190,5891
050,24,033,"Maryland","Prince George's County",4,15,11924,6095,5829
050,24,033,"Maryland","Prince George's County",4,16,11715,5973,5742
050,24,033,"Maryland","Prince George's County",4,17,11358,5719,5639
050,24,033,"Maryland","Prince George's County",4,18,13128,6678,6450
050,24,033,"Maryland","Prince George's County",4,19,13338,6928,6410
050,24,033,"Maryland","Prince George's County",4,20,12354,6363,5991
050,24,033,"Maryland","Prince George's County",4,21,11878,6007,5871
050,24,033,"Maryland","Prince George's County",4,22,11414,5767,5647
050,24,033,"Maryland","Prince George's County",4,23,11349,5656,5693
050,24,033,"Maryland","Prince George's County",4,24,11600,5770,5830
050,24,033,"Maryland","Prince George's County",4,25,11798,5809,5989
050,24,033,"Maryland","Prince George's County",4,26,12143,5984,6159
050,24,033,"Maryland","Prince George's County",4,27,12541,6129,6412
050,24,033,"Maryland","Prince George's County",4,28,12791,6310,6481
050,24,033,"Maryland","Prince George's County",4,29,13150,6458,6692
050,24,033,"Maryland","Prince George's County",4,30,13146,6454,6692
050,24,033,"Maryland","Prince George's County",4,31,13621,6807,6814
050,24,033,"Maryland","Prince George's County",4,32,14037,7340,6697
050,24,033,"Maryland","Prince George's County",4,33,13451,6792,6659
050,24,033,"Maryland","Prince George's County",4,34,13316,6662,6654
050,24,033,"Maryland","Prince George's County",4,35,13137,6443,6694
050,24,033,"Maryland","Prince George's County",4,36,12931,6307,6624
050,24,033,"Maryland","Prince George's County",4,37,12818,6352,6466
050,24,033,"Maryland","Prince George's County",4,38,12597,6263,6334
050,24,033,"Maryland","Prince George's County",4,39,12822,6348,6474
050,24,033,"Maryland","Prince George's County",4,40,13072,6542,6530
050,24,033,"Maryland","Prince George's County",4,41,13116,6523,6593
050,24,033,"Maryland","Prince George's County",4,42,13324,6684,6640
050,24,033,"Maryland","Prince George's County",4,43,12724,6382,6342
050,24,033,"Maryland","Prince George's County",4,44,12524,6224,6300
050,24,033,"Maryland","Prince George's County",4,45,12343,6129,6214
050,24,033,"Maryland","Prince George's County",4,46,11680,5768,5912
050,24,033,"Maryland","Prince George's County",4,47,11737,5853,5884
050,24,033,"Maryland","Prince George's County",4,48,11530,5697,5833
050,24,033,"Maryland","Prince George's County",4,49,11859,5770,6089
050,24,033,"Maryland","Prince George's County",4,50,12481,6022,6459
050,24,033,"Maryland","Prince George's County",4,51,13540,6547,6993
050,24,033,"Maryland","Prince George's County",4,52,13430,6450,6980
050,24,033,"Maryland","Prince George's County",4,53,12788,6096,6692
050,24,033,"Maryland","Prince George's County",4,54,12798,6113,6685
050,24,033,"Maryland","Prince George's County",4,55,12877,6063,6814
050,24,033,"Maryland","Prince George's County",4,56,13260,6197,7063
050,24,033,"Maryland","Prince George's County",4,57,13374,6240,7134
050,24,033,"Maryland","Prince George's County",4,58,13343,6215,7128
050,24,033,"Maryland","Prince George's County",4,59,13163,6187,6976
050,24,033,"Maryland","Prince George's County",4,60,12963,6031,6932
050,24,033,"Maryland","Prince George's County",4,61,12719,5914,6805
050,24,033,"Maryland","Prince George's County",4,62,12613,5928,6685
050,24,033,"Maryland","Prince George's County",4,63,12057,5702,6355
050,24,033,"Maryland","Prince George's County",4,64,11329,5320,6009
050,24,033,"Maryland","Prince George's County",4,65,10910,4929,5981
050,24,033,"Maryland","Prince George's County",4,66,10305,4613,5692
050,24,033,"Maryland","Prince George's County",4,67,9875,4435,5440
050,24,033,"Maryland","Prince George's County",4,68,9532,4274,5258
050,24,033,"Maryland","Prince George's County",4,69,8986,3902,5084
050,24,033,"Maryland","Prince George's County",4,70,8584,3688,4896
050,24,033,"Maryland","Prince George's County",4,71,8298,3490,4808
050,24,033,"Maryland","Prince George's County",4,72,8054,3379,4675
050,24,033,"Maryland","Prince George's County",4,73,7632,3203,4429
050,24,033,"Maryland","Prince George's County",4,74,7221,3015,4206
050,24,033,"Maryland","Prince George's County",4,75,6945,2904,4041
050,24,033,"Maryland","Prince George's County",4,76,5166,2142,3024
050,24,033,"Maryland","Prince George's County",4,77,4868,2016,2852
050,24,033,"Maryland","Prince George's County",4,78,4506,1839,2667
050,24,033,"Maryland","Prince George's County",4,79,4296,1720,2576
050,24,033,"Maryland","Prince George's County",4,80,3673,1465,2208
050,24,033,"Maryland","Prince George's County",4,81,3268,1293,1975
050,24,033,"Maryland","Prince George's County",4,82,2970,1178,1792
050,24,033,"Maryland","Prince George's County",4,83,2532,1011,1521
050,24,033,"Maryland","Prince George's County",4,84,2296,865,1431
050,24,033,"Maryland","Prince George's County",4,85,12695,4155,8540
050,24,033,"Maryland","Prince George's County",5,0,10717,5527,5190
050,24,033,"Maryland","Prince George's County",5,1,10958,5611,5347
050,24,033,"Maryland","Prince George's County",5,2,10832,5572,5260
050,24,033,"Maryland","Prince George's County",5,3,11539,5849,5690
050,24,033,"Maryland","Prince George's County",5,4,11708,5985,5723
050,24,033,"Maryland","Prince George's County",5,5,11758,5956,5802
050,24,033,"Maryland","Prince George's County",5,6,11633,5944,5689
050,24,033,"Maryland","Prince George's County",5,7,11509,5880,5629
050,24,033,"Maryland","Prince George's County",5,8,11474,5908,5566
050,24,033,"Maryland","Prince George's County",5,9,11351,5810,5541
050,24,033,"Maryland","Prince George's County",5,10,11324,5761,5563
050,24,033,"Maryland","Prince George's County",5,11,11330,5774,5556
050,24,033,"Maryland","Prince George's County",5,12,11437,5785,5652
050,24,033,"Maryland","Prince George's County",5,13,11695,5872,5823
050,24,033,"Maryland","Prince George's County",5,14,11603,5851,5752
050,24,033,"Maryland","Prince George's County",5,15,12099,6190,5909
050,24,033,"Maryland","Prince George's County",5,16,12019,6137,5882
050,24,033,"Maryland","Prince George's County",5,17,11723,6008,5715
050,24,033,"Maryland","Prince George's County",5,18,13219,6646,6573
050,24,033,"Maryland","Prince George's County",5,19,13496,7064,6432
050,24,033,"Maryland","Prince George's County",5,20,12427,6421,6006
050,24,033,"Maryland","Prince George's County",5,21,11887,6039,5848
050,24,033,"Maryland","Prince George's County",5,22,11460,5700,5760
050,24,033,"Maryland","Prince George's County",5,23,11507,5836,5671
050,24,033,"Maryland","Prince George's County",5,24,11571,5844,5727
050,24,033,"Maryland","Prince George's County",5,25,11747,5834,5913
050,24,033,"Maryland","Prince George's County",5,26,11926,5826,6100
050,24,033,"Maryland","Prince George's County",5,27,12122,5966,6156
050,24,033,"Maryland","Prince George's County",5,28,12494,6076,6418
050,24,033,"Maryland","Prince George's County",5,29,12762,6213,6549
050,24,033,"Maryland","Prince George's County",5,30,13222,6519,6703
050,24,033,"Maryland","Prince George's County",5,31,13160,6479,6681
050,24,033,"Maryland","Prince George's County",5,32,13614,6803,6811
050,24,033,"Maryland","Prince George's County",5,33,13920,7323,6597
050,24,033,"Maryland","Prince George's County",5,34,13408,6723,6685
050,24,033,"Maryland","Prince George's County",5,35,13168,6587,6581
050,24,033,"Maryland","Prince George's County",5,36,12996,6412,6584
050,24,033,"Maryland","Prince George's County",5,37,12655,6129,6526
050,24,033,"Maryland","Prince George's County",5,38,12757,6344,6413
050,24,033,"Maryland","Prince George's County",5,39,12467,6192,6275
050,24,033,"Maryland","Prince George's County",5,40,12725,6287,6438
050,24,033,"Maryland","Prince George's County",5,41,12888,6457,6431
050,24,033,"Maryland","Prince George's County",5,42,12990,6512,6478
050,24,033,"Maryland","Prince George's County",5,43,13140,6619,6521
050,24,033,"Maryland","Prince George's County",5,44,12667,6300,6367
050,24,033,"Maryland","Prince George's County",5,45,12373,6095,6278
050,24,033,"Maryland","Prince George's County",5,46,12258,6021,6237
050,24,033,"Maryland","Prince George's County",5,47,11525,5714,5811
050,24,033,"Maryland","Prince George's County",5,48,11720,5823,5897
050,24,033,"Maryland","Prince George's County",5,49,11468,5680,5788
050,24,033,"Maryland","Prince George's County",5,50,11825,5769,6056
050,24,033,"Maryland","Prince George's County",5,51,12393,5990,6403
050,24,033,"Maryland","Prince George's County",5,52,13370,6442,6928
050,24,033,"Maryland","Prince George's County",5,53,13300,6352,6948
050,24,033,"Maryland","Prince George's County",5,54,12599,6008,6591
050,24,033,"Maryland","Prince George's County",5,55,12680,6016,6664
050,24,033,"Maryland","Prince George's County",5,56,12746,6000,6746
050,24,033,"Maryland","Prince George's County",5,57,13152,6151,7001
050,24,033,"Maryland","Prince George's County",5,58,13200,6146,7054
050,24,033,"Maryland","Prince George's County",5,59,13232,6189,7043
050,24,033,"Maryland","Prince George's County",5,60,12938,6072,6866
050,24,033,"Maryland","Prince George's County",5,61,12733,5905,6828
050,24,033,"Maryland","Prince George's County",5,62,12533,5797,6736
050,24,033,"Maryland","Prince George's County",5,63,12396,5817,6579
050,24,033,"Maryland","Prince George's County",5,64,11798,5587,6211
050,24,033,"Maryland","Prince George's County",5,65,11050,5150,5900
050,24,033,"Maryland","Prince George's County",5,66,10669,4811,5858
050,24,033,"Maryland","Prince George's County",5,67,10046,4467,5579
050,24,033,"Maryland","Prince George's County",5,68,9746,4380,5366
050,24,033,"Maryland","Prince George's County",5,69,9262,4125,5137
050,24,033,"Maryland","Prince George's County",5,70,8859,3864,4995
050,24,033,"Maryland","Prince George's County",5,71,8333,3548,4785
050,24,033,"Maryland","Prince George's County",5,72,8183,3421,4762
050,24,033,"Maryland","Prince George's County",5,73,7799,3223,4576
050,24,033,"Maryland","Prince George's County",5,74,7429,3109,4320
050,24,033,"Maryland","Prince George's County",5,75,7032,2929,4103
050,24,033,"Maryland","Prince George's County",5,76,6713,2808,3905
050,24,033,"Maryland","Prince George's County",5,77,4946,2027,2919
050,24,033,"Maryland","Prince George's County",5,78,4677,1913,2764
050,24,033,"Maryland","Prince George's County",5,79,4283,1743,2540
050,24,033,"Maryland","Prince George's County",5,80,4079,1602,2477
050,24,033,"Maryland","Prince George's County",5,81,3491,1378,2113
050,24,033,"Maryland","Prince George's County",5,82,3135,1225,1910
050,24,033,"Maryland","Prince George's County",5,83,2769,1093,1676
050,24,033,"Maryland","Prince George's County",5,84,2431,947,1484
050,24,033,"Maryland","Prince George's County",5,85,13155,4318,8837
050,24,035,"Maryland","Queen Anne's County",1,0,490,251,239
050,24,035,"Maryland","Queen Anne's County",1,1,508,261,247
050,24,035,"Maryland","Queen Anne's County",1,2,504,271,233
050,24,035,"Maryland","Queen Anne's County",1,3,525,277,248
050,24,035,"Maryland","Queen Anne's County",1,4,543,284,259
050,24,035,"Maryland","Queen Anne's County",1,5,500,253,247
050,24,035,"Maryland","Queen Anne's County",1,6,559,286,273
050,24,035,"Maryland","Queen Anne's County",1,7,550,283,267
050,24,035,"Maryland","Queen Anne's County",1,8,572,307,265
050,24,035,"Maryland","Queen Anne's County",1,9,613,333,280
050,24,035,"Maryland","Queen Anne's County",1,10,637,314,323
050,24,035,"Maryland","Queen Anne's County",1,11,679,332,347
050,24,035,"Maryland","Queen Anne's County",1,12,662,340,322
050,24,035,"Maryland","Queen Anne's County",1,13,683,345,338
050,24,035,"Maryland","Queen Anne's County",1,14,683,339,344
050,24,035,"Maryland","Queen Anne's County",1,15,668,327,341
050,24,035,"Maryland","Queen Anne's County",1,16,704,374,330
050,24,035,"Maryland","Queen Anne's County",1,17,696,358,338
050,24,035,"Maryland","Queen Anne's County",1,18,594,304,290
050,24,035,"Maryland","Queen Anne's County",1,19,463,243,220
050,24,035,"Maryland","Queen Anne's County",1,20,511,262,249
050,24,035,"Maryland","Queen Anne's County",1,21,503,256,247
050,24,035,"Maryland","Queen Anne's County",1,22,517,267,250
050,24,035,"Maryland","Queen Anne's County",1,23,529,284,245
050,24,035,"Maryland","Queen Anne's County",1,24,474,252,222
050,24,035,"Maryland","Queen Anne's County",1,25,499,274,225
050,24,035,"Maryland","Queen Anne's County",1,26,477,258,219
050,24,035,"Maryland","Queen Anne's County",1,27,504,254,250
050,24,035,"Maryland","Queen Anne's County",1,28,484,244,240
050,24,035,"Maryland","Queen Anne's County",1,29,532,269,263
050,24,035,"Maryland","Queen Anne's County",1,30,540,271,269
050,24,035,"Maryland","Queen Anne's County",1,31,516,232,284
050,24,035,"Maryland","Queen Anne's County",1,32,540,268,272
050,24,035,"Maryland","Queen Anne's County",1,33,538,266,272
050,24,035,"Maryland","Queen Anne's County",1,34,541,277,264
050,24,035,"Maryland","Queen Anne's County",1,35,590,300,290
050,24,035,"Maryland","Queen Anne's County",1,36,585,291,294
050,24,035,"Maryland","Queen Anne's County",1,37,613,289,324
050,24,035,"Maryland","Queen Anne's County",1,38,618,303,315
050,24,035,"Maryland","Queen Anne's County",1,39,580,270,310
050,24,035,"Maryland","Queen Anne's County",1,40,525,257,268
050,24,035,"Maryland","Queen Anne's County",1,41,548,275,273
050,24,035,"Maryland","Queen Anne's County",1,42,525,273,252
050,24,035,"Maryland","Queen Anne's County",1,43,501,245,256
050,24,035,"Maryland","Queen Anne's County",1,44,528,255,273
050,24,035,"Maryland","Queen Anne's County",1,45,572,282,290
050,24,035,"Maryland","Queen Anne's County",1,46,571,282,289
050,24,035,"Maryland","Queen Anne's County",1,47,596,305,291
050,24,035,"Maryland","Queen Anne's County",1,48,664,323,341
050,24,035,"Maryland","Queen Anne's County",1,49,746,354,392
050,24,035,"Maryland","Queen Anne's County",1,50,725,359,366
050,24,035,"Maryland","Queen Anne's County",1,51,724,361,363
050,24,035,"Maryland","Queen Anne's County",1,52,766,373,393
050,24,035,"Maryland","Queen Anne's County",1,53,798,395,403
050,24,035,"Maryland","Queen Anne's County",1,54,811,401,410
050,24,035,"Maryland","Queen Anne's County",1,55,904,467,437
050,24,035,"Maryland","Queen Anne's County",1,56,887,464,423
050,24,035,"Maryland","Queen Anne's County",1,57,862,446,416
050,24,035,"Maryland","Queen Anne's County",1,58,852,415,437
050,24,035,"Maryland","Queen Anne's County",1,59,796,397,399
050,24,035,"Maryland","Queen Anne's County",1,60,804,422,382
050,24,035,"Maryland","Queen Anne's County",1,61,822,409,413
050,24,035,"Maryland","Queen Anne's County",1,62,783,390,393
050,24,035,"Maryland","Queen Anne's County",1,63,759,382,377
050,24,035,"Maryland","Queen Anne's County",1,64,719,337,382
050,24,035,"Maryland","Queen Anne's County",1,65,671,333,338
050,24,035,"Maryland","Queen Anne's County",1,66,629,318,311
050,24,035,"Maryland","Queen Anne's County",1,67,600,299,301
050,24,035,"Maryland","Queen Anne's County",1,68,556,270,286
050,24,035,"Maryland","Queen Anne's County",1,69,540,270,270
050,24,035,"Maryland","Queen Anne's County",1,70,522,255,267
050,24,035,"Maryland","Queen Anne's County",1,71,531,265,266
050,24,035,"Maryland","Queen Anne's County",1,72,594,281,313
050,24,035,"Maryland","Queen Anne's County",1,73,612,287,325
050,24,035,"Maryland","Queen Anne's County",1,74,402,189,213
050,24,035,"Maryland","Queen Anne's County",1,75,437,198,239
050,24,035,"Maryland","Queen Anne's County",1,76,465,225,240
050,24,035,"Maryland","Queen Anne's County",1,77,434,193,241
050,24,035,"Maryland","Queen Anne's County",1,78,349,162,187
050,24,035,"Maryland","Queen Anne's County",1,79,300,146,154
050,24,035,"Maryland","Queen Anne's County",1,80,276,141,135
050,24,035,"Maryland","Queen Anne's County",1,81,234,116,118
050,24,035,"Maryland","Queen Anne's County",1,82,202,97,105
050,24,035,"Maryland","Queen Anne's County",1,83,172,74,98
050,24,035,"Maryland","Queen Anne's County",1,84,159,75,84
050,24,035,"Maryland","Queen Anne's County",1,85,879,364,515
050,24,035,"Maryland","Queen Anne's County",2,0,517,260,257
050,24,035,"Maryland","Queen Anne's County",2,1,508,261,247
050,24,035,"Maryland","Queen Anne's County",2,2,505,268,237
050,24,035,"Maryland","Queen Anne's County",2,3,522,276,246
050,24,035,"Maryland","Queen Anne's County",2,4,545,285,260
050,24,035,"Maryland","Queen Anne's County",2,5,520,267,253
050,24,035,"Maryland","Queen Anne's County",2,6,551,282,269
050,24,035,"Maryland","Queen Anne's County",2,7,551,282,269
050,24,035,"Maryland","Queen Anne's County",2,8,567,302,265
050,24,035,"Maryland","Queen Anne's County",2,9,609,329,280
050,24,035,"Maryland","Queen Anne's County",2,10,638,322,316
050,24,035,"Maryland","Queen Anne's County",2,11,669,328,341
050,24,035,"Maryland","Queen Anne's County",2,12,672,343,329
050,24,035,"Maryland","Queen Anne's County",2,13,680,346,334
050,24,035,"Maryland","Queen Anne's County",2,14,680,340,340
050,24,035,"Maryland","Queen Anne's County",2,15,675,333,342
050,24,035,"Maryland","Queen Anne's County",2,16,695,363,332
050,24,035,"Maryland","Queen Anne's County",2,17,699,364,335
050,24,035,"Maryland","Queen Anne's County",2,18,586,300,286
050,24,035,"Maryland","Queen Anne's County",2,19,475,246,229
050,24,035,"Maryland","Queen Anne's County",2,20,514,266,248
050,24,035,"Maryland","Queen Anne's County",2,21,507,259,248
050,24,035,"Maryland","Queen Anne's County",2,22,513,266,247
050,24,035,"Maryland","Queen Anne's County",2,23,524,280,244
050,24,035,"Maryland","Queen Anne's County",2,24,486,259,227
050,24,035,"Maryland","Queen Anne's County",2,25,490,269,221
050,24,035,"Maryland","Queen Anne's County",2,26,484,261,223
050,24,035,"Maryland","Queen Anne's County",2,27,496,253,243
050,24,035,"Maryland","Queen Anne's County",2,28,498,252,246
050,24,035,"Maryland","Queen Anne's County",2,29,524,265,259
050,24,035,"Maryland","Queen Anne's County",2,30,540,267,273
050,24,035,"Maryland","Queen Anne's County",2,31,525,241,284
050,24,035,"Maryland","Queen Anne's County",2,32,542,264,278
050,24,035,"Maryland","Queen Anne's County",2,33,544,269,275
050,24,035,"Maryland","Queen Anne's County",2,34,551,277,274
050,24,035,"Maryland","Queen Anne's County",2,35,586,299,287
050,24,035,"Maryland","Queen Anne's County",2,36,587,293,294
050,24,035,"Maryland","Queen Anne's County",2,37,614,292,322
050,24,035,"Maryland","Queen Anne's County",2,38,622,301,321
050,24,035,"Maryland","Queen Anne's County",2,39,588,277,311
050,24,035,"Maryland","Queen Anne's County",2,40,547,263,284
050,24,035,"Maryland","Queen Anne's County",2,41,543,270,273
050,24,035,"Maryland","Queen Anne's County",2,42,529,271,258
050,24,035,"Maryland","Queen Anne's County",2,43,517,257,260
050,24,035,"Maryland","Queen Anne's County",2,44,519,255,264
050,24,035,"Maryland","Queen Anne's County",2,45,570,281,289
050,24,035,"Maryland","Queen Anne's County",2,46,569,280,289
050,24,035,"Maryland","Queen Anne's County",2,47,593,301,292
050,24,035,"Maryland","Queen Anne's County",2,48,648,316,332
050,24,035,"Maryland","Queen Anne's County",2,49,729,346,383
050,24,035,"Maryland","Queen Anne's County",2,50,731,358,373
050,24,035,"Maryland","Queen Anne's County",2,51,724,362,362
050,24,035,"Maryland","Queen Anne's County",2,52,750,367,383
050,24,035,"Maryland","Queen Anne's County",2,53,789,390,399
050,24,035,"Maryland","Queen Anne's County",2,54,803,395,408
050,24,035,"Maryland","Queen Anne's County",2,55,881,452,429
050,24,035,"Maryland","Queen Anne's County",2,56,893,466,427
050,24,035,"Maryland","Queen Anne's County",2,57,872,453,419
050,24,035,"Maryland","Queen Anne's County",2,58,852,422,430
050,24,035,"Maryland","Queen Anne's County",2,59,816,405,411
050,24,035,"Maryland","Queen Anne's County",2,60,797,411,386
050,24,035,"Maryland","Queen Anne's County",2,61,815,408,407
050,24,035,"Maryland","Queen Anne's County",2,62,792,395,397
050,24,035,"Maryland","Queen Anne's County",2,63,774,390,384
050,24,035,"Maryland","Queen Anne's County",2,64,724,346,378
050,24,035,"Maryland","Queen Anne's County",2,65,684,334,350
050,24,035,"Maryland","Queen Anne's County",2,66,642,322,320
050,24,035,"Maryland","Queen Anne's County",2,67,608,305,303
050,24,035,"Maryland","Queen Anne's County",2,68,559,271,288
050,24,035,"Maryland","Queen Anne's County",2,69,542,270,272
050,24,035,"Maryland","Queen Anne's County",2,70,527,260,267
050,24,035,"Maryland","Queen Anne's County",2,71,534,264,270
050,24,035,"Maryland","Queen Anne's County",2,72,567,271,296
050,24,035,"Maryland","Queen Anne's County",2,73,636,301,335
050,24,035,"Maryland","Queen Anne's County",2,74,423,198,225
050,24,035,"Maryland","Queen Anne's County",2,75,429,197,232
050,24,035,"Maryland","Queen Anne's County",2,76,455,216,239
050,24,035,"Maryland","Queen Anne's County",2,77,453,208,245
050,24,035,"Maryland","Queen Anne's County",2,78,357,164,193
050,24,035,"Maryland","Queen Anne's County",2,79,309,147,162
050,24,035,"Maryland","Queen Anne's County",2,80,278,139,139
050,24,035,"Maryland","Queen Anne's County",2,81,238,120,118
050,24,035,"Maryland","Queen Anne's County",2,82,207,101,106
050,24,035,"Maryland","Queen Anne's County",2,83,176,78,98
050,24,035,"Maryland","Queen Anne's County",2,84,159,72,87
050,24,035,"Maryland","Queen Anne's County",2,85,874,361,513
050,24,035,"Maryland","Queen Anne's County",3,0,498,259,239
050,24,035,"Maryland","Queen Anne's County",3,1,553,283,270
050,24,035,"Maryland","Queen Anne's County",3,2,550,271,279
050,24,035,"Maryland","Queen Anne's County",3,3,529,280,249
050,24,035,"Maryland","Queen Anne's County",3,4,547,292,255
050,24,035,"Maryland","Queen Anne's County",3,5,576,295,281
050,24,035,"Maryland","Queen Anne's County",3,6,557,293,264
050,24,035,"Maryland","Queen Anne's County",3,7,553,283,270
050,24,035,"Maryland","Queen Anne's County",3,8,569,285,284
050,24,035,"Maryland","Queen Anne's County",3,9,580,308,272
050,24,035,"Maryland","Queen Anne's County",3,10,616,333,283
050,24,035,"Maryland","Queen Anne's County",3,11,640,325,315
050,24,035,"Maryland","Queen Anne's County",3,12,675,332,343
050,24,035,"Maryland","Queen Anne's County",3,13,666,344,322
050,24,035,"Maryland","Queen Anne's County",3,14,691,347,344
050,24,035,"Maryland","Queen Anne's County",3,15,689,347,342
050,24,035,"Maryland","Queen Anne's County",3,16,671,334,337
050,24,035,"Maryland","Queen Anne's County",3,17,706,367,339
050,24,035,"Maryland","Queen Anne's County",3,18,616,328,288
050,24,035,"Maryland","Queen Anne's County",3,19,472,240,232
050,24,035,"Maryland","Queen Anne's County",3,20,535,269,266
050,24,035,"Maryland","Queen Anne's County",3,21,520,270,250
050,24,035,"Maryland","Queen Anne's County",3,22,559,281,278
050,24,035,"Maryland","Queen Anne's County",3,23,538,285,253
050,24,035,"Maryland","Queen Anne's County",3,24,523,272,251
050,24,035,"Maryland","Queen Anne's County",3,25,445,248,197
050,24,035,"Maryland","Queen Anne's County",3,26,499,260,239
050,24,035,"Maryland","Queen Anne's County",3,27,495,276,219
050,24,035,"Maryland","Queen Anne's County",3,28,494,234,260
050,24,035,"Maryland","Queen Anne's County",3,29,507,255,252
050,24,035,"Maryland","Queen Anne's County",3,30,558,274,284
050,24,035,"Maryland","Queen Anne's County",3,31,558,285,273
050,24,035,"Maryland","Queen Anne's County",3,32,576,264,312
050,24,035,"Maryland","Queen Anne's County",3,33,579,278,301
050,24,035,"Maryland","Queen Anne's County",3,34,577,289,288
050,24,035,"Maryland","Queen Anne's County",3,35,580,290,290
050,24,035,"Maryland","Queen Anne's County",3,36,597,294,303
050,24,035,"Maryland","Queen Anne's County",3,37,611,312,299
050,24,035,"Maryland","Queen Anne's County",3,38,646,312,334
050,24,035,"Maryland","Queen Anne's County",3,39,637,309,328
050,24,035,"Maryland","Queen Anne's County",3,40,584,274,310
050,24,035,"Maryland","Queen Anne's County",3,41,566,274,292
050,24,035,"Maryland","Queen Anne's County",3,42,548,265,283
050,24,035,"Maryland","Queen Anne's County",3,43,545,285,260
050,24,035,"Maryland","Queen Anne's County",3,44,531,261,270
050,24,035,"Maryland","Queen Anne's County",3,45,536,271,265
050,24,035,"Maryland","Queen Anne's County",3,46,580,288,292
050,24,035,"Maryland","Queen Anne's County",3,47,566,278,288
050,24,035,"Maryland","Queen Anne's County",3,48,594,297,297
050,24,035,"Maryland","Queen Anne's County",3,49,665,330,335
050,24,035,"Maryland","Queen Anne's County",3,50,728,347,381
050,24,035,"Maryland","Queen Anne's County",3,51,731,353,378
050,24,035,"Maryland","Queen Anne's County",3,52,767,375,392
050,24,035,"Maryland","Queen Anne's County",3,53,764,370,394
050,24,035,"Maryland","Queen Anne's County",3,54,810,408,402
050,24,035,"Maryland","Queen Anne's County",3,55,818,398,420
050,24,035,"Maryland","Queen Anne's County",3,56,888,453,435
050,24,035,"Maryland","Queen Anne's County",3,57,910,466,444
050,24,035,"Maryland","Queen Anne's County",3,58,868,457,411
050,24,035,"Maryland","Queen Anne's County",3,59,856,432,424
050,24,035,"Maryland","Queen Anne's County",3,60,829,415,414
050,24,035,"Maryland","Queen Anne's County",3,61,806,405,401
050,24,035,"Maryland","Queen Anne's County",3,62,825,417,408
050,24,035,"Maryland","Queen Anne's County",3,63,783,393,390
050,24,035,"Maryland","Queen Anne's County",3,64,786,390,396
050,24,035,"Maryland","Queen Anne's County",3,65,735,348,387
050,24,035,"Maryland","Queen Anne's County",3,66,679,329,350
050,24,035,"Maryland","Queen Anne's County",3,67,638,318,320
050,24,035,"Maryland","Queen Anne's County",3,68,592,299,293
050,24,035,"Maryland","Queen Anne's County",3,69,556,278,278
050,24,035,"Maryland","Queen Anne's County",3,70,533,261,272
050,24,035,"Maryland","Queen Anne's County",3,71,517,256,261
050,24,035,"Maryland","Queen Anne's County",3,72,521,260,261
050,24,035,"Maryland","Queen Anne's County",3,73,548,260,288
050,24,035,"Maryland","Queen Anne's County",3,74,604,291,313
050,24,035,"Maryland","Queen Anne's County",3,75,415,193,222
050,24,035,"Maryland","Queen Anne's County",3,76,423,192,231
050,24,035,"Maryland","Queen Anne's County",3,77,440,212,228
050,24,035,"Maryland","Queen Anne's County",3,78,434,196,238
050,24,035,"Maryland","Queen Anne's County",3,79,338,152,186
050,24,035,"Maryland","Queen Anne's County",3,80,296,134,162
050,24,035,"Maryland","Queen Anne's County",3,81,270,133,137
050,24,035,"Maryland","Queen Anne's County",3,82,230,115,115
050,24,035,"Maryland","Queen Anne's County",3,83,192,100,92
050,24,035,"Maryland","Queen Anne's County",3,84,173,76,97
050,24,035,"Maryland","Queen Anne's County",3,85,916,391,525
050,24,035,"Maryland","Queen Anne's County",4,0,539,276,263
050,24,035,"Maryland","Queen Anne's County",4,1,499,263,236
050,24,035,"Maryland","Queen Anne's County",4,2,577,302,275
050,24,035,"Maryland","Queen Anne's County",4,3,558,267,291
050,24,035,"Maryland","Queen Anne's County",4,4,556,300,256
050,24,035,"Maryland","Queen Anne's County",4,5,566,307,259
050,24,035,"Maryland","Queen Anne's County",4,6,595,302,293
050,24,035,"Maryland","Queen Anne's County",4,7,544,288,256
050,24,035,"Maryland","Queen Anne's County",4,8,558,285,273
050,24,035,"Maryland","Queen Anne's County",4,9,578,294,284
050,24,035,"Maryland","Queen Anne's County",4,10,590,313,277
050,24,035,"Maryland","Queen Anne's County",4,11,645,343,302
050,24,035,"Maryland","Queen Anne's County",4,12,644,328,316
050,24,035,"Maryland","Queen Anne's County",4,13,673,330,343
050,24,035,"Maryland","Queen Anne's County",4,14,691,359,332
050,24,035,"Maryland","Queen Anne's County",4,15,687,350,337
050,24,035,"Maryland","Queen Anne's County",4,16,686,346,340
050,24,035,"Maryland","Queen Anne's County",4,17,686,342,344
050,24,035,"Maryland","Queen Anne's County",4,18,573,313,260
050,24,035,"Maryland","Queen Anne's County",4,19,481,253,228
050,24,035,"Maryland","Queen Anne's County",4,20,496,251,245
050,24,035,"Maryland","Queen Anne's County",4,21,547,269,278
050,24,035,"Maryland","Queen Anne's County",4,22,559,280,279
050,24,035,"Maryland","Queen Anne's County",4,23,559,294,265
050,24,035,"Maryland","Queen Anne's County",4,24,532,286,246
050,24,035,"Maryland","Queen Anne's County",4,25,517,275,242
050,24,035,"Maryland","Queen Anne's County",4,26,475,256,219
050,24,035,"Maryland","Queen Anne's County",4,27,521,270,251
050,24,035,"Maryland","Queen Anne's County",4,28,521,290,231
050,24,035,"Maryland","Queen Anne's County",4,29,517,249,268
050,24,035,"Maryland","Queen Anne's County",4,30,538,266,272
050,24,035,"Maryland","Queen Anne's County",4,31,579,267,312
050,24,035,"Maryland","Queen Anne's County",4,32,583,290,293
050,24,035,"Maryland","Queen Anne's County",4,33,593,285,308
050,24,035,"Maryland","Queen Anne's County",4,34,600,287,313
050,24,035,"Maryland","Queen Anne's County",4,35,582,297,285
050,24,035,"Maryland","Queen Anne's County",4,36,585,285,300
050,24,035,"Maryland","Queen Anne's County",4,37,622,294,328
050,24,035,"Maryland","Queen Anne's County",4,38,637,329,308
050,24,035,"Maryland","Queen Anne's County",4,39,667,325,342
050,24,035,"Maryland","Queen Anne's County",4,40,633,317,316
050,24,035,"Maryland","Queen Anne's County",4,41,605,281,324
050,24,035,"Maryland","Queen Anne's County",4,42,585,286,299
050,24,035,"Maryland","Queen Anne's County",4,43,553,269,284
050,24,035,"Maryland","Queen Anne's County",4,44,550,295,255
050,24,035,"Maryland","Queen Anne's County",4,45,557,271,286
050,24,035,"Maryland","Queen Anne's County",4,46,523,262,261
050,24,035,"Maryland","Queen Anne's County",4,47,589,297,292
050,24,035,"Maryland","Queen Anne's County",4,48,571,280,291
050,24,035,"Maryland","Queen Anne's County",4,49,585,296,289
050,24,035,"Maryland","Queen Anne's County",4,50,675,336,339
050,24,035,"Maryland","Queen Anne's County",4,51,742,347,395
050,24,035,"Maryland","Queen Anne's County",4,52,759,365,394
050,24,035,"Maryland","Queen Anne's County",4,53,765,374,391
050,24,035,"Maryland","Queen Anne's County",4,54,774,373,401
050,24,035,"Maryland","Queen Anne's County",4,55,821,410,411
050,24,035,"Maryland","Queen Anne's County",4,56,817,401,416
050,24,035,"Maryland","Queen Anne's County",4,57,921,464,457
050,24,035,"Maryland","Queen Anne's County",4,58,926,468,458
050,24,035,"Maryland","Queen Anne's County",4,59,893,471,422
050,24,035,"Maryland","Queen Anne's County",4,60,871,436,435
050,24,035,"Maryland","Queen Anne's County",4,61,838,412,426
050,24,035,"Maryland","Queen Anne's County",4,62,818,416,402
050,24,035,"Maryland","Queen Anne's County",4,63,837,420,417
050,24,035,"Maryland","Queen Anne's County",4,64,780,384,396
050,24,035,"Maryland","Queen Anne's County",4,65,798,392,406
050,24,035,"Maryland","Queen Anne's County",4,66,715,332,383
050,24,035,"Maryland","Queen Anne's County",4,67,691,330,361
050,24,035,"Maryland","Queen Anne's County",4,68,646,314,332
050,24,035,"Maryland","Queen Anne's County",4,69,581,289,292
050,24,035,"Maryland","Queen Anne's County",4,70,558,274,284
050,24,035,"Maryland","Queen Anne's County",4,71,546,271,275
050,24,035,"Maryland","Queen Anne's County",4,72,517,257,260
050,24,035,"Maryland","Queen Anne's County",4,73,518,261,257
050,24,035,"Maryland","Queen Anne's County",4,74,529,253,276
050,24,035,"Maryland","Queen Anne's County",4,75,594,277,317
050,24,035,"Maryland","Queen Anne's County",4,76,409,193,216
050,24,035,"Maryland","Queen Anne's County",4,77,402,186,216
050,24,035,"Maryland","Queen Anne's County",4,78,422,204,218
050,24,035,"Maryland","Queen Anne's County",4,79,415,191,224
050,24,035,"Maryland","Queen Anne's County",4,80,321,138,183
050,24,035,"Maryland","Queen Anne's County",4,81,294,132,162
050,24,035,"Maryland","Queen Anne's County",4,82,258,126,132
050,24,035,"Maryland","Queen Anne's County",4,83,211,107,104
050,24,035,"Maryland","Queen Anne's County",4,84,187,98,89
050,24,035,"Maryland","Queen Anne's County",4,85,964,418,546
050,24,035,"Maryland","Queen Anne's County",5,0,532,275,257
050,24,035,"Maryland","Queen Anne's County",5,1,579,305,274
050,24,035,"Maryland","Queen Anne's County",5,2,533,281,252
050,24,035,"Maryland","Queen Anne's County",5,3,577,302,275
050,24,035,"Maryland","Queen Anne's County",5,4,566,283,283
050,24,035,"Maryland","Queen Anne's County",5,5,584,310,274
050,24,035,"Maryland","Queen Anne's County",5,6,580,311,269
050,24,035,"Maryland","Queen Anne's County",5,7,596,297,299
050,24,035,"Maryland","Queen Anne's County",5,8,564,293,271
050,24,035,"Maryland","Queen Anne's County",5,9,578,292,286
050,24,035,"Maryland","Queen Anne's County",5,10,605,306,299
050,24,035,"Maryland","Queen Anne's County",5,11,587,313,274
050,24,035,"Maryland","Queen Anne's County",5,12,647,346,301
050,24,035,"Maryland","Queen Anne's County",5,13,640,328,312
050,24,035,"Maryland","Queen Anne's County",5,14,679,339,340
050,24,035,"Maryland","Queen Anne's County",5,15,690,357,333
050,24,035,"Maryland","Queen Anne's County",5,16,678,348,330
050,24,035,"Maryland","Queen Anne's County",5,17,691,352,339
050,24,035,"Maryland","Queen Anne's County",5,18,569,292,277
050,24,035,"Maryland","Queen Anne's County",5,19,457,258,199
050,24,035,"Maryland","Queen Anne's County",5,20,514,267,247
050,24,035,"Maryland","Queen Anne's County",5,21,523,260,263
050,24,035,"Maryland","Queen Anne's County",5,22,561,277,284
050,24,035,"Maryland","Queen Anne's County",5,23,541,279,262
050,24,035,"Maryland","Queen Anne's County",5,24,540,285,255
050,24,035,"Maryland","Queen Anne's County",5,25,527,286,241
050,24,035,"Maryland","Queen Anne's County",5,26,522,269,253
050,24,035,"Maryland","Queen Anne's County",5,27,484,249,235
050,24,035,"Maryland","Queen Anne's County",5,28,514,267,247
050,24,035,"Maryland","Queen Anne's County",5,29,529,284,245
050,24,035,"Maryland","Queen Anne's County",5,30,538,267,271
050,24,035,"Maryland","Queen Anne's County",5,31,550,263,287
050,24,035,"Maryland","Queen Anne's County",5,32,599,277,322
050,24,035,"Maryland","Queen Anne's County",5,33,619,316,303
050,24,035,"Maryland","Queen Anne's County",5,34,615,288,327
050,24,035,"Maryland","Queen Anne's County",5,35,626,311,315
050,24,035,"Maryland","Queen Anne's County",5,36,597,304,293
050,24,035,"Maryland","Queen Anne's County",5,37,615,300,315
050,24,035,"Maryland","Queen Anne's County",5,38,636,305,331
050,24,035,"Maryland","Queen Anne's County",5,39,656,337,319
050,24,035,"Maryland","Queen Anne's County",5,40,677,334,343
050,24,035,"Maryland","Queen Anne's County",5,41,642,311,331
050,24,035,"Maryland","Queen Anne's County",5,42,615,285,330
050,24,035,"Maryland","Queen Anne's County",5,43,594,286,308
050,24,035,"Maryland","Queen Anne's County",5,44,540,259,281
050,24,035,"Maryland","Queen Anne's County",5,45,556,306,250
050,24,035,"Maryland","Queen Anne's County",5,46,553,267,286
050,24,035,"Maryland","Queen Anne's County",5,47,544,275,269
050,24,035,"Maryland","Queen Anne's County",5,48,595,298,297
050,24,035,"Maryland","Queen Anne's County",5,49,578,288,290
050,24,035,"Maryland","Queen Anne's County",5,50,592,298,294
050,24,035,"Maryland","Queen Anne's County",5,51,664,329,335
050,24,035,"Maryland","Queen Anne's County",5,52,761,362,399
050,24,035,"Maryland","Queen Anne's County",5,53,779,379,400
050,24,035,"Maryland","Queen Anne's County",5,54,757,373,384
050,24,035,"Maryland","Queen Anne's County",5,55,777,366,411
050,24,035,"Maryland","Queen Anne's County",5,56,834,419,415
050,24,035,"Maryland","Queen Anne's County",5,57,832,410,422
050,24,035,"Maryland","Queen Anne's County",5,58,914,464,450
050,24,035,"Maryland","Queen Anne's County",5,59,919,462,457
050,24,035,"Maryland","Queen Anne's County",5,60,917,490,427
050,24,035,"Maryland","Queen Anne's County",5,61,891,442,449
050,24,035,"Maryland","Queen Anne's County",5,62,852,409,443
050,24,035,"Maryland","Queen Anne's County",5,63,845,427,418
050,24,035,"Maryland","Queen Anne's County",5,64,842,420,422
050,24,035,"Maryland","Queen Anne's County",5,65,787,393,394
050,24,035,"Maryland","Queen Anne's County",5,66,798,381,417
050,24,035,"Maryland","Queen Anne's County",5,67,739,337,402
050,24,035,"Maryland","Queen Anne's County",5,68,699,335,364
050,24,035,"Maryland","Queen Anne's County",5,69,653,320,333
050,24,035,"Maryland","Queen Anne's County",5,70,598,289,309
050,24,035,"Maryland","Queen Anne's County",5,71,563,277,286
050,24,035,"Maryland","Queen Anne's County",5,72,540,267,273
050,24,035,"Maryland","Queen Anne's County",5,73,510,251,259
050,24,035,"Maryland","Queen Anne's County",5,74,504,258,246
050,24,035,"Maryland","Queen Anne's County",5,75,515,242,273
050,24,035,"Maryland","Queen Anne's County",5,76,589,273,316
050,24,035,"Maryland","Queen Anne's County",5,77,406,189,217
050,24,035,"Maryland","Queen Anne's County",5,78,397,181,216
050,24,035,"Maryland","Queen Anne's County",5,79,409,194,215
050,24,035,"Maryland","Queen Anne's County",5,80,411,184,227
050,24,035,"Maryland","Queen Anne's County",5,81,309,132,177
050,24,035,"Maryland","Queen Anne's County",5,82,290,124,166
050,24,035,"Maryland","Queen Anne's County",5,83,237,123,114
050,24,035,"Maryland","Queen Anne's County",5,84,211,106,105
050,24,035,"Maryland","Queen Anne's County",5,85,1035,467,568
050,24,037,"Maryland","St. Mary's County",1,0,1322,674,648
050,24,037,"Maryland","St. Mary's County",1,1,1364,702,662
050,24,037,"Maryland","St. Mary's County",1,2,1377,712,665
050,24,037,"Maryland","St. Mary's County",1,3,1421,741,680
050,24,037,"Maryland","St. Mary's County",1,4,1535,782,753
050,24,037,"Maryland","St. Mary's County",1,5,1550,796,754
050,24,037,"Maryland","St. Mary's County",1,6,1485,746,739
050,24,037,"Maryland","St. Mary's County",1,7,1460,742,718
050,24,037,"Maryland","St. Mary's County",1,8,1513,775,738
050,24,037,"Maryland","St. Mary's County",1,9,1581,787,794
050,24,037,"Maryland","St. Mary's County",1,10,1575,803,772
050,24,037,"Maryland","St. Mary's County",1,11,1599,837,762
050,24,037,"Maryland","St. Mary's County",1,12,1701,895,806
050,24,037,"Maryland","St. Mary's County",1,13,1715,900,815
050,24,037,"Maryland","St. Mary's County",1,14,1643,850,793
050,24,037,"Maryland","St. Mary's County",1,15,1597,802,795
050,24,037,"Maryland","St. Mary's County",1,16,1551,774,777
050,24,037,"Maryland","St. Mary's County",1,17,1580,814,766
050,24,037,"Maryland","St. Mary's County",1,18,1512,759,753
050,24,037,"Maryland","St. Mary's County",1,19,1420,700,720
050,24,037,"Maryland","St. Mary's County",1,20,1459,733,726
050,24,037,"Maryland","St. Mary's County",1,21,1440,722,718
050,24,037,"Maryland","St. Mary's County",1,22,1373,695,678
050,24,037,"Maryland","St. Mary's County",1,23,1414,728,686
050,24,037,"Maryland","St. Mary's County",1,24,1472,783,689
050,24,037,"Maryland","St. Mary's County",1,25,1472,783,689
050,24,037,"Maryland","St. Mary's County",1,26,1548,818,730
050,24,037,"Maryland","St. Mary's County",1,27,1639,862,777
050,24,037,"Maryland","St. Mary's County",1,28,1582,824,758
050,24,037,"Maryland","St. Mary's County",1,29,1620,847,773
050,24,037,"Maryland","St. Mary's County",1,30,1650,839,811
050,24,037,"Maryland","St. Mary's County",1,31,1594,813,781
050,24,037,"Maryland","St. Mary's County",1,32,1673,841,832
050,24,037,"Maryland","St. Mary's County",1,33,1646,842,804
050,24,037,"Maryland","St. Mary's County",1,34,1631,823,808
050,24,037,"Maryland","St. Mary's County",1,35,1577,802,775
050,24,037,"Maryland","St. Mary's County",1,36,1569,789,780
050,24,037,"Maryland","St. Mary's County",1,37,1606,802,804
050,24,037,"Maryland","St. Mary's County",1,38,1601,813,788
050,24,037,"Maryland","St. Mary's County",1,39,1506,788,718
050,24,037,"Maryland","St. Mary's County",1,40,1458,723,735
050,24,037,"Maryland","St. Mary's County",1,41,1380,690,690
050,24,037,"Maryland","St. Mary's County",1,42,1379,702,677
050,24,037,"Maryland","St. Mary's County",1,43,1322,644,678
050,24,037,"Maryland","St. Mary's County",1,44,1305,642,663
050,24,037,"Maryland","St. Mary's County",1,45,1336,672,664
050,24,037,"Maryland","St. Mary's County",1,46,1305,655,650
050,24,037,"Maryland","St. Mary's County",1,47,1305,651,654
050,24,037,"Maryland","St. Mary's County",1,48,1462,711,751
050,24,037,"Maryland","St. Mary's County",1,49,1536,752,784
050,24,037,"Maryland","St. Mary's County",1,50,1508,756,752
050,24,037,"Maryland","St. Mary's County",1,51,1522,745,777
050,24,037,"Maryland","St. Mary's County",1,52,1593,775,818
050,24,037,"Maryland","St. Mary's County",1,53,1613,810,803
050,24,037,"Maryland","St. Mary's County",1,54,1662,822,840
050,24,037,"Maryland","St. Mary's County",1,55,1726,861,865
050,24,037,"Maryland","St. Mary's County",1,56,1765,910,855
050,24,037,"Maryland","St. Mary's County",1,57,1698,888,810
050,24,037,"Maryland","St. Mary's County",1,58,1661,835,826
050,24,037,"Maryland","St. Mary's County",1,59,1599,808,791
050,24,037,"Maryland","St. Mary's County",1,60,1507,779,728
050,24,037,"Maryland","St. Mary's County",1,61,1523,797,726
050,24,037,"Maryland","St. Mary's County",1,62,1415,730,685
050,24,037,"Maryland","St. Mary's County",1,63,1276,633,643
050,24,037,"Maryland","St. Mary's County",1,64,1222,612,610
050,24,037,"Maryland","St. Mary's County",1,65,1120,549,571
050,24,037,"Maryland","St. Mary's County",1,66,1050,525,525
050,24,037,"Maryland","St. Mary's County",1,67,1053,516,537
050,24,037,"Maryland","St. Mary's County",1,68,1013,480,533
050,24,037,"Maryland","St. Mary's County",1,69,900,425,475
050,24,037,"Maryland","St. Mary's County",1,70,829,398,431
050,24,037,"Maryland","St. Mary's County",1,71,842,389,453
050,24,037,"Maryland","St. Mary's County",1,72,875,409,466
050,24,037,"Maryland","St. Mary's County",1,73,860,420,440
050,24,037,"Maryland","St. Mary's County",1,74,608,298,310
050,24,037,"Maryland","St. Mary's County",1,75,588,264,324
050,24,037,"Maryland","St. Mary's County",1,76,592,286,306
050,24,037,"Maryland","St. Mary's County",1,77,580,279,301
050,24,037,"Maryland","St. Mary's County",1,78,503,244,259
050,24,037,"Maryland","St. Mary's County",1,79,436,209,227
050,24,037,"Maryland","St. Mary's County",1,80,405,194,211
050,24,037,"Maryland","St. Mary's County",1,81,385,173,212
050,24,037,"Maryland","St. Mary's County",1,82,362,164,198
050,24,037,"Maryland","St. Mary's County",1,83,311,154,157
050,24,037,"Maryland","St. Mary's County",1,84,284,127,157
050,24,037,"Maryland","St. Mary's County",1,85,1530,639,891
050,24,037,"Maryland","St. Mary's County",2,0,1327,674,653
050,24,037,"Maryland","St. Mary's County",2,1,1351,695,656
050,24,037,"Maryland","St. Mary's County",2,2,1375,716,659
050,24,037,"Maryland","St. Mary's County",2,3,1416,741,675
050,24,037,"Maryland","St. Mary's County",2,4,1515,777,738
050,24,037,"Maryland","St. Mary's County",2,5,1552,793,759
050,24,037,"Maryland","St. Mary's County",2,6,1505,762,743
050,24,037,"Maryland","St. Mary's County",2,7,1471,750,721
050,24,037,"Maryland","St. Mary's County",2,8,1502,769,733
050,24,037,"Maryland","St. Mary's County",2,9,1561,784,777
050,24,037,"Maryland","St. Mary's County",2,10,1577,800,777
050,24,037,"Maryland","St. Mary's County",2,11,1592,829,763
050,24,037,"Maryland","St. Mary's County",2,12,1683,886,797
050,24,037,"Maryland","St. Mary's County",2,13,1708,898,810
050,24,037,"Maryland","St. Mary's County",2,14,1661,863,798
050,24,037,"Maryland","St. Mary's County",2,15,1607,812,795
050,24,037,"Maryland","St. Mary's County",2,16,1566,783,783
050,24,037,"Maryland","St. Mary's County",2,17,1573,804,769
050,24,037,"Maryland","St. Mary's County",2,18,1506,762,744
050,24,037,"Maryland","St. Mary's County",2,19,1419,699,720
050,24,037,"Maryland","St. Mary's County",2,20,1476,736,740
050,24,037,"Maryland","St. Mary's County",2,21,1454,728,726
050,24,037,"Maryland","St. Mary's County",2,22,1384,703,681
050,24,037,"Maryland","St. Mary's County",2,23,1427,738,689
050,24,037,"Maryland","St. Mary's County",2,24,1478,782,696
050,24,037,"Maryland","St. Mary's County",2,25,1490,794,696
050,24,037,"Maryland","St. Mary's County",2,26,1547,817,730
050,24,037,"Maryland","St. Mary's County",2,27,1617,853,764
050,24,037,"Maryland","St. Mary's County",2,28,1607,840,767
050,24,037,"Maryland","St. Mary's County",2,29,1622,847,775
050,24,037,"Maryland","St. Mary's County",2,30,1651,844,807
050,24,037,"Maryland","St. Mary's County",2,31,1612,820,792
050,24,037,"Maryland","St. Mary's County",2,32,1655,835,820
050,24,037,"Maryland","St. Mary's County",2,33,1660,843,817
050,24,037,"Maryland","St. Mary's County",2,34,1641,829,812
050,24,037,"Maryland","St. Mary's County",2,35,1604,815,789
050,24,037,"Maryland","St. Mary's County",2,36,1568,790,778
050,24,037,"Maryland","St. Mary's County",2,37,1607,802,805
050,24,037,"Maryland","St. Mary's County",2,38,1615,819,796
050,24,037,"Maryland","St. Mary's County",2,39,1527,793,734
050,24,037,"Maryland","St. Mary's County",2,40,1483,746,737
050,24,037,"Maryland","St. Mary's County",2,41,1398,698,700
050,24,037,"Maryland","St. Mary's County",2,42,1377,698,679
050,24,037,"Maryland","St. Mary's County",2,43,1352,668,684
050,24,037,"Maryland","St. Mary's County",2,44,1300,639,661
050,24,037,"Maryland","St. Mary's County",2,45,1335,666,669
050,24,037,"Maryland","St. Mary's County",2,46,1301,653,648
050,24,037,"Maryland","St. Mary's County",2,47,1302,649,653
050,24,037,"Maryland","St. Mary's County",2,48,1421,693,728
050,24,037,"Maryland","St. Mary's County",2,49,1524,743,781
050,24,037,"Maryland","St. Mary's County",2,50,1515,756,759
050,24,037,"Maryland","St. Mary's County",2,51,1508,744,764
050,24,037,"Maryland","St. Mary's County",2,52,1562,760,802
050,24,037,"Maryland","St. Mary's County",2,53,1609,799,810
050,24,037,"Maryland","St. Mary's County",2,54,1645,816,829
050,24,037,"Maryland","St. Mary's County",2,55,1709,849,860
050,24,037,"Maryland","St. Mary's County",2,56,1759,901,858
050,24,037,"Maryland","St. Mary's County",2,57,1702,884,818
050,24,037,"Maryland","St. Mary's County",2,58,1663,845,818
050,24,037,"Maryland","St. Mary's County",2,59,1614,814,800
050,24,037,"Maryland","St. Mary's County",2,60,1524,784,740
050,24,037,"Maryland","St. Mary's County",2,61,1508,789,719
050,24,037,"Maryland","St. Mary's County",2,62,1436,743,693
050,24,037,"Maryland","St. Mary's County",2,63,1320,662,658
050,24,037,"Maryland","St. Mary's County",2,64,1219,608,611
050,24,037,"Maryland","St. Mary's County",2,65,1133,558,575
050,24,037,"Maryland","St. Mary's County",2,66,1062,528,534
050,24,037,"Maryland","St. Mary's County",2,67,1044,514,530
050,24,037,"Maryland","St. Mary's County",2,68,1011,483,528
050,24,037,"Maryland","St. Mary's County",2,69,927,436,491
050,24,037,"Maryland","St. Mary's County",2,70,836,400,436
050,24,037,"Maryland","St. Mary's County",2,71,834,391,443
050,24,037,"Maryland","St. Mary's County",2,72,854,399,455
050,24,037,"Maryland","St. Mary's County",2,73,897,433,464
050,24,037,"Maryland","St. Mary's County",2,74,629,310,319
050,24,037,"Maryland","St. Mary's County",2,75,586,267,319
050,24,037,"Maryland","St. Mary's County",2,76,576,271,305
050,24,037,"Maryland","St. Mary's County",2,77,591,280,311
050,24,037,"Maryland","St. Mary's County",2,78,500,245,255
050,24,037,"Maryland","St. Mary's County",2,79,443,213,230
050,24,037,"Maryland","St. Mary's County",2,80,410,198,212
050,24,037,"Maryland","St. Mary's County",2,81,382,175,207
050,24,037,"Maryland","St. Mary's County",2,82,361,164,197
050,24,037,"Maryland","St. Mary's County",2,83,312,153,159
050,24,037,"Maryland","St. Mary's County",2,84,283,130,153
050,24,037,"Maryland","St. Mary's County",2,85,1533,631,902
050,24,037,"Maryland","St. Mary's County",3,0,1367,697,670
050,24,037,"Maryland","St. Mary's County",3,1,1327,649,678
050,24,037,"Maryland","St. Mary's County",3,2,1363,697,666
050,24,037,"Maryland","St. Mary's County",3,3,1421,737,684
050,24,037,"Maryland","St. Mary's County",3,4,1425,747,678
050,24,037,"Maryland","St. Mary's County",3,5,1513,765,748
050,24,037,"Maryland","St. Mary's County",3,6,1551,795,756
050,24,037,"Maryland","St. Mary's County",3,7,1539,778,761
050,24,037,"Maryland","St. Mary's County",3,8,1492,747,745
050,24,037,"Maryland","St. Mary's County",3,9,1493,769,724
050,24,037,"Maryland","St. Mary's County",3,10,1567,802,765
050,24,037,"Maryland","St. Mary's County",3,11,1570,787,783
050,24,037,"Maryland","St. Mary's County",3,12,1598,828,770
050,24,037,"Maryland","St. Mary's County",3,13,1701,889,812
050,24,037,"Maryland","St. Mary's County",3,14,1698,893,805
050,24,037,"Maryland","St. Mary's County",3,15,1656,862,794
050,24,037,"Maryland","St. Mary's County",3,16,1605,818,787
050,24,037,"Maryland","St. Mary's County",3,17,1582,790,792
050,24,037,"Maryland","St. Mary's County",3,18,1518,786,732
050,24,037,"Maryland","St. Mary's County",3,19,1388,685,703
050,24,037,"Maryland","St. Mary's County",3,20,1499,746,753
050,24,037,"Maryland","St. Mary's County",3,21,1476,738,738
050,24,037,"Maryland","St. Mary's County",3,22,1374,691,683
050,24,037,"Maryland","St. Mary's County",3,23,1432,737,695
050,24,037,"Maryland","St. Mary's County",3,24,1501,772,729
050,24,037,"Maryland","St. Mary's County",3,25,1562,831,731
050,24,037,"Maryland","St. Mary's County",3,26,1552,831,721
050,24,037,"Maryland","St. Mary's County",3,27,1574,821,753
050,24,037,"Maryland","St. Mary's County",3,28,1616,840,776
050,24,037,"Maryland","St. Mary's County",3,29,1639,848,791
050,24,037,"Maryland","St. Mary's County",3,30,1665,868,797
050,24,037,"Maryland","St. Mary's County",3,31,1683,861,822
050,24,037,"Maryland","St. Mary's County",3,32,1639,853,786
050,24,037,"Maryland","St. Mary's County",3,33,1648,830,818
050,24,037,"Maryland","St. Mary's County",3,34,1712,873,839
050,24,037,"Maryland","St. Mary's County",3,35,1632,819,813
050,24,037,"Maryland","St. Mary's County",3,36,1587,805,782
050,24,037,"Maryland","St. Mary's County",3,37,1587,808,779
050,24,037,"Maryland","St. Mary's County",3,38,1611,793,818
050,24,037,"Maryland","St. Mary's County",3,39,1624,801,823
050,24,037,"Maryland","St. Mary's County",3,40,1537,812,725
050,24,037,"Maryland","St. Mary's County",3,41,1466,751,715
050,24,037,"Maryland","St. Mary's County",3,42,1396,688,708
050,24,037,"Maryland","St. Mary's County",3,43,1376,685,691
050,24,037,"Maryland","St. Mary's County",3,44,1355,662,693
050,24,037,"Maryland","St. Mary's County",3,45,1291,640,651
050,24,037,"Maryland","St. Mary's County",3,46,1333,681,652
050,24,037,"Maryland","St. Mary's County",3,47,1302,645,657
050,24,037,"Maryland","St. Mary's County",3,48,1303,646,657
050,24,037,"Maryland","St. Mary's County",3,49,1407,684,723
050,24,037,"Maryland","St. Mary's County",3,50,1498,738,760
050,24,037,"Maryland","St. Mary's County",3,51,1507,742,765
050,24,037,"Maryland","St. Mary's County",3,52,1504,724,780
050,24,037,"Maryland","St. Mary's County",3,53,1569,767,802
050,24,037,"Maryland","St. Mary's County",3,54,1595,791,804
050,24,037,"Maryland","St. Mary's County",3,55,1647,825,822
050,24,037,"Maryland","St. Mary's County",3,56,1669,830,839
050,24,037,"Maryland","St. Mary's County",3,57,1738,888,850
050,24,037,"Maryland","St. Mary's County",3,58,1674,871,803
050,24,037,"Maryland","St. Mary's County",3,59,1616,813,803
050,24,037,"Maryland","St. Mary's County",3,60,1570,789,781
050,24,037,"Maryland","St. Mary's County",3,61,1492,767,725
050,24,037,"Maryland","St. Mary's County",3,62,1434,758,676
050,24,037,"Maryland","St. Mary's County",3,63,1408,729,679
050,24,037,"Maryland","St. Mary's County",3,64,1292,645,647
050,24,037,"Maryland","St. Mary's County",3,65,1200,587,613
050,24,037,"Maryland","St. Mary's County",3,66,1112,550,562
050,24,037,"Maryland","St. Mary's County",3,67,1056,521,535
050,24,037,"Maryland","St. Mary's County",3,68,1012,498,514
050,24,037,"Maryland","St. Mary's County",3,69,962,455,507
050,24,037,"Maryland","St. Mary's County",3,70,904,425,479
050,24,037,"Maryland","St. Mary's County",3,71,810,380,430
050,24,037,"Maryland","St. Mary's County",3,72,801,375,426
050,24,037,"Maryland","St. Mary's County",3,73,816,370,446
050,24,037,"Maryland","St. Mary's County",3,74,877,420,457
050,24,037,"Maryland","St. Mary's County",3,75,598,288,310
050,24,037,"Maryland","St. Mary's County",3,76,571,266,305
050,24,037,"Maryland","St. Mary's County",3,77,576,265,311
050,24,037,"Maryland","St. Mary's County",3,78,546,262,284
050,24,037,"Maryland","St. Mary's County",3,79,473,224,249
050,24,037,"Maryland","St. Mary's County",3,80,427,216,211
050,24,037,"Maryland","St. Mary's County",3,81,393,179,214
050,24,037,"Maryland","St. Mary's County",3,82,366,164,202
050,24,037,"Maryland","St. Mary's County",3,83,348,167,181
050,24,037,"Maryland","St. Mary's County",3,84,282,133,149
050,24,037,"Maryland","St. Mary's County",3,85,1554,651,903
050,24,037,"Maryland","St. Mary's County",4,0,1413,707,706
050,24,037,"Maryland","St. Mary's County",4,1,1354,682,672
050,24,037,"Maryland","St. Mary's County",4,2,1371,672,699
050,24,037,"Maryland","St. Mary's County",4,3,1400,728,672
050,24,037,"Maryland","St. Mary's County",4,4,1392,732,660
050,24,037,"Maryland","St. Mary's County",4,5,1425,736,689
050,24,037,"Maryland","St. Mary's County",4,6,1518,770,748
050,24,037,"Maryland","St. Mary's County",4,7,1589,829,760
050,24,037,"Maryland","St. Mary's County",4,8,1551,783,768
050,24,037,"Maryland","St. Mary's County",4,9,1528,758,770
050,24,037,"Maryland","St. Mary's County",4,10,1514,787,727
050,24,037,"Maryland","St. Mary's County",4,11,1598,821,777
050,24,037,"Maryland","St. Mary's County",4,12,1602,816,786
050,24,037,"Maryland","St. Mary's County",4,13,1629,840,789
050,24,037,"Maryland","St. Mary's County",4,14,1699,882,817
050,24,037,"Maryland","St. Mary's County",4,15,1697,897,800
050,24,037,"Maryland","St. Mary's County",4,16,1653,846,807
050,24,037,"Maryland","St. Mary's County",4,17,1628,832,796
050,24,037,"Maryland","St. Mary's County",4,18,1492,751,741
050,24,037,"Maryland","St. Mary's County",4,19,1381,709,672
050,24,037,"Maryland","St. Mary's County",4,20,1415,707,708
050,24,037,"Maryland","St. Mary's County",4,21,1512,749,763
050,24,037,"Maryland","St. Mary's County",4,22,1367,692,675
050,24,037,"Maryland","St. Mary's County",4,23,1355,695,660
050,24,037,"Maryland","St. Mary's County",4,24,1471,787,684
050,24,037,"Maryland","St. Mary's County",4,25,1513,792,721
050,24,037,"Maryland","St. Mary's County",4,26,1523,805,718
050,24,037,"Maryland","St. Mary's County",4,27,1537,824,713
050,24,037,"Maryland","St. Mary's County",4,28,1543,811,732
050,24,037,"Maryland","St. Mary's County",4,29,1575,817,758
050,24,037,"Maryland","St. Mary's County",4,30,1631,828,803
050,24,037,"Maryland","St. Mary's County",4,31,1643,853,790
050,24,037,"Maryland","St. Mary's County",4,32,1722,892,830
050,24,037,"Maryland","St. Mary's County",4,33,1646,855,791
050,24,037,"Maryland","St. Mary's County",4,34,1636,830,806
050,24,037,"Maryland","St. Mary's County",4,35,1753,896,857
050,24,037,"Maryland","St. Mary's County",4,36,1641,810,831
050,24,037,"Maryland","St. Mary's County",4,37,1592,791,801
050,24,037,"Maryland","St. Mary's County",4,38,1610,820,790
050,24,037,"Maryland","St. Mary's County",4,39,1619,785,834
050,24,037,"Maryland","St. Mary's County",4,40,1618,806,812
050,24,037,"Maryland","St. Mary's County",4,41,1555,807,748
050,24,037,"Maryland","St. Mary's County",4,42,1493,771,722
050,24,037,"Maryland","St. Mary's County",4,43,1419,694,725
050,24,037,"Maryland","St. Mary's County",4,44,1385,693,692
050,24,037,"Maryland","St. Mary's County",4,45,1329,651,678
050,24,037,"Maryland","St. Mary's County",4,46,1307,660,647
050,24,037,"Maryland","St. Mary's County",4,47,1319,667,652
050,24,037,"Maryland","St. Mary's County",4,48,1260,620,640
050,24,037,"Maryland","St. Mary's County",4,49,1297,643,654
050,24,037,"Maryland","St. Mary's County",4,50,1401,679,722
050,24,037,"Maryland","St. Mary's County",4,51,1494,731,763
050,24,037,"Maryland","St. Mary's County",4,52,1494,733,761
050,24,037,"Maryland","St. Mary's County",4,53,1476,707,769
050,24,037,"Maryland","St. Mary's County",4,54,1539,760,779
050,24,037,"Maryland","St. Mary's County",4,55,1561,771,790
050,24,037,"Maryland","St. Mary's County",4,56,1600,816,784
050,24,037,"Maryland","St. Mary's County",4,57,1635,827,808
050,24,037,"Maryland","St. Mary's County",4,58,1725,880,845
050,24,037,"Maryland","St. Mary's County",4,59,1636,846,790
050,24,037,"Maryland","St. Mary's County",4,60,1567,784,783
050,24,037,"Maryland","St. Mary's County",4,61,1545,783,762
050,24,037,"Maryland","St. Mary's County",4,62,1424,721,703
050,24,037,"Maryland","St. Mary's County",4,63,1404,737,667
050,24,037,"Maryland","St. Mary's County",4,64,1365,705,660
050,24,037,"Maryland","St. Mary's County",4,65,1262,622,640
050,24,037,"Maryland","St. Mary's County",4,66,1165,567,598
050,24,037,"Maryland","St. Mary's County",4,67,1078,530,548
050,24,037,"Maryland","St. Mary's County",4,68,1044,513,531
050,24,037,"Maryland","St. Mary's County",4,69,986,476,510
050,24,037,"Maryland","St. Mary's County",4,70,939,448,491
050,24,037,"Maryland","St. Mary's County",4,71,874,401,473
050,24,037,"Maryland","St. Mary's County",4,72,794,376,418
050,24,037,"Maryland","St. Mary's County",4,73,775,359,416
050,24,037,"Maryland","St. Mary's County",4,74,791,361,430
050,24,037,"Maryland","St. Mary's County",4,75,836,387,449
050,24,037,"Maryland","St. Mary's County",4,76,569,276,293
050,24,037,"Maryland","St. Mary's County",4,77,561,257,304
050,24,037,"Maryland","St. Mary's County",4,78,536,247,289
050,24,037,"Maryland","St. Mary's County",4,79,509,236,273
050,24,037,"Maryland","St. Mary's County",4,80,457,219,238
050,24,037,"Maryland","St. Mary's County",4,81,410,199,211
050,24,037,"Maryland","St. Mary's County",4,82,379,177,202
050,24,037,"Maryland","St. Mary's County",4,83,350,164,186
050,24,037,"Maryland","St. Mary's County",4,84,310,146,164
050,24,037,"Maryland","St. Mary's County",4,85,1572,672,900
050,24,037,"Maryland","St. Mary's County",5,0,1394,694,700
050,24,037,"Maryland","St. Mary's County",5,1,1437,718,719
050,24,037,"Maryland","St. Mary's County",5,2,1385,711,674
050,24,037,"Maryland","St. Mary's County",5,3,1419,702,717
050,24,037,"Maryland","St. Mary's County",5,4,1399,738,661
050,24,037,"Maryland","St. Mary's County",5,5,1408,728,680
050,24,037,"Maryland","St. Mary's County",5,6,1442,748,694
050,24,037,"Maryland","St. Mary's County",5,7,1550,793,757
050,24,037,"Maryland","St. Mary's County",5,8,1608,832,776
050,24,037,"Maryland","St. Mary's County",5,9,1544,775,769
050,24,037,"Maryland","St. Mary's County",5,10,1536,763,773
050,24,037,"Maryland","St. Mary's County",5,11,1536,803,733
050,24,037,"Maryland","St. Mary's County",5,12,1609,827,782
050,24,037,"Maryland","St. Mary's County",5,13,1579,800,779
050,24,037,"Maryland","St. Mary's County",5,14,1657,862,795
050,24,037,"Maryland","St. Mary's County",5,15,1696,883,813
050,24,037,"Maryland","St. Mary's County",5,16,1688,883,805
050,24,037,"Maryland","St. Mary's County",5,17,1642,846,796
050,24,037,"Maryland","St. Mary's County",5,18,1555,808,747
050,24,037,"Maryland","St. Mary's County",5,19,1384,684,700
050,24,037,"Maryland","St. Mary's County",5,20,1450,742,708
050,24,037,"Maryland","St. Mary's County",5,21,1438,723,715
050,24,037,"Maryland","St. Mary's County",5,22,1412,721,691
050,24,037,"Maryland","St. Mary's County",5,23,1382,705,677
050,24,037,"Maryland","St. Mary's County",5,24,1380,727,653
050,24,037,"Maryland","St. Mary's County",5,25,1498,803,695
050,24,037,"Maryland","St. Mary's County",5,26,1532,802,730
050,24,037,"Maryland","St. Mary's County",5,27,1487,787,700
050,24,037,"Maryland","St. Mary's County",5,28,1542,810,732
050,24,037,"Maryland","St. Mary's County",5,29,1496,785,711
050,24,037,"Maryland","St. Mary's County",5,30,1596,810,786
050,24,037,"Maryland","St. Mary's County",5,31,1675,833,842
050,24,037,"Maryland","St. Mary's County",5,32,1648,876,772
050,24,037,"Maryland","St. Mary's County",5,33,1694,871,823
050,24,037,"Maryland","St. Mary's County",5,34,1683,861,822
050,24,037,"Maryland","St. Mary's County",5,35,1630,824,806
050,24,037,"Maryland","St. Mary's County",5,36,1759,892,867
050,24,037,"Maryland","St. Mary's County",5,37,1669,837,832
050,24,037,"Maryland","St. Mary's County",5,38,1596,782,814
050,24,037,"Maryland","St. Mary's County",5,39,1643,848,795
050,24,037,"Maryland","St. Mary's County",5,40,1604,780,824
050,24,037,"Maryland","St. Mary's County",5,41,1613,786,827
050,24,037,"Maryland","St. Mary's County",5,42,1583,813,770
050,24,037,"Maryland","St. Mary's County",5,43,1470,756,714
050,24,037,"Maryland","St. Mary's County",5,44,1386,673,713
050,24,037,"Maryland","St. Mary's County",5,45,1397,697,700
050,24,037,"Maryland","St. Mary's County",5,46,1330,654,676
050,24,037,"Maryland","St. Mary's County",5,47,1306,649,657
050,24,037,"Maryland","St. Mary's County",5,48,1296,654,642
050,24,037,"Maryland","St. Mary's County",5,49,1244,618,626
050,24,037,"Maryland","St. Mary's County",5,50,1269,635,634
050,24,037,"Maryland","St. Mary's County",5,51,1383,667,716
050,24,037,"Maryland","St. Mary's County",5,52,1482,735,747
050,24,037,"Maryland","St. Mary's County",5,53,1487,726,761
050,24,037,"Maryland","St. Mary's County",5,54,1453,697,756
050,24,037,"Maryland","St. Mary's County",5,55,1513,742,771
050,24,037,"Maryland","St. Mary's County",5,56,1532,756,776
050,24,037,"Maryland","St. Mary's County",5,57,1565,790,775
050,24,037,"Maryland","St. Mary's County",5,58,1600,818,782
050,24,037,"Maryland","St. Mary's County",5,59,1704,865,839
050,24,037,"Maryland","St. Mary's County",5,60,1606,815,791
050,24,037,"Maryland","St. Mary's County",5,61,1575,793,782
050,24,037,"Maryland","St. Mary's County",5,62,1499,761,738
050,24,037,"Maryland","St. Mary's County",5,63,1407,705,702
050,24,037,"Maryland","St. Mary's County",5,64,1395,729,666
050,24,037,"Maryland","St. Mary's County",5,65,1355,683,672
050,24,037,"Maryland","St. Mary's County",5,66,1235,604,631
050,24,037,"Maryland","St. Mary's County",5,67,1162,568,594
050,24,037,"Maryland","St. Mary's County",5,68,1049,514,535
050,24,037,"Maryland","St. Mary's County",5,69,1027,497,530
050,24,037,"Maryland","St. Mary's County",5,70,981,469,512
050,24,037,"Maryland","St. Mary's County",5,71,915,430,485
050,24,037,"Maryland","St. Mary's County",5,72,853,395,458
050,24,037,"Maryland","St. Mary's County",5,73,776,365,411
050,24,037,"Maryland","St. Mary's County",5,74,742,343,399
050,24,037,"Maryland","St. Mary's County",5,75,755,330,425
050,24,037,"Maryland","St. Mary's County",5,76,814,381,433
050,24,037,"Maryland","St. Mary's County",5,77,577,276,301
050,24,037,"Maryland","St. Mary's County",5,78,524,239,285
050,24,037,"Maryland","St. Mary's County",5,79,506,226,280
050,24,037,"Maryland","St. Mary's County",5,80,487,233,254
050,24,037,"Maryland","St. Mary's County",5,81,439,206,233
050,24,037,"Maryland","St. Mary's County",5,82,395,193,202
050,24,037,"Maryland","St. Mary's County",5,83,365,177,188
050,24,037,"Maryland","St. Mary's County",5,84,311,146,165
050,24,037,"Maryland","St. Mary's County",5,85,1636,719,917
050,24,039,"Maryland","Somerset County",1,0,209,108,101
050,24,039,"Maryland","Somerset County",1,1,217,122,95
050,24,039,"Maryland","Somerset County",1,2,234,110,124
050,24,039,"Maryland","Somerset County",1,3,228,118,110
050,24,039,"Maryland","Somerset County",1,4,233,110,123
050,24,039,"Maryland","Somerset County",1,5,256,138,118
050,24,039,"Maryland","Somerset County",1,6,272,144,128
050,24,039,"Maryland","Somerset County",1,7,243,121,122
050,24,039,"Maryland","Somerset County",1,8,237,120,117
050,24,039,"Maryland","Somerset County",1,9,258,121,137
050,24,039,"Maryland","Somerset County",1,10,243,126,117
050,24,039,"Maryland","Somerset County",1,11,245,130,115
050,24,039,"Maryland","Somerset County",1,12,228,109,119
050,24,039,"Maryland","Somerset County",1,13,242,120,122
050,24,039,"Maryland","Somerset County",1,14,229,122,107
050,24,039,"Maryland","Somerset County",1,15,228,119,109
050,24,039,"Maryland","Somerset County",1,16,240,121,119
050,24,039,"Maryland","Somerset County",1,17,240,120,120
050,24,039,"Maryland","Somerset County",1,18,436,237,199
050,24,039,"Maryland","Somerset County",1,19,624,280,344
050,24,039,"Maryland","Somerset County",1,20,661,318,343
050,24,039,"Maryland","Somerset County",1,21,672,371,301
050,24,039,"Maryland","Somerset County",1,22,490,296,194
050,24,039,"Maryland","Somerset County",1,23,456,297,159
050,24,039,"Maryland","Somerset County",1,24,403,245,158
050,24,039,"Maryland","Somerset County",1,25,357,219,138
050,24,039,"Maryland","Somerset County",1,26,330,223,107
050,24,039,"Maryland","Somerset County",1,27,329,212,117
050,24,039,"Maryland","Somerset County",1,28,338,217,121
050,24,039,"Maryland","Somerset County",1,29,339,203,136
050,24,039,"Maryland","Somerset County",1,30,347,218,129
050,24,039,"Maryland","Somerset County",1,31,298,193,105
050,24,039,"Maryland","Somerset County",1,32,322,210,112
050,24,039,"Maryland","Somerset County",1,33,278,183,95
050,24,039,"Maryland","Somerset County",1,34,279,167,112
050,24,039,"Maryland","Somerset County",1,35,313,196,117
050,24,039,"Maryland","Somerset County",1,36,293,190,103
050,24,039,"Maryland","Somerset County",1,37,319,197,122
050,24,039,"Maryland","Somerset County",1,38,294,176,118
050,24,039,"Maryland","Somerset County",1,39,327,213,114
050,24,039,"Maryland","Somerset County",1,40,300,185,115
050,24,039,"Maryland","Somerset County",1,41,279,174,105
050,24,039,"Maryland","Somerset County",1,42,302,185,117
050,24,039,"Maryland","Somerset County",1,43,262,167,95
050,24,039,"Maryland","Somerset County",1,44,286,184,102
050,24,039,"Maryland","Somerset County",1,45,279,168,111
050,24,039,"Maryland","Somerset County",1,46,255,147,108
050,24,039,"Maryland","Somerset County",1,47,257,157,100
050,24,039,"Maryland","Somerset County",1,48,311,189,122
050,24,039,"Maryland","Somerset County",1,49,311,175,136
050,24,039,"Maryland","Somerset County",1,50,282,161,121
050,24,039,"Maryland","Somerset County",1,51,268,158,110
050,24,039,"Maryland","Somerset County",1,52,278,150,128
050,24,039,"Maryland","Somerset County",1,53,287,156,131
050,24,039,"Maryland","Somerset County",1,54,299,162,137
050,24,039,"Maryland","Somerset County",1,55,310,165,145
050,24,039,"Maryland","Somerset County",1,56,315,161,154
050,24,039,"Maryland","Somerset County",1,57,336,184,152
050,24,039,"Maryland","Somerset County",1,58,343,185,158
050,24,039,"Maryland","Somerset County",1,59,350,184,166
050,24,039,"Maryland","Somerset County",1,60,358,182,176
050,24,039,"Maryland","Somerset County",1,61,339,166,173
050,24,039,"Maryland","Somerset County",1,62,344,176,168
050,24,039,"Maryland","Somerset County",1,63,325,166,159
050,24,039,"Maryland","Somerset County",1,64,317,145,172
050,24,039,"Maryland","Somerset County",1,65,314,155,159
050,24,039,"Maryland","Somerset County",1,66,286,136,150
050,24,039,"Maryland","Somerset County",1,67,299,144,155
050,24,039,"Maryland","Somerset County",1,68,297,149,148
050,24,039,"Maryland","Somerset County",1,69,265,139,126
050,24,039,"Maryland","Somerset County",1,70,256,122,134
050,24,039,"Maryland","Somerset County",1,71,222,108,114
050,24,039,"Maryland","Somerset County",1,72,241,122,119
050,24,039,"Maryland","Somerset County",1,73,213,104,109
050,24,039,"Maryland","Somerset County",1,74,153,73,80
050,24,039,"Maryland","Somerset County",1,75,156,79,77
050,24,039,"Maryland","Somerset County",1,76,153,73,80
050,24,039,"Maryland","Somerset County",1,77,175,81,94
050,24,039,"Maryland","Somerset County",1,78,146,77,69
050,24,039,"Maryland","Somerset County",1,79,115,54,61
050,24,039,"Maryland","Somerset County",1,80,107,42,65
050,24,039,"Maryland","Somerset County",1,81,94,38,56
050,24,039,"Maryland","Somerset County",1,82,103,41,62
050,24,039,"Maryland","Somerset County",1,83,84,37,47
050,24,039,"Maryland","Somerset County",1,84,86,39,47
050,24,039,"Maryland","Somerset County",1,85,470,147,323
050,24,039,"Maryland","Somerset County",2,0,206,108,98
050,24,039,"Maryland","Somerset County",2,1,216,117,99
050,24,039,"Maryland","Somerset County",2,2,231,113,118
050,24,039,"Maryland","Somerset County",2,3,226,112,114
050,24,039,"Maryland","Somerset County",2,4,229,109,120
050,24,039,"Maryland","Somerset County",2,5,251,133,118
050,24,039,"Maryland","Somerset County",2,6,267,141,126
050,24,039,"Maryland","Somerset County",2,7,243,123,120
050,24,039,"Maryland","Somerset County",2,8,237,119,118
050,24,039,"Maryland","Somerset County",2,9,249,120,129
050,24,039,"Maryland","Somerset County",2,10,247,125,122
050,24,039,"Maryland","Somerset County",2,11,242,125,117
050,24,039,"Maryland","Somerset County",2,12,233,113,120
050,24,039,"Maryland","Somerset County",2,13,238,117,121
050,24,039,"Maryland","Somerset County",2,14,232,121,111
050,24,039,"Maryland","Somerset County",2,15,230,120,110
050,24,039,"Maryland","Somerset County",2,16,235,118,117
050,24,039,"Maryland","Somerset County",2,17,241,123,118
050,24,039,"Maryland","Somerset County",2,18,439,235,204
050,24,039,"Maryland","Somerset County",2,19,618,281,337
050,24,039,"Maryland","Somerset County",2,20,665,315,350
050,24,039,"Maryland","Somerset County",2,21,676,372,304
050,24,039,"Maryland","Somerset County",2,22,491,295,196
050,24,039,"Maryland","Somerset County",2,23,457,300,157
050,24,039,"Maryland","Somerset County",2,24,398,243,155
050,24,039,"Maryland","Somerset County",2,25,357,218,139
050,24,039,"Maryland","Somerset County",2,26,326,216,110
050,24,039,"Maryland","Somerset County",2,27,326,212,114
050,24,039,"Maryland","Somerset County",2,28,336,218,118
050,24,039,"Maryland","Somerset County",2,29,333,201,132
050,24,039,"Maryland","Somerset County",2,30,345,215,130
050,24,039,"Maryland","Somerset County",2,31,303,193,110
050,24,039,"Maryland","Somerset County",2,32,321,211,110
050,24,039,"Maryland","Somerset County",2,33,279,179,100
050,24,039,"Maryland","Somerset County",2,34,279,171,108
050,24,039,"Maryland","Somerset County",2,35,311,193,118
050,24,039,"Maryland","Somerset County",2,36,293,187,106
050,24,039,"Maryland","Somerset County",2,37,317,199,118
050,24,039,"Maryland","Somerset County",2,38,297,180,117
050,24,039,"Maryland","Somerset County",2,39,323,209,114
050,24,039,"Maryland","Somerset County",2,40,305,191,114
050,24,039,"Maryland","Somerset County",2,41,284,177,107
050,24,039,"Maryland","Somerset County",2,42,291,178,113
050,24,039,"Maryland","Somerset County",2,43,271,171,100
050,24,039,"Maryland","Somerset County",2,44,277,179,98
050,24,039,"Maryland","Somerset County",2,45,278,170,108
050,24,039,"Maryland","Somerset County",2,46,264,155,109
050,24,039,"Maryland","Somerset County",2,47,252,150,102
050,24,039,"Maryland","Somerset County",2,48,296,180,116
050,24,039,"Maryland","Somerset County",2,49,313,180,133
050,24,039,"Maryland","Somerset County",2,50,288,163,125
050,24,039,"Maryland","Somerset County",2,51,269,156,113
050,24,039,"Maryland","Somerset County",2,52,274,151,123
050,24,039,"Maryland","Somerset County",2,53,285,156,129
050,24,039,"Maryland","Somerset County",2,54,294,158,136
050,24,039,"Maryland","Somerset County",2,55,309,164,145
050,24,039,"Maryland","Somerset County",2,56,313,160,153
050,24,039,"Maryland","Somerset County",2,57,336,180,156
050,24,039,"Maryland","Somerset County",2,58,341,185,156
050,24,039,"Maryland","Somerset County",2,59,343,182,161
050,24,039,"Maryland","Somerset County",2,60,356,184,172
050,24,039,"Maryland","Somerset County",2,61,341,169,172
050,24,039,"Maryland","Somerset County",2,62,340,170,170
050,24,039,"Maryland","Somerset County",2,63,330,168,162
050,24,039,"Maryland","Somerset County",2,64,316,148,168
050,24,039,"Maryland","Somerset County",2,65,312,150,162
050,24,039,"Maryland","Somerset County",2,66,296,141,155
050,24,039,"Maryland","Somerset County",2,67,295,142,153
050,24,039,"Maryland","Somerset County",2,68,293,146,147
050,24,039,"Maryland","Somerset County",2,69,272,141,131
050,24,039,"Maryland","Somerset County",2,70,255,124,131
050,24,039,"Maryland","Somerset County",2,71,227,109,118
050,24,039,"Maryland","Somerset County",2,72,234,118,116
050,24,039,"Maryland","Somerset County",2,73,225,112,113
050,24,039,"Maryland","Somerset County",2,74,154,74,80
050,24,039,"Maryland","Somerset County",2,75,152,78,74
050,24,039,"Maryland","Somerset County",2,76,150,71,79
050,24,039,"Maryland","Somerset County",2,77,173,80,93
050,24,039,"Maryland","Somerset County",2,78,145,74,71
050,24,039,"Maryland","Somerset County",2,79,122,59,63
050,24,039,"Maryland","Somerset County",2,80,111,46,65
050,24,039,"Maryland","Somerset County",2,81,95,37,58
050,24,039,"Maryland","Somerset County",2,82,102,40,62
050,24,039,"Maryland","Somerset County",2,83,84,36,48
050,24,039,"Maryland","Somerset County",2,84,85,39,46
050,24,039,"Maryland","Somerset County",2,85,470,146,324
050,24,039,"Maryland","Somerset County",3,0,215,108,107
050,24,039,"Maryland","Somerset County",3,1,229,131,98
050,24,039,"Maryland","Somerset County",3,2,194,95,99
050,24,039,"Maryland","Somerset County",3,3,235,117,118
050,24,039,"Maryland","Somerset County",3,4,232,120,112
050,24,039,"Maryland","Somerset County",3,5,241,117,124
050,24,039,"Maryland","Somerset County",3,6,248,136,112
050,24,039,"Maryland","Somerset County",3,7,272,146,126
050,24,039,"Maryland","Somerset County",3,8,259,132,127
050,24,039,"Maryland","Somerset County",3,9,249,130,119
050,24,039,"Maryland","Somerset County",3,10,238,118,120
050,24,039,"Maryland","Somerset County",3,11,241,126,115
050,24,039,"Maryland","Somerset County",3,12,244,127,117
050,24,039,"Maryland","Somerset County",3,13,240,117,123
050,24,039,"Maryland","Somerset County",3,14,239,111,128
050,24,039,"Maryland","Somerset County",3,15,235,115,120
050,24,039,"Maryland","Somerset County",3,16,231,114,117
050,24,039,"Maryland","Somerset County",3,17,240,123,117
050,24,039,"Maryland","Somerset County",3,18,434,229,205
050,24,039,"Maryland","Somerset County",3,19,604,281,323
050,24,039,"Maryland","Somerset County",3,20,646,313,333
050,24,039,"Maryland","Somerset County",3,21,680,369,311
050,24,039,"Maryland","Somerset County",3,22,474,282,192
050,24,039,"Maryland","Somerset County",3,23,467,315,152
050,24,039,"Maryland","Somerset County",3,24,393,242,151
050,24,039,"Maryland","Somerset County",3,25,364,224,140
050,24,039,"Maryland","Somerset County",3,26,323,206,117
050,24,039,"Maryland","Somerset County",3,27,319,206,113
050,24,039,"Maryland","Somerset County",3,28,358,234,124
050,24,039,"Maryland","Somerset County",3,29,325,216,109
050,24,039,"Maryland","Somerset County",3,30,355,216,139
050,24,039,"Maryland","Somerset County",3,31,299,184,115
050,24,039,"Maryland","Somerset County",3,32,316,213,103
050,24,039,"Maryland","Somerset County",3,33,279,170,109
050,24,039,"Maryland","Somerset County",3,34,296,193,103
050,24,039,"Maryland","Somerset County",3,35,286,180,106
050,24,039,"Maryland","Somerset County",3,36,301,182,119
050,24,039,"Maryland","Somerset County",3,37,320,209,111
050,24,039,"Maryland","Somerset County",3,38,301,187,114
050,24,039,"Maryland","Somerset County",3,39,323,202,121
050,24,039,"Maryland","Somerset County",3,40,329,214,115
050,24,039,"Maryland","Somerset County",3,41,303,195,108
050,24,039,"Maryland","Somerset County",3,42,264,160,104
050,24,039,"Maryland","Somerset County",3,43,279,170,109
050,24,039,"Maryland","Somerset County",3,44,273,173,100
050,24,039,"Maryland","Somerset County",3,45,276,176,100
050,24,039,"Maryland","Somerset County",3,46,290,182,108
050,24,039,"Maryland","Somerset County",3,47,240,138,102
050,24,039,"Maryland","Somerset County",3,48,255,151,104
050,24,039,"Maryland","Somerset County",3,49,295,183,112
050,24,039,"Maryland","Somerset County",3,50,312,173,139
050,24,039,"Maryland","Somerset County",3,51,276,152,124
050,24,039,"Maryland","Somerset County",3,52,282,160,122
050,24,039,"Maryland","Somerset County",3,53,278,156,122
050,24,039,"Maryland","Somerset County",3,54,264,142,122
050,24,039,"Maryland","Somerset County",3,55,287,155,132
050,24,039,"Maryland","Somerset County",3,56,298,152,146
050,24,039,"Maryland","Somerset County",3,57,327,166,161
050,24,039,"Maryland","Somerset County",3,58,325,171,154
050,24,039,"Maryland","Somerset County",3,59,339,183,156
050,24,039,"Maryland","Somerset County",3,60,340,186,154
050,24,039,"Maryland","Somerset County",3,61,353,178,175
050,24,039,"Maryland","Somerset County",3,62,332,161,171
050,24,039,"Maryland","Somerset County",3,63,338,173,165
050,24,039,"Maryland","Somerset County",3,64,325,163,162
050,24,039,"Maryland","Somerset County",3,65,314,149,165
050,24,039,"Maryland","Somerset County",3,66,307,149,158
050,24,039,"Maryland","Somerset County",3,67,294,141,153
050,24,039,"Maryland","Somerset County",3,68,286,139,147
050,24,039,"Maryland","Somerset County",3,69,286,140,146
050,24,039,"Maryland","Somerset County",3,70,262,136,126
050,24,039,"Maryland","Somerset County",3,71,251,120,131
050,24,039,"Maryland","Somerset County",3,72,224,111,113
050,24,039,"Maryland","Somerset County",3,73,219,108,111
050,24,039,"Maryland","Somerset County",3,74,223,112,111
050,24,039,"Maryland","Somerset County",3,75,149,72,77
050,24,039,"Maryland","Somerset County",3,76,143,69,74
050,24,039,"Maryland","Somerset County",3,77,142,65,77
050,24,039,"Maryland","Somerset County",3,78,159,74,85
050,24,039,"Maryland","Somerset County",3,79,136,65,71
050,24,039,"Maryland","Somerset County",3,80,117,58,59
050,24,039,"Maryland","Somerset County",3,81,104,41,63
050,24,039,"Maryland","Somerset County",3,82,90,34,56
050,24,039,"Maryland","Somerset County",3,83,79,30,49
050,24,039,"Maryland","Somerset County",3,84,78,32,46
050,24,039,"Maryland","Somerset County",3,85,458,143,315
050,24,039,"Maryland","Somerset County",4,0,215,116,99
050,24,039,"Maryland","Somerset County",4,1,212,98,114
050,24,039,"Maryland","Somerset County",4,2,238,129,109
050,24,039,"Maryland","Somerset County",4,3,196,92,104
050,24,039,"Maryland","Somerset County",4,4,220,110,110
050,24,039,"Maryland","Somerset County",4,5,238,125,113
050,24,039,"Maryland","Somerset County",4,6,241,119,122
050,24,039,"Maryland","Somerset County",4,7,250,141,109
050,24,039,"Maryland","Somerset County",4,8,268,148,120
050,24,039,"Maryland","Somerset County",4,9,256,130,126
050,24,039,"Maryland","Somerset County",4,10,239,126,113
050,24,039,"Maryland","Somerset County",4,11,249,128,121
050,24,039,"Maryland","Somerset County",4,12,239,120,119
050,24,039,"Maryland","Somerset County",4,13,252,129,123
050,24,039,"Maryland","Somerset County",4,14,234,114,120
050,24,039,"Maryland","Somerset County",4,15,248,113,135
050,24,039,"Maryland","Somerset County",4,16,232,110,122
050,24,039,"Maryland","Somerset County",4,17,239,120,119
050,24,039,"Maryland","Somerset County",4,18,442,242,200
050,24,039,"Maryland","Somerset County",4,19,608,284,324
050,24,039,"Maryland","Somerset County",4,20,650,316,334
050,24,039,"Maryland","Somerset County",4,21,683,374,309
050,24,039,"Maryland","Somerset County",4,22,509,298,211
050,24,039,"Maryland","Somerset County",4,23,438,295,143
050,24,039,"Maryland","Somerset County",4,24,415,262,153
050,24,039,"Maryland","Somerset County",4,25,371,232,139
050,24,039,"Maryland","Somerset County",4,26,330,210,120
050,24,039,"Maryland","Somerset County",4,27,301,192,109
050,24,039,"Maryland","Somerset County",4,28,334,221,113
050,24,039,"Maryland","Somerset County",4,29,336,218,118
050,24,039,"Maryland","Somerset County",4,30,340,220,120
050,24,039,"Maryland","Somerset County",4,31,336,196,140
050,24,039,"Maryland","Somerset County",4,32,307,203,104
050,24,039,"Maryland","Somerset County",4,33,279,172,107
050,24,039,"Maryland","Somerset County",4,34,268,161,107
050,24,039,"Maryland","Somerset County",4,35,307,194,113
050,24,039,"Maryland","Somerset County",4,36,283,166,117
050,24,039,"Maryland","Somerset County",4,37,324,201,123
050,24,039,"Maryland","Somerset County",4,38,307,201,106
050,24,039,"Maryland","Somerset County",4,39,328,211,117
050,24,039,"Maryland","Somerset County",4,40,318,190,128
050,24,039,"Maryland","Somerset County",4,41,329,216,113
050,24,039,"Maryland","Somerset County",4,42,299,186,113
050,24,039,"Maryland","Somerset County",4,43,263,157,106
050,24,039,"Maryland","Somerset County",4,44,280,171,109
050,24,039,"Maryland","Somerset County",4,45,271,169,102
050,24,039,"Maryland","Somerset County",4,46,281,178,103
050,24,039,"Maryland","Somerset County",4,47,265,156,109
050,24,039,"Maryland","Somerset County",4,48,249,145,104
050,24,039,"Maryland","Somerset County",4,49,261,156,105
050,24,039,"Maryland","Somerset County",4,50,281,168,113
050,24,039,"Maryland","Somerset County",4,51,288,151,137
050,24,039,"Maryland","Somerset County",4,52,284,154,130
050,24,039,"Maryland","Somerset County",4,53,268,155,113
050,24,039,"Maryland","Somerset County",4,54,273,147,126
050,24,039,"Maryland","Somerset County",4,55,272,146,126
050,24,039,"Maryland","Somerset County",4,56,283,142,141
050,24,039,"Maryland","Somerset County",4,57,309,151,158
050,24,039,"Maryland","Somerset County",4,58,309,151,158
050,24,039,"Maryland","Somerset County",4,59,311,164,147
050,24,039,"Maryland","Somerset County",4,60,339,186,153
050,24,039,"Maryland","Somerset County",4,61,338,187,151
050,24,039,"Maryland","Somerset County",4,62,362,182,180
050,24,039,"Maryland","Somerset County",4,63,334,164,170
050,24,039,"Maryland","Somerset County",4,64,334,164,170
050,24,039,"Maryland","Somerset County",4,65,326,169,157
050,24,039,"Maryland","Somerset County",4,66,310,141,169
050,24,039,"Maryland","Somerset County",4,67,308,152,156
050,24,039,"Maryland","Somerset County",4,68,295,142,153
050,24,039,"Maryland","Somerset County",4,69,279,134,145
050,24,039,"Maryland","Somerset County",4,70,282,137,145
050,24,039,"Maryland","Somerset County",4,71,256,131,125
050,24,039,"Maryland","Somerset County",4,72,263,122,141
050,24,039,"Maryland","Somerset County",4,73,214,105,109
050,24,039,"Maryland","Somerset County",4,74,209,106,103
050,24,039,"Maryland","Somerset County",4,75,208,107,101
050,24,039,"Maryland","Somerset County",4,76,137,64,73
050,24,039,"Maryland","Somerset County",4,77,135,63,72
050,24,039,"Maryland","Somerset County",4,78,136,64,72
050,24,039,"Maryland","Somerset County",4,79,142,64,78
050,24,039,"Maryland","Somerset County",4,80,137,67,70
050,24,039,"Maryland","Somerset County",4,81,108,49,59
050,24,039,"Maryland","Somerset County",4,82,102,39,63
050,24,039,"Maryland","Somerset County",4,83,75,28,47
050,24,039,"Maryland","Somerset County",4,84,72,27,45
050,24,039,"Maryland","Somerset County",4,85,451,140,311
050,24,039,"Maryland","Somerset County",5,0,215,116,99
050,24,039,"Maryland","Somerset County",5,1,202,110,92
050,24,039,"Maryland","Somerset County",5,2,224,107,117
050,24,039,"Maryland","Somerset County",5,3,235,131,104
050,24,039,"Maryland","Somerset County",5,4,201,93,108
050,24,039,"Maryland","Somerset County",5,5,229,114,115
050,24,039,"Maryland","Somerset County",5,6,244,126,118
050,24,039,"Maryland","Somerset County",5,7,247,129,118
050,24,039,"Maryland","Somerset County",5,8,246,137,109
050,24,039,"Maryland","Somerset County",5,9,283,157,126
050,24,039,"Maryland","Somerset County",5,10,269,135,134
050,24,039,"Maryland","Somerset County",5,11,242,124,118
050,24,039,"Maryland","Somerset County",5,12,246,125,121
050,24,039,"Maryland","Somerset County",5,13,249,122,127
050,24,039,"Maryland","Somerset County",5,14,255,140,115
050,24,039,"Maryland","Somerset County",5,15,248,121,127
050,24,039,"Maryland","Somerset County",5,16,265,127,138
050,24,039,"Maryland","Somerset County",5,17,249,124,125
050,24,039,"Maryland","Somerset County",5,18,443,236,207
050,24,039,"Maryland","Somerset County",5,19,615,293,322
050,24,039,"Maryland","Somerset County",5,20,654,314,340
050,24,039,"Maryland","Somerset County",5,21,679,377,302
050,24,039,"Maryland","Somerset County",5,22,515,294,221
050,24,039,"Maryland","Somerset County",5,23,469,319,150
050,24,039,"Maryland","Somerset County",5,24,401,265,136
050,24,039,"Maryland","Somerset County",5,25,380,244,136
050,24,039,"Maryland","Somerset County",5,26,332,211,121
050,24,039,"Maryland","Somerset County",5,27,338,207,131
050,24,039,"Maryland","Somerset County",5,28,321,216,105
050,24,039,"Maryland","Somerset County",5,29,330,217,113
050,24,039,"Maryland","Somerset County",5,30,358,237,121
050,24,039,"Maryland","Somerset County",5,31,321,201,120
050,24,039,"Maryland","Somerset County",5,32,359,218,141
050,24,039,"Maryland","Somerset County",5,33,275,165,110
050,24,039,"Maryland","Somerset County",5,34,280,172,108
050,24,039,"Maryland","Somerset County",5,35,287,177,110
050,24,039,"Maryland","Somerset County",5,36,296,182,114
050,24,039,"Maryland","Somerset County",5,37,306,185,121
050,24,039,"Maryland","Somerset County",5,38,319,196,123
050,24,039,"Maryland","Somerset County",5,39,322,214,108
050,24,039,"Maryland","Somerset County",5,40,329,204,125
050,24,039,"Maryland","Somerset County",5,41,337,196,141
050,24,039,"Maryland","Somerset County",5,42,323,205,118
050,24,039,"Maryland","Somerset County",5,43,285,177,108
050,24,039,"Maryland","Somerset County",5,44,262,157,105
050,24,039,"Maryland","Somerset County",5,45,267,161,106
050,24,039,"Maryland","Somerset County",5,46,272,178,94
050,24,039,"Maryland","Somerset County",5,47,266,160,106
050,24,039,"Maryland","Somerset County",5,48,270,163,107
050,24,039,"Maryland","Somerset County",5,49,254,147,107
050,24,039,"Maryland","Somerset County",5,50,247,142,105
050,24,039,"Maryland","Somerset County",5,51,275,159,116
050,24,039,"Maryland","Somerset County",5,52,314,167,147
050,24,039,"Maryland","Somerset County",5,53,289,159,130
050,24,039,"Maryland","Somerset County",5,54,266,144,122
050,24,039,"Maryland","Somerset County",5,55,274,149,125
050,24,039,"Maryland","Somerset County",5,56,273,141,132
050,24,039,"Maryland","Somerset County",5,57,297,145,152
050,24,039,"Maryland","Somerset County",5,58,303,147,156
050,24,039,"Maryland","Somerset County",5,59,309,148,161
050,24,039,"Maryland","Somerset County",5,60,320,172,148
050,24,039,"Maryland","Somerset County",5,61,339,190,149
050,24,039,"Maryland","Somerset County",5,62,346,187,159
050,24,039,"Maryland","Somerset County",5,63,360,179,181
050,24,039,"Maryland","Somerset County",5,64,329,159,170
050,24,039,"Maryland","Somerset County",5,65,332,168,164
050,24,039,"Maryland","Somerset County",5,66,317,160,157
050,24,039,"Maryland","Somerset County",5,67,297,137,160
050,24,039,"Maryland","Somerset County",5,68,303,150,153
050,24,039,"Maryland","Somerset County",5,69,293,137,156
050,24,039,"Maryland","Somerset County",5,70,267,129,138
050,24,039,"Maryland","Somerset County",5,71,280,136,144
050,24,039,"Maryland","Somerset County",5,72,262,132,130
050,24,039,"Maryland","Somerset County",5,73,247,113,134
050,24,039,"Maryland","Somerset County",5,74,209,102,107
050,24,039,"Maryland","Somerset County",5,75,201,102,99
050,24,039,"Maryland","Somerset County",5,76,194,97,97
050,24,039,"Maryland","Somerset County",5,77,131,61,70
050,24,039,"Maryland","Somerset County",5,78,125,59,66
050,24,039,"Maryland","Somerset County",5,79,125,53,72
050,24,039,"Maryland","Somerset County",5,80,139,67,72
050,24,039,"Maryland","Somerset County",5,81,130,58,72
050,24,039,"Maryland","Somerset County",5,82,102,45,57
050,24,039,"Maryland","Somerset County",5,83,84,33,51
050,24,039,"Maryland","Somerset County",5,84,68,25,43
050,24,039,"Maryland","Somerset County",5,85,449,136,313
050,24,041,"Maryland","Talbot County",1,0,342,177,165
050,24,041,"Maryland","Talbot County",1,1,359,186,173
050,24,041,"Maryland","Talbot County",1,2,357,176,181
050,24,041,"Maryland","Talbot County",1,3,359,183,176
050,24,041,"Maryland","Talbot County",1,4,364,189,175
050,24,041,"Maryland","Talbot County",1,5,367,200,167
050,24,041,"Maryland","Talbot County",1,6,367,180,187
050,24,041,"Maryland","Talbot County",1,7,375,197,178
050,24,041,"Maryland","Talbot County",1,8,375,184,191
050,24,041,"Maryland","Talbot County",1,9,409,217,192
050,24,041,"Maryland","Talbot County",1,10,410,222,188
050,24,041,"Maryland","Talbot County",1,11,430,231,199
050,24,041,"Maryland","Talbot County",1,12,433,221,212
050,24,041,"Maryland","Talbot County",1,13,433,233,200
050,24,041,"Maryland","Talbot County",1,14,424,214,210
050,24,041,"Maryland","Talbot County",1,15,416,208,208
050,24,041,"Maryland","Talbot County",1,16,408,204,204
050,24,041,"Maryland","Talbot County",1,17,429,225,204
050,24,041,"Maryland","Talbot County",1,18,361,186,175
050,24,041,"Maryland","Talbot County",1,19,301,159,142
050,24,041,"Maryland","Talbot County",1,20,322,161,161
050,24,041,"Maryland","Talbot County",1,21,308,163,145
050,24,041,"Maryland","Talbot County",1,22,323,162,161
050,24,041,"Maryland","Talbot County",1,23,328,157,171
050,24,041,"Maryland","Talbot County",1,24,315,152,163
050,24,041,"Maryland","Talbot County",1,25,320,159,161
050,24,041,"Maryland","Talbot County",1,26,339,159,180
050,24,041,"Maryland","Talbot County",1,27,342,172,170
050,24,041,"Maryland","Talbot County",1,28,363,190,173
050,24,041,"Maryland","Talbot County",1,29,388,196,192
050,24,041,"Maryland","Talbot County",1,30,393,193,200
050,24,041,"Maryland","Talbot County",1,31,373,161,212
050,24,041,"Maryland","Talbot County",1,32,365,167,198
050,24,041,"Maryland","Talbot County",1,33,374,193,181
050,24,041,"Maryland","Talbot County",1,34,365,169,196
050,24,041,"Maryland","Talbot County",1,35,357,171,186
050,24,041,"Maryland","Talbot County",1,36,385,202,183
050,24,041,"Maryland","Talbot County",1,37,375,196,179
050,24,041,"Maryland","Talbot County",1,38,398,205,193
050,24,041,"Maryland","Talbot County",1,39,392,200,192
050,24,041,"Maryland","Talbot County",1,40,348,166,182
050,24,041,"Maryland","Talbot County",1,41,362,182,180
050,24,041,"Maryland","Talbot County",1,42,335,164,171
050,24,041,"Maryland","Talbot County",1,43,333,159,174
050,24,041,"Maryland","Talbot County",1,44,357,159,198
050,24,041,"Maryland","Talbot County",1,45,355,169,186
050,24,041,"Maryland","Talbot County",1,46,371,168,203
050,24,041,"Maryland","Talbot County",1,47,380,172,208
050,24,041,"Maryland","Talbot County",1,48,456,218,238
050,24,041,"Maryland","Talbot County",1,49,486,250,236
050,24,041,"Maryland","Talbot County",1,50,434,226,208
050,24,041,"Maryland","Talbot County",1,51,440,213,227
050,24,041,"Maryland","Talbot County",1,52,431,202,229
050,24,041,"Maryland","Talbot County",1,53,483,216,267
050,24,041,"Maryland","Talbot County",1,54,527,248,279
050,24,041,"Maryland","Talbot County",1,55,543,230,313
050,24,041,"Maryland","Talbot County",1,56,548,247,301
050,24,041,"Maryland","Talbot County",1,57,542,261,281
050,24,041,"Maryland","Talbot County",1,58,571,270,301
050,24,041,"Maryland","Talbot County",1,59,601,286,315
050,24,041,"Maryland","Talbot County",1,60,571,285,286
050,24,041,"Maryland","Talbot County",1,61,573,272,301
050,24,041,"Maryland","Talbot County",1,62,582,258,324
050,24,041,"Maryland","Talbot County",1,63,580,258,322
050,24,041,"Maryland","Talbot County",1,64,583,248,335
050,24,041,"Maryland","Talbot County",1,65,613,277,336
050,24,041,"Maryland","Talbot County",1,66,571,276,295
050,24,041,"Maryland","Talbot County",1,67,598,268,330
050,24,041,"Maryland","Talbot County",1,68,592,255,337
050,24,041,"Maryland","Talbot County",1,69,558,241,317
050,24,041,"Maryland","Talbot County",1,70,526,243,283
050,24,041,"Maryland","Talbot County",1,71,569,250,319
050,24,041,"Maryland","Talbot County",1,72,604,279,325
050,24,041,"Maryland","Talbot County",1,73,654,311,343
050,24,041,"Maryland","Talbot County",1,74,447,205,242
050,24,041,"Maryland","Talbot County",1,75,477,208,269
050,24,041,"Maryland","Talbot County",1,76,500,229,271
050,24,041,"Maryland","Talbot County",1,77,518,231,287
050,24,041,"Maryland","Talbot County",1,78,442,196,246
050,24,041,"Maryland","Talbot County",1,79,380,179,201
050,24,041,"Maryland","Talbot County",1,80,326,152,174
050,24,041,"Maryland","Talbot County",1,81,304,141,163
050,24,041,"Maryland","Talbot County",1,82,266,115,151
050,24,041,"Maryland","Talbot County",1,83,269,137,132
050,24,041,"Maryland","Talbot County",1,84,251,116,135
050,24,041,"Maryland","Talbot County",1,85,1422,564,858
050,24,041,"Maryland","Talbot County",2,0,358,185,173
050,24,041,"Maryland","Talbot County",2,1,355,184,171
050,24,041,"Maryland","Talbot County",2,2,355,175,180
050,24,041,"Maryland","Talbot County",2,3,352,178,174
050,24,041,"Maryland","Talbot County",2,4,365,188,177
050,24,041,"Maryland","Talbot County",2,5,365,196,169
050,24,041,"Maryland","Talbot County",2,6,371,188,183
050,24,041,"Maryland","Talbot County",2,7,373,193,180
050,24,041,"Maryland","Talbot County",2,8,370,187,183
050,24,041,"Maryland","Talbot County",2,9,401,210,191
050,24,041,"Maryland","Talbot County",2,10,406,220,186
050,24,041,"Maryland","Talbot County",2,11,422,227,195
050,24,041,"Maryland","Talbot County",2,12,437,225,212
050,24,041,"Maryland","Talbot County",2,13,431,229,202
050,24,041,"Maryland","Talbot County",2,14,421,216,205
050,24,041,"Maryland","Talbot County",2,15,416,210,206
050,24,041,"Maryland","Talbot County",2,16,411,207,204
050,24,041,"Maryland","Talbot County",2,17,426,219,207
050,24,041,"Maryland","Talbot County",2,18,358,186,172
050,24,041,"Maryland","Talbot County",2,19,304,159,145
050,24,041,"Maryland","Talbot County",2,20,323,163,160
050,24,041,"Maryland","Talbot County",2,21,312,164,148
050,24,041,"Maryland","Talbot County",2,22,320,160,160
050,24,041,"Maryland","Talbot County",2,23,323,156,167
050,24,041,"Maryland","Talbot County",2,24,319,155,164
050,24,041,"Maryland","Talbot County",2,25,326,160,166
050,24,041,"Maryland","Talbot County",2,26,333,160,173
050,24,041,"Maryland","Talbot County",2,27,343,172,171
050,24,041,"Maryland","Talbot County",2,28,359,187,172
050,24,041,"Maryland","Talbot County",2,29,380,194,186
050,24,041,"Maryland","Talbot County",2,30,391,192,199
050,24,041,"Maryland","Talbot County",2,31,378,169,209
050,24,041,"Maryland","Talbot County",2,32,366,165,201
050,24,041,"Maryland","Talbot County",2,33,373,186,187
050,24,041,"Maryland","Talbot County",2,34,370,177,193
050,24,041,"Maryland","Talbot County",2,35,365,174,191
050,24,041,"Maryland","Talbot County",2,36,376,194,182
050,24,041,"Maryland","Talbot County",2,37,373,193,180
050,24,041,"Maryland","Talbot County",2,38,393,204,189
050,24,041,"Maryland","Talbot County",2,39,392,199,193
050,24,041,"Maryland","Talbot County",2,40,362,176,186
050,24,041,"Maryland","Talbot County",2,41,359,178,181
050,24,041,"Maryland","Talbot County",2,42,341,170,171
050,24,041,"Maryland","Talbot County",2,43,335,160,175
050,24,041,"Maryland","Talbot County",2,44,346,156,190
050,24,041,"Maryland","Talbot County",2,45,359,167,192
050,24,041,"Maryland","Talbot County",2,46,364,167,197
050,24,041,"Maryland","Talbot County",2,47,379,172,207
050,24,041,"Maryland","Talbot County",2,48,437,209,228
050,24,041,"Maryland","Talbot County",2,49,480,242,238
050,24,041,"Maryland","Talbot County",2,50,447,231,216
050,24,041,"Maryland","Talbot County",2,51,436,214,222
050,24,041,"Maryland","Talbot County",2,52,431,204,227
050,24,041,"Maryland","Talbot County",2,53,473,215,258
050,24,041,"Maryland","Talbot County",2,54,519,242,277
050,24,041,"Maryland","Talbot County",2,55,540,234,306
050,24,041,"Maryland","Talbot County",2,56,549,242,307
050,24,041,"Maryland","Talbot County",2,57,545,256,289
050,24,041,"Maryland","Talbot County",2,58,567,269,298
050,24,041,"Maryland","Talbot County",2,59,596,284,312
050,24,041,"Maryland","Talbot County",2,60,578,287,291
050,24,041,"Maryland","Talbot County",2,61,569,274,295
050,24,041,"Maryland","Talbot County",2,62,575,259,316
050,24,041,"Maryland","Talbot County",2,63,580,257,323
050,24,041,"Maryland","Talbot County",2,64,579,247,332
050,24,041,"Maryland","Talbot County",2,65,605,269,336
050,24,041,"Maryland","Talbot County",2,66,588,279,309
050,24,041,"Maryland","Talbot County",2,67,589,268,321
050,24,041,"Maryland","Talbot County",2,68,592,257,335
050,24,041,"Maryland","Talbot County",2,69,573,247,326
050,24,041,"Maryland","Talbot County",2,70,529,240,289
050,24,041,"Maryland","Talbot County",2,71,563,250,313
050,24,041,"Maryland","Talbot County",2,72,588,268,320
050,24,041,"Maryland","Talbot County",2,73,673,319,354
050,24,041,"Maryland","Talbot County",2,74,463,214,249
050,24,041,"Maryland","Talbot County",2,75,473,209,264
050,24,041,"Maryland","Talbot County",2,76,489,221,268
050,24,041,"Maryland","Talbot County",2,77,522,233,289
050,24,041,"Maryland","Talbot County",2,78,445,198,247
050,24,041,"Maryland","Talbot County",2,79,387,178,209
050,24,041,"Maryland","Talbot County",2,80,333,152,181
050,24,041,"Maryland","Talbot County",2,81,306,143,163
050,24,041,"Maryland","Talbot County",2,82,273,120,153
050,24,041,"Maryland","Talbot County",2,83,262,128,134
050,24,041,"Maryland","Talbot County",2,84,251,119,132
050,24,041,"Maryland","Talbot County",2,85,1426,568,858
050,24,041,"Maryland","Talbot County",3,0,326,170,156
050,24,041,"Maryland","Talbot County",3,1,343,172,171
050,24,041,"Maryland","Talbot County",3,2,372,191,181
050,24,041,"Maryland","Talbot County",3,3,368,177,191
050,24,041,"Maryland","Talbot County",3,4,372,190,182
050,24,041,"Maryland","Talbot County",3,5,356,192,164
050,24,041,"Maryland","Talbot County",3,6,362,198,164
050,24,041,"Maryland","Talbot County",3,7,380,197,183
050,24,041,"Maryland","Talbot County",3,8,383,197,186
050,24,041,"Maryland","Talbot County",3,9,359,181,178
050,24,041,"Maryland","Talbot County",3,10,396,202,194
050,24,041,"Maryland","Talbot County",3,11,421,223,198
050,24,041,"Maryland","Talbot County",3,12,427,232,195
050,24,041,"Maryland","Talbot County",3,13,449,232,217
050,24,041,"Maryland","Talbot County",3,14,424,230,194
050,24,041,"Maryland","Talbot County",3,15,418,215,203
050,24,041,"Maryland","Talbot County",3,16,415,209,206
050,24,041,"Maryland","Talbot County",3,17,418,204,214
050,24,041,"Maryland","Talbot County",3,18,368,194,174
050,24,041,"Maryland","Talbot County",3,19,305,156,149
050,24,041,"Maryland","Talbot County",3,20,328,168,160
050,24,041,"Maryland","Talbot County",3,21,358,173,185
050,24,041,"Maryland","Talbot County",3,22,332,174,158
050,24,041,"Maryland","Talbot County",3,23,342,178,164
050,24,041,"Maryland","Talbot County",3,24,340,166,174
050,24,041,"Maryland","Talbot County",3,25,321,163,158
050,24,041,"Maryland","Talbot County",3,26,326,155,171
050,24,041,"Maryland","Talbot County",3,27,344,170,174
050,24,041,"Maryland","Talbot County",3,28,357,179,178
050,24,041,"Maryland","Talbot County",3,29,344,173,171
050,24,041,"Maryland","Talbot County",3,30,400,198,202
050,24,041,"Maryland","Talbot County",3,31,403,197,206
050,24,041,"Maryland","Talbot County",3,32,382,177,205
050,24,041,"Maryland","Talbot County",3,33,382,169,213
050,24,041,"Maryland","Talbot County",3,34,380,189,191
050,24,041,"Maryland","Talbot County",3,35,364,174,190
050,24,041,"Maryland","Talbot County",3,36,368,173,195
050,24,041,"Maryland","Talbot County",3,37,379,193,186
050,24,041,"Maryland","Talbot County",3,38,370,197,173
050,24,041,"Maryland","Talbot County",3,39,387,195,192
050,24,041,"Maryland","Talbot County",3,40,394,198,196
050,24,041,"Maryland","Talbot County",3,41,370,181,189
050,24,041,"Maryland","Talbot County",3,42,348,170,178
050,24,041,"Maryland","Talbot County",3,43,348,175,173
050,24,041,"Maryland","Talbot County",3,44,335,157,178
050,24,041,"Maryland","Talbot County",3,45,370,170,200
050,24,041,"Maryland","Talbot County",3,46,358,169,189
050,24,041,"Maryland","Talbot County",3,47,377,177,200
050,24,041,"Maryland","Talbot County",3,48,363,167,196
050,24,041,"Maryland","Talbot County",3,49,437,208,229
050,24,041,"Maryland","Talbot County",3,50,470,234,236
050,24,041,"Maryland","Talbot County",3,51,445,221,224
050,24,041,"Maryland","Talbot County",3,52,457,222,235
050,24,041,"Maryland","Talbot County",3,53,435,203,232
050,24,041,"Maryland","Talbot County",3,54,480,214,266
050,24,041,"Maryland","Talbot County",3,55,531,253,278
050,24,041,"Maryland","Talbot County",3,56,554,235,319
050,24,041,"Maryland","Talbot County",3,57,559,251,308
050,24,041,"Maryland","Talbot County",3,58,561,272,289
050,24,041,"Maryland","Talbot County",3,59,596,276,320
050,24,041,"Maryland","Talbot County",3,60,597,295,302
050,24,041,"Maryland","Talbot County",3,61,592,300,292
050,24,041,"Maryland","Talbot County",3,62,573,268,305
050,24,041,"Maryland","Talbot County",3,63,585,260,325
050,24,041,"Maryland","Talbot County",3,64,603,272,331
050,24,041,"Maryland","Talbot County",3,65,591,261,330
050,24,041,"Maryland","Talbot County",3,66,608,265,343
050,24,041,"Maryland","Talbot County",3,67,592,281,311
050,24,041,"Maryland","Talbot County",3,68,595,272,323
050,24,041,"Maryland","Talbot County",3,69,597,259,338
050,24,041,"Maryland","Talbot County",3,70,580,251,329
050,24,041,"Maryland","Talbot County",3,71,542,249,293
050,24,041,"Maryland","Talbot County",3,72,558,247,311
050,24,041,"Maryland","Talbot County",3,73,568,258,310
050,24,041,"Maryland","Talbot County",3,74,670,321,349
050,24,041,"Maryland","Talbot County",3,75,457,211,246
050,24,041,"Maryland","Talbot County",3,76,461,202,259
050,24,041,"Maryland","Talbot County",3,77,474,212,262
050,24,041,"Maryland","Talbot County",3,78,502,222,280
050,24,041,"Maryland","Talbot County",3,79,417,188,229
050,24,041,"Maryland","Talbot County",3,80,367,168,199
050,24,041,"Maryland","Talbot County",3,81,319,147,172
050,24,041,"Maryland","Talbot County",3,82,299,139,160
050,24,041,"Maryland","Talbot County",3,83,259,109,150
050,24,041,"Maryland","Talbot County",3,84,248,124,124
050,24,041,"Maryland","Talbot County",3,85,1445,592,853
050,24,041,"Maryland","Talbot County",4,0,309,154,155
050,24,041,"Maryland","Talbot County",4,1,342,175,167
050,24,041,"Maryland","Talbot County",4,2,363,182,181
050,24,041,"Maryland","Talbot County",4,3,375,191,184
050,24,041,"Maryland","Talbot County",4,4,381,180,201
050,24,041,"Maryland","Talbot County",4,5,379,199,180
050,24,041,"Maryland","Talbot County",4,6,379,212,167
050,24,041,"Maryland","Talbot County",4,7,355,193,162
050,24,041,"Maryland","Talbot County",4,8,379,187,192
050,24,041,"Maryland","Talbot County",4,9,386,205,181
050,24,041,"Maryland","Talbot County",4,10,366,183,183
050,24,041,"Maryland","Talbot County",4,11,400,213,187
050,24,041,"Maryland","Talbot County",4,12,411,221,190
050,24,041,"Maryland","Talbot County",4,13,426,233,193
050,24,041,"Maryland","Talbot County",4,14,448,221,227
050,24,041,"Maryland","Talbot County",4,15,420,235,185
050,24,041,"Maryland","Talbot County",4,16,418,217,201
050,24,041,"Maryland","Talbot County",4,17,420,214,206
050,24,041,"Maryland","Talbot County",4,18,365,181,184
050,24,041,"Maryland","Talbot County",4,19,311,161,150
050,24,041,"Maryland","Talbot County",4,20,324,163,161
050,24,041,"Maryland","Talbot County",4,21,347,180,167
050,24,041,"Maryland","Talbot County",4,22,376,180,196
050,24,041,"Maryland","Talbot County",4,23,328,173,155
050,24,041,"Maryland","Talbot County",4,24,326,167,159
050,24,041,"Maryland","Talbot County",4,25,362,182,180
050,24,041,"Maryland","Talbot County",4,26,290,150,140
050,24,041,"Maryland","Talbot County",4,27,332,164,168
050,24,041,"Maryland","Talbot County",4,28,359,176,183
050,24,041,"Maryland","Talbot County",4,29,358,189,169
050,24,041,"Maryland","Talbot County",4,30,349,173,176
050,24,041,"Maryland","Talbot County",4,31,429,213,216
050,24,041,"Maryland","Talbot County",4,32,407,194,213
050,24,041,"Maryland","Talbot County",4,33,390,186,204
050,24,041,"Maryland","Talbot County",4,34,381,174,207
050,24,041,"Maryland","Talbot County",4,35,381,196,185
050,24,041,"Maryland","Talbot County",4,36,370,181,189
050,24,041,"Maryland","Talbot County",4,37,367,166,201
050,24,041,"Maryland","Talbot County",4,38,369,182,187
050,24,041,"Maryland","Talbot County",4,39,384,200,184
050,24,041,"Maryland","Talbot County",4,40,401,205,196
050,24,041,"Maryland","Talbot County",4,41,421,214,207
050,24,041,"Maryland","Talbot County",4,42,367,180,187
050,24,041,"Maryland","Talbot County",4,43,374,183,191
050,24,041,"Maryland","Talbot County",4,44,348,171,177
050,24,041,"Maryland","Talbot County",4,45,352,165,187
050,24,041,"Maryland","Talbot County",4,46,358,168,190
050,24,041,"Maryland","Talbot County",4,47,367,177,190
050,24,041,"Maryland","Talbot County",4,48,365,170,195
050,24,041,"Maryland","Talbot County",4,49,358,162,196
050,24,041,"Maryland","Talbot County",4,50,436,202,234
050,24,041,"Maryland","Talbot County",4,51,461,225,236
050,24,041,"Maryland","Talbot County",4,52,455,220,235
050,24,041,"Maryland","Talbot County",4,53,452,216,236
050,24,041,"Maryland","Talbot County",4,54,432,208,224
050,24,041,"Maryland","Talbot County",4,55,493,230,263
050,24,041,"Maryland","Talbot County",4,56,525,255,270
050,24,041,"Maryland","Talbot County",4,57,566,246,320
050,24,041,"Maryland","Talbot County",4,58,556,243,313
050,24,041,"Maryland","Talbot County",4,59,572,271,301
050,24,041,"Maryland","Talbot County",4,60,595,284,311
050,24,041,"Maryland","Talbot County",4,61,598,285,313
050,24,041,"Maryland","Talbot County",4,62,602,301,301
050,24,041,"Maryland","Talbot County",4,63,583,270,313
050,24,041,"Maryland","Talbot County",4,64,605,265,340
050,24,041,"Maryland","Talbot County",4,65,614,275,339
050,24,041,"Maryland","Talbot County",4,66,587,259,328
050,24,041,"Maryland","Talbot County",4,67,613,262,351
050,24,041,"Maryland","Talbot County",4,68,580,281,299
050,24,041,"Maryland","Talbot County",4,69,589,268,321
050,24,041,"Maryland","Talbot County",4,70,598,254,344
050,24,041,"Maryland","Talbot County",4,71,566,248,318
050,24,041,"Maryland","Talbot County",4,72,519,238,281
050,24,041,"Maryland","Talbot County",4,73,551,241,310
050,24,041,"Maryland","Talbot County",4,74,577,264,313
050,24,041,"Maryland","Talbot County",4,75,665,314,351
050,24,041,"Maryland","Talbot County",4,76,439,204,235
050,24,041,"Maryland","Talbot County",4,77,455,200,255
050,24,041,"Maryland","Talbot County",4,78,454,196,258
050,24,041,"Maryland","Talbot County",4,79,479,211,268
050,24,041,"Maryland","Talbot County",4,80,393,175,218
050,24,041,"Maryland","Talbot County",4,81,354,162,192
050,24,041,"Maryland","Talbot County",4,82,323,147,176
050,24,041,"Maryland","Talbot County",4,83,284,133,151
050,24,041,"Maryland","Talbot County",4,84,232,92,140
050,24,041,"Maryland","Talbot County",4,85,1438,618,820
050,24,041,"Maryland","Talbot County",5,0,308,153,155
050,24,041,"Maryland","Talbot County",5,1,327,147,180
050,24,041,"Maryland","Talbot County",5,2,356,181,175
050,24,041,"Maryland","Talbot County",5,3,378,186,192
050,24,041,"Maryland","Talbot County",5,4,388,198,190
050,24,041,"Maryland","Talbot County",5,5,390,182,208
050,24,041,"Maryland","Talbot County",5,6,386,193,193
050,24,041,"Maryland","Talbot County",5,7,378,205,173
050,24,041,"Maryland","Talbot County",5,8,345,197,148
050,24,041,"Maryland","Talbot County",5,9,392,186,206
050,24,041,"Maryland","Talbot County",5,10,399,207,192
050,24,041,"Maryland","Talbot County",5,11,350,170,180
050,24,041,"Maryland","Talbot County",5,12,402,216,186
050,24,041,"Maryland","Talbot County",5,13,413,221,192
050,24,041,"Maryland","Talbot County",5,14,419,230,189
050,24,041,"Maryland","Talbot County",5,15,450,217,233
050,24,041,"Maryland","Talbot County",5,16,420,234,186
050,24,041,"Maryland","Talbot County",5,17,425,220,205
050,24,041,"Maryland","Talbot County",5,18,369,189,180
050,24,041,"Maryland","Talbot County",5,19,322,154,168
050,24,041,"Maryland","Talbot County",5,20,342,171,171
050,24,041,"Maryland","Talbot County",5,21,339,170,169
050,24,041,"Maryland","Talbot County",5,22,351,183,168
050,24,041,"Maryland","Talbot County",5,23,380,185,195
050,24,041,"Maryland","Talbot County",5,24,330,174,156
050,24,041,"Maryland","Talbot County",5,25,332,178,154
050,24,041,"Maryland","Talbot County",5,26,350,172,178
050,24,041,"Maryland","Talbot County",5,27,296,148,148
050,24,041,"Maryland","Talbot County",5,28,337,169,168
050,24,041,"Maryland","Talbot County",5,29,357,173,184
050,24,041,"Maryland","Talbot County",5,30,352,183,169
050,24,041,"Maryland","Talbot County",5,31,348,177,171
050,24,041,"Maryland","Talbot County",5,32,410,207,203
050,24,041,"Maryland","Talbot County",5,33,393,176,217
050,24,041,"Maryland","Talbot County",5,34,402,194,208
050,24,041,"Maryland","Talbot County",5,35,381,178,203
050,24,041,"Maryland","Talbot County",5,36,388,203,185
050,24,041,"Maryland","Talbot County",5,37,366,174,192
050,24,041,"Maryland","Talbot County",5,38,374,168,206
050,24,041,"Maryland","Talbot County",5,39,360,176,184
050,24,041,"Maryland","Talbot County",5,40,383,202,181
050,24,041,"Maryland","Talbot County",5,41,408,214,194
050,24,041,"Maryland","Talbot County",5,42,412,213,199
050,24,041,"Maryland","Talbot County",5,43,364,175,189
050,24,041,"Maryland","Talbot County",5,44,380,188,192
050,24,041,"Maryland","Talbot County",5,45,373,183,190
050,24,041,"Maryland","Talbot County",5,46,338,165,173
050,24,041,"Maryland","Talbot County",5,47,366,176,190
050,24,041,"Maryland","Talbot County",5,48,388,190,198
050,24,041,"Maryland","Talbot County",5,49,360,165,195
050,24,041,"Maryland","Talbot County",5,50,366,165,201
050,24,041,"Maryland","Talbot County",5,51,430,197,233
050,24,041,"Maryland","Talbot County",5,52,455,226,229
050,24,041,"Maryland","Talbot County",5,53,450,214,236
050,24,041,"Maryland","Talbot County",5,54,458,223,235
050,24,041,"Maryland","Talbot County",5,55,437,214,223
050,24,041,"Maryland","Talbot County",5,56,502,238,264
050,24,041,"Maryland","Talbot County",5,57,521,251,270
050,24,041,"Maryland","Talbot County",5,58,579,255,324
050,24,041,"Maryland","Talbot County",5,59,561,249,312
050,24,041,"Maryland","Talbot County",5,60,585,281,304
050,24,041,"Maryland","Talbot County",5,61,604,282,322
050,24,041,"Maryland","Talbot County",5,62,600,286,314
050,24,041,"Maryland","Talbot County",5,63,597,299,298
050,24,041,"Maryland","Talbot County",5,64,579,265,314
050,24,041,"Maryland","Talbot County",5,65,606,265,341
050,24,041,"Maryland","Talbot County",5,66,622,270,352
050,24,041,"Maryland","Talbot County",5,67,589,253,336
050,24,041,"Maryland","Talbot County",5,68,614,265,349
050,24,041,"Maryland","Talbot County",5,69,577,271,306
050,24,041,"Maryland","Talbot County",5,70,587,275,312
050,24,041,"Maryland","Talbot County",5,71,602,251,351
050,24,041,"Maryland","Talbot County",5,72,559,241,318
050,24,041,"Maryland","Talbot County",5,73,514,235,279
050,24,041,"Maryland","Talbot County",5,74,560,241,319
050,24,041,"Maryland","Talbot County",5,75,565,255,310
050,24,041,"Maryland","Talbot County",5,76,650,310,340
050,24,041,"Maryland","Talbot County",5,77,425,196,229
050,24,041,"Maryland","Talbot County",5,78,431,185,246
050,24,041,"Maryland","Talbot County",5,79,423,183,240
050,24,041,"Maryland","Talbot County",5,80,451,200,251
050,24,041,"Maryland","Talbot County",5,81,376,167,209
050,24,041,"Maryland","Talbot County",5,82,343,154,189
050,24,041,"Maryland","Talbot County",5,83,305,140,165
050,24,041,"Maryland","Talbot County",5,84,258,119,139
050,24,041,"Maryland","Talbot County",5,85,1465,631,834
050,24,043,"Maryland","Washington County",1,0,1690,862,828
050,24,043,"Maryland","Washington County",1,1,1744,900,844
050,24,043,"Maryland","Washington County",1,2,1744,901,843
050,24,043,"Maryland","Washington County",1,3,1674,851,823
050,24,043,"Maryland","Washington County",1,4,1829,953,876
050,24,043,"Maryland","Washington County",1,5,1861,934,927
050,24,043,"Maryland","Washington County",1,6,1877,950,927
050,24,043,"Maryland","Washington County",1,7,1883,1010,873
050,24,043,"Maryland","Washington County",1,8,1865,956,909
050,24,043,"Maryland","Washington County",1,9,1891,937,954
050,24,043,"Maryland","Washington County",1,10,1900,940,960
050,24,043,"Maryland","Washington County",1,11,1929,973,956
050,24,043,"Maryland","Washington County",1,12,2075,1011,1064
050,24,043,"Maryland","Washington County",1,13,2060,1072,988
050,24,043,"Maryland","Washington County",1,14,1983,1023,960
050,24,043,"Maryland","Washington County",1,15,2024,1026,998
050,24,043,"Maryland","Washington County",1,16,2075,1067,1008
050,24,043,"Maryland","Washington County",1,17,2095,1076,1019
050,24,043,"Maryland","Washington County",1,18,1793,977,816
050,24,043,"Maryland","Washington County",1,19,1532,834,698
050,24,043,"Maryland","Washington County",1,20,1716,956,760
050,24,043,"Maryland","Washington County",1,21,1748,977,771
050,24,043,"Maryland","Washington County",1,22,1787,981,806
050,24,043,"Maryland","Washington County",1,23,1868,984,884
050,24,043,"Maryland","Washington County",1,24,1930,1060,870
050,24,043,"Maryland","Washington County",1,25,1877,1024,853
050,24,043,"Maryland","Washington County",1,26,1953,1073,880
050,24,043,"Maryland","Washington County",1,27,1968,1056,912
050,24,043,"Maryland","Washington County",1,28,2059,1094,965
050,24,043,"Maryland","Washington County",1,29,2057,1086,971
050,24,043,"Maryland","Washington County",1,30,2025,1076,949
050,24,043,"Maryland","Washington County",1,31,1935,1052,883
050,24,043,"Maryland","Washington County",1,32,1937,1023,914
050,24,043,"Maryland","Washington County",1,33,1985,1029,956
050,24,043,"Maryland","Washington County",1,34,2001,1048,953
050,24,043,"Maryland","Washington County",1,35,1980,1045,935
050,24,043,"Maryland","Washington County",1,36,1918,1047,871
050,24,043,"Maryland","Washington County",1,37,1943,1051,892
050,24,043,"Maryland","Washington County",1,38,1957,1051,906
050,24,043,"Maryland","Washington County",1,39,1994,1081,913
050,24,043,"Maryland","Washington County",1,40,1969,1061,908
050,24,043,"Maryland","Washington County",1,41,1908,997,911
050,24,043,"Maryland","Washington County",1,42,1894,1028,866
050,24,043,"Maryland","Washington County",1,43,1839,1009,830
050,24,043,"Maryland","Washington County",1,44,1802,954,848
050,24,043,"Maryland","Washington County",1,45,1845,965,880
050,24,043,"Maryland","Washington County",1,46,1851,988,863
050,24,043,"Maryland","Washington County",1,47,1969,1044,925
050,24,043,"Maryland","Washington County",1,48,2128,1096,1032
050,24,043,"Maryland","Washington County",1,49,2334,1238,1096
050,24,043,"Maryland","Washington County",1,50,2243,1193,1050
050,24,043,"Maryland","Washington County",1,51,2221,1143,1078
050,24,043,"Maryland","Washington County",1,52,2054,1030,1024
050,24,043,"Maryland","Washington County",1,53,2103,1070,1033
050,24,043,"Maryland","Washington County",1,54,2173,1103,1070
050,24,043,"Maryland","Washington County",1,55,2248,1138,1110
050,24,043,"Maryland","Washington County",1,56,2320,1145,1175
050,24,043,"Maryland","Washington County",1,57,2250,1115,1135
050,24,043,"Maryland","Washington County",1,58,2284,1137,1147
050,24,043,"Maryland","Washington County",1,59,2168,1101,1067
050,24,043,"Maryland","Washington County",1,60,2044,1011,1033
050,24,043,"Maryland","Washington County",1,61,2075,1074,1001
050,24,043,"Maryland","Washington County",1,62,2076,1058,1018
050,24,043,"Maryland","Washington County",1,63,1941,971,970
050,24,043,"Maryland","Washington County",1,64,1919,959,960
050,24,043,"Maryland","Washington County",1,65,1858,925,933
050,24,043,"Maryland","Washington County",1,66,1711,833,878
050,24,043,"Maryland","Washington County",1,67,1700,824,876
050,24,043,"Maryland","Washington County",1,68,1657,788,869
050,24,043,"Maryland","Washington County",1,69,1574,760,814
050,24,043,"Maryland","Washington County",1,70,1501,714,787
050,24,043,"Maryland","Washington County",1,71,1441,675,766
050,24,043,"Maryland","Washington County",1,72,1474,668,806
050,24,043,"Maryland","Washington County",1,73,1475,686,789
050,24,043,"Maryland","Washington County",1,74,1044,495,549
050,24,043,"Maryland","Washington County",1,75,1038,482,556
050,24,043,"Maryland","Washington County",1,76,1037,469,568
050,24,043,"Maryland","Washington County",1,77,1047,463,584
050,24,043,"Maryland","Washington County",1,78,898,403,495
050,24,043,"Maryland","Washington County",1,79,800,344,456
050,24,043,"Maryland","Washington County",1,80,706,293,413
050,24,043,"Maryland","Washington County",1,81,707,284,423
050,24,043,"Maryland","Washington County",1,82,671,281,390
050,24,043,"Maryland","Washington County",1,83,571,232,339
050,24,043,"Maryland","Washington County",1,84,533,222,311
050,24,043,"Maryland","Washington County",1,85,3441,1183,2258
050,24,043,"Maryland","Washington County",2,0,1695,874,821
050,24,043,"Maryland","Washington County",2,1,1725,884,841
050,24,043,"Maryland","Washington County",2,2,1742,895,847
050,24,043,"Maryland","Washington County",2,3,1692,865,827
050,24,043,"Maryland","Washington County",2,4,1797,934,863
050,24,043,"Maryland","Washington County",2,5,1858,942,916
050,24,043,"Maryland","Washington County",2,6,1879,950,929
050,24,043,"Maryland","Washington County",2,7,1878,994,884
050,24,043,"Maryland","Washington County",2,8,1862,967,895
050,24,043,"Maryland","Washington County",2,9,1888,944,944
050,24,043,"Maryland","Washington County",2,10,1901,940,961
050,24,043,"Maryland","Washington County",2,11,1916,964,952
050,24,043,"Maryland","Washington County",2,12,2049,1005,1044
050,24,043,"Maryland","Washington County",2,13,2060,1052,1008
050,24,043,"Maryland","Washington County",2,14,2005,1036,969
050,24,043,"Maryland","Washington County",2,15,2021,1028,993
050,24,043,"Maryland","Washington County",2,16,2078,1071,1007
050,24,043,"Maryland","Washington County",2,17,2098,1079,1019
050,24,043,"Maryland","Washington County",2,18,1789,972,817
050,24,043,"Maryland","Washington County",2,19,1531,838,693
050,24,043,"Maryland","Washington County",2,20,1732,965,767
050,24,043,"Maryland","Washington County",2,21,1750,977,773
050,24,043,"Maryland","Washington County",2,22,1810,998,812
050,24,043,"Maryland","Washington County",2,23,1869,993,876
050,24,043,"Maryland","Washington County",2,24,1901,1029,872
050,24,043,"Maryland","Washington County",2,25,1890,1034,856
050,24,043,"Maryland","Washington County",2,26,1945,1069,876
050,24,043,"Maryland","Washington County",2,27,1962,1057,905
050,24,043,"Maryland","Washington County",2,28,2042,1092,950
050,24,043,"Maryland","Washington County",2,29,2050,1083,967
050,24,043,"Maryland","Washington County",2,30,2047,1088,959
050,24,043,"Maryland","Washington County",2,31,1945,1046,899
050,24,043,"Maryland","Washington County",2,32,1942,1033,909
050,24,043,"Maryland","Washington County",2,33,1970,1026,944
050,24,043,"Maryland","Washington County",2,34,2003,1045,958
050,24,043,"Maryland","Washington County",2,35,1998,1055,943
050,24,043,"Maryland","Washington County",2,36,1915,1038,877
050,24,043,"Maryland","Washington County",2,37,1937,1054,883
050,24,043,"Maryland","Washington County",2,38,1955,1052,903
050,24,043,"Maryland","Washington County",2,39,1980,1071,909
050,24,043,"Maryland","Washington County",2,40,1989,1071,918
050,24,043,"Maryland","Washington County",2,41,1918,1005,913
050,24,043,"Maryland","Washington County",2,42,1887,1015,872
050,24,043,"Maryland","Washington County",2,43,1872,1026,846
050,24,043,"Maryland","Washington County",2,44,1795,957,838
050,24,043,"Maryland","Washington County",2,45,1844,968,876
050,24,043,"Maryland","Washington County",2,46,1841,979,862
050,24,043,"Maryland","Washington County",2,47,1924,1019,905
050,24,043,"Maryland","Washington County",2,48,2090,1082,1008
050,24,043,"Maryland","Washington County",2,49,2298,1220,1078
050,24,043,"Maryland","Washington County",2,50,2260,1202,1058
050,24,043,"Maryland","Washington County",2,51,2213,1143,1070
050,24,043,"Maryland","Washington County",2,52,2085,1051,1034
050,24,043,"Maryland","Washington County",2,53,2088,1058,1030
050,24,043,"Maryland","Washington County",2,54,2141,1089,1052
050,24,043,"Maryland","Washington County",2,55,2228,1124,1104
050,24,043,"Maryland","Washington County",2,56,2306,1144,1162
050,24,043,"Maryland","Washington County",2,57,2269,1122,1147
050,24,043,"Maryland","Washington County",2,58,2275,1134,1141
050,24,043,"Maryland","Washington County",2,59,2197,1113,1084
050,24,043,"Maryland","Washington County",2,60,2067,1025,1042
050,24,043,"Maryland","Washington County",2,61,2054,1052,1002
050,24,043,"Maryland","Washington County",2,62,2062,1047,1015
050,24,043,"Maryland","Washington County",2,63,1979,991,988
050,24,043,"Maryland","Washington County",2,64,1906,952,954
050,24,043,"Maryland","Washington County",2,65,1864,928,936
050,24,043,"Maryland","Washington County",2,66,1741,851,890
050,24,043,"Maryland","Washington County",2,67,1690,821,869
050,24,043,"Maryland","Washington County",2,68,1644,784,860
050,24,043,"Maryland","Washington County",2,69,1605,771,834
050,24,043,"Maryland","Washington County",2,70,1496,714,782
050,24,043,"Maryland","Washington County",2,71,1447,682,765
050,24,043,"Maryland","Washington County",2,72,1439,659,780
050,24,043,"Maryland","Washington County",2,73,1544,712,832
050,24,043,"Maryland","Washington County",2,74,1075,509,566
050,24,043,"Maryland","Washington County",2,75,1035,480,555
050,24,043,"Maryland","Washington County",2,76,1023,468,555
050,24,043,"Maryland","Washington County",2,77,1054,467,587
050,24,043,"Maryland","Washington County",2,78,915,407,508
050,24,043,"Maryland","Washington County",2,79,815,355,460
050,24,043,"Maryland","Washington County",2,80,717,300,417
050,24,043,"Maryland","Washington County",2,81,687,278,409
050,24,043,"Maryland","Washington County",2,82,673,284,389
050,24,043,"Maryland","Washington County",2,83,587,233,354
050,24,043,"Maryland","Washington County",2,84,530,221,309
050,24,043,"Maryland","Washington County",2,85,3421,1180,2241
050,24,043,"Maryland","Washington County",3,0,1622,812,810
050,24,043,"Maryland","Washington County",3,1,1722,884,838
050,24,043,"Maryland","Washington County",3,2,1741,910,831
050,24,043,"Maryland","Washington County",3,3,1782,906,876
050,24,043,"Maryland","Washington County",3,4,1717,877,840
050,24,043,"Maryland","Washington County",3,5,1808,928,880
050,24,043,"Maryland","Washington County",3,6,1859,940,919
050,24,043,"Maryland","Washington County",3,7,1876,958,918
050,24,043,"Maryland","Washington County",3,8,1889,1000,889
050,24,043,"Maryland","Washington County",3,9,1867,964,903
050,24,043,"Maryland","Washington County",3,10,1879,941,938
050,24,043,"Maryland","Washington County",3,11,1912,951,961
050,24,043,"Maryland","Washington County",3,12,1931,960,971
050,24,043,"Maryland","Washington County",3,13,2042,1012,1030
050,24,043,"Maryland","Washington County",3,14,2070,1072,998
050,24,043,"Maryland","Washington County",3,15,2049,1067,982
050,24,043,"Maryland","Washington County",3,16,2052,1061,991
050,24,043,"Maryland","Washington County",3,17,2104,1089,1015
050,24,043,"Maryland","Washington County",3,18,1854,989,865
050,24,043,"Maryland","Washington County",3,19,1523,835,688
050,24,043,"Maryland","Washington County",3,20,1710,955,755
050,24,043,"Maryland","Washington County",3,21,1808,993,815
050,24,043,"Maryland","Washington County",3,22,1894,1069,825
050,24,043,"Maryland","Washington County",3,23,1887,1022,865
050,24,043,"Maryland","Washington County",3,24,1899,1020,879
050,24,043,"Maryland","Washington County",3,25,1914,1053,861
050,24,043,"Maryland","Washington County",3,26,1926,1046,880
050,24,043,"Maryland","Washington County",3,27,1989,1093,896
050,24,043,"Maryland","Washington County",3,28,1995,1074,921
050,24,043,"Maryland","Washington County",3,29,2029,1100,929
050,24,043,"Maryland","Washington County",3,30,2083,1096,987
050,24,043,"Maryland","Washington County",3,31,2021,1032,989
050,24,043,"Maryland","Washington County",3,32,1992,1076,916
050,24,043,"Maryland","Washington County",3,33,1956,1055,901
050,24,043,"Maryland","Washington County",3,34,2025,1055,970
050,24,043,"Maryland","Washington County",3,35,2048,1057,991
050,24,043,"Maryland","Washington County",3,36,2024,1059,965
050,24,043,"Maryland","Washington County",3,37,1971,1084,887
050,24,043,"Maryland","Washington County",3,38,1976,1067,909
050,24,043,"Maryland","Washington County",3,39,1953,1054,899
050,24,043,"Maryland","Washington County",3,40,1975,1074,901
050,24,043,"Maryland","Washington County",3,41,1992,1072,920
050,24,043,"Maryland","Washington County",3,42,1928,1018,910
050,24,043,"Maryland","Washington County",3,43,1914,1047,867
050,24,043,"Maryland","Washington County",3,44,1860,1006,854
050,24,043,"Maryland","Washington County",3,45,1810,983,827
050,24,043,"Maryland","Washington County",3,46,1827,951,876
050,24,043,"Maryland","Washington County",3,47,1803,947,856
050,24,043,"Maryland","Washington County",3,48,1920,1015,905
050,24,043,"Maryland","Washington County",3,49,2108,1104,1004
050,24,043,"Maryland","Washington County",3,50,2259,1195,1064
050,24,043,"Maryland","Washington County",3,51,2234,1169,1065
050,24,043,"Maryland","Washington County",3,52,2205,1129,1076
050,24,043,"Maryland","Washington County",3,53,2089,1041,1048
050,24,043,"Maryland","Washington County",3,54,2046,1029,1017
050,24,043,"Maryland","Washington County",3,55,2087,1054,1033
050,24,043,"Maryland","Washington County",3,56,2221,1112,1109
050,24,043,"Maryland","Washington County",3,57,2282,1131,1151
050,24,043,"Maryland","Washington County",3,58,2256,1113,1143
050,24,043,"Maryland","Washington County",3,59,2206,1103,1103
050,24,043,"Maryland","Washington County",3,60,2177,1101,1076
050,24,043,"Maryland","Washington County",3,61,2065,1026,1039
050,24,043,"Maryland","Washington County",3,62,2022,1024,998
050,24,043,"Maryland","Washington County",3,63,2029,1021,1008
050,24,043,"Maryland","Washington County",3,64,1946,971,975
050,24,043,"Maryland","Washington County",3,65,1890,946,944
050,24,043,"Maryland","Washington County",3,66,1825,903,922
050,24,043,"Maryland","Washington County",3,67,1716,836,880
050,24,043,"Maryland","Washington County",3,68,1637,782,855
050,24,043,"Maryland","Washington County",3,69,1629,770,859
050,24,043,"Maryland","Washington County",3,70,1562,753,809
050,24,043,"Maryland","Washington County",3,71,1427,682,745
050,24,043,"Maryland","Washington County",3,72,1414,673,741
050,24,043,"Maryland","Washington County",3,73,1416,637,779
050,24,043,"Maryland","Washington County",3,74,1482,681,801
050,24,043,"Maryland","Washington County",3,75,1042,477,565
050,24,043,"Maryland","Washington County",3,76,1009,462,547
050,24,043,"Maryland","Washington County",3,77,947,420,527
050,24,043,"Maryland","Washington County",3,78,1015,436,579
050,24,043,"Maryland","Washington County",3,79,861,381,480
050,24,043,"Maryland","Washington County",3,80,749,316,433
050,24,043,"Maryland","Washington County",3,81,665,281,384
050,24,043,"Maryland","Washington County",3,82,663,281,382
050,24,043,"Maryland","Washington County",3,83,629,247,382
050,24,043,"Maryland","Washington County",3,84,541,213,328
050,24,043,"Maryland","Washington County",3,85,3364,1156,2208
050,24,043,"Maryland","Washington County",4,0,1578,817,761
050,24,043,"Maryland","Washington County",4,1,1659,863,796
050,24,043,"Maryland","Washington County",4,2,1702,877,825
050,24,043,"Maryland","Washington County",4,3,1782,921,861
050,24,043,"Maryland","Washington County",4,4,1782,909,873
050,24,043,"Maryland","Washington County",4,5,1747,907,840
050,24,043,"Maryland","Washington County",4,6,1819,925,894
050,24,043,"Maryland","Washington County",4,7,1892,957,935
050,24,043,"Maryland","Washington County",4,8,1897,968,929
050,24,043,"Maryland","Washington County",4,9,1939,1011,928
050,24,043,"Maryland","Washington County",4,10,1888,961,927
050,24,043,"Maryland","Washington County",4,11,1897,964,933
050,24,043,"Maryland","Washington County",4,12,1892,941,951
050,24,043,"Maryland","Washington County",4,13,1933,963,970
050,24,043,"Maryland","Washington County",4,14,2073,1030,1043
050,24,043,"Maryland","Washington County",4,15,2100,1078,1022
050,24,043,"Maryland","Washington County",4,16,2103,1103,1000
050,24,043,"Maryland","Washington County",4,17,2098,1078,1020
050,24,043,"Maryland","Washington County",4,18,1799,969,830
050,24,043,"Maryland","Washington County",4,19,1493,807,686
050,24,043,"Maryland","Washington County",4,20,1684,941,743
050,24,043,"Maryland","Washington County",4,21,1786,984,802
050,24,043,"Maryland","Washington County",4,22,1923,1074,849
050,24,043,"Maryland","Washington County",4,23,1956,1077,879
050,24,043,"Maryland","Washington County",4,24,1917,1039,878
050,24,043,"Maryland","Washington County",4,25,1963,1077,886
050,24,043,"Maryland","Washington County",4,26,1950,1061,889
050,24,043,"Maryland","Washington County",4,27,1914,1023,891
050,24,043,"Maryland","Washington County",4,28,1986,1086,900
050,24,043,"Maryland","Washington County",4,29,1964,1043,921
050,24,043,"Maryland","Washington County",4,30,2083,1116,967
050,24,043,"Maryland","Washington County",4,31,2064,1072,992
050,24,043,"Maryland","Washington County",4,32,2078,1078,1000
050,24,043,"Maryland","Washington County",4,33,1997,1092,905
050,24,043,"Maryland","Washington County",4,34,2034,1086,948
050,24,043,"Maryland","Washington County",4,35,2027,1049,978
050,24,043,"Maryland","Washington County",4,36,2079,1083,996
050,24,043,"Maryland","Washington County",4,37,2067,1092,975
050,24,043,"Maryland","Washington County",4,38,1993,1094,899
050,24,043,"Maryland","Washington County",4,39,1961,1042,919
050,24,043,"Maryland","Washington County",4,40,1961,1065,896
050,24,043,"Maryland","Washington County",4,41,1954,1056,898
050,24,043,"Maryland","Washington County",4,42,2008,1059,949
050,24,043,"Maryland","Washington County",4,43,1973,1062,911
050,24,043,"Maryland","Washington County",4,44,1910,1045,865
050,24,043,"Maryland","Washington County",4,45,1891,1032,859
050,24,043,"Maryland","Washington County",4,46,1819,977,842
050,24,043,"Maryland","Washington County",4,47,1776,913,863
050,24,043,"Maryland","Washington County",4,48,1808,948,860
050,24,043,"Maryland","Washington County",4,49,1920,1033,887
050,24,043,"Maryland","Washington County",4,50,2070,1068,1002
050,24,043,"Maryland","Washington County",4,51,2187,1144,1043
050,24,043,"Maryland","Washington County",4,52,2198,1144,1054
050,24,043,"Maryland","Washington County",4,53,2185,1118,1067
050,24,043,"Maryland","Washington County",4,54,2061,1032,1029
050,24,043,"Maryland","Washington County",4,55,2030,1007,1023
050,24,043,"Maryland","Washington County",4,56,2092,1053,1039
050,24,043,"Maryland","Washington County",4,57,2197,1086,1111
050,24,043,"Maryland","Washington County",4,58,2265,1109,1156
050,24,043,"Maryland","Washington County",4,59,2203,1078,1125
050,24,043,"Maryland","Washington County",4,60,2170,1076,1094
050,24,043,"Maryland","Washington County",4,61,2152,1096,1056
050,24,043,"Maryland","Washington County",4,62,2011,992,1019
050,24,043,"Maryland","Washington County",4,63,1968,992,976
050,24,043,"Maryland","Washington County",4,64,1990,1008,982
050,24,043,"Maryland","Washington County",4,65,1922,963,959
050,24,043,"Maryland","Washington County",4,66,1841,918,923
050,24,043,"Maryland","Washington County",4,67,1789,882,907
050,24,043,"Maryland","Washington County",4,68,1669,800,869
050,24,043,"Maryland","Washington County",4,69,1614,758,856
050,24,043,"Maryland","Washington County",4,70,1580,743,837
050,24,043,"Maryland","Washington County",4,71,1503,717,786
050,24,043,"Maryland","Washington County",4,72,1384,669,715
050,24,043,"Maryland","Washington County",4,73,1397,658,739
050,24,043,"Maryland","Washington County",4,74,1341,606,735
050,24,043,"Maryland","Washington County",4,75,1437,651,786
050,24,043,"Maryland","Washington County",4,76,1000,452,548
050,24,043,"Maryland","Washington County",4,77,958,436,522
050,24,043,"Maryland","Washington County",4,78,902,391,511
050,24,043,"Maryland","Washington County",4,79,953,400,553
050,24,043,"Maryland","Washington County",4,80,793,345,448
050,24,043,"Maryland","Washington County",4,81,697,291,406
050,24,043,"Maryland","Washington County",4,82,636,276,360
050,24,043,"Maryland","Washington County",4,83,626,245,381
050,24,043,"Maryland","Washington County",4,84,583,233,350
050,24,043,"Maryland","Washington County",4,85,3334,1126,2208
050,24,043,"Maryland","Washington County",5,0,1553,809,744
050,24,043,"Maryland","Washington County",5,1,1586,819,767
050,24,043,"Maryland","Washington County",5,2,1637,842,795
050,24,043,"Maryland","Washington County",5,3,1757,905,852
050,24,043,"Maryland","Washington County",5,4,1803,926,877
050,24,043,"Maryland","Washington County",5,5,1850,955,895
050,24,043,"Maryland","Washington County",5,6,1789,915,874
050,24,043,"Maryland","Washington County",5,7,1831,929,902
050,24,043,"Maryland","Washington County",5,8,1894,941,953
050,24,043,"Maryland","Washington County",5,9,1875,964,911
050,24,043,"Maryland","Washington County",5,10,1970,1032,938
050,24,043,"Maryland","Washington County",5,11,1891,964,927
050,24,043,"Maryland","Washington County",5,12,1895,944,951
050,24,043,"Maryland","Washington County",5,13,1926,961,965
050,24,043,"Maryland","Washington County",5,14,1931,976,955
050,24,043,"Maryland","Washington County",5,15,2100,1051,1049
050,24,043,"Maryland","Washington County",5,16,2147,1111,1036
050,24,043,"Maryland","Washington County",5,17,2157,1141,1016
050,24,043,"Maryland","Washington County",5,18,1822,977,845
050,24,043,"Maryland","Washington County",5,19,1500,826,674
050,24,043,"Maryland","Washington County",5,20,1656,918,738
050,24,043,"Maryland","Washington County",5,21,1752,956,796
050,24,043,"Maryland","Washington County",5,22,1918,1057,861
050,24,043,"Maryland","Washington County",5,23,2024,1110,914
050,24,043,"Maryland","Washington County",5,24,2030,1117,913
050,24,043,"Maryland","Washington County",5,25,1965,1088,877
050,24,043,"Maryland","Washington County",5,26,1947,1047,900
050,24,043,"Maryland","Washington County",5,27,1945,1054,891
050,24,043,"Maryland","Washington County",5,28,1924,1035,889
050,24,043,"Maryland","Washington County",5,29,1961,1086,875
050,24,043,"Maryland","Washington County",5,30,2012,1080,932
050,24,043,"Maryland","Washington County",5,31,2027,1078,949
050,24,043,"Maryland","Washington County",5,32,2090,1092,998
050,24,043,"Maryland","Washington County",5,33,2095,1086,1009
050,24,043,"Maryland","Washington County",5,34,2061,1118,943
050,24,043,"Maryland","Washington County",5,35,2072,1108,964
050,24,043,"Maryland","Washington County",5,36,2055,1060,995
050,24,043,"Maryland","Washington County",5,37,2118,1113,1005
050,24,043,"Maryland","Washington County",5,38,2105,1110,995
050,24,043,"Maryland","Washington County",5,39,1990,1077,913
050,24,043,"Maryland","Washington County",5,40,1989,1048,941
050,24,043,"Maryland","Washington County",5,41,1979,1073,906
050,24,043,"Maryland","Washington County",5,42,1982,1056,926
050,24,043,"Maryland","Washington County",5,43,2026,1091,935
050,24,043,"Maryland","Washington County",5,44,1952,1044,908
050,24,043,"Maryland","Washington County",5,45,1939,1067,872
050,24,043,"Maryland","Washington County",5,46,1893,1034,859
050,24,043,"Maryland","Washington County",5,47,1778,939,839
050,24,043,"Maryland","Washington County",5,48,1754,899,855
050,24,043,"Maryland","Washington County",5,49,1819,963,856
050,24,043,"Maryland","Washington County",5,50,1915,1028,887
050,24,043,"Maryland","Washington County",5,51,2074,1064,1010
050,24,043,"Maryland","Washington County",5,52,2172,1127,1045
050,24,043,"Maryland","Washington County",5,53,2188,1137,1051
050,24,043,"Maryland","Washington County",5,54,2194,1134,1060
050,24,043,"Maryland","Washington County",5,55,2022,994,1028
050,24,043,"Maryland","Washington County",5,56,2024,999,1025
050,24,043,"Maryland","Washington County",5,57,2080,1049,1031
050,24,043,"Maryland","Washington County",5,58,2162,1061,1101
050,24,043,"Maryland","Washington County",5,59,2208,1078,1130
050,24,043,"Maryland","Washington County",5,60,2186,1057,1129
050,24,043,"Maryland","Washington County",5,61,2164,1075,1089
050,24,043,"Maryland","Washington County",5,62,2104,1053,1051
050,24,043,"Maryland","Washington County",5,63,1989,972,1017
050,24,043,"Maryland","Washington County",5,64,1942,989,953
050,24,043,"Maryland","Washington County",5,65,1988,1005,983
050,24,043,"Maryland","Washington County",5,66,1892,933,959
050,24,043,"Maryland","Washington County",5,67,1804,901,903
050,24,043,"Maryland","Washington County",5,68,1736,839,897
050,24,043,"Maryland","Washington County",5,69,1636,768,868
050,24,043,"Maryland","Washington County",5,70,1581,738,843
050,24,043,"Maryland","Washington County",5,71,1537,716,821
050,24,043,"Maryland","Washington County",5,72,1470,706,764
050,24,043,"Maryland","Washington County",5,73,1379,660,719
050,24,043,"Maryland","Washington County",5,74,1342,630,712
050,24,043,"Maryland","Washington County",5,75,1307,586,721
050,24,043,"Maryland","Washington County",5,76,1404,635,769
050,24,043,"Maryland","Washington County",5,77,953,423,530
050,24,043,"Maryland","Washington County",5,78,909,406,503
050,24,043,"Maryland","Washington County",5,79,846,362,484
050,24,043,"Maryland","Washington County",5,80,898,369,529
050,24,043,"Maryland","Washington County",5,81,743,319,424
050,24,043,"Maryland","Washington County",5,82,667,284,383
050,24,043,"Maryland","Washington County",5,83,592,237,355
050,24,043,"Maryland","Washington County",5,84,584,229,355
050,24,043,"Maryland","Washington County",5,85,3349,1125,2224
050,24,045,"Maryland","Wicomico County",1,0,1273,640,633
050,24,045,"Maryland","Wicomico County",1,1,1258,617,641
050,24,045,"Maryland","Wicomico County",1,2,1264,638,626
050,24,045,"Maryland","Wicomico County",1,3,1299,676,623
050,24,045,"Maryland","Wicomico County",1,4,1364,668,696
050,24,045,"Maryland","Wicomico County",1,5,1251,606,645
050,24,045,"Maryland","Wicomico County",1,6,1257,624,633
050,24,045,"Maryland","Wicomico County",1,7,1273,647,626
050,24,045,"Maryland","Wicomico County",1,8,1243,626,617
050,24,045,"Maryland","Wicomico County",1,9,1291,672,619
050,24,045,"Maryland","Wicomico County",1,10,1308,676,632
050,24,045,"Maryland","Wicomico County",1,11,1391,698,693
050,24,045,"Maryland","Wicomico County",1,12,1383,718,665
050,24,045,"Maryland","Wicomico County",1,13,1362,709,653
050,24,045,"Maryland","Wicomico County",1,14,1278,619,659
050,24,045,"Maryland","Wicomico County",1,15,1283,633,650
050,24,045,"Maryland","Wicomico County",1,16,1336,663,673
050,24,045,"Maryland","Wicomico County",1,17,1350,694,656
050,24,045,"Maryland","Wicomico County",1,18,2244,980,1264
050,24,045,"Maryland","Wicomico County",1,19,2266,1080,1186
050,24,045,"Maryland","Wicomico County",1,20,2461,1122,1339
050,24,045,"Maryland","Wicomico County",1,21,2128,986,1142
050,24,045,"Maryland","Wicomico County",1,22,2013,963,1050
050,24,045,"Maryland","Wicomico County",1,23,1784,830,954
050,24,045,"Maryland","Wicomico County",1,24,1482,696,786
050,24,045,"Maryland","Wicomico County",1,25,1396,663,733
050,24,045,"Maryland","Wicomico County",1,26,1361,673,688
050,24,045,"Maryland","Wicomico County",1,27,1339,661,678
050,24,045,"Maryland","Wicomico County",1,28,1301,609,692
050,24,045,"Maryland","Wicomico County",1,29,1329,635,694
050,24,045,"Maryland","Wicomico County",1,30,1267,609,658
050,24,045,"Maryland","Wicomico County",1,31,1178,572,606
050,24,045,"Maryland","Wicomico County",1,32,1145,563,582
050,24,045,"Maryland","Wicomico County",1,33,1098,530,568
050,24,045,"Maryland","Wicomico County",1,34,1166,596,570
050,24,045,"Maryland","Wicomico County",1,35,1153,550,603
050,24,045,"Maryland","Wicomico County",1,36,1198,584,614
050,24,045,"Maryland","Wicomico County",1,37,1207,572,635
050,24,045,"Maryland","Wicomico County",1,38,1167,544,623
050,24,045,"Maryland","Wicomico County",1,39,1212,583,629
050,24,045,"Maryland","Wicomico County",1,40,1219,583,636
050,24,045,"Maryland","Wicomico County",1,41,1164,561,603
050,24,045,"Maryland","Wicomico County",1,42,1137,543,594
050,24,045,"Maryland","Wicomico County",1,43,1131,539,592
050,24,045,"Maryland","Wicomico County",1,44,1046,485,561
050,24,045,"Maryland","Wicomico County",1,45,1058,475,583
050,24,045,"Maryland","Wicomico County",1,46,1031,473,558
050,24,045,"Maryland","Wicomico County",1,47,1124,522,602
050,24,045,"Maryland","Wicomico County",1,48,1203,589,614
050,24,045,"Maryland","Wicomico County",1,49,1245,627,618
050,24,045,"Maryland","Wicomico County",1,50,1220,614,606
050,24,045,"Maryland","Wicomico County",1,51,1200,582,618
050,24,045,"Maryland","Wicomico County",1,52,1130,542,588
050,24,045,"Maryland","Wicomico County",1,53,1204,553,651
050,24,045,"Maryland","Wicomico County",1,54,1291,606,685
050,24,045,"Maryland","Wicomico County",1,55,1316,633,683
050,24,045,"Maryland","Wicomico County",1,56,1348,676,672
050,24,045,"Maryland","Wicomico County",1,57,1326,649,677
050,24,045,"Maryland","Wicomico County",1,58,1350,629,721
050,24,045,"Maryland","Wicomico County",1,59,1321,597,724
050,24,045,"Maryland","Wicomico County",1,60,1289,603,686
050,24,045,"Maryland","Wicomico County",1,61,1322,627,695
050,24,045,"Maryland","Wicomico County",1,62,1309,626,683
050,24,045,"Maryland","Wicomico County",1,63,1301,627,674
050,24,045,"Maryland","Wicomico County",1,64,1228,577,651
050,24,045,"Maryland","Wicomico County",1,65,1235,575,660
050,24,045,"Maryland","Wicomico County",1,66,1246,572,674
050,24,045,"Maryland","Wicomico County",1,67,1123,527,596
050,24,045,"Maryland","Wicomico County",1,68,1055,491,564
050,24,045,"Maryland","Wicomico County",1,69,953,426,527
050,24,045,"Maryland","Wicomico County",1,70,994,482,512
050,24,045,"Maryland","Wicomico County",1,71,935,438,497
050,24,045,"Maryland","Wicomico County",1,72,943,428,515
050,24,045,"Maryland","Wicomico County",1,73,981,435,546
050,24,045,"Maryland","Wicomico County",1,74,697,308,389
050,24,045,"Maryland","Wicomico County",1,75,682,305,377
050,24,045,"Maryland","Wicomico County",1,76,664,304,360
050,24,045,"Maryland","Wicomico County",1,77,650,298,352
050,24,045,"Maryland","Wicomico County",1,78,554,248,306
050,24,045,"Maryland","Wicomico County",1,79,489,217,272
050,24,045,"Maryland","Wicomico County",1,80,425,187,238
050,24,045,"Maryland","Wicomico County",1,81,400,161,239
050,24,045,"Maryland","Wicomico County",1,82,350,138,212
050,24,045,"Maryland","Wicomico County",1,83,309,115,194
050,24,045,"Maryland","Wicomico County",1,84,282,111,171
050,24,045,"Maryland","Wicomico County",1,85,1749,612,1137
050,24,045,"Maryland","Wicomico County",2,0,1290,652,638
050,24,045,"Maryland","Wicomico County",2,1,1257,622,635
050,24,045,"Maryland","Wicomico County",2,2,1264,633,631
050,24,045,"Maryland","Wicomico County",2,3,1287,666,621
050,24,045,"Maryland","Wicomico County",2,4,1348,671,677
050,24,045,"Maryland","Wicomico County",2,5,1280,623,657
050,24,045,"Maryland","Wicomico County",2,6,1256,624,632
050,24,045,"Maryland","Wicomico County",2,7,1264,640,624
050,24,045,"Maryland","Wicomico County",2,8,1251,629,622
050,24,045,"Maryland","Wicomico County",2,9,1278,657,621
050,24,045,"Maryland","Wicomico County",2,10,1304,674,630
050,24,045,"Maryland","Wicomico County",2,11,1368,694,674
050,24,045,"Maryland","Wicomico County",2,12,1387,715,672
050,24,045,"Maryland","Wicomico County",2,13,1362,708,654
050,24,045,"Maryland","Wicomico County",2,14,1292,637,655
050,24,045,"Maryland","Wicomico County",2,15,1283,631,652
050,24,045,"Maryland","Wicomico County",2,16,1322,656,666
050,24,045,"Maryland","Wicomico County",2,17,1344,684,660
050,24,045,"Maryland","Wicomico County",2,18,2240,981,1259
050,24,045,"Maryland","Wicomico County",2,19,2268,1080,1188
050,24,045,"Maryland","Wicomico County",2,20,2459,1124,1335
050,24,045,"Maryland","Wicomico County",2,21,2145,993,1152
050,24,045,"Maryland","Wicomico County",2,22,2012,967,1045
050,24,045,"Maryland","Wicomico County",2,23,1787,834,953
050,24,045,"Maryland","Wicomico County",2,24,1489,697,792
050,24,045,"Maryland","Wicomico County",2,25,1385,656,729
050,24,045,"Maryland","Wicomico County",2,26,1352,671,681
050,24,045,"Maryland","Wicomico County",2,27,1322,655,667
050,24,045,"Maryland","Wicomico County",2,28,1301,615,686
050,24,045,"Maryland","Wicomico County",2,29,1317,629,688
050,24,045,"Maryland","Wicomico County",2,30,1280,612,668
050,24,045,"Maryland","Wicomico County",2,31,1190,576,614
050,24,045,"Maryland","Wicomico County",2,32,1154,565,589
050,24,045,"Maryland","Wicomico County",2,33,1110,538,572
050,24,045,"Maryland","Wicomico County",2,34,1149,580,569
050,24,045,"Maryland","Wicomico County",2,35,1165,564,601
050,24,045,"Maryland","Wicomico County",2,36,1175,570,605
050,24,045,"Maryland","Wicomico County",2,37,1206,576,630
050,24,045,"Maryland","Wicomico County",2,38,1177,554,623
050,24,045,"Maryland","Wicomico County",2,39,1192,572,620
050,24,045,"Maryland","Wicomico County",2,40,1222,585,637
050,24,045,"Maryland","Wicomico County",2,41,1174,562,612
050,24,045,"Maryland","Wicomico County",2,42,1135,543,592
050,24,045,"Maryland","Wicomico County",2,43,1138,543,595
050,24,045,"Maryland","Wicomico County",2,44,1057,495,562
050,24,045,"Maryland","Wicomico County",2,45,1060,477,583
050,24,045,"Maryland","Wicomico County",2,46,1029,467,562
050,24,045,"Maryland","Wicomico County",2,47,1095,505,590
050,24,045,"Maryland","Wicomico County",2,48,1183,573,610
050,24,045,"Maryland","Wicomico County",2,49,1241,620,621
050,24,045,"Maryland","Wicomico County",2,50,1232,621,611
050,24,045,"Maryland","Wicomico County",2,51,1195,585,610
050,24,045,"Maryland","Wicomico County",2,52,1144,548,596
050,24,045,"Maryland","Wicomico County",2,53,1191,550,641
050,24,045,"Maryland","Wicomico County",2,54,1266,593,673
050,24,045,"Maryland","Wicomico County",2,55,1308,623,685
050,24,045,"Maryland","Wicomico County",2,56,1339,662,677
050,24,045,"Maryland","Wicomico County",2,57,1336,659,677
050,24,045,"Maryland","Wicomico County",2,58,1341,630,711
050,24,045,"Maryland","Wicomico County",2,59,1331,605,726
050,24,045,"Maryland","Wicomico County",2,60,1296,603,693
050,24,045,"Maryland","Wicomico County",2,61,1302,618,684
050,24,045,"Maryland","Wicomico County",2,62,1299,620,679
050,24,045,"Maryland","Wicomico County",2,63,1312,633,679
050,24,045,"Maryland","Wicomico County",2,64,1241,588,653
050,24,045,"Maryland","Wicomico County",2,65,1231,576,655
050,24,045,"Maryland","Wicomico County",2,66,1238,568,670
050,24,045,"Maryland","Wicomico County",2,67,1146,533,613
050,24,045,"Maryland","Wicomico County",2,68,1062,497,565
050,24,045,"Maryland","Wicomico County",2,69,976,441,535
050,24,045,"Maryland","Wicomico County",2,70,979,464,515
050,24,045,"Maryland","Wicomico County",2,71,939,442,497
050,24,045,"Maryland","Wicomico County",2,72,923,421,502
050,24,045,"Maryland","Wicomico County",2,73,1007,445,562
050,24,045,"Maryland","Wicomico County",2,74,713,311,402
050,24,045,"Maryland","Wicomico County",2,75,681,303,378
050,24,045,"Maryland","Wicomico County",2,76,658,298,360
050,24,045,"Maryland","Wicomico County",2,77,657,302,355
050,24,045,"Maryland","Wicomico County",2,78,563,254,309
050,24,045,"Maryland","Wicomico County",2,79,494,219,275
050,24,045,"Maryland","Wicomico County",2,80,436,191,245
050,24,045,"Maryland","Wicomico County",2,81,398,164,234
050,24,045,"Maryland","Wicomico County",2,82,361,141,220
050,24,045,"Maryland","Wicomico County",2,83,304,116,188
050,24,045,"Maryland","Wicomico County",2,84,284,110,174
050,24,045,"Maryland","Wicomico County",2,85,1736,605,1131
050,24,045,"Maryland","Wicomico County",3,0,1190,584,606
050,24,045,"Maryland","Wicomico County",3,1,1309,661,648
050,24,045,"Maryland","Wicomico County",3,2,1289,654,635
050,24,045,"Maryland","Wicomico County",3,3,1280,652,628
050,24,045,"Maryland","Wicomico County",3,4,1287,667,620
050,24,045,"Maryland","Wicomico County",3,5,1334,671,663
050,24,045,"Maryland","Wicomico County",3,6,1295,629,666
050,24,045,"Maryland","Wicomico County",3,7,1253,621,632
050,24,045,"Maryland","Wicomico County",3,8,1266,635,631
050,24,045,"Maryland","Wicomico County",3,9,1266,644,622
050,24,045,"Maryland","Wicomico County",3,10,1302,667,635
050,24,045,"Maryland","Wicomico County",3,11,1300,665,635
050,24,045,"Maryland","Wicomico County",3,12,1341,673,668
050,24,045,"Maryland","Wicomico County",3,13,1406,728,678
050,24,045,"Maryland","Wicomico County",3,14,1371,711,660
050,24,045,"Maryland","Wicomico County",3,15,1298,639,659
050,24,045,"Maryland","Wicomico County",3,16,1277,632,645
050,24,045,"Maryland","Wicomico County",3,17,1341,667,674
050,24,045,"Maryland","Wicomico County",3,18,2303,1008,1295
050,24,045,"Maryland","Wicomico County",3,19,2241,1070,1171
050,24,045,"Maryland","Wicomico County",3,20,2438,1103,1335
050,24,045,"Maryland","Wicomico County",3,21,2233,1040,1193
050,24,045,"Maryland","Wicomico County",3,22,2032,979,1053
050,24,045,"Maryland","Wicomico County",3,23,1814,849,965
050,24,045,"Maryland","Wicomico County",3,24,1534,696,838
050,24,045,"Maryland","Wicomico County",3,25,1372,648,724
050,24,045,"Maryland","Wicomico County",3,26,1289,639,650
050,24,045,"Maryland","Wicomico County",3,27,1292,648,644
050,24,045,"Maryland","Wicomico County",3,28,1319,638,681
050,24,045,"Maryland","Wicomico County",3,29,1335,639,696
050,24,045,"Maryland","Wicomico County",3,30,1337,625,712
050,24,045,"Maryland","Wicomico County",3,31,1279,608,671
050,24,045,"Maryland","Wicomico County",3,32,1194,575,619
050,24,045,"Maryland","Wicomico County",3,33,1147,549,598
050,24,045,"Maryland","Wicomico County",3,34,1089,524,565
050,24,045,"Maryland","Wicomico County",3,35,1156,578,578
050,24,045,"Maryland","Wicomico County",3,36,1142,547,595
050,24,045,"Maryland","Wicomico County",3,37,1176,574,602
050,24,045,"Maryland","Wicomico County",3,38,1222,574,648
050,24,045,"Maryland","Wicomico County",3,39,1180,559,621
050,24,045,"Maryland","Wicomico County",3,40,1165,549,616
050,24,045,"Maryland","Wicomico County",3,41,1236,592,644
050,24,045,"Maryland","Wicomico County",3,42,1177,561,616
050,24,045,"Maryland","Wicomico County",3,43,1132,546,586
050,24,045,"Maryland","Wicomico County",3,44,1160,558,602
050,24,045,"Maryland","Wicomico County",3,45,1064,506,558
050,24,045,"Maryland","Wicomico County",3,46,1039,468,571
050,24,045,"Maryland","Wicomico County",3,47,1025,457,568
050,24,045,"Maryland","Wicomico County",3,48,1087,498,589
050,24,045,"Maryland","Wicomico County",3,49,1174,562,612
050,24,045,"Maryland","Wicomico County",3,50,1247,619,628
050,24,045,"Maryland","Wicomico County",3,51,1241,616,625
050,24,045,"Maryland","Wicomico County",3,52,1182,568,614
050,24,045,"Maryland","Wicomico County",3,53,1158,558,600
050,24,045,"Maryland","Wicomico County",3,54,1198,551,647
050,24,045,"Maryland","Wicomico County",3,55,1281,590,691
050,24,045,"Maryland","Wicomico County",3,56,1305,625,680
050,24,045,"Maryland","Wicomico County",3,57,1326,662,664
050,24,045,"Maryland","Wicomico County",3,58,1352,667,685
050,24,045,"Maryland","Wicomico County",3,59,1356,633,723
050,24,045,"Maryland","Wicomico County",3,60,1321,607,714
050,24,045,"Maryland","Wicomico County",3,61,1302,607,695
050,24,045,"Maryland","Wicomico County",3,62,1306,626,680
050,24,045,"Maryland","Wicomico County",3,63,1300,622,678
050,24,045,"Maryland","Wicomico County",3,64,1302,629,673
050,24,045,"Maryland","Wicomico County",3,65,1217,565,652
050,24,045,"Maryland","Wicomico County",3,66,1206,553,653
050,24,045,"Maryland","Wicomico County",3,67,1213,548,665
050,24,045,"Maryland","Wicomico County",3,68,1135,526,609
050,24,045,"Maryland","Wicomico County",3,69,1026,474,552
050,24,045,"Maryland","Wicomico County",3,70,958,421,537
050,24,045,"Maryland","Wicomico County",3,71,956,449,507
050,24,045,"Maryland","Wicomico County",3,72,928,436,492
050,24,045,"Maryland","Wicomico County",3,73,894,398,496
050,24,045,"Maryland","Wicomico County",3,74,969,420,549
050,24,045,"Maryland","Wicomico County",3,75,678,300,378
050,24,045,"Maryland","Wicomico County",3,76,659,294,365
050,24,045,"Maryland","Wicomico County",3,77,633,283,350
050,24,045,"Maryland","Wicomico County",3,78,628,288,340
050,24,045,"Maryland","Wicomico County",3,79,538,237,301
050,24,045,"Maryland","Wicomico County",3,80,450,199,251
050,24,045,"Maryland","Wicomico County",3,81,403,171,232
050,24,045,"Maryland","Wicomico County",3,82,378,150,228
050,24,045,"Maryland","Wicomico County",3,83,328,128,200
050,24,045,"Maryland","Wicomico County",3,84,265,101,164
050,24,045,"Maryland","Wicomico County",3,85,1687,585,1102
050,24,045,"Maryland","Wicomico County",4,0,1293,644,649
050,24,045,"Maryland","Wicomico County",4,1,1189,588,601
050,24,045,"Maryland","Wicomico County",4,2,1298,656,642
050,24,045,"Maryland","Wicomico County",4,3,1299,661,638
050,24,045,"Maryland","Wicomico County",4,4,1292,652,640
050,24,045,"Maryland","Wicomico County",4,5,1286,661,625
050,24,045,"Maryland","Wicomico County",4,6,1325,657,668
050,24,045,"Maryland","Wicomico County",4,7,1299,627,672
050,24,045,"Maryland","Wicomico County",4,8,1284,624,660
050,24,045,"Maryland","Wicomico County",4,9,1268,651,617
050,24,045,"Maryland","Wicomico County",4,10,1270,646,624
050,24,045,"Maryland","Wicomico County",4,11,1311,681,630
050,24,045,"Maryland","Wicomico County",4,12,1300,665,635
050,24,045,"Maryland","Wicomico County",4,13,1318,661,657
050,24,045,"Maryland","Wicomico County",4,14,1389,721,668
050,24,045,"Maryland","Wicomico County",4,15,1353,708,645
050,24,045,"Maryland","Wicomico County",4,16,1301,635,666
050,24,045,"Maryland","Wicomico County",4,17,1296,638,658
050,24,045,"Maryland","Wicomico County",4,18,2240,961,1279
050,24,045,"Maryland","Wicomico County",4,19,2267,1080,1187
050,24,045,"Maryland","Wicomico County",4,20,2359,1075,1284
050,24,045,"Maryland","Wicomico County",4,21,2238,1029,1209
050,24,045,"Maryland","Wicomico County",4,22,2120,1016,1104
050,24,045,"Maryland","Wicomico County",4,23,1827,875,952
050,24,045,"Maryland","Wicomico County",4,24,1561,736,825
050,24,045,"Maryland","Wicomico County",4,25,1411,639,772
050,24,045,"Maryland","Wicomico County",4,26,1273,627,646
050,24,045,"Maryland","Wicomico County",4,27,1242,606,636
050,24,045,"Maryland","Wicomico County",4,28,1272,628,644
050,24,045,"Maryland","Wicomico County",4,29,1346,657,689
050,24,045,"Maryland","Wicomico County",4,30,1349,655,694
050,24,045,"Maryland","Wicomico County",4,31,1292,607,685
050,24,045,"Maryland","Wicomico County",4,32,1330,632,698
050,24,045,"Maryland","Wicomico County",4,33,1197,560,637
050,24,045,"Maryland","Wicomico County",4,34,1148,559,589
050,24,045,"Maryland","Wicomico County",4,35,1131,553,578
050,24,045,"Maryland","Wicomico County",4,36,1169,590,579
050,24,045,"Maryland","Wicomico County",4,37,1146,550,596
050,24,045,"Maryland","Wicomico County",4,38,1157,558,599
050,24,045,"Maryland","Wicomico County",4,39,1227,577,650
050,24,045,"Maryland","Wicomico County",4,40,1166,542,624
050,24,045,"Maryland","Wicomico County",4,41,1218,573,645
050,24,045,"Maryland","Wicomico County",4,42,1231,581,650
050,24,045,"Maryland","Wicomico County",4,43,1188,565,623
050,24,045,"Maryland","Wicomico County",4,44,1124,551,573
050,24,045,"Maryland","Wicomico County",4,45,1165,551,614
050,24,045,"Maryland","Wicomico County",4,46,1062,504,558
050,24,045,"Maryland","Wicomico County",4,47,1043,473,570
050,24,045,"Maryland","Wicomico County",4,48,1014,462,552
050,24,045,"Maryland","Wicomico County",4,49,1098,499,599
050,24,045,"Maryland","Wicomico County",4,50,1186,570,616
050,24,045,"Maryland","Wicomico County",4,51,1264,636,628
050,24,045,"Maryland","Wicomico County",4,52,1236,619,617
050,24,045,"Maryland","Wicomico County",4,53,1153,540,613
050,24,045,"Maryland","Wicomico County",4,54,1154,561,593
050,24,045,"Maryland","Wicomico County",4,55,1186,544,642
050,24,045,"Maryland","Wicomico County",4,56,1287,600,687
050,24,045,"Maryland","Wicomico County",4,57,1307,629,678
050,24,045,"Maryland","Wicomico County",4,58,1335,654,681
050,24,045,"Maryland","Wicomico County",4,59,1349,676,673
050,24,045,"Maryland","Wicomico County",4,60,1341,620,721
050,24,045,"Maryland","Wicomico County",4,61,1302,598,704
050,24,045,"Maryland","Wicomico County",4,62,1281,599,682
050,24,045,"Maryland","Wicomico County",4,63,1272,609,663
050,24,045,"Maryland","Wicomico County",4,64,1287,608,679
050,24,045,"Maryland","Wicomico County",4,65,1289,625,664
050,24,045,"Maryland","Wicomico County",4,66,1186,557,629
050,24,045,"Maryland","Wicomico County",4,67,1179,525,654
050,24,045,"Maryland","Wicomico County",4,68,1190,534,656
050,24,045,"Maryland","Wicomico County",4,69,1114,504,610
050,24,045,"Maryland","Wicomico County",4,70,1018,468,550
050,24,045,"Maryland","Wicomico County",4,71,937,404,533
050,24,045,"Maryland","Wicomico County",4,72,939,442,497
050,24,045,"Maryland","Wicomico County",4,73,903,419,484
050,24,045,"Maryland","Wicomico County",4,74,862,381,481
050,24,045,"Maryland","Wicomico County",4,75,923,399,524
050,24,045,"Maryland","Wicomico County",4,76,654,287,367
050,24,045,"Maryland","Wicomico County",4,77,629,275,354
050,24,045,"Maryland","Wicomico County",4,78,600,271,329
050,24,045,"Maryland","Wicomico County",4,79,604,275,329
050,24,045,"Maryland","Wicomico County",4,80,505,223,282
050,24,045,"Maryland","Wicomico County",4,81,418,181,237
050,24,045,"Maryland","Wicomico County",4,82,378,152,226
050,24,045,"Maryland","Wicomico County",4,83,332,135,197
050,24,045,"Maryland","Wicomico County",4,84,296,115,181
050,24,045,"Maryland","Wicomico County",4,85,1608,542,1066
050,24,045,"Maryland","Wicomico County",5,0,1282,638,644
050,24,045,"Maryland","Wicomico County",5,1,1311,668,643
050,24,045,"Maryland","Wicomico County",5,2,1183,581,602
050,24,045,"Maryland","Wicomico County",5,3,1339,675,664
050,24,045,"Maryland","Wicomico County",5,4,1325,691,634
050,24,045,"Maryland","Wicomico County",5,5,1324,670,654
050,24,045,"Maryland","Wicomico County",5,6,1270,661,609
050,24,045,"Maryland","Wicomico County",5,7,1344,669,675
050,24,045,"Maryland","Wicomico County",5,8,1318,626,692
050,24,045,"Maryland","Wicomico County",5,9,1255,620,635
050,24,045,"Maryland","Wicomico County",5,10,1260,654,606
050,24,045,"Maryland","Wicomico County",5,11,1305,673,632
050,24,045,"Maryland","Wicomico County",5,12,1328,690,638
050,24,045,"Maryland","Wicomico County",5,13,1275,658,617
050,24,045,"Maryland","Wicomico County",5,14,1332,658,674
050,24,045,"Maryland","Wicomico County",5,15,1385,720,665
050,24,045,"Maryland","Wicomico County",5,16,1346,693,653
050,24,045,"Maryland","Wicomico County",5,17,1306,646,660
050,24,045,"Maryland","Wicomico County",5,18,2190,949,1241
050,24,045,"Maryland","Wicomico County",5,19,2245,1057,1188
050,24,045,"Maryland","Wicomico County",5,20,2405,1109,1296
050,24,045,"Maryland","Wicomico County",5,21,2153,1001,1152
050,24,045,"Maryland","Wicomico County",5,22,2099,1023,1076
050,24,045,"Maryland","Wicomico County",5,23,1905,897,1008
050,24,045,"Maryland","Wicomico County",5,24,1600,777,823
050,24,045,"Maryland","Wicomico County",5,25,1423,684,739
050,24,045,"Maryland","Wicomico County",5,26,1318,627,691
050,24,045,"Maryland","Wicomico County",5,27,1214,601,613
050,24,045,"Maryland","Wicomico County",5,28,1224,589,635
050,24,045,"Maryland","Wicomico County",5,29,1247,625,622
050,24,045,"Maryland","Wicomico County",5,30,1393,684,709
050,24,045,"Maryland","Wicomico County",5,31,1324,638,686
050,24,045,"Maryland","Wicomico County",5,32,1285,596,689
050,24,045,"Maryland","Wicomico County",5,33,1337,639,698
050,24,045,"Maryland","Wicomico County",5,34,1199,563,636
050,24,045,"Maryland","Wicomico County",5,35,1145,539,606
050,24,045,"Maryland","Wicomico County",5,36,1134,550,584
050,24,045,"Maryland","Wicomico County",5,37,1158,582,576
050,24,045,"Maryland","Wicomico County",5,38,1129,538,591
050,24,045,"Maryland","Wicomico County",5,39,1147,544,603
050,24,045,"Maryland","Wicomico County",5,40,1234,579,655
050,24,045,"Maryland","Wicomico County",5,41,1187,556,631
050,24,045,"Maryland","Wicomico County",5,42,1213,576,637
050,24,045,"Maryland","Wicomico County",5,43,1233,594,639
050,24,045,"Maryland","Wicomico County",5,44,1191,577,614
050,24,045,"Maryland","Wicomico County",5,45,1101,534,567
050,24,045,"Maryland","Wicomico County",5,46,1150,540,610
050,24,045,"Maryland","Wicomico County",5,47,1083,512,571
050,24,045,"Maryland","Wicomico County",5,48,1032,468,564
050,24,045,"Maryland","Wicomico County",5,49,991,445,546
050,24,045,"Maryland","Wicomico County",5,50,1094,506,588
050,24,045,"Maryland","Wicomico County",5,51,1174,569,605
050,24,045,"Maryland","Wicomico County",5,52,1248,614,634
050,24,045,"Maryland","Wicomico County",5,53,1219,604,615
050,24,045,"Maryland","Wicomico County",5,54,1143,550,593
050,24,045,"Maryland","Wicomico County",5,55,1128,543,585
050,24,045,"Maryland","Wicomico County",5,56,1165,535,630
050,24,045,"Maryland","Wicomico County",5,57,1286,604,682
050,24,045,"Maryland","Wicomico County",5,58,1321,631,690
050,24,045,"Maryland","Wicomico County",5,59,1320,642,678
050,24,045,"Maryland","Wicomico County",5,60,1347,670,677
050,24,045,"Maryland","Wicomico County",5,61,1323,610,713
050,24,045,"Maryland","Wicomico County",5,62,1284,580,704
050,24,045,"Maryland","Wicomico County",5,63,1260,577,683
050,24,045,"Maryland","Wicomico County",5,64,1271,603,668
050,24,045,"Maryland","Wicomico County",5,65,1274,596,678
050,24,045,"Maryland","Wicomico County",5,66,1277,626,651
050,24,045,"Maryland","Wicomico County",5,67,1168,536,632
050,24,045,"Maryland","Wicomico County",5,68,1170,523,647
050,24,045,"Maryland","Wicomico County",5,69,1177,527,650
050,24,045,"Maryland","Wicomico County",5,70,1093,480,613
050,24,045,"Maryland","Wicomico County",5,71,996,456,540
050,24,045,"Maryland","Wicomico County",5,72,911,394,517
050,24,045,"Maryland","Wicomico County",5,73,916,422,494
050,24,045,"Maryland","Wicomico County",5,74,878,403,475
050,24,045,"Maryland","Wicomico County",5,75,827,367,460
050,24,045,"Maryland","Wicomico County",5,76,891,384,507
050,24,045,"Maryland","Wicomico County",5,77,635,275,360
050,24,045,"Maryland","Wicomico County",5,78,602,265,337
050,24,045,"Maryland","Wicomico County",5,79,574,248,326
050,24,045,"Maryland","Wicomico County",5,80,562,263,299
050,24,045,"Maryland","Wicomico County",5,81,474,210,264
050,24,045,"Maryland","Wicomico County",5,82,393,168,225
050,24,045,"Maryland","Wicomico County",5,83,332,132,200
050,24,045,"Maryland","Wicomico County",5,84,294,118,176
050,24,045,"Maryland","Wicomico County",5,85,1596,533,1063
050,24,047,"Maryland","Worcester County",1,0,407,208,199
050,24,047,"Maryland","Worcester County",1,1,401,207,194
050,24,047,"Maryland","Worcester County",1,2,432,218,214
050,24,047,"Maryland","Worcester County",1,3,433,227,206
050,24,047,"Maryland","Worcester County",1,4,475,247,228
050,24,047,"Maryland","Worcester County",1,5,486,247,239
050,24,047,"Maryland","Worcester County",1,6,486,248,238
050,24,047,"Maryland","Worcester County",1,7,486,255,231
050,24,047,"Maryland","Worcester County",1,8,543,282,261
050,24,047,"Maryland","Worcester County",1,9,534,283,251
050,24,047,"Maryland","Worcester County",1,10,531,282,249
050,24,047,"Maryland","Worcester County",1,11,567,302,265
050,24,047,"Maryland","Worcester County",1,12,576,298,278
050,24,047,"Maryland","Worcester County",1,13,568,288,280
050,24,047,"Maryland","Worcester County",1,14,564,306,258
050,24,047,"Maryland","Worcester County",1,15,543,277,266
050,24,047,"Maryland","Worcester County",1,16,550,277,273
050,24,047,"Maryland","Worcester County",1,17,544,282,262
050,24,047,"Maryland","Worcester County",1,18,497,266,231
050,24,047,"Maryland","Worcester County",1,19,432,218,214
050,24,047,"Maryland","Worcester County",1,20,466,241,225
050,24,047,"Maryland","Worcester County",1,21,491,246,245
050,24,047,"Maryland","Worcester County",1,22,500,242,258
050,24,047,"Maryland","Worcester County",1,23,527,254,273
050,24,047,"Maryland","Worcester County",1,24,535,272,263
050,24,047,"Maryland","Worcester County",1,25,567,288,279
050,24,047,"Maryland","Worcester County",1,26,580,284,296
050,24,047,"Maryland","Worcester County",1,27,542,267,275
050,24,047,"Maryland","Worcester County",1,28,551,281,270
050,24,047,"Maryland","Worcester County",1,29,532,262,270
050,24,047,"Maryland","Worcester County",1,30,519,260,259
050,24,047,"Maryland","Worcester County",1,31,496,240,256
050,24,047,"Maryland","Worcester County",1,32,515,245,270
050,24,047,"Maryland","Worcester County",1,33,558,256,302
050,24,047,"Maryland","Worcester County",1,34,560,266,294
050,24,047,"Maryland","Worcester County",1,35,525,271,254
050,24,047,"Maryland","Worcester County",1,36,537,280,257
050,24,047,"Maryland","Worcester County",1,37,514,254,260
050,24,047,"Maryland","Worcester County",1,38,506,253,253
050,24,047,"Maryland","Worcester County",1,39,516,255,261
050,24,047,"Maryland","Worcester County",1,40,502,253,249
050,24,047,"Maryland","Worcester County",1,41,522,277,245
050,24,047,"Maryland","Worcester County",1,42,494,241,253
050,24,047,"Maryland","Worcester County",1,43,517,237,280
050,24,047,"Maryland","Worcester County",1,44,488,232,256
050,24,047,"Maryland","Worcester County",1,45,480,230,250
050,24,047,"Maryland","Worcester County",1,46,506,255,251
050,24,047,"Maryland","Worcester County",1,47,541,276,265
050,24,047,"Maryland","Worcester County",1,48,577,291,286
050,24,047,"Maryland","Worcester County",1,49,664,327,337
050,24,047,"Maryland","Worcester County",1,50,682,332,350
050,24,047,"Maryland","Worcester County",1,51,653,318,335
050,24,047,"Maryland","Worcester County",1,52,640,318,322
050,24,047,"Maryland","Worcester County",1,53,697,349,348
050,24,047,"Maryland","Worcester County",1,54,725,343,382
050,24,047,"Maryland","Worcester County",1,55,797,374,423
050,24,047,"Maryland","Worcester County",1,56,829,376,453
050,24,047,"Maryland","Worcester County",1,57,876,419,457
050,24,047,"Maryland","Worcester County",1,58,879,441,438
050,24,047,"Maryland","Worcester County",1,59,866,427,439
050,24,047,"Maryland","Worcester County",1,60,867,396,471
050,24,047,"Maryland","Worcester County",1,61,855,406,449
050,24,047,"Maryland","Worcester County",1,62,847,417,430
050,24,047,"Maryland","Worcester County",1,63,874,422,452
050,24,047,"Maryland","Worcester County",1,64,902,438,464
050,24,047,"Maryland","Worcester County",1,65,906,431,475
050,24,047,"Maryland","Worcester County",1,66,873,411,462
050,24,047,"Maryland","Worcester County",1,67,869,414,455
050,24,047,"Maryland","Worcester County",1,68,870,420,450
050,24,047,"Maryland","Worcester County",1,69,809,399,410
050,24,047,"Maryland","Worcester County",1,70,795,383,412
050,24,047,"Maryland","Worcester County",1,71,798,377,421
050,24,047,"Maryland","Worcester County",1,72,854,423,431
050,24,047,"Maryland","Worcester County",1,73,877,410,467
050,24,047,"Maryland","Worcester County",1,74,648,291,357
050,24,047,"Maryland","Worcester County",1,75,633,288,345
050,24,047,"Maryland","Worcester County",1,76,618,275,343
050,24,047,"Maryland","Worcester County",1,77,634,291,343
050,24,047,"Maryland","Worcester County",1,78,523,241,282
050,24,047,"Maryland","Worcester County",1,79,475,228,247
050,24,047,"Maryland","Worcester County",1,80,409,191,218
050,24,047,"Maryland","Worcester County",1,81,396,193,203
050,24,047,"Maryland","Worcester County",1,82,411,189,222
050,24,047,"Maryland","Worcester County",1,83,368,164,204
050,24,047,"Maryland","Worcester County",1,84,295,131,164
050,24,047,"Maryland","Worcester County",1,85,1532,607,925
050,24,047,"Maryland","Worcester County",2,0,403,199,204
050,24,047,"Maryland","Worcester County",2,1,403,207,196
050,24,047,"Maryland","Worcester County",2,2,427,217,210
050,24,047,"Maryland","Worcester County",2,3,436,227,209
050,24,047,"Maryland","Worcester County",2,4,468,244,224
050,24,047,"Maryland","Worcester County",2,5,486,248,238
050,24,047,"Maryland","Worcester County",2,6,489,250,239
050,24,047,"Maryland","Worcester County",2,7,490,256,234
050,24,047,"Maryland","Worcester County",2,8,531,279,252
050,24,047,"Maryland","Worcester County",2,9,537,285,252
050,24,047,"Maryland","Worcester County",2,10,533,286,247
050,24,047,"Maryland","Worcester County",2,11,557,299,258
050,24,047,"Maryland","Worcester County",2,12,579,301,278
050,24,047,"Maryland","Worcester County",2,13,572,294,278
050,24,047,"Maryland","Worcester County",2,14,569,303,266
050,24,047,"Maryland","Worcester County",2,15,549,284,265
050,24,047,"Maryland","Worcester County",2,16,551,280,271
050,24,047,"Maryland","Worcester County",2,17,544,280,264
050,24,047,"Maryland","Worcester County",2,18,486,259,227
050,24,047,"Maryland","Worcester County",2,19,431,220,211
050,24,047,"Maryland","Worcester County",2,20,474,242,232
050,24,047,"Maryland","Worcester County",2,21,485,244,241
050,24,047,"Maryland","Worcester County",2,22,502,246,256
050,24,047,"Maryland","Worcester County",2,23,525,253,272
050,24,047,"Maryland","Worcester County",2,24,534,271,263
050,24,047,"Maryland","Worcester County",2,25,564,287,277
050,24,047,"Maryland","Worcester County",2,26,575,285,290
050,24,047,"Maryland","Worcester County",2,27,550,271,279
050,24,047,"Maryland","Worcester County",2,28,547,276,271
050,24,047,"Maryland","Worcester County",2,29,533,264,269
050,24,047,"Maryland","Worcester County",2,30,522,259,263
050,24,047,"Maryland","Worcester County",2,31,502,245,257
050,24,047,"Maryland","Worcester County",2,32,513,244,269
050,24,047,"Maryland","Worcester County",2,33,545,253,292
050,24,047,"Maryland","Worcester County",2,34,563,265,298
050,24,047,"Maryland","Worcester County",2,35,539,273,266
050,24,047,"Maryland","Worcester County",2,36,531,274,257
050,24,047,"Maryland","Worcester County",2,37,518,258,260
050,24,047,"Maryland","Worcester County",2,38,510,253,257
050,24,047,"Maryland","Worcester County",2,39,516,255,261
050,24,047,"Maryland","Worcester County",2,40,509,257,252
050,24,047,"Maryland","Worcester County",2,41,519,274,245
050,24,047,"Maryland","Worcester County",2,42,499,247,252
050,24,047,"Maryland","Worcester County",2,43,518,240,278
050,24,047,"Maryland","Worcester County",2,44,490,233,257
050,24,047,"Maryland","Worcester County",2,45,486,232,254
050,24,047,"Maryland","Worcester County",2,46,500,251,249
050,24,047,"Maryland","Worcester County",2,47,533,270,263
050,24,047,"Maryland","Worcester County",2,48,572,289,283
050,24,047,"Maryland","Worcester County",2,49,648,321,327
050,24,047,"Maryland","Worcester County",2,50,682,331,351
050,24,047,"Maryland","Worcester County",2,51,658,320,338
050,24,047,"Maryland","Worcester County",2,52,642,318,324
050,24,047,"Maryland","Worcester County",2,53,687,343,344
050,24,047,"Maryland","Worcester County",2,54,720,346,374
050,24,047,"Maryland","Worcester County",2,55,777,364,413
050,24,047,"Maryland","Worcester County",2,56,827,378,449
050,24,047,"Maryland","Worcester County",2,57,870,412,458
050,24,047,"Maryland","Worcester County",2,58,882,437,445
050,24,047,"Maryland","Worcester County",2,59,879,432,447
050,24,047,"Maryland","Worcester County",2,60,871,405,466
050,24,047,"Maryland","Worcester County",2,61,859,406,453
050,24,047,"Maryland","Worcester County",2,62,847,416,431
050,24,047,"Maryland","Worcester County",2,63,883,428,455
050,24,047,"Maryland","Worcester County",2,64,897,435,462
050,24,047,"Maryland","Worcester County",2,65,909,433,476
050,24,047,"Maryland","Worcester County",2,66,886,418,468
050,24,047,"Maryland","Worcester County",2,67,867,412,455
050,24,047,"Maryland","Worcester County",2,68,869,418,451
050,24,047,"Maryland","Worcester County",2,69,829,408,421
050,24,047,"Maryland","Worcester County",2,70,795,387,408
050,24,047,"Maryland","Worcester County",2,71,795,379,416
050,24,047,"Maryland","Worcester County",2,72,830,409,421
050,24,047,"Maryland","Worcester County",2,73,914,431,483
050,24,047,"Maryland","Worcester County",2,74,653,297,356
050,24,047,"Maryland","Worcester County",2,75,633,284,349
050,24,047,"Maryland","Worcester County",2,76,614,275,339
050,24,047,"Maryland","Worcester County",2,77,641,292,349
050,24,047,"Maryland","Worcester County",2,78,533,244,289
050,24,047,"Maryland","Worcester County",2,79,477,227,250
050,24,047,"Maryland","Worcester County",2,80,424,202,222
050,24,047,"Maryland","Worcester County",2,81,391,189,202
050,24,047,"Maryland","Worcester County",2,82,401,185,216
050,24,047,"Maryland","Worcester County",2,83,368,165,203
050,24,047,"Maryland","Worcester County",2,84,301,134,167
050,24,047,"Maryland","Worcester County",2,85,1548,623,925
050,24,047,"Maryland","Worcester County",3,0,429,213,216
050,24,047,"Maryland","Worcester County",3,1,407,199,208
050,24,047,"Maryland","Worcester County",3,2,424,219,205
050,24,047,"Maryland","Worcester County",3,3,443,233,210
050,24,047,"Maryland","Worcester County",3,4,460,240,220
050,24,047,"Maryland","Worcester County",3,5,494,252,242
050,24,047,"Maryland","Worcester County",3,6,499,251,248
050,24,047,"Maryland","Worcester County",3,7,489,249,240
050,24,047,"Maryland","Worcester County",3,8,502,258,244
050,24,047,"Maryland","Worcester County",3,9,527,271,256
050,24,047,"Maryland","Worcester County",3,10,553,300,253
050,24,047,"Maryland","Worcester County",3,11,560,308,252
050,24,047,"Maryland","Worcester County",3,12,578,309,269
050,24,047,"Maryland","Worcester County",3,13,601,316,285
050,24,047,"Maryland","Worcester County",3,14,593,304,289
050,24,047,"Maryland","Worcester County",3,15,577,306,271
050,24,047,"Maryland","Worcester County",3,16,568,298,270
050,24,047,"Maryland","Worcester County",3,17,553,285,268
050,24,047,"Maryland","Worcester County",3,18,458,254,204
050,24,047,"Maryland","Worcester County",3,19,409,218,191
050,24,047,"Maryland","Worcester County",3,20,483,244,239
050,24,047,"Maryland","Worcester County",3,21,503,262,241
050,24,047,"Maryland","Worcester County",3,22,550,271,279
050,24,047,"Maryland","Worcester County",3,23,536,251,285
050,24,047,"Maryland","Worcester County",3,24,514,244,270
050,24,047,"Maryland","Worcester County",3,25,553,280,273
050,24,047,"Maryland","Worcester County",3,26,555,289,266
050,24,047,"Maryland","Worcester County",3,27,576,294,282
050,24,047,"Maryland","Worcester County",3,28,569,281,288
050,24,047,"Maryland","Worcester County",3,29,555,286,269
050,24,047,"Maryland","Worcester County",3,30,548,280,268
050,24,047,"Maryland","Worcester County",3,31,573,285,288
050,24,047,"Maryland","Worcester County",3,32,525,260,265
050,24,047,"Maryland","Worcester County",3,33,534,252,282
050,24,047,"Maryland","Worcester County",3,34,570,272,298
050,24,047,"Maryland","Worcester County",3,35,587,275,312
050,24,047,"Maryland","Worcester County",3,36,552,281,271
050,24,047,"Maryland","Worcester County",3,37,555,282,273
050,24,047,"Maryland","Worcester County",3,38,524,269,255
050,24,047,"Maryland","Worcester County",3,39,533,257,276
050,24,047,"Maryland","Worcester County",3,40,537,266,271
050,24,047,"Maryland","Worcester County",3,41,521,272,249
050,24,047,"Maryland","Worcester County",3,42,543,279,264
050,24,047,"Maryland","Worcester County",3,43,518,255,263
050,24,047,"Maryland","Worcester County",3,44,528,248,280
050,24,047,"Maryland","Worcester County",3,45,489,233,256
050,24,047,"Maryland","Worcester County",3,46,512,241,271
050,24,047,"Maryland","Worcester County",3,47,507,256,251
050,24,047,"Maryland","Worcester County",3,48,559,287,272
050,24,047,"Maryland","Worcester County",3,49,601,307,294
050,24,047,"Maryland","Worcester County",3,50,686,340,346
050,24,047,"Maryland","Worcester County",3,51,683,326,357
050,24,047,"Maryland","Worcester County",3,52,661,321,340
050,24,047,"Maryland","Worcester County",3,53,666,321,345
050,24,047,"Maryland","Worcester County",3,54,700,346,354
050,24,047,"Maryland","Worcester County",3,55,731,351,380
050,24,047,"Maryland","Worcester County",3,56,795,375,420
050,24,047,"Maryland","Worcester County",3,57,862,393,469
050,24,047,"Maryland","Worcester County",3,58,915,430,485
050,24,047,"Maryland","Worcester County",3,59,888,431,457
050,24,047,"Maryland","Worcester County",3,60,897,441,456
050,24,047,"Maryland","Worcester County",3,61,883,411,472
050,24,047,"Maryland","Worcester County",3,62,844,397,447
050,24,047,"Maryland","Worcester County",3,63,878,433,445
050,24,047,"Maryland","Worcester County",3,64,922,436,486
050,24,047,"Maryland","Worcester County",3,65,929,456,473
050,24,047,"Maryland","Worcester County",3,66,911,433,478
050,24,047,"Maryland","Worcester County",3,67,893,423,470
050,24,047,"Maryland","Worcester County",3,68,895,424,471
050,24,047,"Maryland","Worcester County",3,69,866,429,437
050,24,047,"Maryland","Worcester County",3,70,838,408,430
050,24,047,"Maryland","Worcester County",3,71,768,369,399
050,24,047,"Maryland","Worcester County",3,72,789,370,419
050,24,047,"Maryland","Worcester County",3,73,814,397,417
050,24,047,"Maryland","Worcester County",3,74,886,428,458
050,24,047,"Maryland","Worcester County",3,75,635,285,350
050,24,047,"Maryland","Worcester County",3,76,597,263,334
050,24,047,"Maryland","Worcester County",3,77,585,255,330
050,24,047,"Maryland","Worcester County",3,78,608,279,329
050,24,047,"Maryland","Worcester County",3,79,512,236,276
050,24,047,"Maryland","Worcester County",3,80,466,220,246
050,24,047,"Maryland","Worcester County",3,81,388,179,209
050,24,047,"Maryland","Worcester County",3,82,368,176,192
050,24,047,"Maryland","Worcester County",3,83,377,175,202
050,24,047,"Maryland","Worcester County",3,84,326,144,182
050,24,047,"Maryland","Worcester County",3,85,1602,662,940
050,24,047,"Maryland","Worcester County",4,0,466,229,237
050,24,047,"Maryland","Worcester County",4,1,408,208,200
050,24,047,"Maryland","Worcester County",4,2,417,198,219
050,24,047,"Maryland","Worcester County",4,3,436,226,210
050,24,047,"Maryland","Worcester County",4,4,460,245,215
050,24,047,"Maryland","Worcester County",4,5,463,239,224
050,24,047,"Maryland","Worcester County",4,6,515,262,253
050,24,047,"Maryland","Worcester County",4,7,506,263,243
050,24,047,"Maryland","Worcester County",4,8,497,259,238
050,24,047,"Maryland","Worcester County",4,9,527,269,258
050,24,047,"Maryland","Worcester County",4,10,522,277,245
050,24,047,"Maryland","Worcester County",4,11,548,291,257
050,24,047,"Maryland","Worcester County",4,12,565,312,253
050,24,047,"Maryland","Worcester County",4,13,590,318,272
050,24,047,"Maryland","Worcester County",4,14,617,327,290
050,24,047,"Maryland","Worcester County",4,15,603,313,290
050,24,047,"Maryland","Worcester County",4,16,594,318,276
050,24,047,"Maryland","Worcester County",4,17,586,306,280
050,24,047,"Maryland","Worcester County",4,18,472,258,214
050,24,047,"Maryland","Worcester County",4,19,387,212,175
050,24,047,"Maryland","Worcester County",4,20,456,246,210
050,24,047,"Maryland","Worcester County",4,21,512,250,262
050,24,047,"Maryland","Worcester County",4,22,534,277,257
050,24,047,"Maryland","Worcester County",4,23,572,290,282
050,24,047,"Maryland","Worcester County",4,24,518,259,259
050,24,047,"Maryland","Worcester County",4,25,519,251,268
050,24,047,"Maryland","Worcester County",4,26,527,264,263
050,24,047,"Maryland","Worcester County",4,27,560,291,269
050,24,047,"Maryland","Worcester County",4,28,553,287,266
050,24,047,"Maryland","Worcester County",4,29,543,262,281
050,24,047,"Maryland","Worcester County",4,30,567,291,276
050,24,047,"Maryland","Worcester County",4,31,569,295,274
050,24,047,"Maryland","Worcester County",4,32,563,282,281
050,24,047,"Maryland","Worcester County",4,33,523,264,259
050,24,047,"Maryland","Worcester County",4,34,523,241,282
050,24,047,"Maryland","Worcester County",4,35,592,274,318
050,24,047,"Maryland","Worcester County",4,36,582,268,314
050,24,047,"Maryland","Worcester County",4,37,557,283,274
050,24,047,"Maryland","Worcester County",4,38,547,280,267
050,24,047,"Maryland","Worcester County",4,39,522,270,252
050,24,047,"Maryland","Worcester County",4,40,541,260,281
050,24,047,"Maryland","Worcester County",4,41,556,280,276
050,24,047,"Maryland","Worcester County",4,42,548,278,270
050,24,047,"Maryland","Worcester County",4,43,551,278,273
050,24,047,"Maryland","Worcester County",4,44,527,260,267
050,24,047,"Maryland","Worcester County",4,45,529,251,278
050,24,047,"Maryland","Worcester County",4,46,484,243,241
050,24,047,"Maryland","Worcester County",4,47,519,246,273
050,24,047,"Maryland","Worcester County",4,48,504,255,249
050,24,047,"Maryland","Worcester County",4,49,574,286,288
050,24,047,"Maryland","Worcester County",4,50,615,314,301
050,24,047,"Maryland","Worcester County",4,51,701,342,359
050,24,047,"Maryland","Worcester County",4,52,664,320,344
050,24,047,"Maryland","Worcester County",4,53,678,322,356
050,24,047,"Maryland","Worcester County",4,54,678,329,349
050,24,047,"Maryland","Worcester County",4,55,725,361,364
050,24,047,"Maryland","Worcester County",4,56,762,365,397
050,24,047,"Maryland","Worcester County",4,57,814,372,442
050,24,047,"Maryland","Worcester County",4,58,934,437,497
050,24,047,"Maryland","Worcester County",4,59,954,449,505
050,24,047,"Maryland","Worcester County",4,60,930,454,476
050,24,047,"Maryland","Worcester County",4,61,913,455,458
050,24,047,"Maryland","Worcester County",4,62,924,427,497
050,24,047,"Maryland","Worcester County",4,63,866,405,461
050,24,047,"Maryland","Worcester County",4,64,896,439,457
050,24,047,"Maryland","Worcester County",4,65,941,438,503
050,24,047,"Maryland","Worcester County",4,66,966,467,499
050,24,047,"Maryland","Worcester County",4,67,913,440,473
050,24,047,"Maryland","Worcester County",4,68,926,437,489
050,24,047,"Maryland","Worcester County",4,69,895,435,460
050,24,047,"Maryland","Worcester County",4,70,868,422,446
050,24,047,"Maryland","Worcester County",4,71,839,400,439
050,24,047,"Maryland","Worcester County",4,72,771,369,402
050,24,047,"Maryland","Worcester County",4,73,765,359,406
050,24,047,"Maryland","Worcester County",4,74,788,387,401
050,24,047,"Maryland","Worcester County",4,75,875,423,452
050,24,047,"Maryland","Worcester County",4,76,609,275,334
050,24,047,"Maryland","Worcester County",4,77,572,245,327
050,24,047,"Maryland","Worcester County",4,78,561,240,321
050,24,047,"Maryland","Worcester County",4,79,580,266,314
050,24,047,"Maryland","Worcester County",4,80,492,226,266
050,24,047,"Maryland","Worcester County",4,81,429,198,231
050,24,047,"Maryland","Worcester County",4,82,368,157,211
050,24,047,"Maryland","Worcester County",4,83,353,166,187
050,24,047,"Maryland","Worcester County",4,84,325,150,175
050,24,047,"Maryland","Worcester County",4,85,1693,702,991
050,24,047,"Maryland","Worcester County",5,0,457,223,234
050,24,047,"Maryland","Worcester County",5,1,464,227,237
050,24,047,"Maryland","Worcester County",5,2,425,207,218
050,24,047,"Maryland","Worcester County",5,3,426,207,219
050,24,047,"Maryland","Worcester County",5,4,443,232,211
050,24,047,"Maryland","Worcester County",5,5,461,244,217
050,24,047,"Maryland","Worcester County",5,6,482,251,231
050,24,047,"Maryland","Worcester County",5,7,523,275,248
050,24,047,"Maryland","Worcester County",5,8,513,269,244
050,24,047,"Maryland","Worcester County",5,9,512,263,249
050,24,047,"Maryland","Worcester County",5,10,523,267,256
050,24,047,"Maryland","Worcester County",5,11,527,279,248
050,24,047,"Maryland","Worcester County",5,12,557,293,264
050,24,047,"Maryland","Worcester County",5,13,585,320,265
050,24,047,"Maryland","Worcester County",5,14,596,317,279
050,24,047,"Maryland","Worcester County",5,15,615,327,288
050,24,047,"Maryland","Worcester County",5,16,592,316,276
050,24,047,"Maryland","Worcester County",5,17,583,311,272
050,24,047,"Maryland","Worcester County",5,18,501,268,233
050,24,047,"Maryland","Worcester County",5,19,387,205,182
050,24,047,"Maryland","Worcester County",5,20,460,232,228
050,24,047,"Maryland","Worcester County",5,21,481,253,228
050,24,047,"Maryland","Worcester County",5,22,563,270,293
050,24,047,"Maryland","Worcester County",5,23,555,283,272
050,24,047,"Maryland","Worcester County",5,24,571,303,268
050,24,047,"Maryland","Worcester County",5,25,541,273,268
050,24,047,"Maryland","Worcester County",5,26,496,227,269
050,24,047,"Maryland","Worcester County",5,27,524,260,264
050,24,047,"Maryland","Worcester County",5,28,527,273,254
050,24,047,"Maryland","Worcester County",5,29,545,281,264
050,24,047,"Maryland","Worcester County",5,30,537,259,278
050,24,047,"Maryland","Worcester County",5,31,555,280,275
050,24,047,"Maryland","Worcester County",5,32,568,289,279
050,24,047,"Maryland","Worcester County",5,33,579,288,291
050,24,047,"Maryland","Worcester County",5,34,538,262,276
050,24,047,"Maryland","Worcester County",5,35,540,248,292
050,24,047,"Maryland","Worcester County",5,36,604,278,326
050,24,047,"Maryland","Worcester County",5,37,582,273,309
050,24,047,"Maryland","Worcester County",5,38,571,285,286
050,24,047,"Maryland","Worcester County",5,39,566,293,273
050,24,047,"Maryland","Worcester County",5,40,521,263,258
050,24,047,"Maryland","Worcester County",5,41,563,280,283
050,24,047,"Maryland","Worcester County",5,42,541,269,272
050,24,047,"Maryland","Worcester County",5,43,550,279,271
050,24,047,"Maryland","Worcester County",5,44,556,290,266
050,24,047,"Maryland","Worcester County",5,45,524,265,259
050,24,047,"Maryland","Worcester County",5,46,533,255,278
050,24,047,"Maryland","Worcester County",5,47,484,243,241
050,24,047,"Maryland","Worcester County",5,48,532,252,280
050,24,047,"Maryland","Worcester County",5,49,514,260,254
050,24,047,"Maryland","Worcester County",5,50,594,292,302
050,24,047,"Maryland","Worcester County",5,51,614,312,302
050,24,047,"Maryland","Worcester County",5,52,697,341,356
050,24,047,"Maryland","Worcester County",5,53,677,316,361
050,24,047,"Maryland","Worcester County",5,54,682,324,358
050,24,047,"Maryland","Worcester County",5,55,672,321,351
050,24,047,"Maryland","Worcester County",5,56,742,369,373
050,24,047,"Maryland","Worcester County",5,57,772,370,402
050,24,047,"Maryland","Worcester County",5,58,819,354,465
050,24,047,"Maryland","Worcester County",5,59,935,435,500
050,24,047,"Maryland","Worcester County",5,60,973,472,501
050,24,047,"Maryland","Worcester County",5,61,947,459,488
050,24,047,"Maryland","Worcester County",5,62,932,469,463
050,24,047,"Maryland","Worcester County",5,63,943,434,509
050,24,047,"Maryland","Worcester County",5,64,884,411,473
050,24,047,"Maryland","Worcester County",5,65,917,443,474
050,24,047,"Maryland","Worcester County",5,66,948,436,512
050,24,047,"Maryland","Worcester County",5,67,966,468,498
050,24,047,"Maryland","Worcester County",5,68,924,442,482
050,24,047,"Maryland","Worcester County",5,69,909,426,483
050,24,047,"Maryland","Worcester County",5,70,891,434,457
050,24,047,"Maryland","Worcester County",5,71,846,405,441
050,24,047,"Maryland","Worcester County",5,72,836,404,432
050,24,047,"Maryland","Worcester County",5,73,760,361,399
050,24,047,"Maryland","Worcester County",5,74,744,352,392
050,24,047,"Maryland","Worcester County",5,75,768,373,395
050,24,047,"Maryland","Worcester County",5,76,855,418,437
050,24,047,"Maryland","Worcester County",5,77,592,269,323
050,24,047,"Maryland","Worcester County",5,78,550,239,311
050,24,047,"Maryland","Worcester County",5,79,538,235,303
050,24,047,"Maryland","Worcester County",5,80,552,249,303
050,24,047,"Maryland","Worcester County",5,81,450,208,242
050,24,047,"Maryland","Worcester County",5,82,408,185,223
050,24,047,"Maryland","Worcester County",5,83,356,151,205
050,24,047,"Maryland","Worcester County",5,84,301,141,160
050,24,047,"Maryland","Worcester County",5,85,1784,757,1027
050,24,510,"Maryland","Baltimore city",1,0,7664,3902,3762
050,24,510,"Maryland","Baltimore city",1,1,7381,3783,3598
050,24,510,"Maryland","Baltimore city",1,2,7309,3717,3592
050,24,510,"Maryland","Baltimore city",1,3,7180,3647,3533
050,24,510,"Maryland","Baltimore city",1,4,7195,3665,3530
050,24,510,"Maryland","Baltimore city",1,5,7148,3698,3450
050,24,510,"Maryland","Baltimore city",1,6,6825,3516,3309
050,24,510,"Maryland","Baltimore city",1,7,6753,3381,3372
050,24,510,"Maryland","Baltimore city",1,8,6645,3374,3271
050,24,510,"Maryland","Baltimore city",1,9,6556,3337,3219
050,24,510,"Maryland","Baltimore city",1,10,6717,3399,3318
050,24,510,"Maryland","Baltimore city",1,11,6922,3493,3429
050,24,510,"Maryland","Baltimore city",1,12,6958,3507,3451
050,24,510,"Maryland","Baltimore city",1,13,6761,3450,3311
050,24,510,"Maryland","Baltimore city",1,14,6435,3268,3167
050,24,510,"Maryland","Baltimore city",1,15,6271,3171,3100
050,24,510,"Maryland","Baltimore city",1,16,6111,3069,3042
050,24,510,"Maryland","Baltimore city",1,17,5995,2989,3006
050,24,510,"Maryland","Baltimore city",1,18,7327,3464,3863
050,24,510,"Maryland","Baltimore city",1,19,8200,3871,4329
050,24,510,"Maryland","Baltimore city",1,20,7358,3468,3890
050,24,510,"Maryland","Baltimore city",1,21,6986,3234,3752
050,24,510,"Maryland","Baltimore city",1,22,6802,3159,3643
050,24,510,"Maryland","Baltimore city",1,23,7599,3489,4110
050,24,510,"Maryland","Baltimore city",1,24,8461,3951,4510
050,24,510,"Maryland","Baltimore city",1,25,9468,4432,5036
050,24,510,"Maryland","Baltimore city",1,26,10338,4842,5496
050,24,510,"Maryland","Baltimore city",1,27,11034,5272,5762
050,24,510,"Maryland","Baltimore city",1,28,11468,5493,5975
050,24,510,"Maryland","Baltimore city",1,29,11835,5702,6133
050,24,510,"Maryland","Baltimore city",1,30,11770,5571,6199
050,24,510,"Maryland","Baltimore city",1,31,11596,5494,6102
050,24,510,"Maryland","Baltimore city",1,32,11026,5267,5759
050,24,510,"Maryland","Baltimore city",1,33,10529,5082,5447
050,24,510,"Maryland","Baltimore city",1,34,10069,4805,5264
050,24,510,"Maryland","Baltimore city",1,35,9472,4500,4972
050,24,510,"Maryland","Baltimore city",1,36,8955,4270,4685
050,24,510,"Maryland","Baltimore city",1,37,8732,4155,4577
050,24,510,"Maryland","Baltimore city",1,38,8253,3832,4421
050,24,510,"Maryland","Baltimore city",1,39,7990,3686,4304
050,24,510,"Maryland","Baltimore city",1,40,7625,3492,4133
050,24,510,"Maryland","Baltimore city",1,41,7094,3264,3830
050,24,510,"Maryland","Baltimore city",1,42,6701,3160,3541
050,24,510,"Maryland","Baltimore city",1,43,6492,3074,3418
050,24,510,"Maryland","Baltimore city",1,44,6137,2868,3269
050,24,510,"Maryland","Baltimore city",1,45,5996,2785,3211
050,24,510,"Maryland","Baltimore city",1,46,5705,2616,3089
050,24,510,"Maryland","Baltimore city",1,47,5857,2729,3128
050,24,510,"Maryland","Baltimore city",1,48,6226,2854,3372
050,24,510,"Maryland","Baltimore city",1,49,6774,3178,3596
050,24,510,"Maryland","Baltimore city",1,50,6653,3190,3463
050,24,510,"Maryland","Baltimore city",1,51,6518,3037,3481
050,24,510,"Maryland","Baltimore city",1,52,6728,3097,3631
050,24,510,"Maryland","Baltimore city",1,53,6780,3198,3582
050,24,510,"Maryland","Baltimore city",1,54,7033,3303,3730
050,24,510,"Maryland","Baltimore city",1,55,7474,3539,3935
050,24,510,"Maryland","Baltimore city",1,56,7587,3606,3981
050,24,510,"Maryland","Baltimore city",1,57,7439,3465,3974
050,24,510,"Maryland","Baltimore city",1,58,7713,3514,4199
050,24,510,"Maryland","Baltimore city",1,59,7812,3563,4249
050,24,510,"Maryland","Baltimore city",1,60,7710,3424,4286
050,24,510,"Maryland","Baltimore city",1,61,7681,3377,4304
050,24,510,"Maryland","Baltimore city",1,62,7572,3419,4153
050,24,510,"Maryland","Baltimore city",1,63,7202,3162,4040
050,24,510,"Maryland","Baltimore city",1,64,6820,2990,3830
050,24,510,"Maryland","Baltimore city",1,65,6403,2823,3580
050,24,510,"Maryland","Baltimore city",1,66,6177,2717,3460
050,24,510,"Maryland","Baltimore city",1,67,6022,2620,3402
050,24,510,"Maryland","Baltimore city",1,68,5721,2486,3235
050,24,510,"Maryland","Baltimore city",1,69,5523,2382,3141
050,24,510,"Maryland","Baltimore city",1,70,5192,2274,2918
050,24,510,"Maryland","Baltimore city",1,71,4898,2091,2807
050,24,510,"Maryland","Baltimore city",1,72,4642,1978,2664
050,24,510,"Maryland","Baltimore city",1,73,4379,1908,2471
050,24,510,"Maryland","Baltimore city",1,74,3144,1279,1865
050,24,510,"Maryland","Baltimore city",1,75,3144,1281,1863
050,24,510,"Maryland","Baltimore city",1,76,3035,1225,1810
050,24,510,"Maryland","Baltimore city",1,77,2942,1176,1766
050,24,510,"Maryland","Baltimore city",1,78,2531,1047,1484
050,24,510,"Maryland","Baltimore city",1,79,2316,930,1386
050,24,510,"Maryland","Baltimore city",1,80,2160,853,1307
050,24,510,"Maryland","Baltimore city",1,81,1994,742,1252
050,24,510,"Maryland","Baltimore city",1,82,1784,665,1119
050,24,510,"Maryland","Baltimore city",1,83,1571,564,1007
050,24,510,"Maryland","Baltimore city",1,84,1487,556,931
050,24,510,"Maryland","Baltimore city",1,85,9202,2922,6280
050,24,510,"Maryland","Baltimore city",2,0,7510,3794,3716
050,24,510,"Maryland","Baltimore city",2,1,7366,3761,3605
050,24,510,"Maryland","Baltimore city",2,2,7255,3695,3560
050,24,510,"Maryland","Baltimore city",2,3,7110,3614,3496
050,24,510,"Maryland","Baltimore city",2,4,7114,3616,3498
050,24,510,"Maryland","Baltimore city",2,5,7098,3667,3431
050,24,510,"Maryland","Baltimore city",2,6,6847,3533,3314
050,24,510,"Maryland","Baltimore city",2,7,6702,3379,3323
050,24,510,"Maryland","Baltimore city",2,8,6601,3344,3257
050,24,510,"Maryland","Baltimore city",2,9,6525,3317,3208
050,24,510,"Maryland","Baltimore city",2,10,6622,3352,3270
050,24,510,"Maryland","Baltimore city",2,11,6794,3427,3367
050,24,510,"Maryland","Baltimore city",2,12,6943,3494,3449
050,24,510,"Maryland","Baltimore city",2,13,6768,3444,3324
050,24,510,"Maryland","Baltimore city",2,14,6463,3281,3182
050,24,510,"Maryland","Baltimore city",2,15,6287,3180,3107
050,24,510,"Maryland","Baltimore city",2,16,6142,3093,3049
050,24,510,"Maryland","Baltimore city",2,17,5991,2990,3001
050,24,510,"Maryland","Baltimore city",2,18,7293,3446,3847
050,24,510,"Maryland","Baltimore city",2,19,8159,3847,4312
050,24,510,"Maryland","Baltimore city",2,20,7402,3493,3909
050,24,510,"Maryland","Baltimore city",2,21,7021,3240,3781
050,24,510,"Maryland","Baltimore city",2,22,6888,3191,3697
050,24,510,"Maryland","Baltimore city",2,23,7542,3460,4082
050,24,510,"Maryland","Baltimore city",2,24,8330,3877,4453
050,24,510,"Maryland","Baltimore city",2,25,9319,4356,4963
050,24,510,"Maryland","Baltimore city",2,26,10213,4793,5420
050,24,510,"Maryland","Baltimore city",2,27,10831,5164,5667
050,24,510,"Maryland","Baltimore city",2,28,11310,5427,5883
050,24,510,"Maryland","Baltimore city",2,29,11684,5617,6067
050,24,510,"Maryland","Baltimore city",2,30,11754,5579,6175
050,24,510,"Maryland","Baltimore city",2,31,11484,5443,6041
050,24,510,"Maryland","Baltimore city",2,32,10989,5243,5746
050,24,510,"Maryland","Baltimore city",2,33,10519,5069,5450
050,24,510,"Maryland","Baltimore city",2,34,10058,4824,5234
050,24,510,"Maryland","Baltimore city",2,35,9540,4535,5005
050,24,510,"Maryland","Baltimore city",2,36,8907,4236,4671
050,24,510,"Maryland","Baltimore city",2,37,8704,4138,4566
050,24,510,"Maryland","Baltimore city",2,38,8335,3890,4445
050,24,510,"Maryland","Baltimore city",2,39,7922,3653,4269
050,24,510,"Maryland","Baltimore city",2,40,7709,3539,4170
050,24,510,"Maryland","Baltimore city",2,41,7161,3285,3876
050,24,510,"Maryland","Baltimore city",2,42,6725,3152,3573
050,24,510,"Maryland","Baltimore city",2,43,6558,3097,3461
050,24,510,"Maryland","Baltimore city",2,44,6118,2870,3248
050,24,510,"Maryland","Baltimore city",2,45,6020,2801,3219
050,24,510,"Maryland","Baltimore city",2,46,5709,2622,3087
050,24,510,"Maryland","Baltimore city",2,47,5783,2686,3097
050,24,510,"Maryland","Baltimore city",2,48,6115,2815,3300
050,24,510,"Maryland","Baltimore city",2,49,6646,3099,3547
050,24,510,"Maryland","Baltimore city",2,50,6643,3169,3474
050,24,510,"Maryland","Baltimore city",2,51,6468,3039,3429
050,24,510,"Maryland","Baltimore city",2,52,6661,3070,3591
050,24,510,"Maryland","Baltimore city",2,53,6714,3139,3575
050,24,510,"Maryland","Baltimore city",2,54,6937,3267,3670
050,24,510,"Maryland","Baltimore city",2,55,7332,3457,3875
050,24,510,"Maryland","Baltimore city",2,56,7546,3577,3969
050,24,510,"Maryland","Baltimore city",2,57,7431,3470,3961
050,24,510,"Maryland","Baltimore city",2,58,7605,3476,4129
050,24,510,"Maryland","Baltimore city",2,59,7725,3511,4214
050,24,510,"Maryland","Baltimore city",2,60,7689,3432,4257
050,24,510,"Maryland","Baltimore city",2,61,7631,3350,4281
050,24,510,"Maryland","Baltimore city",2,62,7490,3355,4135
050,24,510,"Maryland","Baltimore city",2,63,7276,3210,4066
050,24,510,"Maryland","Baltimore city",2,64,6809,2974,3835
050,24,510,"Maryland","Baltimore city",2,65,6446,2836,3610
050,24,510,"Maryland","Baltimore city",2,66,6182,2719,3463
050,24,510,"Maryland","Baltimore city",2,67,5988,2605,3383
050,24,510,"Maryland","Baltimore city",2,68,5693,2466,3227
050,24,510,"Maryland","Baltimore city",2,69,5559,2394,3165
050,24,510,"Maryland","Baltimore city",2,70,5210,2268,2942
050,24,510,"Maryland","Baltimore city",2,71,4906,2107,2799
050,24,510,"Maryland","Baltimore city",2,72,4608,1964,2644
050,24,510,"Maryland","Baltimore city",2,73,4530,1959,2571
050,24,510,"Maryland","Baltimore city",2,74,3232,1335,1897
050,24,510,"Maryland","Baltimore city",2,75,3108,1262,1846
050,24,510,"Maryland","Baltimore city",2,76,2980,1200,1780
050,24,510,"Maryland","Baltimore city",2,77,2959,1177,1782
050,24,510,"Maryland","Baltimore city",2,78,2545,1039,1506
050,24,510,"Maryland","Baltimore city",2,79,2318,928,1390
050,24,510,"Maryland","Baltimore city",2,80,2165,857,1308
050,24,510,"Maryland","Baltimore city",2,81,1968,742,1226
050,24,510,"Maryland","Baltimore city",2,82,1795,660,1135
050,24,510,"Maryland","Baltimore city",2,83,1584,569,1015
050,24,510,"Maryland","Baltimore city",2,84,1465,539,926
050,24,510,"Maryland","Baltimore city",2,85,9073,2897,6176
050,24,510,"Maryland","Baltimore city",3,0,7167,3519,3648
050,24,510,"Maryland","Baltimore city",3,1,7071,3591,3480
050,24,510,"Maryland","Baltimore city",3,2,6935,3559,3376
050,24,510,"Maryland","Baltimore city",3,3,6987,3522,3465
050,24,510,"Maryland","Baltimore city",3,4,6886,3531,3355
050,24,510,"Maryland","Baltimore city",3,5,6894,3510,3384
050,24,510,"Maryland","Baltimore city",3,6,6815,3547,3268
050,24,510,"Maryland","Baltimore city",3,7,6649,3451,3198
050,24,510,"Maryland","Baltimore city",3,8,6522,3261,3261
050,24,510,"Maryland","Baltimore city",3,9,6440,3254,3186
050,24,510,"Maryland","Baltimore city",3,10,6456,3271,3185
050,24,510,"Maryland","Baltimore city",3,11,6435,3266,3169
050,24,510,"Maryland","Baltimore city",3,12,6691,3385,3306
050,24,510,"Maryland","Baltimore city",3,13,6850,3431,3419
050,24,510,"Maryland","Baltimore city",3,14,6685,3408,3277
050,24,510,"Maryland","Baltimore city",3,15,6316,3217,3099
050,24,510,"Maryland","Baltimore city",3,16,6232,3154,3078
050,24,510,"Maryland","Baltimore city",3,17,6147,3083,3064
050,24,510,"Maryland","Baltimore city",3,18,7269,3454,3815
050,24,510,"Maryland","Baltimore city",3,19,8007,3776,4231
050,24,510,"Maryland","Baltimore city",3,20,7206,3379,3827
050,24,510,"Maryland","Baltimore city",3,21,7136,3306,3830
050,24,510,"Maryland","Baltimore city",3,22,6812,3153,3659
050,24,510,"Maryland","Baltimore city",3,23,7584,3550,4034
050,24,510,"Maryland","Baltimore city",3,24,8224,3742,4482
050,24,510,"Maryland","Baltimore city",3,25,8788,4082,4706
050,24,510,"Maryland","Baltimore city",3,26,9644,4533,5111
050,24,510,"Maryland","Baltimore city",3,27,10243,4769,5474
050,24,510,"Maryland","Baltimore city",3,28,10749,5126,5623
050,24,510,"Maryland","Baltimore city",3,29,11165,5333,5832
050,24,510,"Maryland","Baltimore city",3,30,11460,5465,5995
050,24,510,"Maryland","Baltimore city",3,31,11396,5431,5965
050,24,510,"Maryland","Baltimore city",3,32,11053,5254,5799
050,24,510,"Maryland","Baltimore city",3,33,10617,5063,5554
050,24,510,"Maryland","Baltimore city",3,34,10057,4862,5195
050,24,510,"Maryland","Baltimore city",3,35,9663,4608,5055
050,24,510,"Maryland","Baltimore city",3,36,9175,4372,4803
050,24,510,"Maryland","Baltimore city",3,37,8579,4046,4533
050,24,510,"Maryland","Baltimore city",3,38,8466,3999,4467
050,24,510,"Maryland","Baltimore city",3,39,8124,3762,4362
050,24,510,"Maryland","Baltimore city",3,40,7680,3558,4122
050,24,510,"Maryland","Baltimore city",3,41,7579,3457,4122
050,24,510,"Maryland","Baltimore city",3,42,7022,3226,3796
050,24,510,"Maryland","Baltimore city",3,43,6598,3103,3495
050,24,510,"Maryland","Baltimore city",3,44,6415,3006,3409
050,24,510,"Maryland","Baltimore city",3,45,5963,2796,3167
050,24,510,"Maryland","Baltimore city",3,46,5864,2691,3173
050,24,510,"Maryland","Baltimore city",3,47,5630,2576,3054
050,24,510,"Maryland","Baltimore city",3,48,5649,2599,3050
050,24,510,"Maryland","Baltimore city",3,49,5949,2701,3248
050,24,510,"Maryland","Baltimore city",3,50,6465,2980,3485
050,24,510,"Maryland","Baltimore city",3,51,6519,3131,3388
050,24,510,"Maryland","Baltimore city",3,52,6284,2897,3387
050,24,510,"Maryland","Baltimore city",3,53,6457,2966,3491
050,24,510,"Maryland","Baltimore city",3,54,6623,3082,3541
050,24,510,"Maryland","Baltimore city",3,55,6796,3160,3636
050,24,510,"Maryland","Baltimore city",3,56,7187,3390,3797
050,24,510,"Maryland","Baltimore city",3,57,7359,3456,3903
050,24,510,"Maryland","Baltimore city",3,58,7200,3365,3835
050,24,510,"Maryland","Baltimore city",3,59,7336,3352,3984
050,24,510,"Maryland","Baltimore city",3,60,7515,3381,4134
050,24,510,"Maryland","Baltimore city",3,61,7424,3300,4124
050,24,510,"Maryland","Baltimore city",3,62,7437,3255,4182
050,24,510,"Maryland","Baltimore city",3,63,7248,3213,4035
050,24,510,"Maryland","Baltimore city",3,64,7035,3081,3954
050,24,510,"Maryland","Baltimore city",3,65,6532,2835,3697
050,24,510,"Maryland","Baltimore city",3,66,6221,2724,3497
050,24,510,"Maryland","Baltimore city",3,67,5959,2610,3349
050,24,510,"Maryland","Baltimore city",3,68,5741,2484,3257
050,24,510,"Maryland","Baltimore city",3,69,5461,2316,3145
050,24,510,"Maryland","Baltimore city",3,70,5371,2285,3086
050,24,510,"Maryland","Baltimore city",3,71,5003,2157,2846
050,24,510,"Maryland","Baltimore city",3,72,4724,1997,2727
050,24,510,"Maryland","Baltimore city",3,73,4390,1842,2548
050,24,510,"Maryland","Baltimore city",3,74,4344,1877,2467
050,24,510,"Maryland","Baltimore city",3,75,3087,1261,1826
050,24,510,"Maryland","Baltimore city",3,76,2968,1176,1792
050,24,510,"Maryland","Baltimore city",3,77,2817,1115,1702
050,24,510,"Maryland","Baltimore city",3,78,2753,1089,1664
050,24,510,"Maryland","Baltimore city",3,79,2417,987,1430
050,24,510,"Maryland","Baltimore city",3,80,2170,867,1303
050,24,510,"Maryland","Baltimore city",3,81,1985,760,1225
050,24,510,"Maryland","Baltimore city",3,82,1802,686,1116
050,24,510,"Maryland","Baltimore city",3,83,1650,591,1059
050,24,510,"Maryland","Baltimore city",3,84,1453,504,949
050,24,510,"Maryland","Baltimore city",3,85,8901,2879,6022
050,24,510,"Maryland","Baltimore city",4,0,7247,3551,3696
050,24,510,"Maryland","Baltimore city",4,1,6757,3334,3423
050,24,510,"Maryland","Baltimore city",4,2,6725,3379,3346
050,24,510,"Maryland","Baltimore city",4,3,6694,3433,3261
050,24,510,"Maryland","Baltimore city",4,4,6818,3410,3408
050,24,510,"Maryland","Baltimore city",4,5,6706,3447,3259
050,24,510,"Maryland","Baltimore city",4,6,6718,3425,3293
050,24,510,"Maryland","Baltimore city",4,7,6644,3490,3154
050,24,510,"Maryland","Baltimore city",4,8,6536,3438,3098
050,24,510,"Maryland","Baltimore city",4,9,6372,3231,3141
050,24,510,"Maryland","Baltimore city",4,10,6306,3186,3120
050,24,510,"Maryland","Baltimore city",4,11,6334,3201,3133
050,24,510,"Maryland","Baltimore city",4,12,6285,3182,3103
050,24,510,"Maryland","Baltimore city",4,13,6610,3330,3280
050,24,510,"Maryland","Baltimore city",4,14,6724,3381,3343
050,24,510,"Maryland","Baltimore city",4,15,6598,3306,3292
050,24,510,"Maryland","Baltimore city",4,16,6244,3202,3042
050,24,510,"Maryland","Baltimore city",4,17,6179,3120,3059
050,24,510,"Maryland","Baltimore city",4,18,7384,3522,3862
050,24,510,"Maryland","Baltimore city",4,19,7801,3711,4090
050,24,510,"Maryland","Baltimore city",4,20,6972,3353,3619
050,24,510,"Maryland","Baltimore city",4,21,6954,3202,3752
050,24,510,"Maryland","Baltimore city",4,22,6984,3240,3744
050,24,510,"Maryland","Baltimore city",4,23,7353,3375,3978
050,24,510,"Maryland","Baltimore city",4,24,8229,3745,4484
050,24,510,"Maryland","Baltimore city",4,25,8716,3983,4733
050,24,510,"Maryland","Baltimore city",4,26,9047,4128,4919
050,24,510,"Maryland","Baltimore city",4,27,9707,4589,5118
050,24,510,"Maryland","Baltimore city",4,28,10329,4786,5543
050,24,510,"Maryland","Baltimore city",4,29,10572,5074,5498
050,24,510,"Maryland","Baltimore city",4,30,10829,5163,5666
050,24,510,"Maryland","Baltimore city",4,31,11117,5245,5872
050,24,510,"Maryland","Baltimore city",4,32,10886,5166,5720
050,24,510,"Maryland","Baltimore city",4,33,10644,5006,5638
050,24,510,"Maryland","Baltimore city",4,34,10148,4847,5301
050,24,510,"Maryland","Baltimore city",4,35,9684,4645,5039
050,24,510,"Maryland","Baltimore city",4,36,9277,4423,4854
050,24,510,"Maryland","Baltimore city",4,37,8843,4167,4676
050,24,510,"Maryland","Baltimore city",4,38,8309,3906,4403
050,24,510,"Maryland","Baltimore city",4,39,8144,3833,4311
050,24,510,"Maryland","Baltimore city",4,40,7819,3570,4249
050,24,510,"Maryland","Baltimore city",4,41,7458,3409,4049
050,24,510,"Maryland","Baltimore city",4,42,7398,3370,4028
050,24,510,"Maryland","Baltimore city",4,43,6855,3155,3700
050,24,510,"Maryland","Baltimore city",4,44,6440,3006,3434
050,24,510,"Maryland","Baltimore city",4,45,6318,2919,3399
050,24,510,"Maryland","Baltimore city",4,46,5756,2654,3102
050,24,510,"Maryland","Baltimore city",4,47,5681,2583,3098
050,24,510,"Maryland","Baltimore city",4,48,5521,2536,2985
050,24,510,"Maryland","Baltimore city",4,49,5542,2538,3004
050,24,510,"Maryland","Baltimore city",4,50,5819,2586,3233
050,24,510,"Maryland","Baltimore city",4,51,6298,2902,3396
050,24,510,"Maryland","Baltimore city",4,52,6336,2992,3344
050,24,510,"Maryland","Baltimore city",4,53,6035,2749,3286
050,24,510,"Maryland","Baltimore city",4,54,6255,2878,3377
050,24,510,"Maryland","Baltimore city",4,55,6391,2937,3454
050,24,510,"Maryland","Baltimore city",4,56,6601,3066,3535
050,24,510,"Maryland","Baltimore city",4,57,7026,3297,3729
050,24,510,"Maryland","Baltimore city",4,58,7132,3344,3788
050,24,510,"Maryland","Baltimore city",4,59,6987,3228,3759
050,24,510,"Maryland","Baltimore city",4,60,7077,3213,3864
050,24,510,"Maryland","Baltimore city",4,61,7238,3224,4014
050,24,510,"Maryland","Baltimore city",4,62,7175,3186,3989
050,24,510,"Maryland","Baltimore city",4,63,7133,3067,4066
050,24,510,"Maryland","Baltimore city",4,64,6911,3052,3859
050,24,510,"Maryland","Baltimore city",4,65,6701,2906,3795
050,24,510,"Maryland","Baltimore city",4,66,6264,2690,3574
050,24,510,"Maryland","Baltimore city",4,67,5995,2602,3393
050,24,510,"Maryland","Baltimore city",4,68,5731,2492,3239
050,24,510,"Maryland","Baltimore city",4,69,5585,2399,3186
050,24,510,"Maryland","Baltimore city",4,70,5239,2217,3022
050,24,510,"Maryland","Baltimore city",4,71,5159,2184,2975
050,24,510,"Maryland","Baltimore city",4,72,4809,2067,2742
050,24,510,"Maryland","Baltimore city",4,73,4550,1913,2637
050,24,510,"Maryland","Baltimore city",4,74,4226,1762,2464
050,24,510,"Maryland","Baltimore city",4,75,4126,1771,2355
050,24,510,"Maryland","Baltimore city",4,76,2939,1185,1754
050,24,510,"Maryland","Baltimore city",4,77,2802,1094,1708
050,24,510,"Maryland","Baltimore city",4,78,2648,1036,1612
050,24,510,"Maryland","Baltimore city",4,79,2616,1032,1584
050,24,510,"Maryland","Baltimore city",4,80,2259,917,1342
050,24,510,"Maryland","Baltimore city",4,81,1989,760,1229
050,24,510,"Maryland","Baltimore city",4,82,1848,703,1145
050,24,510,"Maryland","Baltimore city",4,83,1657,615,1042
050,24,510,"Maryland","Baltimore city",4,84,1503,526,977
050,24,510,"Maryland","Baltimore city",4,85,8833,2857,5976
050,24,510,"Maryland","Baltimore city",5,0,7213,3535,3678
050,24,510,"Maryland","Baltimore city",5,1,6828,3325,3503
050,24,510,"Maryland","Baltimore city",5,2,6426,3184,3242
050,24,510,"Maryland","Baltimore city",5,3,6544,3307,3237
050,24,510,"Maryland","Baltimore city",5,4,6670,3393,3277
050,24,510,"Maryland","Baltimore city",5,5,6581,3297,3284
050,24,510,"Maryland","Baltimore city",5,6,6629,3390,3239
050,24,510,"Maryland","Baltimore city",5,7,6696,3419,3277
050,24,510,"Maryland","Baltimore city",5,8,6588,3465,3123
050,24,510,"Maryland","Baltimore city",5,9,6392,3347,3045
050,24,510,"Maryland","Baltimore city",5,10,6270,3197,3073
050,24,510,"Maryland","Baltimore city",5,11,6269,3199,3070
050,24,510,"Maryland","Baltimore city",5,12,6271,3170,3101
050,24,510,"Maryland","Baltimore city",5,13,6282,3163,3119
050,24,510,"Maryland","Baltimore city",5,14,6561,3302,3259
050,24,510,"Maryland","Baltimore city",5,15,6727,3370,3357
050,24,510,"Maryland","Baltimore city",5,16,6536,3257,3279
050,24,510,"Maryland","Baltimore city",5,17,6270,3186,3084
050,24,510,"Maryland","Baltimore city",5,18,7454,3572,3882
050,24,510,"Maryland","Baltimore city",5,19,7986,3804,4182
050,24,510,"Maryland","Baltimore city",5,20,6903,3343,3560
050,24,510,"Maryland","Baltimore city",5,21,6726,3155,3571
050,24,510,"Maryland","Baltimore city",5,22,6814,3171,3643
050,24,510,"Maryland","Baltimore city",5,23,7527,3450,4077
050,24,510,"Maryland","Baltimore city",5,24,7988,3708,4280
050,24,510,"Maryland","Baltimore city",5,25,8577,4002,4575
050,24,510,"Maryland","Baltimore city",5,26,9020,4149,4871
050,24,510,"Maryland","Baltimore city",5,27,9076,4203,4873
050,24,510,"Maryland","Baltimore city",5,28,9600,4497,5103
050,24,510,"Maryland","Baltimore city",5,29,10155,4791,5364
050,24,510,"Maryland","Baltimore city",5,30,10351,4924,5427
050,24,510,"Maryland","Baltimore city",5,31,10692,5092,5600
050,24,510,"Maryland","Baltimore city",5,32,10898,5136,5762
050,24,510,"Maryland","Baltimore city",5,33,10581,5003,5578
050,24,510,"Maryland","Baltimore city",5,34,10222,4820,5402
050,24,510,"Maryland","Baltimore city",5,35,9710,4616,5094
050,24,510,"Maryland","Baltimore city",5,36,9360,4487,4873
050,24,510,"Maryland","Baltimore city",5,37,8945,4191,4754
050,24,510,"Maryland","Baltimore city",5,38,8653,4057,4596
050,24,510,"Maryland","Baltimore city",5,39,8064,3732,4332
050,24,510,"Maryland","Baltimore city",5,40,7940,3742,4198
050,24,510,"Maryland","Baltimore city",5,41,7596,3425,4171
050,24,510,"Maryland","Baltimore city",5,42,7332,3331,4001
050,24,510,"Maryland","Baltimore city",5,43,7259,3325,3934
050,24,510,"Maryland","Baltimore city",5,44,6682,3045,3637
050,24,510,"Maryland","Baltimore city",5,45,6348,2943,3405
050,24,510,"Maryland","Baltimore city",5,46,6193,2830,3363
050,24,510,"Maryland","Baltimore city",5,47,5573,2584,2989
050,24,510,"Maryland","Baltimore city",5,48,5675,2583,3092
050,24,510,"Maryland","Baltimore city",5,49,5412,2469,2943
050,24,510,"Maryland","Baltimore city",5,50,5449,2470,2979
050,24,510,"Maryland","Baltimore city",5,51,5755,2542,3213
050,24,510,"Maryland","Baltimore city",5,52,6181,2804,3377
050,24,510,"Maryland","Baltimore city",5,53,6154,2847,3307
050,24,510,"Maryland","Baltimore city",5,54,5921,2690,3231
050,24,510,"Maryland","Baltimore city",5,55,6171,2825,3346
050,24,510,"Maryland","Baltimore city",5,56,6247,2863,3384
050,24,510,"Maryland","Baltimore city",5,57,6479,2993,3486
050,24,510,"Maryland","Baltimore city",5,58,6785,3185,3600
050,24,510,"Maryland","Baltimore city",5,59,6986,3260,3726
050,24,510,"Maryland","Baltimore city",5,60,6815,3136,3679
050,24,510,"Maryland","Baltimore city",5,61,6874,3109,3765
050,24,510,"Maryland","Baltimore city",5,62,7015,3099,3916
050,24,510,"Maryland","Baltimore city",5,63,6953,3060,3893
050,24,510,"Maryland","Baltimore city",5,64,6915,2934,3981
050,24,510,"Maryland","Baltimore city",5,65,6667,2920,3747
050,24,510,"Maryland","Baltimore city",5,66,6476,2786,3690
050,24,510,"Maryland","Baltimore city",5,67,6077,2588,3489
050,24,510,"Maryland","Baltimore city",5,68,5809,2500,3309
050,24,510,"Maryland","Baltimore city",5,69,5524,2382,3142
050,24,510,"Maryland","Baltimore city",5,70,5432,2305,3127
050,24,510,"Maryland","Baltimore city",5,71,5068,2117,2951
050,24,510,"Maryland","Baltimore city",5,72,4969,2093,2876
050,24,510,"Maryland","Baltimore city",5,73,4632,1975,2657
050,24,510,"Maryland","Baltimore city",5,74,4425,1840,2585
050,24,510,"Maryland","Baltimore city",5,75,4021,1674,2347
050,24,510,"Maryland","Baltimore city",5,76,3966,1682,2284
050,24,510,"Maryland","Baltimore city",5,77,2792,1106,1686
050,24,510,"Maryland","Baltimore city",5,78,2656,1028,1628
050,24,510,"Maryland","Baltimore city",5,79,2514,982,1532
050,24,510,"Maryland","Baltimore city",5,80,2445,959,1486
050,24,510,"Maryland","Baltimore city",5,81,2108,835,1273
050,24,510,"Maryland","Baltimore city",5,82,1865,704,1161
050,24,510,"Maryland","Baltimore city",5,83,1689,628,1061
050,24,510,"Maryland","Baltimore city",5,84,1523,556,967
050,24,510,"Maryland","Baltimore city",5,85,8816,2857,5959

