"SUMLEV","STATE","COUNTY","STNAME","CTYNAME","YEAR","AGE","TOT_POP","TOT_MALE","TOT_FEMALE"
050,02,013,"Alaska","Aleutians East Borough",1,0,4,2,2
050,02,013,"Alaska","Aleutians East Borough",1,1,11,5,6
050,02,013,"Alaska","Aleutians East Borough",1,2,9,5,4
050,02,013,"Alaska","Aleutians East Borough",1,3,12,5,7
050,02,013,"Alaska","Aleutians East Borough",1,4,14,7,7
050,02,013,"Alaska","Aleutians East Borough",1,5,11,5,6
050,02,013,"Alaska","Aleutians East Borough",1,6,13,3,10
050,02,013,"Alaska","Aleutians East Borough",1,7,13,5,8
050,02,013,"Alaska","Aleutians East Borough",1,8,10,4,6
050,02,013,"Alaska","Aleutians East Borough",1,9,12,5,7
050,02,013,"Alaska","Aleutians East Borough",1,10,13,6,7
050,02,013,"Alaska","Aleutians East Borough",1,11,15,8,7
050,02,013,"Alaska","Aleutians East Borough",1,12,11,6,5
050,02,013,"Alaska","Aleutians East Borough",1,13,8,4,4
050,02,013,"Alaska","Aleutians East Borough",1,14,13,8,5
050,02,013,"Alaska","Aleutians East Borough",1,15,12,6,6
050,02,013,"Alaska","Aleutians East Borough",1,16,10,6,4
050,02,013,"Alaska","Aleutians East Borough",1,17,9,3,6
050,02,013,"Alaska","Aleutians East Borough",1,18,15,11,4
050,02,013,"Alaska","Aleutians East Borough",1,19,23,19,4
050,02,013,"Alaska","Aleutians East Borough",1,20,42,33,9
050,02,013,"Alaska","Aleutians East Borough",1,21,47,37,10
050,02,013,"Alaska","Aleutians East Borough",1,22,60,47,13
050,02,013,"Alaska","Aleutians East Borough",1,23,63,52,11
050,02,013,"Alaska","Aleutians East Borough",1,24,72,62,10
050,02,013,"Alaska","Aleutians East Borough",1,25,60,55,5
050,02,013,"Alaska","Aleutians East Borough",1,26,76,64,12
050,02,013,"Alaska","Aleutians East Borough",1,27,59,44,15
050,02,013,"Alaska","Aleutians East Borough",1,28,63,45,18
050,02,013,"Alaska","Aleutians East Borough",1,29,48,37,11
050,02,013,"Alaska","Aleutians East Borough",1,30,54,44,10
050,02,013,"Alaska","Aleutians East Borough",1,31,46,34,12
050,02,013,"Alaska","Aleutians East Borough",1,32,48,38,10
050,02,013,"Alaska","Aleutians East Borough",1,33,48,38,10
050,02,013,"Alaska","Aleutians East Borough",1,34,34,28,6
050,02,013,"Alaska","Aleutians East Borough",1,35,56,48,8
050,02,013,"Alaska","Aleutians East Borough",1,36,76,54,22
050,02,013,"Alaska","Aleutians East Borough",1,37,63,43,20
050,02,013,"Alaska","Aleutians East Borough",1,38,47,33,14
050,02,013,"Alaska","Aleutians East Borough",1,39,70,58,12
050,02,013,"Alaska","Aleutians East Borough",1,40,76,51,25
050,02,013,"Alaska","Aleutians East Borough",1,41,76,52,24
050,02,013,"Alaska","Aleutians East Borough",1,42,91,65,26
050,02,013,"Alaska","Aleutians East Borough",1,43,74,51,23
050,02,013,"Alaska","Aleutians East Borough",1,44,92,68,24
050,02,013,"Alaska","Aleutians East Borough",1,45,101,73,28
050,02,013,"Alaska","Aleutians East Borough",1,46,99,71,28
050,02,013,"Alaska","Aleutians East Borough",1,47,94,68,26
050,02,013,"Alaska","Aleutians East Borough",1,48,80,62,18
050,02,013,"Alaska","Aleutians East Borough",1,49,76,55,21
050,02,013,"Alaska","Aleutians East Borough",1,50,84,57,27
050,02,013,"Alaska","Aleutians East Borough",1,51,89,57,32
050,02,013,"Alaska","Aleutians East Borough",1,52,87,61,26
050,02,013,"Alaska","Aleutians East Borough",1,53,83,53,30
050,02,013,"Alaska","Aleutians East Borough",1,54,70,51,19
050,02,013,"Alaska","Aleutians East Borough",1,55,73,51,22
050,02,013,"Alaska","Aleutians East Borough",1,56,66,48,18
050,02,013,"Alaska","Aleutians East Borough",1,57,64,33,31
050,02,013,"Alaska","Aleutians East Borough",1,58,56,36,20
050,02,013,"Alaska","Aleutians East Borough",1,59,53,40,13
050,02,013,"Alaska","Aleutians East Borough",1,60,52,32,20
050,02,013,"Alaska","Aleutians East Borough",1,61,51,29,22
050,02,013,"Alaska","Aleutians East Borough",1,62,34,19,15
050,02,013,"Alaska","Aleutians East Borough",1,63,31,20,11
050,02,013,"Alaska","Aleutians East Borough",1,64,41,28,13
050,02,013,"Alaska","Aleutians East Borough",1,65,26,19,7
050,02,013,"Alaska","Aleutians East Borough",1,66,23,12,11
050,02,013,"Alaska","Aleutians East Borough",1,67,18,9,9
050,02,013,"Alaska","Aleutians East Borough",1,68,17,9,8
050,02,013,"Alaska","Aleutians East Borough",1,69,13,8,5
050,02,013,"Alaska","Aleutians East Borough",1,70,20,11,9
050,02,013,"Alaska","Aleutians East Borough",1,71,8,3,5
050,02,013,"Alaska","Aleutians East Borough",1,72,18,10,8
050,02,013,"Alaska","Aleutians East Borough",1,73,19,10,9
050,02,013,"Alaska","Aleutians East Borough",1,74,18,9,9
050,02,013,"Alaska","Aleutians East Borough",1,75,18,8,10
050,02,013,"Alaska","Aleutians East Borough",1,76,17,9,8
050,02,013,"Alaska","Aleutians East Borough",1,77,9,8,1
050,02,013,"Alaska","Aleutians East Borough",1,78,2,2,0
050,02,013,"Alaska","Aleutians East Borough",1,79,6,4,2
050,02,013,"Alaska","Aleutians East Borough",1,80,0,0,0
050,02,013,"Alaska","Aleutians East Borough",1,81,2,2,0
050,02,013,"Alaska","Aleutians East Borough",1,82,4,4,0
050,02,013,"Alaska","Aleutians East Borough",1,83,1,1,0
050,02,013,"Alaska","Aleutians East Borough",1,84,0,0,0
050,02,013,"Alaska","Aleutians East Borough",1,85,19,13,6
050,02,013,"Alaska","Aleutians East Borough",2,0,11,5,6
050,02,013,"Alaska","Aleutians East Borough",2,1,10,5,5
050,02,013,"Alaska","Aleutians East Borough",2,2,9,5,4
050,02,013,"Alaska","Aleutians East Borough",2,3,12,5,7
050,02,013,"Alaska","Aleutians East Borough",2,4,13,6,7
050,02,013,"Alaska","Aleutians East Borough",2,5,12,5,7
050,02,013,"Alaska","Aleutians East Borough",2,6,13,3,10
050,02,013,"Alaska","Aleutians East Borough",2,7,13,5,8
050,02,013,"Alaska","Aleutians East Borough",2,8,9,4,5
050,02,013,"Alaska","Aleutians East Borough",2,9,12,5,7
050,02,013,"Alaska","Aleutians East Borough",2,10,13,6,7
050,02,013,"Alaska","Aleutians East Borough",2,11,15,8,7
050,02,013,"Alaska","Aleutians East Borough",2,12,11,6,5
050,02,013,"Alaska","Aleutians East Borough",2,13,8,4,4
050,02,013,"Alaska","Aleutians East Borough",2,14,13,8,5
050,02,013,"Alaska","Aleutians East Borough",2,15,13,7,6
050,02,013,"Alaska","Aleutians East Borough",2,16,10,6,4
050,02,013,"Alaska","Aleutians East Borough",2,17,8,3,5
050,02,013,"Alaska","Aleutians East Borough",2,18,15,11,4
050,02,013,"Alaska","Aleutians East Borough",2,19,23,19,4
050,02,013,"Alaska","Aleutians East Borough",2,20,42,33,9
050,02,013,"Alaska","Aleutians East Borough",2,21,45,35,10
050,02,013,"Alaska","Aleutians East Borough",2,22,60,47,13
050,02,013,"Alaska","Aleutians East Borough",2,23,64,53,11
050,02,013,"Alaska","Aleutians East Borough",2,24,71,62,9
050,02,013,"Alaska","Aleutians East Borough",2,25,59,54,5
050,02,013,"Alaska","Aleutians East Borough",2,26,76,64,12
050,02,013,"Alaska","Aleutians East Borough",2,27,60,45,15
050,02,013,"Alaska","Aleutians East Borough",2,28,64,46,18
050,02,013,"Alaska","Aleutians East Borough",2,29,48,37,11
050,02,013,"Alaska","Aleutians East Borough",2,30,55,45,10
050,02,013,"Alaska","Aleutians East Borough",2,31,45,33,12
050,02,013,"Alaska","Aleutians East Borough",2,32,46,36,10
050,02,013,"Alaska","Aleutians East Borough",2,33,46,37,9
050,02,013,"Alaska","Aleutians East Borough",2,34,35,29,6
050,02,013,"Alaska","Aleutians East Borough",2,35,56,48,8
050,02,013,"Alaska","Aleutians East Borough",2,36,76,54,22
050,02,013,"Alaska","Aleutians East Borough",2,37,64,44,20
050,02,013,"Alaska","Aleutians East Borough",2,38,48,33,15
050,02,013,"Alaska","Aleutians East Borough",2,39,69,57,12
050,02,013,"Alaska","Aleutians East Borough",2,40,78,52,26
050,02,013,"Alaska","Aleutians East Borough",2,41,77,53,24
050,02,013,"Alaska","Aleutians East Borough",2,42,91,65,26
050,02,013,"Alaska","Aleutians East Borough",2,43,74,51,23
050,02,013,"Alaska","Aleutians East Borough",2,44,91,68,23
050,02,013,"Alaska","Aleutians East Borough",2,45,100,73,27
050,02,013,"Alaska","Aleutians East Borough",2,46,97,70,27
050,02,013,"Alaska","Aleutians East Borough",2,47,93,67,26
050,02,013,"Alaska","Aleutians East Borough",2,48,83,64,19
050,02,013,"Alaska","Aleutians East Borough",2,49,75,55,20
050,02,013,"Alaska","Aleutians East Borough",2,50,84,57,27
050,02,013,"Alaska","Aleutians East Borough",2,51,89,57,32
050,02,013,"Alaska","Aleutians East Borough",2,52,86,60,26
050,02,013,"Alaska","Aleutians East Borough",2,53,83,53,30
050,02,013,"Alaska","Aleutians East Borough",2,54,70,51,19
050,02,013,"Alaska","Aleutians East Borough",2,55,72,50,22
050,02,013,"Alaska","Aleutians East Borough",2,56,66,49,17
050,02,013,"Alaska","Aleutians East Borough",2,57,64,32,32
050,02,013,"Alaska","Aleutians East Borough",2,58,56,35,21
050,02,013,"Alaska","Aleutians East Borough",2,59,53,40,13
050,02,013,"Alaska","Aleutians East Borough",2,60,53,33,20
050,02,013,"Alaska","Aleutians East Borough",2,61,49,28,21
050,02,013,"Alaska","Aleutians East Borough",2,62,33,18,15
050,02,013,"Alaska","Aleutians East Borough",2,63,31,20,11
050,02,013,"Alaska","Aleutians East Borough",2,64,40,27,13
050,02,013,"Alaska","Aleutians East Borough",2,65,27,19,8
050,02,013,"Alaska","Aleutians East Borough",2,66,25,13,12
050,02,013,"Alaska","Aleutians East Borough",2,67,18,9,9
050,02,013,"Alaska","Aleutians East Borough",2,68,18,10,8
050,02,013,"Alaska","Aleutians East Borough",2,69,14,9,5
050,02,013,"Alaska","Aleutians East Borough",2,70,21,11,10
050,02,013,"Alaska","Aleutians East Borough",2,71,8,3,5
050,02,013,"Alaska","Aleutians East Borough",2,72,17,9,8
050,02,013,"Alaska","Aleutians East Borough",2,73,19,10,9
050,02,013,"Alaska","Aleutians East Borough",2,74,17,8,9
050,02,013,"Alaska","Aleutians East Borough",2,75,18,8,10
050,02,013,"Alaska","Aleutians East Borough",2,76,18,9,9
050,02,013,"Alaska","Aleutians East Borough",2,77,12,9,3
050,02,013,"Alaska","Aleutians East Borough",2,78,3,3,0
050,02,013,"Alaska","Aleutians East Borough",2,79,6,4,2
050,02,013,"Alaska","Aleutians East Borough",2,80,1,1,0
050,02,013,"Alaska","Aleutians East Borough",2,81,1,1,0
050,02,013,"Alaska","Aleutians East Borough",2,82,4,4,0
050,02,013,"Alaska","Aleutians East Borough",2,83,1,1,0
050,02,013,"Alaska","Aleutians East Borough",2,84,0,0,0
050,02,013,"Alaska","Aleutians East Borough",2,85,19,13,6
050,02,013,"Alaska","Aleutians East Borough",3,0,7,4,3
050,02,013,"Alaska","Aleutians East Borough",3,1,15,11,4
050,02,013,"Alaska","Aleutians East Borough",3,2,7,2,5
050,02,013,"Alaska","Aleutians East Borough",3,3,8,5,3
050,02,013,"Alaska","Aleutians East Borough",3,4,12,4,8
050,02,013,"Alaska","Aleutians East Borough",3,5,15,8,7
050,02,013,"Alaska","Aleutians East Borough",3,6,11,4,7
050,02,013,"Alaska","Aleutians East Borough",3,7,12,4,8
050,02,013,"Alaska","Aleutians East Borough",3,8,13,5,8
050,02,013,"Alaska","Aleutians East Borough",3,9,8,4,4
050,02,013,"Alaska","Aleutians East Borough",3,10,13,6,7
050,02,013,"Alaska","Aleutians East Borough",3,11,11,5,6
050,02,013,"Alaska","Aleutians East Borough",3,12,15,9,6
050,02,013,"Alaska","Aleutians East Borough",3,13,10,5,5
050,02,013,"Alaska","Aleutians East Borough",3,14,10,5,5
050,02,013,"Alaska","Aleutians East Borough",3,15,11,5,6
050,02,013,"Alaska","Aleutians East Borough",3,16,13,5,8
050,02,013,"Alaska","Aleutians East Borough",3,17,11,7,4
050,02,013,"Alaska","Aleutians East Borough",3,18,12,6,6
050,02,013,"Alaska","Aleutians East Borough",3,19,25,22,3
050,02,013,"Alaska","Aleutians East Borough",3,20,37,30,7
050,02,013,"Alaska","Aleutians East Borough",3,21,44,34,10
050,02,013,"Alaska","Aleutians East Borough",3,22,57,45,12
050,02,013,"Alaska","Aleutians East Borough",3,23,66,53,13
050,02,013,"Alaska","Aleutians East Borough",3,24,72,65,7
050,02,013,"Alaska","Aleutians East Borough",3,25,58,50,8
050,02,013,"Alaska","Aleutians East Borough",3,26,71,61,10
050,02,013,"Alaska","Aleutians East Borough",3,27,63,46,17
050,02,013,"Alaska","Aleutians East Borough",3,28,56,44,12
050,02,013,"Alaska","Aleutians East Borough",3,29,57,39,18
050,02,013,"Alaska","Aleutians East Borough",3,30,57,48,9
050,02,013,"Alaska","Aleutians East Borough",3,31,51,38,13
050,02,013,"Alaska","Aleutians East Borough",3,32,46,37,9
050,02,013,"Alaska","Aleutians East Borough",3,33,44,30,14
050,02,013,"Alaska","Aleutians East Borough",3,34,41,33,8
050,02,013,"Alaska","Aleutians East Borough",3,35,57,47,10
050,02,013,"Alaska","Aleutians East Borough",3,36,70,53,17
050,02,013,"Alaska","Aleutians East Borough",3,37,68,49,19
050,02,013,"Alaska","Aleutians East Borough",3,38,48,32,16
050,02,013,"Alaska","Aleutians East Borough",3,39,71,61,10
050,02,013,"Alaska","Aleutians East Borough",3,40,82,52,30
050,02,013,"Alaska","Aleutians East Borough",3,41,76,52,24
050,02,013,"Alaska","Aleutians East Borough",3,42,90,68,22
050,02,013,"Alaska","Aleutians East Borough",3,43,73,48,25
050,02,013,"Alaska","Aleutians East Borough",3,44,92,69,23
050,02,013,"Alaska","Aleutians East Borough",3,45,101,75,26
050,02,013,"Alaska","Aleutians East Borough",3,46,83,63,20
050,02,013,"Alaska","Aleutians East Borough",3,47,94,68,26
050,02,013,"Alaska","Aleutians East Borough",3,48,89,68,21
050,02,013,"Alaska","Aleutians East Borough",3,49,75,54,21
050,02,013,"Alaska","Aleutians East Borough",3,50,76,52,24
050,02,013,"Alaska","Aleutians East Borough",3,51,90,58,32
050,02,013,"Alaska","Aleutians East Borough",3,52,80,56,24
050,02,013,"Alaska","Aleutians East Borough",3,53,88,57,31
050,02,013,"Alaska","Aleutians East Borough",3,54,68,49,19
050,02,013,"Alaska","Aleutians East Borough",3,55,66,46,20
050,02,013,"Alaska","Aleutians East Borough",3,56,62,47,15
050,02,013,"Alaska","Aleutians East Borough",3,57,63,30,33
050,02,013,"Alaska","Aleutians East Borough",3,58,60,36,24
050,02,013,"Alaska","Aleutians East Borough",3,59,52,38,14
050,02,013,"Alaska","Aleutians East Borough",3,60,48,28,20
050,02,013,"Alaska","Aleutians East Borough",3,61,46,26,20
050,02,013,"Alaska","Aleutians East Borough",3,62,30,15,15
050,02,013,"Alaska","Aleutians East Borough",3,63,29,18,11
050,02,013,"Alaska","Aleutians East Borough",3,64,32,23,9
050,02,013,"Alaska","Aleutians East Borough",3,65,28,22,6
050,02,013,"Alaska","Aleutians East Borough",3,66,22,10,12
050,02,013,"Alaska","Aleutians East Borough",3,67,22,12,10
050,02,013,"Alaska","Aleutians East Borough",3,68,19,11,8
050,02,013,"Alaska","Aleutians East Borough",3,69,20,12,8
050,02,013,"Alaska","Aleutians East Borough",3,70,21,12,9
050,02,013,"Alaska","Aleutians East Borough",3,71,10,4,6
050,02,013,"Alaska","Aleutians East Borough",3,72,10,4,6
050,02,013,"Alaska","Aleutians East Borough",3,73,15,9,6
050,02,013,"Alaska","Aleutians East Borough",3,74,23,13,10
050,02,013,"Alaska","Aleutians East Borough",3,75,18,8,10
050,02,013,"Alaska","Aleutians East Borough",3,76,21,8,13
050,02,013,"Alaska","Aleutians East Borough",3,77,21,13,8
050,02,013,"Alaska","Aleutians East Borough",3,78,9,6,3
050,02,013,"Alaska","Aleutians East Borough",3,79,4,4,0
050,02,013,"Alaska","Aleutians East Borough",3,80,7,5,2
050,02,013,"Alaska","Aleutians East Borough",3,81,1,1,0
050,02,013,"Alaska","Aleutians East Borough",3,82,1,1,0
050,02,013,"Alaska","Aleutians East Borough",3,83,5,5,0
050,02,013,"Alaska","Aleutians East Borough",3,84,1,1,0
050,02,013,"Alaska","Aleutians East Borough",3,85,21,14,7
050,02,013,"Alaska","Aleutians East Borough",4,0,8,5,3
050,02,013,"Alaska","Aleutians East Borough",4,1,7,5,2
050,02,013,"Alaska","Aleutians East Borough",4,2,11,8,3
050,02,013,"Alaska","Aleutians East Borough",4,3,7,2,5
050,02,013,"Alaska","Aleutians East Borough",4,4,9,6,3
050,02,013,"Alaska","Aleutians East Borough",4,5,13,5,8
050,02,013,"Alaska","Aleutians East Borough",4,6,12,7,5
050,02,013,"Alaska","Aleutians East Borough",4,7,10,3,7
050,02,013,"Alaska","Aleutians East Borough",4,8,10,3,7
050,02,013,"Alaska","Aleutians East Borough",4,9,11,5,6
050,02,013,"Alaska","Aleutians East Borough",4,10,7,4,3
050,02,013,"Alaska","Aleutians East Borough",4,11,11,5,6
050,02,013,"Alaska","Aleutians East Borough",4,12,10,4,6
050,02,013,"Alaska","Aleutians East Borough",4,13,16,10,6
050,02,013,"Alaska","Aleutians East Borough",4,14,10,5,5
050,02,013,"Alaska","Aleutians East Borough",4,15,9,6,3
050,02,013,"Alaska","Aleutians East Borough",4,16,10,5,5
050,02,013,"Alaska","Aleutians East Borough",4,17,8,3,5
050,02,013,"Alaska","Aleutians East Borough",4,18,11,8,3
050,02,013,"Alaska","Aleutians East Borough",4,19,25,19,6
050,02,013,"Alaska","Aleutians East Borough",4,20,41,33,8
050,02,013,"Alaska","Aleutians East Borough",4,21,45,37,8
050,02,013,"Alaska","Aleutians East Borough",4,22,53,45,8
050,02,013,"Alaska","Aleutians East Borough",4,23,60,47,13
050,02,013,"Alaska","Aleutians East Borough",4,24,70,63,7
050,02,013,"Alaska","Aleutians East Borough",4,25,72,65,7
050,02,013,"Alaska","Aleutians East Borough",4,26,74,61,13
050,02,013,"Alaska","Aleutians East Borough",4,27,51,37,14
050,02,013,"Alaska","Aleutians East Borough",4,28,60,47,13
050,02,013,"Alaska","Aleutians East Borough",4,29,54,40,14
050,02,013,"Alaska","Aleutians East Borough",4,30,62,46,16
050,02,013,"Alaska","Aleutians East Borough",4,31,46,32,14
050,02,013,"Alaska","Aleutians East Borough",4,32,54,41,13
050,02,013,"Alaska","Aleutians East Borough",4,33,46,35,11
050,02,013,"Alaska","Aleutians East Borough",4,34,42,28,14
050,02,013,"Alaska","Aleutians East Borough",4,35,60,49,11
050,02,013,"Alaska","Aleutians East Borough",4,36,75,56,19
050,02,013,"Alaska","Aleutians East Borough",4,37,58,44,14
050,02,013,"Alaska","Aleutians East Borough",4,38,53,38,15
050,02,013,"Alaska","Aleutians East Borough",4,39,77,62,15
050,02,013,"Alaska","Aleutians East Borough",4,40,90,60,30
050,02,013,"Alaska","Aleutians East Borough",4,41,89,61,28
050,02,013,"Alaska","Aleutians East Borough",4,42,86,64,22
050,02,013,"Alaska","Aleutians East Borough",4,43,72,51,21
050,02,013,"Alaska","Aleutians East Borough",4,44,90,68,22
050,02,013,"Alaska","Aleutians East Borough",4,45,99,74,25
050,02,013,"Alaska","Aleutians East Borough",4,46,90,66,24
050,02,013,"Alaska","Aleutians East Borough",4,47,81,60,21
050,02,013,"Alaska","Aleutians East Borough",4,48,86,66,20
050,02,013,"Alaska","Aleutians East Borough",4,49,81,59,22
050,02,013,"Alaska","Aleutians East Borough",4,50,76,52,24
050,02,013,"Alaska","Aleutians East Borough",4,51,81,55,26
050,02,013,"Alaska","Aleutians East Borough",4,52,83,60,23
050,02,013,"Alaska","Aleutians East Borough",4,53,81,50,31
050,02,013,"Alaska","Aleutians East Borough",4,54,75,54,21
050,02,013,"Alaska","Aleutians East Borough",4,55,68,45,23
050,02,013,"Alaska","Aleutians East Borough",4,56,54,44,10
050,02,013,"Alaska","Aleutians East Borough",4,57,63,32,31
050,02,013,"Alaska","Aleutians East Borough",4,58,62,38,24
050,02,013,"Alaska","Aleutians East Borough",4,59,55,41,14
050,02,013,"Alaska","Aleutians East Borough",4,60,49,28,21
050,02,013,"Alaska","Aleutians East Borough",4,61,45,25,20
050,02,013,"Alaska","Aleutians East Borough",4,62,30,16,14
050,02,013,"Alaska","Aleutians East Borough",4,63,28,15,13
050,02,013,"Alaska","Aleutians East Borough",4,64,34,24,10
050,02,013,"Alaska","Aleutians East Borough",4,65,22,17,5
050,02,013,"Alaska","Aleutians East Borough",4,66,24,15,9
050,02,013,"Alaska","Aleutians East Borough",4,67,20,8,12
050,02,013,"Alaska","Aleutians East Borough",4,68,17,8,9
050,02,013,"Alaska","Aleutians East Borough",4,69,18,13,5
050,02,013,"Alaska","Aleutians East Borough",4,70,27,15,12
050,02,013,"Alaska","Aleutians East Borough",4,71,11,7,4
050,02,013,"Alaska","Aleutians East Borough",4,72,12,5,7
050,02,013,"Alaska","Aleutians East Borough",4,73,8,3,5
050,02,013,"Alaska","Aleutians East Borough",4,74,19,12,7
050,02,013,"Alaska","Aleutians East Borough",4,75,24,13,11
050,02,013,"Alaska","Aleutians East Borough",4,76,21,8,13
050,02,013,"Alaska","Aleutians East Borough",4,77,23,11,12
050,02,013,"Alaska","Aleutians East Borough",4,78,19,10,9
050,02,013,"Alaska","Aleutians East Borough",4,79,8,5,3
050,02,013,"Alaska","Aleutians East Borough",4,80,4,4,0
050,02,013,"Alaska","Aleutians East Borough",4,81,8,6,2
050,02,013,"Alaska","Aleutians East Borough",4,82,1,1,0
050,02,013,"Alaska","Aleutians East Borough",4,83,1,1,0
050,02,013,"Alaska","Aleutians East Borough",4,84,6,6,0
050,02,013,"Alaska","Aleutians East Borough",4,85,21,13,8
050,02,013,"Alaska","Aleutians East Borough",5,0,12,9,3
050,02,013,"Alaska","Aleutians East Borough",5,1,9,6,3
050,02,013,"Alaska","Aleutians East Borough",5,2,6,4,2
050,02,013,"Alaska","Aleutians East Borough",5,3,11,8,3
050,02,013,"Alaska","Aleutians East Borough",5,4,12,3,9
050,02,013,"Alaska","Aleutians East Borough",5,5,13,9,4
050,02,013,"Alaska","Aleutians East Borough",5,6,12,4,8
050,02,013,"Alaska","Aleutians East Borough",5,7,12,6,6
050,02,013,"Alaska","Aleutians East Borough",5,8,10,5,5
050,02,013,"Alaska","Aleutians East Borough",5,9,9,3,6
050,02,013,"Alaska","Aleutians East Borough",5,10,11,3,8
050,02,013,"Alaska","Aleutians East Borough",5,11,9,6,3
050,02,013,"Alaska","Aleutians East Borough",5,12,12,6,6
050,02,013,"Alaska","Aleutians East Borough",5,13,11,4,7
050,02,013,"Alaska","Aleutians East Borough",5,14,12,6,6
050,02,013,"Alaska","Aleutians East Borough",5,15,9,5,4
050,02,013,"Alaska","Aleutians East Borough",5,16,11,7,4
050,02,013,"Alaska","Aleutians East Borough",5,17,10,4,6
050,02,013,"Alaska","Aleutians East Borough",5,18,12,7,5
050,02,013,"Alaska","Aleutians East Borough",5,19,23,20,3
050,02,013,"Alaska","Aleutians East Borough",5,20,40,31,9
050,02,013,"Alaska","Aleutians East Borough",5,21,45,36,9
050,02,013,"Alaska","Aleutians East Borough",5,22,56,47,9
050,02,013,"Alaska","Aleutians East Borough",5,23,63,52,11
050,02,013,"Alaska","Aleutians East Borough",5,24,70,61,9
050,02,013,"Alaska","Aleutians East Borough",5,25,66,59,7
050,02,013,"Alaska","Aleutians East Borough",5,26,76,66,10
050,02,013,"Alaska","Aleutians East Borough",5,27,58,41,17
050,02,013,"Alaska","Aleutians East Borough",5,28,51,40,11
050,02,013,"Alaska","Aleutians East Borough",5,29,45,32,13
050,02,013,"Alaska","Aleutians East Borough",5,30,57,48,9
050,02,013,"Alaska","Aleutians East Borough",5,31,53,36,17
050,02,013,"Alaska","Aleutians East Borough",5,32,48,38,10
050,02,013,"Alaska","Aleutians East Borough",5,33,51,38,13
050,02,013,"Alaska","Aleutians East Borough",5,34,44,34,10
050,02,013,"Alaska","Aleutians East Borough",5,35,57,48,9
050,02,013,"Alaska","Aleutians East Borough",5,36,75,54,21
050,02,013,"Alaska","Aleutians East Borough",5,37,64,48,16
050,02,013,"Alaska","Aleutians East Borough",5,38,44,34,10
050,02,013,"Alaska","Aleutians East Borough",5,39,81,64,17
050,02,013,"Alaska","Aleutians East Borough",5,40,95,61,34
050,02,013,"Alaska","Aleutians East Borough",5,41,85,57,28
050,02,013,"Alaska","Aleutians East Borough",5,42,98,74,24
050,02,013,"Alaska","Aleutians East Borough",5,43,71,48,23
050,02,013,"Alaska","Aleutians East Borough",5,44,90,67,23
050,02,013,"Alaska","Aleutians East Borough",5,45,99,74,25
050,02,013,"Alaska","Aleutians East Borough",5,46,92,68,24
050,02,013,"Alaska","Aleutians East Borough",5,47,92,66,26
050,02,013,"Alaska","Aleutians East Borough",5,48,76,61,15
050,02,013,"Alaska","Aleutians East Borough",5,49,78,58,20
050,02,013,"Alaska","Aleutians East Borough",5,50,83,55,28
050,02,013,"Alaska","Aleutians East Borough",5,51,83,54,29
050,02,013,"Alaska","Aleutians East Borough",5,52,78,57,21
050,02,013,"Alaska","Aleutians East Borough",5,53,81,54,27
050,02,013,"Alaska","Aleutians East Borough",5,54,68,46,22
050,02,013,"Alaska","Aleutians East Borough",5,55,77,51,26
050,02,013,"Alaska","Aleutians East Borough",5,56,59,44,15
050,02,013,"Alaska","Aleutians East Borough",5,57,56,29,27
050,02,013,"Alaska","Aleutians East Borough",5,58,61,39,22
050,02,013,"Alaska","Aleutians East Borough",5,59,58,42,16
050,02,013,"Alaska","Aleutians East Borough",5,60,50,30,20
050,02,013,"Alaska","Aleutians East Borough",5,61,47,25,22
050,02,013,"Alaska","Aleutians East Borough",5,62,26,12,14
050,02,013,"Alaska","Aleutians East Borough",5,63,27,15,12
050,02,013,"Alaska","Aleutians East Borough",5,64,32,21,11
050,02,013,"Alaska","Aleutians East Borough",5,65,26,20,6
050,02,013,"Alaska","Aleutians East Borough",5,66,15,9,6
050,02,013,"Alaska","Aleutians East Borough",5,67,21,14,7
050,02,013,"Alaska","Aleutians East Borough",5,68,20,8,12
050,02,013,"Alaska","Aleutians East Borough",5,69,17,9,8
050,02,013,"Alaska","Aleutians East Borough",5,70,23,14,9
050,02,013,"Alaska","Aleutians East Borough",5,71,16,9,7
050,02,013,"Alaska","Aleutians East Borough",5,72,14,9,5
050,02,013,"Alaska","Aleutians East Borough",5,73,10,4,6
050,02,013,"Alaska","Aleutians East Borough",5,74,10,5,5
050,02,013,"Alaska","Aleutians East Borough",5,75,19,12,7
050,02,013,"Alaska","Aleutians East Borough",5,76,27,13,14
050,02,013,"Alaska","Aleutians East Borough",5,77,23,11,12
050,02,013,"Alaska","Aleutians East Borough",5,78,21,8,13
050,02,013,"Alaska","Aleutians East Borough",5,79,21,11,10
050,02,013,"Alaska","Aleutians East Borough",5,80,8,5,3
050,02,013,"Alaska","Aleutians East Borough",5,81,4,4,0
050,02,013,"Alaska","Aleutians East Borough",5,82,8,6,2
050,02,013,"Alaska","Aleutians East Borough",5,83,1,1,0
050,02,013,"Alaska","Aleutians East Borough",5,84,1,1,0
050,02,013,"Alaska","Aleutians East Borough",5,85,24,18,6
050,02,016,"Alaska","Aleutians West Census Area",1,0,25,15,10
050,02,016,"Alaska","Aleutians West Census Area",1,1,25,14,11
050,02,016,"Alaska","Aleutians West Census Area",1,2,29,16,13
050,02,016,"Alaska","Aleutians West Census Area",1,3,26,16,10
050,02,016,"Alaska","Aleutians West Census Area",1,4,32,17,15
050,02,016,"Alaska","Aleutians West Census Area",1,5,26,10,16
050,02,016,"Alaska","Aleutians West Census Area",1,6,32,18,14
050,02,016,"Alaska","Aleutians West Census Area",1,7,32,17,15
050,02,016,"Alaska","Aleutians West Census Area",1,8,24,12,12
050,02,016,"Alaska","Aleutians West Census Area",1,9,27,14,13
050,02,016,"Alaska","Aleutians West Census Area",1,10,27,14,13
050,02,016,"Alaska","Aleutians West Census Area",1,11,35,18,17
050,02,016,"Alaska","Aleutians West Census Area",1,12,28,17,11
050,02,016,"Alaska","Aleutians West Census Area",1,13,30,11,19
050,02,016,"Alaska","Aleutians West Census Area",1,14,33,16,17
050,02,016,"Alaska","Aleutians West Census Area",1,15,36,18,18
050,02,016,"Alaska","Aleutians West Census Area",1,16,25,15,10
050,02,016,"Alaska","Aleutians West Census Area",1,17,29,16,13
050,02,016,"Alaska","Aleutians West Census Area",1,18,29,15,14
050,02,016,"Alaska","Aleutians West Census Area",1,19,47,33,14
050,02,016,"Alaska","Aleutians West Census Area",1,20,46,34,12
050,02,016,"Alaska","Aleutians West Census Area",1,21,67,49,18
050,02,016,"Alaska","Aleutians West Census Area",1,22,70,54,16
050,02,016,"Alaska","Aleutians West Census Area",1,23,74,51,23
050,02,016,"Alaska","Aleutians West Census Area",1,24,82,59,23
050,02,016,"Alaska","Aleutians West Census Area",1,25,89,72,17
050,02,016,"Alaska","Aleutians West Census Area",1,26,109,94,15
050,02,016,"Alaska","Aleutians West Census Area",1,27,108,92,16
050,02,016,"Alaska","Aleutians West Census Area",1,28,88,66,22
050,02,016,"Alaska","Aleutians West Census Area",1,29,113,73,40
050,02,016,"Alaska","Aleutians West Census Area",1,30,110,80,30
050,02,016,"Alaska","Aleutians West Census Area",1,31,93,66,27
050,02,016,"Alaska","Aleutians West Census Area",1,32,68,47,21
050,02,016,"Alaska","Aleutians West Census Area",1,33,94,71,23
050,02,016,"Alaska","Aleutians West Census Area",1,34,82,55,27
050,02,016,"Alaska","Aleutians West Census Area",1,35,99,72,27
050,02,016,"Alaska","Aleutians West Census Area",1,36,107,76,31
050,02,016,"Alaska","Aleutians West Census Area",1,37,89,68,21
050,02,016,"Alaska","Aleutians West Census Area",1,38,76,65,11
050,02,016,"Alaska","Aleutians West Census Area",1,39,90,61,29
050,02,016,"Alaska","Aleutians West Census Area",1,40,102,76,26
050,02,016,"Alaska","Aleutians West Census Area",1,41,127,96,31
050,02,016,"Alaska","Aleutians West Census Area",1,42,106,72,34
050,02,016,"Alaska","Aleutians West Census Area",1,43,105,77,28
050,02,016,"Alaska","Aleutians West Census Area",1,44,122,98,24
050,02,016,"Alaska","Aleutians West Census Area",1,45,110,88,22
050,02,016,"Alaska","Aleutians West Census Area",1,46,123,95,28
050,02,016,"Alaska","Aleutians West Census Area",1,47,93,65,28
050,02,016,"Alaska","Aleutians West Census Area",1,48,93,58,35
050,02,016,"Alaska","Aleutians West Census Area",1,49,112,79,33
050,02,016,"Alaska","Aleutians West Census Area",1,50,120,79,41
050,02,016,"Alaska","Aleutians West Census Area",1,51,112,78,34
050,02,016,"Alaska","Aleutians West Census Area",1,52,149,113,36
050,02,016,"Alaska","Aleutians West Census Area",1,53,113,67,46
050,02,016,"Alaska","Aleutians West Census Area",1,54,101,76,25
050,02,016,"Alaska","Aleutians West Census Area",1,55,113,82,31
050,02,016,"Alaska","Aleutians West Census Area",1,56,72,50,22
050,02,016,"Alaska","Aleutians West Census Area",1,57,108,72,36
050,02,016,"Alaska","Aleutians West Census Area",1,58,94,66,28
050,02,016,"Alaska","Aleutians West Census Area",1,59,75,47,28
050,02,016,"Alaska","Aleutians West Census Area",1,60,99,61,38
050,02,016,"Alaska","Aleutians West Census Area",1,61,80,57,23
050,02,016,"Alaska","Aleutians West Census Area",1,62,98,74,24
050,02,016,"Alaska","Aleutians West Census Area",1,63,60,35,25
050,02,016,"Alaska","Aleutians West Census Area",1,64,39,27,12
050,02,016,"Alaska","Aleutians West Census Area",1,65,45,36,9
050,02,016,"Alaska","Aleutians West Census Area",1,66,39,23,16
050,02,016,"Alaska","Aleutians West Census Area",1,67,43,29,14
050,02,016,"Alaska","Aleutians West Census Area",1,68,40,25,15
050,02,016,"Alaska","Aleutians West Census Area",1,69,30,11,19
050,02,016,"Alaska","Aleutians West Census Area",1,70,30,23,7
050,02,016,"Alaska","Aleutians West Census Area",1,71,21,12,9
050,02,016,"Alaska","Aleutians West Census Area",1,72,19,14,5
050,02,016,"Alaska","Aleutians West Census Area",1,73,12,8,4
050,02,016,"Alaska","Aleutians West Census Area",1,74,16,8,8
050,02,016,"Alaska","Aleutians West Census Area",1,75,9,3,6
050,02,016,"Alaska","Aleutians West Census Area",1,76,4,2,2
050,02,016,"Alaska","Aleutians West Census Area",1,77,4,1,3
050,02,016,"Alaska","Aleutians West Census Area",1,78,4,3,1
050,02,016,"Alaska","Aleutians West Census Area",1,79,5,4,1
050,02,016,"Alaska","Aleutians West Census Area",1,80,5,2,3
050,02,016,"Alaska","Aleutians West Census Area",1,81,3,2,1
050,02,016,"Alaska","Aleutians West Census Area",1,82,3,1,2
050,02,016,"Alaska","Aleutians West Census Area",1,83,0,0,0
050,02,016,"Alaska","Aleutians West Census Area",1,84,3,2,1
050,02,016,"Alaska","Aleutians West Census Area",1,85,13,5,8
050,02,016,"Alaska","Aleutians West Census Area",2,0,32,18,14
050,02,016,"Alaska","Aleutians West Census Area",2,1,26,15,11
050,02,016,"Alaska","Aleutians West Census Area",2,2,28,15,13
050,02,016,"Alaska","Aleutians West Census Area",2,3,27,17,10
050,02,016,"Alaska","Aleutians West Census Area",2,4,29,16,13
050,02,016,"Alaska","Aleutians West Census Area",2,5,27,11,16
050,02,016,"Alaska","Aleutians West Census Area",2,6,30,16,14
050,02,016,"Alaska","Aleutians West Census Area",2,7,34,19,15
050,02,016,"Alaska","Aleutians West Census Area",2,8,25,13,12
050,02,016,"Alaska","Aleutians West Census Area",2,9,25,13,12
050,02,016,"Alaska","Aleutians West Census Area",2,10,27,14,13
050,02,016,"Alaska","Aleutians West Census Area",2,11,35,18,17
050,02,016,"Alaska","Aleutians West Census Area",2,12,29,17,12
050,02,016,"Alaska","Aleutians West Census Area",2,13,29,12,17
050,02,016,"Alaska","Aleutians West Census Area",2,14,34,17,17
050,02,016,"Alaska","Aleutians West Census Area",2,15,35,17,18
050,02,016,"Alaska","Aleutians West Census Area",2,16,25,15,10
050,02,016,"Alaska","Aleutians West Census Area",2,17,27,15,12
050,02,016,"Alaska","Aleutians West Census Area",2,18,29,16,13
050,02,016,"Alaska","Aleutians West Census Area",2,19,47,33,14
050,02,016,"Alaska","Aleutians West Census Area",2,20,45,33,12
050,02,016,"Alaska","Aleutians West Census Area",2,21,67,49,18
050,02,016,"Alaska","Aleutians West Census Area",2,22,69,53,16
050,02,016,"Alaska","Aleutians West Census Area",2,23,74,51,23
050,02,016,"Alaska","Aleutians West Census Area",2,24,80,58,22
050,02,016,"Alaska","Aleutians West Census Area",2,25,88,72,16
050,02,016,"Alaska","Aleutians West Census Area",2,26,110,94,16
050,02,016,"Alaska","Aleutians West Census Area",2,27,108,91,17
050,02,016,"Alaska","Aleutians West Census Area",2,28,88,66,22
050,02,016,"Alaska","Aleutians West Census Area",2,29,112,73,39
050,02,016,"Alaska","Aleutians West Census Area",2,30,109,79,30
050,02,016,"Alaska","Aleutians West Census Area",2,31,96,68,28
050,02,016,"Alaska","Aleutians West Census Area",2,32,68,48,20
050,02,016,"Alaska","Aleutians West Census Area",2,33,92,70,22
050,02,016,"Alaska","Aleutians West Census Area",2,34,81,55,26
050,02,016,"Alaska","Aleutians West Census Area",2,35,101,73,28
050,02,016,"Alaska","Aleutians West Census Area",2,36,104,73,31
050,02,016,"Alaska","Aleutians West Census Area",2,37,91,69,22
050,02,016,"Alaska","Aleutians West Census Area",2,38,78,66,12
050,02,016,"Alaska","Aleutians West Census Area",2,39,89,61,28
050,02,016,"Alaska","Aleutians West Census Area",2,40,101,76,25
050,02,016,"Alaska","Aleutians West Census Area",2,41,126,95,31
050,02,016,"Alaska","Aleutians West Census Area",2,42,106,72,34
050,02,016,"Alaska","Aleutians West Census Area",2,43,104,75,29
050,02,016,"Alaska","Aleutians West Census Area",2,44,122,98,24
050,02,016,"Alaska","Aleutians West Census Area",2,45,110,89,21
050,02,016,"Alaska","Aleutians West Census Area",2,46,122,94,28
050,02,016,"Alaska","Aleutians West Census Area",2,47,94,66,28
050,02,016,"Alaska","Aleutians West Census Area",2,48,93,59,34
050,02,016,"Alaska","Aleutians West Census Area",2,49,112,79,33
050,02,016,"Alaska","Aleutians West Census Area",2,50,120,80,40
050,02,016,"Alaska","Aleutians West Census Area",2,51,109,76,33
050,02,016,"Alaska","Aleutians West Census Area",2,52,149,112,37
050,02,016,"Alaska","Aleutians West Census Area",2,53,114,69,45
050,02,016,"Alaska","Aleutians West Census Area",2,54,102,76,26
050,02,016,"Alaska","Aleutians West Census Area",2,55,112,81,31
050,02,016,"Alaska","Aleutians West Census Area",2,56,73,50,23
050,02,016,"Alaska","Aleutians West Census Area",2,57,103,69,34
050,02,016,"Alaska","Aleutians West Census Area",2,58,94,66,28
050,02,016,"Alaska","Aleutians West Census Area",2,59,76,49,27
050,02,016,"Alaska","Aleutians West Census Area",2,60,97,60,37
050,02,016,"Alaska","Aleutians West Census Area",2,61,78,55,23
050,02,016,"Alaska","Aleutians West Census Area",2,62,97,74,23
050,02,016,"Alaska","Aleutians West Census Area",2,63,61,36,25
050,02,016,"Alaska","Aleutians West Census Area",2,64,38,25,13
050,02,016,"Alaska","Aleutians West Census Area",2,65,45,36,9
050,02,016,"Alaska","Aleutians West Census Area",2,66,39,24,15
050,02,016,"Alaska","Aleutians West Census Area",2,67,42,29,13
050,02,016,"Alaska","Aleutians West Census Area",2,68,40,25,15
050,02,016,"Alaska","Aleutians West Census Area",2,69,30,12,18
050,02,016,"Alaska","Aleutians West Census Area",2,70,33,23,10
050,02,016,"Alaska","Aleutians West Census Area",2,71,21,12,9
050,02,016,"Alaska","Aleutians West Census Area",2,72,20,14,6
050,02,016,"Alaska","Aleutians West Census Area",2,73,13,8,5
050,02,016,"Alaska","Aleutians West Census Area",2,74,15,8,7
050,02,016,"Alaska","Aleutians West Census Area",2,75,9,3,6
050,02,016,"Alaska","Aleutians West Census Area",2,76,4,2,2
050,02,016,"Alaska","Aleutians West Census Area",2,77,4,1,3
050,02,016,"Alaska","Aleutians West Census Area",2,78,4,3,1
050,02,016,"Alaska","Aleutians West Census Area",2,79,4,3,1
050,02,016,"Alaska","Aleutians West Census Area",2,80,6,3,3
050,02,016,"Alaska","Aleutians West Census Area",2,81,3,2,1
050,02,016,"Alaska","Aleutians West Census Area",2,82,3,1,2
050,02,016,"Alaska","Aleutians West Census Area",2,83,0,0,0
050,02,016,"Alaska","Aleutians West Census Area",2,84,3,2,1
050,02,016,"Alaska","Aleutians West Census Area",2,85,13,5,8
050,02,016,"Alaska","Aleutians West Census Area",3,0,28,17,11
050,02,016,"Alaska","Aleutians West Census Area",3,1,30,16,14
050,02,016,"Alaska","Aleutians West Census Area",3,2,21,13,8
050,02,016,"Alaska","Aleutians West Census Area",3,3,29,16,13
050,02,016,"Alaska","Aleutians West Census Area",3,4,25,15,10
050,02,016,"Alaska","Aleutians West Census Area",3,5,29,17,12
050,02,016,"Alaska","Aleutians West Census Area",3,6,30,16,14
050,02,016,"Alaska","Aleutians West Census Area",3,7,33,18,15
050,02,016,"Alaska","Aleutians West Census Area",3,8,29,15,14
050,02,016,"Alaska","Aleutians West Census Area",3,9,29,15,14
050,02,016,"Alaska","Aleutians West Census Area",3,10,23,11,12
050,02,016,"Alaska","Aleutians West Census Area",3,11,30,15,15
050,02,016,"Alaska","Aleutians West Census Area",3,12,32,17,15
050,02,016,"Alaska","Aleutians West Census Area",3,13,35,18,17
050,02,016,"Alaska","Aleutians West Census Area",3,14,24,12,12
050,02,016,"Alaska","Aleutians West Census Area",3,15,32,16,16
050,02,016,"Alaska","Aleutians West Census Area",3,16,33,15,18
050,02,016,"Alaska","Aleutians West Census Area",3,17,22,12,10
050,02,016,"Alaska","Aleutians West Census Area",3,18,28,16,12
050,02,016,"Alaska","Aleutians West Census Area",3,19,49,36,13
050,02,016,"Alaska","Aleutians West Census Area",3,20,47,34,13
050,02,016,"Alaska","Aleutians West Census Area",3,21,61,45,16
050,02,016,"Alaska","Aleutians West Census Area",3,22,74,52,22
050,02,016,"Alaska","Aleutians West Census Area",3,23,69,48,21
050,02,016,"Alaska","Aleutians West Census Area",3,24,75,58,17
050,02,016,"Alaska","Aleutians West Census Area",3,25,83,68,15
050,02,016,"Alaska","Aleutians West Census Area",3,26,109,95,14
050,02,016,"Alaska","Aleutians West Census Area",3,27,113,95,18
050,02,016,"Alaska","Aleutians West Census Area",3,28,78,64,14
050,02,016,"Alaska","Aleutians West Census Area",3,29,112,78,34
050,02,016,"Alaska","Aleutians West Census Area",3,30,104,77,27
050,02,016,"Alaska","Aleutians West Census Area",3,31,112,77,35
050,02,016,"Alaska","Aleutians West Census Area",3,32,74,54,20
050,02,016,"Alaska","Aleutians West Census Area",3,33,85,65,20
050,02,016,"Alaska","Aleutians West Census Area",3,34,78,52,26
050,02,016,"Alaska","Aleutians West Census Area",3,35,98,76,22
050,02,016,"Alaska","Aleutians West Census Area",3,36,97,67,30
050,02,016,"Alaska","Aleutians West Census Area",3,37,96,70,26
050,02,016,"Alaska","Aleutians West Census Area",3,38,85,63,22
050,02,016,"Alaska","Aleutians West Census Area",3,39,95,66,29
050,02,016,"Alaska","Aleutians West Census Area",3,40,102,77,25
050,02,016,"Alaska","Aleutians West Census Area",3,41,122,96,26
050,02,016,"Alaska","Aleutians West Census Area",3,42,107,77,30
050,02,016,"Alaska","Aleutians West Census Area",3,43,104,69,35
050,02,016,"Alaska","Aleutians West Census Area",3,44,117,95,22
050,02,016,"Alaska","Aleutians West Census Area",3,45,110,92,18
050,02,016,"Alaska","Aleutians West Census Area",3,46,118,90,28
050,02,016,"Alaska","Aleutians West Census Area",3,47,96,68,28
050,02,016,"Alaska","Aleutians West Census Area",3,48,90,61,29
050,02,016,"Alaska","Aleutians West Census Area",3,49,119,83,36
050,02,016,"Alaska","Aleutians West Census Area",3,50,112,75,37
050,02,016,"Alaska","Aleutians West Census Area",3,51,102,72,30
050,02,016,"Alaska","Aleutians West Census Area",3,52,140,104,36
050,02,016,"Alaska","Aleutians West Census Area",3,53,123,76,47
050,02,016,"Alaska","Aleutians West Census Area",3,54,99,75,24
050,02,016,"Alaska","Aleutians West Census Area",3,55,109,82,27
050,02,016,"Alaska","Aleutians West Census Area",3,56,75,51,24
050,02,016,"Alaska","Aleutians West Census Area",3,57,98,67,31
050,02,016,"Alaska","Aleutians West Census Area",3,58,82,56,26
050,02,016,"Alaska","Aleutians West Census Area",3,59,74,47,27
050,02,016,"Alaska","Aleutians West Census Area",3,60,94,64,30
050,02,016,"Alaska","Aleutians West Census Area",3,61,68,45,23
050,02,016,"Alaska","Aleutians West Census Area",3,62,95,75,20
050,02,016,"Alaska","Aleutians West Census Area",3,63,60,35,25
050,02,016,"Alaska","Aleutians West Census Area",3,64,37,25,12
050,02,016,"Alaska","Aleutians West Census Area",3,65,45,35,10
050,02,016,"Alaska","Aleutians West Census Area",3,66,45,29,16
050,02,016,"Alaska","Aleutians West Census Area",3,67,35,26,9
050,02,016,"Alaska","Aleutians West Census Area",3,68,39,25,14
050,02,016,"Alaska","Aleutians West Census Area",3,69,27,12,15
050,02,016,"Alaska","Aleutians West Census Area",3,70,36,24,12
050,02,016,"Alaska","Aleutians West Census Area",3,71,18,9,9
050,02,016,"Alaska","Aleutians West Census Area",3,72,20,13,7
050,02,016,"Alaska","Aleutians West Census Area",3,73,18,12,6
050,02,016,"Alaska","Aleutians West Census Area",3,74,16,11,5
050,02,016,"Alaska","Aleutians West Census Area",3,75,14,6,8
050,02,016,"Alaska","Aleutians West Census Area",3,76,8,3,5
050,02,016,"Alaska","Aleutians West Census Area",3,77,4,2,2
050,02,016,"Alaska","Aleutians West Census Area",3,78,4,1,3
050,02,016,"Alaska","Aleutians West Census Area",3,79,4,3,1
050,02,016,"Alaska","Aleutians West Census Area",3,80,3,2,1
050,02,016,"Alaska","Aleutians West Census Area",3,81,6,3,3
050,02,016,"Alaska","Aleutians West Census Area",3,82,2,1,1
050,02,016,"Alaska","Aleutians West Census Area",3,83,3,1,2
050,02,016,"Alaska","Aleutians West Census Area",3,84,0,0,0
050,02,016,"Alaska","Aleutians West Census Area",3,85,11,4,7
050,02,016,"Alaska","Aleutians West Census Area",4,0,27,16,11
050,02,016,"Alaska","Aleutians West Census Area",4,1,30,18,12
050,02,016,"Alaska","Aleutians West Census Area",4,2,22,11,11
050,02,016,"Alaska","Aleutians West Census Area",4,3,22,12,10
050,02,016,"Alaska","Aleutians West Census Area",4,4,25,12,13
050,02,016,"Alaska","Aleutians West Census Area",4,5,21,10,11
050,02,016,"Alaska","Aleutians West Census Area",4,6,27,16,11
050,02,016,"Alaska","Aleutians West Census Area",4,7,24,14,10
050,02,016,"Alaska","Aleutians West Census Area",4,8,25,12,13
050,02,016,"Alaska","Aleutians West Census Area",4,9,23,14,9
050,02,016,"Alaska","Aleutians West Census Area",4,10,26,10,16
050,02,016,"Alaska","Aleutians West Census Area",4,11,22,10,12
050,02,016,"Alaska","Aleutians West Census Area",4,12,23,12,11
050,02,016,"Alaska","Aleutians West Census Area",4,13,31,17,14
050,02,016,"Alaska","Aleutians West Census Area",4,14,33,18,15
050,02,016,"Alaska","Aleutians West Census Area",4,15,25,12,13
050,02,016,"Alaska","Aleutians West Census Area",4,16,30,17,13
050,02,016,"Alaska","Aleutians West Census Area",4,17,30,16,14
050,02,016,"Alaska","Aleutians West Census Area",4,18,21,14,7
050,02,016,"Alaska","Aleutians West Census Area",4,19,43,32,11
050,02,016,"Alaska","Aleutians West Census Area",4,20,49,36,13
050,02,016,"Alaska","Aleutians West Census Area",4,21,64,45,19
050,02,016,"Alaska","Aleutians West Census Area",4,22,64,46,18
050,02,016,"Alaska","Aleutians West Census Area",4,23,79,51,28
050,02,016,"Alaska","Aleutians West Census Area",4,24,67,52,15
050,02,016,"Alaska","Aleutians West Census Area",4,25,81,70,11
050,02,016,"Alaska","Aleutians West Census Area",4,26,108,94,14
050,02,016,"Alaska","Aleutians West Census Area",4,27,117,102,15
050,02,016,"Alaska","Aleutians West Census Area",4,28,91,70,21
050,02,016,"Alaska","Aleutians West Census Area",4,29,103,77,26
050,02,016,"Alaska","Aleutians West Census Area",4,30,109,84,25
050,02,016,"Alaska","Aleutians West Census Area",4,31,100,69,31
050,02,016,"Alaska","Aleutians West Census Area",4,32,85,59,26
050,02,016,"Alaska","Aleutians West Census Area",4,33,99,77,22
050,02,016,"Alaska","Aleutians West Census Area",4,34,76,48,28
050,02,016,"Alaska","Aleutians West Census Area",4,35,92,70,22
050,02,016,"Alaska","Aleutians West Census Area",4,36,93,66,27
050,02,016,"Alaska","Aleutians West Census Area",4,37,93,68,25
050,02,016,"Alaska","Aleutians West Census Area",4,38,101,69,32
050,02,016,"Alaska","Aleutians West Census Area",4,39,100,59,41
050,02,016,"Alaska","Aleutians West Census Area",4,40,114,85,29
050,02,016,"Alaska","Aleutians West Census Area",4,41,113,89,24
050,02,016,"Alaska","Aleutians West Census Area",4,42,105,78,27
050,02,016,"Alaska","Aleutians West Census Area",4,43,102,71,31
050,02,016,"Alaska","Aleutians West Census Area",4,44,117,92,25
050,02,016,"Alaska","Aleutians West Census Area",4,45,104,89,15
050,02,016,"Alaska","Aleutians West Census Area",4,46,117,94,23
050,02,016,"Alaska","Aleutians West Census Area",4,47,93,67,26
050,02,016,"Alaska","Aleutians West Census Area",4,48,100,68,32
050,02,016,"Alaska","Aleutians West Census Area",4,49,115,85,30
050,02,016,"Alaska","Aleutians West Census Area",4,50,115,79,36
050,02,016,"Alaska","Aleutians West Census Area",4,51,96,65,31
050,02,016,"Alaska","Aleutians West Census Area",4,52,140,102,38
050,02,016,"Alaska","Aleutians West Census Area",4,53,113,65,48
050,02,016,"Alaska","Aleutians West Census Area",4,54,109,81,28
050,02,016,"Alaska","Aleutians West Census Area",4,55,106,81,25
050,02,016,"Alaska","Aleutians West Census Area",4,56,73,51,22
050,02,016,"Alaska","Aleutians West Census Area",4,57,99,70,29
050,02,016,"Alaska","Aleutians West Census Area",4,58,80,56,24
050,02,016,"Alaska","Aleutians West Census Area",4,59,70,42,28
050,02,016,"Alaska","Aleutians West Census Area",4,60,93,61,32
050,02,016,"Alaska","Aleutians West Census Area",4,61,70,50,20
050,02,016,"Alaska","Aleutians West Census Area",4,62,86,68,18
050,02,016,"Alaska","Aleutians West Census Area",4,63,59,38,21
050,02,016,"Alaska","Aleutians West Census Area",4,64,33,21,12
050,02,016,"Alaska","Aleutians West Census Area",4,65,44,33,11
050,02,016,"Alaska","Aleutians West Census Area",4,66,40,26,14
050,02,016,"Alaska","Aleutians West Census Area",4,67,42,31,11
050,02,016,"Alaska","Aleutians West Census Area",4,68,34,24,10
050,02,016,"Alaska","Aleutians West Census Area",4,69,28,13,15
050,02,016,"Alaska","Aleutians West Census Area",4,70,35,24,11
050,02,016,"Alaska","Aleutians West Census Area",4,71,20,11,9
050,02,016,"Alaska","Aleutians West Census Area",4,72,17,9,8
050,02,016,"Alaska","Aleutians West Census Area",4,73,18,11,7
050,02,016,"Alaska","Aleutians West Census Area",4,74,21,15,6
050,02,016,"Alaska","Aleutians West Census Area",4,75,13,8,5
050,02,016,"Alaska","Aleutians West Census Area",4,76,14,6,8
050,02,016,"Alaska","Aleutians West Census Area",4,77,7,3,4
050,02,016,"Alaska","Aleutians West Census Area",4,78,4,2,2
050,02,016,"Alaska","Aleutians West Census Area",4,79,4,1,3
050,02,016,"Alaska","Aleutians West Census Area",4,80,4,3,1
050,02,016,"Alaska","Aleutians West Census Area",4,81,3,2,1
050,02,016,"Alaska","Aleutians West Census Area",4,82,6,3,3
050,02,016,"Alaska","Aleutians West Census Area",4,83,1,1,0
050,02,016,"Alaska","Aleutians West Census Area",4,84,3,1,2
050,02,016,"Alaska","Aleutians West Census Area",4,85,9,2,7
050,02,016,"Alaska","Aleutians West Census Area",5,0,28,18,10
050,02,016,"Alaska","Aleutians West Census Area",5,1,27,16,11
050,02,016,"Alaska","Aleutians West Census Area",5,2,29,16,13
050,02,016,"Alaska","Aleutians West Census Area",5,3,21,10,11
050,02,016,"Alaska","Aleutians West Census Area",5,4,14,9,5
050,02,016,"Alaska","Aleutians West Census Area",5,5,19,7,12
050,02,016,"Alaska","Aleutians West Census Area",5,6,22,11,11
050,02,016,"Alaska","Aleutians West Census Area",5,7,23,11,12
050,02,016,"Alaska","Aleutians West Census Area",5,8,18,9,9
050,02,016,"Alaska","Aleutians West Census Area",5,9,21,7,14
050,02,016,"Alaska","Aleutians West Census Area",5,10,23,13,10
050,02,016,"Alaska","Aleutians West Census Area",5,11,26,8,18
050,02,016,"Alaska","Aleutians West Census Area",5,12,21,11,10
050,02,016,"Alaska","Aleutians West Census Area",5,13,22,9,13
050,02,016,"Alaska","Aleutians West Census Area",5,14,28,18,10
050,02,016,"Alaska","Aleutians West Census Area",5,15,31,16,15
050,02,016,"Alaska","Aleutians West Census Area",5,16,23,13,10
050,02,016,"Alaska","Aleutians West Census Area",5,17,30,17,13
050,02,016,"Alaska","Aleutians West Census Area",5,18,26,15,11
050,02,016,"Alaska","Aleutians West Census Area",5,19,42,34,8
050,02,016,"Alaska","Aleutians West Census Area",5,20,45,32,13
050,02,016,"Alaska","Aleutians West Census Area",5,21,70,49,21
050,02,016,"Alaska","Aleutians West Census Area",5,22,71,49,22
050,02,016,"Alaska","Aleutians West Census Area",5,23,70,45,25
050,02,016,"Alaska","Aleutians West Census Area",5,24,77,57,20
050,02,016,"Alaska","Aleutians West Census Area",5,25,74,64,10
050,02,016,"Alaska","Aleutians West Census Area",5,26,100,91,9
050,02,016,"Alaska","Aleutians West Census Area",5,27,116,99,17
050,02,016,"Alaska","Aleutians West Census Area",5,28,98,79,19
050,02,016,"Alaska","Aleutians West Census Area",5,29,122,88,34
050,02,016,"Alaska","Aleutians West Census Area",5,30,101,80,21
050,02,016,"Alaska","Aleutians West Census Area",5,31,101,77,24
050,02,016,"Alaska","Aleutians West Census Area",5,32,75,57,18
050,02,016,"Alaska","Aleutians West Census Area",5,33,103,79,24
050,02,016,"Alaska","Aleutians West Census Area",5,34,96,64,32
050,02,016,"Alaska","Aleutians West Census Area",5,35,96,73,23
050,02,016,"Alaska","Aleutians West Census Area",5,36,97,69,28
050,02,016,"Alaska","Aleutians West Census Area",5,37,101,72,29
050,02,016,"Alaska","Aleutians West Census Area",5,38,99,71,28
050,02,016,"Alaska","Aleutians West Census Area",5,39,123,72,51
050,02,016,"Alaska","Aleutians West Census Area",5,40,118,80,38
050,02,016,"Alaska","Aleutians West Census Area",5,41,131,96,35
050,02,016,"Alaska","Aleutians West Census Area",5,42,110,82,28
050,02,016,"Alaska","Aleutians West Census Area",5,43,105,78,27
050,02,016,"Alaska","Aleutians West Census Area",5,44,126,101,25
050,02,016,"Alaska","Aleutians West Census Area",5,45,113,89,24
050,02,016,"Alaska","Aleutians West Census Area",5,46,113,92,21
050,02,016,"Alaska","Aleutians West Census Area",5,47,92,68,24
050,02,016,"Alaska","Aleutians West Census Area",5,48,95,66,29
050,02,016,"Alaska","Aleutians West Census Area",5,49,130,97,33
050,02,016,"Alaska","Aleutians West Census Area",5,50,106,78,28
050,02,016,"Alaska","Aleutians West Census Area",5,51,104,76,28
050,02,016,"Alaska","Aleutians West Census Area",5,52,132,94,38
050,02,016,"Alaska","Aleutians West Census Area",5,53,114,65,49
050,02,016,"Alaska","Aleutians West Census Area",5,54,108,76,32
050,02,016,"Alaska","Aleutians West Census Area",5,55,115,84,31
050,02,016,"Alaska","Aleutians West Census Area",5,56,71,50,21
050,02,016,"Alaska","Aleutians West Census Area",5,57,97,67,30
050,02,016,"Alaska","Aleutians West Census Area",5,58,83,59,24
050,02,016,"Alaska","Aleutians West Census Area",5,59,66,41,25
050,02,016,"Alaska","Aleutians West Census Area",5,60,91,59,32
050,02,016,"Alaska","Aleutians West Census Area",5,61,69,48,21
050,02,016,"Alaska","Aleutians West Census Area",5,62,91,74,17
050,02,016,"Alaska","Aleutians West Census Area",5,63,51,31,20
050,02,016,"Alaska","Aleutians West Census Area",5,64,36,26,10
050,02,016,"Alaska","Aleutians West Census Area",5,65,41,31,10
050,02,016,"Alaska","Aleutians West Census Area",5,66,44,26,18
050,02,016,"Alaska","Aleutians West Census Area",5,67,32,25,7
050,02,016,"Alaska","Aleutians West Census Area",5,68,38,27,11
050,02,016,"Alaska","Aleutians West Census Area",5,69,21,10,11
050,02,016,"Alaska","Aleutians West Census Area",5,70,35,25,10
050,02,016,"Alaska","Aleutians West Census Area",5,71,19,9,10
050,02,016,"Alaska","Aleutians West Census Area",5,72,19,10,9
050,02,016,"Alaska","Aleutians West Census Area",5,73,11,7,4
050,02,016,"Alaska","Aleutians West Census Area",5,74,19,14,5
050,02,016,"Alaska","Aleutians West Census Area",5,75,18,12,6
050,02,016,"Alaska","Aleutians West Census Area",5,76,13,8,5
050,02,016,"Alaska","Aleutians West Census Area",5,77,14,6,8
050,02,016,"Alaska","Aleutians West Census Area",5,78,7,3,4
050,02,016,"Alaska","Aleutians West Census Area",5,79,4,2,2
050,02,016,"Alaska","Aleutians West Census Area",5,80,4,1,3
050,02,016,"Alaska","Aleutians West Census Area",5,81,4,3,1
050,02,016,"Alaska","Aleutians West Census Area",5,82,3,2,1
050,02,016,"Alaska","Aleutians West Census Area",5,83,5,3,2
050,02,016,"Alaska","Aleutians West Census Area",5,84,1,1,0
050,02,016,"Alaska","Aleutians West Census Area",5,85,12,2,10
050,02,020,"Alaska","Anchorage Municipality",1,0,3845,1969,1876
050,02,020,"Alaska","Anchorage Municipality",1,1,3849,1961,1888
050,02,020,"Alaska","Anchorage Municipality",1,2,3933,2034,1899
050,02,020,"Alaska","Anchorage Municipality",1,3,4012,2021,1991
050,02,020,"Alaska","Anchorage Municipality",1,4,4116,2098,2018
050,02,020,"Alaska","Anchorage Municipality",1,5,4017,1987,2030
050,02,020,"Alaska","Anchorage Municipality",1,6,4023,2019,2004
050,02,020,"Alaska","Anchorage Municipality",1,7,4032,2072,1960
050,02,020,"Alaska","Anchorage Municipality",1,8,3933,1995,1938
050,02,020,"Alaska","Anchorage Municipality",1,9,3898,2013,1885
050,02,020,"Alaska","Anchorage Municipality",1,10,3799,1950,1849
050,02,020,"Alaska","Anchorage Municipality",1,11,3959,2098,1861
050,02,020,"Alaska","Anchorage Municipality",1,12,3964,2117,1847
050,02,020,"Alaska","Anchorage Municipality",1,13,3808,1974,1834
050,02,020,"Alaska","Anchorage Municipality",1,14,3675,1848,1827
050,02,020,"Alaska","Anchorage Municipality",1,15,3837,1923,1914
050,02,020,"Alaska","Anchorage Municipality",1,16,3675,1862,1813
050,02,020,"Alaska","Anchorage Municipality",1,17,3713,1927,1786
050,02,020,"Alaska","Anchorage Municipality",1,18,3367,1810,1557
050,02,020,"Alaska","Anchorage Municipality",1,19,3411,1933,1478
050,02,020,"Alaska","Anchorage Municipality",1,20,3973,2303,1670
050,02,020,"Alaska","Anchorage Municipality",1,21,4127,2384,1743
050,02,020,"Alaska","Anchorage Municipality",1,22,4210,2313,1897
050,02,020,"Alaska","Anchorage Municipality",1,23,4387,2429,1958
050,02,020,"Alaska","Anchorage Municipality",1,24,4462,2472,1990
050,02,020,"Alaska","Anchorage Municipality",1,25,4637,2516,2121
050,02,020,"Alaska","Anchorage Municipality",1,26,4759,2541,2218
050,02,020,"Alaska","Anchorage Municipality",1,27,4934,2603,2331
050,02,020,"Alaska","Anchorage Municipality",1,28,5133,2645,2488
050,02,020,"Alaska","Anchorage Municipality",1,29,5143,2627,2516
050,02,020,"Alaska","Anchorage Municipality",1,30,5122,2580,2542
050,02,020,"Alaska","Anchorage Municipality",1,31,5017,2517,2500
050,02,020,"Alaska","Anchorage Municipality",1,32,4893,2497,2396
050,02,020,"Alaska","Anchorage Municipality",1,33,4838,2512,2326
050,02,020,"Alaska","Anchorage Municipality",1,34,4924,2553,2371
050,02,020,"Alaska","Anchorage Municipality",1,35,4750,2424,2326
050,02,020,"Alaska","Anchorage Municipality",1,36,4546,2370,2176
050,02,020,"Alaska","Anchorage Municipality",1,37,4578,2353,2225
050,02,020,"Alaska","Anchorage Municipality",1,38,4330,2232,2098
050,02,020,"Alaska","Anchorage Municipality",1,39,4127,2095,2032
050,02,020,"Alaska","Anchorage Municipality",1,40,3962,1955,2007
050,02,020,"Alaska","Anchorage Municipality",1,41,3670,1817,1853
050,02,020,"Alaska","Anchorage Municipality",1,42,3599,1841,1758
050,02,020,"Alaska","Anchorage Municipality",1,43,3387,1745,1642
050,02,020,"Alaska","Anchorage Municipality",1,44,3300,1668,1632
050,02,020,"Alaska","Anchorage Municipality",1,45,3239,1615,1624
050,02,020,"Alaska","Anchorage Municipality",1,46,3137,1625,1512
050,02,020,"Alaska","Anchorage Municipality",1,47,3320,1723,1597
050,02,020,"Alaska","Anchorage Municipality",1,48,3539,1847,1692
050,02,020,"Alaska","Anchorage Municipality",1,49,3799,1955,1844
050,02,020,"Alaska","Anchorage Municipality",1,50,3677,1897,1780
050,02,020,"Alaska","Anchorage Municipality",1,51,3498,1842,1656
050,02,020,"Alaska","Anchorage Municipality",1,52,3342,1720,1622
050,02,020,"Alaska","Anchorage Municipality",1,53,3330,1677,1653
050,02,020,"Alaska","Anchorage Municipality",1,54,3356,1688,1668
050,02,020,"Alaska","Anchorage Municipality",1,55,3558,1769,1789
050,02,020,"Alaska","Anchorage Municipality",1,56,3718,1884,1834
050,02,020,"Alaska","Anchorage Municipality",1,57,3698,1879,1819
050,02,020,"Alaska","Anchorage Municipality",1,58,3701,1872,1829
050,02,020,"Alaska","Anchorage Municipality",1,59,3671,1891,1780
050,02,020,"Alaska","Anchorage Municipality",1,60,3646,1884,1762
050,02,020,"Alaska","Anchorage Municipality",1,61,3409,1691,1718
050,02,020,"Alaska","Anchorage Municipality",1,62,3348,1679,1669
050,02,020,"Alaska","Anchorage Municipality",1,63,3228,1597,1631
050,02,020,"Alaska","Anchorage Municipality",1,64,3140,1534,1606
050,02,020,"Alaska","Anchorage Municipality",1,65,3117,1550,1567
050,02,020,"Alaska","Anchorage Municipality",1,66,2852,1433,1419
050,02,020,"Alaska","Anchorage Municipality",1,67,2689,1363,1326
050,02,020,"Alaska","Anchorage Municipality",1,68,2423,1198,1225
050,02,020,"Alaska","Anchorage Municipality",1,69,2259,1114,1145
050,02,020,"Alaska","Anchorage Municipality",1,70,2207,1099,1108
050,02,020,"Alaska","Anchorage Municipality",1,71,2022,1018,1004
050,02,020,"Alaska","Anchorage Municipality",1,72,1975,996,979
050,02,020,"Alaska","Anchorage Municipality",1,73,1891,958,933
050,02,020,"Alaska","Anchorage Municipality",1,74,1397,665,732
050,02,020,"Alaska","Anchorage Municipality",1,75,1340,636,704
050,02,020,"Alaska","Anchorage Municipality",1,76,1252,616,636
050,02,020,"Alaska","Anchorage Municipality",1,77,1169,564,605
050,02,020,"Alaska","Anchorage Municipality",1,78,1000,468,532
050,02,020,"Alaska","Anchorage Municipality",1,79,859,402,457
050,02,020,"Alaska","Anchorage Municipality",1,80,750,332,418
050,02,020,"Alaska","Anchorage Municipality",1,81,639,293,346
050,02,020,"Alaska","Anchorage Municipality",1,82,618,247,371
050,02,020,"Alaska","Anchorage Municipality",1,83,517,211,306
050,02,020,"Alaska","Anchorage Municipality",1,84,475,196,279
050,02,020,"Alaska","Anchorage Municipality",1,85,2765,1029,1736
050,02,020,"Alaska","Anchorage Municipality",2,0,3831,1941,1890
050,02,020,"Alaska","Anchorage Municipality",2,1,3826,1948,1878
050,02,020,"Alaska","Anchorage Municipality",2,2,3877,1992,1885
050,02,020,"Alaska","Anchorage Municipality",2,3,3979,2016,1963
050,02,020,"Alaska","Anchorage Municipality",2,4,4079,2072,2007
050,02,020,"Alaska","Anchorage Municipality",2,5,4020,2003,2017
050,02,020,"Alaska","Anchorage Municipality",2,6,4008,2004,2004
050,02,020,"Alaska","Anchorage Municipality",2,7,4016,2050,1966
050,02,020,"Alaska","Anchorage Municipality",2,8,3931,1997,1934
050,02,020,"Alaska","Anchorage Municipality",2,9,3882,1998,1884
050,02,020,"Alaska","Anchorage Municipality",2,10,3802,1954,1848
050,02,020,"Alaska","Anchorage Municipality",2,11,3879,2038,1841
050,02,020,"Alaska","Anchorage Municipality",2,12,3961,2110,1851
050,02,020,"Alaska","Anchorage Municipality",2,13,3837,1997,1840
050,02,020,"Alaska","Anchorage Municipality",2,14,3694,1874,1820
050,02,020,"Alaska","Anchorage Municipality",2,15,3801,1913,1888
050,02,020,"Alaska","Anchorage Municipality",2,16,3699,1868,1831
050,02,020,"Alaska","Anchorage Municipality",2,17,3701,1915,1786
050,02,020,"Alaska","Anchorage Municipality",2,18,3399,1827,1572
050,02,020,"Alaska","Anchorage Municipality",2,19,3436,1945,1491
050,02,020,"Alaska","Anchorage Municipality",2,20,4015,2325,1690
050,02,020,"Alaska","Anchorage Municipality",2,21,4111,2372,1739
050,02,020,"Alaska","Anchorage Municipality",2,22,4210,2327,1883
050,02,020,"Alaska","Anchorage Municipality",2,23,4367,2417,1950
050,02,020,"Alaska","Anchorage Municipality",2,24,4425,2450,1975
050,02,020,"Alaska","Anchorage Municipality",2,25,4568,2479,2089
050,02,020,"Alaska","Anchorage Municipality",2,26,4729,2533,2196
050,02,020,"Alaska","Anchorage Municipality",2,27,4861,2568,2293
050,02,020,"Alaska","Anchorage Municipality",2,28,5078,2633,2445
050,02,020,"Alaska","Anchorage Municipality",2,29,5113,2611,2502
050,02,020,"Alaska","Anchorage Municipality",2,30,5139,2600,2539
050,02,020,"Alaska","Anchorage Municipality",2,31,5008,2508,2500
050,02,020,"Alaska","Anchorage Municipality",2,32,4904,2491,2413
050,02,020,"Alaska","Anchorage Municipality",2,33,4830,2504,2326
050,02,020,"Alaska","Anchorage Municipality",2,34,4883,2532,2351
050,02,020,"Alaska","Anchorage Municipality",2,35,4795,2451,2344
050,02,020,"Alaska","Anchorage Municipality",2,36,4550,2359,2191
050,02,020,"Alaska","Anchorage Municipality",2,37,4556,2350,2206
050,02,020,"Alaska","Anchorage Municipality",2,38,4366,2254,2112
050,02,020,"Alaska","Anchorage Municipality",2,39,4140,2097,2043
050,02,020,"Alaska","Anchorage Municipality",2,40,3999,1987,2012
050,02,020,"Alaska","Anchorage Municipality",2,41,3723,1838,1885
050,02,020,"Alaska","Anchorage Municipality",2,42,3567,1806,1761
050,02,020,"Alaska","Anchorage Municipality",2,43,3447,1772,1675
050,02,020,"Alaska","Anchorage Municipality",2,44,3281,1669,1612
050,02,020,"Alaska","Anchorage Municipality",2,45,3254,1624,1630
050,02,020,"Alaska","Anchorage Municipality",2,46,3166,1624,1542
050,02,020,"Alaska","Anchorage Municipality",2,47,3259,1687,1572
050,02,020,"Alaska","Anchorage Municipality",2,48,3467,1804,1663
050,02,020,"Alaska","Anchorage Municipality",2,49,3743,1932,1811
050,02,020,"Alaska","Anchorage Municipality",2,50,3694,1906,1788
050,02,020,"Alaska","Anchorage Municipality",2,51,3505,1837,1668
050,02,020,"Alaska","Anchorage Municipality",2,52,3362,1739,1623
050,02,020,"Alaska","Anchorage Municipality",2,53,3299,1661,1638
050,02,020,"Alaska","Anchorage Municipality",2,54,3329,1682,1647
050,02,020,"Alaska","Anchorage Municipality",2,55,3491,1746,1745
050,02,020,"Alaska","Anchorage Municipality",2,56,3667,1849,1818
050,02,020,"Alaska","Anchorage Municipality",2,57,3681,1866,1815
050,02,020,"Alaska","Anchorage Municipality",2,58,3673,1862,1811
050,02,020,"Alaska","Anchorage Municipality",2,59,3664,1876,1788
050,02,020,"Alaska","Anchorage Municipality",2,60,3620,1865,1755
050,02,020,"Alaska","Anchorage Municipality",2,61,3437,1721,1716
050,02,020,"Alaska","Anchorage Municipality",2,62,3326,1661,1665
050,02,020,"Alaska","Anchorage Municipality",2,63,3250,1627,1623
050,02,020,"Alaska","Anchorage Municipality",2,64,3127,1535,1592
050,02,020,"Alaska","Anchorage Municipality",2,65,3094,1526,1568
050,02,020,"Alaska","Anchorage Municipality",2,66,2900,1448,1452
050,02,020,"Alaska","Anchorage Municipality",2,67,2705,1363,1342
050,02,020,"Alaska","Anchorage Municipality",2,68,2460,1225,1235
050,02,020,"Alaska","Anchorage Municipality",2,69,2293,1127,1166
050,02,020,"Alaska","Anchorage Municipality",2,70,2196,1090,1106
050,02,020,"Alaska","Anchorage Municipality",2,71,2055,1032,1023
050,02,020,"Alaska","Anchorage Municipality",2,72,1938,980,958
050,02,020,"Alaska","Anchorage Municipality",2,73,1984,1007,977
050,02,020,"Alaska","Anchorage Municipality",2,74,1420,683,737
050,02,020,"Alaska","Anchorage Municipality",2,75,1345,637,708
050,02,020,"Alaska","Anchorage Municipality",2,76,1262,613,649
050,02,020,"Alaska","Anchorage Municipality",2,77,1198,582,616
050,02,020,"Alaska","Anchorage Municipality",2,78,1015,476,539
050,02,020,"Alaska","Anchorage Municipality",2,79,873,406,467
050,02,020,"Alaska","Anchorage Municipality",2,80,767,342,425
050,02,020,"Alaska","Anchorage Municipality",2,81,656,297,359
050,02,020,"Alaska","Anchorage Municipality",2,82,614,250,364
050,02,020,"Alaska","Anchorage Municipality",2,83,534,217,317
050,02,020,"Alaska","Anchorage Municipality",2,84,468,189,279
050,02,020,"Alaska","Anchorage Municipality",2,85,2779,1036,1743
050,02,020,"Alaska","Anchorage Municipality",3,0,3644,1839,1805
050,02,020,"Alaska","Anchorage Municipality",3,1,3734,1872,1862
050,02,020,"Alaska","Anchorage Municipality",3,2,3681,1869,1812
050,02,020,"Alaska","Anchorage Municipality",3,3,3757,1915,1842
050,02,020,"Alaska","Anchorage Municipality",3,4,3970,2010,1960
050,02,020,"Alaska","Anchorage Municipality",3,5,3962,2027,1935
050,02,020,"Alaska","Anchorage Municipality",3,6,3947,1978,1969
050,02,020,"Alaska","Anchorage Municipality",3,7,3970,1969,2001
050,02,020,"Alaska","Anchorage Municipality",3,8,3967,2037,1930
050,02,020,"Alaska","Anchorage Municipality",3,9,3817,1947,1870
050,02,020,"Alaska","Anchorage Municipality",3,10,3822,1945,1877
050,02,020,"Alaska","Anchorage Municipality",3,11,3753,1916,1837
050,02,020,"Alaska","Anchorage Municipality",3,12,3835,2012,1823
050,02,020,"Alaska","Anchorage Municipality",3,13,3896,2067,1829
050,02,020,"Alaska","Anchorage Municipality",3,14,3786,1983,1803
050,02,020,"Alaska","Anchorage Municipality",3,15,3684,1890,1794
050,02,020,"Alaska","Anchorage Municipality",3,16,3718,1879,1839
050,02,020,"Alaska","Anchorage Municipality",3,17,3659,1863,1796
050,02,020,"Alaska","Anchorage Municipality",3,18,3385,1819,1566
050,02,020,"Alaska","Anchorage Municipality",3,19,3426,1959,1467
050,02,020,"Alaska","Anchorage Municipality",3,20,4108,2406,1702
050,02,020,"Alaska","Anchorage Municipality",3,21,4253,2463,1790
050,02,020,"Alaska","Anchorage Municipality",3,22,4204,2363,1841
050,02,020,"Alaska","Anchorage Municipality",3,23,4294,2357,1937
050,02,020,"Alaska","Anchorage Municipality",3,24,4403,2440,1963
050,02,020,"Alaska","Anchorage Municipality",3,25,4431,2402,2029
050,02,020,"Alaska","Anchorage Municipality",3,26,4549,2434,2115
050,02,020,"Alaska","Anchorage Municipality",3,27,4685,2497,2188
050,02,020,"Alaska","Anchorage Municipality",3,28,4774,2509,2265
050,02,020,"Alaska","Anchorage Municipality",3,29,4973,2573,2400
050,02,020,"Alaska","Anchorage Municipality",3,30,5073,2612,2461
050,02,020,"Alaska","Anchorage Municipality",3,31,5034,2536,2498
050,02,020,"Alaska","Anchorage Municipality",3,32,4939,2469,2470
050,02,020,"Alaska","Anchorage Municipality",3,33,4756,2424,2332
050,02,020,"Alaska","Anchorage Municipality",3,34,4728,2440,2288
050,02,020,"Alaska","Anchorage Municipality",3,35,4844,2507,2337
050,02,020,"Alaska","Anchorage Municipality",3,36,4760,2431,2329
050,02,020,"Alaska","Anchorage Municipality",3,37,4455,2306,2149
050,02,020,"Alaska","Anchorage Municipality",3,38,4480,2311,2169
050,02,020,"Alaska","Anchorage Municipality",3,39,4313,2201,2112
050,02,020,"Alaska","Anchorage Municipality",3,40,4068,2104,1964
050,02,020,"Alaska","Anchorage Municipality",3,41,3943,1953,1990
050,02,020,"Alaska","Anchorage Municipality",3,42,3612,1780,1832
050,02,020,"Alaska","Anchorage Municipality",3,43,3500,1791,1709
050,02,020,"Alaska","Anchorage Municipality",3,44,3380,1718,1662
050,02,020,"Alaska","Anchorage Municipality",3,45,3235,1644,1591
050,02,020,"Alaska","Anchorage Municipality",3,46,3278,1675,1603
050,02,020,"Alaska","Anchorage Municipality",3,47,3110,1604,1506
050,02,020,"Alaska","Anchorage Municipality",3,48,3196,1646,1550
050,02,020,"Alaska","Anchorage Municipality",3,49,3470,1803,1667
050,02,020,"Alaska","Anchorage Municipality",3,50,3623,1873,1750
050,02,020,"Alaska","Anchorage Municipality",3,51,3584,1852,1732
050,02,020,"Alaska","Anchorage Municipality",3,52,3436,1781,1655
050,02,020,"Alaska","Anchorage Municipality",3,53,3220,1629,1591
050,02,020,"Alaska","Anchorage Municipality",3,54,3200,1623,1577
050,02,020,"Alaska","Anchorage Municipality",3,55,3246,1647,1599
050,02,020,"Alaska","Anchorage Municipality",3,56,3380,1702,1678
050,02,020,"Alaska","Anchorage Municipality",3,57,3534,1765,1769
050,02,020,"Alaska","Anchorage Municipality",3,58,3535,1785,1750
050,02,020,"Alaska","Anchorage Municipality",3,59,3562,1787,1775
050,02,020,"Alaska","Anchorage Municipality",3,60,3539,1807,1732
050,02,020,"Alaska","Anchorage Municipality",3,61,3510,1804,1706
050,02,020,"Alaska","Anchorage Municipality",3,62,3288,1636,1652
050,02,020,"Alaska","Anchorage Municipality",3,63,3185,1598,1587
050,02,020,"Alaska","Anchorage Municipality",3,64,3159,1581,1578
050,02,020,"Alaska","Anchorage Municipality",3,65,3004,1476,1528
050,02,020,"Alaska","Anchorage Municipality",3,66,2976,1472,1504
050,02,020,"Alaska","Anchorage Municipality",3,67,2792,1384,1408
050,02,020,"Alaska","Anchorage Municipality",3,68,2604,1299,1305
050,02,020,"Alaska","Anchorage Municipality",3,69,2383,1170,1213
050,02,020,"Alaska","Anchorage Municipality",3,70,2214,1081,1133
050,02,020,"Alaska","Anchorage Municipality",3,71,2144,1057,1087
050,02,020,"Alaska","Anchorage Municipality",3,72,1982,988,994
050,02,020,"Alaska","Anchorage Municipality",3,73,1868,941,927
050,02,020,"Alaska","Anchorage Municipality",3,74,1922,975,947
050,02,020,"Alaska","Anchorage Municipality",3,75,1368,660,708
050,02,020,"Alaska","Anchorage Municipality",3,76,1281,599,682
050,02,020,"Alaska","Anchorage Municipality",3,77,1218,589,629
050,02,020,"Alaska","Anchorage Municipality",3,78,1135,544,591
050,02,020,"Alaska","Anchorage Municipality",3,79,969,450,519
050,02,020,"Alaska","Anchorage Municipality",3,80,833,387,446
050,02,020,"Alaska","Anchorage Municipality",3,81,723,333,390
050,02,020,"Alaska","Anchorage Municipality",3,82,620,271,349
050,02,020,"Alaska","Anchorage Municipality",3,83,574,229,345
050,02,020,"Alaska","Anchorage Municipality",3,84,492,193,299
050,02,020,"Alaska","Anchorage Municipality",3,85,2805,1039,1766
050,02,020,"Alaska","Anchorage Municipality",4,0,3593,1840,1753
050,02,020,"Alaska","Anchorage Municipality",4,1,3446,1736,1710
050,02,020,"Alaska","Anchorage Municipality",4,2,3656,1800,1856
050,02,020,"Alaska","Anchorage Municipality",4,3,3592,1777,1815
050,02,020,"Alaska","Anchorage Municipality",4,4,3671,1859,1812
050,02,020,"Alaska","Anchorage Municipality",4,5,3852,1937,1915
050,02,020,"Alaska","Anchorage Municipality",4,6,3903,1974,1929
050,02,020,"Alaska","Anchorage Municipality",4,7,3896,1948,1948
050,02,020,"Alaska","Anchorage Municipality",4,8,4019,1990,2029
050,02,020,"Alaska","Anchorage Municipality",4,9,3941,2010,1931
050,02,020,"Alaska","Anchorage Municipality",4,10,3772,1904,1868
050,02,020,"Alaska","Anchorage Municipality",4,11,3772,1920,1852
050,02,020,"Alaska","Anchorage Municipality",4,12,3740,1899,1841
050,02,020,"Alaska","Anchorage Municipality",4,13,3793,2023,1770
050,02,020,"Alaska","Anchorage Municipality",4,14,3821,2033,1788
050,02,020,"Alaska","Anchorage Municipality",4,15,3763,1998,1765
050,02,020,"Alaska","Anchorage Municipality",4,16,3645,1857,1788
050,02,020,"Alaska","Anchorage Municipality",4,17,3737,1881,1856
050,02,020,"Alaska","Anchorage Municipality",4,18,3312,1764,1548
050,02,020,"Alaska","Anchorage Municipality",4,19,3190,1856,1334
050,02,020,"Alaska","Anchorage Municipality",4,20,3920,2335,1585
050,02,020,"Alaska","Anchorage Municipality",4,21,4229,2445,1784
050,02,020,"Alaska","Anchorage Municipality",4,22,4260,2376,1884
050,02,020,"Alaska","Anchorage Municipality",4,23,4299,2389,1910
050,02,020,"Alaska","Anchorage Municipality",4,24,4372,2379,1993
050,02,020,"Alaska","Anchorage Municipality",4,25,4366,2377,1989
050,02,020,"Alaska","Anchorage Municipality",4,26,4497,2405,2092
050,02,020,"Alaska","Anchorage Municipality",4,27,4428,2344,2084
050,02,020,"Alaska","Anchorage Municipality",4,28,4631,2451,2180
050,02,020,"Alaska","Anchorage Municipality",4,29,4766,2475,2291
050,02,020,"Alaska","Anchorage Municipality",4,30,4975,2543,2432
050,02,020,"Alaska","Anchorage Municipality",4,31,5020,2568,2452
050,02,020,"Alaska","Anchorage Municipality",4,32,5040,2531,2509
050,02,020,"Alaska","Anchorage Municipality",4,33,4853,2439,2414
050,02,020,"Alaska","Anchorage Municipality",4,34,4759,2420,2339
050,02,020,"Alaska","Anchorage Municipality",4,35,4665,2383,2282
050,02,020,"Alaska","Anchorage Municipality",4,36,4776,2495,2281
050,02,020,"Alaska","Anchorage Municipality",4,37,4669,2378,2291
050,02,020,"Alaska","Anchorage Municipality",4,38,4341,2230,2111
050,02,020,"Alaska","Anchorage Municipality",4,39,4398,2258,2140
050,02,020,"Alaska","Anchorage Municipality",4,40,4210,2169,2041
050,02,020,"Alaska","Anchorage Municipality",4,41,4015,2053,1962
050,02,020,"Alaska","Anchorage Municipality",4,42,3788,1851,1937
050,02,020,"Alaska","Anchorage Municipality",4,43,3525,1761,1764
050,02,020,"Alaska","Anchorage Municipality",4,44,3459,1785,1674
050,02,020,"Alaska","Anchorage Municipality",4,45,3305,1666,1639
050,02,020,"Alaska","Anchorage Municipality",4,46,3191,1661,1530
050,02,020,"Alaska","Anchorage Municipality",4,47,3227,1639,1588
050,02,020,"Alaska","Anchorage Municipality",4,48,3041,1570,1471
050,02,020,"Alaska","Anchorage Municipality",4,49,3172,1618,1554
050,02,020,"Alaska","Anchorage Municipality",4,50,3400,1774,1626
050,02,020,"Alaska","Anchorage Municipality",4,51,3513,1817,1696
050,02,020,"Alaska","Anchorage Municipality",4,52,3491,1776,1715
050,02,020,"Alaska","Anchorage Municipality",4,53,3309,1672,1637
050,02,020,"Alaska","Anchorage Municipality",4,54,3133,1592,1541
050,02,020,"Alaska","Anchorage Municipality",4,55,3095,1559,1536
050,02,020,"Alaska","Anchorage Municipality",4,56,3201,1616,1585
050,02,020,"Alaska","Anchorage Municipality",4,57,3284,1612,1672
050,02,020,"Alaska","Anchorage Municipality",4,58,3406,1693,1713
050,02,020,"Alaska","Anchorage Municipality",4,59,3405,1712,1693
050,02,020,"Alaska","Anchorage Municipality",4,60,3442,1715,1727
050,02,020,"Alaska","Anchorage Municipality",4,61,3457,1765,1692
050,02,020,"Alaska","Anchorage Municipality",4,62,3382,1726,1656
050,02,020,"Alaska","Anchorage Municipality",4,63,3136,1566,1570
050,02,020,"Alaska","Anchorage Municipality",4,64,3062,1514,1548
050,02,020,"Alaska","Anchorage Municipality",4,65,3013,1498,1515
050,02,020,"Alaska","Anchorage Municipality",4,66,2855,1400,1455
050,02,020,"Alaska","Anchorage Municipality",4,67,2829,1382,1447
050,02,020,"Alaska","Anchorage Municipality",4,68,2678,1326,1352
050,02,020,"Alaska","Anchorage Municipality",4,69,2531,1245,1286
050,02,020,"Alaska","Anchorage Municipality",4,70,2274,1136,1138
050,02,020,"Alaska","Anchorage Municipality",4,71,2138,1043,1095
050,02,020,"Alaska","Anchorage Municipality",4,72,2072,1016,1056
050,02,020,"Alaska","Anchorage Municipality",4,73,1917,949,968
050,02,020,"Alaska","Anchorage Municipality",4,74,1785,879,906
050,02,020,"Alaska","Anchorage Municipality",4,75,1832,923,909
050,02,020,"Alaska","Anchorage Municipality",4,76,1287,617,670
050,02,020,"Alaska","Anchorage Municipality",4,77,1222,556,666
050,02,020,"Alaska","Anchorage Municipality",4,78,1177,552,625
050,02,020,"Alaska","Anchorage Municipality",4,79,1054,513,541
050,02,020,"Alaska","Anchorage Municipality",4,80,910,409,501
050,02,020,"Alaska","Anchorage Municipality",4,81,769,365,404
050,02,020,"Alaska","Anchorage Municipality",4,82,717,318,399
050,02,020,"Alaska","Anchorage Municipality",4,83,559,245,314
050,02,020,"Alaska","Anchorage Municipality",4,84,519,194,325
050,02,020,"Alaska","Anchorage Municipality",4,85,2818,1025,1793
050,02,020,"Alaska","Anchorage Municipality",5,0,3574,1832,1742
050,02,020,"Alaska","Anchorage Municipality",5,1,3507,1773,1734
050,02,020,"Alaska","Anchorage Municipality",5,2,3323,1639,1684
050,02,020,"Alaska","Anchorage Municipality",5,3,3555,1750,1805
050,02,020,"Alaska","Anchorage Municipality",5,4,3506,1745,1761
050,02,020,"Alaska","Anchorage Municipality",5,5,3580,1808,1772
050,02,020,"Alaska","Anchorage Municipality",5,6,3801,1927,1874
050,02,020,"Alaska","Anchorage Municipality",5,7,3864,1951,1913
050,02,020,"Alaska","Anchorage Municipality",5,8,3972,1991,1981
050,02,020,"Alaska","Anchorage Municipality",5,9,4044,2026,2018
050,02,020,"Alaska","Anchorage Municipality",5,10,3905,1994,1911
050,02,020,"Alaska","Anchorage Municipality",5,11,3709,1881,1828
050,02,020,"Alaska","Anchorage Municipality",5,12,3718,1889,1829
050,02,020,"Alaska","Anchorage Municipality",5,13,3719,1881,1838
050,02,020,"Alaska","Anchorage Municipality",5,14,3744,1991,1753
050,02,020,"Alaska","Anchorage Municipality",5,15,3841,2075,1766
050,02,020,"Alaska","Anchorage Municipality",5,16,3703,1969,1734
050,02,020,"Alaska","Anchorage Municipality",5,17,3625,1849,1776
050,02,020,"Alaska","Anchorage Municipality",5,18,3349,1776,1573
050,02,020,"Alaska","Anchorage Municipality",5,19,3206,1834,1372
050,02,020,"Alaska","Anchorage Municipality",5,20,3735,2255,1480
050,02,020,"Alaska","Anchorage Municipality",5,21,4090,2422,1668
050,02,020,"Alaska","Anchorage Municipality",5,22,4313,2389,1924
050,02,020,"Alaska","Anchorage Municipality",5,23,4393,2412,1981
050,02,020,"Alaska","Anchorage Municipality",5,24,4432,2423,2009
050,02,020,"Alaska","Anchorage Municipality",5,25,4387,2363,2024
050,02,020,"Alaska","Anchorage Municipality",5,26,4399,2354,2045
050,02,020,"Alaska","Anchorage Municipality",5,27,4382,2279,2103
050,02,020,"Alaska","Anchorage Municipality",5,28,4423,2345,2078
050,02,020,"Alaska","Anchorage Municipality",5,29,4518,2351,2167
050,02,020,"Alaska","Anchorage Municipality",5,30,4693,2457,2236
050,02,020,"Alaska","Anchorage Municipality",5,31,4927,2505,2422
050,02,020,"Alaska","Anchorage Municipality",5,32,5078,2588,2490
050,02,020,"Alaska","Anchorage Municipality",5,33,5058,2546,2512
050,02,020,"Alaska","Anchorage Municipality",5,34,4800,2441,2359
050,02,020,"Alaska","Anchorage Municipality",5,35,4733,2391,2342
050,02,020,"Alaska","Anchorage Municipality",5,36,4618,2382,2236
050,02,020,"Alaska","Anchorage Municipality",5,37,4738,2457,2281
050,02,020,"Alaska","Anchorage Municipality",5,38,4541,2314,2227
050,02,020,"Alaska","Anchorage Municipality",5,39,4314,2203,2111
050,02,020,"Alaska","Anchorage Municipality",5,40,4357,2278,2079
050,02,020,"Alaska","Anchorage Municipality",5,41,4208,2150,2058
050,02,020,"Alaska","Anchorage Municipality",5,42,3931,2005,1926
050,02,020,"Alaska","Anchorage Municipality",5,43,3726,1835,1891
050,02,020,"Alaska","Anchorage Municipality",5,44,3502,1761,1741
050,02,020,"Alaska","Anchorage Municipality",5,45,3419,1767,1652
050,02,020,"Alaska","Anchorage Municipality",5,46,3300,1692,1608
050,02,020,"Alaska","Anchorage Municipality",5,47,3181,1646,1535
050,02,020,"Alaska","Anchorage Municipality",5,48,3139,1595,1544
050,02,020,"Alaska","Anchorage Municipality",5,49,3056,1588,1468
050,02,020,"Alaska","Anchorage Municipality",5,50,3059,1563,1496
050,02,020,"Alaska","Anchorage Municipality",5,51,3340,1754,1586
050,02,020,"Alaska","Anchorage Municipality",5,52,3451,1773,1678
050,02,020,"Alaska","Anchorage Municipality",5,53,3351,1680,1671
050,02,020,"Alaska","Anchorage Municipality",5,54,3241,1643,1598
050,02,020,"Alaska","Anchorage Municipality",5,55,3045,1554,1491
050,02,020,"Alaska","Anchorage Municipality",5,56,3028,1527,1501
050,02,020,"Alaska","Anchorage Municipality",5,57,3099,1540,1559
050,02,020,"Alaska","Anchorage Municipality",5,58,3188,1582,1606
050,02,020,"Alaska","Anchorage Municipality",5,59,3313,1652,1661
050,02,020,"Alaska","Anchorage Municipality",5,60,3327,1662,1665
050,02,020,"Alaska","Anchorage Municipality",5,61,3359,1666,1693
050,02,020,"Alaska","Anchorage Municipality",5,62,3311,1688,1623
050,02,020,"Alaska","Anchorage Municipality",5,63,3257,1658,1599
050,02,020,"Alaska","Anchorage Municipality",5,64,3038,1498,1540
050,02,020,"Alaska","Anchorage Municipality",5,65,2931,1446,1485
050,02,020,"Alaska","Anchorage Municipality",5,66,2874,1434,1440
050,02,020,"Alaska","Anchorage Municipality",5,67,2747,1350,1397
050,02,020,"Alaska","Anchorage Municipality",5,68,2746,1343,1403
050,02,020,"Alaska","Anchorage Municipality",5,69,2604,1271,1333
050,02,020,"Alaska","Anchorage Municipality",5,70,2432,1200,1232
050,02,020,"Alaska","Anchorage Municipality",5,71,2240,1127,1113
050,02,020,"Alaska","Anchorage Municipality",5,72,2061,998,1063
050,02,020,"Alaska","Anchorage Municipality",5,73,1999,979,1020
050,02,020,"Alaska","Anchorage Municipality",5,74,1860,899,961
050,02,020,"Alaska","Anchorage Municipality",5,75,1711,832,879
050,02,020,"Alaska","Anchorage Municipality",5,76,1731,882,849
050,02,020,"Alaska","Anchorage Municipality",5,77,1226,580,646
050,02,020,"Alaska","Anchorage Municipality",5,78,1159,519,640
050,02,020,"Alaska","Anchorage Municipality",5,79,1096,505,591
050,02,020,"Alaska","Anchorage Municipality",5,80,1011,483,528
050,02,020,"Alaska","Anchorage Municipality",5,81,850,395,455
050,02,020,"Alaska","Anchorage Municipality",5,82,742,342,400
050,02,020,"Alaska","Anchorage Municipality",5,83,657,288,369
050,02,020,"Alaska","Anchorage Municipality",5,84,492,203,289
050,02,020,"Alaska","Anchorage Municipality",5,85,2863,1025,1838
050,02,050,"Alaska","Bethel Census Area",1,0,417,212,205
050,02,050,"Alaska","Bethel Census Area",1,1,397,207,190
050,02,050,"Alaska","Bethel Census Area",1,2,374,205,169
050,02,050,"Alaska","Bethel Census Area",1,3,411,235,176
050,02,050,"Alaska","Bethel Census Area",1,4,374,201,173
050,02,050,"Alaska","Bethel Census Area",1,5,368,188,180
050,02,050,"Alaska","Bethel Census Area",1,6,404,211,193
050,02,050,"Alaska","Bethel Census Area",1,7,379,201,178
050,02,050,"Alaska","Bethel Census Area",1,8,388,196,192
050,02,050,"Alaska","Bethel Census Area",1,9,401,195,206
050,02,050,"Alaska","Bethel Census Area",1,10,348,173,175
050,02,050,"Alaska","Bethel Census Area",1,11,350,183,167
050,02,050,"Alaska","Bethel Census Area",1,12,347,167,180
050,02,050,"Alaska","Bethel Census Area",1,13,336,168,168
050,02,050,"Alaska","Bethel Census Area",1,14,334,163,171
050,02,050,"Alaska","Bethel Census Area",1,15,326,155,171
050,02,050,"Alaska","Bethel Census Area",1,16,333,175,158
050,02,050,"Alaska","Bethel Census Area",1,17,328,164,164
050,02,050,"Alaska","Bethel Census Area",1,18,311,165,146
050,02,050,"Alaska","Bethel Census Area",1,19,287,145,142
050,02,050,"Alaska","Bethel Census Area",1,20,291,154,137
050,02,050,"Alaska","Bethel Census Area",1,21,271,154,117
050,02,050,"Alaska","Bethel Census Area",1,22,274,146,128
050,02,050,"Alaska","Bethel Census Area",1,23,259,125,134
050,02,050,"Alaska","Bethel Census Area",1,24,248,121,127
050,02,050,"Alaska","Bethel Census Area",1,25,292,151,141
050,02,050,"Alaska","Bethel Census Area",1,26,289,148,141
050,02,050,"Alaska","Bethel Census Area",1,27,280,142,138
050,02,050,"Alaska","Bethel Census Area",1,28,289,148,141
050,02,050,"Alaska","Bethel Census Area",1,29,302,153,149
050,02,050,"Alaska","Bethel Census Area",1,30,287,140,147
050,02,050,"Alaska","Bethel Census Area",1,31,287,153,134
050,02,050,"Alaska","Bethel Census Area",1,32,275,151,124
050,02,050,"Alaska","Bethel Census Area",1,33,273,150,123
050,02,050,"Alaska","Bethel Census Area",1,34,267,147,120
050,02,050,"Alaska","Bethel Census Area",1,35,243,132,111
050,02,050,"Alaska","Bethel Census Area",1,36,244,121,123
050,02,050,"Alaska","Bethel Census Area",1,37,231,120,111
050,02,050,"Alaska","Bethel Census Area",1,38,207,111,96
050,02,050,"Alaska","Bethel Census Area",1,39,207,101,106
050,02,050,"Alaska","Bethel Census Area",1,40,210,113,97
050,02,050,"Alaska","Bethel Census Area",1,41,206,110,96
050,02,050,"Alaska","Bethel Census Area",1,42,182,93,89
050,02,050,"Alaska","Bethel Census Area",1,43,170,90,80
050,02,050,"Alaska","Bethel Census Area",1,44,175,93,82
050,02,050,"Alaska","Bethel Census Area",1,45,172,92,80
050,02,050,"Alaska","Bethel Census Area",1,46,172,84,88
050,02,050,"Alaska","Bethel Census Area",1,47,176,95,81
050,02,050,"Alaska","Bethel Census Area",1,48,174,100,74
050,02,050,"Alaska","Bethel Census Area",1,49,186,97,89
050,02,050,"Alaska","Bethel Census Area",1,50,168,86,82
050,02,050,"Alaska","Bethel Census Area",1,51,165,91,74
050,02,050,"Alaska","Bethel Census Area",1,52,186,112,74
050,02,050,"Alaska","Bethel Census Area",1,53,198,117,81
050,02,050,"Alaska","Bethel Census Area",1,54,187,113,74
050,02,050,"Alaska","Bethel Census Area",1,55,209,113,96
050,02,050,"Alaska","Bethel Census Area",1,56,223,125,98
050,02,050,"Alaska","Bethel Census Area",1,57,211,112,99
050,02,050,"Alaska","Bethel Census Area",1,58,210,116,94
050,02,050,"Alaska","Bethel Census Area",1,59,198,117,81
050,02,050,"Alaska","Bethel Census Area",1,60,200,111,89
050,02,050,"Alaska","Bethel Census Area",1,61,200,112,88
050,02,050,"Alaska","Bethel Census Area",1,62,173,98,75
050,02,050,"Alaska","Bethel Census Area",1,63,145,81,64
050,02,050,"Alaska","Bethel Census Area",1,64,147,76,71
050,02,050,"Alaska","Bethel Census Area",1,65,152,80,72
050,02,050,"Alaska","Bethel Census Area",1,66,136,73,63
050,02,050,"Alaska","Bethel Census Area",1,67,131,65,66
050,02,050,"Alaska","Bethel Census Area",1,68,129,68,61
050,02,050,"Alaska","Bethel Census Area",1,69,104,60,44
050,02,050,"Alaska","Bethel Census Area",1,70,104,56,48
050,02,050,"Alaska","Bethel Census Area",1,71,88,51,37
050,02,050,"Alaska","Bethel Census Area",1,72,75,35,40
050,02,050,"Alaska","Bethel Census Area",1,73,75,39,36
050,02,050,"Alaska","Bethel Census Area",1,74,55,27,28
050,02,050,"Alaska","Bethel Census Area",1,75,54,29,25
050,02,050,"Alaska","Bethel Census Area",1,76,54,27,27
050,02,050,"Alaska","Bethel Census Area",1,77,47,19,28
050,02,050,"Alaska","Bethel Census Area",1,78,52,17,35
050,02,050,"Alaska","Bethel Census Area",1,79,53,25,28
050,02,050,"Alaska","Bethel Census Area",1,80,30,16,14
050,02,050,"Alaska","Bethel Census Area",1,81,18,9,9
050,02,050,"Alaska","Bethel Census Area",1,82,26,14,12
050,02,050,"Alaska","Bethel Census Area",1,83,19,10,9
050,02,050,"Alaska","Bethel Census Area",1,84,24,11,13
050,02,050,"Alaska","Bethel Census Area",1,85,59,11,48
050,02,050,"Alaska","Bethel Census Area",2,0,420,205,215
050,02,050,"Alaska","Bethel Census Area",2,1,398,208,190
050,02,050,"Alaska","Bethel Census Area",2,2,378,205,173
050,02,050,"Alaska","Bethel Census Area",2,3,402,228,174
050,02,050,"Alaska","Bethel Census Area",2,4,381,208,173
050,02,050,"Alaska","Bethel Census Area",2,5,367,190,177
050,02,050,"Alaska","Bethel Census Area",2,6,398,206,192
050,02,050,"Alaska","Bethel Census Area",2,7,379,202,177
050,02,050,"Alaska","Bethel Census Area",2,8,386,197,189
050,02,050,"Alaska","Bethel Census Area",2,9,397,196,201
050,02,050,"Alaska","Bethel Census Area",2,10,359,176,183
050,02,050,"Alaska","Bethel Census Area",2,11,348,179,169
050,02,050,"Alaska","Bethel Census Area",2,12,348,172,176
050,02,050,"Alaska","Bethel Census Area",2,13,338,169,169
050,02,050,"Alaska","Bethel Census Area",2,14,330,161,169
050,02,050,"Alaska","Bethel Census Area",2,15,328,156,172
050,02,050,"Alaska","Bethel Census Area",2,16,332,170,162
050,02,050,"Alaska","Bethel Census Area",2,17,325,165,160
050,02,050,"Alaska","Bethel Census Area",2,18,308,163,145
050,02,050,"Alaska","Bethel Census Area",2,19,290,147,143
050,02,050,"Alaska","Bethel Census Area",2,20,290,153,137
050,02,050,"Alaska","Bethel Census Area",2,21,272,151,121
050,02,050,"Alaska","Bethel Census Area",2,22,277,149,128
050,02,050,"Alaska","Bethel Census Area",2,23,259,128,131
050,02,050,"Alaska","Bethel Census Area",2,24,255,125,130
050,02,050,"Alaska","Bethel Census Area",2,25,283,146,137
050,02,050,"Alaska","Bethel Census Area",2,26,283,144,139
050,02,050,"Alaska","Bethel Census Area",2,27,281,145,136
050,02,050,"Alaska","Bethel Census Area",2,28,285,146,139
050,02,050,"Alaska","Bethel Census Area",2,29,297,149,148
050,02,050,"Alaska","Bethel Census Area",2,30,290,142,148
050,02,050,"Alaska","Bethel Census Area",2,31,285,149,136
050,02,050,"Alaska","Bethel Census Area",2,32,277,151,126
050,02,050,"Alaska","Bethel Census Area",2,33,273,150,123
050,02,050,"Alaska","Bethel Census Area",2,34,262,144,118
050,02,050,"Alaska","Bethel Census Area",2,35,248,136,112
050,02,050,"Alaska","Bethel Census Area",2,36,241,120,121
050,02,050,"Alaska","Bethel Census Area",2,37,234,122,112
050,02,050,"Alaska","Bethel Census Area",2,38,212,113,99
050,02,050,"Alaska","Bethel Census Area",2,39,205,103,102
050,02,050,"Alaska","Bethel Census Area",2,40,210,109,101
050,02,050,"Alaska","Bethel Census Area",2,41,204,110,94
050,02,050,"Alaska","Bethel Census Area",2,42,185,96,89
050,02,050,"Alaska","Bethel Census Area",2,43,177,92,85
050,02,050,"Alaska","Bethel Census Area",2,44,175,93,82
050,02,050,"Alaska","Bethel Census Area",2,45,174,93,81
050,02,050,"Alaska","Bethel Census Area",2,46,171,85,86
050,02,050,"Alaska","Bethel Census Area",2,47,175,91,84
050,02,050,"Alaska","Bethel Census Area",2,48,176,100,76
050,02,050,"Alaska","Bethel Census Area",2,49,181,99,82
050,02,050,"Alaska","Bethel Census Area",2,50,171,87,84
050,02,050,"Alaska","Bethel Census Area",2,51,166,90,76
050,02,050,"Alaska","Bethel Census Area",2,52,178,105,73
050,02,050,"Alaska","Bethel Census Area",2,53,196,116,80
050,02,050,"Alaska","Bethel Census Area",2,54,190,114,76
050,02,050,"Alaska","Bethel Census Area",2,55,203,112,91
050,02,050,"Alaska","Bethel Census Area",2,56,220,122,98
050,02,050,"Alaska","Bethel Census Area",2,57,211,116,95
050,02,050,"Alaska","Bethel Census Area",2,58,209,114,95
050,02,050,"Alaska","Bethel Census Area",2,59,198,116,82
050,02,050,"Alaska","Bethel Census Area",2,60,200,112,88
050,02,050,"Alaska","Bethel Census Area",2,61,200,113,87
050,02,050,"Alaska","Bethel Census Area",2,62,175,98,77
050,02,050,"Alaska","Bethel Census Area",2,63,150,85,65
050,02,050,"Alaska","Bethel Census Area",2,64,147,77,70
050,02,050,"Alaska","Bethel Census Area",2,65,152,79,73
050,02,050,"Alaska","Bethel Census Area",2,66,138,73,65
050,02,050,"Alaska","Bethel Census Area",2,67,132,67,65
050,02,050,"Alaska","Bethel Census Area",2,68,123,63,60
050,02,050,"Alaska","Bethel Census Area",2,69,109,61,48
050,02,050,"Alaska","Bethel Census Area",2,70,103,56,47
050,02,050,"Alaska","Bethel Census Area",2,71,91,52,39
050,02,050,"Alaska","Bethel Census Area",2,72,75,36,39
050,02,050,"Alaska","Bethel Census Area",2,73,78,39,39
050,02,050,"Alaska","Bethel Census Area",2,74,57,28,29
050,02,050,"Alaska","Bethel Census Area",2,75,54,28,26
050,02,050,"Alaska","Bethel Census Area",2,76,54,28,26
050,02,050,"Alaska","Bethel Census Area",2,77,49,21,28
050,02,050,"Alaska","Bethel Census Area",2,78,51,17,34
050,02,050,"Alaska","Bethel Census Area",2,79,52,23,29
050,02,050,"Alaska","Bethel Census Area",2,80,34,18,16
050,02,050,"Alaska","Bethel Census Area",2,81,20,10,10
050,02,050,"Alaska","Bethel Census Area",2,82,24,13,11
050,02,050,"Alaska","Bethel Census Area",2,83,20,11,9
050,02,050,"Alaska","Bethel Census Area",2,84,23,11,12
050,02,050,"Alaska","Bethel Census Area",2,85,59,12,47
050,02,050,"Alaska","Bethel Census Area",3,0,387,215,172
050,02,050,"Alaska","Bethel Census Area",3,1,398,198,200
050,02,050,"Alaska","Bethel Census Area",3,2,404,211,193
050,02,050,"Alaska","Bethel Census Area",3,3,374,201,173
050,02,050,"Alaska","Bethel Census Area",3,4,399,228,171
050,02,050,"Alaska","Bethel Census Area",3,5,374,203,171
050,02,050,"Alaska","Bethel Census Area",3,6,378,195,183
050,02,050,"Alaska","Bethel Census Area",3,7,383,197,186
050,02,050,"Alaska","Bethel Census Area",3,8,375,201,174
050,02,050,"Alaska","Bethel Census Area",3,9,390,199,191
050,02,050,"Alaska","Bethel Census Area",3,10,379,188,191
050,02,050,"Alaska","Bethel Census Area",3,11,364,175,189
050,02,050,"Alaska","Bethel Census Area",3,12,342,179,163
050,02,050,"Alaska","Bethel Census Area",3,13,345,172,173
050,02,050,"Alaska","Bethel Census Area",3,14,331,168,163
050,02,050,"Alaska","Bethel Census Area",3,15,330,155,175
050,02,050,"Alaska","Bethel Census Area",3,16,325,157,168
050,02,050,"Alaska","Bethel Census Area",3,17,324,165,159
050,02,050,"Alaska","Bethel Census Area",3,18,289,151,138
050,02,050,"Alaska","Bethel Census Area",3,19,295,148,147
050,02,050,"Alaska","Bethel Census Area",3,20,291,152,139
050,02,050,"Alaska","Bethel Census Area",3,21,288,153,135
050,02,050,"Alaska","Bethel Census Area",3,22,279,159,120
050,02,050,"Alaska","Bethel Census Area",3,23,271,148,123
050,02,050,"Alaska","Bethel Census Area",3,24,279,141,138
050,02,050,"Alaska","Bethel Census Area",3,25,261,144,117
050,02,050,"Alaska","Bethel Census Area",3,26,271,135,136
050,02,050,"Alaska","Bethel Census Area",3,27,277,142,135
050,02,050,"Alaska","Bethel Census Area",3,28,275,144,131
050,02,050,"Alaska","Bethel Census Area",3,29,270,128,142
050,02,050,"Alaska","Bethel Census Area",3,30,295,153,142
050,02,050,"Alaska","Bethel Census Area",3,31,268,136,132
050,02,050,"Alaska","Bethel Census Area",3,32,288,156,132
050,02,050,"Alaska","Bethel Census Area",3,33,277,152,125
050,02,050,"Alaska","Bethel Census Area",3,34,258,137,121
050,02,050,"Alaska","Bethel Census Area",3,35,252,141,111
050,02,050,"Alaska","Bethel Census Area",3,36,230,126,104
050,02,050,"Alaska","Bethel Census Area",3,37,250,134,116
050,02,050,"Alaska","Bethel Census Area",3,38,214,109,105
050,02,050,"Alaska","Bethel Census Area",3,39,210,109,101
050,02,050,"Alaska","Bethel Census Area",3,40,191,94,97
050,02,050,"Alaska","Bethel Census Area",3,41,202,104,98
050,02,050,"Alaska","Bethel Census Area",3,42,200,109,91
050,02,050,"Alaska","Bethel Census Area",3,43,184,89,95
050,02,050,"Alaska","Bethel Census Area",3,44,176,96,80
050,02,050,"Alaska","Bethel Census Area",3,45,176,100,76
050,02,050,"Alaska","Bethel Census Area",3,46,164,88,76
050,02,050,"Alaska","Bethel Census Area",3,47,162,80,82
050,02,050,"Alaska","Bethel Census Area",3,48,166,87,79
050,02,050,"Alaska","Bethel Census Area",3,49,170,98,72
050,02,050,"Alaska","Bethel Census Area",3,50,188,100,88
050,02,050,"Alaska","Bethel Census Area",3,51,162,83,79
050,02,050,"Alaska","Bethel Census Area",3,52,172,94,78
050,02,050,"Alaska","Bethel Census Area",3,53,182,105,77
050,02,050,"Alaska","Bethel Census Area",3,54,195,115,80
050,02,050,"Alaska","Bethel Census Area",3,55,187,111,76
050,02,050,"Alaska","Bethel Census Area",3,56,199,111,88
050,02,050,"Alaska","Bethel Census Area",3,57,212,124,88
050,02,050,"Alaska","Bethel Census Area",3,58,204,111,93
050,02,050,"Alaska","Bethel Census Area",3,59,194,107,87
050,02,050,"Alaska","Bethel Census Area",3,60,186,109,77
050,02,050,"Alaska","Bethel Census Area",3,61,187,108,79
050,02,050,"Alaska","Bethel Census Area",3,62,194,107,87
050,02,050,"Alaska","Bethel Census Area",3,63,166,96,70
050,02,050,"Alaska","Bethel Census Area",3,64,143,81,62
050,02,050,"Alaska","Bethel Census Area",3,65,138,71,67
050,02,050,"Alaska","Bethel Census Area",3,66,142,72,70
050,02,050,"Alaska","Bethel Census Area",3,67,134,71,63
050,02,050,"Alaska","Bethel Census Area",3,68,128,63,65
050,02,050,"Alaska","Bethel Census Area",3,69,117,59,58
050,02,050,"Alaska","Bethel Census Area",3,70,104,56,48
050,02,050,"Alaska","Bethel Census Area",3,71,101,55,46
050,02,050,"Alaska","Bethel Census Area",3,72,93,53,40
050,02,050,"Alaska","Bethel Census Area",3,73,70,31,39
050,02,050,"Alaska","Bethel Census Area",3,74,80,41,39
050,02,050,"Alaska","Bethel Census Area",3,75,53,25,28
050,02,050,"Alaska","Bethel Census Area",3,76,55,28,27
050,02,050,"Alaska","Bethel Census Area",3,77,48,23,25
050,02,050,"Alaska","Bethel Census Area",3,78,48,21,27
050,02,050,"Alaska","Bethel Census Area",3,79,44,14,30
050,02,050,"Alaska","Bethel Census Area",3,80,45,20,25
050,02,050,"Alaska","Bethel Census Area",3,81,31,16,15
050,02,050,"Alaska","Bethel Census Area",3,82,20,10,10
050,02,050,"Alaska","Bethel Census Area",3,83,19,8,11
050,02,050,"Alaska","Bethel Census Area",3,84,18,11,7
050,02,050,"Alaska","Bethel Census Area",3,85,54,14,40
050,02,050,"Alaska","Bethel Census Area",4,0,391,217,174
050,02,050,"Alaska","Bethel Census Area",4,1,382,213,169
050,02,050,"Alaska","Bethel Census Area",4,2,383,191,192
050,02,050,"Alaska","Bethel Census Area",4,3,386,203,183
050,02,050,"Alaska","Bethel Census Area",4,4,367,197,170
050,02,050,"Alaska","Bethel Census Area",4,5,377,213,164
050,02,050,"Alaska","Bethel Census Area",4,6,374,202,172
050,02,050,"Alaska","Bethel Census Area",4,7,357,181,176
050,02,050,"Alaska","Bethel Census Area",4,8,372,196,176
050,02,050,"Alaska","Bethel Census Area",4,9,366,195,171
050,02,050,"Alaska","Bethel Census Area",4,10,367,188,179
050,02,050,"Alaska","Bethel Census Area",4,11,367,184,183
050,02,050,"Alaska","Bethel Census Area",4,12,341,171,170
050,02,050,"Alaska","Bethel Census Area",4,13,325,166,159
050,02,050,"Alaska","Bethel Census Area",4,14,336,165,171
050,02,050,"Alaska","Bethel Census Area",4,15,316,160,156
050,02,050,"Alaska","Bethel Census Area",4,16,321,154,167
050,02,050,"Alaska","Bethel Census Area",4,17,319,155,164
050,02,050,"Alaska","Bethel Census Area",4,18,280,148,132
050,02,050,"Alaska","Bethel Census Area",4,19,268,136,132
050,02,050,"Alaska","Bethel Census Area",4,20,280,138,142
050,02,050,"Alaska","Bethel Census Area",4,21,263,138,125
050,02,050,"Alaska","Bethel Census Area",4,22,282,148,134
050,02,050,"Alaska","Bethel Census Area",4,23,267,150,117
050,02,050,"Alaska","Bethel Census Area",4,24,286,155,131
050,02,050,"Alaska","Bethel Census Area",4,25,296,160,136
050,02,050,"Alaska","Bethel Census Area",4,26,224,118,106
050,02,050,"Alaska","Bethel Census Area",4,27,260,133,127
050,02,050,"Alaska","Bethel Census Area",4,28,263,138,125
050,02,050,"Alaska","Bethel Census Area",4,29,269,137,132
050,02,050,"Alaska","Bethel Census Area",4,30,254,121,133
050,02,050,"Alaska","Bethel Census Area",4,31,295,156,139
050,02,050,"Alaska","Bethel Census Area",4,32,242,128,114
050,02,050,"Alaska","Bethel Census Area",4,33,264,144,120
050,02,050,"Alaska","Bethel Census Area",4,34,269,148,121
050,02,050,"Alaska","Bethel Census Area",4,35,252,139,113
050,02,050,"Alaska","Bethel Census Area",4,36,243,132,111
050,02,050,"Alaska","Bethel Census Area",4,37,233,133,100
050,02,050,"Alaska","Bethel Census Area",4,38,224,120,104
050,02,050,"Alaska","Bethel Census Area",4,39,207,108,99
050,02,050,"Alaska","Bethel Census Area",4,40,199,99,100
050,02,050,"Alaska","Bethel Census Area",4,41,187,87,100
050,02,050,"Alaska","Bethel Census Area",4,42,189,102,87
050,02,050,"Alaska","Bethel Census Area",4,43,186,95,91
050,02,050,"Alaska","Bethel Census Area",4,44,188,99,89
050,02,050,"Alaska","Bethel Census Area",4,45,178,100,78
050,02,050,"Alaska","Bethel Census Area",4,46,171,100,71
050,02,050,"Alaska","Bethel Census Area",4,47,168,93,75
050,02,050,"Alaska","Bethel Census Area",4,48,156,76,80
050,02,050,"Alaska","Bethel Census Area",4,49,168,93,75
050,02,050,"Alaska","Bethel Census Area",4,50,155,93,62
050,02,050,"Alaska","Bethel Census Area",4,51,180,96,84
050,02,050,"Alaska","Bethel Census Area",4,52,154,79,75
050,02,050,"Alaska","Bethel Census Area",4,53,172,93,79
050,02,050,"Alaska","Bethel Census Area",4,54,187,105,82
050,02,050,"Alaska","Bethel Census Area",4,55,199,116,83
050,02,050,"Alaska","Bethel Census Area",4,56,186,109,77
050,02,050,"Alaska","Bethel Census Area",4,57,196,111,85
050,02,050,"Alaska","Bethel Census Area",4,58,214,124,90
050,02,050,"Alaska","Bethel Census Area",4,59,203,112,91
050,02,050,"Alaska","Bethel Census Area",4,60,185,100,85
050,02,050,"Alaska","Bethel Census Area",4,61,177,103,74
050,02,050,"Alaska","Bethel Census Area",4,62,184,103,81
050,02,050,"Alaska","Bethel Census Area",4,63,187,104,83
050,02,050,"Alaska","Bethel Census Area",4,64,156,94,62
050,02,050,"Alaska","Bethel Census Area",4,65,135,79,56
050,02,050,"Alaska","Bethel Census Area",4,66,134,66,68
050,02,050,"Alaska","Bethel Census Area",4,67,140,70,70
050,02,050,"Alaska","Bethel Census Area",4,68,132,70,62
050,02,050,"Alaska","Bethel Census Area",4,69,115,55,60
050,02,050,"Alaska","Bethel Census Area",4,70,114,57,57
050,02,050,"Alaska","Bethel Census Area",4,71,105,55,50
050,02,050,"Alaska","Bethel Census Area",4,72,99,53,46
050,02,050,"Alaska","Bethel Census Area",4,73,91,51,40
050,02,050,"Alaska","Bethel Census Area",4,74,69,31,38
050,02,050,"Alaska","Bethel Census Area",4,75,73,36,37
050,02,050,"Alaska","Bethel Census Area",4,76,44,18,26
050,02,050,"Alaska","Bethel Census Area",4,77,47,23,24
050,02,050,"Alaska","Bethel Census Area",4,78,47,22,25
050,02,050,"Alaska","Bethel Census Area",4,79,42,19,23
050,02,050,"Alaska","Bethel Census Area",4,80,39,12,27
050,02,050,"Alaska","Bethel Census Area",4,81,44,19,25
050,02,050,"Alaska","Bethel Census Area",4,82,31,15,16
050,02,050,"Alaska","Bethel Census Area",4,83,15,8,7
050,02,050,"Alaska","Bethel Census Area",4,84,14,6,8
050,02,050,"Alaska","Bethel Census Area",4,85,36,11,25
050,02,050,"Alaska","Bethel Census Area",5,0,381,209,172
050,02,050,"Alaska","Bethel Census Area",5,1,388,211,177
050,02,050,"Alaska","Bethel Census Area",5,2,378,214,164
050,02,050,"Alaska","Bethel Census Area",5,3,381,189,192
050,02,050,"Alaska","Bethel Census Area",5,4,370,201,169
050,02,050,"Alaska","Bethel Census Area",5,5,362,193,169
050,02,050,"Alaska","Bethel Census Area",5,6,384,221,163
050,02,050,"Alaska","Bethel Census Area",5,7,349,190,159
050,02,050,"Alaska","Bethel Census Area",5,8,357,183,174
050,02,050,"Alaska","Bethel Census Area",5,9,367,191,176
050,02,050,"Alaska","Bethel Census Area",5,10,352,187,165
050,02,050,"Alaska","Bethel Census Area",5,11,363,184,179
050,02,050,"Alaska","Bethel Census Area",5,12,368,185,183
050,02,050,"Alaska","Bethel Census Area",5,13,341,168,173
050,02,050,"Alaska","Bethel Census Area",5,14,317,164,153
050,02,050,"Alaska","Bethel Census Area",5,15,331,167,164
050,02,050,"Alaska","Bethel Census Area",5,16,316,158,158
050,02,050,"Alaska","Bethel Census Area",5,17,321,155,166
050,02,050,"Alaska","Bethel Census Area",5,18,289,142,147
050,02,050,"Alaska","Bethel Census Area",5,19,266,136,130
050,02,050,"Alaska","Bethel Census Area",5,20,274,138,136
050,02,050,"Alaska","Bethel Census Area",5,21,262,122,140
050,02,050,"Alaska","Bethel Census Area",5,22,267,142,125
050,02,050,"Alaska","Bethel Census Area",5,23,281,144,137
050,02,050,"Alaska","Bethel Census Area",5,24,290,166,124
050,02,050,"Alaska","Bethel Census Area",5,25,297,167,130
050,02,050,"Alaska","Bethel Census Area",5,26,281,144,137
050,02,050,"Alaska","Bethel Census Area",5,27,219,117,102
050,02,050,"Alaska","Bethel Census Area",5,28,249,124,125
050,02,050,"Alaska","Bethel Census Area",5,29,258,127,131
050,02,050,"Alaska","Bethel Census Area",5,30,255,129,126
050,02,050,"Alaska","Bethel Census Area",5,31,254,125,129
050,02,050,"Alaska","Bethel Census Area",5,32,289,157,132
050,02,050,"Alaska","Bethel Census Area",5,33,228,124,104
050,02,050,"Alaska","Bethel Census Area",5,34,255,140,115
050,02,050,"Alaska","Bethel Census Area",5,35,274,150,124
050,02,050,"Alaska","Bethel Census Area",5,36,242,127,115
050,02,050,"Alaska","Bethel Census Area",5,37,243,138,105
050,02,050,"Alaska","Bethel Census Area",5,38,221,123,98
050,02,050,"Alaska","Bethel Census Area",5,39,225,123,102
050,02,050,"Alaska","Bethel Census Area",5,40,209,107,102
050,02,050,"Alaska","Bethel Census Area",5,41,192,93,99
050,02,050,"Alaska","Bethel Census Area",5,42,181,92,89
050,02,050,"Alaska","Bethel Census Area",5,43,186,104,82
050,02,050,"Alaska","Bethel Census Area",5,44,183,98,85
050,02,050,"Alaska","Bethel Census Area",5,45,190,103,87
050,02,050,"Alaska","Bethel Census Area",5,46,171,94,77
050,02,050,"Alaska","Bethel Census Area",5,47,159,92,67
050,02,050,"Alaska","Bethel Census Area",5,48,168,91,77
050,02,050,"Alaska","Bethel Census Area",5,49,156,79,77
050,02,050,"Alaska","Bethel Census Area",5,50,172,97,75
050,02,050,"Alaska","Bethel Census Area",5,51,149,87,62
050,02,050,"Alaska","Bethel Census Area",5,52,172,92,80
050,02,050,"Alaska","Bethel Census Area",5,53,153,78,75
050,02,050,"Alaska","Bethel Census Area",5,54,176,94,82
050,02,050,"Alaska","Bethel Census Area",5,55,184,101,83
050,02,050,"Alaska","Bethel Census Area",5,56,191,110,81
050,02,050,"Alaska","Bethel Census Area",5,57,174,108,66
050,02,050,"Alaska","Bethel Census Area",5,58,193,108,85
050,02,050,"Alaska","Bethel Census Area",5,59,209,126,83
050,02,050,"Alaska","Bethel Census Area",5,60,194,105,89
050,02,050,"Alaska","Bethel Census Area",5,61,186,99,87
050,02,050,"Alaska","Bethel Census Area",5,62,170,96,74
050,02,050,"Alaska","Bethel Census Area",5,63,175,96,79
050,02,050,"Alaska","Bethel Census Area",5,64,173,101,72
050,02,050,"Alaska","Bethel Census Area",5,65,147,90,57
050,02,050,"Alaska","Bethel Census Area",5,66,131,74,57
050,02,050,"Alaska","Bethel Census Area",5,67,130,63,67
050,02,050,"Alaska","Bethel Census Area",5,68,138,70,68
050,02,050,"Alaska","Bethel Census Area",5,69,124,66,58
050,02,050,"Alaska","Bethel Census Area",5,70,109,53,56
050,02,050,"Alaska","Bethel Census Area",5,71,110,53,57
050,02,050,"Alaska","Bethel Census Area",5,72,101,53,48
050,02,050,"Alaska","Bethel Census Area",5,73,98,52,46
050,02,050,"Alaska","Bethel Census Area",5,74,91,51,40
050,02,050,"Alaska","Bethel Census Area",5,75,63,27,36
050,02,050,"Alaska","Bethel Census Area",5,76,68,33,35
050,02,050,"Alaska","Bethel Census Area",5,77,39,15,24
050,02,050,"Alaska","Bethel Census Area",5,78,44,22,22
050,02,050,"Alaska","Bethel Census Area",5,79,42,20,22
050,02,050,"Alaska","Bethel Census Area",5,80,34,14,20
050,02,050,"Alaska","Bethel Census Area",5,81,37,11,26
050,02,050,"Alaska","Bethel Census Area",5,82,42,17,25
050,02,050,"Alaska","Bethel Census Area",5,83,28,14,14
050,02,050,"Alaska","Bethel Census Area",5,84,9,5,4
050,02,050,"Alaska","Bethel Census Area",5,85,28,15,13
050,02,060,"Alaska","Bristol Bay Borough",1,0,8,4,4
050,02,060,"Alaska","Bristol Bay Borough",1,1,11,7,4
050,02,060,"Alaska","Bristol Bay Borough",1,2,10,4,6
050,02,060,"Alaska","Bristol Bay Borough",1,3,7,2,5
050,02,060,"Alaska","Bristol Bay Borough",1,4,13,6,7
050,02,060,"Alaska","Bristol Bay Borough",1,5,14,4,10
050,02,060,"Alaska","Bristol Bay Borough",1,6,8,4,4
050,02,060,"Alaska","Bristol Bay Borough",1,7,15,12,3
050,02,060,"Alaska","Bristol Bay Borough",1,8,14,9,5
050,02,060,"Alaska","Bristol Bay Borough",1,9,6,4,2
050,02,060,"Alaska","Bristol Bay Borough",1,10,9,3,6
050,02,060,"Alaska","Bristol Bay Borough",1,11,7,2,5
050,02,060,"Alaska","Bristol Bay Borough",1,12,7,4,3
050,02,060,"Alaska","Bristol Bay Borough",1,13,4,2,2
050,02,060,"Alaska","Bristol Bay Borough",1,14,7,5,2
050,02,060,"Alaska","Bristol Bay Borough",1,15,6,2,4
050,02,060,"Alaska","Bristol Bay Borough",1,16,7,3,4
050,02,060,"Alaska","Bristol Bay Borough",1,17,5,2,3
050,02,060,"Alaska","Bristol Bay Borough",1,18,5,2,3
050,02,060,"Alaska","Bristol Bay Borough",1,19,10,5,5
050,02,060,"Alaska","Bristol Bay Borough",1,20,8,4,4
050,02,060,"Alaska","Bristol Bay Borough",1,21,8,5,3
050,02,060,"Alaska","Bristol Bay Borough",1,22,7,4,3
050,02,060,"Alaska","Bristol Bay Borough",1,23,10,5,5
050,02,060,"Alaska","Bristol Bay Borough",1,24,13,8,5
050,02,060,"Alaska","Bristol Bay Borough",1,25,15,8,7
050,02,060,"Alaska","Bristol Bay Borough",1,26,7,3,4
050,02,060,"Alaska","Bristol Bay Borough",1,27,10,4,6
050,02,060,"Alaska","Bristol Bay Borough",1,28,11,6,5
050,02,060,"Alaska","Bristol Bay Borough",1,29,10,7,3
050,02,060,"Alaska","Bristol Bay Borough",1,30,13,6,7
050,02,060,"Alaska","Bristol Bay Borough",1,31,9,2,7
050,02,060,"Alaska","Bristol Bay Borough",1,32,16,8,8
050,02,060,"Alaska","Bristol Bay Borough",1,33,18,5,13
050,02,060,"Alaska","Bristol Bay Borough",1,34,10,5,5
050,02,060,"Alaska","Bristol Bay Borough",1,35,15,8,7
050,02,060,"Alaska","Bristol Bay Borough",1,36,12,6,6
050,02,060,"Alaska","Bristol Bay Borough",1,37,7,4,3
050,02,060,"Alaska","Bristol Bay Borough",1,38,8,5,3
050,02,060,"Alaska","Bristol Bay Borough",1,39,15,9,6
050,02,060,"Alaska","Bristol Bay Borough",1,40,9,7,2
050,02,060,"Alaska","Bristol Bay Borough",1,41,6,3,3
050,02,060,"Alaska","Bristol Bay Borough",1,42,5,3,2
050,02,060,"Alaska","Bristol Bay Borough",1,43,6,4,2
050,02,060,"Alaska","Bristol Bay Borough",1,44,15,10,5
050,02,060,"Alaska","Bristol Bay Borough",1,45,11,7,4
050,02,060,"Alaska","Bristol Bay Borough",1,46,12,4,8
050,02,060,"Alaska","Bristol Bay Borough",1,47,6,5,1
050,02,060,"Alaska","Bristol Bay Borough",1,48,12,5,7
050,02,060,"Alaska","Bristol Bay Borough",1,49,10,6,4
050,02,060,"Alaska","Bristol Bay Borough",1,50,9,7,2
050,02,060,"Alaska","Bristol Bay Borough",1,51,11,6,5
050,02,060,"Alaska","Bristol Bay Borough",1,52,8,4,4
050,02,060,"Alaska","Bristol Bay Borough",1,53,9,7,2
050,02,060,"Alaska","Bristol Bay Borough",1,54,11,7,4
050,02,060,"Alaska","Bristol Bay Borough",1,55,15,10,5
050,02,060,"Alaska","Bristol Bay Borough",1,56,14,7,7
050,02,060,"Alaska","Bristol Bay Borough",1,57,18,8,10
050,02,060,"Alaska","Bristol Bay Borough",1,58,16,7,9
050,02,060,"Alaska","Bristol Bay Borough",1,59,18,13,5
050,02,060,"Alaska","Bristol Bay Borough",1,60,22,11,11
050,02,060,"Alaska","Bristol Bay Borough",1,61,16,9,7
050,02,060,"Alaska","Bristol Bay Borough",1,62,13,6,7
050,02,060,"Alaska","Bristol Bay Borough",1,63,12,6,6
050,02,060,"Alaska","Bristol Bay Borough",1,64,9,7,2
050,02,060,"Alaska","Bristol Bay Borough",1,65,14,8,6
050,02,060,"Alaska","Bristol Bay Borough",1,66,13,7,6
050,02,060,"Alaska","Bristol Bay Borough",1,67,18,9,9
050,02,060,"Alaska","Bristol Bay Borough",1,68,10,7,3
050,02,060,"Alaska","Bristol Bay Borough",1,69,8,5,3
050,02,060,"Alaska","Bristol Bay Borough",1,70,10,4,6
050,02,060,"Alaska","Bristol Bay Borough",1,71,10,5,5
050,02,060,"Alaska","Bristol Bay Borough",1,72,7,5,2
050,02,060,"Alaska","Bristol Bay Borough",1,73,6,5,1
050,02,060,"Alaska","Bristol Bay Borough",1,74,5,4,1
050,02,060,"Alaska","Bristol Bay Borough",1,75,5,4,1
050,02,060,"Alaska","Bristol Bay Borough",1,76,7,5,2
050,02,060,"Alaska","Bristol Bay Borough",1,77,3,1,2
050,02,060,"Alaska","Bristol Bay Borough",1,78,4,2,2
050,02,060,"Alaska","Bristol Bay Borough",1,79,3,1,2
050,02,060,"Alaska","Bristol Bay Borough",1,80,2,0,2
050,02,060,"Alaska","Bristol Bay Borough",1,81,5,2,3
050,02,060,"Alaska","Bristol Bay Borough",1,82,4,3,1
050,02,060,"Alaska","Bristol Bay Borough",1,83,3,1,2
050,02,060,"Alaska","Bristol Bay Borough",1,84,5,3,2
050,02,060,"Alaska","Bristol Bay Borough",1,85,13,3,10
050,02,060,"Alaska","Bristol Bay Borough",2,0,10,5,5
050,02,060,"Alaska","Bristol Bay Borough",2,1,11,7,4
050,02,060,"Alaska","Bristol Bay Borough",2,2,10,4,6
050,02,060,"Alaska","Bristol Bay Borough",2,3,6,2,4
050,02,060,"Alaska","Bristol Bay Borough",2,4,10,5,5
050,02,060,"Alaska","Bristol Bay Borough",2,5,14,4,10
050,02,060,"Alaska","Bristol Bay Borough",2,6,11,5,6
050,02,060,"Alaska","Bristol Bay Borough",2,7,14,11,3
050,02,060,"Alaska","Bristol Bay Borough",2,8,12,8,4
050,02,060,"Alaska","Bristol Bay Borough",2,9,8,5,3
050,02,060,"Alaska","Bristol Bay Borough",2,10,9,3,6
050,02,060,"Alaska","Bristol Bay Borough",2,11,8,2,6
050,02,060,"Alaska","Bristol Bay Borough",2,12,7,4,3
050,02,060,"Alaska","Bristol Bay Borough",2,13,4,2,2
050,02,060,"Alaska","Bristol Bay Borough",2,14,6,4,2
050,02,060,"Alaska","Bristol Bay Borough",2,15,6,2,4
050,02,060,"Alaska","Bristol Bay Borough",2,16,7,3,4
050,02,060,"Alaska","Bristol Bay Borough",2,17,5,2,3
050,02,060,"Alaska","Bristol Bay Borough",2,18,4,2,2
050,02,060,"Alaska","Bristol Bay Borough",2,19,7,4,3
050,02,060,"Alaska","Bristol Bay Borough",2,20,9,5,4
050,02,060,"Alaska","Bristol Bay Borough",2,21,8,5,3
050,02,060,"Alaska","Bristol Bay Borough",2,22,7,4,3
050,02,060,"Alaska","Bristol Bay Borough",2,23,10,5,5
050,02,060,"Alaska","Bristol Bay Borough",2,24,13,8,5
050,02,060,"Alaska","Bristol Bay Borough",2,25,15,8,7
050,02,060,"Alaska","Bristol Bay Borough",2,26,7,3,4
050,02,060,"Alaska","Bristol Bay Borough",2,27,10,4,6
050,02,060,"Alaska","Bristol Bay Borough",2,28,11,6,5
050,02,060,"Alaska","Bristol Bay Borough",2,29,10,7,3
050,02,060,"Alaska","Bristol Bay Borough",2,30,14,7,7
050,02,060,"Alaska","Bristol Bay Borough",2,31,10,4,6
050,02,060,"Alaska","Bristol Bay Borough",2,32,16,7,9
050,02,060,"Alaska","Bristol Bay Borough",2,33,16,5,11
050,02,060,"Alaska","Bristol Bay Borough",2,34,12,5,7
050,02,060,"Alaska","Bristol Bay Borough",2,35,12,6,6
050,02,060,"Alaska","Bristol Bay Borough",2,36,13,7,6
050,02,060,"Alaska","Bristol Bay Borough",2,37,9,5,4
050,02,060,"Alaska","Bristol Bay Borough",2,38,9,6,3
050,02,060,"Alaska","Bristol Bay Borough",2,39,12,7,5
050,02,060,"Alaska","Bristol Bay Borough",2,40,10,7,3
050,02,060,"Alaska","Bristol Bay Borough",2,41,8,4,4
050,02,060,"Alaska","Bristol Bay Borough",2,42,5,3,2
050,02,060,"Alaska","Bristol Bay Borough",2,43,6,4,2
050,02,060,"Alaska","Bristol Bay Borough",2,44,11,8,3
050,02,060,"Alaska","Bristol Bay Borough",2,45,12,8,4
050,02,060,"Alaska","Bristol Bay Borough",2,46,10,4,6
050,02,060,"Alaska","Bristol Bay Borough",2,47,7,5,2
050,02,060,"Alaska","Bristol Bay Borough",2,48,10,4,6
050,02,060,"Alaska","Bristol Bay Borough",2,49,11,6,5
050,02,060,"Alaska","Bristol Bay Borough",2,50,8,6,2
050,02,060,"Alaska","Bristol Bay Borough",2,51,10,6,4
050,02,060,"Alaska","Bristol Bay Borough",2,52,8,4,4
050,02,060,"Alaska","Bristol Bay Borough",2,53,9,7,2
050,02,060,"Alaska","Bristol Bay Borough",2,54,10,7,3
050,02,060,"Alaska","Bristol Bay Borough",2,55,14,9,5
050,02,060,"Alaska","Bristol Bay Borough",2,56,13,8,5
050,02,060,"Alaska","Bristol Bay Borough",2,57,17,8,9
050,02,060,"Alaska","Bristol Bay Borough",2,58,16,8,8
050,02,060,"Alaska","Bristol Bay Borough",2,59,16,11,5
050,02,060,"Alaska","Bristol Bay Borough",2,60,21,12,9
050,02,060,"Alaska","Bristol Bay Borough",2,61,16,8,8
050,02,060,"Alaska","Bristol Bay Borough",2,62,12,6,6
050,02,060,"Alaska","Bristol Bay Borough",2,63,12,6,6
050,02,060,"Alaska","Bristol Bay Borough",2,64,10,7,3
050,02,060,"Alaska","Bristol Bay Borough",2,65,13,8,5
050,02,060,"Alaska","Bristol Bay Borough",2,66,12,7,5
050,02,060,"Alaska","Bristol Bay Borough",2,67,18,9,9
050,02,060,"Alaska","Bristol Bay Borough",2,68,11,7,4
050,02,060,"Alaska","Bristol Bay Borough",2,69,9,6,3
050,02,060,"Alaska","Bristol Bay Borough",2,70,10,4,6
050,02,060,"Alaska","Bristol Bay Borough",2,71,10,5,5
050,02,060,"Alaska","Bristol Bay Borough",2,72,8,5,3
050,02,060,"Alaska","Bristol Bay Borough",2,73,6,5,1
050,02,060,"Alaska","Bristol Bay Borough",2,74,5,4,1
050,02,060,"Alaska","Bristol Bay Borough",2,75,5,4,1
050,02,060,"Alaska","Bristol Bay Borough",2,76,7,5,2
050,02,060,"Alaska","Bristol Bay Borough",2,77,4,2,2
050,02,060,"Alaska","Bristol Bay Borough",2,78,4,2,2
050,02,060,"Alaska","Bristol Bay Borough",2,79,3,1,2
050,02,060,"Alaska","Bristol Bay Borough",2,80,2,0,2
050,02,060,"Alaska","Bristol Bay Borough",2,81,5,2,3
050,02,060,"Alaska","Bristol Bay Borough",2,82,4,3,1
050,02,060,"Alaska","Bristol Bay Borough",2,83,3,1,2
050,02,060,"Alaska","Bristol Bay Borough",2,84,4,2,2
050,02,060,"Alaska","Bristol Bay Borough",2,85,13,3,10
050,02,060,"Alaska","Bristol Bay Borough",3,0,6,1,5
050,02,060,"Alaska","Bristol Bay Borough",3,1,9,5,4
050,02,060,"Alaska","Bristol Bay Borough",3,2,11,7,4
050,02,060,"Alaska","Bristol Bay Borough",3,3,10,4,6
050,02,060,"Alaska","Bristol Bay Borough",3,4,7,3,4
050,02,060,"Alaska","Bristol Bay Borough",3,5,12,7,5
050,02,060,"Alaska","Bristol Bay Borough",3,6,19,7,12
050,02,060,"Alaska","Bristol Bay Borough",3,7,10,4,6
050,02,060,"Alaska","Bristol Bay Borough",3,8,14,11,3
050,02,060,"Alaska","Bristol Bay Borough",3,9,15,9,6
050,02,060,"Alaska","Bristol Bay Borough",3,10,8,5,3
050,02,060,"Alaska","Bristol Bay Borough",3,11,9,3,6
050,02,060,"Alaska","Bristol Bay Borough",3,12,10,3,7
050,02,060,"Alaska","Bristol Bay Borough",3,13,7,4,3
050,02,060,"Alaska","Bristol Bay Borough",3,14,4,2,2
050,02,060,"Alaska","Bristol Bay Borough",3,15,7,4,3
050,02,060,"Alaska","Bristol Bay Borough",3,16,6,2,4
050,02,060,"Alaska","Bristol Bay Borough",3,17,7,3,4
050,02,060,"Alaska","Bristol Bay Borough",3,18,6,2,4
050,02,060,"Alaska","Bristol Bay Borough",3,19,3,2,1
050,02,060,"Alaska","Bristol Bay Borough",3,20,6,4,2
050,02,060,"Alaska","Bristol Bay Borough",3,21,9,6,3
050,02,060,"Alaska","Bristol Bay Borough",3,22,7,3,4
050,02,060,"Alaska","Bristol Bay Borough",3,23,10,6,4
050,02,060,"Alaska","Bristol Bay Borough",3,24,10,6,4
050,02,060,"Alaska","Bristol Bay Borough",3,25,16,10,6
050,02,060,"Alaska","Bristol Bay Borough",3,26,14,7,7
050,02,060,"Alaska","Bristol Bay Borough",3,27,11,4,7
050,02,060,"Alaska","Bristol Bay Borough",3,28,15,9,6
050,02,060,"Alaska","Bristol Bay Borough",3,29,11,6,5
050,02,060,"Alaska","Bristol Bay Borough",3,30,10,6,4
050,02,060,"Alaska","Bristol Bay Borough",3,31,14,6,8
050,02,060,"Alaska","Bristol Bay Borough",3,32,10,4,6
050,02,060,"Alaska","Bristol Bay Borough",3,33,14,6,8
050,02,060,"Alaska","Bristol Bay Borough",3,34,16,6,10
050,02,060,"Alaska","Bristol Bay Borough",3,35,11,6,5
050,02,060,"Alaska","Bristol Bay Borough",3,36,12,6,6
050,02,060,"Alaska","Bristol Bay Borough",3,37,12,6,6
050,02,060,"Alaska","Bristol Bay Borough",3,38,11,6,5
050,02,060,"Alaska","Bristol Bay Borough",3,39,6,3,3
050,02,060,"Alaska","Bristol Bay Borough",3,40,12,7,5
050,02,060,"Alaska","Bristol Bay Borough",3,41,13,9,4
050,02,060,"Alaska","Bristol Bay Borough",3,42,8,5,3
050,02,060,"Alaska","Bristol Bay Borough",3,43,6,3,3
050,02,060,"Alaska","Bristol Bay Borough",3,44,7,5,2
050,02,060,"Alaska","Bristol Bay Borough",3,45,9,7,2
050,02,060,"Alaska","Bristol Bay Borough",3,46,9,7,2
050,02,060,"Alaska","Bristol Bay Borough",3,47,11,5,6
050,02,060,"Alaska","Bristol Bay Borough",3,48,6,4,2
050,02,060,"Alaska","Bristol Bay Borough",3,49,8,4,4
050,02,060,"Alaska","Bristol Bay Borough",3,50,11,6,5
050,02,060,"Alaska","Bristol Bay Borough",3,51,9,6,3
050,02,060,"Alaska","Bristol Bay Borough",3,52,11,7,4
050,02,060,"Alaska","Bristol Bay Borough",3,53,9,4,5
050,02,060,"Alaska","Bristol Bay Borough",3,54,9,7,2
050,02,060,"Alaska","Bristol Bay Borough",3,55,11,8,3
050,02,060,"Alaska","Bristol Bay Borough",3,56,13,8,5
050,02,060,"Alaska","Bristol Bay Borough",3,57,14,8,6
050,02,060,"Alaska","Bristol Bay Borough",3,58,17,8,9
050,02,060,"Alaska","Bristol Bay Borough",3,59,14,8,6
050,02,060,"Alaska","Bristol Bay Borough",3,60,15,10,5
050,02,060,"Alaska","Bristol Bay Borough",3,61,19,10,9
050,02,060,"Alaska","Bristol Bay Borough",3,62,16,9,7
050,02,060,"Alaska","Bristol Bay Borough",3,63,11,5,6
050,02,060,"Alaska","Bristol Bay Borough",3,64,11,5,6
050,02,060,"Alaska","Bristol Bay Borough",3,65,8,6,2
050,02,060,"Alaska","Bristol Bay Borough",3,66,13,8,5
050,02,060,"Alaska","Bristol Bay Borough",3,67,12,7,5
050,02,060,"Alaska","Bristol Bay Borough",3,68,17,9,8
050,02,060,"Alaska","Bristol Bay Borough",3,69,11,7,4
050,02,060,"Alaska","Bristol Bay Borough",3,70,6,4,2
050,02,060,"Alaska","Bristol Bay Borough",3,71,10,4,6
050,02,060,"Alaska","Bristol Bay Borough",3,72,10,5,5
050,02,060,"Alaska","Bristol Bay Borough",3,73,8,5,3
050,02,060,"Alaska","Bristol Bay Borough",3,74,5,4,1
050,02,060,"Alaska","Bristol Bay Borough",3,75,6,5,1
050,02,060,"Alaska","Bristol Bay Borough",3,76,5,4,1
050,02,060,"Alaska","Bristol Bay Borough",3,77,7,5,2
050,02,060,"Alaska","Bristol Bay Borough",3,78,4,2,2
050,02,060,"Alaska","Bristol Bay Borough",3,79,4,2,2
050,02,060,"Alaska","Bristol Bay Borough",3,80,3,1,2
050,02,060,"Alaska","Bristol Bay Borough",3,81,2,0,2
050,02,060,"Alaska","Bristol Bay Borough",3,82,4,1,3
050,02,060,"Alaska","Bristol Bay Borough",3,83,4,3,1
050,02,060,"Alaska","Bristol Bay Borough",3,84,3,1,2
050,02,060,"Alaska","Bristol Bay Borough",3,85,16,5,11
050,02,060,"Alaska","Bristol Bay Borough",4,0,11,4,7
050,02,060,"Alaska","Bristol Bay Borough",4,1,10,3,7
050,02,060,"Alaska","Bristol Bay Borough",4,2,9,5,4
050,02,060,"Alaska","Bristol Bay Borough",4,3,11,7,4
050,02,060,"Alaska","Bristol Bay Borough",4,4,13,7,6
050,02,060,"Alaska","Bristol Bay Borough",4,5,7,3,4
050,02,060,"Alaska","Bristol Bay Borough",4,6,12,8,4
050,02,060,"Alaska","Bristol Bay Borough",4,7,20,8,12
050,02,060,"Alaska","Bristol Bay Borough",4,8,8,4,4
050,02,060,"Alaska","Bristol Bay Borough",4,9,15,11,4
050,02,060,"Alaska","Bristol Bay Borough",4,10,16,10,6
050,02,060,"Alaska","Bristol Bay Borough",4,11,8,5,3
050,02,060,"Alaska","Bristol Bay Borough",4,12,7,3,4
050,02,060,"Alaska","Bristol Bay Borough",4,13,10,3,7
050,02,060,"Alaska","Bristol Bay Borough",4,14,5,2,3
050,02,060,"Alaska","Bristol Bay Borough",4,15,6,2,4
050,02,060,"Alaska","Bristol Bay Borough",4,16,9,4,5
050,02,060,"Alaska","Bristol Bay Borough",4,17,6,2,4
050,02,060,"Alaska","Bristol Bay Borough",4,18,8,3,5
050,02,060,"Alaska","Bristol Bay Borough",4,19,8,4,4
050,02,060,"Alaska","Bristol Bay Borough",4,20,3,2,1
050,02,060,"Alaska","Bristol Bay Borough",4,21,7,5,2
050,02,060,"Alaska","Bristol Bay Borough",4,22,8,5,3
050,02,060,"Alaska","Bristol Bay Borough",4,23,10,6,4
050,02,060,"Alaska","Bristol Bay Borough",4,24,13,8,5
050,02,060,"Alaska","Bristol Bay Borough",4,25,8,6,2
050,02,060,"Alaska","Bristol Bay Borough",4,26,16,7,9
050,02,060,"Alaska","Bristol Bay Borough",4,27,19,10,9
050,02,060,"Alaska","Bristol Bay Borough",4,28,16,10,6
050,02,060,"Alaska","Bristol Bay Borough",4,29,15,8,7
050,02,060,"Alaska","Bristol Bay Borough",4,30,12,6,6
050,02,060,"Alaska","Bristol Bay Borough",4,31,12,7,5
050,02,060,"Alaska","Bristol Bay Borough",4,32,15,6,9
050,02,060,"Alaska","Bristol Bay Borough",4,33,10,4,6
050,02,060,"Alaska","Bristol Bay Borough",4,34,16,6,10
050,02,060,"Alaska","Bristol Bay Borough",4,35,15,6,9
050,02,060,"Alaska","Bristol Bay Borough",4,36,12,7,5
050,02,060,"Alaska","Bristol Bay Borough",4,37,11,6,5
050,02,060,"Alaska","Bristol Bay Borough",4,38,11,7,4
050,02,060,"Alaska","Bristol Bay Borough",4,39,8,4,4
050,02,060,"Alaska","Bristol Bay Borough",4,40,8,5,3
050,02,060,"Alaska","Bristol Bay Borough",4,41,13,7,6
050,02,060,"Alaska","Bristol Bay Borough",4,42,14,10,4
050,02,060,"Alaska","Bristol Bay Borough",4,43,9,5,4
050,02,060,"Alaska","Bristol Bay Borough",4,44,7,4,3
050,02,060,"Alaska","Bristol Bay Borough",4,45,7,5,2
050,02,060,"Alaska","Bristol Bay Borough",4,46,9,7,2
050,02,060,"Alaska","Bristol Bay Borough",4,47,8,7,1
050,02,060,"Alaska","Bristol Bay Borough",4,48,11,5,6
050,02,060,"Alaska","Bristol Bay Borough",4,49,7,5,2
050,02,060,"Alaska","Bristol Bay Borough",4,50,8,4,4
050,02,060,"Alaska","Bristol Bay Borough",4,51,12,6,6
050,02,060,"Alaska","Bristol Bay Borough",4,52,9,6,3
050,02,060,"Alaska","Bristol Bay Borough",4,53,13,10,3
050,02,060,"Alaska","Bristol Bay Borough",4,54,9,4,5
050,02,060,"Alaska","Bristol Bay Borough",4,55,9,7,2
050,02,060,"Alaska","Bristol Bay Borough",4,56,11,8,3
050,02,060,"Alaska","Bristol Bay Borough",4,57,13,8,5
050,02,060,"Alaska","Bristol Bay Borough",4,58,13,8,5
050,02,060,"Alaska","Bristol Bay Borough",4,59,18,8,10
050,02,060,"Alaska","Bristol Bay Borough",4,60,13,8,5
050,02,060,"Alaska","Bristol Bay Borough",4,61,11,6,5
050,02,060,"Alaska","Bristol Bay Borough",4,62,18,10,8
050,02,060,"Alaska","Bristol Bay Borough",4,63,13,7,6
050,02,060,"Alaska","Bristol Bay Borough",4,64,13,7,6
050,02,060,"Alaska","Bristol Bay Borough",4,65,10,6,4
050,02,060,"Alaska","Bristol Bay Borough",4,66,7,5,2
050,02,060,"Alaska","Bristol Bay Borough",4,67,10,6,4
050,02,060,"Alaska","Bristol Bay Borough",4,68,12,7,5
050,02,060,"Alaska","Bristol Bay Borough",4,69,17,9,8
050,02,060,"Alaska","Bristol Bay Borough",4,70,10,7,3
050,02,060,"Alaska","Bristol Bay Borough",4,71,5,3,2
050,02,060,"Alaska","Bristol Bay Borough",4,72,10,4,6
050,02,060,"Alaska","Bristol Bay Borough",4,73,10,5,5
050,02,060,"Alaska","Bristol Bay Borough",4,74,7,5,2
050,02,060,"Alaska","Bristol Bay Borough",4,75,5,4,1
050,02,060,"Alaska","Bristol Bay Borough",4,76,6,5,1
050,02,060,"Alaska","Bristol Bay Borough",4,77,5,4,1
050,02,060,"Alaska","Bristol Bay Borough",4,78,7,5,2
050,02,060,"Alaska","Bristol Bay Borough",4,79,4,2,2
050,02,060,"Alaska","Bristol Bay Borough",4,80,2,1,1
050,02,060,"Alaska","Bristol Bay Borough",4,81,3,1,2
050,02,060,"Alaska","Bristol Bay Borough",4,82,2,0,2
050,02,060,"Alaska","Bristol Bay Borough",4,83,4,1,3
050,02,060,"Alaska","Bristol Bay Borough",4,84,4,3,1
050,02,060,"Alaska","Bristol Bay Borough",4,85,18,5,13
050,02,060,"Alaska","Bristol Bay Borough",5,0,11,4,7
050,02,060,"Alaska","Bristol Bay Borough",5,1,11,4,7
050,02,060,"Alaska","Bristol Bay Borough",5,2,11,4,7
050,02,060,"Alaska","Bristol Bay Borough",5,3,9,5,4
050,02,060,"Alaska","Bristol Bay Borough",5,4,13,9,4
050,02,060,"Alaska","Bristol Bay Borough",5,5,13,6,7
050,02,060,"Alaska","Bristol Bay Borough",5,6,4,2,2
050,02,060,"Alaska","Bristol Bay Borough",5,7,12,7,5
050,02,060,"Alaska","Bristol Bay Borough",5,8,14,9,5
050,02,060,"Alaska","Bristol Bay Borough",5,9,8,4,4
050,02,060,"Alaska","Bristol Bay Borough",5,10,15,9,6
050,02,060,"Alaska","Bristol Bay Borough",5,11,14,10,4
050,02,060,"Alaska","Bristol Bay Borough",5,12,10,6,4
050,02,060,"Alaska","Bristol Bay Borough",5,13,7,3,4
050,02,060,"Alaska","Bristol Bay Borough",5,14,9,3,6
050,02,060,"Alaska","Bristol Bay Borough",5,15,4,2,2
050,02,060,"Alaska","Bristol Bay Borough",5,16,6,2,4
050,02,060,"Alaska","Bristol Bay Borough",5,17,10,5,5
050,02,060,"Alaska","Bristol Bay Borough",5,18,6,2,4
050,02,060,"Alaska","Bristol Bay Borough",5,19,7,3,4
050,02,060,"Alaska","Bristol Bay Borough",5,20,7,3,4
050,02,060,"Alaska","Bristol Bay Borough",5,21,4,3,1
050,02,060,"Alaska","Bristol Bay Borough",5,22,4,3,1
050,02,060,"Alaska","Bristol Bay Borough",5,23,8,4,4
050,02,060,"Alaska","Bristol Bay Borough",5,24,10,5,5
050,02,060,"Alaska","Bristol Bay Borough",5,25,13,8,5
050,02,060,"Alaska","Bristol Bay Borough",5,26,7,5,2
050,02,060,"Alaska","Bristol Bay Borough",5,27,12,8,4
050,02,060,"Alaska","Bristol Bay Borough",5,28,23,15,8
050,02,060,"Alaska","Bristol Bay Borough",5,29,19,11,8
050,02,060,"Alaska","Bristol Bay Borough",5,30,15,8,7
050,02,060,"Alaska","Bristol Bay Borough",5,31,11,4,7
050,02,060,"Alaska","Bristol Bay Borough",5,32,10,5,5
050,02,060,"Alaska","Bristol Bay Borough",5,33,13,7,6
050,02,060,"Alaska","Bristol Bay Borough",5,34,10,4,6
050,02,060,"Alaska","Bristol Bay Borough",5,35,12,7,5
050,02,060,"Alaska","Bristol Bay Borough",5,36,12,6,6
050,02,060,"Alaska","Bristol Bay Borough",5,37,12,6,6
050,02,060,"Alaska","Bristol Bay Borough",5,38,13,8,5
050,02,060,"Alaska","Bristol Bay Borough",5,39,10,5,5
050,02,060,"Alaska","Bristol Bay Borough",5,40,8,4,4
050,02,060,"Alaska","Bristol Bay Borough",5,41,8,5,3
050,02,060,"Alaska","Bristol Bay Borough",5,42,9,7,2
050,02,060,"Alaska","Bristol Bay Borough",5,43,9,7,2
050,02,060,"Alaska","Bristol Bay Borough",5,44,8,5,3
050,02,060,"Alaska","Bristol Bay Borough",5,45,7,4,3
050,02,060,"Alaska","Bristol Bay Borough",5,46,7,5,2
050,02,060,"Alaska","Bristol Bay Borough",5,47,9,7,2
050,02,060,"Alaska","Bristol Bay Borough",5,48,4,3,1
050,02,060,"Alaska","Bristol Bay Borough",5,49,11,5,6
050,02,060,"Alaska","Bristol Bay Borough",5,50,8,5,3
050,02,060,"Alaska","Bristol Bay Borough",5,51,9,4,5
050,02,060,"Alaska","Bristol Bay Borough",5,52,12,6,6
050,02,060,"Alaska","Bristol Bay Borough",5,53,9,6,3
050,02,060,"Alaska","Bristol Bay Borough",5,54,15,10,5
050,02,060,"Alaska","Bristol Bay Borough",5,55,9,5,4
050,02,060,"Alaska","Bristol Bay Borough",5,56,9,7,2
050,02,060,"Alaska","Bristol Bay Borough",5,57,7,4,3
050,02,060,"Alaska","Bristol Bay Borough",5,58,17,10,7
050,02,060,"Alaska","Bristol Bay Borough",5,59,13,9,4
050,02,060,"Alaska","Bristol Bay Borough",5,60,16,6,10
050,02,060,"Alaska","Bristol Bay Borough",5,61,12,7,5
050,02,060,"Alaska","Bristol Bay Borough",5,62,13,8,5
050,02,060,"Alaska","Bristol Bay Borough",5,63,14,6,8
050,02,060,"Alaska","Bristol Bay Borough",5,64,12,6,6
050,02,060,"Alaska","Bristol Bay Borough",5,65,11,7,4
050,02,060,"Alaska","Bristol Bay Borough",5,66,9,5,4
050,02,060,"Alaska","Bristol Bay Borough",5,67,7,5,2
050,02,060,"Alaska","Bristol Bay Borough",5,68,10,6,4
050,02,060,"Alaska","Bristol Bay Borough",5,69,12,7,5
050,02,060,"Alaska","Bristol Bay Borough",5,70,16,9,7
050,02,060,"Alaska","Bristol Bay Borough",5,71,10,7,3
050,02,060,"Alaska","Bristol Bay Borough",5,72,5,3,2
050,02,060,"Alaska","Bristol Bay Borough",5,73,10,4,6
050,02,060,"Alaska","Bristol Bay Borough",5,74,9,5,4
050,02,060,"Alaska","Bristol Bay Borough",5,75,7,5,2
050,02,060,"Alaska","Bristol Bay Borough",5,76,5,4,1
050,02,060,"Alaska","Bristol Bay Borough",5,77,6,5,1
050,02,060,"Alaska","Bristol Bay Borough",5,78,7,5,2
050,02,060,"Alaska","Bristol Bay Borough",5,79,7,5,2
050,02,060,"Alaska","Bristol Bay Borough",5,80,4,2,2
050,02,060,"Alaska","Bristol Bay Borough",5,81,2,1,1
050,02,060,"Alaska","Bristol Bay Borough",5,82,3,1,2
050,02,060,"Alaska","Bristol Bay Borough",5,83,2,0,2
050,02,060,"Alaska","Bristol Bay Borough",5,84,4,1,3
050,02,060,"Alaska","Bristol Bay Borough",5,85,24,11,13
050,02,063,"Alaska","Chugach Census Area",1,0,78,40,38
050,02,063,"Alaska","Chugach Census Area",1,1,87,48,39
050,02,063,"Alaska","Chugach Census Area",1,2,87,44,43
050,02,063,"Alaska","Chugach Census Area",1,3,90,43,47
050,02,063,"Alaska","Chugach Census Area",1,4,88,40,48
050,02,063,"Alaska","Chugach Census Area",1,5,100,49,51
050,02,063,"Alaska","Chugach Census Area",1,6,91,49,42
050,02,063,"Alaska","Chugach Census Area",1,7,95,44,51
050,02,063,"Alaska","Chugach Census Area",1,8,94,53,41
050,02,063,"Alaska","Chugach Census Area",1,9,95,55,40
050,02,063,"Alaska","Chugach Census Area",1,10,87,45,42
050,02,063,"Alaska","Chugach Census Area",1,11,96,51,45
050,02,063,"Alaska","Chugach Census Area",1,12,99,45,54
050,02,063,"Alaska","Chugach Census Area",1,13,88,48,40
050,02,063,"Alaska","Chugach Census Area",1,14,77,44,33
050,02,063,"Alaska","Chugach Census Area",1,15,70,40,30
050,02,063,"Alaska","Chugach Census Area",1,16,69,35,34
050,02,063,"Alaska","Chugach Census Area",1,17,83,38,45
050,02,063,"Alaska","Chugach Census Area",1,18,95,47,48
050,02,063,"Alaska","Chugach Census Area",1,19,74,42,32
050,02,063,"Alaska","Chugach Census Area",1,20,82,48,34
050,02,063,"Alaska","Chugach Census Area",1,21,95,60,35
050,02,063,"Alaska","Chugach Census Area",1,22,88,54,34
050,02,063,"Alaska","Chugach Census Area",1,23,88,52,36
050,02,063,"Alaska","Chugach Census Area",1,24,74,44,30
050,02,063,"Alaska","Chugach Census Area",1,25,85,44,41
050,02,063,"Alaska","Chugach Census Area",1,26,91,41,50
050,02,063,"Alaska","Chugach Census Area",1,27,90,50,40
050,02,063,"Alaska","Chugach Census Area",1,28,90,44,46
050,02,063,"Alaska","Chugach Census Area",1,29,103,56,47
050,02,063,"Alaska","Chugach Census Area",1,30,96,48,48
050,02,063,"Alaska","Chugach Census Area",1,31,87,42,45
050,02,063,"Alaska","Chugach Census Area",1,32,109,60,49
050,02,063,"Alaska","Chugach Census Area",1,33,108,61,47
050,02,063,"Alaska","Chugach Census Area",1,34,106,59,47
050,02,063,"Alaska","Chugach Census Area",1,35,111,61,50
050,02,063,"Alaska","Chugach Census Area",1,36,106,59,47
050,02,063,"Alaska","Chugach Census Area",1,37,97,53,44
050,02,063,"Alaska","Chugach Census Area",1,38,104,59,45
050,02,063,"Alaska","Chugach Census Area",1,39,104,57,47
050,02,063,"Alaska","Chugach Census Area",1,40,92,52,40
050,02,063,"Alaska","Chugach Census Area",1,41,93,47,46
050,02,063,"Alaska","Chugach Census Area",1,42,74,33,41
050,02,063,"Alaska","Chugach Census Area",1,43,83,42,41
050,02,063,"Alaska","Chugach Census Area",1,44,66,38,28
050,02,063,"Alaska","Chugach Census Area",1,45,80,41,39
050,02,063,"Alaska","Chugach Census Area",1,46,69,37,32
050,02,063,"Alaska","Chugach Census Area",1,47,73,36,37
050,02,063,"Alaska","Chugach Census Area",1,48,84,52,32
050,02,063,"Alaska","Chugach Census Area",1,49,102,58,44
050,02,063,"Alaska","Chugach Census Area",1,50,92,54,38
050,02,063,"Alaska","Chugach Census Area",1,51,83,51,32
050,02,063,"Alaska","Chugach Census Area",1,52,89,45,44
050,02,063,"Alaska","Chugach Census Area",1,53,84,50,34
050,02,063,"Alaska","Chugach Census Area",1,54,104,61,43
050,02,063,"Alaska","Chugach Census Area",1,55,99,54,45
050,02,063,"Alaska","Chugach Census Area",1,56,102,58,44
050,02,063,"Alaska","Chugach Census Area",1,57,116,66,50
050,02,063,"Alaska","Chugach Census Area",1,58,134,76,58
050,02,063,"Alaska","Chugach Census Area",1,59,127,69,58
050,02,063,"Alaska","Chugach Census Area",1,60,121,66,55
050,02,063,"Alaska","Chugach Census Area",1,61,138,72,66
050,02,063,"Alaska","Chugach Census Area",1,62,124,65,59
050,02,063,"Alaska","Chugach Census Area",1,63,128,74,54
050,02,063,"Alaska","Chugach Census Area",1,64,123,63,60
050,02,063,"Alaska","Chugach Census Area",1,65,115,62,53
050,02,063,"Alaska","Chugach Census Area",1,66,98,50,48
050,02,063,"Alaska","Chugach Census Area",1,67,86,44,42
050,02,063,"Alaska","Chugach Census Area",1,68,72,39,33
050,02,063,"Alaska","Chugach Census Area",1,69,61,31,30
050,02,063,"Alaska","Chugach Census Area",1,70,59,35,24
050,02,063,"Alaska","Chugach Census Area",1,71,70,41,29
050,02,063,"Alaska","Chugach Census Area",1,72,58,33,25
050,02,063,"Alaska","Chugach Census Area",1,73,56,27,29
050,02,063,"Alaska","Chugach Census Area",1,74,39,20,19
050,02,063,"Alaska","Chugach Census Area",1,75,32,19,13
050,02,063,"Alaska","Chugach Census Area",1,76,31,13,18
050,02,063,"Alaska","Chugach Census Area",1,77,33,20,13
050,02,063,"Alaska","Chugach Census Area",1,78,24,14,10
050,02,063,"Alaska","Chugach Census Area",1,79,20,6,14
050,02,063,"Alaska","Chugach Census Area",1,80,20,9,11
050,02,063,"Alaska","Chugach Census Area",1,81,11,6,5
050,02,063,"Alaska","Chugach Census Area",1,82,10,5,5
050,02,063,"Alaska","Chugach Census Area",1,83,13,4,9
050,02,063,"Alaska","Chugach Census Area",1,84,11,5,6
050,02,063,"Alaska","Chugach Census Area",1,85,47,12,35
050,02,063,"Alaska","Chugach Census Area",2,0,77,41,36
050,02,063,"Alaska","Chugach Census Area",2,1,85,46,39
050,02,063,"Alaska","Chugach Census Area",2,2,87,46,41
050,02,063,"Alaska","Chugach Census Area",2,3,88,43,45
050,02,063,"Alaska","Chugach Census Area",2,4,89,40,49
050,02,063,"Alaska","Chugach Census Area",2,5,97,47,50
050,02,063,"Alaska","Chugach Census Area",2,6,96,50,46
050,02,063,"Alaska","Chugach Census Area",2,7,92,46,46
050,02,063,"Alaska","Chugach Census Area",2,8,94,52,42
050,02,063,"Alaska","Chugach Census Area",2,9,95,54,41
050,02,063,"Alaska","Chugach Census Area",2,10,90,49,41
050,02,063,"Alaska","Chugach Census Area",2,11,92,49,43
050,02,063,"Alaska","Chugach Census Area",2,12,98,46,52
050,02,063,"Alaska","Chugach Census Area",2,13,89,47,42
050,02,063,"Alaska","Chugach Census Area",2,14,77,44,33
050,02,063,"Alaska","Chugach Census Area",2,15,71,41,30
050,02,063,"Alaska","Chugach Census Area",2,16,70,37,33
050,02,063,"Alaska","Chugach Census Area",2,17,79,37,42
050,02,063,"Alaska","Chugach Census Area",2,18,88,43,45
050,02,063,"Alaska","Chugach Census Area",2,19,78,44,34
050,02,063,"Alaska","Chugach Census Area",2,20,82,48,34
050,02,063,"Alaska","Chugach Census Area",2,21,95,59,36
050,02,063,"Alaska","Chugach Census Area",2,22,90,54,36
050,02,063,"Alaska","Chugach Census Area",2,23,87,52,35
050,02,063,"Alaska","Chugach Census Area",2,24,75,45,30
050,02,063,"Alaska","Chugach Census Area",2,25,84,45,39
050,02,063,"Alaska","Chugach Census Area",2,26,88,40,48
050,02,063,"Alaska","Chugach Census Area",2,27,91,49,42
050,02,063,"Alaska","Chugach Census Area",2,28,93,48,45
050,02,063,"Alaska","Chugach Census Area",2,29,101,54,47
050,02,063,"Alaska","Chugach Census Area",2,30,97,49,48
050,02,063,"Alaska","Chugach Census Area",2,31,90,44,46
050,02,063,"Alaska","Chugach Census Area",2,32,106,57,49
050,02,063,"Alaska","Chugach Census Area",2,33,108,61,47
050,02,063,"Alaska","Chugach Census Area",2,34,106,59,47
050,02,063,"Alaska","Chugach Census Area",2,35,110,60,50
050,02,063,"Alaska","Chugach Census Area",2,36,107,59,48
050,02,063,"Alaska","Chugach Census Area",2,37,99,55,44
050,02,063,"Alaska","Chugach Census Area",2,38,102,57,45
050,02,063,"Alaska","Chugach Census Area",2,39,101,57,44
050,02,063,"Alaska","Chugach Census Area",2,40,98,55,43
050,02,063,"Alaska","Chugach Census Area",2,41,88,46,42
050,02,063,"Alaska","Chugach Census Area",2,42,78,36,42
050,02,063,"Alaska","Chugach Census Area",2,43,79,38,41
050,02,063,"Alaska","Chugach Census Area",2,44,68,38,30
050,02,063,"Alaska","Chugach Census Area",2,45,76,40,36
050,02,063,"Alaska","Chugach Census Area",2,46,72,38,34
050,02,063,"Alaska","Chugach Census Area",2,47,70,35,35
050,02,063,"Alaska","Chugach Census Area",2,48,80,48,32
050,02,063,"Alaska","Chugach Census Area",2,49,98,57,41
050,02,063,"Alaska","Chugach Census Area",2,50,95,56,39
050,02,063,"Alaska","Chugach Census Area",2,51,85,52,33
050,02,063,"Alaska","Chugach Census Area",2,52,85,44,41
050,02,063,"Alaska","Chugach Census Area",2,53,86,50,36
050,02,063,"Alaska","Chugach Census Area",2,54,98,58,40
050,02,063,"Alaska","Chugach Census Area",2,55,99,54,45
050,02,063,"Alaska","Chugach Census Area",2,56,99,56,43
050,02,063,"Alaska","Chugach Census Area",2,57,112,63,49
050,02,063,"Alaska","Chugach Census Area",2,58,129,74,55
050,02,063,"Alaska","Chugach Census Area",2,59,128,69,59
050,02,063,"Alaska","Chugach Census Area",2,60,121,67,54
050,02,063,"Alaska","Chugach Census Area",2,61,131,68,63
050,02,063,"Alaska","Chugach Census Area",2,62,125,66,59
050,02,063,"Alaska","Chugach Census Area",2,63,127,72,55
050,02,063,"Alaska","Chugach Census Area",2,64,122,64,58
050,02,063,"Alaska","Chugach Census Area",2,65,119,64,55
050,02,063,"Alaska","Chugach Census Area",2,66,101,52,49
050,02,063,"Alaska","Chugach Census Area",2,67,89,46,43
050,02,063,"Alaska","Chugach Census Area",2,68,74,39,35
050,02,063,"Alaska","Chugach Census Area",2,69,65,33,32
050,02,063,"Alaska","Chugach Census Area",2,70,60,35,25
050,02,063,"Alaska","Chugach Census Area",2,71,66,38,28
050,02,063,"Alaska","Chugach Census Area",2,72,59,34,25
050,02,063,"Alaska","Chugach Census Area",2,73,60,30,30
050,02,063,"Alaska","Chugach Census Area",2,74,39,20,19
050,02,063,"Alaska","Chugach Census Area",2,75,33,19,14
050,02,063,"Alaska","Chugach Census Area",2,76,30,14,16
050,02,063,"Alaska","Chugach Census Area",2,77,33,18,15
050,02,063,"Alaska","Chugach Census Area",2,78,25,15,10
050,02,063,"Alaska","Chugach Census Area",2,79,21,7,14
050,02,063,"Alaska","Chugach Census Area",2,80,19,9,10
050,02,063,"Alaska","Chugach Census Area",2,81,11,5,6
050,02,063,"Alaska","Chugach Census Area",2,82,10,5,5
050,02,063,"Alaska","Chugach Census Area",2,83,12,4,8
050,02,063,"Alaska","Chugach Census Area",2,84,12,6,6
050,02,063,"Alaska","Chugach Census Area",2,85,49,13,36
050,02,063,"Alaska","Chugach Census Area",3,0,79,46,33
050,02,063,"Alaska","Chugach Census Area",3,1,71,39,32
050,02,063,"Alaska","Chugach Census Area",3,2,80,42,38
050,02,063,"Alaska","Chugach Census Area",3,3,82,46,36
050,02,063,"Alaska","Chugach Census Area",3,4,89,46,43
050,02,063,"Alaska","Chugach Census Area",3,5,87,40,47
050,02,063,"Alaska","Chugach Census Area",3,6,100,50,50
050,02,063,"Alaska","Chugach Census Area",3,7,91,47,44
050,02,063,"Alaska","Chugach Census Area",3,8,100,49,51
050,02,063,"Alaska","Chugach Census Area",3,9,93,50,43
050,02,063,"Alaska","Chugach Census Area",3,10,91,53,38
050,02,063,"Alaska","Chugach Census Area",3,11,92,49,43
050,02,063,"Alaska","Chugach Census Area",3,12,90,45,45
050,02,063,"Alaska","Chugach Census Area",3,13,99,47,52
050,02,063,"Alaska","Chugach Census Area",3,14,84,45,39
050,02,063,"Alaska","Chugach Census Area",3,15,75,43,32
050,02,063,"Alaska","Chugach Census Area",3,16,71,41,30
050,02,063,"Alaska","Chugach Census Area",3,17,66,37,29
050,02,063,"Alaska","Chugach Census Area",3,18,74,36,38
050,02,063,"Alaska","Chugach Census Area",3,19,83,45,38
050,02,063,"Alaska","Chugach Census Area",3,20,86,53,33
050,02,063,"Alaska","Chugach Census Area",3,21,79,46,33
050,02,063,"Alaska","Chugach Census Area",3,22,80,50,30
050,02,063,"Alaska","Chugach Census Area",3,23,83,51,32
050,02,063,"Alaska","Chugach Census Area",3,24,86,49,37
050,02,063,"Alaska","Chugach Census Area",3,25,76,50,26
050,02,063,"Alaska","Chugach Census Area",3,26,76,32,44
050,02,063,"Alaska","Chugach Census Area",3,27,80,36,44
050,02,063,"Alaska","Chugach Census Area",3,28,85,47,38
050,02,063,"Alaska","Chugach Census Area",3,29,94,50,44
050,02,063,"Alaska","Chugach Census Area",3,30,96,53,43
050,02,063,"Alaska","Chugach Census Area",3,31,89,44,45
050,02,063,"Alaska","Chugach Census Area",3,32,90,45,45
050,02,063,"Alaska","Chugach Census Area",3,33,113,61,52
050,02,063,"Alaska","Chugach Census Area",3,34,99,56,43
050,02,063,"Alaska","Chugach Census Area",3,35,110,62,48
050,02,063,"Alaska","Chugach Census Area",3,36,105,61,44
050,02,063,"Alaska","Chugach Census Area",3,37,111,60,51
050,02,063,"Alaska","Chugach Census Area",3,38,89,47,42
050,02,063,"Alaska","Chugach Census Area",3,39,96,56,40
050,02,063,"Alaska","Chugach Census Area",3,40,100,53,47
050,02,063,"Alaska","Chugach Census Area",3,41,95,54,41
050,02,063,"Alaska","Chugach Census Area",3,42,90,47,43
050,02,063,"Alaska","Chugach Census Area",3,43,73,35,38
050,02,063,"Alaska","Chugach Census Area",3,44,80,36,44
050,02,063,"Alaska","Chugach Census Area",3,45,62,36,26
050,02,063,"Alaska","Chugach Census Area",3,46,80,43,37
050,02,063,"Alaska","Chugach Census Area",3,47,67,33,34
050,02,063,"Alaska","Chugach Census Area",3,48,68,38,30
050,02,063,"Alaska","Chugach Census Area",3,49,72,42,30
050,02,063,"Alaska","Chugach Census Area",3,50,97,57,40
050,02,063,"Alaska","Chugach Census Area",3,51,96,57,39
050,02,063,"Alaska","Chugach Census Area",3,52,80,46,34
050,02,063,"Alaska","Chugach Census Area",3,53,83,45,38
050,02,063,"Alaska","Chugach Census Area",3,54,90,54,36
050,02,063,"Alaska","Chugach Census Area",3,55,84,49,35
050,02,063,"Alaska","Chugach Census Area",3,56,100,57,43
050,02,063,"Alaska","Chugach Census Area",3,57,105,58,47
050,02,063,"Alaska","Chugach Census Area",3,58,112,63,49
050,02,063,"Alaska","Chugach Census Area",3,59,126,72,54
050,02,063,"Alaska","Chugach Census Area",3,60,122,66,56
050,02,063,"Alaska","Chugach Census Area",3,61,115,63,52
050,02,063,"Alaska","Chugach Census Area",3,62,131,71,60
050,02,063,"Alaska","Chugach Census Area",3,63,117,59,58
050,02,063,"Alaska","Chugach Census Area",3,64,121,66,55
050,02,063,"Alaska","Chugach Census Area",3,65,116,62,54
050,02,063,"Alaska","Chugach Census Area",3,66,112,60,52
050,02,063,"Alaska","Chugach Census Area",3,67,98,49,49
050,02,063,"Alaska","Chugach Census Area",3,68,92,46,46
050,02,063,"Alaska","Chugach Census Area",3,69,74,39,35
050,02,063,"Alaska","Chugach Census Area",3,70,63,32,31
050,02,063,"Alaska","Chugach Census Area",3,71,59,34,25
050,02,063,"Alaska","Chugach Census Area",3,72,66,37,29
050,02,063,"Alaska","Chugach Census Area",3,73,59,34,25
050,02,063,"Alaska","Chugach Census Area",3,74,59,30,29
050,02,063,"Alaska","Chugach Census Area",3,75,39,19,20
050,02,063,"Alaska","Chugach Census Area",3,76,30,18,12
050,02,063,"Alaska","Chugach Census Area",3,77,32,15,17
050,02,063,"Alaska","Chugach Census Area",3,78,31,16,15
050,02,063,"Alaska","Chugach Census Area",3,79,27,15,12
050,02,063,"Alaska","Chugach Census Area",3,80,18,6,12
050,02,063,"Alaska","Chugach Census Area",3,81,19,9,10
050,02,063,"Alaska","Chugach Census Area",3,82,10,5,5
050,02,063,"Alaska","Chugach Census Area",3,83,11,5,6
050,02,063,"Alaska","Chugach Census Area",3,84,13,4,9
050,02,063,"Alaska","Chugach Census Area",3,85,57,18,39
050,02,063,"Alaska","Chugach Census Area",4,0,74,42,32
050,02,063,"Alaska","Chugach Census Area",4,1,73,43,30
050,02,063,"Alaska","Chugach Census Area",4,2,76,42,34
050,02,063,"Alaska","Chugach Census Area",4,3,81,42,39
050,02,063,"Alaska","Chugach Census Area",4,4,84,45,39
050,02,063,"Alaska","Chugach Census Area",4,5,88,43,45
050,02,063,"Alaska","Chugach Census Area",4,6,89,42,47
050,02,063,"Alaska","Chugach Census Area",4,7,99,55,44
050,02,063,"Alaska","Chugach Census Area",4,8,102,47,55
050,02,063,"Alaska","Chugach Census Area",4,9,104,48,56
050,02,063,"Alaska","Chugach Census Area",4,10,97,52,45
050,02,063,"Alaska","Chugach Census Area",4,11,90,52,38
050,02,063,"Alaska","Chugach Census Area",4,12,91,52,39
050,02,063,"Alaska","Chugach Census Area",4,13,85,43,42
050,02,063,"Alaska","Chugach Census Area",4,14,98,46,52
050,02,063,"Alaska","Chugach Census Area",4,15,85,44,41
050,02,063,"Alaska","Chugach Census Area",4,16,75,43,32
050,02,063,"Alaska","Chugach Census Area",4,17,69,38,31
050,02,063,"Alaska","Chugach Census Area",4,18,62,35,27
050,02,063,"Alaska","Chugach Census Area",4,19,68,35,33
050,02,063,"Alaska","Chugach Census Area",4,20,84,44,40
050,02,063,"Alaska","Chugach Census Area",4,21,89,60,29
050,02,063,"Alaska","Chugach Census Area",4,22,67,35,32
050,02,063,"Alaska","Chugach Census Area",4,23,72,47,25
050,02,063,"Alaska","Chugach Census Area",4,24,82,44,38
050,02,063,"Alaska","Chugach Census Area",4,25,85,53,32
050,02,063,"Alaska","Chugach Census Area",4,26,71,38,33
050,02,063,"Alaska","Chugach Census Area",4,27,76,34,42
050,02,063,"Alaska","Chugach Census Area",4,28,80,37,43
050,02,063,"Alaska","Chugach Census Area",4,29,89,50,39
050,02,063,"Alaska","Chugach Census Area",4,30,93,51,42
050,02,063,"Alaska","Chugach Census Area",4,31,91,47,44
050,02,063,"Alaska","Chugach Census Area",4,32,94,49,45
050,02,063,"Alaska","Chugach Census Area",4,33,96,53,43
050,02,063,"Alaska","Chugach Census Area",4,34,108,55,53
050,02,063,"Alaska","Chugach Census Area",4,35,109,61,48
050,02,063,"Alaska","Chugach Census Area",4,36,109,61,48
050,02,063,"Alaska","Chugach Census Area",4,37,110,61,49
050,02,063,"Alaska","Chugach Census Area",4,38,108,59,49
050,02,063,"Alaska","Chugach Census Area",4,39,91,52,39
050,02,063,"Alaska","Chugach Census Area",4,40,98,53,45
050,02,063,"Alaska","Chugach Census Area",4,41,99,52,47
050,02,063,"Alaska","Chugach Census Area",4,42,95,51,44
050,02,063,"Alaska","Chugach Census Area",4,43,81,42,39
050,02,063,"Alaska","Chugach Census Area",4,44,71,36,35
050,02,063,"Alaska","Chugach Census Area",4,45,78,36,42
050,02,063,"Alaska","Chugach Census Area",4,46,68,41,27
050,02,063,"Alaska","Chugach Census Area",4,47,75,42,33
050,02,063,"Alaska","Chugach Census Area",4,48,65,32,33
050,02,063,"Alaska","Chugach Census Area",4,49,71,41,30
050,02,063,"Alaska","Chugach Census Area",4,50,70,40,30
050,02,063,"Alaska","Chugach Census Area",4,51,95,58,37
050,02,063,"Alaska","Chugach Census Area",4,52,92,53,39
050,02,063,"Alaska","Chugach Census Area",4,53,74,47,27
050,02,063,"Alaska","Chugach Census Area",4,54,81,46,35
050,02,063,"Alaska","Chugach Census Area",4,55,76,42,34
050,02,063,"Alaska","Chugach Census Area",4,56,87,53,34
050,02,063,"Alaska","Chugach Census Area",4,57,102,59,43
050,02,063,"Alaska","Chugach Census Area",4,58,101,58,43
050,02,063,"Alaska","Chugach Census Area",4,59,105,58,47
050,02,063,"Alaska","Chugach Census Area",4,60,122,71,51
050,02,063,"Alaska","Chugach Census Area",4,61,114,62,52
050,02,063,"Alaska","Chugach Census Area",4,62,107,59,48
050,02,063,"Alaska","Chugach Census Area",4,63,117,72,45
050,02,063,"Alaska","Chugach Census Area",4,64,115,57,58
050,02,063,"Alaska","Chugach Census Area",4,65,120,64,56
050,02,063,"Alaska","Chugach Census Area",4,66,113,58,55
050,02,063,"Alaska","Chugach Census Area",4,67,107,55,52
050,02,063,"Alaska","Chugach Census Area",4,68,92,48,44
050,02,063,"Alaska","Chugach Census Area",4,69,89,44,45
050,02,063,"Alaska","Chugach Census Area",4,70,71,38,33
050,02,063,"Alaska","Chugach Census Area",4,71,61,31,30
050,02,063,"Alaska","Chugach Census Area",4,72,59,34,25
050,02,063,"Alaska","Chugach Census Area",4,73,66,36,30
050,02,063,"Alaska","Chugach Census Area",4,74,58,34,24
050,02,063,"Alaska","Chugach Census Area",4,75,54,27,27
050,02,063,"Alaska","Chugach Census Area",4,76,34,15,19
050,02,063,"Alaska","Chugach Census Area",4,77,31,18,13
050,02,063,"Alaska","Chugach Census Area",4,78,27,12,15
050,02,063,"Alaska","Chugach Census Area",4,79,28,13,15
050,02,063,"Alaska","Chugach Census Area",4,80,24,14,10
050,02,063,"Alaska","Chugach Census Area",4,81,16,5,11
050,02,063,"Alaska","Chugach Census Area",4,82,19,9,10
050,02,063,"Alaska","Chugach Census Area",4,83,10,5,5
050,02,063,"Alaska","Chugach Census Area",4,84,9,4,5
050,02,063,"Alaska","Chugach Census Area",4,85,58,20,38
050,02,063,"Alaska","Chugach Census Area",5,0,62,33,29
050,02,063,"Alaska","Chugach Census Area",5,1,74,38,36
050,02,063,"Alaska","Chugach Census Area",5,2,75,44,31
050,02,063,"Alaska","Chugach Census Area",5,3,66,39,27
050,02,063,"Alaska","Chugach Census Area",5,4,74,38,36
050,02,063,"Alaska","Chugach Census Area",5,5,86,44,42
050,02,063,"Alaska","Chugach Census Area",5,6,88,43,45
050,02,063,"Alaska","Chugach Census Area",5,7,97,46,51
050,02,063,"Alaska","Chugach Census Area",5,8,100,49,51
050,02,063,"Alaska","Chugach Census Area",5,9,99,45,54
050,02,063,"Alaska","Chugach Census Area",5,10,99,45,54
050,02,063,"Alaska","Chugach Census Area",5,11,92,52,40
050,02,063,"Alaska","Chugach Census Area",5,12,87,47,40
050,02,063,"Alaska","Chugach Census Area",5,13,81,49,32
050,02,063,"Alaska","Chugach Census Area",5,14,85,41,44
050,02,063,"Alaska","Chugach Census Area",5,15,81,37,44
050,02,063,"Alaska","Chugach Census Area",5,16,83,40,43
050,02,063,"Alaska","Chugach Census Area",5,17,72,42,30
050,02,063,"Alaska","Chugach Census Area",5,18,63,35,28
050,02,063,"Alaska","Chugach Census Area",5,19,57,39,18
050,02,063,"Alaska","Chugach Census Area",5,20,73,39,34
050,02,063,"Alaska","Chugach Census Area",5,21,89,56,33
050,02,063,"Alaska","Chugach Census Area",5,22,87,53,34
050,02,063,"Alaska","Chugach Census Area",5,23,61,33,28
050,02,063,"Alaska","Chugach Census Area",5,24,80,47,33
050,02,063,"Alaska","Chugach Census Area",5,25,91,49,42
050,02,063,"Alaska","Chugach Census Area",5,26,83,47,36
050,02,063,"Alaska","Chugach Census Area",5,27,80,42,38
050,02,063,"Alaska","Chugach Census Area",5,28,71,37,34
050,02,063,"Alaska","Chugach Census Area",5,29,87,42,45
050,02,063,"Alaska","Chugach Census Area",5,30,94,54,40
050,02,063,"Alaska","Chugach Census Area",5,31,84,50,34
050,02,063,"Alaska","Chugach Census Area",5,32,92,46,46
050,02,063,"Alaska","Chugach Census Area",5,33,87,42,45
050,02,063,"Alaska","Chugach Census Area",5,34,99,54,45
050,02,063,"Alaska","Chugach Census Area",5,35,99,50,49
050,02,063,"Alaska","Chugach Census Area",5,36,109,60,49
050,02,063,"Alaska","Chugach Census Area",5,37,113,65,48
050,02,063,"Alaska","Chugach Census Area",5,38,107,58,49
050,02,063,"Alaska","Chugach Census Area",5,39,102,57,45
050,02,063,"Alaska","Chugach Census Area",5,40,91,49,42
050,02,063,"Alaska","Chugach Census Area",5,41,89,49,40
050,02,063,"Alaska","Chugach Census Area",5,42,94,47,47
050,02,063,"Alaska","Chugach Census Area",5,43,93,49,44
050,02,063,"Alaska","Chugach Census Area",5,44,76,40,36
050,02,063,"Alaska","Chugach Census Area",5,45,67,32,35
050,02,063,"Alaska","Chugach Census Area",5,46,86,42,44
050,02,063,"Alaska","Chugach Census Area",5,47,62,37,25
050,02,063,"Alaska","Chugach Census Area",5,48,85,48,37
050,02,063,"Alaska","Chugach Census Area",5,49,60,30,30
050,02,063,"Alaska","Chugach Census Area",5,50,68,39,29
050,02,063,"Alaska","Chugach Census Area",5,51,70,41,29
050,02,063,"Alaska","Chugach Census Area",5,52,91,55,36
050,02,063,"Alaska","Chugach Census Area",5,53,85,50,35
050,02,063,"Alaska","Chugach Census Area",5,54,77,50,27
050,02,063,"Alaska","Chugach Census Area",5,55,73,40,33
050,02,063,"Alaska","Chugach Census Area",5,56,71,39,32
050,02,063,"Alaska","Chugach Census Area",5,57,82,52,30
050,02,063,"Alaska","Chugach Census Area",5,58,96,57,39
050,02,063,"Alaska","Chugach Census Area",5,59,99,56,43
050,02,063,"Alaska","Chugach Census Area",5,60,105,62,43
050,02,063,"Alaska","Chugach Census Area",5,61,100,56,44
050,02,063,"Alaska","Chugach Census Area",5,62,108,52,56
050,02,063,"Alaska","Chugach Census Area",5,63,99,54,45
050,02,063,"Alaska","Chugach Census Area",5,64,112,66,46
050,02,063,"Alaska","Chugach Census Area",5,65,106,54,52
050,02,063,"Alaska","Chugach Census Area",5,66,117,61,56
050,02,063,"Alaska","Chugach Census Area",5,67,104,53,51
050,02,063,"Alaska","Chugach Census Area",5,68,100,51,49
050,02,063,"Alaska","Chugach Census Area",5,69,91,47,44
050,02,063,"Alaska","Chugach Census Area",5,70,87,45,42
050,02,063,"Alaska","Chugach Census Area",5,71,68,36,32
050,02,063,"Alaska","Chugach Census Area",5,72,63,33,30
050,02,063,"Alaska","Chugach Census Area",5,73,60,34,26
050,02,063,"Alaska","Chugach Census Area",5,74,64,38,26
050,02,063,"Alaska","Chugach Census Area",5,75,59,34,25
050,02,063,"Alaska","Chugach Census Area",5,76,51,24,27
050,02,063,"Alaska","Chugach Census Area",5,77,37,16,21
050,02,063,"Alaska","Chugach Census Area",5,78,30,18,12
050,02,063,"Alaska","Chugach Census Area",5,79,26,10,16
050,02,063,"Alaska","Chugach Census Area",5,80,28,13,15
050,02,063,"Alaska","Chugach Census Area",5,81,24,14,10
050,02,063,"Alaska","Chugach Census Area",5,82,16,5,11
050,02,063,"Alaska","Chugach Census Area",5,83,16,6,10
050,02,063,"Alaska","Chugach Census Area",5,84,10,5,5
050,02,063,"Alaska","Chugach Census Area",5,85,64,25,39
050,02,066,"Alaska","Copper River Census Area",1,0,30,15,15
050,02,066,"Alaska","Copper River Census Area",1,1,28,13,15
050,02,066,"Alaska","Copper River Census Area",1,2,37,19,18
050,02,066,"Alaska","Copper River Census Area",1,3,34,14,20
050,02,066,"Alaska","Copper River Census Area",1,4,31,13,18
050,02,066,"Alaska","Copper River Census Area",1,5,39,21,18
050,02,066,"Alaska","Copper River Census Area",1,6,43,22,21
050,02,066,"Alaska","Copper River Census Area",1,7,38,18,20
050,02,066,"Alaska","Copper River Census Area",1,8,37,16,21
050,02,066,"Alaska","Copper River Census Area",1,9,38,24,14
050,02,066,"Alaska","Copper River Census Area",1,10,38,21,17
050,02,066,"Alaska","Copper River Census Area",1,11,39,20,19
050,02,066,"Alaska","Copper River Census Area",1,12,44,22,22
050,02,066,"Alaska","Copper River Census Area",1,13,45,21,24
050,02,066,"Alaska","Copper River Census Area",1,14,37,21,16
050,02,066,"Alaska","Copper River Census Area",1,15,34,19,15
050,02,066,"Alaska","Copper River Census Area",1,16,35,21,14
050,02,066,"Alaska","Copper River Census Area",1,17,38,16,22
050,02,066,"Alaska","Copper River Census Area",1,18,32,16,16
050,02,066,"Alaska","Copper River Census Area",1,19,26,13,13
050,02,066,"Alaska","Copper River Census Area",1,20,20,11,9
050,02,066,"Alaska","Copper River Census Area",1,21,26,17,9
050,02,066,"Alaska","Copper River Census Area",1,22,24,14,10
050,02,066,"Alaska","Copper River Census Area",1,23,21,13,8
050,02,066,"Alaska","Copper River Census Area",1,24,21,12,9
050,02,066,"Alaska","Copper River Census Area",1,25,27,10,17
050,02,066,"Alaska","Copper River Census Area",1,26,26,13,13
050,02,066,"Alaska","Copper River Census Area",1,27,24,16,8
050,02,066,"Alaska","Copper River Census Area",1,28,33,17,16
050,02,066,"Alaska","Copper River Census Area",1,29,28,13,15
050,02,066,"Alaska","Copper River Census Area",1,30,27,14,13
050,02,066,"Alaska","Copper River Census Area",1,31,31,15,16
050,02,066,"Alaska","Copper River Census Area",1,32,36,17,19
050,02,066,"Alaska","Copper River Census Area",1,33,33,18,15
050,02,066,"Alaska","Copper River Census Area",1,34,37,21,16
050,02,066,"Alaska","Copper River Census Area",1,35,35,19,16
050,02,066,"Alaska","Copper River Census Area",1,36,36,19,17
050,02,066,"Alaska","Copper River Census Area",1,37,32,19,13
050,02,066,"Alaska","Copper River Census Area",1,38,32,18,14
050,02,066,"Alaska","Copper River Census Area",1,39,39,21,18
050,02,066,"Alaska","Copper River Census Area",1,40,32,20,12
050,02,066,"Alaska","Copper River Census Area",1,41,28,14,14
050,02,066,"Alaska","Copper River Census Area",1,42,29,13,16
050,02,066,"Alaska","Copper River Census Area",1,43,29,14,15
050,02,066,"Alaska","Copper River Census Area",1,44,25,14,11
050,02,066,"Alaska","Copper River Census Area",1,45,25,12,13
050,02,066,"Alaska","Copper River Census Area",1,46,20,11,9
050,02,066,"Alaska","Copper River Census Area",1,47,18,10,8
050,02,066,"Alaska","Copper River Census Area",1,48,31,19,12
050,02,066,"Alaska","Copper River Census Area",1,49,37,24,13
050,02,066,"Alaska","Copper River Census Area",1,50,33,18,15
050,02,066,"Alaska","Copper River Census Area",1,51,27,16,11
050,02,066,"Alaska","Copper River Census Area",1,52,29,15,14
050,02,066,"Alaska","Copper River Census Area",1,53,29,17,12
050,02,066,"Alaska","Copper River Census Area",1,54,29,17,12
050,02,066,"Alaska","Copper River Census Area",1,55,35,20,15
050,02,066,"Alaska","Copper River Census Area",1,56,30,18,12
050,02,066,"Alaska","Copper River Census Area",1,57,32,17,15
050,02,066,"Alaska","Copper River Census Area",1,58,39,21,18
050,02,066,"Alaska","Copper River Census Area",1,59,44,23,21
050,02,066,"Alaska","Copper River Census Area",1,60,40,22,18
050,02,066,"Alaska","Copper River Census Area",1,61,48,28,20
050,02,066,"Alaska","Copper River Census Area",1,62,48,29,19
050,02,066,"Alaska","Copper River Census Area",1,63,38,21,17
050,02,066,"Alaska","Copper River Census Area",1,64,40,22,18
050,02,066,"Alaska","Copper River Census Area",1,65,40,23,17
050,02,066,"Alaska","Copper River Census Area",1,66,36,17,19
050,02,066,"Alaska","Copper River Census Area",1,67,36,20,16
050,02,066,"Alaska","Copper River Census Area",1,68,33,19,14
050,02,066,"Alaska","Copper River Census Area",1,69,33,19,14
050,02,066,"Alaska","Copper River Census Area",1,70,35,21,14
050,02,066,"Alaska","Copper River Census Area",1,71,34,21,13
050,02,066,"Alaska","Copper River Census Area",1,72,31,20,11
050,02,066,"Alaska","Copper River Census Area",1,73,33,21,12
050,02,066,"Alaska","Copper River Census Area",1,74,21,11,10
050,02,066,"Alaska","Copper River Census Area",1,75,17,10,7
050,02,066,"Alaska","Copper River Census Area",1,76,18,11,7
050,02,066,"Alaska","Copper River Census Area",1,77,17,10,7
050,02,066,"Alaska","Copper River Census Area",1,78,14,9,5
050,02,066,"Alaska","Copper River Census Area",1,79,16,7,9
050,02,066,"Alaska","Copper River Census Area",1,80,12,5,7
050,02,066,"Alaska","Copper River Census Area",1,81,8,3,5
050,02,066,"Alaska","Copper River Census Area",1,82,7,3,4
050,02,066,"Alaska","Copper River Census Area",1,83,9,5,4
050,02,066,"Alaska","Copper River Census Area",1,84,9,5,4
050,02,066,"Alaska","Copper River Census Area",1,85,31,13,18
050,02,066,"Alaska","Copper River Census Area",2,0,29,15,14
050,02,066,"Alaska","Copper River Census Area",2,1,29,14,15
050,02,066,"Alaska","Copper River Census Area",2,2,35,18,17
050,02,066,"Alaska","Copper River Census Area",2,3,35,15,20
050,02,066,"Alaska","Copper River Census Area",2,4,31,13,18
050,02,066,"Alaska","Copper River Census Area",2,5,38,20,18
050,02,066,"Alaska","Copper River Census Area",2,6,43,22,21
050,02,066,"Alaska","Copper River Census Area",2,7,38,18,20
050,02,066,"Alaska","Copper River Census Area",2,8,37,17,20
050,02,066,"Alaska","Copper River Census Area",2,9,37,22,15
050,02,066,"Alaska","Copper River Census Area",2,10,37,21,16
050,02,066,"Alaska","Copper River Census Area",2,11,39,21,18
050,02,066,"Alaska","Copper River Census Area",2,12,44,22,22
050,02,066,"Alaska","Copper River Census Area",2,13,43,20,23
050,02,066,"Alaska","Copper River Census Area",2,14,37,20,17
050,02,066,"Alaska","Copper River Census Area",2,15,36,21,15
050,02,066,"Alaska","Copper River Census Area",2,16,34,20,14
050,02,066,"Alaska","Copper River Census Area",2,17,37,17,20
050,02,066,"Alaska","Copper River Census Area",2,18,30,14,16
050,02,066,"Alaska","Copper River Census Area",2,19,25,13,12
050,02,066,"Alaska","Copper River Census Area",2,20,21,12,9
050,02,066,"Alaska","Copper River Census Area",2,21,25,16,9
050,02,066,"Alaska","Copper River Census Area",2,22,26,16,10
050,02,066,"Alaska","Copper River Census Area",2,23,22,13,9
050,02,066,"Alaska","Copper River Census Area",2,24,22,12,10
050,02,066,"Alaska","Copper River Census Area",2,25,26,11,15
050,02,066,"Alaska","Copper River Census Area",2,26,26,13,13
050,02,066,"Alaska","Copper River Census Area",2,27,25,15,10
050,02,066,"Alaska","Copper River Census Area",2,28,31,17,14
050,02,066,"Alaska","Copper River Census Area",2,29,29,14,15
050,02,066,"Alaska","Copper River Census Area",2,30,28,15,13
050,02,066,"Alaska","Copper River Census Area",2,31,31,15,16
050,02,066,"Alaska","Copper River Census Area",2,32,35,17,18
050,02,066,"Alaska","Copper River Census Area",2,33,35,19,16
050,02,066,"Alaska","Copper River Census Area",2,34,36,20,16
050,02,066,"Alaska","Copper River Census Area",2,35,35,18,17
050,02,066,"Alaska","Copper River Census Area",2,36,35,19,16
050,02,066,"Alaska","Copper River Census Area",2,37,33,19,14
050,02,066,"Alaska","Copper River Census Area",2,38,33,19,14
050,02,066,"Alaska","Copper River Census Area",2,39,37,21,16
050,02,066,"Alaska","Copper River Census Area",2,40,35,22,13
050,02,066,"Alaska","Copper River Census Area",2,41,29,15,14
050,02,066,"Alaska","Copper River Census Area",2,42,29,14,15
050,02,066,"Alaska","Copper River Census Area",2,43,29,13,16
050,02,066,"Alaska","Copper River Census Area",2,44,25,14,11
050,02,066,"Alaska","Copper River Census Area",2,45,26,13,13
050,02,066,"Alaska","Copper River Census Area",2,46,21,12,9
050,02,066,"Alaska","Copper River Census Area",2,47,18,10,8
050,02,066,"Alaska","Copper River Census Area",2,48,28,17,11
050,02,066,"Alaska","Copper River Census Area",2,49,36,24,12
050,02,066,"Alaska","Copper River Census Area",2,50,34,19,15
050,02,066,"Alaska","Copper River Census Area",2,51,30,18,12
050,02,066,"Alaska","Copper River Census Area",2,52,29,15,14
050,02,066,"Alaska","Copper River Census Area",2,53,28,16,12
050,02,066,"Alaska","Copper River Census Area",2,54,28,17,11
050,02,066,"Alaska","Copper River Census Area",2,55,34,19,15
050,02,066,"Alaska","Copper River Census Area",2,56,31,19,12
050,02,066,"Alaska","Copper River Census Area",2,57,31,16,15
050,02,066,"Alaska","Copper River Census Area",2,58,37,20,17
050,02,066,"Alaska","Copper River Census Area",2,59,42,21,21
050,02,066,"Alaska","Copper River Census Area",2,60,41,22,19
050,02,066,"Alaska","Copper River Census Area",2,61,45,26,19
050,02,066,"Alaska","Copper River Census Area",2,62,48,29,19
050,02,066,"Alaska","Copper River Census Area",2,63,40,23,17
050,02,066,"Alaska","Copper River Census Area",2,64,39,21,18
050,02,066,"Alaska","Copper River Census Area",2,65,41,23,18
050,02,066,"Alaska","Copper River Census Area",2,66,36,18,18
050,02,066,"Alaska","Copper River Census Area",2,67,36,20,16
050,02,066,"Alaska","Copper River Census Area",2,68,34,19,15
050,02,066,"Alaska","Copper River Census Area",2,69,35,20,15
050,02,066,"Alaska","Copper River Census Area",2,70,34,20,14
050,02,066,"Alaska","Copper River Census Area",2,71,34,21,13
050,02,066,"Alaska","Copper River Census Area",2,72,31,19,12
050,02,066,"Alaska","Copper River Census Area",2,73,33,21,12
050,02,066,"Alaska","Copper River Census Area",2,74,22,12,10
050,02,066,"Alaska","Copper River Census Area",2,75,18,10,8
050,02,066,"Alaska","Copper River Census Area",2,76,17,10,7
050,02,066,"Alaska","Copper River Census Area",2,77,18,11,7
050,02,066,"Alaska","Copper River Census Area",2,78,14,9,5
050,02,066,"Alaska","Copper River Census Area",2,79,16,8,8
050,02,066,"Alaska","Copper River Census Area",2,80,12,6,6
050,02,066,"Alaska","Copper River Census Area",2,81,7,2,5
050,02,066,"Alaska","Copper River Census Area",2,82,7,3,4
050,02,066,"Alaska","Copper River Census Area",2,83,9,5,4
050,02,066,"Alaska","Copper River Census Area",2,84,9,5,4
050,02,066,"Alaska","Copper River Census Area",2,85,33,13,20
050,02,066,"Alaska","Copper River Census Area",3,0,25,12,13
050,02,066,"Alaska","Copper River Census Area",3,1,31,18,13
050,02,066,"Alaska","Copper River Census Area",3,2,24,9,15
050,02,066,"Alaska","Copper River Census Area",3,3,35,19,16
050,02,066,"Alaska","Copper River Census Area",3,4,33,14,19
050,02,066,"Alaska","Copper River Census Area",3,5,34,17,17
050,02,066,"Alaska","Copper River Census Area",3,6,41,24,17
050,02,066,"Alaska","Copper River Census Area",3,7,43,23,20
050,02,066,"Alaska","Copper River Census Area",3,8,40,18,22
050,02,066,"Alaska","Copper River Census Area",3,9,32,12,20
050,02,066,"Alaska","Copper River Census Area",3,10,42,26,16
050,02,066,"Alaska","Copper River Census Area",3,11,42,26,16
050,02,066,"Alaska","Copper River Census Area",3,12,37,22,15
050,02,066,"Alaska","Copper River Census Area",3,13,41,20,21
050,02,066,"Alaska","Copper River Census Area",3,14,44,21,23
050,02,066,"Alaska","Copper River Census Area",3,15,40,21,19
050,02,066,"Alaska","Copper River Census Area",3,16,34,20,14
050,02,066,"Alaska","Copper River Census Area",3,17,35,22,13
050,02,066,"Alaska","Copper River Census Area",3,18,27,10,17
050,02,066,"Alaska","Copper River Census Area",3,19,23,9,14
050,02,066,"Alaska","Copper River Census Area",3,20,20,11,9
050,02,066,"Alaska","Copper River Census Area",3,21,23,13,10
050,02,066,"Alaska","Copper River Census Area",3,22,28,17,11
050,02,066,"Alaska","Copper River Census Area",3,23,25,16,9
050,02,066,"Alaska","Copper River Census Area",3,24,21,9,12
050,02,066,"Alaska","Copper River Census Area",3,25,25,13,12
050,02,066,"Alaska","Copper River Census Area",3,26,23,10,13
050,02,066,"Alaska","Copper River Census Area",3,27,27,15,12
050,02,066,"Alaska","Copper River Census Area",3,28,21,13,8
050,02,066,"Alaska","Copper River Census Area",3,29,30,17,13
050,02,066,"Alaska","Copper River Census Area",3,30,30,13,17
050,02,066,"Alaska","Copper River Census Area",3,31,28,13,15
050,02,066,"Alaska","Copper River Census Area",3,32,31,15,16
050,02,066,"Alaska","Copper River Census Area",3,33,23,11,12
050,02,066,"Alaska","Copper River Census Area",3,34,35,18,17
050,02,066,"Alaska","Copper River Census Area",3,35,35,19,16
050,02,066,"Alaska","Copper River Census Area",3,36,33,19,14
050,02,066,"Alaska","Copper River Census Area",3,37,35,21,14
050,02,066,"Alaska","Copper River Census Area",3,38,36,23,13
050,02,066,"Alaska","Copper River Census Area",3,39,36,18,18
050,02,066,"Alaska","Copper River Census Area",3,40,39,24,15
050,02,066,"Alaska","Copper River Census Area",3,41,36,22,14
050,02,066,"Alaska","Copper River Census Area",3,42,32,16,16
050,02,066,"Alaska","Copper River Census Area",3,43,31,16,15
050,02,066,"Alaska","Copper River Census Area",3,44,35,17,18
050,02,066,"Alaska","Copper River Census Area",3,45,22,11,11
050,02,066,"Alaska","Copper River Census Area",3,46,27,15,12
050,02,066,"Alaska","Copper River Census Area",3,47,22,14,8
050,02,066,"Alaska","Copper River Census Area",3,48,24,15,9
050,02,066,"Alaska","Copper River Census Area",3,49,31,20,11
050,02,066,"Alaska","Copper River Census Area",3,50,40,27,13
050,02,066,"Alaska","Copper River Census Area",3,51,32,18,14
050,02,066,"Alaska","Copper River Census Area",3,52,27,16,11
050,02,066,"Alaska","Copper River Census Area",3,53,28,15,13
050,02,066,"Alaska","Copper River Census Area",3,54,30,17,13
050,02,066,"Alaska","Copper River Census Area",3,55,26,17,9
050,02,066,"Alaska","Copper River Census Area",3,56,34,19,15
050,02,066,"Alaska","Copper River Census Area",3,57,36,19,17
050,02,066,"Alaska","Copper River Census Area",3,58,33,19,14
050,02,066,"Alaska","Copper River Census Area",3,59,36,19,17
050,02,066,"Alaska","Copper River Census Area",3,60,42,21,21
050,02,066,"Alaska","Copper River Census Area",3,61,42,22,20
050,02,066,"Alaska","Copper River Census Area",3,62,43,25,18
050,02,066,"Alaska","Copper River Census Area",3,63,47,30,17
050,02,066,"Alaska","Copper River Census Area",3,64,39,23,16
050,02,066,"Alaska","Copper River Census Area",3,65,39,21,18
050,02,066,"Alaska","Copper River Census Area",3,66,44,24,20
050,02,066,"Alaska","Copper River Census Area",3,67,34,17,17
050,02,066,"Alaska","Copper River Census Area",3,68,38,22,16
050,02,066,"Alaska","Copper River Census Area",3,69,32,17,15
050,02,066,"Alaska","Copper River Census Area",3,70,33,18,15
050,02,066,"Alaska","Copper River Census Area",3,71,33,19,14
050,02,066,"Alaska","Copper River Census Area",3,72,35,22,13
050,02,066,"Alaska","Copper River Census Area",3,73,32,19,13
050,02,066,"Alaska","Copper River Census Area",3,74,31,20,11
050,02,066,"Alaska","Copper River Census Area",3,75,21,11,10
050,02,066,"Alaska","Copper River Census Area",3,76,16,8,8
050,02,066,"Alaska","Copper River Census Area",3,77,15,9,6
050,02,066,"Alaska","Copper River Census Area",3,78,15,9,6
050,02,066,"Alaska","Copper River Census Area",3,79,12,7,5
050,02,066,"Alaska","Copper River Census Area",3,80,15,7,8
050,02,066,"Alaska","Copper River Census Area",3,81,11,6,5
050,02,066,"Alaska","Copper River Census Area",3,82,8,2,6
050,02,066,"Alaska","Copper River Census Area",3,83,7,3,4
050,02,066,"Alaska","Copper River Census Area",3,84,9,5,4
050,02,066,"Alaska","Copper River Census Area",3,85,39,18,21
050,02,066,"Alaska","Copper River Census Area",4,0,25,16,9
050,02,066,"Alaska","Copper River Census Area",4,1,32,12,20
050,02,066,"Alaska","Copper River Census Area",4,2,33,18,15
050,02,066,"Alaska","Copper River Census Area",4,3,26,11,15
050,02,066,"Alaska","Copper River Census Area",4,4,37,18,19
050,02,066,"Alaska","Copper River Census Area",4,5,33,13,20
050,02,066,"Alaska","Copper River Census Area",4,6,32,15,17
050,02,066,"Alaska","Copper River Census Area",4,7,43,24,19
050,02,066,"Alaska","Copper River Census Area",4,8,40,22,18
050,02,066,"Alaska","Copper River Census Area",4,9,40,17,23
050,02,066,"Alaska","Copper River Census Area",4,10,32,14,18
050,02,066,"Alaska","Copper River Census Area",4,11,39,25,14
050,02,066,"Alaska","Copper River Census Area",4,12,40,23,17
050,02,066,"Alaska","Copper River Census Area",4,13,36,22,14
050,02,066,"Alaska","Copper River Census Area",4,14,40,21,19
050,02,066,"Alaska","Copper River Census Area",4,15,42,19,23
050,02,066,"Alaska","Copper River Census Area",4,16,38,20,18
050,02,066,"Alaska","Copper River Census Area",4,17,36,22,14
050,02,066,"Alaska","Copper River Census Area",4,18,30,20,10
050,02,066,"Alaska","Copper River Census Area",4,19,20,6,14
050,02,066,"Alaska","Copper River Census Area",4,20,21,7,14
050,02,066,"Alaska","Copper River Census Area",4,21,18,9,9
050,02,066,"Alaska","Copper River Census Area",4,22,26,15,11
050,02,066,"Alaska","Copper River Census Area",4,23,27,17,10
050,02,066,"Alaska","Copper River Census Area",4,24,18,12,6
050,02,066,"Alaska","Copper River Census Area",4,25,17,6,11
050,02,066,"Alaska","Copper River Census Area",4,26,24,13,11
050,02,066,"Alaska","Copper River Census Area",4,27,31,14,17
050,02,066,"Alaska","Copper River Census Area",4,28,27,14,13
050,02,066,"Alaska","Copper River Census Area",4,29,21,12,9
050,02,066,"Alaska","Copper River Census Area",4,30,33,21,12
050,02,066,"Alaska","Copper River Census Area",4,31,29,9,20
050,02,066,"Alaska","Copper River Census Area",4,32,29,13,16
050,02,066,"Alaska","Copper River Census Area",4,33,31,14,17
050,02,066,"Alaska","Copper River Census Area",4,34,26,15,11
050,02,066,"Alaska","Copper River Census Area",4,35,36,20,16
050,02,066,"Alaska","Copper River Census Area",4,36,33,20,13
050,02,066,"Alaska","Copper River Census Area",4,37,36,21,15
050,02,066,"Alaska","Copper River Census Area",4,38,36,21,15
050,02,066,"Alaska","Copper River Census Area",4,39,33,19,14
050,02,066,"Alaska","Copper River Census Area",4,40,37,21,16
050,02,066,"Alaska","Copper River Census Area",4,41,39,25,14
050,02,066,"Alaska","Copper River Census Area",4,42,39,22,17
050,02,066,"Alaska","Copper River Census Area",4,43,34,13,21
050,02,066,"Alaska","Copper River Census Area",4,44,37,21,16
050,02,066,"Alaska","Copper River Census Area",4,45,32,16,16
050,02,066,"Alaska","Copper River Census Area",4,46,25,12,13
050,02,066,"Alaska","Copper River Census Area",4,47,27,15,12
050,02,066,"Alaska","Copper River Census Area",4,48,21,13,8
050,02,066,"Alaska","Copper River Census Area",4,49,23,15,8
050,02,066,"Alaska","Copper River Census Area",4,50,34,21,13
050,02,066,"Alaska","Copper River Census Area",4,51,40,30,10
050,02,066,"Alaska","Copper River Census Area",4,52,33,19,14
050,02,066,"Alaska","Copper River Census Area",4,53,27,16,11
050,02,066,"Alaska","Copper River Census Area",4,54,31,17,14
050,02,066,"Alaska","Copper River Census Area",4,55,31,17,14
050,02,066,"Alaska","Copper River Census Area",4,56,24,16,8
050,02,066,"Alaska","Copper River Census Area",4,57,33,19,14
050,02,066,"Alaska","Copper River Census Area",4,58,33,17,16
050,02,066,"Alaska","Copper River Census Area",4,59,32,19,13
050,02,066,"Alaska","Copper River Census Area",4,60,37,19,18
050,02,066,"Alaska","Copper River Census Area",4,61,39,18,21
050,02,066,"Alaska","Copper River Census Area",4,62,38,19,19
050,02,066,"Alaska","Copper River Census Area",4,63,46,26,20
050,02,066,"Alaska","Copper River Census Area",4,64,46,28,18
050,02,066,"Alaska","Copper River Census Area",4,65,35,19,16
050,02,066,"Alaska","Copper River Census Area",4,66,37,20,17
050,02,066,"Alaska","Copper River Census Area",4,67,45,25,20
050,02,066,"Alaska","Copper River Census Area",4,68,37,20,17
050,02,066,"Alaska","Copper River Census Area",4,69,35,20,15
050,02,066,"Alaska","Copper River Census Area",4,70,31,17,14
050,02,066,"Alaska","Copper River Census Area",4,71,31,18,13
050,02,066,"Alaska","Copper River Census Area",4,72,32,18,14
050,02,066,"Alaska","Copper River Census Area",4,73,36,22,14
050,02,066,"Alaska","Copper River Census Area",4,74,31,19,12
050,02,066,"Alaska","Copper River Census Area",4,75,28,17,11
050,02,066,"Alaska","Copper River Census Area",4,76,17,8,9
050,02,066,"Alaska","Copper River Census Area",4,77,16,8,8
050,02,066,"Alaska","Copper River Census Area",4,78,13,7,6
050,02,066,"Alaska","Copper River Census Area",4,79,12,8,4
050,02,066,"Alaska","Copper River Census Area",4,80,10,5,5
050,02,066,"Alaska","Copper River Census Area",4,81,14,6,8
050,02,066,"Alaska","Copper River Census Area",4,82,9,5,4
050,02,066,"Alaska","Copper River Census Area",4,83,7,1,6
050,02,066,"Alaska","Copper River Census Area",4,84,6,2,4
050,02,066,"Alaska","Copper River Census Area",4,85,43,21,22
050,02,066,"Alaska","Copper River Census Area",5,0,32,18,14
050,02,066,"Alaska","Copper River Census Area",5,1,31,20,11
050,02,066,"Alaska","Copper River Census Area",5,2,43,22,21
050,02,066,"Alaska","Copper River Census Area",5,3,30,16,14
050,02,066,"Alaska","Copper River Census Area",5,4,29,8,21
050,02,066,"Alaska","Copper River Census Area",5,5,39,20,19
050,02,066,"Alaska","Copper River Census Area",5,6,39,16,23
050,02,066,"Alaska","Copper River Census Area",5,7,34,13,21
050,02,066,"Alaska","Copper River Census Area",5,8,48,24,24
050,02,066,"Alaska","Copper River Census Area",5,9,40,21,19
050,02,066,"Alaska","Copper River Census Area",5,10,39,17,22
050,02,066,"Alaska","Copper River Census Area",5,11,32,15,17
050,02,066,"Alaska","Copper River Census Area",5,12,38,26,12
050,02,066,"Alaska","Copper River Census Area",5,13,46,29,17
050,02,066,"Alaska","Copper River Census Area",5,14,36,21,15
050,02,066,"Alaska","Copper River Census Area",5,15,39,21,18
050,02,066,"Alaska","Copper River Census Area",5,16,44,19,25
050,02,066,"Alaska","Copper River Census Area",5,17,41,20,21
050,02,066,"Alaska","Copper River Census Area",5,18,31,18,13
050,02,066,"Alaska","Copper River Census Area",5,19,25,15,10
050,02,066,"Alaska","Copper River Census Area",5,20,20,7,13
050,02,066,"Alaska","Copper River Census Area",5,21,21,6,15
050,02,066,"Alaska","Copper River Census Area",5,22,18,7,11
050,02,066,"Alaska","Copper River Census Area",5,23,26,18,8
050,02,066,"Alaska","Copper River Census Area",5,24,27,19,8
050,02,066,"Alaska","Copper River Census Area",5,25,23,16,7
050,02,066,"Alaska","Copper River Census Area",5,26,23,10,13
050,02,066,"Alaska","Copper River Census Area",5,27,31,15,16
050,02,066,"Alaska","Copper River Census Area",5,28,31,14,17
050,02,066,"Alaska","Copper River Census Area",5,29,24,12,12
050,02,066,"Alaska","Copper River Census Area",5,30,28,18,10
050,02,066,"Alaska","Copper River Census Area",5,31,34,21,13
050,02,066,"Alaska","Copper River Census Area",5,32,24,8,16
050,02,066,"Alaska","Copper River Census Area",5,33,27,10,17
050,02,066,"Alaska","Copper River Census Area",5,34,32,16,16
050,02,066,"Alaska","Copper River Census Area",5,35,24,16,8
050,02,066,"Alaska","Copper River Census Area",5,36,29,16,13
050,02,066,"Alaska","Copper River Census Area",5,37,34,19,15
050,02,066,"Alaska","Copper River Census Area",5,38,37,22,15
050,02,066,"Alaska","Copper River Census Area",5,39,38,20,18
050,02,066,"Alaska","Copper River Census Area",5,40,35,20,15
050,02,066,"Alaska","Copper River Census Area",5,41,42,21,21
050,02,066,"Alaska","Copper River Census Area",5,42,41,24,17
050,02,066,"Alaska","Copper River Census Area",5,43,40,25,15
050,02,066,"Alaska","Copper River Census Area",5,44,33,13,20
050,02,066,"Alaska","Copper River Census Area",5,45,35,22,13
050,02,066,"Alaska","Copper River Census Area",5,46,30,16,14
050,02,066,"Alaska","Copper River Census Area",5,47,30,16,14
050,02,066,"Alaska","Copper River Census Area",5,48,25,14,11
050,02,066,"Alaska","Copper River Census Area",5,49,23,13,10
050,02,066,"Alaska","Copper River Census Area",5,50,23,14,9
050,02,066,"Alaska","Copper River Census Area",5,51,30,19,11
050,02,066,"Alaska","Copper River Census Area",5,52,42,32,10
050,02,066,"Alaska","Copper River Census Area",5,53,37,20,17
050,02,066,"Alaska","Copper River Census Area",5,54,30,19,11
050,02,066,"Alaska","Copper River Census Area",5,55,31,17,14
050,02,066,"Alaska","Copper River Census Area",5,56,30,16,14
050,02,066,"Alaska","Copper River Census Area",5,57,25,16,9
050,02,066,"Alaska","Copper River Census Area",5,58,31,18,13
050,02,066,"Alaska","Copper River Census Area",5,59,33,16,17
050,02,066,"Alaska","Copper River Census Area",5,60,34,18,16
050,02,066,"Alaska","Copper River Census Area",5,61,37,16,21
050,02,066,"Alaska","Copper River Census Area",5,62,37,15,22
050,02,066,"Alaska","Copper River Census Area",5,63,42,21,21
050,02,066,"Alaska","Copper River Census Area",5,64,44,25,19
050,02,066,"Alaska","Copper River Census Area",5,65,44,29,15
050,02,066,"Alaska","Copper River Census Area",5,66,35,19,16
050,02,066,"Alaska","Copper River Census Area",5,67,36,19,17
050,02,066,"Alaska","Copper River Census Area",5,68,43,24,19
050,02,066,"Alaska","Copper River Census Area",5,69,35,19,16
050,02,066,"Alaska","Copper River Census Area",5,70,28,17,11
050,02,066,"Alaska","Copper River Census Area",5,71,31,17,14
050,02,066,"Alaska","Copper River Census Area",5,72,33,19,14
050,02,066,"Alaska","Copper River Census Area",5,73,32,18,14
050,02,066,"Alaska","Copper River Census Area",5,74,37,22,15
050,02,066,"Alaska","Copper River Census Area",5,75,27,17,10
050,02,066,"Alaska","Copper River Census Area",5,76,26,17,9
050,02,066,"Alaska","Copper River Census Area",5,77,14,8,6
050,02,066,"Alaska","Copper River Census Area",5,78,17,9,8
050,02,066,"Alaska","Copper River Census Area",5,79,10,5,5
050,02,066,"Alaska","Copper River Census Area",5,80,11,8,3
050,02,066,"Alaska","Copper River Census Area",5,81,10,5,5
050,02,066,"Alaska","Copper River Census Area",5,82,14,6,8
050,02,066,"Alaska","Copper River Census Area",5,83,9,5,4
050,02,066,"Alaska","Copper River Census Area",5,84,7,1,6
050,02,066,"Alaska","Copper River Census Area",5,85,48,22,26
050,02,068,"Alaska","Denali Borough",1,0,12,6,6
050,02,068,"Alaska","Denali Borough",1,1,13,6,7
050,02,068,"Alaska","Denali Borough",1,2,10,6,4
050,02,068,"Alaska","Denali Borough",1,3,22,12,10
050,02,068,"Alaska","Denali Borough",1,4,14,7,7
050,02,068,"Alaska","Denali Borough",1,5,14,8,6
050,02,068,"Alaska","Denali Borough",1,6,20,10,10
050,02,068,"Alaska","Denali Borough",1,7,21,9,12
050,02,068,"Alaska","Denali Borough",1,8,20,8,12
050,02,068,"Alaska","Denali Borough",1,9,15,8,7
050,02,068,"Alaska","Denali Borough",1,10,16,11,5
050,02,068,"Alaska","Denali Borough",1,11,18,10,8
050,02,068,"Alaska","Denali Borough",1,12,21,11,10
050,02,068,"Alaska","Denali Borough",1,13,17,12,5
050,02,068,"Alaska","Denali Borough",1,14,17,9,8
050,02,068,"Alaska","Denali Borough",1,15,10,7,3
050,02,068,"Alaska","Denali Borough",1,16,15,9,6
050,02,068,"Alaska","Denali Borough",1,17,19,10,9
050,02,068,"Alaska","Denali Borough",1,18,14,5,9
050,02,068,"Alaska","Denali Borough",1,19,13,6,7
050,02,068,"Alaska","Denali Borough",1,20,10,3,7
050,02,068,"Alaska","Denali Borough",1,21,14,7,7
050,02,068,"Alaska","Denali Borough",1,22,22,15,7
050,02,068,"Alaska","Denali Borough",1,23,21,16,5
050,02,068,"Alaska","Denali Borough",1,24,15,11,4
050,02,068,"Alaska","Denali Borough",1,25,21,15,6
050,02,068,"Alaska","Denali Borough",1,26,26,18,8
050,02,068,"Alaska","Denali Borough",1,27,26,18,8
050,02,068,"Alaska","Denali Borough",1,28,21,9,12
050,02,068,"Alaska","Denali Borough",1,29,29,14,15
050,02,068,"Alaska","Denali Borough",1,30,30,15,15
050,02,068,"Alaska","Denali Borough",1,31,31,14,17
050,02,068,"Alaska","Denali Borough",1,32,28,13,15
050,02,068,"Alaska","Denali Borough",1,33,26,14,12
050,02,068,"Alaska","Denali Borough",1,34,22,11,11
050,02,068,"Alaska","Denali Borough",1,35,26,15,11
050,02,068,"Alaska","Denali Borough",1,36,29,18,11
050,02,068,"Alaska","Denali Borough",1,37,35,19,16
050,02,068,"Alaska","Denali Borough",1,38,26,12,14
050,02,068,"Alaska","Denali Borough",1,39,24,13,11
050,02,068,"Alaska","Denali Borough",1,40,21,10,11
050,02,068,"Alaska","Denali Borough",1,41,23,10,13
050,02,068,"Alaska","Denali Borough",1,42,32,19,13
050,02,068,"Alaska","Denali Borough",1,43,27,13,14
050,02,068,"Alaska","Denali Borough",1,44,24,10,14
050,02,068,"Alaska","Denali Borough",1,45,24,11,13
050,02,068,"Alaska","Denali Borough",1,46,20,11,9
050,02,068,"Alaska","Denali Borough",1,47,21,10,11
050,02,068,"Alaska","Denali Borough",1,48,28,17,11
050,02,068,"Alaska","Denali Borough",1,49,25,10,15
050,02,068,"Alaska","Denali Borough",1,50,27,14,13
050,02,068,"Alaska","Denali Borough",1,51,26,15,11
050,02,068,"Alaska","Denali Borough",1,52,19,8,11
050,02,068,"Alaska","Denali Borough",1,53,17,9,8
050,02,068,"Alaska","Denali Borough",1,54,28,14,14
050,02,068,"Alaska","Denali Borough",1,55,34,14,20
050,02,068,"Alaska","Denali Borough",1,56,35,17,18
050,02,068,"Alaska","Denali Borough",1,57,24,8,16
050,02,068,"Alaska","Denali Borough",1,58,34,17,17
050,02,068,"Alaska","Denali Borough",1,59,34,22,12
050,02,068,"Alaska","Denali Borough",1,60,25,16,9
050,02,068,"Alaska","Denali Borough",1,61,20,12,8
050,02,068,"Alaska","Denali Borough",1,62,20,12,8
050,02,068,"Alaska","Denali Borough",1,63,17,13,4
050,02,068,"Alaska","Denali Borough",1,64,18,12,6
050,02,068,"Alaska","Denali Borough",1,65,21,10,11
050,02,068,"Alaska","Denali Borough",1,66,21,9,12
050,02,068,"Alaska","Denali Borough",1,67,28,17,11
050,02,068,"Alaska","Denali Borough",1,68,22,15,7
050,02,068,"Alaska","Denali Borough",1,69,14,9,5
050,02,068,"Alaska","Denali Borough",1,70,13,9,4
050,02,068,"Alaska","Denali Borough",1,71,13,7,6
050,02,068,"Alaska","Denali Borough",1,72,8,6,2
050,02,068,"Alaska","Denali Borough",1,73,5,3,2
050,02,068,"Alaska","Denali Borough",1,74,5,4,1
050,02,068,"Alaska","Denali Borough",1,75,6,3,3
050,02,068,"Alaska","Denali Borough",1,76,5,3,2
050,02,068,"Alaska","Denali Borough",1,77,5,4,1
050,02,068,"Alaska","Denali Borough",1,78,5,3,2
050,02,068,"Alaska","Denali Borough",1,79,3,2,1
050,02,068,"Alaska","Denali Borough",1,80,5,3,2
050,02,068,"Alaska","Denali Borough",1,81,3,1,2
050,02,068,"Alaska","Denali Borough",1,82,2,1,1
050,02,068,"Alaska","Denali Borough",1,83,4,2,2
050,02,068,"Alaska","Denali Borough",1,84,2,1,1
050,02,068,"Alaska","Denali Borough",1,85,8,4,4
050,02,068,"Alaska","Denali Borough",2,0,11,6,5
050,02,068,"Alaska","Denali Borough",2,1,13,6,7
050,02,068,"Alaska","Denali Borough",2,2,10,5,5
050,02,068,"Alaska","Denali Borough",2,3,18,10,8
050,02,068,"Alaska","Denali Borough",2,4,16,8,8
050,02,068,"Alaska","Denali Borough",2,5,15,8,7
050,02,068,"Alaska","Denali Borough",2,6,20,10,10
050,02,068,"Alaska","Denali Borough",2,7,20,9,11
050,02,068,"Alaska","Denali Borough",2,8,20,8,12
050,02,068,"Alaska","Denali Borough",2,9,16,8,8
050,02,068,"Alaska","Denali Borough",2,10,15,10,5
050,02,068,"Alaska","Denali Borough",2,11,18,10,8
050,02,068,"Alaska","Denali Borough",2,12,20,11,9
050,02,068,"Alaska","Denali Borough",2,13,17,11,6
050,02,068,"Alaska","Denali Borough",2,14,17,9,8
050,02,068,"Alaska","Denali Borough",2,15,9,6,3
050,02,068,"Alaska","Denali Borough",2,16,14,8,6
050,02,068,"Alaska","Denali Borough",2,17,18,10,8
050,02,068,"Alaska","Denali Borough",2,18,14,5,9
050,02,068,"Alaska","Denali Borough",2,19,12,5,7
050,02,068,"Alaska","Denali Borough",2,20,11,4,7
050,02,068,"Alaska","Denali Borough",2,21,14,7,7
050,02,068,"Alaska","Denali Borough",2,22,23,15,8
050,02,068,"Alaska","Denali Borough",2,23,22,16,6
050,02,068,"Alaska","Denali Borough",2,24,17,12,5
050,02,068,"Alaska","Denali Borough",2,25,19,13,6
050,02,068,"Alaska","Denali Borough",2,26,26,18,8
050,02,068,"Alaska","Denali Borough",2,27,26,17,9
050,02,068,"Alaska","Denali Borough",2,28,24,11,13
050,02,068,"Alaska","Denali Borough",2,29,26,13,13
050,02,068,"Alaska","Denali Borough",2,30,30,15,15
050,02,068,"Alaska","Denali Borough",2,31,30,14,16
050,02,068,"Alaska","Denali Borough",2,32,29,13,16
050,02,068,"Alaska","Denali Borough",2,33,28,15,13
050,02,068,"Alaska","Denali Borough",2,34,22,11,11
050,02,068,"Alaska","Denali Borough",2,35,27,15,12
050,02,068,"Alaska","Denali Borough",2,36,28,17,11
050,02,068,"Alaska","Denali Borough",2,37,34,19,15
050,02,068,"Alaska","Denali Borough",2,38,29,15,14
050,02,068,"Alaska","Denali Borough",2,39,23,12,11
050,02,068,"Alaska","Denali Borough",2,40,21,10,11
050,02,068,"Alaska","Denali Borough",2,41,23,11,12
050,02,068,"Alaska","Denali Borough",2,42,30,17,13
050,02,068,"Alaska","Denali Borough",2,43,28,14,14
050,02,068,"Alaska","Denali Borough",2,44,24,10,14
050,02,068,"Alaska","Denali Borough",2,45,23,11,12
050,02,068,"Alaska","Denali Borough",2,46,19,10,9
050,02,068,"Alaska","Denali Borough",2,47,21,11,10
050,02,068,"Alaska","Denali Borough",2,48,27,16,11
050,02,068,"Alaska","Denali Borough",2,49,26,12,14
050,02,068,"Alaska","Denali Borough",2,50,27,13,14
050,02,068,"Alaska","Denali Borough",2,51,26,15,11
050,02,068,"Alaska","Denali Borough",2,52,20,9,11
050,02,068,"Alaska","Denali Borough",2,53,17,9,8
050,02,068,"Alaska","Denali Borough",2,54,24,12,12
050,02,068,"Alaska","Denali Borough",2,55,32,13,19
050,02,068,"Alaska","Denali Borough",2,56,34,16,18
050,02,068,"Alaska","Denali Borough",2,57,26,10,16
050,02,068,"Alaska","Denali Borough",2,58,31,15,16
050,02,068,"Alaska","Denali Borough",2,59,32,19,13
050,02,068,"Alaska","Denali Borough",2,60,26,16,10
050,02,068,"Alaska","Denali Borough",2,61,21,13,8
050,02,068,"Alaska","Denali Borough",2,62,20,12,8
050,02,068,"Alaska","Denali Borough",2,63,17,12,5
050,02,068,"Alaska","Denali Borough",2,64,16,11,5
050,02,068,"Alaska","Denali Borough",2,65,21,11,10
050,02,068,"Alaska","Denali Borough",2,66,21,9,12
050,02,068,"Alaska","Denali Borough",2,67,26,15,11
050,02,068,"Alaska","Denali Borough",2,68,24,16,8
050,02,068,"Alaska","Denali Borough",2,69,16,11,5
050,02,068,"Alaska","Denali Borough",2,70,12,8,4
050,02,068,"Alaska","Denali Borough",2,71,13,7,6
050,02,068,"Alaska","Denali Borough",2,72,9,6,3
050,02,068,"Alaska","Denali Borough",2,73,6,4,2
050,02,068,"Alaska","Denali Borough",2,74,5,4,1
050,02,068,"Alaska","Denali Borough",2,75,6,3,3
050,02,068,"Alaska","Denali Borough",2,76,5,3,2
050,02,068,"Alaska","Denali Borough",2,77,5,4,1
050,02,068,"Alaska","Denali Borough",2,78,5,3,2
050,02,068,"Alaska","Denali Borough",2,79,3,2,1
050,02,068,"Alaska","Denali Borough",2,80,5,3,2
050,02,068,"Alaska","Denali Borough",2,81,4,2,2
050,02,068,"Alaska","Denali Borough",2,82,2,1,1
050,02,068,"Alaska","Denali Borough",2,83,4,2,2
050,02,068,"Alaska","Denali Borough",2,84,2,1,1
050,02,068,"Alaska","Denali Borough",2,85,8,4,4
050,02,068,"Alaska","Denali Borough",3,0,18,9,9
050,02,068,"Alaska","Denali Borough",3,1,13,4,9
050,02,068,"Alaska","Denali Borough",3,2,14,6,8
050,02,068,"Alaska","Denali Borough",3,3,11,5,6
050,02,068,"Alaska","Denali Borough",3,4,19,11,8
050,02,068,"Alaska","Denali Borough",3,5,17,8,9
050,02,068,"Alaska","Denali Borough",3,6,11,6,5
050,02,068,"Alaska","Denali Borough",3,7,18,7,11
050,02,068,"Alaska","Denali Borough",3,8,20,10,10
050,02,068,"Alaska","Denali Borough",3,9,23,9,14
050,02,068,"Alaska","Denali Borough",3,10,17,10,7
050,02,068,"Alaska","Denali Borough",3,11,17,9,8
050,02,068,"Alaska","Denali Borough",3,12,18,11,7
050,02,068,"Alaska","Denali Borough",3,13,17,9,8
050,02,068,"Alaska","Denali Borough",3,14,17,11,6
050,02,068,"Alaska","Denali Borough",3,15,16,10,6
050,02,068,"Alaska","Denali Borough",3,16,10,6,4
050,02,068,"Alaska","Denali Borough",3,17,14,9,5
050,02,068,"Alaska","Denali Borough",3,18,13,6,7
050,02,068,"Alaska","Denali Borough",3,19,11,4,7
050,02,068,"Alaska","Denali Borough",3,20,11,6,5
050,02,068,"Alaska","Denali Borough",3,21,12,7,5
050,02,068,"Alaska","Denali Borough",3,22,14,6,8
050,02,068,"Alaska","Denali Borough",3,23,17,11,6
050,02,068,"Alaska","Denali Borough",3,24,27,15,12
050,02,068,"Alaska","Denali Borough",3,25,19,12,7
050,02,068,"Alaska","Denali Borough",3,26,17,11,6
050,02,068,"Alaska","Denali Borough",3,27,25,17,8
050,02,068,"Alaska","Denali Borough",3,28,25,19,6
050,02,068,"Alaska","Denali Borough",3,29,28,13,15
050,02,068,"Alaska","Denali Borough",3,30,24,14,10
050,02,068,"Alaska","Denali Borough",3,31,31,15,16
050,02,068,"Alaska","Denali Borough",3,32,32,15,17
050,02,068,"Alaska","Denali Borough",3,33,28,13,15
050,02,068,"Alaska","Denali Borough",3,34,28,17,11
050,02,068,"Alaska","Denali Borough",3,35,21,9,12
050,02,068,"Alaska","Denali Borough",3,36,29,17,12
050,02,068,"Alaska","Denali Borough",3,37,24,12,12
050,02,068,"Alaska","Denali Borough",3,38,31,17,14
050,02,068,"Alaska","Denali Borough",3,39,28,15,13
050,02,068,"Alaska","Denali Borough",3,40,20,10,10
050,02,068,"Alaska","Denali Borough",3,41,25,14,11
050,02,068,"Alaska","Denali Borough",3,42,21,11,10
050,02,068,"Alaska","Denali Borough",3,43,31,16,15
050,02,068,"Alaska","Denali Borough",3,44,27,14,13
050,02,068,"Alaska","Denali Borough",3,45,24,12,12
050,02,068,"Alaska","Denali Borough",3,46,25,13,12
050,02,068,"Alaska","Denali Borough",3,47,17,8,9
050,02,068,"Alaska","Denali Borough",3,48,20,9,11
050,02,068,"Alaska","Denali Borough",3,49,23,14,9
050,02,068,"Alaska","Denali Borough",3,50,23,12,11
050,02,068,"Alaska","Denali Borough",3,51,23,12,11
050,02,068,"Alaska","Denali Borough",3,52,28,17,11
050,02,068,"Alaska","Denali Borough",3,53,20,10,10
050,02,068,"Alaska","Denali Borough",3,54,18,10,8
050,02,068,"Alaska","Denali Borough",3,55,24,12,12
050,02,068,"Alaska","Denali Borough",3,56,34,14,20
050,02,068,"Alaska","Denali Borough",3,57,34,15,19
050,02,068,"Alaska","Denali Borough",3,58,26,10,16
050,02,068,"Alaska","Denali Borough",3,59,30,16,14
050,02,068,"Alaska","Denali Borough",3,60,31,18,13
050,02,068,"Alaska","Denali Borough",3,61,22,13,9
050,02,068,"Alaska","Denali Borough",3,62,21,12,9
050,02,068,"Alaska","Denali Borough",3,63,18,10,8
050,02,068,"Alaska","Denali Borough",3,64,17,12,5
050,02,068,"Alaska","Denali Borough",3,65,16,10,6
050,02,068,"Alaska","Denali Borough",3,66,20,10,10
050,02,068,"Alaska","Denali Borough",3,67,21,9,12
050,02,068,"Alaska","Denali Borough",3,68,28,15,13
050,02,068,"Alaska","Denali Borough",3,69,20,13,7
050,02,068,"Alaska","Denali Borough",3,70,14,12,2
050,02,068,"Alaska","Denali Borough",3,71,11,9,2
050,02,068,"Alaska","Denali Borough",3,72,11,6,5
050,02,068,"Alaska","Denali Borough",3,73,10,6,4
050,02,068,"Alaska","Denali Borough",3,74,5,4,1
050,02,068,"Alaska","Denali Borough",3,75,5,4,1
050,02,068,"Alaska","Denali Borough",3,76,5,3,2
050,02,068,"Alaska","Denali Borough",3,77,5,3,2
050,02,068,"Alaska","Denali Borough",3,78,5,4,1
050,02,068,"Alaska","Denali Borough",3,79,6,3,3
050,02,068,"Alaska","Denali Borough",3,80,3,2,1
050,02,068,"Alaska","Denali Borough",3,81,5,3,2
050,02,068,"Alaska","Denali Borough",3,82,4,2,2
050,02,068,"Alaska","Denali Borough",3,83,2,1,1
050,02,068,"Alaska","Denali Borough",3,84,3,2,1
050,02,068,"Alaska","Denali Borough",3,85,9,4,5
050,02,068,"Alaska","Denali Borough",4,0,20,9,11
050,02,068,"Alaska","Denali Borough",4,1,19,10,9
050,02,068,"Alaska","Denali Borough",4,2,8,3,5
050,02,068,"Alaska","Denali Borough",4,3,15,6,9
050,02,068,"Alaska","Denali Borough",4,4,10,4,6
050,02,068,"Alaska","Denali Borough",4,5,19,12,7
050,02,068,"Alaska","Denali Borough",4,6,19,9,10
050,02,068,"Alaska","Denali Borough",4,7,11,6,5
050,02,068,"Alaska","Denali Borough",4,8,18,8,10
050,02,068,"Alaska","Denali Borough",4,9,20,9,11
050,02,068,"Alaska","Denali Borough",4,10,21,9,12
050,02,068,"Alaska","Denali Borough",4,11,15,8,7
050,02,068,"Alaska","Denali Borough",4,12,16,8,8
050,02,068,"Alaska","Denali Borough",4,13,18,10,8
050,02,068,"Alaska","Denali Borough",4,14,17,9,8
050,02,068,"Alaska","Denali Borough",4,15,17,10,7
050,02,068,"Alaska","Denali Borough",4,16,16,10,6
050,02,068,"Alaska","Denali Borough",4,17,10,6,4
050,02,068,"Alaska","Denali Borough",4,18,9,6,3
050,02,068,"Alaska","Denali Borough",4,19,9,5,4
050,02,068,"Alaska","Denali Borough",4,20,10,3,7
050,02,068,"Alaska","Denali Borough",4,21,11,6,5
050,02,068,"Alaska","Denali Borough",4,22,11,5,6
050,02,068,"Alaska","Denali Borough",4,23,12,6,6
050,02,068,"Alaska","Denali Borough",4,24,20,14,6
050,02,068,"Alaska","Denali Borough",4,25,24,13,11
050,02,068,"Alaska","Denali Borough",4,26,21,15,6
050,02,068,"Alaska","Denali Borough",4,27,14,11,3
050,02,068,"Alaska","Denali Borough",4,28,27,19,8
050,02,068,"Alaska","Denali Borough",4,29,25,18,7
050,02,068,"Alaska","Denali Borough",4,30,29,14,15
050,02,068,"Alaska","Denali Borough",4,31,24,12,12
050,02,068,"Alaska","Denali Borough",4,32,29,14,15
050,02,068,"Alaska","Denali Borough",4,33,31,15,16
050,02,068,"Alaska","Denali Borough",4,34,31,18,13
050,02,068,"Alaska","Denali Borough",4,35,26,17,9
050,02,068,"Alaska","Denali Borough",4,36,26,13,13
050,02,068,"Alaska","Denali Borough",4,37,23,12,11
050,02,068,"Alaska","Denali Borough",4,38,28,14,14
050,02,068,"Alaska","Denali Borough",4,39,29,15,14
050,02,068,"Alaska","Denali Borough",4,40,28,14,14
050,02,068,"Alaska","Denali Borough",4,41,22,11,11
050,02,068,"Alaska","Denali Borough",4,42,24,11,13
050,02,068,"Alaska","Denali Borough",4,43,22,12,10
050,02,068,"Alaska","Denali Borough",4,44,29,16,13
050,02,068,"Alaska","Denali Borough",4,45,27,14,13
050,02,068,"Alaska","Denali Borough",4,46,26,13,13
050,02,068,"Alaska","Denali Borough",4,47,26,13,13
050,02,068,"Alaska","Denali Borough",4,48,18,9,9
050,02,068,"Alaska","Denali Borough",4,49,18,9,9
050,02,068,"Alaska","Denali Borough",4,50,24,14,10
050,02,068,"Alaska","Denali Borough",4,51,21,12,9
050,02,068,"Alaska","Denali Borough",4,52,22,12,10
050,02,068,"Alaska","Denali Borough",4,53,27,16,11
050,02,068,"Alaska","Denali Borough",4,54,20,10,10
050,02,068,"Alaska","Denali Borough",4,55,17,9,8
050,02,068,"Alaska","Denali Borough",4,56,26,12,14
050,02,068,"Alaska","Denali Borough",4,57,29,13,16
050,02,068,"Alaska","Denali Borough",4,58,35,17,18
050,02,068,"Alaska","Denali Borough",4,59,24,10,14
050,02,068,"Alaska","Denali Borough",4,60,28,14,14
050,02,068,"Alaska","Denali Borough",4,61,29,16,13
050,02,068,"Alaska","Denali Borough",4,62,22,13,9
050,02,068,"Alaska","Denali Borough",4,63,24,13,11
050,02,068,"Alaska","Denali Borough",4,64,17,10,7
050,02,068,"Alaska","Denali Borough",4,65,17,13,4
050,02,068,"Alaska","Denali Borough",4,66,15,9,6
050,02,068,"Alaska","Denali Borough",4,67,19,12,7
050,02,068,"Alaska","Denali Borough",4,68,25,9,16
050,02,068,"Alaska","Denali Borough",4,69,24,13,11
050,02,068,"Alaska","Denali Borough",4,70,18,12,6
050,02,068,"Alaska","Denali Borough",4,71,12,11,1
050,02,068,"Alaska","Denali Borough",4,72,11,9,2
050,02,068,"Alaska","Denali Borough",4,73,9,5,4
050,02,068,"Alaska","Denali Borough",4,74,9,6,3
050,02,068,"Alaska","Denali Borough",4,75,5,4,1
050,02,068,"Alaska","Denali Borough",4,76,5,4,1
050,02,068,"Alaska","Denali Borough",4,77,6,3,3
050,02,068,"Alaska","Denali Borough",4,78,5,3,2
050,02,068,"Alaska","Denali Borough",4,79,5,4,1
050,02,068,"Alaska","Denali Borough",4,80,5,3,2
050,02,068,"Alaska","Denali Borough",4,81,3,2,1
050,02,068,"Alaska","Denali Borough",4,82,3,1,2
050,02,068,"Alaska","Denali Borough",4,83,4,2,2
050,02,068,"Alaska","Denali Borough",4,84,1,0,1
050,02,068,"Alaska","Denali Borough",4,85,11,6,5
050,02,068,"Alaska","Denali Borough",5,0,18,8,10
050,02,068,"Alaska","Denali Borough",5,1,13,4,9
050,02,068,"Alaska","Denali Borough",5,2,20,10,10
050,02,068,"Alaska","Denali Borough",5,3,15,6,9
050,02,068,"Alaska","Denali Borough",5,4,11,5,6
050,02,068,"Alaska","Denali Borough",5,5,11,4,7
050,02,068,"Alaska","Denali Borough",5,6,19,10,9
050,02,068,"Alaska","Denali Borough",5,7,18,9,9
050,02,068,"Alaska","Denali Borough",5,8,16,9,7
050,02,068,"Alaska","Denali Borough",5,9,18,9,9
050,02,068,"Alaska","Denali Borough",5,10,19,8,11
050,02,068,"Alaska","Denali Borough",5,11,23,9,14
050,02,068,"Alaska","Denali Borough",5,12,14,8,6
050,02,068,"Alaska","Denali Borough",5,13,14,7,7
050,02,068,"Alaska","Denali Borough",5,14,18,11,7
050,02,068,"Alaska","Denali Borough",5,15,15,9,6
050,02,068,"Alaska","Denali Borough",5,16,17,10,7
050,02,068,"Alaska","Denali Borough",5,17,14,8,6
050,02,068,"Alaska","Denali Borough",5,18,7,5,2
050,02,068,"Alaska","Denali Borough",5,19,7,5,2
050,02,068,"Alaska","Denali Borough",5,20,9,6,3
050,02,068,"Alaska","Denali Borough",5,21,10,3,7
050,02,068,"Alaska","Denali Borough",5,22,10,7,3
050,02,068,"Alaska","Denali Borough",5,23,16,6,10
050,02,068,"Alaska","Denali Borough",5,24,17,10,7
050,02,068,"Alaska","Denali Borough",5,25,25,19,6
050,02,068,"Alaska","Denali Borough",5,26,24,16,8
050,02,068,"Alaska","Denali Borough",5,27,20,13,7
050,02,068,"Alaska","Denali Borough",5,28,20,14,6
050,02,068,"Alaska","Denali Borough",5,29,28,18,10
050,02,068,"Alaska","Denali Borough",5,30,25,16,9
050,02,068,"Alaska","Denali Borough",5,31,20,9,11
050,02,068,"Alaska","Denali Borough",5,32,28,15,13
050,02,068,"Alaska","Denali Borough",5,33,31,18,13
050,02,068,"Alaska","Denali Borough",5,34,31,16,15
050,02,068,"Alaska","Denali Borough",5,35,33,16,17
050,02,068,"Alaska","Denali Borough",5,36,27,18,9
050,02,068,"Alaska","Denali Borough",5,37,22,13,9
050,02,068,"Alaska","Denali Borough",5,38,27,14,13
050,02,068,"Alaska","Denali Borough",5,39,28,15,13
050,02,068,"Alaska","Denali Borough",5,40,31,17,14
050,02,068,"Alaska","Denali Borough",5,41,29,17,12
050,02,068,"Alaska","Denali Borough",5,42,25,12,13
050,02,068,"Alaska","Denali Borough",5,43,20,8,12
050,02,068,"Alaska","Denali Borough",5,44,22,11,11
050,02,068,"Alaska","Denali Borough",5,45,31,18,13
050,02,068,"Alaska","Denali Borough",5,46,27,15,12
050,02,068,"Alaska","Denali Borough",5,47,24,12,12
050,02,068,"Alaska","Denali Borough",5,48,27,13,14
050,02,068,"Alaska","Denali Borough",5,49,17,7,10
050,02,068,"Alaska","Denali Borough",5,50,19,11,8
050,02,068,"Alaska","Denali Borough",5,51,29,18,11
050,02,068,"Alaska","Denali Borough",5,52,20,12,8
050,02,068,"Alaska","Denali Borough",5,53,23,12,11
050,02,068,"Alaska","Denali Borough",5,54,27,15,12
050,02,068,"Alaska","Denali Borough",5,55,22,11,11
050,02,068,"Alaska","Denali Borough",5,56,17,9,8
050,02,068,"Alaska","Denali Borough",5,57,25,12,13
050,02,068,"Alaska","Denali Borough",5,58,33,18,15
050,02,068,"Alaska","Denali Borough",5,59,29,13,16
050,02,068,"Alaska","Denali Borough",5,60,21,9,12
050,02,068,"Alaska","Denali Borough",5,61,24,11,13
050,02,068,"Alaska","Denali Borough",5,62,28,15,13
050,02,068,"Alaska","Denali Borough",5,63,21,12,9
050,02,068,"Alaska","Denali Borough",5,64,22,13,9
050,02,068,"Alaska","Denali Borough",5,65,16,8,8
050,02,068,"Alaska","Denali Borough",5,66,16,13,3
050,02,068,"Alaska","Denali Borough",5,67,14,8,6
050,02,068,"Alaska","Denali Borough",5,68,18,11,7
050,02,068,"Alaska","Denali Borough",5,69,21,9,12
050,02,068,"Alaska","Denali Borough",5,70,22,13,9
050,02,068,"Alaska","Denali Borough",5,71,16,11,5
050,02,068,"Alaska","Denali Borough",5,72,12,11,1
050,02,068,"Alaska","Denali Borough",5,73,11,9,2
050,02,068,"Alaska","Denali Borough",5,74,7,5,2
050,02,068,"Alaska","Denali Borough",5,75,9,6,3
050,02,068,"Alaska","Denali Borough",5,76,3,2,1
050,02,068,"Alaska","Denali Borough",5,77,5,4,1
050,02,068,"Alaska","Denali Borough",5,78,6,3,3
050,02,068,"Alaska","Denali Borough",5,79,4,2,2
050,02,068,"Alaska","Denali Borough",5,80,5,4,1
050,02,068,"Alaska","Denali Borough",5,81,6,3,3
050,02,068,"Alaska","Denali Borough",5,82,2,2,0
050,02,068,"Alaska","Denali Borough",5,83,3,1,2
050,02,068,"Alaska","Denali Borough",5,84,4,2,2
050,02,068,"Alaska","Denali Borough",5,85,13,7,6
050,02,070,"Alaska","Dillingham Census Area",1,0,84,43,41
050,02,070,"Alaska","Dillingham Census Area",1,1,85,45,40
050,02,070,"Alaska","Dillingham Census Area",1,2,88,46,42
050,02,070,"Alaska","Dillingham Census Area",1,3,97,54,43
050,02,070,"Alaska","Dillingham Census Area",1,4,92,42,50
050,02,070,"Alaska","Dillingham Census Area",1,5,93,33,60
050,02,070,"Alaska","Dillingham Census Area",1,6,91,36,55
050,02,070,"Alaska","Dillingham Census Area",1,7,92,46,46
050,02,070,"Alaska","Dillingham Census Area",1,8,83,50,33
050,02,070,"Alaska","Dillingham Census Area",1,9,109,53,56
050,02,070,"Alaska","Dillingham Census Area",1,10,92,46,46
050,02,070,"Alaska","Dillingham Census Area",1,11,83,45,38
050,02,070,"Alaska","Dillingham Census Area",1,12,83,51,32
050,02,070,"Alaska","Dillingham Census Area",1,13,74,40,34
050,02,070,"Alaska","Dillingham Census Area",1,14,77,40,37
050,02,070,"Alaska","Dillingham Census Area",1,15,79,35,44
050,02,070,"Alaska","Dillingham Census Area",1,16,69,37,32
050,02,070,"Alaska","Dillingham Census Area",1,17,70,38,32
050,02,070,"Alaska","Dillingham Census Area",1,18,63,33,30
050,02,070,"Alaska","Dillingham Census Area",1,19,59,33,26
050,02,070,"Alaska","Dillingham Census Area",1,20,60,34,26
050,02,070,"Alaska","Dillingham Census Area",1,21,72,39,33
050,02,070,"Alaska","Dillingham Census Area",1,22,69,37,32
050,02,070,"Alaska","Dillingham Census Area",1,23,70,37,33
050,02,070,"Alaska","Dillingham Census Area",1,24,61,33,28
050,02,070,"Alaska","Dillingham Census Area",1,25,68,37,31
050,02,070,"Alaska","Dillingham Census Area",1,26,79,38,41
050,02,070,"Alaska","Dillingham Census Area",1,27,79,41,38
050,02,070,"Alaska","Dillingham Census Area",1,28,89,52,37
050,02,070,"Alaska","Dillingham Census Area",1,29,84,42,42
050,02,070,"Alaska","Dillingham Census Area",1,30,78,38,40
050,02,070,"Alaska","Dillingham Census Area",1,31,77,34,43
050,02,070,"Alaska","Dillingham Census Area",1,32,73,40,33
050,02,070,"Alaska","Dillingham Census Area",1,33,66,35,31
050,02,070,"Alaska","Dillingham Census Area",1,34,66,36,30
050,02,070,"Alaska","Dillingham Census Area",1,35,58,28,30
050,02,070,"Alaska","Dillingham Census Area",1,36,74,35,39
050,02,070,"Alaska","Dillingham Census Area",1,37,61,31,30
050,02,070,"Alaska","Dillingham Census Area",1,38,52,29,23
050,02,070,"Alaska","Dillingham Census Area",1,39,58,31,27
050,02,070,"Alaska","Dillingham Census Area",1,40,55,29,26
050,02,070,"Alaska","Dillingham Census Area",1,41,50,24,26
050,02,070,"Alaska","Dillingham Census Area",1,42,42,14,28
050,02,070,"Alaska","Dillingham Census Area",1,43,39,25,14
050,02,070,"Alaska","Dillingham Census Area",1,44,42,23,19
050,02,070,"Alaska","Dillingham Census Area",1,45,38,21,17
050,02,070,"Alaska","Dillingham Census Area",1,46,38,19,19
050,02,070,"Alaska","Dillingham Census Area",1,47,37,18,19
050,02,070,"Alaska","Dillingham Census Area",1,48,38,21,17
050,02,070,"Alaska","Dillingham Census Area",1,49,38,19,19
050,02,070,"Alaska","Dillingham Census Area",1,50,47,27,20
050,02,070,"Alaska","Dillingham Census Area",1,51,55,27,28
050,02,070,"Alaska","Dillingham Census Area",1,52,42,25,17
050,02,070,"Alaska","Dillingham Census Area",1,53,56,30,26
050,02,070,"Alaska","Dillingham Census Area",1,54,65,30,35
050,02,070,"Alaska","Dillingham Census Area",1,55,69,36,33
050,02,070,"Alaska","Dillingham Census Area",1,56,54,28,26
050,02,070,"Alaska","Dillingham Census Area",1,57,63,30,33
050,02,070,"Alaska","Dillingham Census Area",1,58,76,43,33
050,02,070,"Alaska","Dillingham Census Area",1,59,58,29,29
050,02,070,"Alaska","Dillingham Census Area",1,60,58,34,24
050,02,070,"Alaska","Dillingham Census Area",1,61,64,34,30
050,02,070,"Alaska","Dillingham Census Area",1,62,54,33,21
050,02,070,"Alaska","Dillingham Census Area",1,63,61,28,33
050,02,070,"Alaska","Dillingham Census Area",1,64,49,23,26
050,02,070,"Alaska","Dillingham Census Area",1,65,59,33,26
050,02,070,"Alaska","Dillingham Census Area",1,66,48,25,23
050,02,070,"Alaska","Dillingham Census Area",1,67,46,23,23
050,02,070,"Alaska","Dillingham Census Area",1,68,36,17,19
050,02,070,"Alaska","Dillingham Census Area",1,69,39,21,18
050,02,070,"Alaska","Dillingham Census Area",1,70,34,20,14
050,02,070,"Alaska","Dillingham Census Area",1,71,23,12,11
050,02,070,"Alaska","Dillingham Census Area",1,72,18,8,10
050,02,070,"Alaska","Dillingham Census Area",1,73,19,11,8
050,02,070,"Alaska","Dillingham Census Area",1,74,24,13,11
050,02,070,"Alaska","Dillingham Census Area",1,75,31,16,15
050,02,070,"Alaska","Dillingham Census Area",1,76,16,8,8
050,02,070,"Alaska","Dillingham Census Area",1,77,14,7,7
050,02,070,"Alaska","Dillingham Census Area",1,78,12,7,5
050,02,070,"Alaska","Dillingham Census Area",1,79,15,4,11
050,02,070,"Alaska","Dillingham Census Area",1,80,11,5,6
050,02,070,"Alaska","Dillingham Census Area",1,81,10,5,5
050,02,070,"Alaska","Dillingham Census Area",1,82,9,6,3
050,02,070,"Alaska","Dillingham Census Area",1,83,13,8,5
050,02,070,"Alaska","Dillingham Census Area",1,84,3,2,1
050,02,070,"Alaska","Dillingham Census Area",1,85,31,12,19
050,02,070,"Alaska","Dillingham Census Area",2,0,82,41,41
050,02,070,"Alaska","Dillingham Census Area",2,1,85,45,40
050,02,070,"Alaska","Dillingham Census Area",2,2,87,46,41
050,02,070,"Alaska","Dillingham Census Area",2,3,93,51,42
050,02,070,"Alaska","Dillingham Census Area",2,4,92,45,47
050,02,070,"Alaska","Dillingham Census Area",2,5,92,34,58
050,02,070,"Alaska","Dillingham Census Area",2,6,91,36,55
050,02,070,"Alaska","Dillingham Census Area",2,7,91,44,47
050,02,070,"Alaska","Dillingham Census Area",2,8,83,48,35
050,02,070,"Alaska","Dillingham Census Area",2,9,103,53,50
050,02,070,"Alaska","Dillingham Census Area",2,10,94,48,46
050,02,070,"Alaska","Dillingham Census Area",2,11,83,44,39
050,02,070,"Alaska","Dillingham Census Area",2,12,85,51,34
050,02,070,"Alaska","Dillingham Census Area",2,13,76,42,34
050,02,070,"Alaska","Dillingham Census Area",2,14,77,40,37
050,02,070,"Alaska","Dillingham Census Area",2,15,80,36,44
050,02,070,"Alaska","Dillingham Census Area",2,16,71,37,34
050,02,070,"Alaska","Dillingham Census Area",2,17,68,37,31
050,02,070,"Alaska","Dillingham Census Area",2,18,63,34,29
050,02,070,"Alaska","Dillingham Census Area",2,19,56,31,25
050,02,070,"Alaska","Dillingham Census Area",2,20,59,34,25
050,02,070,"Alaska","Dillingham Census Area",2,21,68,37,31
050,02,070,"Alaska","Dillingham Census Area",2,22,71,39,32
050,02,070,"Alaska","Dillingham Census Area",2,23,68,36,32
050,02,070,"Alaska","Dillingham Census Area",2,24,63,35,28
050,02,070,"Alaska","Dillingham Census Area",2,25,68,37,31
050,02,070,"Alaska","Dillingham Census Area",2,26,75,37,38
050,02,070,"Alaska","Dillingham Census Area",2,27,80,42,38
050,02,070,"Alaska","Dillingham Census Area",2,28,85,48,37
050,02,070,"Alaska","Dillingham Census Area",2,29,85,44,41
050,02,070,"Alaska","Dillingham Census Area",2,30,79,39,40
050,02,070,"Alaska","Dillingham Census Area",2,31,73,33,40
050,02,070,"Alaska","Dillingham Census Area",2,32,75,39,36
050,02,070,"Alaska","Dillingham Census Area",2,33,66,34,32
050,02,070,"Alaska","Dillingham Census Area",2,34,65,36,29
050,02,070,"Alaska","Dillingham Census Area",2,35,63,32,31
050,02,070,"Alaska","Dillingham Census Area",2,36,72,35,37
050,02,070,"Alaska","Dillingham Census Area",2,37,61,31,30
050,02,070,"Alaska","Dillingham Census Area",2,38,54,29,25
050,02,070,"Alaska","Dillingham Census Area",2,39,57,31,26
050,02,070,"Alaska","Dillingham Census Area",2,40,57,31,26
050,02,070,"Alaska","Dillingham Census Area",2,41,50,25,25
050,02,070,"Alaska","Dillingham Census Area",2,42,42,16,26
050,02,070,"Alaska","Dillingham Census Area",2,43,40,23,17
050,02,070,"Alaska","Dillingham Census Area",2,44,42,24,18
050,02,070,"Alaska","Dillingham Census Area",2,45,37,21,16
050,02,070,"Alaska","Dillingham Census Area",2,46,38,19,19
050,02,070,"Alaska","Dillingham Census Area",2,47,38,18,20
050,02,070,"Alaska","Dillingham Census Area",2,48,36,20,16
050,02,070,"Alaska","Dillingham Census Area",2,49,39,21,18
050,02,070,"Alaska","Dillingham Census Area",2,50,44,25,19
050,02,070,"Alaska","Dillingham Census Area",2,51,53,28,25
050,02,070,"Alaska","Dillingham Census Area",2,52,44,25,19
050,02,070,"Alaska","Dillingham Census Area",2,53,50,27,23
050,02,070,"Alaska","Dillingham Census Area",2,54,63,30,33
050,02,070,"Alaska","Dillingham Census Area",2,55,70,36,34
050,02,070,"Alaska","Dillingham Census Area",2,56,59,31,28
050,02,070,"Alaska","Dillingham Census Area",2,57,61,29,32
050,02,070,"Alaska","Dillingham Census Area",2,58,71,39,32
050,02,070,"Alaska","Dillingham Census Area",2,59,59,30,29
050,02,070,"Alaska","Dillingham Census Area",2,60,60,34,26
050,02,070,"Alaska","Dillingham Census Area",2,61,61,33,28
050,02,070,"Alaska","Dillingham Census Area",2,62,57,34,23
050,02,070,"Alaska","Dillingham Census Area",2,63,60,29,31
050,02,070,"Alaska","Dillingham Census Area",2,64,51,24,27
050,02,070,"Alaska","Dillingham Census Area",2,65,55,30,25
050,02,070,"Alaska","Dillingham Census Area",2,66,51,27,24
050,02,070,"Alaska","Dillingham Census Area",2,67,46,23,23
050,02,070,"Alaska","Dillingham Census Area",2,68,38,18,20
050,02,070,"Alaska","Dillingham Census Area",2,69,39,21,18
050,02,070,"Alaska","Dillingham Census Area",2,70,35,20,15
050,02,070,"Alaska","Dillingham Census Area",2,71,25,13,12
050,02,070,"Alaska","Dillingham Census Area",2,72,19,9,10
050,02,070,"Alaska","Dillingham Census Area",2,73,20,11,9
050,02,070,"Alaska","Dillingham Census Area",2,74,21,11,10
050,02,070,"Alaska","Dillingham Census Area",2,75,30,16,14
050,02,070,"Alaska","Dillingham Census Area",2,76,18,9,9
050,02,070,"Alaska","Dillingham Census Area",2,77,14,7,7
050,02,070,"Alaska","Dillingham Census Area",2,78,13,7,6
050,02,070,"Alaska","Dillingham Census Area",2,79,14,4,10
050,02,070,"Alaska","Dillingham Census Area",2,80,11,4,7
050,02,070,"Alaska","Dillingham Census Area",2,81,10,5,5
050,02,070,"Alaska","Dillingham Census Area",2,82,9,6,3
050,02,070,"Alaska","Dillingham Census Area",2,83,12,8,4
050,02,070,"Alaska","Dillingham Census Area",2,84,5,3,2
050,02,070,"Alaska","Dillingham Census Area",2,85,32,13,19
050,02,070,"Alaska","Dillingham Census Area",3,0,90,51,39
050,02,070,"Alaska","Dillingham Census Area",3,1,85,43,42
050,02,070,"Alaska","Dillingham Census Area",3,2,86,45,41
050,02,070,"Alaska","Dillingham Census Area",3,3,85,43,42
050,02,070,"Alaska","Dillingham Census Area",3,4,90,51,39
050,02,070,"Alaska","Dillingham Census Area",3,5,89,45,44
050,02,070,"Alaska","Dillingham Census Area",3,6,91,38,53
050,02,070,"Alaska","Dillingham Census Area",3,7,91,35,56
050,02,070,"Alaska","Dillingham Census Area",3,8,90,44,46
050,02,070,"Alaska","Dillingham Census Area",3,9,82,44,38
050,02,070,"Alaska","Dillingham Census Area",3,10,100,49,51
050,02,070,"Alaska","Dillingham Census Area",3,11,87,44,43
050,02,070,"Alaska","Dillingham Census Area",3,12,92,46,46
050,02,070,"Alaska","Dillingham Census Area",3,13,73,43,30
050,02,070,"Alaska","Dillingham Census Area",3,14,74,40,34
050,02,070,"Alaska","Dillingham Census Area",3,15,75,37,38
050,02,070,"Alaska","Dillingham Census Area",3,16,76,31,45
050,02,070,"Alaska","Dillingham Census Area",3,17,70,37,33
050,02,070,"Alaska","Dillingham Census Area",3,18,63,34,29
050,02,070,"Alaska","Dillingham Census Area",3,19,52,28,24
050,02,070,"Alaska","Dillingham Census Area",3,20,55,29,26
050,02,070,"Alaska","Dillingham Census Area",3,21,52,31,21
050,02,070,"Alaska","Dillingham Census Area",3,22,70,39,31
050,02,070,"Alaska","Dillingham Census Area",3,23,74,41,33
050,02,070,"Alaska","Dillingham Census Area",3,24,71,40,31
050,02,070,"Alaska","Dillingham Census Area",3,25,70,38,32
050,02,070,"Alaska","Dillingham Census Area",3,26,65,33,32
050,02,070,"Alaska","Dillingham Census Area",3,27,77,42,35
050,02,070,"Alaska","Dillingham Census Area",3,28,73,36,37
050,02,070,"Alaska","Dillingham Census Area",3,29,90,52,38
050,02,070,"Alaska","Dillingham Census Area",3,30,90,50,40
050,02,070,"Alaska","Dillingham Census Area",3,31,79,36,43
050,02,070,"Alaska","Dillingham Census Area",3,32,67,30,37
050,02,070,"Alaska","Dillingham Census Area",3,33,76,39,37
050,02,070,"Alaska","Dillingham Census Area",3,34,66,35,31
050,02,070,"Alaska","Dillingham Census Area",3,35,63,35,28
050,02,070,"Alaska","Dillingham Census Area",3,36,58,29,29
050,02,070,"Alaska","Dillingham Census Area",3,37,69,40,29
050,02,070,"Alaska","Dillingham Census Area",3,38,53,30,23
050,02,070,"Alaska","Dillingham Census Area",3,39,53,31,22
050,02,070,"Alaska","Dillingham Census Area",3,40,57,30,27
050,02,070,"Alaska","Dillingham Census Area",3,41,55,29,26
050,02,070,"Alaska","Dillingham Census Area",3,42,48,25,23
050,02,070,"Alaska","Dillingham Census Area",3,43,45,19,26
050,02,070,"Alaska","Dillingham Census Area",3,44,37,21,16
050,02,070,"Alaska","Dillingham Census Area",3,45,40,23,17
050,02,070,"Alaska","Dillingham Census Area",3,46,32,19,13
050,02,070,"Alaska","Dillingham Census Area",3,47,45,25,20
050,02,070,"Alaska","Dillingham Census Area",3,48,32,15,17
050,02,070,"Alaska","Dillingham Census Area",3,49,33,17,16
050,02,070,"Alaska","Dillingham Census Area",3,50,39,21,18
050,02,070,"Alaska","Dillingham Census Area",3,51,45,24,21
050,02,070,"Alaska","Dillingham Census Area",3,52,50,27,23
050,02,070,"Alaska","Dillingham Census Area",3,53,40,21,19
050,02,070,"Alaska","Dillingham Census Area",3,54,47,23,24
050,02,070,"Alaska","Dillingham Census Area",3,55,61,29,32
050,02,070,"Alaska","Dillingham Census Area",3,56,62,31,31
050,02,070,"Alaska","Dillingham Census Area",3,57,60,32,28
050,02,070,"Alaska","Dillingham Census Area",3,58,60,29,31
050,02,070,"Alaska","Dillingham Census Area",3,59,70,36,34
050,02,070,"Alaska","Dillingham Census Area",3,60,54,30,24
050,02,070,"Alaska","Dillingham Census Area",3,61,59,33,26
050,02,070,"Alaska","Dillingham Census Area",3,62,56,30,26
050,02,070,"Alaska","Dillingham Census Area",3,63,56,33,23
050,02,070,"Alaska","Dillingham Census Area",3,64,59,30,29
050,02,070,"Alaska","Dillingham Census Area",3,65,50,25,25
050,02,070,"Alaska","Dillingham Census Area",3,66,50,28,22
050,02,070,"Alaska","Dillingham Census Area",3,67,48,24,24
050,02,070,"Alaska","Dillingham Census Area",3,68,46,23,23
050,02,070,"Alaska","Dillingham Census Area",3,69,37,18,19
050,02,070,"Alaska","Dillingham Census Area",3,70,39,21,18
050,02,070,"Alaska","Dillingham Census Area",3,71,34,20,14
050,02,070,"Alaska","Dillingham Census Area",3,72,26,13,13
050,02,070,"Alaska","Dillingham Census Area",3,73,21,11,10
050,02,070,"Alaska","Dillingham Census Area",3,74,18,9,9
050,02,070,"Alaska","Dillingham Census Area",3,75,19,11,8
050,02,070,"Alaska","Dillingham Census Area",3,76,30,16,14
050,02,070,"Alaska","Dillingham Census Area",3,77,18,9,9
050,02,070,"Alaska","Dillingham Census Area",3,78,14,7,7
050,02,070,"Alaska","Dillingham Census Area",3,79,11,6,5
050,02,070,"Alaska","Dillingham Census Area",3,80,15,5,10
050,02,070,"Alaska","Dillingham Census Area",3,81,10,4,6
050,02,070,"Alaska","Dillingham Census Area",3,82,10,5,5
050,02,070,"Alaska","Dillingham Census Area",3,83,8,5,3
050,02,070,"Alaska","Dillingham Census Area",3,84,11,7,4
050,02,070,"Alaska","Dillingham Census Area",3,85,27,11,16
050,02,070,"Alaska","Dillingham Census Area",4,0,79,41,38
050,02,070,"Alaska","Dillingham Census Area",4,1,101,61,40
050,02,070,"Alaska","Dillingham Census Area",4,2,82,40,42
050,02,070,"Alaska","Dillingham Census Area",4,3,77,44,33
050,02,070,"Alaska","Dillingham Census Area",4,4,80,43,37
050,02,070,"Alaska","Dillingham Census Area",4,5,86,46,40
050,02,070,"Alaska","Dillingham Census Area",4,6,89,45,44
050,02,070,"Alaska","Dillingham Census Area",4,7,88,36,52
050,02,070,"Alaska","Dillingham Census Area",4,8,85,36,49
050,02,070,"Alaska","Dillingham Census Area",4,9,90,42,48
050,02,070,"Alaska","Dillingham Census Area",4,10,80,44,36
050,02,070,"Alaska","Dillingham Census Area",4,11,97,46,51
050,02,070,"Alaska","Dillingham Census Area",4,12,94,48,46
050,02,070,"Alaska","Dillingham Census Area",4,13,84,43,41
050,02,070,"Alaska","Dillingham Census Area",4,14,73,42,31
050,02,070,"Alaska","Dillingham Census Area",4,15,72,36,36
050,02,070,"Alaska","Dillingham Census Area",4,16,69,34,35
050,02,070,"Alaska","Dillingham Census Area",4,17,67,30,37
050,02,070,"Alaska","Dillingham Census Area",4,18,61,34,27
050,02,070,"Alaska","Dillingham Census Area",4,19,55,30,25
050,02,070,"Alaska","Dillingham Census Area",4,20,48,25,23
050,02,070,"Alaska","Dillingham Census Area",4,21,53,27,26
050,02,070,"Alaska","Dillingham Census Area",4,22,56,34,22
050,02,070,"Alaska","Dillingham Census Area",4,23,70,37,33
050,02,070,"Alaska","Dillingham Census Area",4,24,69,43,26
050,02,070,"Alaska","Dillingham Census Area",4,25,69,41,28
050,02,070,"Alaska","Dillingham Census Area",4,26,68,35,33
050,02,070,"Alaska","Dillingham Census Area",4,27,64,32,32
050,02,070,"Alaska","Dillingham Census Area",4,28,68,34,34
050,02,070,"Alaska","Dillingham Census Area",4,29,75,36,39
050,02,070,"Alaska","Dillingham Census Area",4,30,90,54,36
050,02,070,"Alaska","Dillingham Census Area",4,31,87,49,38
050,02,070,"Alaska","Dillingham Census Area",4,32,82,38,44
050,02,070,"Alaska","Dillingham Census Area",4,33,65,29,36
050,02,070,"Alaska","Dillingham Census Area",4,34,72,35,37
050,02,070,"Alaska","Dillingham Census Area",4,35,61,30,31
050,02,070,"Alaska","Dillingham Census Area",4,36,64,37,27
050,02,070,"Alaska","Dillingham Census Area",4,37,63,36,27
050,02,070,"Alaska","Dillingham Census Area",4,38,75,46,29
050,02,070,"Alaska","Dillingham Census Area",4,39,54,32,22
050,02,070,"Alaska","Dillingham Census Area",4,40,51,30,21
050,02,070,"Alaska","Dillingham Census Area",4,41,54,27,27
050,02,070,"Alaska","Dillingham Census Area",4,42,54,28,26
050,02,070,"Alaska","Dillingham Census Area",4,43,46,23,23
050,02,070,"Alaska","Dillingham Census Area",4,44,40,16,24
050,02,070,"Alaska","Dillingham Census Area",4,45,34,18,16
050,02,070,"Alaska","Dillingham Census Area",4,46,40,23,17
050,02,070,"Alaska","Dillingham Census Area",4,47,38,22,16
050,02,070,"Alaska","Dillingham Census Area",4,48,39,20,19
050,02,070,"Alaska","Dillingham Census Area",4,49,32,15,17
050,02,070,"Alaska","Dillingham Census Area",4,50,37,17,20
050,02,070,"Alaska","Dillingham Census Area",4,51,39,20,19
050,02,070,"Alaska","Dillingham Census Area",4,52,45,23,22
050,02,070,"Alaska","Dillingham Census Area",4,53,50,24,26
050,02,070,"Alaska","Dillingham Census Area",4,54,36,17,19
050,02,070,"Alaska","Dillingham Census Area",4,55,45,24,21
050,02,070,"Alaska","Dillingham Census Area",4,56,59,28,31
050,02,070,"Alaska","Dillingham Census Area",4,57,61,31,30
050,02,070,"Alaska","Dillingham Census Area",4,58,59,34,25
050,02,070,"Alaska","Dillingham Census Area",4,59,54,24,30
050,02,070,"Alaska","Dillingham Census Area",4,60,65,34,31
050,02,070,"Alaska","Dillingham Census Area",4,61,54,30,24
050,02,070,"Alaska","Dillingham Census Area",4,62,59,32,27
050,02,070,"Alaska","Dillingham Census Area",4,63,54,28,26
050,02,070,"Alaska","Dillingham Census Area",4,64,53,32,21
050,02,070,"Alaska","Dillingham Census Area",4,65,53,27,26
050,02,070,"Alaska","Dillingham Census Area",4,66,44,20,24
050,02,070,"Alaska","Dillingham Census Area",4,67,45,24,21
050,02,070,"Alaska","Dillingham Census Area",4,68,47,23,24
050,02,070,"Alaska","Dillingham Census Area",4,69,47,23,24
050,02,070,"Alaska","Dillingham Census Area",4,70,34,15,19
050,02,070,"Alaska","Dillingham Census Area",4,71,39,21,18
050,02,070,"Alaska","Dillingham Census Area",4,72,35,20,15
050,02,070,"Alaska","Dillingham Census Area",4,73,28,15,13
050,02,070,"Alaska","Dillingham Census Area",4,74,19,9,10
050,02,070,"Alaska","Dillingham Census Area",4,75,18,9,9
050,02,070,"Alaska","Dillingham Census Area",4,76,17,10,7
050,02,070,"Alaska","Dillingham Census Area",4,77,27,15,12
050,02,070,"Alaska","Dillingham Census Area",4,78,18,9,9
050,02,070,"Alaska","Dillingham Census Area",4,79,13,7,6
050,02,070,"Alaska","Dillingham Census Area",4,80,8,3,5
050,02,070,"Alaska","Dillingham Census Area",4,81,14,5,9
050,02,070,"Alaska","Dillingham Census Area",4,82,10,4,6
050,02,070,"Alaska","Dillingham Census Area",4,83,8,4,4
050,02,070,"Alaska","Dillingham Census Area",4,84,8,5,3
050,02,070,"Alaska","Dillingham Census Area",4,85,32,15,17
050,02,070,"Alaska","Dillingham Census Area",5,0,76,39,37
050,02,070,"Alaska","Dillingham Census Area",5,1,77,43,34
050,02,070,"Alaska","Dillingham Census Area",5,2,86,51,35
050,02,070,"Alaska","Dillingham Census Area",5,3,79,39,40
050,02,070,"Alaska","Dillingham Census Area",5,4,68,38,30
050,02,070,"Alaska","Dillingham Census Area",5,5,79,43,36
050,02,070,"Alaska","Dillingham Census Area",5,6,83,45,38
050,02,070,"Alaska","Dillingham Census Area",5,7,90,45,45
050,02,070,"Alaska","Dillingham Census Area",5,8,77,30,47
050,02,070,"Alaska","Dillingham Census Area",5,9,78,31,47
050,02,070,"Alaska","Dillingham Census Area",5,10,83,42,41
050,02,070,"Alaska","Dillingham Census Area",5,11,78,41,37
050,02,070,"Alaska","Dillingham Census Area",5,12,97,49,48
050,02,070,"Alaska","Dillingham Census Area",5,13,91,47,44
050,02,070,"Alaska","Dillingham Census Area",5,14,80,42,38
050,02,070,"Alaska","Dillingham Census Area",5,15,71,42,29
050,02,070,"Alaska","Dillingham Census Area",5,16,69,36,33
050,02,070,"Alaska","Dillingham Census Area",5,17,65,30,35
050,02,070,"Alaska","Dillingham Census Area",5,18,63,30,33
050,02,070,"Alaska","Dillingham Census Area",5,19,51,30,21
050,02,070,"Alaska","Dillingham Census Area",5,20,52,31,21
050,02,070,"Alaska","Dillingham Census Area",5,21,48,25,23
050,02,070,"Alaska","Dillingham Census Area",5,22,52,28,24
050,02,070,"Alaska","Dillingham Census Area",5,23,58,34,24
050,02,070,"Alaska","Dillingham Census Area",5,24,70,40,30
050,02,070,"Alaska","Dillingham Census Area",5,25,66,43,23
050,02,070,"Alaska","Dillingham Census Area",5,26,62,35,27
050,02,070,"Alaska","Dillingham Census Area",5,27,69,38,31
050,02,070,"Alaska","Dillingham Census Area",5,28,58,27,31
050,02,070,"Alaska","Dillingham Census Area",5,29,64,34,30
050,02,070,"Alaska","Dillingham Census Area",5,30,70,36,34
050,02,070,"Alaska","Dillingham Census Area",5,31,88,54,34
050,02,070,"Alaska","Dillingham Census Area",5,32,82,44,38
050,02,070,"Alaska","Dillingham Census Area",5,33,79,36,43
050,02,070,"Alaska","Dillingham Census Area",5,34,62,27,35
050,02,070,"Alaska","Dillingham Census Area",5,35,73,35,38
050,02,070,"Alaska","Dillingham Census Area",5,36,66,35,31
050,02,070,"Alaska","Dillingham Census Area",5,37,57,33,24
050,02,070,"Alaska","Dillingham Census Area",5,38,67,43,24
050,02,070,"Alaska","Dillingham Census Area",5,39,72,44,28
050,02,070,"Alaska","Dillingham Census Area",5,40,47,29,18
050,02,070,"Alaska","Dillingham Census Area",5,41,55,29,26
050,02,070,"Alaska","Dillingham Census Area",5,42,51,28,23
050,02,070,"Alaska","Dillingham Census Area",5,43,51,25,26
050,02,070,"Alaska","Dillingham Census Area",5,44,44,20,24
050,02,070,"Alaska","Dillingham Census Area",5,45,39,13,26
050,02,070,"Alaska","Dillingham Census Area",5,46,35,19,16
050,02,070,"Alaska","Dillingham Census Area",5,47,41,26,15
050,02,070,"Alaska","Dillingham Census Area",5,48,37,20,17
050,02,070,"Alaska","Dillingham Census Area",5,49,42,24,18
050,02,070,"Alaska","Dillingham Census Area",5,50,34,16,18
050,02,070,"Alaska","Dillingham Census Area",5,51,35,18,17
050,02,070,"Alaska","Dillingham Census Area",5,52,38,19,19
050,02,070,"Alaska","Dillingham Census Area",5,53,44,23,21
050,02,070,"Alaska","Dillingham Census Area",5,54,50,24,26
050,02,070,"Alaska","Dillingham Census Area",5,55,39,21,18
050,02,070,"Alaska","Dillingham Census Area",5,56,41,19,22
050,02,070,"Alaska","Dillingham Census Area",5,57,61,28,33
050,02,070,"Alaska","Dillingham Census Area",5,58,56,28,28
050,02,070,"Alaska","Dillingham Census Area",5,59,61,34,27
050,02,070,"Alaska","Dillingham Census Area",5,60,52,23,29
050,02,070,"Alaska","Dillingham Census Area",5,61,65,33,32
050,02,070,"Alaska","Dillingham Census Area",5,62,49,26,23
050,02,070,"Alaska","Dillingham Census Area",5,63,56,29,27
050,02,070,"Alaska","Dillingham Census Area",5,64,51,25,26
050,02,070,"Alaska","Dillingham Census Area",5,65,53,32,21
050,02,070,"Alaska","Dillingham Census Area",5,66,48,24,24
050,02,070,"Alaska","Dillingham Census Area",5,67,40,16,24
050,02,070,"Alaska","Dillingham Census Area",5,68,43,22,21
050,02,070,"Alaska","Dillingham Census Area",5,69,45,24,21
050,02,070,"Alaska","Dillingham Census Area",5,70,46,22,24
050,02,070,"Alaska","Dillingham Census Area",5,71,32,13,19
050,02,070,"Alaska","Dillingham Census Area",5,72,39,21,18
050,02,070,"Alaska","Dillingham Census Area",5,73,35,21,14
050,02,070,"Alaska","Dillingham Census Area",5,74,26,13,13
050,02,070,"Alaska","Dillingham Census Area",5,75,17,7,10
050,02,070,"Alaska","Dillingham Census Area",5,76,16,8,8
050,02,070,"Alaska","Dillingham Census Area",5,77,13,7,6
050,02,070,"Alaska","Dillingham Census Area",5,78,26,15,11
050,02,070,"Alaska","Dillingham Census Area",5,79,18,9,9
050,02,070,"Alaska","Dillingham Census Area",5,80,10,4,6
050,02,070,"Alaska","Dillingham Census Area",5,81,8,3,5
050,02,070,"Alaska","Dillingham Census Area",5,82,14,5,9
050,02,070,"Alaska","Dillingham Census Area",5,83,8,3,5
050,02,070,"Alaska","Dillingham Census Area",5,84,7,4,3
050,02,070,"Alaska","Dillingham Census Area",5,85,33,16,17
050,02,090,"Alaska","Fairbanks North Star Borough",1,0,1402,714,688
050,02,090,"Alaska","Fairbanks North Star Borough",1,1,1335,697,638
050,02,090,"Alaska","Fairbanks North Star Borough",1,2,1362,721,641
050,02,090,"Alaska","Fairbanks North Star Borough",1,3,1370,714,656
050,02,090,"Alaska","Fairbanks North Star Borough",1,4,1393,701,692
050,02,090,"Alaska","Fairbanks North Star Borough",1,5,1352,690,662
050,02,090,"Alaska","Fairbanks North Star Borough",1,6,1346,692,654
050,02,090,"Alaska","Fairbanks North Star Borough",1,7,1296,664,632
050,02,090,"Alaska","Fairbanks North Star Borough",1,8,1320,670,650
050,02,090,"Alaska","Fairbanks North Star Borough",1,9,1309,668,641
050,02,090,"Alaska","Fairbanks North Star Borough",1,10,1284,672,612
050,02,090,"Alaska","Fairbanks North Star Borough",1,11,1296,683,613
050,02,090,"Alaska","Fairbanks North Star Borough",1,12,1298,683,615
050,02,090,"Alaska","Fairbanks North Star Borough",1,13,1243,641,602
050,02,090,"Alaska","Fairbanks North Star Borough",1,14,1110,553,557
050,02,090,"Alaska","Fairbanks North Star Borough",1,15,1115,563,552
050,02,090,"Alaska","Fairbanks North Star Borough",1,16,1170,600,570
050,02,090,"Alaska","Fairbanks North Star Borough",1,17,1129,563,566
050,02,090,"Alaska","Fairbanks North Star Borough",1,18,1008,538,470
050,02,090,"Alaska","Fairbanks North Star Borough",1,19,1131,670,461
050,02,090,"Alaska","Fairbanks North Star Borough",1,20,1560,984,576
050,02,090,"Alaska","Fairbanks North Star Borough",1,21,1847,1213,634
050,02,090,"Alaska","Fairbanks North Star Borough",1,22,1910,1252,658
050,02,090,"Alaska","Fairbanks North Star Borough",1,23,1831,1144,687
050,02,090,"Alaska","Fairbanks North Star Borough",1,24,1870,1136,734
050,02,090,"Alaska","Fairbanks North Star Borough",1,25,1924,1121,803
050,02,090,"Alaska","Fairbanks North Star Borough",1,26,1827,1069,758
050,02,090,"Alaska","Fairbanks North Star Borough",1,27,1835,1054,781
050,02,090,"Alaska","Fairbanks North Star Borough",1,28,1928,1079,849
050,02,090,"Alaska","Fairbanks North Star Borough",1,29,1745,959,786
050,02,090,"Alaska","Fairbanks North Star Borough",1,30,1630,860,770
050,02,090,"Alaska","Fairbanks North Star Borough",1,31,1608,861,747
050,02,090,"Alaska","Fairbanks North Star Borough",1,32,1638,884,754
050,02,090,"Alaska","Fairbanks North Star Borough",1,33,1586,883,703
050,02,090,"Alaska","Fairbanks North Star Borough",1,34,1583,840,743
050,02,090,"Alaska","Fairbanks North Star Borough",1,35,1554,860,694
050,02,090,"Alaska","Fairbanks North Star Borough",1,36,1525,828,697
050,02,090,"Alaska","Fairbanks North Star Borough",1,37,1505,815,690
050,02,090,"Alaska","Fairbanks North Star Borough",1,38,1381,744,637
050,02,090,"Alaska","Fairbanks North Star Borough",1,39,1315,722,593
050,02,090,"Alaska","Fairbanks North Star Borough",1,40,1233,691,542
050,02,090,"Alaska","Fairbanks North Star Borough",1,41,1109,620,489
050,02,090,"Alaska","Fairbanks North Star Borough",1,42,1116,590,526
050,02,090,"Alaska","Fairbanks North Star Borough",1,43,1053,550,503
050,02,090,"Alaska","Fairbanks North Star Borough",1,44,998,514,484
050,02,090,"Alaska","Fairbanks North Star Borough",1,45,993,521,472
050,02,090,"Alaska","Fairbanks North Star Borough",1,46,952,521,431
050,02,090,"Alaska","Fairbanks North Star Borough",1,47,955,514,441
050,02,090,"Alaska","Fairbanks North Star Borough",1,48,967,501,466
050,02,090,"Alaska","Fairbanks North Star Borough",1,49,1016,542,474
050,02,090,"Alaska","Fairbanks North Star Borough",1,50,977,510,467
050,02,090,"Alaska","Fairbanks North Star Borough",1,51,914,484,430
050,02,090,"Alaska","Fairbanks North Star Borough",1,52,903,467,436
050,02,090,"Alaska","Fairbanks North Star Borough",1,53,953,500,453
050,02,090,"Alaska","Fairbanks North Star Borough",1,54,1000,497,503
050,02,090,"Alaska","Fairbanks North Star Borough",1,55,1052,559,493
050,02,090,"Alaska","Fairbanks North Star Borough",1,56,1093,551,542
050,02,090,"Alaska","Fairbanks North Star Borough",1,57,1099,563,536
050,02,090,"Alaska","Fairbanks North Star Borough",1,58,1062,544,518
050,02,090,"Alaska","Fairbanks North Star Borough",1,59,1067,543,524
050,02,090,"Alaska","Fairbanks North Star Borough",1,60,1083,556,527
050,02,090,"Alaska","Fairbanks North Star Borough",1,61,1010,521,489
050,02,090,"Alaska","Fairbanks North Star Borough",1,62,1038,544,494
050,02,090,"Alaska","Fairbanks North Star Borough",1,63,1010,507,503
050,02,090,"Alaska","Fairbanks North Star Borough",1,64,1004,497,507
050,02,090,"Alaska","Fairbanks North Star Borough",1,65,1010,500,510
050,02,090,"Alaska","Fairbanks North Star Borough",1,66,956,489,467
050,02,090,"Alaska","Fairbanks North Star Borough",1,67,880,483,397
050,02,090,"Alaska","Fairbanks North Star Borough",1,68,871,468,403
050,02,090,"Alaska","Fairbanks North Star Borough",1,69,799,420,379
050,02,090,"Alaska","Fairbanks North Star Borough",1,70,768,426,342
050,02,090,"Alaska","Fairbanks North Star Borough",1,71,672,365,307
050,02,090,"Alaska","Fairbanks North Star Borough",1,72,639,349,290
050,02,090,"Alaska","Fairbanks North Star Borough",1,73,649,356,293
050,02,090,"Alaska","Fairbanks North Star Borough",1,74,477,257,220
050,02,090,"Alaska","Fairbanks North Star Borough",1,75,474,251,223
050,02,090,"Alaska","Fairbanks North Star Borough",1,76,381,194,187
050,02,090,"Alaska","Fairbanks North Star Borough",1,77,372,189,183
050,02,090,"Alaska","Fairbanks North Star Borough",1,78,304,149,155
050,02,090,"Alaska","Fairbanks North Star Borough",1,79,273,133,140
050,02,090,"Alaska","Fairbanks North Star Borough",1,80,225,120,105
050,02,090,"Alaska","Fairbanks North Star Borough",1,81,193,90,103
050,02,090,"Alaska","Fairbanks North Star Borough",1,82,183,85,98
050,02,090,"Alaska","Fairbanks North Star Borough",1,83,173,82,91
050,02,090,"Alaska","Fairbanks North Star Borough",1,84,141,58,83
050,02,090,"Alaska","Fairbanks North Star Borough",1,85,692,262,430
050,02,090,"Alaska","Fairbanks North Star Borough",2,0,1364,698,666
050,02,090,"Alaska","Fairbanks North Star Borough",2,1,1323,690,633
050,02,090,"Alaska","Fairbanks North Star Borough",2,2,1340,707,633
050,02,090,"Alaska","Fairbanks North Star Borough",2,3,1353,705,648
050,02,090,"Alaska","Fairbanks North Star Borough",2,4,1382,697,685
050,02,090,"Alaska","Fairbanks North Star Borough",2,5,1353,685,668
050,02,090,"Alaska","Fairbanks North Star Borough",2,6,1340,688,652
050,02,090,"Alaska","Fairbanks North Star Borough",2,7,1298,663,635
050,02,090,"Alaska","Fairbanks North Star Borough",2,8,1304,661,643
050,02,090,"Alaska","Fairbanks North Star Borough",2,9,1304,667,637
050,02,090,"Alaska","Fairbanks North Star Borough",2,10,1280,667,613
050,02,090,"Alaska","Fairbanks North Star Borough",2,11,1280,675,605
050,02,090,"Alaska","Fairbanks North Star Borough",2,12,1292,680,612
050,02,090,"Alaska","Fairbanks North Star Borough",2,13,1242,641,601
050,02,090,"Alaska","Fairbanks North Star Borough",2,14,1134,570,564
050,02,090,"Alaska","Fairbanks North Star Borough",2,15,1108,557,551
050,02,090,"Alaska","Fairbanks North Star Borough",2,16,1155,589,566
050,02,090,"Alaska","Fairbanks North Star Borough",2,17,1130,566,564
050,02,090,"Alaska","Fairbanks North Star Borough",2,18,1044,560,484
050,02,090,"Alaska","Fairbanks North Star Borough",2,19,1151,679,472
050,02,090,"Alaska","Fairbanks North Star Borough",2,20,1550,975,575
050,02,090,"Alaska","Fairbanks North Star Borough",2,21,1800,1180,620
050,02,090,"Alaska","Fairbanks North Star Borough",2,22,1887,1231,656
050,02,090,"Alaska","Fairbanks North Star Borough",2,23,1822,1139,683
050,02,090,"Alaska","Fairbanks North Star Borough",2,24,1842,1119,723
050,02,090,"Alaska","Fairbanks North Star Borough",2,25,1885,1104,781
050,02,090,"Alaska","Fairbanks North Star Borough",2,26,1824,1061,763
050,02,090,"Alaska","Fairbanks North Star Borough",2,27,1814,1048,766
050,02,090,"Alaska","Fairbanks North Star Borough",2,28,1883,1061,822
050,02,090,"Alaska","Fairbanks North Star Borough",2,29,1763,966,797
050,02,090,"Alaska","Fairbanks North Star Borough",2,30,1643,874,769
050,02,090,"Alaska","Fairbanks North Star Borough",2,31,1596,852,744
050,02,090,"Alaska","Fairbanks North Star Borough",2,32,1624,877,747
050,02,090,"Alaska","Fairbanks North Star Borough",2,33,1586,873,713
050,02,090,"Alaska","Fairbanks North Star Borough",2,34,1573,847,726
050,02,090,"Alaska","Fairbanks North Star Borough",2,35,1552,850,702
050,02,090,"Alaska","Fairbanks North Star Borough",2,36,1519,829,690
050,02,090,"Alaska","Fairbanks North Star Borough",2,37,1504,811,693
050,02,090,"Alaska","Fairbanks North Star Borough",2,38,1406,762,644
050,02,090,"Alaska","Fairbanks North Star Borough",2,39,1318,720,598
050,02,090,"Alaska","Fairbanks North Star Borough",2,40,1246,694,552
050,02,090,"Alaska","Fairbanks North Star Borough",2,41,1129,631,498
050,02,090,"Alaska","Fairbanks North Star Borough",2,42,1098,590,508
050,02,090,"Alaska","Fairbanks North Star Borough",2,43,1074,564,510
050,02,090,"Alaska","Fairbanks North Star Borough",2,44,987,510,477
050,02,090,"Alaska","Fairbanks North Star Borough",2,45,988,518,470
050,02,090,"Alaska","Fairbanks North Star Borough",2,46,952,514,438
050,02,090,"Alaska","Fairbanks North Star Borough",2,47,941,507,434
050,02,090,"Alaska","Fairbanks North Star Borough",2,48,960,503,457
050,02,090,"Alaska","Fairbanks North Star Borough",2,49,1001,531,470
050,02,090,"Alaska","Fairbanks North Star Borough",2,50,984,518,466
050,02,090,"Alaska","Fairbanks North Star Borough",2,51,919,483,436
050,02,090,"Alaska","Fairbanks North Star Borough",2,52,894,464,430
050,02,090,"Alaska","Fairbanks North Star Borough",2,53,930,486,444
050,02,090,"Alaska","Fairbanks North Star Borough",2,54,981,495,486
050,02,090,"Alaska","Fairbanks North Star Borough",2,55,1031,540,491
050,02,090,"Alaska","Fairbanks North Star Borough",2,56,1077,549,528
050,02,090,"Alaska","Fairbanks North Star Borough",2,57,1093,559,534
050,02,090,"Alaska","Fairbanks North Star Borough",2,58,1060,543,517
050,02,090,"Alaska","Fairbanks North Star Borough",2,59,1065,544,521
050,02,090,"Alaska","Fairbanks North Star Borough",2,60,1067,546,521
050,02,090,"Alaska","Fairbanks North Star Borough",2,61,1008,517,491
050,02,090,"Alaska","Fairbanks North Star Borough",2,62,1019,534,485
050,02,090,"Alaska","Fairbanks North Star Borough",2,63,1019,518,501
050,02,090,"Alaska","Fairbanks North Star Borough",2,64,991,492,499
050,02,090,"Alaska","Fairbanks North Star Borough",2,65,995,493,502
050,02,090,"Alaska","Fairbanks North Star Borough",2,66,964,488,476
050,02,090,"Alaska","Fairbanks North Star Borough",2,67,889,479,410
050,02,090,"Alaska","Fairbanks North Star Borough",2,68,861,464,397
050,02,090,"Alaska","Fairbanks North Star Borough",2,69,818,432,386
050,02,090,"Alaska","Fairbanks North Star Borough",2,70,769,421,348
050,02,090,"Alaska","Fairbanks North Star Borough",2,71,691,376,315
050,02,090,"Alaska","Fairbanks North Star Borough",2,72,633,349,284
050,02,090,"Alaska","Fairbanks North Star Borough",2,73,669,368,301
050,02,090,"Alaska","Fairbanks North Star Borough",2,74,480,261,219
050,02,090,"Alaska","Fairbanks North Star Borough",2,75,476,250,226
050,02,090,"Alaska","Fairbanks North Star Borough",2,76,397,204,193
050,02,090,"Alaska","Fairbanks North Star Borough",2,77,384,193,191
050,02,090,"Alaska","Fairbanks North Star Borough",2,78,309,153,156
050,02,090,"Alaska","Fairbanks North Star Borough",2,79,273,134,139
050,02,090,"Alaska","Fairbanks North Star Borough",2,80,232,120,112
050,02,090,"Alaska","Fairbanks North Star Borough",2,81,199,97,102
050,02,090,"Alaska","Fairbanks North Star Borough",2,82,184,84,100
050,02,090,"Alaska","Fairbanks North Star Borough",2,83,173,81,92
050,02,090,"Alaska","Fairbanks North Star Borough",2,84,149,64,85
050,02,090,"Alaska","Fairbanks North Star Borough",2,85,710,271,439
050,02,090,"Alaska","Fairbanks North Star Borough",3,0,1384,686,698
050,02,090,"Alaska","Fairbanks North Star Borough",3,1,1357,674,683
050,02,090,"Alaska","Fairbanks North Star Borough",3,2,1287,668,619
050,02,090,"Alaska","Fairbanks North Star Borough",3,3,1350,711,639
050,02,090,"Alaska","Fairbanks North Star Borough",3,4,1398,723,675
050,02,090,"Alaska","Fairbanks North Star Borough",3,5,1330,674,656
050,02,090,"Alaska","Fairbanks North Star Borough",3,6,1313,682,631
050,02,090,"Alaska","Fairbanks North Star Borough",3,7,1324,673,651
050,02,090,"Alaska","Fairbanks North Star Borough",3,8,1281,664,617
050,02,090,"Alaska","Fairbanks North Star Borough",3,9,1279,646,633
050,02,090,"Alaska","Fairbanks North Star Borough",3,10,1260,659,601
050,02,090,"Alaska","Fairbanks North Star Borough",3,11,1231,635,596
050,02,090,"Alaska","Fairbanks North Star Borough",3,12,1237,662,575
050,02,090,"Alaska","Fairbanks North Star Borough",3,13,1253,659,594
050,02,090,"Alaska","Fairbanks North Star Borough",3,14,1213,638,575
050,02,090,"Alaska","Fairbanks North Star Borough",3,15,1096,551,545
050,02,090,"Alaska","Fairbanks North Star Borough",3,16,1082,538,544
050,02,090,"Alaska","Fairbanks North Star Borough",3,17,1134,581,553
050,02,090,"Alaska","Fairbanks North Star Borough",3,18,1081,566,515
050,02,090,"Alaska","Fairbanks North Star Borough",3,19,1188,691,497
050,02,090,"Alaska","Fairbanks North Star Borough",3,20,1670,1065,605
050,02,090,"Alaska","Fairbanks North Star Borough",3,21,1804,1152,652
050,02,090,"Alaska","Fairbanks North Star Borough",3,22,1830,1169,661
050,02,090,"Alaska","Fairbanks North Star Borough",3,23,1803,1116,687
050,02,090,"Alaska","Fairbanks North Star Borough",3,24,1838,1146,692
050,02,090,"Alaska","Fairbanks North Star Borough",3,25,1813,1059,754
050,02,090,"Alaska","Fairbanks North Star Borough",3,26,1849,1041,808
050,02,090,"Alaska","Fairbanks North Star Borough",3,27,1807,1057,750
050,02,090,"Alaska","Fairbanks North Star Borough",3,28,1842,1067,775
050,02,090,"Alaska","Fairbanks North Star Borough",3,29,1860,1043,817
050,02,090,"Alaska","Fairbanks North Star Borough",3,30,1713,927,786
050,02,090,"Alaska","Fairbanks North Star Borough",3,31,1641,867,774
050,02,090,"Alaska","Fairbanks North Star Borough",3,32,1602,852,750
050,02,090,"Alaska","Fairbanks North Star Borough",3,33,1599,847,752
050,02,090,"Alaska","Fairbanks North Star Borough",3,34,1598,873,725
050,02,090,"Alaska","Fairbanks North Star Borough",3,35,1554,845,709
050,02,090,"Alaska","Fairbanks North Star Borough",3,36,1530,841,689
050,02,090,"Alaska","Fairbanks North Star Borough",3,37,1480,813,667
050,02,090,"Alaska","Fairbanks North Star Borough",3,38,1468,792,676
050,02,090,"Alaska","Fairbanks North Star Borough",3,39,1370,740,630
050,02,090,"Alaska","Fairbanks North Star Borough",3,40,1269,689,580
050,02,090,"Alaska","Fairbanks North Star Borough",3,41,1209,682,527
050,02,090,"Alaska","Fairbanks North Star Borough",3,42,1132,625,507
050,02,090,"Alaska","Fairbanks North Star Borough",3,43,1080,574,506
050,02,090,"Alaska","Fairbanks North Star Borough",3,44,1047,550,497
050,02,090,"Alaska","Fairbanks North Star Borough",3,45,980,510,470
050,02,090,"Alaska","Fairbanks North Star Borough",3,46,954,492,462
050,02,090,"Alaska","Fairbanks North Star Borough",3,47,920,489,431
050,02,090,"Alaska","Fairbanks North Star Borough",3,48,930,492,438
050,02,090,"Alaska","Fairbanks North Star Borough",3,49,933,500,433
050,02,090,"Alaska","Fairbanks North Star Borough",3,50,987,542,445
050,02,090,"Alaska","Fairbanks North Star Borough",3,51,941,486,455
050,02,090,"Alaska","Fairbanks North Star Borough",3,52,892,467,425
050,02,090,"Alaska","Fairbanks North Star Borough",3,53,894,470,424
050,02,090,"Alaska","Fairbanks North Star Borough",3,54,929,487,442
050,02,090,"Alaska","Fairbanks North Star Borough",3,55,945,472,473
050,02,090,"Alaska","Fairbanks North Star Borough",3,56,974,503,471
050,02,090,"Alaska","Fairbanks North Star Borough",3,57,1044,538,506
050,02,090,"Alaska","Fairbanks North Star Borough",3,58,1054,533,521
050,02,090,"Alaska","Fairbanks North Star Borough",3,59,1010,512,498
050,02,090,"Alaska","Fairbanks North Star Borough",3,60,1026,517,509
050,02,090,"Alaska","Fairbanks North Star Borough",3,61,1035,531,504
050,02,090,"Alaska","Fairbanks North Star Borough",3,62,970,510,460
050,02,090,"Alaska","Fairbanks North Star Borough",3,63,983,520,463
050,02,090,"Alaska","Fairbanks North Star Borough",3,64,995,501,494
050,02,090,"Alaska","Fairbanks North Star Borough",3,65,947,467,480
050,02,090,"Alaska","Fairbanks North Star Borough",3,66,964,469,495
050,02,090,"Alaska","Fairbanks North Star Borough",3,67,935,474,461
050,02,090,"Alaska","Fairbanks North Star Borough",3,68,856,460,396
050,02,090,"Alaska","Fairbanks North Star Borough",3,69,836,452,384
050,02,090,"Alaska","Fairbanks North Star Borough",3,70,787,418,369
050,02,090,"Alaska","Fairbanks North Star Borough",3,71,729,400,329
050,02,090,"Alaska","Fairbanks North Star Borough",3,72,669,361,308
050,02,090,"Alaska","Fairbanks North Star Borough",3,73,614,342,272
050,02,090,"Alaska","Fairbanks North Star Borough",3,74,645,353,292
050,02,090,"Alaska","Fairbanks North Star Borough",3,75,472,256,216
050,02,090,"Alaska","Fairbanks North Star Borough",3,76,453,237,216
050,02,090,"Alaska","Fairbanks North Star Borough",3,77,392,194,198
050,02,090,"Alaska","Fairbanks North Star Borough",3,78,368,183,185
050,02,090,"Alaska","Fairbanks North Star Borough",3,79,275,137,138
050,02,090,"Alaska","Fairbanks North Star Borough",3,80,257,125,132
050,02,090,"Alaska","Fairbanks North Star Borough",3,81,221,112,109
050,02,090,"Alaska","Fairbanks North Star Borough",3,82,196,94,102
050,02,090,"Alaska","Fairbanks North Star Borough",3,83,182,84,98
050,02,090,"Alaska","Fairbanks North Star Borough",3,84,168,77,91
050,02,090,"Alaska","Fairbanks North Star Borough",3,85,745,278,467
050,02,090,"Alaska","Fairbanks North Star Borough",4,0,1433,760,673
050,02,090,"Alaska","Fairbanks North Star Borough",4,1,1374,692,682
050,02,090,"Alaska","Fairbanks North Star Borough",4,2,1312,660,652
050,02,090,"Alaska","Fairbanks North Star Borough",4,3,1256,656,600
050,02,090,"Alaska","Fairbanks North Star Borough",4,4,1315,693,622
050,02,090,"Alaska","Fairbanks North Star Borough",4,5,1378,697,681
050,02,090,"Alaska","Fairbanks North Star Borough",4,6,1280,649,631
050,02,090,"Alaska","Fairbanks North Star Borough",4,7,1307,660,647
050,02,090,"Alaska","Fairbanks North Star Borough",4,8,1301,649,652
050,02,090,"Alaska","Fairbanks North Star Borough",4,9,1287,662,625
050,02,090,"Alaska","Fairbanks North Star Borough",4,10,1286,633,653
050,02,090,"Alaska","Fairbanks North Star Borough",4,11,1252,662,590
050,02,090,"Alaska","Fairbanks North Star Borough",4,12,1194,612,582
050,02,090,"Alaska","Fairbanks North Star Borough",4,13,1212,649,563
050,02,090,"Alaska","Fairbanks North Star Borough",4,14,1216,650,566
050,02,090,"Alaska","Fairbanks North Star Borough",4,15,1183,626,557
050,02,090,"Alaska","Fairbanks North Star Borough",4,16,1067,536,531
050,02,090,"Alaska","Fairbanks North Star Borough",4,17,1029,518,511
050,02,090,"Alaska","Fairbanks North Star Borough",4,18,987,536,451
050,02,090,"Alaska","Fairbanks North Star Borough",4,19,1028,598,430
050,02,090,"Alaska","Fairbanks North Star Borough",4,20,1489,949,540
050,02,090,"Alaska","Fairbanks North Star Borough",4,21,1857,1242,615
050,02,090,"Alaska","Fairbanks North Star Borough",4,22,1795,1111,684
050,02,090,"Alaska","Fairbanks North Star Borough",4,23,1757,1058,699
050,02,090,"Alaska","Fairbanks North Star Borough",4,24,1780,1079,701
050,02,090,"Alaska","Fairbanks North Star Borough",4,25,1880,1130,750
050,02,090,"Alaska","Fairbanks North Star Borough",4,26,1829,1079,750
050,02,090,"Alaska","Fairbanks North Star Borough",4,27,1819,1008,811
050,02,090,"Alaska","Fairbanks North Star Borough",4,28,1794,1032,762
050,02,090,"Alaska","Fairbanks North Star Borough",4,29,1783,1015,768
050,02,090,"Alaska","Fairbanks North Star Borough",4,30,1827,1036,791
050,02,090,"Alaska","Fairbanks North Star Borough",4,31,1670,917,753
050,02,090,"Alaska","Fairbanks North Star Borough",4,32,1637,862,775
050,02,090,"Alaska","Fairbanks North Star Borough",4,33,1586,848,738
050,02,090,"Alaska","Fairbanks North Star Borough",4,34,1603,846,757
050,02,090,"Alaska","Fairbanks North Star Borough",4,35,1568,868,700
050,02,090,"Alaska","Fairbanks North Star Borough",4,36,1570,854,716
050,02,090,"Alaska","Fairbanks North Star Borough",4,37,1504,814,690
050,02,090,"Alaska","Fairbanks North Star Borough",4,38,1433,785,648
050,02,090,"Alaska","Fairbanks North Star Borough",4,39,1402,752,650
050,02,090,"Alaska","Fairbanks North Star Borough",4,40,1335,719,616
050,02,090,"Alaska","Fairbanks North Star Borough",4,41,1234,662,572
050,02,090,"Alaska","Fairbanks North Star Borough",4,42,1176,662,514
050,02,090,"Alaska","Fairbanks North Star Borough",4,43,1111,610,501
050,02,090,"Alaska","Fairbanks North Star Borough",4,44,1035,548,487
050,02,090,"Alaska","Fairbanks North Star Borough",4,45,1043,548,495
050,02,090,"Alaska","Fairbanks North Star Borough",4,46,943,482,461
050,02,090,"Alaska","Fairbanks North Star Borough",4,47,920,468,452
050,02,090,"Alaska","Fairbanks North Star Borough",4,48,909,477,432
050,02,090,"Alaska","Fairbanks North Star Borough",4,49,921,491,430
050,02,090,"Alaska","Fairbanks North Star Borough",4,50,931,495,436
050,02,090,"Alaska","Fairbanks North Star Borough",4,51,968,529,439
050,02,090,"Alaska","Fairbanks North Star Borough",4,52,916,467,449
050,02,090,"Alaska","Fairbanks North Star Borough",4,53,887,468,419
050,02,090,"Alaska","Fairbanks North Star Borough",4,54,877,465,412
050,02,090,"Alaska","Fairbanks North Star Borough",4,55,887,471,416
050,02,090,"Alaska","Fairbanks North Star Borough",4,56,908,445,463
050,02,090,"Alaska","Fairbanks North Star Borough",4,57,963,497,466
050,02,090,"Alaska","Fairbanks North Star Borough",4,58,1004,520,484
050,02,090,"Alaska","Fairbanks North Star Borough",4,59,1012,503,509
050,02,090,"Alaska","Fairbanks North Star Borough",4,60,981,501,480
050,02,090,"Alaska","Fairbanks North Star Borough",4,61,999,503,496
050,02,090,"Alaska","Fairbanks North Star Borough",4,62,1011,525,486
050,02,090,"Alaska","Fairbanks North Star Borough",4,63,946,493,453
050,02,090,"Alaska","Fairbanks North Star Borough",4,64,951,502,449
050,02,090,"Alaska","Fairbanks North Star Borough",4,65,962,485,477
050,02,090,"Alaska","Fairbanks North Star Borough",4,66,909,447,462
050,02,090,"Alaska","Fairbanks North Star Borough",4,67,921,446,475
050,02,090,"Alaska","Fairbanks North Star Borough",4,68,900,453,447
050,02,090,"Alaska","Fairbanks North Star Borough",4,69,819,437,382
050,02,090,"Alaska","Fairbanks North Star Borough",4,70,797,433,364
050,02,090,"Alaska","Fairbanks North Star Borough",4,71,746,400,346
050,02,090,"Alaska","Fairbanks North Star Borough",4,72,716,392,324
050,02,090,"Alaska","Fairbanks North Star Borough",4,73,649,350,299
050,02,090,"Alaska","Fairbanks North Star Borough",4,74,583,319,264
050,02,090,"Alaska","Fairbanks North Star Borough",4,75,613,333,280
050,02,090,"Alaska","Fairbanks North Star Borough",4,76,429,236,193
050,02,090,"Alaska","Fairbanks North Star Borough",4,77,460,235,225
050,02,090,"Alaska","Fairbanks North Star Borough",4,78,374,186,188
050,02,090,"Alaska","Fairbanks North Star Borough",4,79,326,166,160
050,02,090,"Alaska","Fairbanks North Star Borough",4,80,250,125,125
050,02,090,"Alaska","Fairbanks North Star Borough",4,81,242,112,130
050,02,090,"Alaska","Fairbanks North Star Borough",4,82,213,104,109
050,02,090,"Alaska","Fairbanks North Star Borough",4,83,186,85,101
050,02,090,"Alaska","Fairbanks North Star Borough",4,84,182,79,103
050,02,090,"Alaska","Fairbanks North Star Borough",4,85,777,294,483
050,02,090,"Alaska","Fairbanks North Star Borough",5,0,1414,741,673
050,02,090,"Alaska","Fairbanks North Star Borough",5,1,1346,721,625
050,02,090,"Alaska","Fairbanks North Star Borough",5,2,1329,683,646
050,02,090,"Alaska","Fairbanks North Star Borough",5,3,1328,678,650
050,02,090,"Alaska","Fairbanks North Star Borough",5,4,1246,660,586
050,02,090,"Alaska","Fairbanks North Star Borough",5,5,1247,659,588
050,02,090,"Alaska","Fairbanks North Star Borough",5,6,1328,662,666
050,02,090,"Alaska","Fairbanks North Star Borough",5,7,1248,628,620
050,02,090,"Alaska","Fairbanks North Star Borough",5,8,1271,634,637
050,02,090,"Alaska","Fairbanks North Star Borough",5,9,1263,623,640
050,02,090,"Alaska","Fairbanks North Star Borough",5,10,1264,655,609
050,02,090,"Alaska","Fairbanks North Star Borough",5,11,1258,627,631
050,02,090,"Alaska","Fairbanks North Star Borough",5,12,1222,649,573
050,02,090,"Alaska","Fairbanks North Star Borough",5,13,1160,591,569
050,02,090,"Alaska","Fairbanks North Star Borough",5,14,1199,644,555
050,02,090,"Alaska","Fairbanks North Star Borough",5,15,1201,638,563
050,02,090,"Alaska","Fairbanks North Star Borough",5,16,1160,613,547
050,02,090,"Alaska","Fairbanks North Star Borough",5,17,1051,533,518
050,02,090,"Alaska","Fairbanks North Star Borough",5,18,931,492,439
050,02,090,"Alaska","Fairbanks North Star Borough",5,19,1030,590,440
050,02,090,"Alaska","Fairbanks North Star Borough",5,20,1402,862,540
050,02,090,"Alaska","Fairbanks North Star Borough",5,21,1692,1117,575
050,02,090,"Alaska","Fairbanks North Star Borough",5,22,1946,1266,680
050,02,090,"Alaska","Fairbanks North Star Borough",5,23,1697,1007,690
050,02,090,"Alaska","Fairbanks North Star Borough",5,24,1805,1063,742
050,02,090,"Alaska","Fairbanks North Star Borough",5,25,1793,1080,713
050,02,090,"Alaska","Fairbanks North Star Borough",5,26,1852,1099,753
050,02,090,"Alaska","Fairbanks North Star Borough",5,27,1789,1039,750
050,02,090,"Alaska","Fairbanks North Star Borough",5,28,1776,990,786
050,02,090,"Alaska","Fairbanks North Star Borough",5,29,1730,972,758
050,02,090,"Alaska","Fairbanks North Star Borough",5,30,1760,1011,749
050,02,090,"Alaska","Fairbanks North Star Borough",5,31,1781,1003,778
050,02,090,"Alaska","Fairbanks North Star Borough",5,32,1651,903,748
050,02,090,"Alaska","Fairbanks North Star Borough",5,33,1635,870,765
050,02,090,"Alaska","Fairbanks North Star Borough",5,34,1607,870,737
050,02,090,"Alaska","Fairbanks North Star Borough",5,35,1550,795,755
050,02,090,"Alaska","Fairbanks North Star Borough",5,36,1536,853,683
050,02,090,"Alaska","Fairbanks North Star Borough",5,37,1544,840,704
050,02,090,"Alaska","Fairbanks North Star Borough",5,38,1495,807,688
050,02,090,"Alaska","Fairbanks North Star Borough",5,39,1352,740,612
050,02,090,"Alaska","Fairbanks North Star Borough",5,40,1355,724,631
050,02,090,"Alaska","Fairbanks North Star Borough",5,41,1333,727,606
050,02,090,"Alaska","Fairbanks North Star Borough",5,42,1198,637,561
050,02,090,"Alaska","Fairbanks North Star Borough",5,43,1155,652,503
050,02,090,"Alaska","Fairbanks North Star Borough",5,44,1073,592,481
050,02,090,"Alaska","Fairbanks North Star Borough",5,45,1027,539,488
050,02,090,"Alaska","Fairbanks North Star Borough",5,46,992,514,478
050,02,090,"Alaska","Fairbanks North Star Borough",5,47,905,459,446
050,02,090,"Alaska","Fairbanks North Star Borough",5,48,889,450,439
050,02,090,"Alaska","Fairbanks North Star Borough",5,49,880,471,409
050,02,090,"Alaska","Fairbanks North Star Borough",5,50,918,492,426
050,02,090,"Alaska","Fairbanks North Star Borough",5,51,918,477,441
050,02,090,"Alaska","Fairbanks North Star Borough",5,52,937,509,428
050,02,090,"Alaska","Fairbanks North Star Borough",5,53,882,447,435
050,02,090,"Alaska","Fairbanks North Star Borough",5,54,873,462,411
050,02,090,"Alaska","Fairbanks North Star Borough",5,55,833,445,388
050,02,090,"Alaska","Fairbanks North Star Borough",5,56,842,456,386
050,02,090,"Alaska","Fairbanks North Star Borough",5,57,899,439,460
050,02,090,"Alaska","Fairbanks North Star Borough",5,58,910,461,449
050,02,090,"Alaska","Fairbanks North Star Borough",5,59,953,493,460
050,02,090,"Alaska","Fairbanks North Star Borough",5,60,985,486,499
050,02,090,"Alaska","Fairbanks North Star Borough",5,61,941,491,450
050,02,090,"Alaska","Fairbanks North Star Borough",5,62,965,492,473
050,02,090,"Alaska","Fairbanks North Star Borough",5,63,967,504,463
050,02,090,"Alaska","Fairbanks North Star Borough",5,64,926,485,441
050,02,090,"Alaska","Fairbanks North Star Borough",5,65,927,499,428
050,02,090,"Alaska","Fairbanks North Star Borough",5,66,935,467,468
050,02,090,"Alaska","Fairbanks North Star Borough",5,67,862,420,442
050,02,090,"Alaska","Fairbanks North Star Borough",5,68,882,429,453
050,02,090,"Alaska","Fairbanks North Star Borough",5,69,875,440,435
050,02,090,"Alaska","Fairbanks North Star Borough",5,70,794,428,366
050,02,090,"Alaska","Fairbanks North Star Borough",5,71,753,403,350
050,02,090,"Alaska","Fairbanks North Star Borough",5,72,733,392,341
050,02,090,"Alaska","Fairbanks North Star Borough",5,73,690,379,311
050,02,090,"Alaska","Fairbanks North Star Borough",5,74,614,329,285
050,02,090,"Alaska","Fairbanks North Star Borough",5,75,567,309,258
050,02,090,"Alaska","Fairbanks North Star Borough",5,76,575,313,262
050,02,090,"Alaska","Fairbanks North Star Borough",5,77,433,237,196
050,02,090,"Alaska","Fairbanks North Star Borough",5,78,440,227,213
050,02,090,"Alaska","Fairbanks North Star Borough",5,79,337,170,167
050,02,090,"Alaska","Fairbanks North Star Borough",5,80,297,150,147
050,02,090,"Alaska","Fairbanks North Star Borough",5,81,233,114,119
050,02,090,"Alaska","Fairbanks North Star Borough",5,82,233,105,128
050,02,090,"Alaska","Fairbanks North Star Borough",5,83,207,100,107
050,02,090,"Alaska","Fairbanks North Star Borough",5,84,180,76,104
050,02,090,"Alaska","Fairbanks North Star Borough",5,85,828,315,513
050,02,100,"Alaska","Haines Borough",1,0,15,8,7
050,02,100,"Alaska","Haines Borough",1,1,18,9,9
050,02,100,"Alaska","Haines Borough",1,2,21,12,9
050,02,100,"Alaska","Haines Borough",1,3,16,9,7
050,02,100,"Alaska","Haines Borough",1,4,16,9,7
050,02,100,"Alaska","Haines Borough",1,5,18,8,10
050,02,100,"Alaska","Haines Borough",1,6,14,6,8
050,02,100,"Alaska","Haines Borough",1,7,14,5,9
050,02,100,"Alaska","Haines Borough",1,8,21,9,12
050,02,100,"Alaska","Haines Borough",1,9,25,14,11
050,02,100,"Alaska","Haines Borough",1,10,19,7,12
050,02,100,"Alaska","Haines Borough",1,11,21,10,11
050,02,100,"Alaska","Haines Borough",1,12,20,14,6
050,02,100,"Alaska","Haines Borough",1,13,23,10,13
050,02,100,"Alaska","Haines Borough",1,14,23,13,10
050,02,100,"Alaska","Haines Borough",1,15,29,15,14
050,02,100,"Alaska","Haines Borough",1,16,28,12,16
050,02,100,"Alaska","Haines Borough",1,17,26,12,14
050,02,100,"Alaska","Haines Borough",1,18,28,15,13
050,02,100,"Alaska","Haines Borough",1,19,17,10,7
050,02,100,"Alaska","Haines Borough",1,20,16,7,9
050,02,100,"Alaska","Haines Borough",1,21,16,8,8
050,02,100,"Alaska","Haines Borough",1,22,16,8,8
050,02,100,"Alaska","Haines Borough",1,23,21,11,10
050,02,100,"Alaska","Haines Borough",1,24,18,10,8
050,02,100,"Alaska","Haines Borough",1,25,27,17,10
050,02,100,"Alaska","Haines Borough",1,26,20,13,7
050,02,100,"Alaska","Haines Borough",1,27,19,13,6
050,02,100,"Alaska","Haines Borough",1,28,22,13,9
050,02,100,"Alaska","Haines Borough",1,29,20,8,12
050,02,100,"Alaska","Haines Borough",1,30,11,8,3
050,02,100,"Alaska","Haines Borough",1,31,19,10,9
050,02,100,"Alaska","Haines Borough",1,32,24,11,13
050,02,100,"Alaska","Haines Borough",1,33,20,8,12
050,02,100,"Alaska","Haines Borough",1,34,22,12,10
050,02,100,"Alaska","Haines Borough",1,35,22,12,10
050,02,100,"Alaska","Haines Borough",1,36,32,16,16
050,02,100,"Alaska","Haines Borough",1,37,29,15,14
050,02,100,"Alaska","Haines Borough",1,38,25,12,13
050,02,100,"Alaska","Haines Borough",1,39,24,12,12
050,02,100,"Alaska","Haines Borough",1,40,21,11,10
050,02,100,"Alaska","Haines Borough",1,41,26,13,13
050,02,100,"Alaska","Haines Borough",1,42,19,12,7
050,02,100,"Alaska","Haines Borough",1,43,25,14,11
050,02,100,"Alaska","Haines Borough",1,44,25,14,11
050,02,100,"Alaska","Haines Borough",1,45,25,13,12
050,02,100,"Alaska","Haines Borough",1,46,28,14,14
050,02,100,"Alaska","Haines Borough",1,47,20,11,9
050,02,100,"Alaska","Haines Borough",1,48,17,9,8
050,02,100,"Alaska","Haines Borough",1,49,24,14,10
050,02,100,"Alaska","Haines Borough",1,50,33,17,16
050,02,100,"Alaska","Haines Borough",1,51,31,12,19
050,02,100,"Alaska","Haines Borough",1,52,25,12,13
050,02,100,"Alaska","Haines Borough",1,53,27,15,12
050,02,100,"Alaska","Haines Borough",1,54,24,14,10
050,02,100,"Alaska","Haines Borough",1,55,33,15,18
050,02,100,"Alaska","Haines Borough",1,56,35,18,17
050,02,100,"Alaska","Haines Borough",1,57,39,22,17
050,02,100,"Alaska","Haines Borough",1,58,44,22,22
050,02,100,"Alaska","Haines Borough",1,59,36,21,15
050,02,100,"Alaska","Haines Borough",1,60,31,20,11
050,02,100,"Alaska","Haines Borough",1,61,39,21,18
050,02,100,"Alaska","Haines Borough",1,62,46,22,24
050,02,100,"Alaska","Haines Borough",1,63,44,23,21
050,02,100,"Alaska","Haines Borough",1,64,42,22,20
050,02,100,"Alaska","Haines Borough",1,65,40,22,18
050,02,100,"Alaska","Haines Borough",1,66,33,16,17
050,02,100,"Alaska","Haines Borough",1,67,43,24,19
050,02,100,"Alaska","Haines Borough",1,68,38,21,17
050,02,100,"Alaska","Haines Borough",1,69,33,18,15
050,02,100,"Alaska","Haines Borough",1,70,30,14,16
050,02,100,"Alaska","Haines Borough",1,71,35,15,20
050,02,100,"Alaska","Haines Borough",1,72,35,19,16
050,02,100,"Alaska","Haines Borough",1,73,29,16,13
050,02,100,"Alaska","Haines Borough",1,74,22,13,9
050,02,100,"Alaska","Haines Borough",1,75,19,9,10
050,02,100,"Alaska","Haines Borough",1,76,15,8,7
050,02,100,"Alaska","Haines Borough",1,77,12,5,7
050,02,100,"Alaska","Haines Borough",1,78,11,6,5
050,02,100,"Alaska","Haines Borough",1,79,15,9,6
050,02,100,"Alaska","Haines Borough",1,80,7,2,5
050,02,100,"Alaska","Haines Borough",1,81,10,4,6
050,02,100,"Alaska","Haines Borough",1,82,12,5,7
050,02,100,"Alaska","Haines Borough",1,83,6,2,4
050,02,100,"Alaska","Haines Borough",1,84,4,1,3
050,02,100,"Alaska","Haines Borough",1,85,35,10,25
050,02,100,"Alaska","Haines Borough",2,0,18,8,10
050,02,100,"Alaska","Haines Borough",2,1,18,9,9
050,02,100,"Alaska","Haines Borough",2,2,20,11,9
050,02,100,"Alaska","Haines Borough",2,3,16,9,7
050,02,100,"Alaska","Haines Borough",2,4,16,9,7
050,02,100,"Alaska","Haines Borough",2,5,19,9,10
050,02,100,"Alaska","Haines Borough",2,6,15,7,8
050,02,100,"Alaska","Haines Borough",2,7,14,5,9
050,02,100,"Alaska","Haines Borough",2,8,21,9,12
050,02,100,"Alaska","Haines Borough",2,9,24,13,11
050,02,100,"Alaska","Haines Borough",2,10,21,9,12
050,02,100,"Alaska","Haines Borough",2,11,20,9,11
050,02,100,"Alaska","Haines Borough",2,12,21,14,7
050,02,100,"Alaska","Haines Borough",2,13,22,11,11
050,02,100,"Alaska","Haines Borough",2,14,22,11,11
050,02,100,"Alaska","Haines Borough",2,15,27,14,13
050,02,100,"Alaska","Haines Borough",2,16,28,13,15
050,02,100,"Alaska","Haines Borough",2,17,27,12,15
050,02,100,"Alaska","Haines Borough",2,18,28,15,13
050,02,100,"Alaska","Haines Borough",2,19,19,11,8
050,02,100,"Alaska","Haines Borough",2,20,16,7,9
050,02,100,"Alaska","Haines Borough",2,21,16,8,8
050,02,100,"Alaska","Haines Borough",2,22,16,8,8
050,02,100,"Alaska","Haines Borough",2,23,19,10,9
050,02,100,"Alaska","Haines Borough",2,24,21,12,9
050,02,100,"Alaska","Haines Borough",2,25,25,16,9
050,02,100,"Alaska","Haines Borough",2,26,22,15,7
050,02,100,"Alaska","Haines Borough",2,27,20,14,6
050,02,100,"Alaska","Haines Borough",2,28,23,14,9
050,02,100,"Alaska","Haines Borough",2,29,18,9,9
050,02,100,"Alaska","Haines Borough",2,30,14,9,5
050,02,100,"Alaska","Haines Borough",2,31,17,9,8
050,02,100,"Alaska","Haines Borough",2,32,24,11,13
050,02,100,"Alaska","Haines Borough",2,33,21,9,12
050,02,100,"Alaska","Haines Borough",2,34,22,12,10
050,02,100,"Alaska","Haines Borough",2,35,23,12,11
050,02,100,"Alaska","Haines Borough",2,36,31,16,15
050,02,100,"Alaska","Haines Borough",2,37,29,15,14
050,02,100,"Alaska","Haines Borough",2,38,26,13,13
050,02,100,"Alaska","Haines Borough",2,39,25,13,12
050,02,100,"Alaska","Haines Borough",2,40,23,12,11
050,02,100,"Alaska","Haines Borough",2,41,24,12,12
050,02,100,"Alaska","Haines Borough",2,42,20,12,8
050,02,100,"Alaska","Haines Borough",2,43,24,13,11
050,02,100,"Alaska","Haines Borough",2,44,26,14,12
050,02,100,"Alaska","Haines Borough",2,45,25,14,11
050,02,100,"Alaska","Haines Borough",2,46,27,15,12
050,02,100,"Alaska","Haines Borough",2,47,22,12,10
050,02,100,"Alaska","Haines Borough",2,48,17,9,8
050,02,100,"Alaska","Haines Borough",2,49,23,13,10
050,02,100,"Alaska","Haines Borough",2,50,32,17,15
050,02,100,"Alaska","Haines Borough",2,51,32,13,19
050,02,100,"Alaska","Haines Borough",2,52,25,11,14
050,02,100,"Alaska","Haines Borough",2,53,25,14,11
050,02,100,"Alaska","Haines Borough",2,54,26,15,11
050,02,100,"Alaska","Haines Borough",2,55,31,15,16
050,02,100,"Alaska","Haines Borough",2,56,34,17,17
050,02,100,"Alaska","Haines Borough",2,57,39,22,17
050,02,100,"Alaska","Haines Borough",2,58,43,22,21
050,02,100,"Alaska","Haines Borough",2,59,37,21,16
050,02,100,"Alaska","Haines Borough",2,60,31,19,12
050,02,100,"Alaska","Haines Borough",2,61,36,20,16
050,02,100,"Alaska","Haines Borough",2,62,44,22,22
050,02,100,"Alaska","Haines Borough",2,63,44,22,22
050,02,100,"Alaska","Haines Borough",2,64,42,22,20
050,02,100,"Alaska","Haines Borough",2,65,41,22,19
050,02,100,"Alaska","Haines Borough",2,66,37,18,19
050,02,100,"Alaska","Haines Borough",2,67,40,22,18
050,02,100,"Alaska","Haines Borough",2,68,40,22,18
050,02,100,"Alaska","Haines Borough",2,69,34,19,15
050,02,100,"Alaska","Haines Borough",2,70,28,15,13
050,02,100,"Alaska","Haines Borough",2,71,34,15,19
050,02,100,"Alaska","Haines Borough",2,72,33,17,16
050,02,100,"Alaska","Haines Borough",2,73,31,17,14
050,02,100,"Alaska","Haines Borough",2,74,23,13,10
050,02,100,"Alaska","Haines Borough",2,75,20,10,10
050,02,100,"Alaska","Haines Borough",2,76,15,8,7
050,02,100,"Alaska","Haines Borough",2,77,12,5,7
050,02,100,"Alaska","Haines Borough",2,78,11,6,5
050,02,100,"Alaska","Haines Borough",2,79,13,7,6
050,02,100,"Alaska","Haines Borough",2,80,9,3,6
050,02,100,"Alaska","Haines Borough",2,81,9,3,6
050,02,100,"Alaska","Haines Borough",2,82,12,5,7
050,02,100,"Alaska","Haines Borough",2,83,8,3,5
050,02,100,"Alaska","Haines Borough",2,84,4,1,3
050,02,100,"Alaska","Haines Borough",2,85,34,9,25
050,02,100,"Alaska","Haines Borough",3,0,19,11,8
050,02,100,"Alaska","Haines Borough",3,1,18,8,10
050,02,100,"Alaska","Haines Borough",3,2,17,10,7
050,02,100,"Alaska","Haines Borough",3,3,22,11,11
050,02,100,"Alaska","Haines Borough",3,4,16,10,6
050,02,100,"Alaska","Haines Borough",3,5,20,12,8
050,02,100,"Alaska","Haines Borough",3,6,20,11,9
050,02,100,"Alaska","Haines Borough",3,7,14,9,5
050,02,100,"Alaska","Haines Borough",3,8,14,5,9
050,02,100,"Alaska","Haines Borough",3,9,21,8,13
050,02,100,"Alaska","Haines Borough",3,10,23,11,12
050,02,100,"Alaska","Haines Borough",3,11,18,9,9
050,02,100,"Alaska","Haines Borough",3,12,20,9,11
050,02,100,"Alaska","Haines Borough",3,13,22,14,8
050,02,100,"Alaska","Haines Borough",3,14,22,11,11
050,02,100,"Alaska","Haines Borough",3,15,21,10,11
050,02,100,"Alaska","Haines Borough",3,16,26,13,13
050,02,100,"Alaska","Haines Borough",3,17,26,11,15
050,02,100,"Alaska","Haines Borough",3,18,21,11,10
050,02,100,"Alaska","Haines Borough",3,19,21,11,10
050,02,100,"Alaska","Haines Borough",3,20,15,6,9
050,02,100,"Alaska","Haines Borough",3,21,13,6,7
050,02,100,"Alaska","Haines Borough",3,22,13,5,8
050,02,100,"Alaska","Haines Borough",3,23,20,9,11
050,02,100,"Alaska","Haines Borough",3,24,23,11,12
050,02,100,"Alaska","Haines Borough",3,25,15,7,8
050,02,100,"Alaska","Haines Borough",3,26,25,18,7
050,02,100,"Alaska","Haines Borough",3,27,26,15,11
050,02,100,"Alaska","Haines Borough",3,28,23,15,8
050,02,100,"Alaska","Haines Borough",3,29,23,11,12
050,02,100,"Alaska","Haines Borough",3,30,18,8,10
050,02,100,"Alaska","Haines Borough",3,31,18,11,7
050,02,100,"Alaska","Haines Borough",3,32,17,9,8
050,02,100,"Alaska","Haines Borough",3,33,24,13,11
050,02,100,"Alaska","Haines Borough",3,34,18,8,10
050,02,100,"Alaska","Haines Borough",3,35,22,13,9
050,02,100,"Alaska","Haines Borough",3,36,23,13,10
050,02,100,"Alaska","Haines Borough",3,37,33,17,16
050,02,100,"Alaska","Haines Borough",3,38,30,14,16
050,02,100,"Alaska","Haines Borough",3,39,25,13,12
050,02,100,"Alaska","Haines Borough",3,40,28,14,14
050,02,100,"Alaska","Haines Borough",3,41,22,12,10
050,02,100,"Alaska","Haines Borough",3,42,30,13,17
050,02,100,"Alaska","Haines Borough",3,43,20,11,9
050,02,100,"Alaska","Haines Borough",3,44,23,13,10
050,02,100,"Alaska","Haines Borough",3,45,24,12,12
050,02,100,"Alaska","Haines Borough",3,46,25,14,11
050,02,100,"Alaska","Haines Borough",3,47,26,14,12
050,02,100,"Alaska","Haines Borough",3,48,24,13,11
050,02,100,"Alaska","Haines Borough",3,49,17,9,8
050,02,100,"Alaska","Haines Borough",3,50,24,13,11
050,02,100,"Alaska","Haines Borough",3,51,29,16,13
050,02,100,"Alaska","Haines Borough",3,52,31,13,18
050,02,100,"Alaska","Haines Borough",3,53,24,11,13
050,02,100,"Alaska","Haines Borough",3,54,24,14,10
050,02,100,"Alaska","Haines Borough",3,55,27,16,11
050,02,100,"Alaska","Haines Borough",3,56,33,18,15
050,02,100,"Alaska","Haines Borough",3,57,33,16,17
050,02,100,"Alaska","Haines Borough",3,58,40,22,18
050,02,100,"Alaska","Haines Borough",3,59,42,20,22
050,02,100,"Alaska","Haines Borough",3,60,37,22,15
050,02,100,"Alaska","Haines Borough",3,61,31,19,12
050,02,100,"Alaska","Haines Borough",3,62,36,20,16
050,02,100,"Alaska","Haines Borough",3,63,43,21,22
050,02,100,"Alaska","Haines Borough",3,64,44,22,22
050,02,100,"Alaska","Haines Borough",3,65,41,21,20
050,02,100,"Alaska","Haines Borough",3,66,42,22,20
050,02,100,"Alaska","Haines Borough",3,67,36,18,18
050,02,100,"Alaska","Haines Borough",3,68,37,20,17
050,02,100,"Alaska","Haines Borough",3,69,40,22,18
050,02,100,"Alaska","Haines Borough",3,70,33,18,15
050,02,100,"Alaska","Haines Borough",3,71,27,15,12
050,02,100,"Alaska","Haines Borough",3,72,34,14,20
050,02,100,"Alaska","Haines Borough",3,73,32,17,15
050,02,100,"Alaska","Haines Borough",3,74,32,18,14
050,02,100,"Alaska","Haines Borough",3,75,22,13,9
050,02,100,"Alaska","Haines Borough",3,76,20,11,9
050,02,100,"Alaska","Haines Borough",3,77,15,8,7
050,02,100,"Alaska","Haines Borough",3,78,12,5,7
050,02,100,"Alaska","Haines Borough",3,79,7,5,2
050,02,100,"Alaska","Haines Borough",3,80,14,7,7
050,02,100,"Alaska","Haines Borough",3,81,7,2,5
050,02,100,"Alaska","Haines Borough",3,82,10,3,7
050,02,100,"Alaska","Haines Borough",3,83,10,5,5
050,02,100,"Alaska","Haines Borough",3,84,9,3,6
050,02,100,"Alaska","Haines Borough",3,85,32,9,23
050,02,100,"Alaska","Haines Borough",4,0,22,7,15
050,02,100,"Alaska","Haines Borough",4,1,21,11,10
050,02,100,"Alaska","Haines Borough",4,2,19,8,11
050,02,100,"Alaska","Haines Borough",4,3,18,11,7
050,02,100,"Alaska","Haines Borough",4,4,21,10,11
050,02,100,"Alaska","Haines Borough",4,5,17,10,7
050,02,100,"Alaska","Haines Borough",4,6,22,14,8
050,02,100,"Alaska","Haines Borough",4,7,21,11,10
050,02,100,"Alaska","Haines Borough",4,8,13,8,5
050,02,100,"Alaska","Haines Borough",4,9,15,6,9
050,02,100,"Alaska","Haines Borough",4,10,22,10,12
050,02,100,"Alaska","Haines Borough",4,11,24,11,13
050,02,100,"Alaska","Haines Borough",4,12,19,9,10
050,02,100,"Alaska","Haines Borough",4,13,19,9,10
050,02,100,"Alaska","Haines Borough",4,14,22,15,7
050,02,100,"Alaska","Haines Borough",4,15,18,10,8
050,02,100,"Alaska","Haines Borough",4,16,21,10,11
050,02,100,"Alaska","Haines Borough",4,17,21,11,10
050,02,100,"Alaska","Haines Borough",4,18,22,10,12
050,02,100,"Alaska","Haines Borough",4,19,15,7,8
050,02,100,"Alaska","Haines Borough",4,20,22,12,10
050,02,100,"Alaska","Haines Borough",4,21,13,7,6
050,02,100,"Alaska","Haines Borough",4,22,12,5,7
050,02,100,"Alaska","Haines Borough",4,23,15,8,7
050,02,100,"Alaska","Haines Borough",4,24,19,10,9
050,02,100,"Alaska","Haines Borough",4,25,21,9,12
050,02,100,"Alaska","Haines Borough",4,26,14,6,8
050,02,100,"Alaska","Haines Borough",4,27,23,19,4
050,02,100,"Alaska","Haines Borough",4,28,25,13,12
050,02,100,"Alaska","Haines Borough",4,29,21,14,7
050,02,100,"Alaska","Haines Borough",4,30,27,14,13
050,02,100,"Alaska","Haines Borough",4,31,27,9,18
050,02,100,"Alaska","Haines Borough",4,32,19,10,9
050,02,100,"Alaska","Haines Borough",4,33,18,10,8
050,02,100,"Alaska","Haines Borough",4,34,24,13,11
050,02,100,"Alaska","Haines Borough",4,35,17,9,8
050,02,100,"Alaska","Haines Borough",4,36,21,14,7
050,02,100,"Alaska","Haines Borough",4,37,23,13,10
050,02,100,"Alaska","Haines Borough",4,38,33,18,15
050,02,100,"Alaska","Haines Borough",4,39,33,15,18
050,02,100,"Alaska","Haines Borough",4,40,23,12,11
050,02,100,"Alaska","Haines Borough",4,41,28,15,13
050,02,100,"Alaska","Haines Borough",4,42,22,12,10
050,02,100,"Alaska","Haines Borough",4,43,27,11,16
050,02,100,"Alaska","Haines Borough",4,44,19,12,7
050,02,100,"Alaska","Haines Borough",4,45,23,13,10
050,02,100,"Alaska","Haines Borough",4,46,24,13,11
050,02,100,"Alaska","Haines Borough",4,47,28,15,13
050,02,100,"Alaska","Haines Borough",4,48,22,12,10
050,02,100,"Alaska","Haines Borough",4,49,24,12,12
050,02,100,"Alaska","Haines Borough",4,50,18,9,9
050,02,100,"Alaska","Haines Borough",4,51,26,15,11
050,02,100,"Alaska","Haines Borough",4,52,29,16,13
050,02,100,"Alaska","Haines Borough",4,53,28,11,17
050,02,100,"Alaska","Haines Borough",4,54,24,13,11
050,02,100,"Alaska","Haines Borough",4,55,26,15,11
050,02,100,"Alaska","Haines Borough",4,56,29,16,13
050,02,100,"Alaska","Haines Borough",4,57,32,18,14
050,02,100,"Alaska","Haines Borough",4,58,32,15,17
050,02,100,"Alaska","Haines Borough",4,59,39,21,18
050,02,100,"Alaska","Haines Borough",4,60,41,19,22
050,02,100,"Alaska","Haines Borough",4,61,39,22,17
050,02,100,"Alaska","Haines Borough",4,62,31,17,14
050,02,100,"Alaska","Haines Borough",4,63,38,23,15
050,02,100,"Alaska","Haines Borough",4,64,48,22,26
050,02,100,"Alaska","Haines Borough",4,65,42,22,20
050,02,100,"Alaska","Haines Borough",4,66,38,18,20
050,02,100,"Alaska","Haines Borough",4,67,41,22,19
050,02,100,"Alaska","Haines Borough",4,68,36,19,17
050,02,100,"Alaska","Haines Borough",4,69,35,18,17
050,02,100,"Alaska","Haines Borough",4,70,40,22,18
050,02,100,"Alaska","Haines Borough",4,71,31,18,13
050,02,100,"Alaska","Haines Borough",4,72,27,15,12
050,02,100,"Alaska","Haines Borough",4,73,34,14,20
050,02,100,"Alaska","Haines Borough",4,74,29,15,14
050,02,100,"Alaska","Haines Borough",4,75,32,17,15
050,02,100,"Alaska","Haines Borough",4,76,23,15,8
050,02,100,"Alaska","Haines Borough",4,77,19,11,8
050,02,100,"Alaska","Haines Borough",4,78,15,8,7
050,02,100,"Alaska","Haines Borough",4,79,9,4,5
050,02,100,"Alaska","Haines Borough",4,80,8,5,3
050,02,100,"Alaska","Haines Borough",4,81,11,5,6
050,02,100,"Alaska","Haines Borough",4,82,8,2,6
050,02,100,"Alaska","Haines Borough",4,83,7,3,4
050,02,100,"Alaska","Haines Borough",4,84,11,5,6
050,02,100,"Alaska","Haines Borough",4,85,35,9,26
050,02,100,"Alaska","Haines Borough",5,0,24,8,16
050,02,100,"Alaska","Haines Borough",5,1,24,7,17
050,02,100,"Alaska","Haines Borough",5,2,19,12,7
050,02,100,"Alaska","Haines Borough",5,3,19,7,12
050,02,100,"Alaska","Haines Borough",5,4,17,10,7
050,02,100,"Alaska","Haines Borough",5,5,20,8,12
050,02,100,"Alaska","Haines Borough",5,6,16,11,5
050,02,100,"Alaska","Haines Borough",5,7,23,14,9
050,02,100,"Alaska","Haines Borough",5,8,21,11,10
050,02,100,"Alaska","Haines Borough",5,9,13,7,6
050,02,100,"Alaska","Haines Borough",5,10,18,9,9
050,02,100,"Alaska","Haines Borough",5,11,22,10,12
050,02,100,"Alaska","Haines Borough",5,12,24,11,13
050,02,100,"Alaska","Haines Borough",5,13,16,6,10
050,02,100,"Alaska","Haines Borough",5,14,15,9,6
050,02,100,"Alaska","Haines Borough",5,15,22,15,7
050,02,100,"Alaska","Haines Borough",5,16,16,10,6
050,02,100,"Alaska","Haines Borough",5,17,23,11,12
050,02,100,"Alaska","Haines Borough",5,18,20,11,9
050,02,100,"Alaska","Haines Borough",5,19,16,7,9
050,02,100,"Alaska","Haines Borough",5,20,14,8,6
050,02,100,"Alaska","Haines Borough",5,21,20,12,8
050,02,100,"Alaska","Haines Borough",5,22,10,4,6
050,02,100,"Alaska","Haines Borough",5,23,13,5,8
050,02,100,"Alaska","Haines Borough",5,24,15,7,8
050,02,100,"Alaska","Haines Borough",5,25,15,9,6
050,02,100,"Alaska","Haines Borough",5,26,19,7,12
050,02,100,"Alaska","Haines Borough",5,27,15,7,8
050,02,100,"Alaska","Haines Borough",5,28,25,18,7
050,02,100,"Alaska","Haines Borough",5,29,25,14,11
050,02,100,"Alaska","Haines Borough",5,30,23,15,8
050,02,100,"Alaska","Haines Borough",5,31,32,15,17
050,02,100,"Alaska","Haines Borough",5,32,27,9,18
050,02,100,"Alaska","Haines Borough",5,33,20,11,9
050,02,100,"Alaska","Haines Borough",5,34,18,9,9
050,02,100,"Alaska","Haines Borough",5,35,20,11,9
050,02,100,"Alaska","Haines Borough",5,36,19,10,9
050,02,100,"Alaska","Haines Borough",5,37,20,13,7
050,02,100,"Alaska","Haines Borough",5,38,25,15,10
050,02,100,"Alaska","Haines Borough",5,39,40,19,21
050,02,100,"Alaska","Haines Borough",5,40,33,16,17
050,02,100,"Alaska","Haines Borough",5,41,30,15,15
050,02,100,"Alaska","Haines Borough",5,42,29,15,14
050,02,100,"Alaska","Haines Borough",5,43,23,12,11
050,02,100,"Alaska","Haines Borough",5,44,30,14,16
050,02,100,"Alaska","Haines Borough",5,45,20,13,7
050,02,100,"Alaska","Haines Borough",5,46,22,14,8
050,02,100,"Alaska","Haines Borough",5,47,24,13,11
050,02,100,"Alaska","Haines Borough",5,48,29,16,13
050,02,100,"Alaska","Haines Borough",5,49,22,13,9
050,02,100,"Alaska","Haines Borough",5,50,21,12,9
050,02,100,"Alaska","Haines Borough",5,51,18,8,10
050,02,100,"Alaska","Haines Borough",5,52,29,16,13
050,02,100,"Alaska","Haines Borough",5,53,26,15,11
050,02,100,"Alaska","Haines Borough",5,54,27,9,18
050,02,100,"Alaska","Haines Borough",5,55,27,16,11
050,02,100,"Alaska","Haines Borough",5,56,29,18,11
050,02,100,"Alaska","Haines Borough",5,57,29,17,12
050,02,100,"Alaska","Haines Borough",5,58,31,16,15
050,02,100,"Alaska","Haines Borough",5,59,31,14,17
050,02,100,"Alaska","Haines Borough",5,60,37,20,17
050,02,100,"Alaska","Haines Borough",5,61,42,19,23
050,02,100,"Alaska","Haines Borough",5,62,39,22,17
050,02,100,"Alaska","Haines Borough",5,63,28,16,12
050,02,100,"Alaska","Haines Borough",5,64,35,21,14
050,02,100,"Alaska","Haines Borough",5,65,44,21,23
050,02,100,"Alaska","Haines Borough",5,66,41,22,19
050,02,100,"Alaska","Haines Borough",5,67,40,19,21
050,02,100,"Alaska","Haines Borough",5,68,42,23,19
050,02,100,"Alaska","Haines Borough",5,69,36,19,17
050,02,100,"Alaska","Haines Borough",5,70,35,19,16
050,02,100,"Alaska","Haines Borough",5,71,37,21,16
050,02,100,"Alaska","Haines Borough",5,72,32,18,14
050,02,100,"Alaska","Haines Borough",5,73,26,15,11
050,02,100,"Alaska","Haines Borough",5,74,34,14,20
050,02,100,"Alaska","Haines Borough",5,75,28,16,12
050,02,100,"Alaska","Haines Borough",5,76,32,16,16
050,02,100,"Alaska","Haines Borough",5,77,22,15,7
050,02,100,"Alaska","Haines Borough",5,78,19,11,8
050,02,100,"Alaska","Haines Borough",5,79,13,7,6
050,02,100,"Alaska","Haines Borough",5,80,9,4,5
050,02,100,"Alaska","Haines Borough",5,81,6,4,2
050,02,100,"Alaska","Haines Borough",5,82,11,4,7
050,02,100,"Alaska","Haines Borough",5,83,6,2,4
050,02,100,"Alaska","Haines Borough",5,84,8,3,5
050,02,100,"Alaska","Haines Borough",5,85,35,10,25
050,02,105,"Alaska","Hoonah-Angoon Census Area",1,0,22,11,11
050,02,105,"Alaska","Hoonah-Angoon Census Area",1,1,22,7,15
050,02,105,"Alaska","Hoonah-Angoon Census Area",1,2,17,6,11
050,02,105,"Alaska","Hoonah-Angoon Census Area",1,3,25,13,12
050,02,105,"Alaska","Hoonah-Angoon Census Area",1,4,20,10,10
050,02,105,"Alaska","Hoonah-Angoon Census Area",1,5,21,8,13
050,02,105,"Alaska","Hoonah-Angoon Census Area",1,6,28,14,14
050,02,105,"Alaska","Hoonah-Angoon Census Area",1,7,24,13,11
050,02,105,"Alaska","Hoonah-Angoon Census Area",1,8,20,12,8
050,02,105,"Alaska","Hoonah-Angoon Census Area",1,9,28,17,11
050,02,105,"Alaska","Hoonah-Angoon Census Area",1,10,27,13,14
050,02,105,"Alaska","Hoonah-Angoon Census Area",1,11,19,12,7
050,02,105,"Alaska","Hoonah-Angoon Census Area",1,12,28,17,11
050,02,105,"Alaska","Hoonah-Angoon Census Area",1,13,24,14,10
050,02,105,"Alaska","Hoonah-Angoon Census Area",1,14,27,15,12
050,02,105,"Alaska","Hoonah-Angoon Census Area",1,15,26,10,16
050,02,105,"Alaska","Hoonah-Angoon Census Area",1,16,22,9,13
050,02,105,"Alaska","Hoonah-Angoon Census Area",1,17,21,10,11
050,02,105,"Alaska","Hoonah-Angoon Census Area",1,18,22,8,14
050,02,105,"Alaska","Hoonah-Angoon Census Area",1,19,17,10,7
050,02,105,"Alaska","Hoonah-Angoon Census Area",1,20,15,7,8
050,02,105,"Alaska","Hoonah-Angoon Census Area",1,21,16,5,11
050,02,105,"Alaska","Hoonah-Angoon Census Area",1,22,20,11,9
050,02,105,"Alaska","Hoonah-Angoon Census Area",1,23,18,8,10
050,02,105,"Alaska","Hoonah-Angoon Census Area",1,24,18,10,8
050,02,105,"Alaska","Hoonah-Angoon Census Area",1,25,20,14,6
050,02,105,"Alaska","Hoonah-Angoon Census Area",1,26,15,9,6
050,02,105,"Alaska","Hoonah-Angoon Census Area",1,27,22,15,7
050,02,105,"Alaska","Hoonah-Angoon Census Area",1,28,27,19,8
050,02,105,"Alaska","Hoonah-Angoon Census Area",1,29,26,16,10
050,02,105,"Alaska","Hoonah-Angoon Census Area",1,30,31,18,13
050,02,105,"Alaska","Hoonah-Angoon Census Area",1,31,22,13,9
050,02,105,"Alaska","Hoonah-Angoon Census Area",1,32,25,12,13
050,02,105,"Alaska","Hoonah-Angoon Census Area",1,33,23,16,7
050,02,105,"Alaska","Hoonah-Angoon Census Area",1,34,25,15,10
050,02,105,"Alaska","Hoonah-Angoon Census Area",1,35,27,14,13
050,02,105,"Alaska","Hoonah-Angoon Census Area",1,36,23,12,11
050,02,105,"Alaska","Hoonah-Angoon Census Area",1,37,21,11,10
050,02,105,"Alaska","Hoonah-Angoon Census Area",1,38,26,17,9
050,02,105,"Alaska","Hoonah-Angoon Census Area",1,39,26,11,15
050,02,105,"Alaska","Hoonah-Angoon Census Area",1,40,19,6,13
050,02,105,"Alaska","Hoonah-Angoon Census Area",1,41,27,11,16
050,02,105,"Alaska","Hoonah-Angoon Census Area",1,42,25,10,15
050,02,105,"Alaska","Hoonah-Angoon Census Area",1,43,28,13,15
050,02,105,"Alaska","Hoonah-Angoon Census Area",1,44,25,16,9
050,02,105,"Alaska","Hoonah-Angoon Census Area",1,45,18,5,13
050,02,105,"Alaska","Hoonah-Angoon Census Area",1,46,19,10,9
050,02,105,"Alaska","Hoonah-Angoon Census Area",1,47,26,20,6
050,02,105,"Alaska","Hoonah-Angoon Census Area",1,48,31,21,10
050,02,105,"Alaska","Hoonah-Angoon Census Area",1,49,38,24,14
050,02,105,"Alaska","Hoonah-Angoon Census Area",1,50,42,33,9
050,02,105,"Alaska","Hoonah-Angoon Census Area",1,51,40,27,13
050,02,105,"Alaska","Hoonah-Angoon Census Area",1,52,37,20,17
050,02,105,"Alaska","Hoonah-Angoon Census Area",1,53,33,21,12
050,02,105,"Alaska","Hoonah-Angoon Census Area",1,54,33,18,15
050,02,105,"Alaska","Hoonah-Angoon Census Area",1,55,40,19,21
050,02,105,"Alaska","Hoonah-Angoon Census Area",1,56,45,20,25
050,02,105,"Alaska","Hoonah-Angoon Census Area",1,57,47,20,27
050,02,105,"Alaska","Hoonah-Angoon Census Area",1,58,47,27,20
050,02,105,"Alaska","Hoonah-Angoon Census Area",1,59,51,32,19
050,02,105,"Alaska","Hoonah-Angoon Census Area",1,60,50,29,21
050,02,105,"Alaska","Hoonah-Angoon Census Area",1,61,41,20,21
050,02,105,"Alaska","Hoonah-Angoon Census Area",1,62,41,20,21
050,02,105,"Alaska","Hoonah-Angoon Census Area",1,63,46,25,21
050,02,105,"Alaska","Hoonah-Angoon Census Area",1,64,41,24,17
050,02,105,"Alaska","Hoonah-Angoon Census Area",1,65,46,26,20
050,02,105,"Alaska","Hoonah-Angoon Census Area",1,66,44,20,24
050,02,105,"Alaska","Hoonah-Angoon Census Area",1,67,43,21,22
050,02,105,"Alaska","Hoonah-Angoon Census Area",1,68,42,19,23
050,02,105,"Alaska","Hoonah-Angoon Census Area",1,69,36,19,17
050,02,105,"Alaska","Hoonah-Angoon Census Area",1,70,45,20,25
050,02,105,"Alaska","Hoonah-Angoon Census Area",1,71,43,24,19
050,02,105,"Alaska","Hoonah-Angoon Census Area",1,72,29,22,7
050,02,105,"Alaska","Hoonah-Angoon Census Area",1,73,31,23,8
050,02,105,"Alaska","Hoonah-Angoon Census Area",1,74,22,16,6
050,02,105,"Alaska","Hoonah-Angoon Census Area",1,75,23,16,7
050,02,105,"Alaska","Hoonah-Angoon Census Area",1,76,22,16,6
050,02,105,"Alaska","Hoonah-Angoon Census Area",1,77,23,14,9
050,02,105,"Alaska","Hoonah-Angoon Census Area",1,78,16,7,9
050,02,105,"Alaska","Hoonah-Angoon Census Area",1,79,15,9,6
050,02,105,"Alaska","Hoonah-Angoon Census Area",1,80,11,7,4
050,02,105,"Alaska","Hoonah-Angoon Census Area",1,81,11,6,5
050,02,105,"Alaska","Hoonah-Angoon Census Area",1,82,4,3,1
050,02,105,"Alaska","Hoonah-Angoon Census Area",1,83,11,8,3
050,02,105,"Alaska","Hoonah-Angoon Census Area",1,84,7,4,3
050,02,105,"Alaska","Hoonah-Angoon Census Area",1,85,40,30,10
050,02,105,"Alaska","Hoonah-Angoon Census Area",2,0,22,12,10
050,02,105,"Alaska","Hoonah-Angoon Census Area",2,1,22,8,14
050,02,105,"Alaska","Hoonah-Angoon Census Area",2,2,19,7,12
050,02,105,"Alaska","Hoonah-Angoon Census Area",2,3,24,11,13
050,02,105,"Alaska","Hoonah-Angoon Census Area",2,4,21,11,10
050,02,105,"Alaska","Hoonah-Angoon Census Area",2,5,21,9,12
050,02,105,"Alaska","Hoonah-Angoon Census Area",2,6,28,13,15
050,02,105,"Alaska","Hoonah-Angoon Census Area",2,7,26,14,12
050,02,105,"Alaska","Hoonah-Angoon Census Area",2,8,21,12,9
050,02,105,"Alaska","Hoonah-Angoon Census Area",2,9,26,16,10
050,02,105,"Alaska","Hoonah-Angoon Census Area",2,10,26,14,12
050,02,105,"Alaska","Hoonah-Angoon Census Area",2,11,22,13,9
050,02,105,"Alaska","Hoonah-Angoon Census Area",2,12,27,16,11
050,02,105,"Alaska","Hoonah-Angoon Census Area",2,13,22,13,9
050,02,105,"Alaska","Hoonah-Angoon Census Area",2,14,26,14,12
050,02,105,"Alaska","Hoonah-Angoon Census Area",2,15,26,11,15
050,02,105,"Alaska","Hoonah-Angoon Census Area",2,16,24,9,15
050,02,105,"Alaska","Hoonah-Angoon Census Area",2,17,21,10,11
050,02,105,"Alaska","Hoonah-Angoon Census Area",2,18,20,7,13
050,02,105,"Alaska","Hoonah-Angoon Census Area",2,19,18,10,8
050,02,105,"Alaska","Hoonah-Angoon Census Area",2,20,15,7,8
050,02,105,"Alaska","Hoonah-Angoon Census Area",2,21,16,5,11
050,02,105,"Alaska","Hoonah-Angoon Census Area",2,22,18,9,9
050,02,105,"Alaska","Hoonah-Angoon Census Area",2,23,18,9,9
050,02,105,"Alaska","Hoonah-Angoon Census Area",2,24,19,10,9
050,02,105,"Alaska","Hoonah-Angoon Census Area",2,25,20,13,7
050,02,105,"Alaska","Hoonah-Angoon Census Area",2,26,17,11,6
050,02,105,"Alaska","Hoonah-Angoon Census Area",2,27,21,14,7
050,02,105,"Alaska","Hoonah-Angoon Census Area",2,28,26,18,8
050,02,105,"Alaska","Hoonah-Angoon Census Area",2,29,27,17,10
050,02,105,"Alaska","Hoonah-Angoon Census Area",2,30,31,19,12
050,02,105,"Alaska","Hoonah-Angoon Census Area",2,31,24,14,10
050,02,105,"Alaska","Hoonah-Angoon Census Area",2,32,23,12,11
050,02,105,"Alaska","Hoonah-Angoon Census Area",2,33,24,15,9
050,02,105,"Alaska","Hoonah-Angoon Census Area",2,34,25,15,10
050,02,105,"Alaska","Hoonah-Angoon Census Area",2,35,26,13,13
050,02,105,"Alaska","Hoonah-Angoon Census Area",2,36,23,13,10
050,02,105,"Alaska","Hoonah-Angoon Census Area",2,37,21,11,10
050,02,105,"Alaska","Hoonah-Angoon Census Area",2,38,26,16,10
050,02,105,"Alaska","Hoonah-Angoon Census Area",2,39,24,11,13
050,02,105,"Alaska","Hoonah-Angoon Census Area",2,40,22,8,14
050,02,105,"Alaska","Hoonah-Angoon Census Area",2,41,26,10,16
050,02,105,"Alaska","Hoonah-Angoon Census Area",2,42,25,10,15
050,02,105,"Alaska","Hoonah-Angoon Census Area",2,43,26,12,14
050,02,105,"Alaska","Hoonah-Angoon Census Area",2,44,25,15,10
050,02,105,"Alaska","Hoonah-Angoon Census Area",2,45,19,7,12
050,02,105,"Alaska","Hoonah-Angoon Census Area",2,46,17,9,8
050,02,105,"Alaska","Hoonah-Angoon Census Area",2,47,24,18,6
050,02,105,"Alaska","Hoonah-Angoon Census Area",2,48,30,21,9
050,02,105,"Alaska","Hoonah-Angoon Census Area",2,49,36,24,12
050,02,105,"Alaska","Hoonah-Angoon Census Area",2,50,41,32,9
050,02,105,"Alaska","Hoonah-Angoon Census Area",2,51,41,29,12
050,02,105,"Alaska","Hoonah-Angoon Census Area",2,52,36,21,15
050,02,105,"Alaska","Hoonah-Angoon Census Area",2,53,34,21,13
050,02,105,"Alaska","Hoonah-Angoon Census Area",2,54,32,18,14
050,02,105,"Alaska","Hoonah-Angoon Census Area",2,55,39,19,20
050,02,105,"Alaska","Hoonah-Angoon Census Area",2,56,46,21,25
050,02,105,"Alaska","Hoonah-Angoon Census Area",2,57,47,20,27
050,02,105,"Alaska","Hoonah-Angoon Census Area",2,58,46,25,21
050,02,105,"Alaska","Hoonah-Angoon Census Area",2,59,51,31,20
050,02,105,"Alaska","Hoonah-Angoon Census Area",2,60,47,26,21
050,02,105,"Alaska","Hoonah-Angoon Census Area",2,61,42,21,21
050,02,105,"Alaska","Hoonah-Angoon Census Area",2,62,41,20,21
050,02,105,"Alaska","Hoonah-Angoon Census Area",2,63,46,24,22
050,02,105,"Alaska","Hoonah-Angoon Census Area",2,64,42,24,18
050,02,105,"Alaska","Hoonah-Angoon Census Area",2,65,46,26,20
050,02,105,"Alaska","Hoonah-Angoon Census Area",2,66,44,21,23
050,02,105,"Alaska","Hoonah-Angoon Census Area",2,67,43,21,22
050,02,105,"Alaska","Hoonah-Angoon Census Area",2,68,42,19,23
050,02,105,"Alaska","Hoonah-Angoon Census Area",2,69,35,19,16
050,02,105,"Alaska","Hoonah-Angoon Census Area",2,70,43,21,22
050,02,105,"Alaska","Hoonah-Angoon Census Area",2,71,43,23,20
050,02,105,"Alaska","Hoonah-Angoon Census Area",2,72,31,21,10
050,02,105,"Alaska","Hoonah-Angoon Census Area",2,73,32,24,8
050,02,105,"Alaska","Hoonah-Angoon Census Area",2,74,23,17,6
050,02,105,"Alaska","Hoonah-Angoon Census Area",2,75,24,17,7
050,02,105,"Alaska","Hoonah-Angoon Census Area",2,76,22,16,6
050,02,105,"Alaska","Hoonah-Angoon Census Area",2,77,24,15,9
050,02,105,"Alaska","Hoonah-Angoon Census Area",2,78,16,7,9
050,02,105,"Alaska","Hoonah-Angoon Census Area",2,79,16,9,7
050,02,105,"Alaska","Hoonah-Angoon Census Area",2,80,13,8,5
050,02,105,"Alaska","Hoonah-Angoon Census Area",2,81,9,5,4
050,02,105,"Alaska","Hoonah-Angoon Census Area",2,82,5,3,2
050,02,105,"Alaska","Hoonah-Angoon Census Area",2,83,9,6,3
050,02,105,"Alaska","Hoonah-Angoon Census Area",2,84,9,6,3
050,02,105,"Alaska","Hoonah-Angoon Census Area",2,85,42,31,11
050,02,105,"Alaska","Hoonah-Angoon Census Area",3,0,25,13,12
050,02,105,"Alaska","Hoonah-Angoon Census Area",3,1,22,12,10
050,02,105,"Alaska","Hoonah-Angoon Census Area",3,2,23,9,14
050,02,105,"Alaska","Hoonah-Angoon Census Area",3,3,17,10,7
050,02,105,"Alaska","Hoonah-Angoon Census Area",3,4,26,13,13
050,02,105,"Alaska","Hoonah-Angoon Census Area",3,5,17,7,10
050,02,105,"Alaska","Hoonah-Angoon Census Area",3,6,20,9,11
050,02,105,"Alaska","Hoonah-Angoon Census Area",3,7,26,9,17
050,02,105,"Alaska","Hoonah-Angoon Census Area",3,8,25,14,11
050,02,105,"Alaska","Hoonah-Angoon Census Area",3,9,22,12,10
050,02,105,"Alaska","Hoonah-Angoon Census Area",3,10,26,16,10
050,02,105,"Alaska","Hoonah-Angoon Census Area",3,11,20,9,11
050,02,105,"Alaska","Hoonah-Angoon Census Area",3,12,21,12,9
050,02,105,"Alaska","Hoonah-Angoon Census Area",3,13,24,15,9
050,02,105,"Alaska","Hoonah-Angoon Census Area",3,14,19,11,8
050,02,105,"Alaska","Hoonah-Angoon Census Area",3,15,22,12,10
050,02,105,"Alaska","Hoonah-Angoon Census Area",3,16,25,11,14
050,02,105,"Alaska","Hoonah-Angoon Census Area",3,17,23,9,14
050,02,105,"Alaska","Hoonah-Angoon Census Area",3,18,20,11,9
050,02,105,"Alaska","Hoonah-Angoon Census Area",3,19,14,5,9
050,02,105,"Alaska","Hoonah-Angoon Census Area",3,20,18,10,8
050,02,105,"Alaska","Hoonah-Angoon Census Area",3,21,14,7,7
050,02,105,"Alaska","Hoonah-Angoon Census Area",3,22,16,3,13
050,02,105,"Alaska","Hoonah-Angoon Census Area",3,23,18,10,8
050,02,105,"Alaska","Hoonah-Angoon Census Area",3,24,21,12,9
050,02,105,"Alaska","Hoonah-Angoon Census Area",3,25,20,9,11
050,02,105,"Alaska","Hoonah-Angoon Census Area",3,26,15,10,5
050,02,105,"Alaska","Hoonah-Angoon Census Area",3,27,17,10,7
050,02,105,"Alaska","Hoonah-Angoon Census Area",3,28,24,16,8
050,02,105,"Alaska","Hoonah-Angoon Census Area",3,29,32,23,9
050,02,105,"Alaska","Hoonah-Angoon Census Area",3,30,35,23,12
050,02,105,"Alaska","Hoonah-Angoon Census Area",3,31,29,16,13
050,02,105,"Alaska","Hoonah-Angoon Census Area",3,32,32,20,12
050,02,105,"Alaska","Hoonah-Angoon Census Area",3,33,24,12,12
050,02,105,"Alaska","Hoonah-Angoon Census Area",3,34,21,13,8
050,02,105,"Alaska","Hoonah-Angoon Census Area",3,35,24,16,8
050,02,105,"Alaska","Hoonah-Angoon Census Area",3,36,24,12,12
050,02,105,"Alaska","Hoonah-Angoon Census Area",3,37,22,13,9
050,02,105,"Alaska","Hoonah-Angoon Census Area",3,38,22,11,11
050,02,105,"Alaska","Hoonah-Angoon Census Area",3,39,28,15,13
050,02,105,"Alaska","Hoonah-Angoon Census Area",3,40,23,12,11
050,02,105,"Alaska","Hoonah-Angoon Census Area",3,41,18,8,10
050,02,105,"Alaska","Hoonah-Angoon Census Area",3,42,27,8,19
050,02,105,"Alaska","Hoonah-Angoon Census Area",3,43,29,11,18
050,02,105,"Alaska","Hoonah-Angoon Census Area",3,44,26,12,14
050,02,105,"Alaska","Hoonah-Angoon Census Area",3,45,27,17,10
050,02,105,"Alaska","Hoonah-Angoon Census Area",3,46,21,8,13
050,02,105,"Alaska","Hoonah-Angoon Census Area",3,47,16,8,8
050,02,105,"Alaska","Hoonah-Angoon Census Area",3,48,26,20,6
050,02,105,"Alaska","Hoonah-Angoon Census Area",3,49,30,21,9
050,02,105,"Alaska","Hoonah-Angoon Census Area",3,50,36,24,12
050,02,105,"Alaska","Hoonah-Angoon Census Area",3,51,30,22,8
050,02,105,"Alaska","Hoonah-Angoon Census Area",3,52,39,27,12
050,02,105,"Alaska","Hoonah-Angoon Census Area",3,53,35,21,14
050,02,105,"Alaska","Hoonah-Angoon Census Area",3,54,35,21,14
050,02,105,"Alaska","Hoonah-Angoon Census Area",3,55,33,19,14
050,02,105,"Alaska","Hoonah-Angoon Census Area",3,56,37,17,20
050,02,105,"Alaska","Hoonah-Angoon Census Area",3,57,45,21,24
050,02,105,"Alaska","Hoonah-Angoon Census Area",3,58,50,22,28
050,02,105,"Alaska","Hoonah-Angoon Census Area",3,59,41,25,16
050,02,105,"Alaska","Hoonah-Angoon Census Area",3,60,53,31,22
050,02,105,"Alaska","Hoonah-Angoon Census Area",3,61,46,25,21
050,02,105,"Alaska","Hoonah-Angoon Census Area",3,62,42,23,19
050,02,105,"Alaska","Hoonah-Angoon Census Area",3,63,42,19,23
050,02,105,"Alaska","Hoonah-Angoon Census Area",3,64,46,24,22
050,02,105,"Alaska","Hoonah-Angoon Census Area",3,65,42,24,18
050,02,105,"Alaska","Hoonah-Angoon Census Area",3,66,48,28,20
050,02,105,"Alaska","Hoonah-Angoon Census Area",3,67,45,21,24
050,02,105,"Alaska","Hoonah-Angoon Census Area",3,68,43,20,23
050,02,105,"Alaska","Hoonah-Angoon Census Area",3,69,41,19,22
050,02,105,"Alaska","Hoonah-Angoon Census Area",3,70,33,19,14
050,02,105,"Alaska","Hoonah-Angoon Census Area",3,71,40,20,20
050,02,105,"Alaska","Hoonah-Angoon Census Area",3,72,41,21,20
050,02,105,"Alaska","Hoonah-Angoon Census Area",3,73,30,22,8
050,02,105,"Alaska","Hoonah-Angoon Census Area",3,74,32,24,8
050,02,105,"Alaska","Hoonah-Angoon Census Area",3,75,20,15,5
050,02,105,"Alaska","Hoonah-Angoon Census Area",3,76,23,16,7
050,02,105,"Alaska","Hoonah-Angoon Census Area",3,77,22,16,6
050,02,105,"Alaska","Hoonah-Angoon Census Area",3,78,23,14,9
050,02,105,"Alaska","Hoonah-Angoon Census Area",3,79,15,7,8
050,02,105,"Alaska","Hoonah-Angoon Census Area",3,80,11,5,6
050,02,105,"Alaska","Hoonah-Angoon Census Area",3,81,12,7,5
050,02,105,"Alaska","Hoonah-Angoon Census Area",3,82,10,5,5
050,02,105,"Alaska","Hoonah-Angoon Census Area",3,83,2,0,2
050,02,105,"Alaska","Hoonah-Angoon Census Area",3,84,9,7,2
050,02,105,"Alaska","Hoonah-Angoon Census Area",3,85,42,32,10
050,02,105,"Alaska","Hoonah-Angoon Census Area",4,0,17,8,9
050,02,105,"Alaska","Hoonah-Angoon Census Area",4,1,27,13,14
050,02,105,"Alaska","Hoonah-Angoon Census Area",4,2,24,13,11
050,02,105,"Alaska","Hoonah-Angoon Census Area",4,3,21,10,11
050,02,105,"Alaska","Hoonah-Angoon Census Area",4,4,17,10,7
050,02,105,"Alaska","Hoonah-Angoon Census Area",4,5,23,11,12
050,02,105,"Alaska","Hoonah-Angoon Census Area",4,6,14,6,8
050,02,105,"Alaska","Hoonah-Angoon Census Area",4,7,20,9,11
050,02,105,"Alaska","Hoonah-Angoon Census Area",4,8,20,9,11
050,02,105,"Alaska","Hoonah-Angoon Census Area",4,9,24,14,10
050,02,105,"Alaska","Hoonah-Angoon Census Area",4,10,21,12,9
050,02,105,"Alaska","Hoonah-Angoon Census Area",4,11,24,14,10
050,02,105,"Alaska","Hoonah-Angoon Census Area",4,12,19,9,10
050,02,105,"Alaska","Hoonah-Angoon Census Area",4,13,22,13,9
050,02,105,"Alaska","Hoonah-Angoon Census Area",4,14,22,14,8
050,02,105,"Alaska","Hoonah-Angoon Census Area",4,15,17,10,7
050,02,105,"Alaska","Hoonah-Angoon Census Area",4,16,19,11,8
050,02,105,"Alaska","Hoonah-Angoon Census Area",4,17,24,11,13
050,02,105,"Alaska","Hoonah-Angoon Census Area",4,18,19,5,14
050,02,105,"Alaska","Hoonah-Angoon Census Area",4,19,15,9,6
050,02,105,"Alaska","Hoonah-Angoon Census Area",4,20,15,5,10
050,02,105,"Alaska","Hoonah-Angoon Census Area",4,21,17,10,7
050,02,105,"Alaska","Hoonah-Angoon Census Area",4,22,16,8,8
050,02,105,"Alaska","Hoonah-Angoon Census Area",4,23,18,3,15
050,02,105,"Alaska","Hoonah-Angoon Census Area",4,24,20,12,8
050,02,105,"Alaska","Hoonah-Angoon Census Area",4,25,21,13,8
050,02,105,"Alaska","Hoonah-Angoon Census Area",4,26,19,7,12
050,02,105,"Alaska","Hoonah-Angoon Census Area",4,27,12,6,6
050,02,105,"Alaska","Hoonah-Angoon Census Area",4,28,18,11,7
050,02,105,"Alaska","Hoonah-Angoon Census Area",4,29,27,17,10
050,02,105,"Alaska","Hoonah-Angoon Census Area",4,30,36,25,11
050,02,105,"Alaska","Hoonah-Angoon Census Area",4,31,36,22,14
050,02,105,"Alaska","Hoonah-Angoon Census Area",4,32,23,14,9
050,02,105,"Alaska","Hoonah-Angoon Census Area",4,33,28,15,13
050,02,105,"Alaska","Hoonah-Angoon Census Area",4,34,27,14,13
050,02,105,"Alaska","Hoonah-Angoon Census Area",4,35,26,17,9
050,02,105,"Alaska","Hoonah-Angoon Census Area",4,36,19,14,5
050,02,105,"Alaska","Hoonah-Angoon Census Area",4,37,22,11,11
050,02,105,"Alaska","Hoonah-Angoon Census Area",4,38,24,16,8
050,02,105,"Alaska","Hoonah-Angoon Census Area",4,39,16,8,8
050,02,105,"Alaska","Hoonah-Angoon Census Area",4,40,29,14,15
050,02,105,"Alaska","Hoonah-Angoon Census Area",4,41,25,13,12
050,02,105,"Alaska","Hoonah-Angoon Census Area",4,42,18,9,9
050,02,105,"Alaska","Hoonah-Angoon Census Area",4,43,26,8,18
050,02,105,"Alaska","Hoonah-Angoon Census Area",4,44,28,11,17
050,02,105,"Alaska","Hoonah-Angoon Census Area",4,45,26,12,14
050,02,105,"Alaska","Hoonah-Angoon Census Area",4,46,27,17,10
050,02,105,"Alaska","Hoonah-Angoon Census Area",4,47,20,8,12
050,02,105,"Alaska","Hoonah-Angoon Census Area",4,48,17,8,9
050,02,105,"Alaska","Hoonah-Angoon Census Area",4,49,26,20,6
050,02,105,"Alaska","Hoonah-Angoon Census Area",4,50,30,21,9
050,02,105,"Alaska","Hoonah-Angoon Census Area",4,51,40,25,15
050,02,105,"Alaska","Hoonah-Angoon Census Area",4,52,32,23,9
050,02,105,"Alaska","Hoonah-Angoon Census Area",4,53,41,28,13
050,02,105,"Alaska","Hoonah-Angoon Census Area",4,54,36,21,15
050,02,105,"Alaska","Hoonah-Angoon Census Area",4,55,31,19,12
050,02,105,"Alaska","Hoonah-Angoon Census Area",4,56,31,18,13
050,02,105,"Alaska","Hoonah-Angoon Census Area",4,57,37,17,20
050,02,105,"Alaska","Hoonah-Angoon Census Area",4,58,45,18,27
050,02,105,"Alaska","Hoonah-Angoon Census Area",4,59,49,23,26
050,02,105,"Alaska","Hoonah-Angoon Census Area",4,60,39,26,13
050,02,105,"Alaska","Hoonah-Angoon Census Area",4,61,51,29,22
050,02,105,"Alaska","Hoonah-Angoon Census Area",4,62,47,26,21
050,02,105,"Alaska","Hoonah-Angoon Census Area",4,63,41,24,17
050,02,105,"Alaska","Hoonah-Angoon Census Area",4,64,42,17,25
050,02,105,"Alaska","Hoonah-Angoon Census Area",4,65,50,24,26
050,02,105,"Alaska","Hoonah-Angoon Census Area",4,66,39,21,18
050,02,105,"Alaska","Hoonah-Angoon Census Area",4,67,46,26,20
050,02,105,"Alaska","Hoonah-Angoon Census Area",4,68,43,21,22
050,02,105,"Alaska","Hoonah-Angoon Census Area",4,69,45,21,24
050,02,105,"Alaska","Hoonah-Angoon Census Area",4,70,41,19,22
050,02,105,"Alaska","Hoonah-Angoon Census Area",4,71,31,18,13
050,02,105,"Alaska","Hoonah-Angoon Census Area",4,72,38,19,19
050,02,105,"Alaska","Hoonah-Angoon Census Area",4,73,38,20,18
050,02,105,"Alaska","Hoonah-Angoon Census Area",4,74,31,23,8
050,02,105,"Alaska","Hoonah-Angoon Census Area",4,75,29,22,7
050,02,105,"Alaska","Hoonah-Angoon Census Area",4,76,20,15,5
050,02,105,"Alaska","Hoonah-Angoon Census Area",4,77,20,14,6
050,02,105,"Alaska","Hoonah-Angoon Census Area",4,78,22,16,6
050,02,105,"Alaska","Hoonah-Angoon Census Area",4,79,23,14,9
050,02,105,"Alaska","Hoonah-Angoon Census Area",4,80,11,3,8
050,02,105,"Alaska","Hoonah-Angoon Census Area",4,81,10,5,5
050,02,105,"Alaska","Hoonah-Angoon Census Area",4,82,12,7,5
050,02,105,"Alaska","Hoonah-Angoon Census Area",4,83,8,3,5
050,02,105,"Alaska","Hoonah-Angoon Census Area",4,84,2,0,2
050,02,105,"Alaska","Hoonah-Angoon Census Area",4,85,37,27,10
050,02,105,"Alaska","Hoonah-Angoon Census Area",5,0,17,9,8
050,02,105,"Alaska","Hoonah-Angoon Census Area",5,1,17,8,9
050,02,105,"Alaska","Hoonah-Angoon Census Area",5,2,28,15,13
050,02,105,"Alaska","Hoonah-Angoon Census Area",5,3,24,13,11
050,02,105,"Alaska","Hoonah-Angoon Census Area",5,4,21,10,11
050,02,105,"Alaska","Hoonah-Angoon Census Area",5,5,17,10,7
050,02,105,"Alaska","Hoonah-Angoon Census Area",5,6,20,9,11
050,02,105,"Alaska","Hoonah-Angoon Census Area",5,7,14,6,8
050,02,105,"Alaska","Hoonah-Angoon Census Area",5,8,18,6,12
050,02,105,"Alaska","Hoonah-Angoon Census Area",5,9,22,9,13
050,02,105,"Alaska","Hoonah-Angoon Census Area",5,10,24,14,10
050,02,105,"Alaska","Hoonah-Angoon Census Area",5,11,21,12,9
050,02,105,"Alaska","Hoonah-Angoon Census Area",5,12,24,14,10
050,02,105,"Alaska","Hoonah-Angoon Census Area",5,13,22,12,10
050,02,105,"Alaska","Hoonah-Angoon Census Area",5,14,23,13,10
050,02,105,"Alaska","Hoonah-Angoon Census Area",5,15,24,14,10
050,02,105,"Alaska","Hoonah-Angoon Census Area",5,16,20,10,10
050,02,105,"Alaska","Hoonah-Angoon Census Area",5,17,17,11,6
050,02,105,"Alaska","Hoonah-Angoon Census Area",5,18,22,10,12
050,02,105,"Alaska","Hoonah-Angoon Census Area",5,19,17,5,12
050,02,105,"Alaska","Hoonah-Angoon Census Area",5,20,17,10,7
050,02,105,"Alaska","Hoonah-Angoon Census Area",5,21,13,5,8
050,02,105,"Alaska","Hoonah-Angoon Census Area",5,22,16,10,6
050,02,105,"Alaska","Hoonah-Angoon Census Area",5,23,17,8,9
050,02,105,"Alaska","Hoonah-Angoon Census Area",5,24,21,6,15
050,02,105,"Alaska","Hoonah-Angoon Census Area",5,25,23,13,10
050,02,105,"Alaska","Hoonah-Angoon Census Area",5,26,19,12,7
050,02,105,"Alaska","Hoonah-Angoon Census Area",5,27,17,7,10
050,02,105,"Alaska","Hoonah-Angoon Census Area",5,28,14,8,6
050,02,105,"Alaska","Hoonah-Angoon Census Area",5,29,21,14,7
050,02,105,"Alaska","Hoonah-Angoon Census Area",5,30,28,16,12
050,02,105,"Alaska","Hoonah-Angoon Census Area",5,31,31,21,10
050,02,105,"Alaska","Hoonah-Angoon Census Area",5,32,34,20,14
050,02,105,"Alaska","Hoonah-Angoon Census Area",5,33,25,14,11
050,02,105,"Alaska","Hoonah-Angoon Census Area",5,34,27,14,13
050,02,105,"Alaska","Hoonah-Angoon Census Area",5,35,30,15,15
050,02,105,"Alaska","Hoonah-Angoon Census Area",5,36,26,17,9
050,02,105,"Alaska","Hoonah-Angoon Census Area",5,37,19,13,6
050,02,105,"Alaska","Hoonah-Angoon Census Area",5,38,24,12,12
050,02,105,"Alaska","Hoonah-Angoon Census Area",5,39,18,11,7
050,02,105,"Alaska","Hoonah-Angoon Census Area",5,40,15,9,6
050,02,105,"Alaska","Hoonah-Angoon Census Area",5,41,30,15,15
050,02,105,"Alaska","Hoonah-Angoon Census Area",5,42,24,14,10
050,02,105,"Alaska","Hoonah-Angoon Census Area",5,43,16,8,8
050,02,105,"Alaska","Hoonah-Angoon Census Area",5,44,22,7,15
050,02,105,"Alaska","Hoonah-Angoon Census Area",5,45,27,11,16
050,02,105,"Alaska","Hoonah-Angoon Census Area",5,46,26,12,14
050,02,105,"Alaska","Hoonah-Angoon Census Area",5,47,28,19,9
050,02,105,"Alaska","Hoonah-Angoon Census Area",5,48,17,7,10
050,02,105,"Alaska","Hoonah-Angoon Census Area",5,49,18,8,10
050,02,105,"Alaska","Hoonah-Angoon Census Area",5,50,29,21,8
050,02,105,"Alaska","Hoonah-Angoon Census Area",5,51,34,23,11
050,02,105,"Alaska","Hoonah-Angoon Census Area",5,52,38,23,15
050,02,105,"Alaska","Hoonah-Angoon Census Area",5,53,28,20,8
050,02,105,"Alaska","Hoonah-Angoon Census Area",5,54,38,25,13
050,02,105,"Alaska","Hoonah-Angoon Census Area",5,55,35,20,15
050,02,105,"Alaska","Hoonah-Angoon Census Area",5,56,33,19,14
050,02,105,"Alaska","Hoonah-Angoon Census Area",5,57,30,18,12
050,02,105,"Alaska","Hoonah-Angoon Census Area",5,58,38,17,21
050,02,105,"Alaska","Hoonah-Angoon Census Area",5,59,46,19,27
050,02,105,"Alaska","Hoonah-Angoon Census Area",5,60,45,21,24
050,02,105,"Alaska","Hoonah-Angoon Census Area",5,61,40,27,13
050,02,105,"Alaska","Hoonah-Angoon Census Area",5,62,51,29,22
050,02,105,"Alaska","Hoonah-Angoon Census Area",5,63,51,28,23
050,02,105,"Alaska","Hoonah-Angoon Census Area",5,64,42,24,18
050,02,105,"Alaska","Hoonah-Angoon Census Area",5,65,42,17,25
050,02,105,"Alaska","Hoonah-Angoon Census Area",5,66,50,25,25
050,02,105,"Alaska","Hoonah-Angoon Census Area",5,67,39,21,18
050,02,105,"Alaska","Hoonah-Angoon Census Area",5,68,49,28,21
050,02,105,"Alaska","Hoonah-Angoon Census Area",5,69,43,21,22
050,02,105,"Alaska","Hoonah-Angoon Census Area",5,70,44,20,24
050,02,105,"Alaska","Hoonah-Angoon Census Area",5,71,36,18,18
050,02,105,"Alaska","Hoonah-Angoon Census Area",5,72,32,19,13
050,02,105,"Alaska","Hoonah-Angoon Census Area",5,73,38,19,19
050,02,105,"Alaska","Hoonah-Angoon Census Area",5,74,38,20,18
050,02,105,"Alaska","Hoonah-Angoon Census Area",5,75,30,23,7
050,02,105,"Alaska","Hoonah-Angoon Census Area",5,76,29,22,7
050,02,105,"Alaska","Hoonah-Angoon Census Area",5,77,18,13,5
050,02,105,"Alaska","Hoonah-Angoon Census Area",5,78,19,13,6
050,02,105,"Alaska","Hoonah-Angoon Census Area",5,79,22,16,6
050,02,105,"Alaska","Hoonah-Angoon Census Area",5,80,17,10,7
050,02,105,"Alaska","Hoonah-Angoon Census Area",5,81,11,3,8
050,02,105,"Alaska","Hoonah-Angoon Census Area",5,82,10,5,5
050,02,105,"Alaska","Hoonah-Angoon Census Area",5,83,9,4,5
050,02,105,"Alaska","Hoonah-Angoon Census Area",5,84,7,3,4
050,02,105,"Alaska","Hoonah-Angoon Census Area",5,85,26,14,12
050,02,110,"Alaska","Juneau City and Borough",1,0,316,159,157
050,02,110,"Alaska","Juneau City and Borough",1,1,322,163,159
050,02,110,"Alaska","Juneau City and Borough",1,2,326,166,160
050,02,110,"Alaska","Juneau City and Borough",1,3,364,195,169
050,02,110,"Alaska","Juneau City and Borough",1,4,397,206,191
050,02,110,"Alaska","Juneau City and Borough",1,5,394,210,184
050,02,110,"Alaska","Juneau City and Borough",1,6,412,213,199
050,02,110,"Alaska","Juneau City and Borough",1,7,373,206,167
050,02,110,"Alaska","Juneau City and Borough",1,8,370,195,175
050,02,110,"Alaska","Juneau City and Borough",1,9,390,206,184
050,02,110,"Alaska","Juneau City and Borough",1,10,391,199,192
050,02,110,"Alaska","Juneau City and Borough",1,11,392,204,188
050,02,110,"Alaska","Juneau City and Borough",1,12,392,203,189
050,02,110,"Alaska","Juneau City and Borough",1,13,406,216,190
050,02,110,"Alaska","Juneau City and Borough",1,14,386,194,192
050,02,110,"Alaska","Juneau City and Borough",1,15,387,197,190
050,02,110,"Alaska","Juneau City and Borough",1,16,384,193,191
050,02,110,"Alaska","Juneau City and Borough",1,17,401,189,212
050,02,110,"Alaska","Juneau City and Borough",1,18,380,187,193
050,02,110,"Alaska","Juneau City and Borough",1,19,332,175,157
050,02,110,"Alaska","Juneau City and Borough",1,20,305,166,139
050,02,110,"Alaska","Juneau City and Borough",1,21,336,169,167
050,02,110,"Alaska","Juneau City and Borough",1,22,373,195,178
050,02,110,"Alaska","Juneau City and Borough",1,23,366,192,174
050,02,110,"Alaska","Juneau City and Borough",1,24,394,212,182
050,02,110,"Alaska","Juneau City and Borough",1,25,452,263,189
050,02,110,"Alaska","Juneau City and Borough",1,26,478,259,219
050,02,110,"Alaska","Juneau City and Borough",1,27,488,243,245
050,02,110,"Alaska","Juneau City and Borough",1,28,492,256,236
050,02,110,"Alaska","Juneau City and Borough",1,29,491,249,242
050,02,110,"Alaska","Juneau City and Borough",1,30,497,230,267
050,02,110,"Alaska","Juneau City and Borough",1,31,443,224,219
050,02,110,"Alaska","Juneau City and Borough",1,32,473,239,234
050,02,110,"Alaska","Juneau City and Borough",1,33,493,256,237
050,02,110,"Alaska","Juneau City and Borough",1,34,516,268,248
050,02,110,"Alaska","Juneau City and Borough",1,35,514,256,258
050,02,110,"Alaska","Juneau City and Borough",1,36,490,240,250
050,02,110,"Alaska","Juneau City and Borough",1,37,519,263,256
050,02,110,"Alaska","Juneau City and Borough",1,38,506,255,251
050,02,110,"Alaska","Juneau City and Borough",1,39,453,233,220
050,02,110,"Alaska","Juneau City and Borough",1,40,462,244,218
050,02,110,"Alaska","Juneau City and Borough",1,41,422,227,195
050,02,110,"Alaska","Juneau City and Borough",1,42,413,207,206
050,02,110,"Alaska","Juneau City and Borough",1,43,405,189,216
050,02,110,"Alaska","Juneau City and Borough",1,44,415,215,200
050,02,110,"Alaska","Juneau City and Borough",1,45,413,229,184
050,02,110,"Alaska","Juneau City and Borough",1,46,391,219,172
050,02,110,"Alaska","Juneau City and Borough",1,47,399,210,189
050,02,110,"Alaska","Juneau City and Borough",1,48,400,210,190
050,02,110,"Alaska","Juneau City and Borough",1,49,446,239,207
050,02,110,"Alaska","Juneau City and Borough",1,50,481,235,246
050,02,110,"Alaska","Juneau City and Borough",1,51,440,230,210
050,02,110,"Alaska","Juneau City and Borough",1,52,394,202,192
050,02,110,"Alaska","Juneau City and Borough",1,53,425,211,214
050,02,110,"Alaska","Juneau City and Borough",1,54,446,224,222
050,02,110,"Alaska","Juneau City and Borough",1,55,445,239,206
050,02,110,"Alaska","Juneau City and Borough",1,56,450,243,207
050,02,110,"Alaska","Juneau City and Borough",1,57,461,249,212
050,02,110,"Alaska","Juneau City and Borough",1,58,508,266,242
050,02,110,"Alaska","Juneau City and Borough",1,59,512,272,240
050,02,110,"Alaska","Juneau City and Borough",1,60,498,250,248
050,02,110,"Alaska","Juneau City and Borough",1,61,442,229,213
050,02,110,"Alaska","Juneau City and Borough",1,62,447,236,211
050,02,110,"Alaska","Juneau City and Borough",1,63,435,222,213
050,02,110,"Alaska","Juneau City and Borough",1,64,410,205,205
050,02,110,"Alaska","Juneau City and Borough",1,65,413,208,205
050,02,110,"Alaska","Juneau City and Borough",1,66,398,206,192
050,02,110,"Alaska","Juneau City and Borough",1,67,370,169,201
050,02,110,"Alaska","Juneau City and Borough",1,68,358,179,179
050,02,110,"Alaska","Juneau City and Borough",1,69,319,160,159
050,02,110,"Alaska","Juneau City and Borough",1,70,322,170,152
050,02,110,"Alaska","Juneau City and Borough",1,71,303,158,145
050,02,110,"Alaska","Juneau City and Borough",1,72,300,165,135
050,02,110,"Alaska","Juneau City and Borough",1,73,261,138,123
050,02,110,"Alaska","Juneau City and Borough",1,74,190,94,96
050,02,110,"Alaska","Juneau City and Borough",1,75,174,83,91
050,02,110,"Alaska","Juneau City and Borough",1,76,166,84,82
050,02,110,"Alaska","Juneau City and Borough",1,77,142,61,81
050,02,110,"Alaska","Juneau City and Borough",1,78,143,60,83
050,02,110,"Alaska","Juneau City and Borough",1,79,112,51,61
050,02,110,"Alaska","Juneau City and Borough",1,80,97,47,50
050,02,110,"Alaska","Juneau City and Borough",1,81,85,41,44
050,02,110,"Alaska","Juneau City and Borough",1,82,81,35,46
050,02,110,"Alaska","Juneau City and Borough",1,83,74,37,37
050,02,110,"Alaska","Juneau City and Borough",1,84,60,30,30
050,02,110,"Alaska","Juneau City and Borough",1,85,334,114,220
050,02,110,"Alaska","Juneau City and Borough",2,0,309,158,151
050,02,110,"Alaska","Juneau City and Borough",2,1,313,158,155
050,02,110,"Alaska","Juneau City and Borough",2,2,323,165,158
050,02,110,"Alaska","Juneau City and Borough",2,3,356,189,167
050,02,110,"Alaska","Juneau City and Borough",2,4,387,202,185
050,02,110,"Alaska","Juneau City and Borough",2,5,394,211,183
050,02,110,"Alaska","Juneau City and Borough",2,6,407,213,194
050,02,110,"Alaska","Juneau City and Borough",2,7,382,208,174
050,02,110,"Alaska","Juneau City and Borough",2,8,366,194,172
050,02,110,"Alaska","Juneau City and Borough",2,9,383,202,181
050,02,110,"Alaska","Juneau City and Borough",2,10,392,201,191
050,02,110,"Alaska","Juneau City and Borough",2,11,387,202,185
050,02,110,"Alaska","Juneau City and Borough",2,12,395,206,189
050,02,110,"Alaska","Juneau City and Borough",2,13,400,213,187
050,02,110,"Alaska","Juneau City and Borough",2,14,388,200,188
050,02,110,"Alaska","Juneau City and Borough",2,15,387,197,190
050,02,110,"Alaska","Juneau City and Borough",2,16,381,190,191
050,02,110,"Alaska","Juneau City and Borough",2,17,404,191,213
050,02,110,"Alaska","Juneau City and Borough",2,18,375,185,190
050,02,110,"Alaska","Juneau City and Borough",2,19,337,176,161
050,02,110,"Alaska","Juneau City and Borough",2,20,312,170,142
050,02,110,"Alaska","Juneau City and Borough",2,21,334,169,165
050,02,110,"Alaska","Juneau City and Borough",2,22,367,193,174
050,02,110,"Alaska","Juneau City and Borough",2,23,370,195,175
050,02,110,"Alaska","Juneau City and Borough",2,24,392,209,183
050,02,110,"Alaska","Juneau City and Borough",2,25,443,254,189
050,02,110,"Alaska","Juneau City and Borough",2,26,475,261,214
050,02,110,"Alaska","Juneau City and Borough",2,27,482,243,239
050,02,110,"Alaska","Juneau City and Borough",2,28,494,254,240
050,02,110,"Alaska","Juneau City and Borough",2,29,493,251,242
050,02,110,"Alaska","Juneau City and Borough",2,30,495,235,260
050,02,110,"Alaska","Juneau City and Borough",2,31,453,226,227
050,02,110,"Alaska","Juneau City and Borough",2,32,464,233,231
050,02,110,"Alaska","Juneau City and Borough",2,33,486,248,238
050,02,110,"Alaska","Juneau City and Borough",2,34,512,269,243
050,02,110,"Alaska","Juneau City and Borough",2,35,515,261,254
050,02,110,"Alaska","Juneau City and Borough",2,36,495,244,251
050,02,110,"Alaska","Juneau City and Borough",2,37,518,263,255
050,02,110,"Alaska","Juneau City and Borough",2,38,511,259,252
050,02,110,"Alaska","Juneau City and Borough",2,39,464,239,225
050,02,110,"Alaska","Juneau City and Borough",2,40,462,242,220
050,02,110,"Alaska","Juneau City and Borough",2,41,431,232,199
050,02,110,"Alaska","Juneau City and Borough",2,42,414,210,204
050,02,110,"Alaska","Juneau City and Borough",2,43,409,194,215
050,02,110,"Alaska","Juneau City and Borough",2,44,411,209,202
050,02,110,"Alaska","Juneau City and Borough",2,45,411,223,188
050,02,110,"Alaska","Juneau City and Borough",2,46,396,223,173
050,02,110,"Alaska","Juneau City and Borough",2,47,393,209,184
050,02,110,"Alaska","Juneau City and Borough",2,48,399,211,188
050,02,110,"Alaska","Juneau City and Borough",2,49,435,231,204
050,02,110,"Alaska","Juneau City and Borough",2,50,477,239,238
050,02,110,"Alaska","Juneau City and Borough",2,51,446,230,216
050,02,110,"Alaska","Juneau City and Borough",2,52,404,209,195
050,02,110,"Alaska","Juneau City and Borough",2,53,417,208,209
050,02,110,"Alaska","Juneau City and Borough",2,54,434,219,215
050,02,110,"Alaska","Juneau City and Borough",2,55,445,235,210
050,02,110,"Alaska","Juneau City and Borough",2,56,447,243,204
050,02,110,"Alaska","Juneau City and Borough",2,57,456,246,210
050,02,110,"Alaska","Juneau City and Borough",2,58,494,260,234
050,02,110,"Alaska","Juneau City and Borough",2,59,507,270,237
050,02,110,"Alaska","Juneau City and Borough",2,60,493,250,243
050,02,110,"Alaska","Juneau City and Borough",2,61,449,232,217
050,02,110,"Alaska","Juneau City and Borough",2,62,443,234,209
050,02,110,"Alaska","Juneau City and Borough",2,63,436,222,214
050,02,110,"Alaska","Juneau City and Borough",2,64,405,203,202
050,02,110,"Alaska","Juneau City and Borough",2,65,409,207,202
050,02,110,"Alaska","Juneau City and Borough",2,66,398,204,194
050,02,110,"Alaska","Juneau City and Borough",2,67,370,173,197
050,02,110,"Alaska","Juneau City and Borough",2,68,354,173,181
050,02,110,"Alaska","Juneau City and Borough",2,69,329,164,165
050,02,110,"Alaska","Juneau City and Borough",2,70,322,168,154
050,02,110,"Alaska","Juneau City and Borough",2,71,302,155,147
050,02,110,"Alaska","Juneau City and Borough",2,72,299,161,138
050,02,110,"Alaska","Juneau City and Borough",2,73,282,150,132
050,02,110,"Alaska","Juneau City and Borough",2,74,197,99,98
050,02,110,"Alaska","Juneau City and Borough",2,75,176,85,91
050,02,110,"Alaska","Juneau City and Borough",2,76,164,82,82
050,02,110,"Alaska","Juneau City and Borough",2,77,151,68,83
050,02,110,"Alaska","Juneau City and Borough",2,78,140,59,81
050,02,110,"Alaska","Juneau City and Borough",2,79,119,52,67
050,02,110,"Alaska","Juneau City and Borough",2,80,100,48,52
050,02,110,"Alaska","Juneau City and Borough",2,81,85,42,43
050,02,110,"Alaska","Juneau City and Borough",2,82,83,36,47
050,02,110,"Alaska","Juneau City and Borough",2,83,73,35,38
050,02,110,"Alaska","Juneau City and Borough",2,84,62,31,31
050,02,110,"Alaska","Juneau City and Borough",2,85,339,117,222
050,02,110,"Alaska","Juneau City and Borough",3,0,285,151,134
050,02,110,"Alaska","Juneau City and Borough",3,1,308,148,160
050,02,110,"Alaska","Juneau City and Borough",3,2,302,149,153
050,02,110,"Alaska","Juneau City and Borough",3,3,338,177,161
050,02,110,"Alaska","Juneau City and Borough",3,4,352,181,171
050,02,110,"Alaska","Juneau City and Borough",3,5,385,198,187
050,02,110,"Alaska","Juneau City and Borough",3,6,405,215,190
050,02,110,"Alaska","Juneau City and Borough",3,7,396,206,190
050,02,110,"Alaska","Juneau City and Borough",3,8,388,209,179
050,02,110,"Alaska","Juneau City and Borough",3,9,361,194,167
050,02,110,"Alaska","Juneau City and Borough",3,10,379,200,179
050,02,110,"Alaska","Juneau City and Borough",3,11,396,205,191
050,02,110,"Alaska","Juneau City and Borough",3,12,380,194,186
050,02,110,"Alaska","Juneau City and Borough",3,13,375,196,179
050,02,110,"Alaska","Juneau City and Borough",3,14,398,210,188
050,02,110,"Alaska","Juneau City and Borough",3,15,389,202,187
050,02,110,"Alaska","Juneau City and Borough",3,16,388,192,196
050,02,110,"Alaska","Juneau City and Borough",3,17,390,189,201
050,02,110,"Alaska","Juneau City and Borough",3,18,368,176,192
050,02,110,"Alaska","Juneau City and Borough",3,19,326,160,166
050,02,110,"Alaska","Juneau City and Borough",3,20,339,182,157
050,02,110,"Alaska","Juneau City and Borough",3,21,317,168,149
050,02,110,"Alaska","Juneau City and Borough",3,22,351,183,168
050,02,110,"Alaska","Juneau City and Borough",3,23,375,190,185
050,02,110,"Alaska","Juneau City and Borough",3,24,382,184,198
050,02,110,"Alaska","Juneau City and Borough",3,25,405,220,185
050,02,110,"Alaska","Juneau City and Borough",3,26,423,246,177
050,02,110,"Alaska","Juneau City and Borough",3,27,460,253,207
050,02,110,"Alaska","Juneau City and Borough",3,28,464,228,236
050,02,110,"Alaska","Juneau City and Borough",3,29,487,251,236
050,02,110,"Alaska","Juneau City and Borough",3,30,488,249,239
050,02,110,"Alaska","Juneau City and Borough",3,31,489,235,254
050,02,110,"Alaska","Juneau City and Borough",3,32,458,211,247
050,02,110,"Alaska","Juneau City and Borough",3,33,464,225,239
050,02,110,"Alaska","Juneau City and Borough",3,34,493,251,242
050,02,110,"Alaska","Juneau City and Borough",3,35,525,274,251
050,02,110,"Alaska","Juneau City and Borough",3,36,513,266,247
050,02,110,"Alaska","Juneau City and Borough",3,37,478,247,231
050,02,110,"Alaska","Juneau City and Borough",3,38,488,241,247
050,02,110,"Alaska","Juneau City and Borough",3,39,508,256,252
050,02,110,"Alaska","Juneau City and Borough",3,40,449,229,220
050,02,110,"Alaska","Juneau City and Borough",3,41,474,248,226
050,02,110,"Alaska","Juneau City and Borough",3,42,434,238,196
050,02,110,"Alaska","Juneau City and Borough",3,43,405,205,200
050,02,110,"Alaska","Juneau City and Borough",3,44,395,195,200
050,02,110,"Alaska","Juneau City and Borough",3,45,408,200,208
050,02,110,"Alaska","Juneau City and Borough",3,46,417,229,188
050,02,110,"Alaska","Juneau City and Borough",3,47,376,210,166
050,02,110,"Alaska","Juneau City and Borough",3,48,396,214,182
050,02,110,"Alaska","Juneau City and Borough",3,49,382,198,184
050,02,110,"Alaska","Juneau City and Borough",3,50,437,233,204
050,02,110,"Alaska","Juneau City and Borough",3,51,462,227,235
050,02,110,"Alaska","Juneau City and Borough",3,52,438,225,213
050,02,110,"Alaska","Juneau City and Borough",3,53,404,207,197
050,02,110,"Alaska","Juneau City and Borough",3,54,412,210,202
050,02,110,"Alaska","Juneau City and Borough",3,55,442,225,217
050,02,110,"Alaska","Juneau City and Borough",3,56,441,235,206
050,02,110,"Alaska","Juneau City and Borough",3,57,447,241,206
050,02,110,"Alaska","Juneau City and Borough",3,58,452,245,207
050,02,110,"Alaska","Juneau City and Borough",3,59,484,249,235
050,02,110,"Alaska","Juneau City and Borough",3,60,499,256,243
050,02,110,"Alaska","Juneau City and Borough",3,61,483,248,235
050,02,110,"Alaska","Juneau City and Borough",3,62,424,227,197
050,02,110,"Alaska","Juneau City and Borough",3,63,436,228,208
050,02,110,"Alaska","Juneau City and Borough",3,64,418,212,206
050,02,110,"Alaska","Juneau City and Borough",3,65,389,202,187
050,02,110,"Alaska","Juneau City and Borough",3,66,396,194,202
050,02,110,"Alaska","Juneau City and Borough",3,67,374,192,182
050,02,110,"Alaska","Juneau City and Borough",3,68,364,172,192
050,02,110,"Alaska","Juneau City and Borough",3,69,345,167,178
050,02,110,"Alaska","Juneau City and Borough",3,70,320,160,160
050,02,110,"Alaska","Juneau City and Borough",3,71,307,163,144
050,02,110,"Alaska","Juneau City and Borough",3,72,308,155,153
050,02,110,"Alaska","Juneau City and Borough",3,73,286,155,131
050,02,110,"Alaska","Juneau City and Borough",3,74,274,145,129
050,02,110,"Alaska","Juneau City and Borough",3,75,189,96,93
050,02,110,"Alaska","Juneau City and Borough",3,76,170,83,87
050,02,110,"Alaska","Juneau City and Borough",3,77,152,75,77
050,02,110,"Alaska","Juneau City and Borough",3,78,142,68,74
050,02,110,"Alaska","Juneau City and Borough",3,79,136,54,82
050,02,110,"Alaska","Juneau City and Borough",3,80,112,49,63
050,02,110,"Alaska","Juneau City and Borough",3,81,84,42,42
050,02,110,"Alaska","Juneau City and Borough",3,82,89,43,46
050,02,110,"Alaska","Juneau City and Borough",3,83,82,35,47
050,02,110,"Alaska","Juneau City and Borough",3,84,63,31,32
050,02,110,"Alaska","Juneau City and Borough",3,85,366,132,234
050,02,110,"Alaska","Juneau City and Borough",4,0,298,140,158
050,02,110,"Alaska","Juneau City and Borough",4,1,280,152,128
050,02,110,"Alaska","Juneau City and Borough",4,2,302,141,161
050,02,110,"Alaska","Juneau City and Borough",4,3,301,155,146
050,02,110,"Alaska","Juneau City and Borough",4,4,329,172,157
050,02,110,"Alaska","Juneau City and Borough",4,5,357,184,173
050,02,110,"Alaska","Juneau City and Borough",4,6,372,195,177
050,02,110,"Alaska","Juneau City and Borough",4,7,407,215,192
050,02,110,"Alaska","Juneau City and Borough",4,8,394,205,189
050,02,110,"Alaska","Juneau City and Borough",4,9,384,212,172
050,02,110,"Alaska","Juneau City and Borough",4,10,352,181,171
050,02,110,"Alaska","Juneau City and Borough",4,11,372,192,180
050,02,110,"Alaska","Juneau City and Borough",4,12,399,203,196
050,02,110,"Alaska","Juneau City and Borough",4,13,379,191,188
050,02,110,"Alaska","Juneau City and Borough",4,14,371,192,179
050,02,110,"Alaska","Juneau City and Borough",4,15,390,207,183
050,02,110,"Alaska","Juneau City and Borough",4,16,375,194,181
050,02,110,"Alaska","Juneau City and Borough",4,17,401,195,206
050,02,110,"Alaska","Juneau City and Borough",4,18,352,173,179
050,02,110,"Alaska","Juneau City and Borough",4,19,338,166,172
050,02,110,"Alaska","Juneau City and Borough",4,20,312,150,162
050,02,110,"Alaska","Juneau City and Borough",4,21,349,179,170
050,02,110,"Alaska","Juneau City and Borough",4,22,344,187,157
050,02,110,"Alaska","Juneau City and Borough",4,23,334,173,161
050,02,110,"Alaska","Juneau City and Borough",4,24,364,185,179
050,02,110,"Alaska","Juneau City and Borough",4,25,387,194,193
050,02,110,"Alaska","Juneau City and Borough",4,26,402,227,175
050,02,110,"Alaska","Juneau City and Borough",4,27,450,269,181
050,02,110,"Alaska","Juneau City and Borough",4,28,456,247,209
050,02,110,"Alaska","Juneau City and Borough",4,29,477,243,234
050,02,110,"Alaska","Juneau City and Borough",4,30,488,256,232
050,02,110,"Alaska","Juneau City and Borough",4,31,472,247,225
050,02,110,"Alaska","Juneau City and Borough",4,32,479,220,259
050,02,110,"Alaska","Juneau City and Borough",4,33,485,219,266
050,02,110,"Alaska","Juneau City and Borough",4,34,470,223,247
050,02,110,"Alaska","Juneau City and Borough",4,35,467,239,228
050,02,110,"Alaska","Juneau City and Borough",4,36,518,272,246
050,02,110,"Alaska","Juneau City and Borough",4,37,513,271,242
050,02,110,"Alaska","Juneau City and Borough",4,38,471,241,230
050,02,110,"Alaska","Juneau City and Borough",4,39,484,231,253
050,02,110,"Alaska","Juneau City and Borough",4,40,501,258,243
050,02,110,"Alaska","Juneau City and Borough",4,41,453,234,219
050,02,110,"Alaska","Juneau City and Borough",4,42,481,265,216
050,02,110,"Alaska","Juneau City and Borough",4,43,429,235,194
050,02,110,"Alaska","Juneau City and Borough",4,44,407,204,203
050,02,110,"Alaska","Juneau City and Borough",4,45,380,183,197
050,02,110,"Alaska","Juneau City and Borough",4,46,414,191,223
050,02,110,"Alaska","Juneau City and Borough",4,47,415,224,191
050,02,110,"Alaska","Juneau City and Borough",4,48,387,222,165
050,02,110,"Alaska","Juneau City and Borough",4,49,377,203,174
050,02,110,"Alaska","Juneau City and Borough",4,50,393,211,182
050,02,110,"Alaska","Juneau City and Borough",4,51,425,225,200
050,02,110,"Alaska","Juneau City and Borough",4,52,454,219,235
050,02,110,"Alaska","Juneau City and Borough",4,53,433,226,207
050,02,110,"Alaska","Juneau City and Borough",4,54,408,211,197
050,02,110,"Alaska","Juneau City and Borough",4,55,398,200,198
050,02,110,"Alaska","Juneau City and Borough",4,56,439,225,214
050,02,110,"Alaska","Juneau City and Borough",4,57,430,221,209
050,02,110,"Alaska","Juneau City and Borough",4,58,427,233,194
050,02,110,"Alaska","Juneau City and Borough",4,59,440,238,202
050,02,110,"Alaska","Juneau City and Borough",4,60,472,233,239
050,02,110,"Alaska","Juneau City and Borough",4,61,490,253,237
050,02,110,"Alaska","Juneau City and Borough",4,62,456,238,218
050,02,110,"Alaska","Juneau City and Borough",4,63,404,206,198
050,02,110,"Alaska","Juneau City and Borough",4,64,413,212,201
050,02,110,"Alaska","Juneau City and Borough",4,65,393,203,190
050,02,110,"Alaska","Juneau City and Borough",4,66,386,198,188
050,02,110,"Alaska","Juneau City and Borough",4,67,375,182,193
050,02,110,"Alaska","Juneau City and Borough",4,68,359,188,171
050,02,110,"Alaska","Juneau City and Borough",4,69,356,167,189
050,02,110,"Alaska","Juneau City and Borough",4,70,346,165,181
050,02,110,"Alaska","Juneau City and Borough",4,71,308,152,156
050,02,110,"Alaska","Juneau City and Borough",4,72,308,167,141
050,02,110,"Alaska","Juneau City and Borough",4,73,287,146,141
050,02,110,"Alaska","Juneau City and Borough",4,74,273,146,127
050,02,110,"Alaska","Juneau City and Borough",4,75,259,138,121
050,02,110,"Alaska","Juneau City and Borough",4,76,182,93,89
050,02,110,"Alaska","Juneau City and Borough",4,77,167,83,84
050,02,110,"Alaska","Juneau City and Borough",4,78,146,74,72
050,02,110,"Alaska","Juneau City and Borough",4,79,135,61,74
050,02,110,"Alaska","Juneau City and Borough",4,80,133,52,81
050,02,110,"Alaska","Juneau City and Borough",4,81,104,48,56
050,02,110,"Alaska","Juneau City and Borough",4,82,87,41,46
050,02,110,"Alaska","Juneau City and Borough",4,83,84,40,44
050,02,110,"Alaska","Juneau City and Borough",4,84,79,34,45
050,02,110,"Alaska","Juneau City and Borough",4,85,372,135,237
050,02,110,"Alaska","Juneau City and Borough",5,0,288,141,147
050,02,110,"Alaska","Juneau City and Borough",5,1,286,125,161
050,02,110,"Alaska","Juneau City and Borough",5,2,271,138,133
050,02,110,"Alaska","Juneau City and Borough",5,3,310,155,155
050,02,110,"Alaska","Juneau City and Borough",5,4,284,145,139
050,02,110,"Alaska","Juneau City and Borough",5,5,332,168,164
050,02,110,"Alaska","Juneau City and Borough",5,6,362,183,179
050,02,110,"Alaska","Juneau City and Borough",5,7,376,199,177
050,02,110,"Alaska","Juneau City and Borough",5,8,400,213,187
050,02,110,"Alaska","Juneau City and Borough",5,9,381,200,181
050,02,110,"Alaska","Juneau City and Borough",5,10,380,208,172
050,02,110,"Alaska","Juneau City and Borough",5,11,345,176,169
050,02,110,"Alaska","Juneau City and Borough",5,12,368,192,176
050,02,110,"Alaska","Juneau City and Borough",5,13,392,196,196
050,02,110,"Alaska","Juneau City and Borough",5,14,377,190,187
050,02,110,"Alaska","Juneau City and Borough",5,15,370,195,175
050,02,110,"Alaska","Juneau City and Borough",5,16,372,200,172
050,02,110,"Alaska","Juneau City and Borough",5,17,394,203,191
050,02,110,"Alaska","Juneau City and Borough",5,18,369,182,187
050,02,110,"Alaska","Juneau City and Borough",5,19,330,164,166
050,02,110,"Alaska","Juneau City and Borough",5,20,321,154,167
050,02,110,"Alaska","Juneau City and Borough",5,21,326,151,175
050,02,110,"Alaska","Juneau City and Borough",5,22,358,186,172
050,02,110,"Alaska","Juneau City and Borough",5,23,361,190,171
050,02,110,"Alaska","Juneau City and Borough",5,24,348,190,158
050,02,110,"Alaska","Juneau City and Borough",5,25,394,208,186
050,02,110,"Alaska","Juneau City and Borough",5,26,401,196,205
050,02,110,"Alaska","Juneau City and Borough",5,27,394,218,176
050,02,110,"Alaska","Juneau City and Borough",5,28,457,273,184
050,02,110,"Alaska","Juneau City and Borough",5,29,485,263,222
050,02,110,"Alaska","Juneau City and Borough",5,30,460,235,225
050,02,110,"Alaska","Juneau City and Borough",5,31,475,252,223
050,02,110,"Alaska","Juneau City and Borough",5,32,453,226,227
050,02,110,"Alaska","Juneau City and Borough",5,33,484,225,259
050,02,110,"Alaska","Juneau City and Borough",5,34,504,231,273
050,02,110,"Alaska","Juneau City and Borough",5,35,465,220,245
050,02,110,"Alaska","Juneau City and Borough",5,36,463,235,228
050,02,110,"Alaska","Juneau City and Borough",5,37,509,266,243
050,02,110,"Alaska","Juneau City and Borough",5,38,499,266,233
050,02,110,"Alaska","Juneau City and Borough",5,39,493,261,232
050,02,110,"Alaska","Juneau City and Borough",5,40,473,220,253
050,02,110,"Alaska","Juneau City and Borough",5,41,504,259,245
050,02,110,"Alaska","Juneau City and Borough",5,42,439,231,208
050,02,110,"Alaska","Juneau City and Borough",5,43,479,261,218
050,02,110,"Alaska","Juneau City and Borough",5,44,426,235,191
050,02,110,"Alaska","Juneau City and Borough",5,45,386,189,197
050,02,110,"Alaska","Juneau City and Borough",5,46,383,192,191
050,02,110,"Alaska","Juneau City and Borough",5,47,392,187,205
050,02,110,"Alaska","Juneau City and Borough",5,48,410,221,189
050,02,110,"Alaska","Juneau City and Borough",5,49,362,201,161
050,02,110,"Alaska","Juneau City and Borough",5,50,390,211,179
050,02,110,"Alaska","Juneau City and Borough",5,51,381,201,180
050,02,110,"Alaska","Juneau City and Borough",5,52,428,227,201
050,02,110,"Alaska","Juneau City and Borough",5,53,455,217,238
050,02,110,"Alaska","Juneau City and Borough",5,54,422,222,200
050,02,110,"Alaska","Juneau City and Borough",5,55,396,203,193
050,02,110,"Alaska","Juneau City and Borough",5,56,388,199,189
050,02,110,"Alaska","Juneau City and Borough",5,57,421,213,208
050,02,110,"Alaska","Juneau City and Borough",5,58,417,218,199
050,02,110,"Alaska","Juneau City and Borough",5,59,416,220,196
050,02,110,"Alaska","Juneau City and Borough",5,60,442,231,211
050,02,110,"Alaska","Juneau City and Borough",5,61,454,229,225
050,02,110,"Alaska","Juneau City and Borough",5,62,479,248,231
050,02,110,"Alaska","Juneau City and Borough",5,63,438,225,213
050,02,110,"Alaska","Juneau City and Borough",5,64,381,191,190
050,02,110,"Alaska","Juneau City and Borough",5,65,410,221,189
050,02,110,"Alaska","Juneau City and Borough",5,66,396,207,189
050,02,110,"Alaska","Juneau City and Borough",5,67,377,191,186
050,02,110,"Alaska","Juneau City and Borough",5,68,357,171,186
050,02,110,"Alaska","Juneau City and Borough",5,69,355,185,170
050,02,110,"Alaska","Juneau City and Borough",5,70,345,165,180
050,02,110,"Alaska","Juneau City and Borough",5,71,330,157,173
050,02,110,"Alaska","Juneau City and Borough",5,72,314,152,162
050,02,110,"Alaska","Juneau City and Borough",5,73,294,157,137
050,02,110,"Alaska","Juneau City and Borough",5,74,275,138,137
050,02,110,"Alaska","Juneau City and Borough",5,75,266,144,122
050,02,110,"Alaska","Juneau City and Borough",5,76,252,132,120
050,02,110,"Alaska","Juneau City and Borough",5,77,177,93,84
050,02,110,"Alaska","Juneau City and Borough",5,78,160,81,79
050,02,110,"Alaska","Juneau City and Borough",5,79,145,68,77
050,02,110,"Alaska","Juneau City and Borough",5,80,131,60,71
050,02,110,"Alaska","Juneau City and Borough",5,81,121,50,71
050,02,110,"Alaska","Juneau City and Borough",5,82,104,46,58
050,02,110,"Alaska","Juneau City and Borough",5,83,82,38,44
050,02,110,"Alaska","Juneau City and Borough",5,84,79,39,40
050,02,110,"Alaska","Juneau City and Borough",5,85,386,136,250
050,02,122,"Alaska","Kenai Peninsula Borough",1,0,662,337,325
050,02,122,"Alaska","Kenai Peninsula Borough",1,1,667,346,321
050,02,122,"Alaska","Kenai Peninsula Borough",1,2,687,368,319
050,02,122,"Alaska","Kenai Peninsula Borough",1,3,710,367,343
050,02,122,"Alaska","Kenai Peninsula Borough",1,4,711,364,347
050,02,122,"Alaska","Kenai Peninsula Borough",1,5,696,363,333
050,02,122,"Alaska","Kenai Peninsula Borough",1,6,700,366,334
050,02,122,"Alaska","Kenai Peninsula Borough",1,7,732,389,343
050,02,122,"Alaska","Kenai Peninsula Borough",1,8,734,372,362
050,02,122,"Alaska","Kenai Peninsula Borough",1,9,743,402,341
050,02,122,"Alaska","Kenai Peninsula Borough",1,10,782,392,390
050,02,122,"Alaska","Kenai Peninsula Borough",1,11,793,405,388
050,02,122,"Alaska","Kenai Peninsula Borough",1,12,777,406,371
050,02,122,"Alaska","Kenai Peninsula Borough",1,13,784,405,379
050,02,122,"Alaska","Kenai Peninsula Borough",1,14,762,409,353
050,02,122,"Alaska","Kenai Peninsula Borough",1,15,735,399,336
050,02,122,"Alaska","Kenai Peninsula Borough",1,16,772,399,373
050,02,122,"Alaska","Kenai Peninsula Borough",1,17,781,402,379
050,02,122,"Alaska","Kenai Peninsula Borough",1,18,648,349,299
050,02,122,"Alaska","Kenai Peninsula Borough",1,19,570,317,253
050,02,122,"Alaska","Kenai Peninsula Borough",1,20,579,320,259
050,02,122,"Alaska","Kenai Peninsula Borough",1,21,616,343,273
050,02,122,"Alaska","Kenai Peninsula Borough",1,22,587,318,269
050,02,122,"Alaska","Kenai Peninsula Borough",1,23,605,325,280
050,02,122,"Alaska","Kenai Peninsula Borough",1,24,654,354,300
050,02,122,"Alaska","Kenai Peninsula Borough",1,25,670,360,310
050,02,122,"Alaska","Kenai Peninsula Borough",1,26,653,346,307
050,02,122,"Alaska","Kenai Peninsula Borough",1,27,698,372,326
050,02,122,"Alaska","Kenai Peninsula Borough",1,28,763,407,356
050,02,122,"Alaska","Kenai Peninsula Borough",1,29,799,430,369
050,02,122,"Alaska","Kenai Peninsula Borough",1,30,828,444,384
050,02,122,"Alaska","Kenai Peninsula Borough",1,31,713,371,342
050,02,122,"Alaska","Kenai Peninsula Borough",1,32,712,364,348
050,02,122,"Alaska","Kenai Peninsula Borough",1,33,698,368,330
050,02,122,"Alaska","Kenai Peninsula Borough",1,34,762,405,357
050,02,122,"Alaska","Kenai Peninsula Borough",1,35,758,399,359
050,02,122,"Alaska","Kenai Peninsula Borough",1,36,753,403,350
050,02,122,"Alaska","Kenai Peninsula Borough",1,37,806,431,375
050,02,122,"Alaska","Kenai Peninsula Borough",1,38,797,423,374
050,02,122,"Alaska","Kenai Peninsula Borough",1,39,776,403,373
050,02,122,"Alaska","Kenai Peninsula Borough",1,40,696,367,329
050,02,122,"Alaska","Kenai Peninsula Borough",1,41,720,382,338
050,02,122,"Alaska","Kenai Peninsula Borough",1,42,678,368,310
050,02,122,"Alaska","Kenai Peninsula Borough",1,43,664,355,309
050,02,122,"Alaska","Kenai Peninsula Borough",1,44,663,372,291
050,02,122,"Alaska","Kenai Peninsula Borough",1,45,642,337,305
050,02,122,"Alaska","Kenai Peninsula Borough",1,46,632,331,301
050,02,122,"Alaska","Kenai Peninsula Borough",1,47,650,332,318
050,02,122,"Alaska","Kenai Peninsula Borough",1,48,715,375,340
050,02,122,"Alaska","Kenai Peninsula Borough",1,49,758,405,353
050,02,122,"Alaska","Kenai Peninsula Borough",1,50,728,388,340
050,02,122,"Alaska","Kenai Peninsula Borough",1,51,708,392,316
050,02,122,"Alaska","Kenai Peninsula Borough",1,52,699,358,341
050,02,122,"Alaska","Kenai Peninsula Borough",1,53,699,350,349
050,02,122,"Alaska","Kenai Peninsula Borough",1,54,717,363,354
050,02,122,"Alaska","Kenai Peninsula Borough",1,55,758,398,360
050,02,122,"Alaska","Kenai Peninsula Borough",1,56,805,407,398
050,02,122,"Alaska","Kenai Peninsula Borough",1,57,812,424,388
050,02,122,"Alaska","Kenai Peninsula Borough",1,58,879,466,413
050,02,122,"Alaska","Kenai Peninsula Borough",1,59,941,492,449
050,02,122,"Alaska","Kenai Peninsula Borough",1,60,942,491,451
050,02,122,"Alaska","Kenai Peninsula Borough",1,61,928,483,445
050,02,122,"Alaska","Kenai Peninsula Borough",1,62,958,496,462
050,02,122,"Alaska","Kenai Peninsula Borough",1,63,939,470,469
050,02,122,"Alaska","Kenai Peninsula Borough",1,64,918,470,448
050,02,122,"Alaska","Kenai Peninsula Borough",1,65,916,478,438
050,02,122,"Alaska","Kenai Peninsula Borough",1,66,927,483,444
050,02,122,"Alaska","Kenai Peninsula Borough",1,67,881,470,411
050,02,122,"Alaska","Kenai Peninsula Borough",1,68,855,445,410
050,02,122,"Alaska","Kenai Peninsula Borough",1,69,764,400,364
050,02,122,"Alaska","Kenai Peninsula Borough",1,70,732,376,356
050,02,122,"Alaska","Kenai Peninsula Borough",1,71,661,352,309
050,02,122,"Alaska","Kenai Peninsula Borough",1,72,633,334,299
050,02,122,"Alaska","Kenai Peninsula Borough",1,73,616,318,298
050,02,122,"Alaska","Kenai Peninsula Borough",1,74,413,223,190
050,02,122,"Alaska","Kenai Peninsula Borough",1,75,424,239,185
050,02,122,"Alaska","Kenai Peninsula Borough",1,76,439,237,202
050,02,122,"Alaska","Kenai Peninsula Borough",1,77,401,209,192
050,02,122,"Alaska","Kenai Peninsula Borough",1,78,309,167,142
050,02,122,"Alaska","Kenai Peninsula Borough",1,79,297,165,132
050,02,122,"Alaska","Kenai Peninsula Borough",1,80,234,119,115
050,02,122,"Alaska","Kenai Peninsula Borough",1,81,208,107,101
050,02,122,"Alaska","Kenai Peninsula Borough",1,82,175,89,86
050,02,122,"Alaska","Kenai Peninsula Borough",1,83,147,84,63
050,02,122,"Alaska","Kenai Peninsula Borough",1,84,145,76,69
050,02,122,"Alaska","Kenai Peninsula Borough",1,85,702,294,408
050,02,122,"Alaska","Kenai Peninsula Borough",2,0,647,328,319
050,02,122,"Alaska","Kenai Peninsula Borough",2,1,668,347,321
050,02,122,"Alaska","Kenai Peninsula Borough",2,2,685,366,319
050,02,122,"Alaska","Kenai Peninsula Borough",2,3,703,367,336
050,02,122,"Alaska","Kenai Peninsula Borough",2,4,714,368,346
050,02,122,"Alaska","Kenai Peninsula Borough",2,5,702,365,337
050,02,122,"Alaska","Kenai Peninsula Borough",2,6,704,370,334
050,02,122,"Alaska","Kenai Peninsula Borough",2,7,724,383,341
050,02,122,"Alaska","Kenai Peninsula Borough",2,8,735,378,357
050,02,122,"Alaska","Kenai Peninsula Borough",2,9,739,393,346
050,02,122,"Alaska","Kenai Peninsula Borough",2,10,772,394,378
050,02,122,"Alaska","Kenai Peninsula Borough",2,11,785,401,384
050,02,122,"Alaska","Kenai Peninsula Borough",2,12,785,408,377
050,02,122,"Alaska","Kenai Peninsula Borough",2,13,784,407,377
050,02,122,"Alaska","Kenai Peninsula Borough",2,14,767,406,361
050,02,122,"Alaska","Kenai Peninsula Borough",2,15,743,400,343
050,02,122,"Alaska","Kenai Peninsula Borough",2,16,764,400,364
050,02,122,"Alaska","Kenai Peninsula Borough",2,17,780,402,378
050,02,122,"Alaska","Kenai Peninsula Borough",2,18,655,352,303
050,02,122,"Alaska","Kenai Peninsula Borough",2,19,576,321,255
050,02,122,"Alaska","Kenai Peninsula Borough",2,20,594,329,265
050,02,122,"Alaska","Kenai Peninsula Borough",2,21,610,339,271
050,02,122,"Alaska","Kenai Peninsula Borough",2,22,586,317,269
050,02,122,"Alaska","Kenai Peninsula Borough",2,23,611,326,285
050,02,122,"Alaska","Kenai Peninsula Borough",2,24,659,358,301
050,02,122,"Alaska","Kenai Peninsula Borough",2,25,663,354,309
050,02,122,"Alaska","Kenai Peninsula Borough",2,26,660,348,312
050,02,122,"Alaska","Kenai Peninsula Borough",2,27,694,368,326
050,02,122,"Alaska","Kenai Peninsula Borough",2,28,749,399,350
050,02,122,"Alaska","Kenai Peninsula Borough",2,29,801,431,370
050,02,122,"Alaska","Kenai Peninsula Borough",2,30,831,444,387
050,02,122,"Alaska","Kenai Peninsula Borough",2,31,741,388,353
050,02,122,"Alaska","Kenai Peninsula Borough",2,32,708,365,343
050,02,122,"Alaska","Kenai Peninsula Borough",2,33,703,365,338
050,02,122,"Alaska","Kenai Peninsula Borough",2,34,748,397,351
050,02,122,"Alaska","Kenai Peninsula Borough",2,35,763,404,359
050,02,122,"Alaska","Kenai Peninsula Borough",2,36,751,399,352
050,02,122,"Alaska","Kenai Peninsula Borough",2,37,797,424,373
050,02,122,"Alaska","Kenai Peninsula Borough",2,38,812,433,379
050,02,122,"Alaska","Kenai Peninsula Borough",2,39,773,404,369
050,02,122,"Alaska","Kenai Peninsula Borough",2,40,727,386,341
050,02,122,"Alaska","Kenai Peninsula Borough",2,41,713,378,335
050,02,122,"Alaska","Kenai Peninsula Borough",2,42,689,374,315
050,02,122,"Alaska","Kenai Peninsula Borough",2,43,671,358,313
050,02,122,"Alaska","Kenai Peninsula Borough",2,44,663,369,294
050,02,122,"Alaska","Kenai Peninsula Borough",2,45,647,341,306
050,02,122,"Alaska","Kenai Peninsula Borough",2,46,631,331,300
050,02,122,"Alaska","Kenai Peninsula Borough",2,47,645,332,313
050,02,122,"Alaska","Kenai Peninsula Borough",2,48,698,364,334
050,02,122,"Alaska","Kenai Peninsula Borough",2,49,753,399,354
050,02,122,"Alaska","Kenai Peninsula Borough",2,50,738,392,346
050,02,122,"Alaska","Kenai Peninsula Borough",2,51,712,390,322
050,02,122,"Alaska","Kenai Peninsula Borough",2,52,700,365,335
050,02,122,"Alaska","Kenai Peninsula Borough",2,53,699,350,349
050,02,122,"Alaska","Kenai Peninsula Borough",2,54,714,361,353
050,02,122,"Alaska","Kenai Peninsula Borough",2,55,749,389,360
050,02,122,"Alaska","Kenai Peninsula Borough",2,56,786,400,386
050,02,122,"Alaska","Kenai Peninsula Borough",2,57,808,418,390
050,02,122,"Alaska","Kenai Peninsula Borough",2,58,863,455,408
050,02,122,"Alaska","Kenai Peninsula Borough",2,59,934,489,445
050,02,122,"Alaska","Kenai Peninsula Borough",2,60,938,488,450
050,02,122,"Alaska","Kenai Peninsula Borough",2,61,925,481,444
050,02,122,"Alaska","Kenai Peninsula Borough",2,62,953,498,455
050,02,122,"Alaska","Kenai Peninsula Borough",2,63,950,479,471
050,02,122,"Alaska","Kenai Peninsula Borough",2,64,920,467,453
050,02,122,"Alaska","Kenai Peninsula Borough",2,65,915,477,438
050,02,122,"Alaska","Kenai Peninsula Borough",2,66,923,481,442
050,02,122,"Alaska","Kenai Peninsula Borough",2,67,888,471,417
050,02,122,"Alaska","Kenai Peninsula Borough",2,68,853,445,408
050,02,122,"Alaska","Kenai Peninsula Borough",2,69,792,414,378
050,02,122,"Alaska","Kenai Peninsula Borough",2,70,736,379,357
050,02,122,"Alaska","Kenai Peninsula Borough",2,71,674,358,316
050,02,122,"Alaska","Kenai Peninsula Borough",2,72,631,336,295
050,02,122,"Alaska","Kenai Peninsula Borough",2,73,649,338,311
050,02,122,"Alaska","Kenai Peninsula Borough",2,74,434,229,205
050,02,122,"Alaska","Kenai Peninsula Borough",2,75,417,233,184
050,02,122,"Alaska","Kenai Peninsula Borough",2,76,431,235,196
050,02,122,"Alaska","Kenai Peninsula Borough",2,77,418,221,197
050,02,122,"Alaska","Kenai Peninsula Borough",2,78,325,173,152
050,02,122,"Alaska","Kenai Peninsula Borough",2,79,297,164,133
050,02,122,"Alaska","Kenai Peninsula Borough",2,80,242,128,114
050,02,122,"Alaska","Kenai Peninsula Borough",2,81,212,109,103
050,02,122,"Alaska","Kenai Peninsula Borough",2,82,181,90,91
050,02,122,"Alaska","Kenai Peninsula Borough",2,83,152,85,67
050,02,122,"Alaska","Kenai Peninsula Borough",2,84,143,75,68
050,02,122,"Alaska","Kenai Peninsula Borough",2,85,717,302,415
050,02,122,"Alaska","Kenai Peninsula Borough",3,0,679,334,345
050,02,122,"Alaska","Kenai Peninsula Borough",3,1,674,342,332
050,02,122,"Alaska","Kenai Peninsula Borough",3,2,660,348,312
050,02,122,"Alaska","Kenai Peninsula Borough",3,3,695,371,324
050,02,122,"Alaska","Kenai Peninsula Borough",3,4,706,371,335
050,02,122,"Alaska","Kenai Peninsula Borough",3,5,733,366,367
050,02,122,"Alaska","Kenai Peninsula Borough",3,6,714,368,346
050,02,122,"Alaska","Kenai Peninsula Borough",3,7,744,385,359
050,02,122,"Alaska","Kenai Peninsula Borough",3,8,738,387,351
050,02,122,"Alaska","Kenai Peninsula Borough",3,9,744,384,360
050,02,122,"Alaska","Kenai Peninsula Borough",3,10,762,395,367
050,02,122,"Alaska","Kenai Peninsula Borough",3,11,783,408,375
050,02,122,"Alaska","Kenai Peninsula Borough",3,12,801,417,384
050,02,122,"Alaska","Kenai Peninsula Borough",3,13,789,403,386
050,02,122,"Alaska","Kenai Peninsula Borough",3,14,786,403,383
050,02,122,"Alaska","Kenai Peninsula Borough",3,15,767,401,366
050,02,122,"Alaska","Kenai Peninsula Borough",3,16,752,405,347
050,02,122,"Alaska","Kenai Peninsula Borough",3,17,744,398,346
050,02,122,"Alaska","Kenai Peninsula Borough",3,18,685,363,322
050,02,122,"Alaska","Kenai Peninsula Borough",3,19,591,329,262
050,02,122,"Alaska","Kenai Peninsula Borough",3,20,634,352,282
050,02,122,"Alaska","Kenai Peninsula Borough",3,21,617,350,267
050,02,122,"Alaska","Kenai Peninsula Borough",3,22,564,302,262
050,02,122,"Alaska","Kenai Peninsula Borough",3,23,604,320,284
050,02,122,"Alaska","Kenai Peninsula Borough",3,24,639,347,292
050,02,122,"Alaska","Kenai Peninsula Borough",3,25,660,365,295
050,02,122,"Alaska","Kenai Peninsula Borough",3,26,686,350,336
050,02,122,"Alaska","Kenai Peninsula Borough",3,27,681,369,312
050,02,122,"Alaska","Kenai Peninsula Borough",3,28,744,395,349
050,02,122,"Alaska","Kenai Peninsula Borough",3,29,792,429,363
050,02,122,"Alaska","Kenai Peninsula Borough",3,30,826,451,375
050,02,122,"Alaska","Kenai Peninsula Borough",3,31,867,447,420
050,02,122,"Alaska","Kenai Peninsula Borough",3,32,783,411,372
050,02,122,"Alaska","Kenai Peninsula Borough",3,33,732,373,359
050,02,122,"Alaska","Kenai Peninsula Borough",3,34,737,386,351
050,02,122,"Alaska","Kenai Peninsula Borough",3,35,798,435,363
050,02,122,"Alaska","Kenai Peninsula Borough",3,36,758,403,355
050,02,122,"Alaska","Kenai Peninsula Borough",3,37,770,410,360
050,02,122,"Alaska","Kenai Peninsula Borough",3,38,812,439,373
050,02,122,"Alaska","Kenai Peninsula Borough",3,39,802,432,370
050,02,122,"Alaska","Kenai Peninsula Borough",3,40,806,424,382
050,02,122,"Alaska","Kenai Peninsula Borough",3,41,745,391,354
050,02,122,"Alaska","Kenai Peninsula Borough",3,42,734,402,332
050,02,122,"Alaska","Kenai Peninsula Borough",3,43,703,365,338
050,02,122,"Alaska","Kenai Peninsula Borough",3,44,678,376,302
050,02,122,"Alaska","Kenai Peninsula Borough",3,45,672,375,297
050,02,122,"Alaska","Kenai Peninsula Borough",3,46,653,347,306
050,02,122,"Alaska","Kenai Peninsula Borough",3,47,621,336,285
050,02,122,"Alaska","Kenai Peninsula Borough",3,48,647,333,314
050,02,122,"Alaska","Kenai Peninsula Borough",3,49,701,362,339
050,02,122,"Alaska","Kenai Peninsula Borough",3,50,785,412,373
050,02,122,"Alaska","Kenai Peninsula Borough",3,51,730,389,341
050,02,122,"Alaska","Kenai Peninsula Borough",3,52,715,384,331
050,02,122,"Alaska","Kenai Peninsula Borough",3,53,709,364,345
050,02,122,"Alaska","Kenai Peninsula Borough",3,54,702,364,338
050,02,122,"Alaska","Kenai Peninsula Borough",3,55,715,356,359
050,02,122,"Alaska","Kenai Peninsula Borough",3,56,734,377,357
050,02,122,"Alaska","Kenai Peninsula Borough",3,57,789,401,388
050,02,122,"Alaska","Kenai Peninsula Borough",3,58,813,420,393
050,02,122,"Alaska","Kenai Peninsula Borough",3,59,874,457,417
050,02,122,"Alaska","Kenai Peninsula Borough",3,60,936,484,452
050,02,122,"Alaska","Kenai Peninsula Borough",3,61,942,483,459
050,02,122,"Alaska","Kenai Peninsula Borough",3,62,958,503,455
050,02,122,"Alaska","Kenai Peninsula Borough",3,63,959,501,458
050,02,122,"Alaska","Kenai Peninsula Borough",3,64,945,470,475
050,02,122,"Alaska","Kenai Peninsula Borough",3,65,918,458,460
050,02,122,"Alaska","Kenai Peninsula Borough",3,66,893,472,421
050,02,122,"Alaska","Kenai Peninsula Borough",3,67,916,482,434
050,02,122,"Alaska","Kenai Peninsula Borough",3,68,874,456,418
050,02,122,"Alaska","Kenai Peninsula Borough",3,69,854,449,405
050,02,122,"Alaska","Kenai Peninsula Borough",3,70,779,401,378
050,02,122,"Alaska","Kenai Peninsula Borough",3,71,721,370,351
050,02,122,"Alaska","Kenai Peninsula Borough",3,72,668,353,315
050,02,122,"Alaska","Kenai Peninsula Borough",3,73,616,326,290
050,02,122,"Alaska","Kenai Peninsula Borough",3,74,634,324,310
050,02,122,"Alaska","Kenai Peninsula Borough",3,75,416,222,194
050,02,122,"Alaska","Kenai Peninsula Borough",3,76,410,230,180
050,02,122,"Alaska","Kenai Peninsula Borough",3,77,410,223,187
050,02,122,"Alaska","Kenai Peninsula Borough",3,78,398,210,188
050,02,122,"Alaska","Kenai Peninsula Borough",3,79,304,158,146
050,02,122,"Alaska","Kenai Peninsula Borough",3,80,279,152,127
050,02,122,"Alaska","Kenai Peninsula Borough",3,81,243,132,111
050,02,122,"Alaska","Kenai Peninsula Borough",3,82,207,98,109
050,02,122,"Alaska","Kenai Peninsula Borough",3,83,169,85,84
050,02,122,"Alaska","Kenai Peninsula Borough",3,84,141,80,61
050,02,122,"Alaska","Kenai Peninsula Borough",3,85,777,340,437
050,02,122,"Alaska","Kenai Peninsula Borough",4,0,633,328,305
050,02,122,"Alaska","Kenai Peninsula Borough",4,1,691,335,356
050,02,122,"Alaska","Kenai Peninsula Borough",4,2,682,347,335
050,02,122,"Alaska","Kenai Peninsula Borough",4,3,676,359,317
050,02,122,"Alaska","Kenai Peninsula Borough",4,4,702,378,324
050,02,122,"Alaska","Kenai Peninsula Borough",4,5,729,385,344
050,02,122,"Alaska","Kenai Peninsula Borough",4,6,780,394,386
050,02,122,"Alaska","Kenai Peninsula Borough",4,7,725,379,346
050,02,122,"Alaska","Kenai Peninsula Borough",4,8,751,384,367
050,02,122,"Alaska","Kenai Peninsula Borough",4,9,767,398,369
050,02,122,"Alaska","Kenai Peninsula Borough",4,10,793,416,377
050,02,122,"Alaska","Kenai Peninsula Borough",4,11,779,405,374
050,02,122,"Alaska","Kenai Peninsula Borough",4,12,800,420,380
050,02,122,"Alaska","Kenai Peninsula Borough",4,13,817,425,392
050,02,122,"Alaska","Kenai Peninsula Borough",4,14,809,412,397
050,02,122,"Alaska","Kenai Peninsula Borough",4,15,788,403,385
050,02,122,"Alaska","Kenai Peninsula Borough",4,16,790,409,381
050,02,122,"Alaska","Kenai Peninsula Borough",4,17,771,420,351
050,02,122,"Alaska","Kenai Peninsula Borough",4,18,665,363,302
050,02,122,"Alaska","Kenai Peninsula Borough",4,19,595,328,267
050,02,122,"Alaska","Kenai Peninsula Borough",4,20,602,335,267
050,02,122,"Alaska","Kenai Peninsula Borough",4,21,624,360,264
050,02,122,"Alaska","Kenai Peninsula Borough",4,22,564,315,249
050,02,122,"Alaska","Kenai Peninsula Borough",4,23,607,325,282
050,02,122,"Alaska","Kenai Peninsula Borough",4,24,627,333,294
050,02,122,"Alaska","Kenai Peninsula Borough",4,25,621,337,284
050,02,122,"Alaska","Kenai Peninsula Borough",4,26,661,354,307
050,02,122,"Alaska","Kenai Peninsula Borough",4,27,696,351,345
050,02,122,"Alaska","Kenai Peninsula Borough",4,28,703,366,337
050,02,122,"Alaska","Kenai Peninsula Borough",4,29,770,406,364
050,02,122,"Alaska","Kenai Peninsula Borough",4,30,819,442,377
050,02,122,"Alaska","Kenai Peninsula Borough",4,31,827,432,395
050,02,122,"Alaska","Kenai Peninsula Borough",4,32,901,458,443
050,02,122,"Alaska","Kenai Peninsula Borough",4,33,774,393,381
050,02,122,"Alaska","Kenai Peninsula Borough",4,34,763,383,380
050,02,122,"Alaska","Kenai Peninsula Borough",4,35,756,394,362
050,02,122,"Alaska","Kenai Peninsula Borough",4,36,798,430,368
050,02,122,"Alaska","Kenai Peninsula Borough",4,37,805,430,375
050,02,122,"Alaska","Kenai Peninsula Borough",4,38,787,425,362
050,02,122,"Alaska","Kenai Peninsula Borough",4,39,815,439,376
050,02,122,"Alaska","Kenai Peninsula Borough",4,40,828,443,385
050,02,122,"Alaska","Kenai Peninsula Borough",4,41,814,418,396
050,02,122,"Alaska","Kenai Peninsula Borough",4,42,794,425,369
050,02,122,"Alaska","Kenai Peninsula Borough",4,43,729,388,341
050,02,122,"Alaska","Kenai Peninsula Borough",4,44,748,395,353
050,02,122,"Alaska","Kenai Peninsula Borough",4,45,672,366,306
050,02,122,"Alaska","Kenai Peninsula Borough",4,46,683,382,301
050,02,122,"Alaska","Kenai Peninsula Borough",4,47,661,345,316
050,02,122,"Alaska","Kenai Peninsula Borough",4,48,613,328,285
050,02,122,"Alaska","Kenai Peninsula Borough",4,49,653,331,322
050,02,122,"Alaska","Kenai Peninsula Borough",4,50,727,372,355
050,02,122,"Alaska","Kenai Peninsula Borough",4,51,773,409,364
050,02,122,"Alaska","Kenai Peninsula Borough",4,52,728,392,336
050,02,122,"Alaska","Kenai Peninsula Borough",4,53,708,376,332
050,02,122,"Alaska","Kenai Peninsula Borough",4,54,708,367,341
050,02,122,"Alaska","Kenai Peninsula Borough",4,55,718,364,354
050,02,122,"Alaska","Kenai Peninsula Borough",4,56,706,346,360
050,02,122,"Alaska","Kenai Peninsula Borough",4,57,723,372,351
050,02,122,"Alaska","Kenai Peninsula Borough",4,58,795,419,376
050,02,122,"Alaska","Kenai Peninsula Borough",4,59,827,424,403
050,02,122,"Alaska","Kenai Peninsula Borough",4,60,863,444,419
050,02,122,"Alaska","Kenai Peninsula Borough",4,61,925,470,455
050,02,122,"Alaska","Kenai Peninsula Borough",4,62,954,502,452
050,02,122,"Alaska","Kenai Peninsula Borough",4,63,945,484,461
050,02,122,"Alaska","Kenai Peninsula Borough",4,64,961,499,462
050,02,122,"Alaska","Kenai Peninsula Borough",4,65,935,468,467
050,02,122,"Alaska","Kenai Peninsula Borough",4,66,921,458,463
050,02,122,"Alaska","Kenai Peninsula Borough",4,67,886,468,418
050,02,122,"Alaska","Kenai Peninsula Borough",4,68,904,468,436
050,02,122,"Alaska","Kenai Peninsula Borough",4,69,863,452,411
050,02,122,"Alaska","Kenai Peninsula Borough",4,70,835,435,400
050,02,122,"Alaska","Kenai Peninsula Borough",4,71,764,391,373
050,02,122,"Alaska","Kenai Peninsula Borough",4,72,707,358,349
050,02,122,"Alaska","Kenai Peninsula Borough",4,73,651,339,312
050,02,122,"Alaska","Kenai Peninsula Borough",4,74,590,319,271
050,02,122,"Alaska","Kenai Peninsula Borough",4,75,613,309,304
050,02,122,"Alaska","Kenai Peninsula Borough",4,76,405,214,191
050,02,122,"Alaska","Kenai Peninsula Borough",4,77,386,223,163
050,02,122,"Alaska","Kenai Peninsula Borough",4,78,390,204,186
050,02,122,"Alaska","Kenai Peninsula Borough",4,79,364,193,171
050,02,122,"Alaska","Kenai Peninsula Borough",4,80,269,140,129
050,02,122,"Alaska","Kenai Peninsula Borough",4,81,266,142,124
050,02,122,"Alaska","Kenai Peninsula Borough",4,82,222,110,112
050,02,122,"Alaska","Kenai Peninsula Borough",4,83,195,91,104
050,02,122,"Alaska","Kenai Peninsula Borough",4,84,149,73,76
050,02,122,"Alaska","Kenai Peninsula Borough",4,85,777,368,409
050,02,122,"Alaska","Kenai Peninsula Borough",5,0,636,330,306
050,02,122,"Alaska","Kenai Peninsula Borough",5,1,657,329,328
050,02,122,"Alaska","Kenai Peninsula Borough",5,2,696,331,365
050,02,122,"Alaska","Kenai Peninsula Borough",5,3,706,358,348
050,02,122,"Alaska","Kenai Peninsula Borough",5,4,674,358,316
050,02,122,"Alaska","Kenai Peninsula Borough",5,5,710,378,332
050,02,122,"Alaska","Kenai Peninsula Borough",5,6,756,386,370
050,02,122,"Alaska","Kenai Peninsula Borough",5,7,773,402,371
050,02,122,"Alaska","Kenai Peninsula Borough",5,8,730,375,355
050,02,122,"Alaska","Kenai Peninsula Borough",5,9,762,397,365
050,02,122,"Alaska","Kenai Peninsula Borough",5,10,785,405,380
050,02,122,"Alaska","Kenai Peninsula Borough",5,11,786,413,373
050,02,122,"Alaska","Kenai Peninsula Borough",5,12,788,402,386
050,02,122,"Alaska","Kenai Peninsula Borough",5,13,822,430,392
050,02,122,"Alaska","Kenai Peninsula Borough",5,14,833,427,406
050,02,122,"Alaska","Kenai Peninsula Borough",5,15,809,412,397
050,02,122,"Alaska","Kenai Peninsula Borough",5,16,794,408,386
050,02,122,"Alaska","Kenai Peninsula Borough",5,17,785,416,369
050,02,122,"Alaska","Kenai Peninsula Borough",5,18,667,376,291
050,02,122,"Alaska","Kenai Peninsula Borough",5,19,596,329,267
050,02,122,"Alaska","Kenai Peninsula Borough",5,20,630,345,285
050,02,122,"Alaska","Kenai Peninsula Borough",5,21,617,354,263
050,02,122,"Alaska","Kenai Peninsula Borough",5,22,588,335,253
050,02,122,"Alaska","Kenai Peninsula Borough",5,23,588,329,259
050,02,122,"Alaska","Kenai Peninsula Borough",5,24,650,349,301
050,02,122,"Alaska","Kenai Peninsula Borough",5,25,653,345,308
050,02,122,"Alaska","Kenai Peninsula Borough",5,26,616,326,290
050,02,122,"Alaska","Kenai Peninsula Borough",5,27,672,363,309
050,02,122,"Alaska","Kenai Peninsula Borough",5,28,700,350,350
050,02,122,"Alaska","Kenai Peninsula Borough",5,29,745,393,352
050,02,122,"Alaska","Kenai Peninsula Borough",5,30,819,431,388
050,02,122,"Alaska","Kenai Peninsula Borough",5,31,843,455,388
050,02,122,"Alaska","Kenai Peninsula Borough",5,32,855,433,422
050,02,122,"Alaska","Kenai Peninsula Borough",5,33,885,438,447
050,02,122,"Alaska","Kenai Peninsula Borough",5,34,796,393,403
050,02,122,"Alaska","Kenai Peninsula Borough",5,35,786,391,395
050,02,122,"Alaska","Kenai Peninsula Borough",5,36,780,411,369
050,02,122,"Alaska","Kenai Peninsula Borough",5,37,807,435,372
050,02,122,"Alaska","Kenai Peninsula Borough",5,38,835,447,388
050,02,122,"Alaska","Kenai Peninsula Borough",5,39,777,421,356
050,02,122,"Alaska","Kenai Peninsula Borough",5,40,828,448,380
050,02,122,"Alaska","Kenai Peninsula Borough",5,41,814,435,379
050,02,122,"Alaska","Kenai Peninsula Borough",5,42,865,451,414
050,02,122,"Alaska","Kenai Peninsula Borough",5,43,783,410,373
050,02,122,"Alaska","Kenai Peninsula Borough",5,44,759,410,349
050,02,122,"Alaska","Kenai Peninsula Borough",5,45,746,384,362
050,02,122,"Alaska","Kenai Peninsula Borough",5,46,677,379,298
050,02,122,"Alaska","Kenai Peninsula Borough",5,47,695,385,310
050,02,122,"Alaska","Kenai Peninsula Borough",5,48,659,345,314
050,02,122,"Alaska","Kenai Peninsula Borough",5,49,630,334,296
050,02,122,"Alaska","Kenai Peninsula Borough",5,50,670,345,325
050,02,122,"Alaska","Kenai Peninsula Borough",5,51,733,379,354
050,02,122,"Alaska","Kenai Peninsula Borough",5,52,771,404,367
050,02,122,"Alaska","Kenai Peninsula Borough",5,53,738,389,349
050,02,122,"Alaska","Kenai Peninsula Borough",5,54,717,386,331
050,02,122,"Alaska","Kenai Peninsula Borough",5,55,694,357,337
050,02,122,"Alaska","Kenai Peninsula Borough",5,56,716,366,350
050,02,122,"Alaska","Kenai Peninsula Borough",5,57,694,344,350
050,02,122,"Alaska","Kenai Peninsula Borough",5,58,719,366,353
050,02,122,"Alaska","Kenai Peninsula Borough",5,59,809,430,379
050,02,122,"Alaska","Kenai Peninsula Borough",5,60,816,415,401
050,02,122,"Alaska","Kenai Peninsula Borough",5,61,843,430,413
050,02,122,"Alaska","Kenai Peninsula Borough",5,62,934,472,462
050,02,122,"Alaska","Kenai Peninsula Borough",5,63,931,488,443
050,02,122,"Alaska","Kenai Peninsula Borough",5,64,953,483,470
050,02,122,"Alaska","Kenai Peninsula Borough",5,65,935,488,447
050,02,122,"Alaska","Kenai Peninsula Borough",5,66,921,465,456
050,02,122,"Alaska","Kenai Peninsula Borough",5,67,919,460,459
050,02,122,"Alaska","Kenai Peninsula Borough",5,68,874,453,421
050,02,122,"Alaska","Kenai Peninsula Borough",5,69,895,460,435
050,02,122,"Alaska","Kenai Peninsula Borough",5,70,845,444,401
050,02,122,"Alaska","Kenai Peninsula Borough",5,71,813,421,392
050,02,122,"Alaska","Kenai Peninsula Borough",5,72,748,377,371
050,02,122,"Alaska","Kenai Peninsula Borough",5,73,697,351,346
050,02,122,"Alaska","Kenai Peninsula Borough",5,74,636,336,300
050,02,122,"Alaska","Kenai Peninsula Borough",5,75,569,297,272
050,02,122,"Alaska","Kenai Peninsula Borough",5,76,602,298,304
050,02,122,"Alaska","Kenai Peninsula Borough",5,77,386,205,181
050,02,122,"Alaska","Kenai Peninsula Borough",5,78,363,208,155
050,02,122,"Alaska","Kenai Peninsula Borough",5,79,371,200,171
050,02,122,"Alaska","Kenai Peninsula Borough",5,80,331,174,157
050,02,122,"Alaska","Kenai Peninsula Borough",5,81,260,133,127
050,02,122,"Alaska","Kenai Peninsula Borough",5,82,251,129,122
050,02,122,"Alaska","Kenai Peninsula Borough",5,83,210,107,103
050,02,122,"Alaska","Kenai Peninsula Borough",5,84,184,83,101
050,02,122,"Alaska","Kenai Peninsula Borough",5,85,812,392,420
050,02,130,"Alaska","Ketchikan Gateway Borough",1,0,137,69,68
050,02,130,"Alaska","Ketchikan Gateway Borough",1,1,129,65,64
050,02,130,"Alaska","Ketchikan Gateway Borough",1,2,134,71,63
050,02,130,"Alaska","Ketchikan Gateway Borough",1,3,153,74,79
050,02,130,"Alaska","Ketchikan Gateway Borough",1,4,173,97,76
050,02,130,"Alaska","Ketchikan Gateway Borough",1,5,165,88,77
050,02,130,"Alaska","Ketchikan Gateway Borough",1,6,155,85,70
050,02,130,"Alaska","Ketchikan Gateway Borough",1,7,160,89,71
050,02,130,"Alaska","Ketchikan Gateway Borough",1,8,173,83,90
050,02,130,"Alaska","Ketchikan Gateway Borough",1,9,178,78,100
050,02,130,"Alaska","Ketchikan Gateway Borough",1,10,188,92,96
050,02,130,"Alaska","Ketchikan Gateway Borough",1,11,172,77,95
050,02,130,"Alaska","Ketchikan Gateway Borough",1,12,168,86,82
050,02,130,"Alaska","Ketchikan Gateway Borough",1,13,166,77,89
050,02,130,"Alaska","Ketchikan Gateway Borough",1,14,158,83,75
050,02,130,"Alaska","Ketchikan Gateway Borough",1,15,181,91,90
050,02,130,"Alaska","Ketchikan Gateway Borough",1,16,186,100,86
050,02,130,"Alaska","Ketchikan Gateway Borough",1,17,175,96,79
050,02,130,"Alaska","Ketchikan Gateway Borough",1,18,157,87,70
050,02,130,"Alaska","Ketchikan Gateway Borough",1,19,144,88,56
050,02,130,"Alaska","Ketchikan Gateway Borough",1,20,162,94,68
050,02,130,"Alaska","Ketchikan Gateway Borough",1,21,159,80,79
050,02,130,"Alaska","Ketchikan Gateway Borough",1,22,145,72,73
050,02,130,"Alaska","Ketchikan Gateway Borough",1,23,157,81,76
050,02,130,"Alaska","Ketchikan Gateway Borough",1,24,165,98,67
050,02,130,"Alaska","Ketchikan Gateway Borough",1,25,182,100,82
050,02,130,"Alaska","Ketchikan Gateway Borough",1,26,175,93,82
050,02,130,"Alaska","Ketchikan Gateway Borough",1,27,179,99,80
050,02,130,"Alaska","Ketchikan Gateway Borough",1,28,209,111,98
050,02,130,"Alaska","Ketchikan Gateway Borough",1,29,200,103,97
050,02,130,"Alaska","Ketchikan Gateway Borough",1,30,198,91,107
050,02,130,"Alaska","Ketchikan Gateway Borough",1,31,202,110,92
050,02,130,"Alaska","Ketchikan Gateway Borough",1,32,181,88,93
050,02,130,"Alaska","Ketchikan Gateway Borough",1,33,193,89,104
050,02,130,"Alaska","Ketchikan Gateway Borough",1,34,196,96,100
050,02,130,"Alaska","Ketchikan Gateway Borough",1,35,192,100,92
050,02,130,"Alaska","Ketchikan Gateway Borough",1,36,209,105,104
050,02,130,"Alaska","Ketchikan Gateway Borough",1,37,218,116,102
050,02,130,"Alaska","Ketchikan Gateway Borough",1,38,222,119,103
050,02,130,"Alaska","Ketchikan Gateway Borough",1,39,191,103,88
050,02,130,"Alaska","Ketchikan Gateway Borough",1,40,203,114,89
050,02,130,"Alaska","Ketchikan Gateway Borough",1,41,173,93,80
050,02,130,"Alaska","Ketchikan Gateway Borough",1,42,171,90,81
050,02,130,"Alaska","Ketchikan Gateway Borough",1,43,156,85,71
050,02,130,"Alaska","Ketchikan Gateway Borough",1,44,165,84,81
050,02,130,"Alaska","Ketchikan Gateway Borough",1,45,158,86,72
050,02,130,"Alaska","Ketchikan Gateway Borough",1,46,147,73,74
050,02,130,"Alaska","Ketchikan Gateway Borough",1,47,151,69,82
050,02,130,"Alaska","Ketchikan Gateway Borough",1,48,168,85,83
050,02,130,"Alaska","Ketchikan Gateway Borough",1,49,180,98,82
050,02,130,"Alaska","Ketchikan Gateway Borough",1,50,201,106,95
050,02,130,"Alaska","Ketchikan Gateway Borough",1,51,176,89,87
050,02,130,"Alaska","Ketchikan Gateway Borough",1,52,167,78,89
050,02,130,"Alaska","Ketchikan Gateway Borough",1,53,163,71,92
050,02,130,"Alaska","Ketchikan Gateway Borough",1,54,166,78,88
050,02,130,"Alaska","Ketchikan Gateway Borough",1,55,175,101,74
050,02,130,"Alaska","Ketchikan Gateway Borough",1,56,209,120,89
050,02,130,"Alaska","Ketchikan Gateway Borough",1,57,214,119,95
050,02,130,"Alaska","Ketchikan Gateway Borough",1,58,226,125,101
050,02,130,"Alaska","Ketchikan Gateway Borough",1,59,222,114,108
050,02,130,"Alaska","Ketchikan Gateway Borough",1,60,224,115,109
050,02,130,"Alaska","Ketchikan Gateway Borough",1,61,203,109,94
050,02,130,"Alaska","Ketchikan Gateway Borough",1,62,211,109,102
050,02,130,"Alaska","Ketchikan Gateway Borough",1,63,203,100,103
050,02,130,"Alaska","Ketchikan Gateway Borough",1,64,205,93,112
050,02,130,"Alaska","Ketchikan Gateway Borough",1,65,191,85,106
050,02,130,"Alaska","Ketchikan Gateway Borough",1,66,193,105,88
050,02,130,"Alaska","Ketchikan Gateway Borough",1,67,177,92,85
050,02,130,"Alaska","Ketchikan Gateway Borough",1,68,168,86,82
050,02,130,"Alaska","Ketchikan Gateway Borough",1,69,151,82,69
050,02,130,"Alaska","Ketchikan Gateway Borough",1,70,147,89,58
050,02,130,"Alaska","Ketchikan Gateway Borough",1,71,148,80,68
050,02,130,"Alaska","Ketchikan Gateway Borough",1,72,139,72,67
050,02,130,"Alaska","Ketchikan Gateway Borough",1,73,120,50,70
050,02,130,"Alaska","Ketchikan Gateway Borough",1,74,93,42,51
050,02,130,"Alaska","Ketchikan Gateway Borough",1,75,94,49,45
050,02,130,"Alaska","Ketchikan Gateway Borough",1,76,90,45,45
050,02,130,"Alaska","Ketchikan Gateway Borough",1,77,98,49,49
050,02,130,"Alaska","Ketchikan Gateway Borough",1,78,80,37,43
050,02,130,"Alaska","Ketchikan Gateway Borough",1,79,65,35,30
050,02,130,"Alaska","Ketchikan Gateway Borough",1,80,43,19,24
050,02,130,"Alaska","Ketchikan Gateway Borough",1,81,41,20,21
050,02,130,"Alaska","Ketchikan Gateway Borough",1,82,35,18,17
050,02,130,"Alaska","Ketchikan Gateway Borough",1,83,41,22,19
050,02,130,"Alaska","Ketchikan Gateway Borough",1,84,35,16,19
050,02,130,"Alaska","Ketchikan Gateway Borough",1,85,180,69,111
050,02,130,"Alaska","Ketchikan Gateway Borough",2,0,148,71,77
050,02,130,"Alaska","Ketchikan Gateway Borough",2,1,130,67,63
050,02,130,"Alaska","Ketchikan Gateway Borough",2,2,135,70,65
050,02,130,"Alaska","Ketchikan Gateway Borough",2,3,146,71,75
050,02,130,"Alaska","Ketchikan Gateway Borough",2,4,169,93,76
050,02,130,"Alaska","Ketchikan Gateway Borough",2,5,163,88,75
050,02,130,"Alaska","Ketchikan Gateway Borough",2,6,156,86,70
050,02,130,"Alaska","Ketchikan Gateway Borough",2,7,157,86,71
050,02,130,"Alaska","Ketchikan Gateway Borough",2,8,169,83,86
050,02,130,"Alaska","Ketchikan Gateway Borough",2,9,175,79,96
050,02,130,"Alaska","Ketchikan Gateway Borough",2,10,184,88,96
050,02,130,"Alaska","Ketchikan Gateway Borough",2,11,171,78,93
050,02,130,"Alaska","Ketchikan Gateway Borough",2,12,170,84,86
050,02,130,"Alaska","Ketchikan Gateway Borough",2,13,165,79,86
050,02,130,"Alaska","Ketchikan Gateway Borough",2,14,157,80,77
050,02,130,"Alaska","Ketchikan Gateway Borough",2,15,175,88,87
050,02,130,"Alaska","Ketchikan Gateway Borough",2,16,183,97,86
050,02,130,"Alaska","Ketchikan Gateway Borough",2,17,178,98,80
050,02,130,"Alaska","Ketchikan Gateway Borough",2,18,154,85,69
050,02,130,"Alaska","Ketchikan Gateway Borough",2,19,144,87,57
050,02,130,"Alaska","Ketchikan Gateway Borough",2,20,165,98,67
050,02,130,"Alaska","Ketchikan Gateway Borough",2,21,164,85,79
050,02,130,"Alaska","Ketchikan Gateway Borough",2,22,149,72,77
050,02,130,"Alaska","Ketchikan Gateway Borough",2,23,156,79,77
050,02,130,"Alaska","Ketchikan Gateway Borough",2,24,167,99,68
050,02,130,"Alaska","Ketchikan Gateway Borough",2,25,179,99,80
050,02,130,"Alaska","Ketchikan Gateway Borough",2,26,174,92,82
050,02,130,"Alaska","Ketchikan Gateway Borough",2,27,180,100,80
050,02,130,"Alaska","Ketchikan Gateway Borough",2,28,201,108,93
050,02,130,"Alaska","Ketchikan Gateway Borough",2,29,199,99,100
050,02,130,"Alaska","Ketchikan Gateway Borough",2,30,198,93,105
050,02,130,"Alaska","Ketchikan Gateway Borough",2,31,197,103,94
050,02,130,"Alaska","Ketchikan Gateway Borough",2,32,185,91,94
050,02,130,"Alaska","Ketchikan Gateway Borough",2,33,191,88,103
050,02,130,"Alaska","Ketchikan Gateway Borough",2,34,196,96,100
050,02,130,"Alaska","Ketchikan Gateway Borough",2,35,195,100,95
050,02,130,"Alaska","Ketchikan Gateway Borough",2,36,201,103,98
050,02,130,"Alaska","Ketchikan Gateway Borough",2,37,216,114,102
050,02,130,"Alaska","Ketchikan Gateway Borough",2,38,225,122,103
050,02,130,"Alaska","Ketchikan Gateway Borough",2,39,192,102,90
050,02,130,"Alaska","Ketchikan Gateway Borough",2,40,198,110,88
050,02,130,"Alaska","Ketchikan Gateway Borough",2,41,179,98,81
050,02,130,"Alaska","Ketchikan Gateway Borough",2,42,170,90,80
050,02,130,"Alaska","Ketchikan Gateway Borough",2,43,159,85,74
050,02,130,"Alaska","Ketchikan Gateway Borough",2,44,161,84,77
050,02,130,"Alaska","Ketchikan Gateway Borough",2,45,159,85,74
050,02,130,"Alaska","Ketchikan Gateway Borough",2,46,146,74,72
050,02,130,"Alaska","Ketchikan Gateway Borough",2,47,150,70,80
050,02,130,"Alaska","Ketchikan Gateway Borough",2,48,165,82,83
050,02,130,"Alaska","Ketchikan Gateway Borough",2,49,178,96,82
050,02,130,"Alaska","Ketchikan Gateway Borough",2,50,196,105,91
050,02,130,"Alaska","Ketchikan Gateway Borough",2,51,174,89,85
050,02,130,"Alaska","Ketchikan Gateway Borough",2,52,169,81,88
050,02,130,"Alaska","Ketchikan Gateway Borough",2,53,163,71,92
050,02,130,"Alaska","Ketchikan Gateway Borough",2,54,166,78,88
050,02,130,"Alaska","Ketchikan Gateway Borough",2,55,172,94,78
050,02,130,"Alaska","Ketchikan Gateway Borough",2,56,200,115,85
050,02,130,"Alaska","Ketchikan Gateway Borough",2,57,212,119,93
050,02,130,"Alaska","Ketchikan Gateway Borough",2,58,221,123,98
050,02,130,"Alaska","Ketchikan Gateway Borough",2,59,222,117,105
050,02,130,"Alaska","Ketchikan Gateway Borough",2,60,222,114,108
050,02,130,"Alaska","Ketchikan Gateway Borough",2,61,209,112,97
050,02,130,"Alaska","Ketchikan Gateway Borough",2,62,207,107,100
050,02,130,"Alaska","Ketchikan Gateway Borough",2,63,205,103,102
050,02,130,"Alaska","Ketchikan Gateway Borough",2,64,203,91,112
050,02,130,"Alaska","Ketchikan Gateway Borough",2,65,195,87,108
050,02,130,"Alaska","Ketchikan Gateway Borough",2,66,193,102,91
050,02,130,"Alaska","Ketchikan Gateway Borough",2,67,175,92,83
050,02,130,"Alaska","Ketchikan Gateway Borough",2,68,169,87,82
050,02,130,"Alaska","Ketchikan Gateway Borough",2,69,155,83,72
050,02,130,"Alaska","Ketchikan Gateway Borough",2,70,149,89,60
050,02,130,"Alaska","Ketchikan Gateway Borough",2,71,145,79,66
050,02,130,"Alaska","Ketchikan Gateway Borough",2,72,136,72,64
050,02,130,"Alaska","Ketchikan Gateway Borough",2,73,129,57,72
050,02,130,"Alaska","Ketchikan Gateway Borough",2,74,94,41,53
050,02,130,"Alaska","Ketchikan Gateway Borough",2,75,96,49,47
050,02,130,"Alaska","Ketchikan Gateway Borough",2,76,90,45,45
050,02,130,"Alaska","Ketchikan Gateway Borough",2,77,98,50,48
050,02,130,"Alaska","Ketchikan Gateway Borough",2,78,82,39,43
050,02,130,"Alaska","Ketchikan Gateway Borough",2,79,68,35,33
050,02,130,"Alaska","Ketchikan Gateway Borough",2,80,47,21,26
050,02,130,"Alaska","Ketchikan Gateway Borough",2,81,41,20,21
050,02,130,"Alaska","Ketchikan Gateway Borough",2,82,37,19,18
050,02,130,"Alaska","Ketchikan Gateway Borough",2,83,40,21,19
050,02,130,"Alaska","Ketchikan Gateway Borough",2,84,34,16,18
050,02,130,"Alaska","Ketchikan Gateway Borough",2,85,177,67,110
050,02,130,"Alaska","Ketchikan Gateway Borough",3,0,139,71,68
050,02,130,"Alaska","Ketchikan Gateway Borough",3,1,142,70,72
050,02,130,"Alaska","Ketchikan Gateway Borough",3,2,124,65,59
050,02,130,"Alaska","Ketchikan Gateway Borough",3,3,127,66,61
050,02,130,"Alaska","Ketchikan Gateway Borough",3,4,153,77,76
050,02,130,"Alaska","Ketchikan Gateway Borough",3,5,164,88,76
050,02,130,"Alaska","Ketchikan Gateway Borough",3,6,164,90,74
050,02,130,"Alaska","Ketchikan Gateway Borough",3,7,153,81,72
050,02,130,"Alaska","Ketchikan Gateway Borough",3,8,161,83,78
050,02,130,"Alaska","Ketchikan Gateway Borough",3,9,159,78,81
050,02,130,"Alaska","Ketchikan Gateway Borough",3,10,169,77,92
050,02,130,"Alaska","Ketchikan Gateway Borough",3,11,180,86,94
050,02,130,"Alaska","Ketchikan Gateway Borough",3,12,166,77,89
050,02,130,"Alaska","Ketchikan Gateway Borough",3,13,170,83,87
050,02,130,"Alaska","Ketchikan Gateway Borough",3,14,165,86,79
050,02,130,"Alaska","Ketchikan Gateway Borough",3,15,156,77,79
050,02,130,"Alaska","Ketchikan Gateway Borough",3,16,179,93,86
050,02,130,"Alaska","Ketchikan Gateway Borough",3,17,183,98,85
050,02,130,"Alaska","Ketchikan Gateway Borough",3,18,148,83,65
050,02,130,"Alaska","Ketchikan Gateway Borough",3,19,137,84,53
050,02,130,"Alaska","Ketchikan Gateway Borough",3,20,170,102,68
050,02,130,"Alaska","Ketchikan Gateway Borough",3,21,170,98,72
050,02,130,"Alaska","Ketchikan Gateway Borough",3,22,155,73,82
050,02,130,"Alaska","Ketchikan Gateway Borough",3,23,140,69,71
050,02,130,"Alaska","Ketchikan Gateway Borough",3,24,170,95,75
050,02,130,"Alaska","Ketchikan Gateway Borough",3,25,182,113,69
050,02,130,"Alaska","Ketchikan Gateway Borough",3,26,179,100,79
050,02,130,"Alaska","Ketchikan Gateway Borough",3,27,191,104,87
050,02,130,"Alaska","Ketchikan Gateway Borough",3,28,190,106,84
050,02,130,"Alaska","Ketchikan Gateway Borough",3,29,193,101,92
050,02,130,"Alaska","Ketchikan Gateway Borough",3,30,178,90,88
050,02,130,"Alaska","Ketchikan Gateway Borough",3,31,203,99,104
050,02,130,"Alaska","Ketchikan Gateway Borough",3,32,190,94,96
050,02,130,"Alaska","Ketchikan Gateway Borough",3,33,190,96,94
050,02,130,"Alaska","Ketchikan Gateway Borough",3,34,181,84,97
050,02,130,"Alaska","Ketchikan Gateway Borough",3,35,187,90,97
050,02,130,"Alaska","Ketchikan Gateway Borough",3,36,185,94,91
050,02,130,"Alaska","Ketchikan Gateway Borough",3,37,200,104,96
050,02,130,"Alaska","Ketchikan Gateway Borough",3,38,233,129,104
050,02,130,"Alaska","Ketchikan Gateway Borough",3,39,207,111,96
050,02,130,"Alaska","Ketchikan Gateway Borough",3,40,195,104,91
050,02,130,"Alaska","Ketchikan Gateway Borough",3,41,197,111,86
050,02,130,"Alaska","Ketchikan Gateway Borough",3,42,184,105,79
050,02,130,"Alaska","Ketchikan Gateway Borough",3,43,166,84,82
050,02,130,"Alaska","Ketchikan Gateway Borough",3,44,160,83,77
050,02,130,"Alaska","Ketchikan Gateway Borough",3,45,159,83,76
050,02,130,"Alaska","Ketchikan Gateway Borough",3,46,160,82,78
050,02,130,"Alaska","Ketchikan Gateway Borough",3,47,144,75,69
050,02,130,"Alaska","Ketchikan Gateway Borough",3,48,151,72,79
050,02,130,"Alaska","Ketchikan Gateway Borough",3,49,165,85,80
050,02,130,"Alaska","Ketchikan Gateway Borough",3,50,197,103,94
050,02,130,"Alaska","Ketchikan Gateway Borough",3,51,171,92,79
050,02,130,"Alaska","Ketchikan Gateway Borough",3,52,185,97,88
050,02,130,"Alaska","Ketchikan Gateway Borough",3,53,160,74,86
050,02,130,"Alaska","Ketchikan Gateway Borough",3,54,168,77,91
050,02,130,"Alaska","Ketchikan Gateway Borough",3,55,159,75,84
050,02,130,"Alaska","Ketchikan Gateway Borough",3,56,173,88,85
050,02,130,"Alaska","Ketchikan Gateway Borough",3,57,204,123,81
050,02,130,"Alaska","Ketchikan Gateway Borough",3,58,214,120,94
050,02,130,"Alaska","Ketchikan Gateway Borough",3,59,219,118,101
050,02,130,"Alaska","Ketchikan Gateway Borough",3,60,218,113,105
050,02,130,"Alaska","Ketchikan Gateway Borough",3,61,214,109,105
050,02,130,"Alaska","Ketchikan Gateway Borough",3,62,206,111,95
050,02,130,"Alaska","Ketchikan Gateway Borough",3,63,203,103,100
050,02,130,"Alaska","Ketchikan Gateway Borough",3,64,200,98,102
050,02,130,"Alaska","Ketchikan Gateway Borough",3,65,197,92,105
050,02,130,"Alaska","Ketchikan Gateway Borough",3,66,189,87,102
050,02,130,"Alaska","Ketchikan Gateway Borough",3,67,185,100,85
050,02,130,"Alaska","Ketchikan Gateway Borough",3,68,169,88,81
050,02,130,"Alaska","Ketchikan Gateway Borough",3,69,162,85,77
050,02,130,"Alaska","Ketchikan Gateway Borough",3,70,156,89,67
050,02,130,"Alaska","Ketchikan Gateway Borough",3,71,143,80,63
050,02,130,"Alaska","Ketchikan Gateway Borough",3,72,144,81,63
050,02,130,"Alaska","Ketchikan Gateway Borough",3,73,136,70,66
050,02,130,"Alaska","Ketchikan Gateway Borough",3,74,124,55,69
050,02,130,"Alaska","Ketchikan Gateway Borough",3,75,90,40,50
050,02,130,"Alaska","Ketchikan Gateway Borough",3,76,92,49,43
050,02,130,"Alaska","Ketchikan Gateway Borough",3,77,87,42,45
050,02,130,"Alaska","Ketchikan Gateway Borough",3,78,91,46,45
050,02,130,"Alaska","Ketchikan Gateway Borough",3,79,78,38,40
050,02,130,"Alaska","Ketchikan Gateway Borough",3,80,66,33,33
050,02,130,"Alaska","Ketchikan Gateway Borough",3,81,47,21,26
050,02,130,"Alaska","Ketchikan Gateway Borough",3,82,40,19,21
050,02,130,"Alaska","Ketchikan Gateway Borough",3,83,35,17,18
050,02,130,"Alaska","Ketchikan Gateway Borough",3,84,38,21,17
050,02,130,"Alaska","Ketchikan Gateway Borough",3,85,192,76,116
050,02,130,"Alaska","Ketchikan Gateway Borough",4,0,123,74,49
050,02,130,"Alaska","Ketchikan Gateway Borough",4,1,107,56,51
050,02,130,"Alaska","Ketchikan Gateway Borough",4,2,138,67,71
050,02,130,"Alaska","Ketchikan Gateway Borough",4,3,123,66,57
050,02,130,"Alaska","Ketchikan Gateway Borough",4,4,139,72,67
050,02,130,"Alaska","Ketchikan Gateway Borough",4,5,156,84,72
050,02,130,"Alaska","Ketchikan Gateway Borough",4,6,170,90,80
050,02,130,"Alaska","Ketchikan Gateway Borough",4,7,162,88,74
050,02,130,"Alaska","Ketchikan Gateway Borough",4,8,167,88,79
050,02,130,"Alaska","Ketchikan Gateway Borough",4,9,163,85,78
050,02,130,"Alaska","Ketchikan Gateway Borough",4,10,163,75,88
050,02,130,"Alaska","Ketchikan Gateway Borough",4,11,171,81,90
050,02,130,"Alaska","Ketchikan Gateway Borough",4,12,184,90,94
050,02,130,"Alaska","Ketchikan Gateway Borough",4,13,174,78,96
050,02,130,"Alaska","Ketchikan Gateway Borough",4,14,167,85,82
050,02,130,"Alaska","Ketchikan Gateway Borough",4,15,174,89,85
050,02,130,"Alaska","Ketchikan Gateway Borough",4,16,156,79,77
050,02,130,"Alaska","Ketchikan Gateway Borough",4,17,181,93,88
050,02,130,"Alaska","Ketchikan Gateway Borough",4,18,150,81,69
050,02,130,"Alaska","Ketchikan Gateway Borough",4,19,130,85,45
050,02,130,"Alaska","Ketchikan Gateway Borough",4,20,141,88,53
050,02,130,"Alaska","Ketchikan Gateway Borough",4,21,172,94,78
050,02,130,"Alaska","Ketchikan Gateway Borough",4,22,161,93,68
050,02,130,"Alaska","Ketchikan Gateway Borough",4,23,144,68,76
050,02,130,"Alaska","Ketchikan Gateway Borough",4,24,155,84,71
050,02,130,"Alaska","Ketchikan Gateway Borough",4,25,162,96,66
050,02,130,"Alaska","Ketchikan Gateway Borough",4,26,164,94,70
050,02,130,"Alaska","Ketchikan Gateway Borough",4,27,186,101,85
050,02,130,"Alaska","Ketchikan Gateway Borough",4,28,193,109,84
050,02,130,"Alaska","Ketchikan Gateway Borough",4,29,188,96,92
050,02,130,"Alaska","Ketchikan Gateway Borough",4,30,192,102,90
050,02,130,"Alaska","Ketchikan Gateway Borough",4,31,190,95,95
050,02,130,"Alaska","Ketchikan Gateway Borough",4,32,209,97,112
050,02,130,"Alaska","Ketchikan Gateway Borough",4,33,194,101,93
050,02,130,"Alaska","Ketchikan Gateway Borough",4,34,194,105,89
050,02,130,"Alaska","Ketchikan Gateway Borough",4,35,180,80,100
050,02,130,"Alaska","Ketchikan Gateway Borough",4,36,188,92,96
050,02,130,"Alaska","Ketchikan Gateway Borough",4,37,188,87,101
050,02,130,"Alaska","Ketchikan Gateway Borough",4,38,218,119,99
050,02,130,"Alaska","Ketchikan Gateway Borough",4,39,207,104,103
050,02,130,"Alaska","Ketchikan Gateway Borough",4,40,209,110,99
050,02,130,"Alaska","Ketchikan Gateway Borough",4,41,205,113,92
050,02,130,"Alaska","Ketchikan Gateway Borough",4,42,202,117,85
050,02,130,"Alaska","Ketchikan Gateway Borough",4,43,174,99,75
050,02,130,"Alaska","Ketchikan Gateway Borough",4,44,169,90,79
050,02,130,"Alaska","Ketchikan Gateway Borough",4,45,153,80,73
050,02,130,"Alaska","Ketchikan Gateway Borough",4,46,155,83,72
050,02,130,"Alaska","Ketchikan Gateway Borough",4,47,158,82,76
050,02,130,"Alaska","Ketchikan Gateway Borough",4,48,142,76,66
050,02,130,"Alaska","Ketchikan Gateway Borough",4,49,153,74,79
050,02,130,"Alaska","Ketchikan Gateway Borough",4,50,183,94,89
050,02,130,"Alaska","Ketchikan Gateway Borough",4,51,171,90,81
050,02,130,"Alaska","Ketchikan Gateway Borough",4,52,178,95,83
050,02,130,"Alaska","Ketchikan Gateway Borough",4,53,175,87,88
050,02,130,"Alaska","Ketchikan Gateway Borough",4,54,165,79,86
050,02,130,"Alaska","Ketchikan Gateway Borough",4,55,169,75,94
050,02,130,"Alaska","Ketchikan Gateway Borough",4,56,151,74,77
050,02,130,"Alaska","Ketchikan Gateway Borough",4,57,171,88,83
050,02,130,"Alaska","Ketchikan Gateway Borough",4,58,201,120,81
050,02,130,"Alaska","Ketchikan Gateway Borough",4,59,214,121,93
050,02,130,"Alaska","Ketchikan Gateway Borough",4,60,211,112,99
050,02,130,"Alaska","Ketchikan Gateway Borough",4,61,215,114,101
050,02,130,"Alaska","Ketchikan Gateway Borough",4,62,204,107,97
050,02,130,"Alaska","Ketchikan Gateway Borough",4,63,196,102,94
050,02,130,"Alaska","Ketchikan Gateway Borough",4,64,187,96,91
050,02,130,"Alaska","Ketchikan Gateway Borough",4,65,191,94,97
050,02,130,"Alaska","Ketchikan Gateway Borough",4,66,189,89,100
050,02,130,"Alaska","Ketchikan Gateway Borough",4,67,183,82,101
050,02,130,"Alaska","Ketchikan Gateway Borough",4,68,187,102,85
050,02,130,"Alaska","Ketchikan Gateway Borough",4,69,167,84,83
050,02,130,"Alaska","Ketchikan Gateway Borough",4,70,168,95,73
050,02,130,"Alaska","Ketchikan Gateway Borough",4,71,140,76,64
050,02,130,"Alaska","Ketchikan Gateway Borough",4,72,137,75,62
050,02,130,"Alaska","Ketchikan Gateway Borough",4,73,135,76,59
050,02,130,"Alaska","Ketchikan Gateway Borough",4,74,132,68,64
050,02,130,"Alaska","Ketchikan Gateway Borough",4,75,118,52,66
050,02,130,"Alaska","Ketchikan Gateway Borough",4,76,88,39,49
050,02,130,"Alaska","Ketchikan Gateway Borough",4,77,86,45,41
050,02,130,"Alaska","Ketchikan Gateway Borough",4,78,82,39,43
050,02,130,"Alaska","Ketchikan Gateway Borough",4,79,88,45,43
050,02,130,"Alaska","Ketchikan Gateway Borough",4,80,75,37,38
050,02,130,"Alaska","Ketchikan Gateway Borough",4,81,61,31,30
050,02,130,"Alaska","Ketchikan Gateway Borough",4,82,43,19,24
050,02,130,"Alaska","Ketchikan Gateway Borough",4,83,39,19,20
050,02,130,"Alaska","Ketchikan Gateway Borough",4,84,32,16,16
050,02,130,"Alaska","Ketchikan Gateway Borough",4,85,196,81,115
050,02,130,"Alaska","Ketchikan Gateway Borough",5,0,120,71,49
050,02,130,"Alaska","Ketchikan Gateway Borough",5,1,129,80,49
050,02,130,"Alaska","Ketchikan Gateway Borough",5,2,111,56,55
050,02,130,"Alaska","Ketchikan Gateway Borough",5,3,126,64,62
050,02,130,"Alaska","Ketchikan Gateway Borough",5,4,124,69,55
050,02,130,"Alaska","Ketchikan Gateway Borough",5,5,131,66,65
050,02,130,"Alaska","Ketchikan Gateway Borough",5,6,151,84,67
050,02,130,"Alaska","Ketchikan Gateway Borough",5,7,167,89,78
050,02,130,"Alaska","Ketchikan Gateway Borough",5,8,159,91,68
050,02,130,"Alaska","Ketchikan Gateway Borough",5,9,160,85,75
050,02,130,"Alaska","Ketchikan Gateway Borough",5,10,168,89,79
050,02,130,"Alaska","Ketchikan Gateway Borough",5,11,164,73,91
050,02,130,"Alaska","Ketchikan Gateway Borough",5,12,170,83,87
050,02,130,"Alaska","Ketchikan Gateway Borough",5,13,184,87,97
050,02,130,"Alaska","Ketchikan Gateway Borough",5,14,165,77,88
050,02,130,"Alaska","Ketchikan Gateway Borough",5,15,167,82,85
050,02,130,"Alaska","Ketchikan Gateway Borough",5,16,166,85,81
050,02,130,"Alaska","Ketchikan Gateway Borough",5,17,153,79,74
050,02,130,"Alaska","Ketchikan Gateway Borough",5,18,138,71,67
050,02,130,"Alaska","Ketchikan Gateway Borough",5,19,145,87,58
050,02,130,"Alaska","Ketchikan Gateway Borough",5,20,143,98,45
050,02,130,"Alaska","Ketchikan Gateway Borough",5,21,140,82,58
050,02,130,"Alaska","Ketchikan Gateway Borough",5,22,160,85,75
050,02,130,"Alaska","Ketchikan Gateway Borough",5,23,166,97,69
050,02,130,"Alaska","Ketchikan Gateway Borough",5,24,161,84,77
050,02,130,"Alaska","Ketchikan Gateway Borough",5,25,163,88,75
050,02,130,"Alaska","Ketchikan Gateway Borough",5,26,157,82,75
050,02,130,"Alaska","Ketchikan Gateway Borough",5,27,176,110,66
050,02,130,"Alaska","Ketchikan Gateway Borough",5,28,203,105,98
050,02,130,"Alaska","Ketchikan Gateway Borough",5,29,193,99,94
050,02,130,"Alaska","Ketchikan Gateway Borough",5,30,188,96,92
050,02,130,"Alaska","Ketchikan Gateway Borough",5,31,192,105,87
050,02,130,"Alaska","Ketchikan Gateway Borough",5,32,203,109,94
050,02,130,"Alaska","Ketchikan Gateway Borough",5,33,229,107,122
050,02,130,"Alaska","Ketchikan Gateway Borough",5,34,196,106,90
050,02,130,"Alaska","Ketchikan Gateway Borough",5,35,194,111,83
050,02,130,"Alaska","Ketchikan Gateway Borough",5,36,187,82,105
050,02,130,"Alaska","Ketchikan Gateway Borough",5,37,198,96,102
050,02,130,"Alaska","Ketchikan Gateway Borough",5,38,215,108,107
050,02,130,"Alaska","Ketchikan Gateway Borough",5,39,206,103,103
050,02,130,"Alaska","Ketchikan Gateway Borough",5,40,197,104,93
050,02,130,"Alaska","Ketchikan Gateway Borough",5,41,200,106,94
050,02,130,"Alaska","Ketchikan Gateway Borough",5,42,219,124,95
050,02,130,"Alaska","Ketchikan Gateway Borough",5,43,199,109,90
050,02,130,"Alaska","Ketchikan Gateway Borough",5,44,176,104,72
050,02,130,"Alaska","Ketchikan Gateway Borough",5,45,165,87,78
050,02,130,"Alaska","Ketchikan Gateway Borough",5,46,148,78,70
050,02,130,"Alaska","Ketchikan Gateway Borough",5,47,160,81,79
050,02,130,"Alaska","Ketchikan Gateway Borough",5,48,160,84,76
050,02,130,"Alaska","Ketchikan Gateway Borough",5,49,144,78,66
050,02,130,"Alaska","Ketchikan Gateway Borough",5,50,173,83,90
050,02,130,"Alaska","Ketchikan Gateway Borough",5,51,164,84,80
050,02,130,"Alaska","Ketchikan Gateway Borough",5,52,180,94,86
050,02,130,"Alaska","Ketchikan Gateway Borough",5,53,167,89,78
050,02,130,"Alaska","Ketchikan Gateway Borough",5,54,181,94,87
050,02,130,"Alaska","Ketchikan Gateway Borough",5,55,158,76,82
050,02,130,"Alaska","Ketchikan Gateway Borough",5,56,177,79,98
050,02,130,"Alaska","Ketchikan Gateway Borough",5,57,148,76,72
050,02,130,"Alaska","Ketchikan Gateway Borough",5,58,163,83,80
050,02,130,"Alaska","Ketchikan Gateway Borough",5,59,195,119,76
050,02,130,"Alaska","Ketchikan Gateway Borough",5,60,210,116,94
050,02,130,"Alaska","Ketchikan Gateway Borough",5,61,199,110,89
050,02,130,"Alaska","Ketchikan Gateway Borough",5,62,197,106,91
050,02,130,"Alaska","Ketchikan Gateway Borough",5,63,188,98,90
050,02,130,"Alaska","Ketchikan Gateway Borough",5,64,193,99,94
050,02,130,"Alaska","Ketchikan Gateway Borough",5,65,183,94,89
050,02,130,"Alaska","Ketchikan Gateway Borough",5,66,190,92,98
050,02,130,"Alaska","Ketchikan Gateway Borough",5,67,186,87,99
050,02,130,"Alaska","Ketchikan Gateway Borough",5,68,175,80,95
050,02,130,"Alaska","Ketchikan Gateway Borough",5,69,181,97,84
050,02,130,"Alaska","Ketchikan Gateway Borough",5,70,171,92,79
050,02,130,"Alaska","Ketchikan Gateway Borough",5,71,150,79,71
050,02,130,"Alaska","Ketchikan Gateway Borough",5,72,136,75,61
050,02,130,"Alaska","Ketchikan Gateway Borough",5,73,133,70,63
050,02,130,"Alaska","Ketchikan Gateway Borough",5,74,129,73,56
050,02,130,"Alaska","Ketchikan Gateway Borough",5,75,127,66,61
050,02,130,"Alaska","Ketchikan Gateway Borough",5,76,111,48,63
050,02,130,"Alaska","Ketchikan Gateway Borough",5,77,83,37,46
050,02,130,"Alaska","Ketchikan Gateway Borough",5,78,81,42,39
050,02,130,"Alaska","Ketchikan Gateway Borough",5,79,80,38,42
050,02,130,"Alaska","Ketchikan Gateway Borough",5,80,82,44,38
050,02,130,"Alaska","Ketchikan Gateway Borough",5,81,71,35,36
050,02,130,"Alaska","Ketchikan Gateway Borough",5,82,57,27,30
050,02,130,"Alaska","Ketchikan Gateway Borough",5,83,45,21,24
050,02,130,"Alaska","Ketchikan Gateway Borough",5,84,38,19,19
050,02,130,"Alaska","Ketchikan Gateway Borough",5,85,200,86,114
050,02,150,"Alaska","Kodiak Island Borough",1,0,140,74,66
050,02,150,"Alaska","Kodiak Island Borough",1,1,133,83,50
050,02,150,"Alaska","Kodiak Island Borough",1,2,191,93,98
050,02,150,"Alaska","Kodiak Island Borough",1,3,180,88,92
050,02,150,"Alaska","Kodiak Island Borough",1,4,194,114,80
050,02,150,"Alaska","Kodiak Island Borough",1,5,206,115,91
050,02,150,"Alaska","Kodiak Island Borough",1,6,198,120,78
050,02,150,"Alaska","Kodiak Island Borough",1,7,196,106,90
050,02,150,"Alaska","Kodiak Island Borough",1,8,181,99,82
050,02,150,"Alaska","Kodiak Island Borough",1,9,177,105,72
050,02,150,"Alaska","Kodiak Island Borough",1,10,178,88,90
050,02,150,"Alaska","Kodiak Island Borough",1,11,186,91,95
050,02,150,"Alaska","Kodiak Island Borough",1,12,179,83,96
050,02,150,"Alaska","Kodiak Island Borough",1,13,183,92,91
050,02,150,"Alaska","Kodiak Island Borough",1,14,158,78,80
050,02,150,"Alaska","Kodiak Island Borough",1,15,155,80,75
050,02,150,"Alaska","Kodiak Island Borough",1,16,154,78,76
050,02,150,"Alaska","Kodiak Island Borough",1,17,149,78,71
050,02,150,"Alaska","Kodiak Island Borough",1,18,131,71,60
050,02,150,"Alaska","Kodiak Island Borough",1,19,146,90,56
050,02,150,"Alaska","Kodiak Island Borough",1,20,233,163,70
050,02,150,"Alaska","Kodiak Island Borough",1,21,176,122,54
050,02,150,"Alaska","Kodiak Island Borough",1,22,187,114,73
050,02,150,"Alaska","Kodiak Island Borough",1,23,214,125,89
050,02,150,"Alaska","Kodiak Island Borough",1,24,184,103,81
050,02,150,"Alaska","Kodiak Island Borough",1,25,189,106,83
050,02,150,"Alaska","Kodiak Island Borough",1,26,193,101,92
050,02,150,"Alaska","Kodiak Island Borough",1,27,214,113,101
050,02,150,"Alaska","Kodiak Island Borough",1,28,180,95,85
050,02,150,"Alaska","Kodiak Island Borough",1,29,219,112,107
050,02,150,"Alaska","Kodiak Island Borough",1,30,235,124,111
050,02,150,"Alaska","Kodiak Island Borough",1,31,236,128,108
050,02,150,"Alaska","Kodiak Island Borough",1,32,216,119,97
050,02,150,"Alaska","Kodiak Island Borough",1,33,216,121,95
050,02,150,"Alaska","Kodiak Island Borough",1,34,206,119,87
050,02,150,"Alaska","Kodiak Island Borough",1,35,227,117,110
050,02,150,"Alaska","Kodiak Island Borough",1,36,225,108,117
050,02,150,"Alaska","Kodiak Island Borough",1,37,230,117,113
050,02,150,"Alaska","Kodiak Island Borough",1,38,222,110,112
050,02,150,"Alaska","Kodiak Island Borough",1,39,233,106,127
050,02,150,"Alaska","Kodiak Island Borough",1,40,173,90,83
050,02,150,"Alaska","Kodiak Island Borough",1,41,174,97,77
050,02,150,"Alaska","Kodiak Island Borough",1,42,154,86,68
050,02,150,"Alaska","Kodiak Island Borough",1,43,169,95,74
050,02,150,"Alaska","Kodiak Island Borough",1,44,150,82,68
050,02,150,"Alaska","Kodiak Island Borough",1,45,136,68,68
050,02,150,"Alaska","Kodiak Island Borough",1,46,135,69,66
050,02,150,"Alaska","Kodiak Island Borough",1,47,112,60,52
050,02,150,"Alaska","Kodiak Island Borough",1,48,124,65,59
050,02,150,"Alaska","Kodiak Island Borough",1,49,130,66,64
050,02,150,"Alaska","Kodiak Island Borough",1,50,138,63,75
050,02,150,"Alaska","Kodiak Island Borough",1,51,126,62,64
050,02,150,"Alaska","Kodiak Island Borough",1,52,132,70,62
050,02,150,"Alaska","Kodiak Island Borough",1,53,148,85,63
050,02,150,"Alaska","Kodiak Island Borough",1,54,157,93,64
050,02,150,"Alaska","Kodiak Island Borough",1,55,144,70,74
050,02,150,"Alaska","Kodiak Island Borough",1,56,169,86,83
050,02,150,"Alaska","Kodiak Island Borough",1,57,179,92,87
050,02,150,"Alaska","Kodiak Island Borough",1,58,186,110,76
050,02,150,"Alaska","Kodiak Island Borough",1,59,182,104,78
050,02,150,"Alaska","Kodiak Island Borough",1,60,171,102,69
050,02,150,"Alaska","Kodiak Island Borough",1,61,170,94,76
050,02,150,"Alaska","Kodiak Island Borough",1,62,177,102,75
050,02,150,"Alaska","Kodiak Island Borough",1,63,159,89,70
050,02,150,"Alaska","Kodiak Island Borough",1,64,174,98,76
050,02,150,"Alaska","Kodiak Island Borough",1,65,162,89,73
050,02,150,"Alaska","Kodiak Island Borough",1,66,142,80,62
050,02,150,"Alaska","Kodiak Island Borough",1,67,110,60,50
050,02,150,"Alaska","Kodiak Island Borough",1,68,107,57,50
050,02,150,"Alaska","Kodiak Island Borough",1,69,117,57,60
050,02,150,"Alaska","Kodiak Island Borough",1,70,104,53,51
050,02,150,"Alaska","Kodiak Island Borough",1,71,88,43,45
050,02,150,"Alaska","Kodiak Island Borough",1,72,92,51,41
050,02,150,"Alaska","Kodiak Island Borough",1,73,90,47,43
050,02,150,"Alaska","Kodiak Island Borough",1,74,68,34,34
050,02,150,"Alaska","Kodiak Island Borough",1,75,60,29,31
050,02,150,"Alaska","Kodiak Island Borough",1,76,62,26,36
050,02,150,"Alaska","Kodiak Island Borough",1,77,56,23,33
050,02,150,"Alaska","Kodiak Island Borough",1,78,42,20,22
050,02,150,"Alaska","Kodiak Island Borough",1,79,38,15,23
050,02,150,"Alaska","Kodiak Island Borough",1,80,41,19,22
050,02,150,"Alaska","Kodiak Island Borough",1,81,39,18,21
050,02,150,"Alaska","Kodiak Island Borough",1,82,28,13,15
050,02,150,"Alaska","Kodiak Island Borough",1,83,23,11,12
050,02,150,"Alaska","Kodiak Island Borough",1,84,27,9,18
050,02,150,"Alaska","Kodiak Island Borough",1,85,85,28,57
050,02,150,"Alaska","Kodiak Island Borough",2,0,145,76,69
050,02,150,"Alaska","Kodiak Island Borough",2,1,134,80,54
050,02,150,"Alaska","Kodiak Island Borough",2,2,178,91,87
050,02,150,"Alaska","Kodiak Island Borough",2,3,181,91,90
050,02,150,"Alaska","Kodiak Island Borough",2,4,191,109,82
050,02,150,"Alaska","Kodiak Island Borough",2,5,200,114,86
050,02,150,"Alaska","Kodiak Island Borough",2,6,197,117,80
050,02,150,"Alaska","Kodiak Island Borough",2,7,195,109,86
050,02,150,"Alaska","Kodiak Island Borough",2,8,185,102,83
050,02,150,"Alaska","Kodiak Island Borough",2,9,175,102,73
050,02,150,"Alaska","Kodiak Island Borough",2,10,180,94,86
050,02,150,"Alaska","Kodiak Island Borough",2,11,182,88,94
050,02,150,"Alaska","Kodiak Island Borough",2,12,182,85,97
050,02,150,"Alaska","Kodiak Island Borough",2,13,182,88,94
050,02,150,"Alaska","Kodiak Island Borough",2,14,161,81,80
050,02,150,"Alaska","Kodiak Island Borough",2,15,151,77,74
050,02,150,"Alaska","Kodiak Island Borough",2,16,150,77,73
050,02,150,"Alaska","Kodiak Island Borough",2,17,147,77,70
050,02,150,"Alaska","Kodiak Island Borough",2,18,128,70,58
050,02,150,"Alaska","Kodiak Island Borough",2,19,145,91,54
050,02,150,"Alaska","Kodiak Island Borough",2,20,229,158,71
050,02,150,"Alaska","Kodiak Island Borough",2,21,175,123,52
050,02,150,"Alaska","Kodiak Island Borough",2,22,188,113,75
050,02,150,"Alaska","Kodiak Island Borough",2,23,211,125,86
050,02,150,"Alaska","Kodiak Island Borough",2,24,186,103,83
050,02,150,"Alaska","Kodiak Island Borough",2,25,190,108,82
050,02,150,"Alaska","Kodiak Island Borough",2,26,192,100,92
050,02,150,"Alaska","Kodiak Island Borough",2,27,207,107,100
050,02,150,"Alaska","Kodiak Island Borough",2,28,186,99,87
050,02,150,"Alaska","Kodiak Island Borough",2,29,207,105,102
050,02,150,"Alaska","Kodiak Island Borough",2,30,232,123,109
050,02,150,"Alaska","Kodiak Island Borough",2,31,233,126,107
050,02,150,"Alaska","Kodiak Island Borough",2,32,222,123,99
050,02,150,"Alaska","Kodiak Island Borough",2,33,213,118,95
050,02,150,"Alaska","Kodiak Island Borough",2,34,214,121,93
050,02,150,"Alaska","Kodiak Island Borough",2,35,216,115,101
050,02,150,"Alaska","Kodiak Island Borough",2,36,223,109,114
050,02,150,"Alaska","Kodiak Island Borough",2,37,230,115,115
050,02,150,"Alaska","Kodiak Island Borough",2,38,224,112,112
050,02,150,"Alaska","Kodiak Island Borough",2,39,227,106,121
050,02,150,"Alaska","Kodiak Island Borough",2,40,185,93,92
050,02,150,"Alaska","Kodiak Island Borough",2,41,171,94,77
050,02,150,"Alaska","Kodiak Island Borough",2,42,154,85,69
050,02,150,"Alaska","Kodiak Island Borough",2,43,165,91,74
050,02,150,"Alaska","Kodiak Island Borough",2,44,152,83,69
050,02,150,"Alaska","Kodiak Island Borough",2,45,139,71,68
050,02,150,"Alaska","Kodiak Island Borough",2,46,132,69,63
050,02,150,"Alaska","Kodiak Island Borough",2,47,116,61,55
050,02,150,"Alaska","Kodiak Island Borough",2,48,122,65,57
050,02,150,"Alaska","Kodiak Island Borough",2,49,127,64,63
050,02,150,"Alaska","Kodiak Island Borough",2,50,133,61,72
050,02,150,"Alaska","Kodiak Island Borough",2,51,130,62,68
050,02,150,"Alaska","Kodiak Island Borough",2,52,127,67,60
050,02,150,"Alaska","Kodiak Island Borough",2,53,143,81,62
050,02,150,"Alaska","Kodiak Island Borough",2,54,156,92,64
050,02,150,"Alaska","Kodiak Island Borough",2,55,143,73,70
050,02,150,"Alaska","Kodiak Island Borough",2,56,164,84,80
050,02,150,"Alaska","Kodiak Island Borough",2,57,175,89,86
050,02,150,"Alaska","Kodiak Island Borough",2,58,183,106,77
050,02,150,"Alaska","Kodiak Island Borough",2,59,183,104,79
050,02,150,"Alaska","Kodiak Island Borough",2,60,173,103,70
050,02,150,"Alaska","Kodiak Island Borough",2,61,167,94,73
050,02,150,"Alaska","Kodiak Island Borough",2,62,174,100,74
050,02,150,"Alaska","Kodiak Island Borough",2,63,163,90,73
050,02,150,"Alaska","Kodiak Island Borough",2,64,169,95,74
050,02,150,"Alaska","Kodiak Island Borough",2,65,164,91,73
050,02,150,"Alaska","Kodiak Island Borough",2,66,147,81,66
050,02,150,"Alaska","Kodiak Island Borough",2,67,118,64,54
050,02,150,"Alaska","Kodiak Island Borough",2,68,106,57,49
050,02,150,"Alaska","Kodiak Island Borough",2,69,112,56,56
050,02,150,"Alaska","Kodiak Island Borough",2,70,106,54,52
050,02,150,"Alaska","Kodiak Island Borough",2,71,92,45,47
050,02,150,"Alaska","Kodiak Island Borough",2,72,91,49,42
050,02,150,"Alaska","Kodiak Island Borough",2,73,93,49,44
050,02,150,"Alaska","Kodiak Island Borough",2,74,67,34,33
050,02,150,"Alaska","Kodiak Island Borough",2,75,64,31,33
050,02,150,"Alaska","Kodiak Island Borough",2,76,58,24,34
050,02,150,"Alaska","Kodiak Island Borough",2,77,59,25,34
050,02,150,"Alaska","Kodiak Island Borough",2,78,45,21,24
050,02,150,"Alaska","Kodiak Island Borough",2,79,36,16,20
050,02,150,"Alaska","Kodiak Island Borough",2,80,41,18,23
050,02,150,"Alaska","Kodiak Island Borough",2,81,38,18,20
050,02,150,"Alaska","Kodiak Island Borough",2,82,31,14,17
050,02,150,"Alaska","Kodiak Island Borough",2,83,23,11,12
050,02,150,"Alaska","Kodiak Island Borough",2,84,26,10,16
050,02,150,"Alaska","Kodiak Island Borough",2,85,90,30,60
050,02,150,"Alaska","Kodiak Island Borough",3,0,166,81,85
050,02,150,"Alaska","Kodiak Island Borough",3,1,153,92,61
050,02,150,"Alaska","Kodiak Island Borough",3,2,130,75,55
050,02,150,"Alaska","Kodiak Island Borough",3,3,185,87,98
050,02,150,"Alaska","Kodiak Island Borough",3,4,172,87,85
050,02,150,"Alaska","Kodiak Island Borough",3,5,202,118,84
050,02,150,"Alaska","Kodiak Island Borough",3,6,183,103,80
050,02,150,"Alaska","Kodiak Island Borough",3,7,195,120,75
050,02,150,"Alaska","Kodiak Island Borough",3,8,192,110,82
050,02,150,"Alaska","Kodiak Island Borough",3,9,172,95,77
050,02,150,"Alaska","Kodiak Island Borough",3,10,175,98,77
050,02,150,"Alaska","Kodiak Island Borough",3,11,179,93,86
050,02,150,"Alaska","Kodiak Island Borough",3,12,172,86,86
050,02,150,"Alaska","Kodiak Island Borough",3,13,170,76,94
050,02,150,"Alaska","Kodiak Island Borough",3,14,175,86,89
050,02,150,"Alaska","Kodiak Island Borough",3,15,149,80,69
050,02,150,"Alaska","Kodiak Island Borough",3,16,136,70,66
050,02,150,"Alaska","Kodiak Island Borough",3,17,149,74,75
050,02,150,"Alaska","Kodiak Island Borough",3,18,129,67,62
050,02,150,"Alaska","Kodiak Island Borough",3,19,144,93,51
050,02,150,"Alaska","Kodiak Island Borough",3,20,207,134,73
050,02,150,"Alaska","Kodiak Island Borough",3,21,181,116,65
050,02,150,"Alaska","Kodiak Island Borough",3,22,196,120,76
050,02,150,"Alaska","Kodiak Island Borough",3,23,200,130,70
050,02,150,"Alaska","Kodiak Island Borough",3,24,168,89,79
050,02,150,"Alaska","Kodiak Island Borough",3,25,170,106,64
050,02,150,"Alaska","Kodiak Island Borough",3,26,190,102,88
050,02,150,"Alaska","Kodiak Island Borough",3,27,197,102,95
050,02,150,"Alaska","Kodiak Island Borough",3,28,207,120,87
050,02,150,"Alaska","Kodiak Island Borough",3,29,189,92,97
050,02,150,"Alaska","Kodiak Island Borough",3,30,212,111,101
050,02,150,"Alaska","Kodiak Island Borough",3,31,255,132,123
050,02,150,"Alaska","Kodiak Island Borough",3,32,241,130,111
050,02,150,"Alaska","Kodiak Island Borough",3,33,205,108,97
050,02,150,"Alaska","Kodiak Island Borough",3,34,219,121,98
050,02,150,"Alaska","Kodiak Island Borough",3,35,200,115,85
050,02,150,"Alaska","Kodiak Island Borough",3,36,210,108,102
050,02,150,"Alaska","Kodiak Island Borough",3,37,221,111,110
050,02,150,"Alaska","Kodiak Island Borough",3,38,223,110,113
050,02,150,"Alaska","Kodiak Island Borough",3,39,211,107,104
050,02,150,"Alaska","Kodiak Island Borough",3,40,211,98,113
050,02,150,"Alaska","Kodiak Island Borough",3,41,178,89,89
050,02,150,"Alaska","Kodiak Island Borough",3,42,161,83,78
050,02,150,"Alaska","Kodiak Island Borough",3,43,145,79,66
050,02,150,"Alaska","Kodiak Island Borough",3,44,157,85,72
050,02,150,"Alaska","Kodiak Island Borough",3,45,137,76,61
050,02,150,"Alaska","Kodiak Island Borough",3,46,127,69,58
050,02,150,"Alaska","Kodiak Island Borough",3,47,121,65,56
050,02,150,"Alaska","Kodiak Island Borough",3,48,115,64,51
050,02,150,"Alaska","Kodiak Island Borough",3,49,126,65,61
050,02,150,"Alaska","Kodiak Island Borough",3,50,123,60,63
050,02,150,"Alaska","Kodiak Island Borough",3,51,130,58,72
050,02,150,"Alaska","Kodiak Island Borough",3,52,130,63,67
050,02,150,"Alaska","Kodiak Island Borough",3,53,125,65,60
050,02,150,"Alaska","Kodiak Island Borough",3,54,141,83,58
050,02,150,"Alaska","Kodiak Island Borough",3,55,161,96,65
050,02,150,"Alaska","Kodiak Island Borough",3,56,140,75,65
050,02,150,"Alaska","Kodiak Island Borough",3,57,158,78,80
050,02,150,"Alaska","Kodiak Island Borough",3,58,170,89,81
050,02,150,"Alaska","Kodiak Island Borough",3,59,182,107,75
050,02,150,"Alaska","Kodiak Island Borough",3,60,174,97,77
050,02,150,"Alaska","Kodiak Island Borough",3,61,172,101,71
050,02,150,"Alaska","Kodiak Island Borough",3,62,154,87,67
050,02,150,"Alaska","Kodiak Island Borough",3,63,164,95,69
050,02,150,"Alaska","Kodiak Island Borough",3,64,162,98,64
050,02,150,"Alaska","Kodiak Island Borough",3,65,159,90,69
050,02,150,"Alaska","Kodiak Island Borough",3,66,163,92,71
050,02,150,"Alaska","Kodiak Island Borough",3,67,138,79,59
050,02,150,"Alaska","Kodiak Island Borough",3,68,113,60,53
050,02,150,"Alaska","Kodiak Island Borough",3,69,105,55,50
050,02,150,"Alaska","Kodiak Island Borough",3,70,107,52,55
050,02,150,"Alaska","Kodiak Island Borough",3,71,103,50,53
050,02,150,"Alaska","Kodiak Island Borough",3,72,88,44,44
050,02,150,"Alaska","Kodiak Island Borough",3,73,89,47,42
050,02,150,"Alaska","Kodiak Island Borough",3,74,87,45,42
050,02,150,"Alaska","Kodiak Island Borough",3,75,64,35,29
050,02,150,"Alaska","Kodiak Island Borough",3,76,61,31,30
050,02,150,"Alaska","Kodiak Island Borough",3,77,58,25,33
050,02,150,"Alaska","Kodiak Island Borough",3,78,52,22,30
050,02,150,"Alaska","Kodiak Island Borough",3,79,45,20,25
050,02,150,"Alaska","Kodiak Island Borough",3,80,34,15,19
050,02,150,"Alaska","Kodiak Island Borough",3,81,38,17,21
050,02,150,"Alaska","Kodiak Island Borough",3,82,35,15,20
050,02,150,"Alaska","Kodiak Island Borough",3,83,30,14,16
050,02,150,"Alaska","Kodiak Island Borough",3,84,23,11,12
050,02,150,"Alaska","Kodiak Island Borough",3,85,92,27,65
050,02,150,"Alaska","Kodiak Island Borough",4,0,156,69,87
050,02,150,"Alaska","Kodiak Island Borough",4,1,178,82,96
050,02,150,"Alaska","Kodiak Island Borough",4,2,139,77,62
050,02,150,"Alaska","Kodiak Island Borough",4,3,122,69,53
050,02,150,"Alaska","Kodiak Island Borough",4,4,178,81,97
050,02,150,"Alaska","Kodiak Island Borough",4,5,170,89,81
050,02,150,"Alaska","Kodiak Island Borough",4,6,196,106,90
050,02,150,"Alaska","Kodiak Island Borough",4,7,173,102,71
050,02,150,"Alaska","Kodiak Island Borough",4,8,195,116,79
050,02,150,"Alaska","Kodiak Island Borough",4,9,177,100,77
050,02,150,"Alaska","Kodiak Island Borough",4,10,163,90,73
050,02,150,"Alaska","Kodiak Island Borough",4,11,168,91,77
050,02,150,"Alaska","Kodiak Island Borough",4,12,178,91,87
050,02,150,"Alaska","Kodiak Island Borough",4,13,171,83,88
050,02,150,"Alaska","Kodiak Island Borough",4,14,167,77,90
050,02,150,"Alaska","Kodiak Island Borough",4,15,166,83,83
050,02,150,"Alaska","Kodiak Island Borough",4,16,142,78,64
050,02,150,"Alaska","Kodiak Island Borough",4,17,133,69,64
050,02,150,"Alaska","Kodiak Island Borough",4,18,120,64,56
050,02,150,"Alaska","Kodiak Island Borough",4,19,135,83,52
050,02,150,"Alaska","Kodiak Island Borough",4,20,212,146,66
050,02,150,"Alaska","Kodiak Island Borough",4,21,152,97,55
050,02,150,"Alaska","Kodiak Island Borough",4,22,176,101,75
050,02,150,"Alaska","Kodiak Island Borough",4,23,199,126,73
050,02,150,"Alaska","Kodiak Island Borough",4,24,148,99,49
050,02,150,"Alaska","Kodiak Island Borough",4,25,161,93,68
050,02,150,"Alaska","Kodiak Island Borough",4,26,186,113,73
050,02,150,"Alaska","Kodiak Island Borough",4,27,193,96,97
050,02,150,"Alaska","Kodiak Island Borough",4,28,192,96,96
050,02,150,"Alaska","Kodiak Island Borough",4,29,194,109,85
050,02,150,"Alaska","Kodiak Island Borough",4,30,194,98,96
050,02,150,"Alaska","Kodiak Island Borough",4,31,245,109,136
050,02,150,"Alaska","Kodiak Island Borough",4,32,250,123,127
050,02,150,"Alaska","Kodiak Island Borough",4,33,224,121,103
050,02,150,"Alaska","Kodiak Island Borough",4,34,206,106,100
050,02,150,"Alaska","Kodiak Island Borough",4,35,216,122,94
050,02,150,"Alaska","Kodiak Island Borough",4,36,190,108,82
050,02,150,"Alaska","Kodiak Island Borough",4,37,201,97,104
050,02,150,"Alaska","Kodiak Island Borough",4,38,222,109,113
050,02,150,"Alaska","Kodiak Island Borough",4,39,214,105,109
050,02,150,"Alaska","Kodiak Island Borough",4,40,195,103,92
050,02,150,"Alaska","Kodiak Island Borough",4,41,205,100,105
050,02,150,"Alaska","Kodiak Island Borough",4,42,162,76,86
050,02,150,"Alaska","Kodiak Island Borough",4,43,152,72,80
050,02,150,"Alaska","Kodiak Island Borough",4,44,131,69,62
050,02,150,"Alaska","Kodiak Island Borough",4,45,143,71,72
050,02,150,"Alaska","Kodiak Island Borough",4,46,142,79,63
050,02,150,"Alaska","Kodiak Island Borough",4,47,127,74,53
050,02,150,"Alaska","Kodiak Island Borough",4,48,122,67,55
050,02,150,"Alaska","Kodiak Island Borough",4,49,114,65,49
050,02,150,"Alaska","Kodiak Island Borough",4,50,122,66,56
050,02,150,"Alaska","Kodiak Island Borough",4,51,123,64,59
050,02,150,"Alaska","Kodiak Island Borough",4,52,126,58,68
050,02,150,"Alaska","Kodiak Island Borough",4,53,127,61,66
050,02,150,"Alaska","Kodiak Island Borough",4,54,121,64,57
050,02,150,"Alaska","Kodiak Island Borough",4,55,134,76,58
050,02,150,"Alaska","Kodiak Island Borough",4,56,147,85,62
050,02,150,"Alaska","Kodiak Island Borough",4,57,133,66,67
050,02,150,"Alaska","Kodiak Island Borough",4,58,157,77,80
050,02,150,"Alaska","Kodiak Island Borough",4,59,159,83,76
050,02,150,"Alaska","Kodiak Island Borough",4,60,176,107,69
050,02,150,"Alaska","Kodiak Island Borough",4,61,174,98,76
050,02,150,"Alaska","Kodiak Island Borough",4,62,165,93,72
050,02,150,"Alaska","Kodiak Island Borough",4,63,150,86,64
050,02,150,"Alaska","Kodiak Island Borough",4,64,160,93,67
050,02,150,"Alaska","Kodiak Island Borough",4,65,161,96,65
050,02,150,"Alaska","Kodiak Island Borough",4,66,157,93,64
050,02,150,"Alaska","Kodiak Island Borough",4,67,154,85,69
050,02,150,"Alaska","Kodiak Island Borough",4,68,139,79,60
050,02,150,"Alaska","Kodiak Island Borough",4,69,115,62,53
050,02,150,"Alaska","Kodiak Island Borough",4,70,103,53,50
050,02,150,"Alaska","Kodiak Island Borough",4,71,105,51,54
050,02,150,"Alaska","Kodiak Island Borough",4,72,97,48,49
050,02,150,"Alaska","Kodiak Island Borough",4,73,83,41,42
050,02,150,"Alaska","Kodiak Island Borough",4,74,87,47,40
050,02,150,"Alaska","Kodiak Island Borough",4,75,81,42,39
050,02,150,"Alaska","Kodiak Island Borough",4,76,64,37,27
050,02,150,"Alaska","Kodiak Island Borough",4,77,60,32,28
050,02,150,"Alaska","Kodiak Island Borough",4,78,49,21,28
050,02,150,"Alaska","Kodiak Island Borough",4,79,51,20,31
050,02,150,"Alaska","Kodiak Island Borough",4,80,43,20,23
050,02,150,"Alaska","Kodiak Island Borough",4,81,34,14,20
050,02,150,"Alaska","Kodiak Island Borough",4,82,38,18,20
050,02,150,"Alaska","Kodiak Island Borough",4,83,32,15,17
050,02,150,"Alaska","Kodiak Island Borough",4,84,27,13,14
050,02,150,"Alaska","Kodiak Island Borough",4,85,90,22,68
050,02,150,"Alaska","Kodiak Island Borough",5,0,154,69,85
050,02,150,"Alaska","Kodiak Island Borough",5,1,152,72,80
050,02,150,"Alaska","Kodiak Island Borough",5,2,169,79,90
050,02,150,"Alaska","Kodiak Island Borough",5,3,137,72,65
050,02,150,"Alaska","Kodiak Island Borough",5,4,124,68,56
050,02,150,"Alaska","Kodiak Island Borough",5,5,181,82,99
050,02,150,"Alaska","Kodiak Island Borough",5,6,173,89,84
050,02,150,"Alaska","Kodiak Island Borough",5,7,199,112,87
050,02,150,"Alaska","Kodiak Island Borough",5,8,165,101,64
050,02,150,"Alaska","Kodiak Island Borough",5,9,175,111,64
050,02,150,"Alaska","Kodiak Island Borough",5,10,177,98,79
050,02,150,"Alaska","Kodiak Island Borough",5,11,156,81,75
050,02,150,"Alaska","Kodiak Island Borough",5,12,157,85,72
050,02,150,"Alaska","Kodiak Island Borough",5,13,178,88,90
050,02,150,"Alaska","Kodiak Island Borough",5,14,175,87,88
050,02,150,"Alaska","Kodiak Island Borough",5,15,167,83,84
050,02,150,"Alaska","Kodiak Island Borough",5,16,161,85,76
050,02,150,"Alaska","Kodiak Island Borough",5,17,133,74,59
050,02,150,"Alaska","Kodiak Island Borough",5,18,106,55,51
050,02,150,"Alaska","Kodiak Island Borough",5,19,128,82,46
050,02,150,"Alaska","Kodiak Island Borough",5,20,212,140,72
050,02,150,"Alaska","Kodiak Island Borough",5,21,173,115,58
050,02,150,"Alaska","Kodiak Island Borough",5,22,171,96,75
050,02,150,"Alaska","Kodiak Island Borough",5,23,189,108,81
050,02,150,"Alaska","Kodiak Island Borough",5,24,164,102,62
050,02,150,"Alaska","Kodiak Island Borough",5,25,161,117,44
050,02,150,"Alaska","Kodiak Island Borough",5,26,180,106,74
050,02,150,"Alaska","Kodiak Island Borough",5,27,182,106,76
050,02,150,"Alaska","Kodiak Island Borough",5,28,177,91,86
050,02,150,"Alaska","Kodiak Island Borough",5,29,178,88,90
050,02,150,"Alaska","Kodiak Island Borough",5,30,195,106,89
050,02,150,"Alaska","Kodiak Island Borough",5,31,210,101,109
050,02,150,"Alaska","Kodiak Island Borough",5,32,251,113,138
050,02,150,"Alaska","Kodiak Island Borough",5,33,229,113,116
050,02,150,"Alaska","Kodiak Island Borough",5,34,227,121,106
050,02,150,"Alaska","Kodiak Island Borough",5,35,192,93,99
050,02,150,"Alaska","Kodiak Island Borough",5,36,231,123,108
050,02,150,"Alaska","Kodiak Island Borough",5,37,195,101,94
050,02,150,"Alaska","Kodiak Island Borough",5,38,203,100,103
050,02,150,"Alaska","Kodiak Island Borough",5,39,209,102,107
050,02,150,"Alaska","Kodiak Island Borough",5,40,215,108,107
050,02,150,"Alaska","Kodiak Island Borough",5,41,187,92,95
050,02,150,"Alaska","Kodiak Island Borough",5,42,201,99,102
050,02,150,"Alaska","Kodiak Island Borough",5,43,157,78,79
050,02,150,"Alaska","Kodiak Island Borough",5,44,148,67,81
050,02,150,"Alaska","Kodiak Island Borough",5,45,119,62,57
050,02,150,"Alaska","Kodiak Island Borough",5,46,132,70,62
050,02,150,"Alaska","Kodiak Island Borough",5,47,143,77,66
050,02,150,"Alaska","Kodiak Island Borough",5,48,122,75,47
050,02,150,"Alaska","Kodiak Island Borough",5,49,113,59,54
050,02,150,"Alaska","Kodiak Island Borough",5,50,105,56,49
050,02,150,"Alaska","Kodiak Island Borough",5,51,120,66,54
050,02,150,"Alaska","Kodiak Island Borough",5,52,123,68,55
050,02,150,"Alaska","Kodiak Island Borough",5,53,126,59,67
050,02,150,"Alaska","Kodiak Island Borough",5,54,119,58,61
050,02,150,"Alaska","Kodiak Island Borough",5,55,120,61,59
050,02,150,"Alaska","Kodiak Island Borough",5,56,132,77,55
050,02,150,"Alaska","Kodiak Island Borough",5,57,142,78,64
050,02,150,"Alaska","Kodiak Island Borough",5,58,127,64,63
050,02,150,"Alaska","Kodiak Island Borough",5,59,150,71,79
050,02,150,"Alaska","Kodiak Island Borough",5,60,159,84,75
050,02,150,"Alaska","Kodiak Island Borough",5,61,176,103,73
050,02,150,"Alaska","Kodiak Island Borough",5,62,168,93,75
050,02,150,"Alaska","Kodiak Island Borough",5,63,158,91,67
050,02,150,"Alaska","Kodiak Island Borough",5,64,147,84,63
050,02,150,"Alaska","Kodiak Island Borough",5,65,161,93,68
050,02,150,"Alaska","Kodiak Island Borough",5,66,156,95,61
050,02,150,"Alaska","Kodiak Island Borough",5,67,155,91,64
050,02,150,"Alaska","Kodiak Island Borough",5,68,158,87,71
050,02,150,"Alaska","Kodiak Island Borough",5,69,132,75,57
050,02,150,"Alaska","Kodiak Island Borough",5,70,113,62,51
050,02,150,"Alaska","Kodiak Island Borough",5,71,101,52,49
050,02,150,"Alaska","Kodiak Island Borough",5,72,102,49,53
050,02,150,"Alaska","Kodiak Island Borough",5,73,95,47,48
050,02,150,"Alaska","Kodiak Island Borough",5,74,81,41,40
050,02,150,"Alaska","Kodiak Island Borough",5,75,84,46,38
050,02,150,"Alaska","Kodiak Island Borough",5,76,77,41,36
050,02,150,"Alaska","Kodiak Island Borough",5,77,64,37,27
050,02,150,"Alaska","Kodiak Island Borough",5,78,54,30,24
050,02,150,"Alaska","Kodiak Island Borough",5,79,48,20,28
050,02,150,"Alaska","Kodiak Island Borough",5,80,47,18,29
050,02,150,"Alaska","Kodiak Island Borough",5,81,41,19,22
050,02,150,"Alaska","Kodiak Island Borough",5,82,34,14,20
050,02,150,"Alaska","Kodiak Island Borough",5,83,36,18,18
050,02,150,"Alaska","Kodiak Island Borough",5,84,32,15,17
050,02,150,"Alaska","Kodiak Island Borough",5,85,89,15,74
050,02,158,"Alaska","Kusilvak Census Area",1,0,227,119,108
050,02,158,"Alaska","Kusilvak Census Area",1,1,217,123,94
050,02,158,"Alaska","Kusilvak Census Area",1,2,230,119,111
050,02,158,"Alaska","Kusilvak Census Area",1,3,208,112,96
050,02,158,"Alaska","Kusilvak Census Area",1,4,192,102,90
050,02,158,"Alaska","Kusilvak Census Area",1,5,210,106,104
050,02,158,"Alaska","Kusilvak Census Area",1,6,201,107,94
050,02,158,"Alaska","Kusilvak Census Area",1,7,201,102,99
050,02,158,"Alaska","Kusilvak Census Area",1,8,219,121,98
050,02,158,"Alaska","Kusilvak Census Area",1,9,209,110,99
050,02,158,"Alaska","Kusilvak Census Area",1,10,180,101,79
050,02,158,"Alaska","Kusilvak Census Area",1,11,189,113,76
050,02,158,"Alaska","Kusilvak Census Area",1,12,168,93,75
050,02,158,"Alaska","Kusilvak Census Area",1,13,179,94,85
050,02,158,"Alaska","Kusilvak Census Area",1,14,159,87,72
050,02,158,"Alaska","Kusilvak Census Area",1,15,161,80,81
050,02,158,"Alaska","Kusilvak Census Area",1,16,166,94,72
050,02,158,"Alaska","Kusilvak Census Area",1,17,166,83,83
050,02,158,"Alaska","Kusilvak Census Area",1,18,143,68,75
050,02,158,"Alaska","Kusilvak Census Area",1,19,123,61,62
050,02,158,"Alaska","Kusilvak Census Area",1,20,119,67,52
050,02,158,"Alaska","Kusilvak Census Area",1,21,119,69,50
050,02,158,"Alaska","Kusilvak Census Area",1,22,133,71,62
050,02,158,"Alaska","Kusilvak Census Area",1,23,133,67,66
050,02,158,"Alaska","Kusilvak Census Area",1,24,116,69,47
050,02,158,"Alaska","Kusilvak Census Area",1,25,105,55,50
050,02,158,"Alaska","Kusilvak Census Area",1,26,127,54,73
050,02,158,"Alaska","Kusilvak Census Area",1,27,132,60,72
050,02,158,"Alaska","Kusilvak Census Area",1,28,120,55,65
050,02,158,"Alaska","Kusilvak Census Area",1,29,127,69,58
050,02,158,"Alaska","Kusilvak Census Area",1,30,135,84,51
050,02,158,"Alaska","Kusilvak Census Area",1,31,135,78,57
050,02,158,"Alaska","Kusilvak Census Area",1,32,137,78,59
050,02,158,"Alaska","Kusilvak Census Area",1,33,115,68,47
050,02,158,"Alaska","Kusilvak Census Area",1,34,106,58,48
050,02,158,"Alaska","Kusilvak Census Area",1,35,102,49,53
050,02,158,"Alaska","Kusilvak Census Area",1,36,87,44,43
050,02,158,"Alaska","Kusilvak Census Area",1,37,96,56,40
050,02,158,"Alaska","Kusilvak Census Area",1,38,69,39,30
050,02,158,"Alaska","Kusilvak Census Area",1,39,79,42,37
050,02,158,"Alaska","Kusilvak Census Area",1,40,82,48,34
050,02,158,"Alaska","Kusilvak Census Area",1,41,65,34,31
050,02,158,"Alaska","Kusilvak Census Area",1,42,65,30,35
050,02,158,"Alaska","Kusilvak Census Area",1,43,63,33,30
050,02,158,"Alaska","Kusilvak Census Area",1,44,61,31,30
050,02,158,"Alaska","Kusilvak Census Area",1,45,64,34,30
050,02,158,"Alaska","Kusilvak Census Area",1,46,61,34,27
050,02,158,"Alaska","Kusilvak Census Area",1,47,64,36,28
050,02,158,"Alaska","Kusilvak Census Area",1,48,68,35,33
050,02,158,"Alaska","Kusilvak Census Area",1,49,62,33,29
050,02,158,"Alaska","Kusilvak Census Area",1,50,60,32,28
050,02,158,"Alaska","Kusilvak Census Area",1,51,78,40,38
050,02,158,"Alaska","Kusilvak Census Area",1,52,81,46,35
050,02,158,"Alaska","Kusilvak Census Area",1,53,80,45,35
050,02,158,"Alaska","Kusilvak Census Area",1,54,70,42,28
050,02,158,"Alaska","Kusilvak Census Area",1,55,81,42,39
050,02,158,"Alaska","Kusilvak Census Area",1,56,92,45,47
050,02,158,"Alaska","Kusilvak Census Area",1,57,91,54,37
050,02,158,"Alaska","Kusilvak Census Area",1,58,76,39,37
050,02,158,"Alaska","Kusilvak Census Area",1,59,81,42,39
050,02,158,"Alaska","Kusilvak Census Area",1,60,80,44,36
050,02,158,"Alaska","Kusilvak Census Area",1,61,70,39,31
050,02,158,"Alaska","Kusilvak Census Area",1,62,70,41,29
050,02,158,"Alaska","Kusilvak Census Area",1,63,60,35,25
050,02,158,"Alaska","Kusilvak Census Area",1,64,59,34,25
050,02,158,"Alaska","Kusilvak Census Area",1,65,58,31,27
050,02,158,"Alaska","Kusilvak Census Area",1,66,58,30,28
050,02,158,"Alaska","Kusilvak Census Area",1,67,44,22,22
050,02,158,"Alaska","Kusilvak Census Area",1,68,42,22,20
050,02,158,"Alaska","Kusilvak Census Area",1,69,39,19,20
050,02,158,"Alaska","Kusilvak Census Area",1,70,40,17,23
050,02,158,"Alaska","Kusilvak Census Area",1,71,35,18,17
050,02,158,"Alaska","Kusilvak Census Area",1,72,31,14,17
050,02,158,"Alaska","Kusilvak Census Area",1,73,26,10,16
050,02,158,"Alaska","Kusilvak Census Area",1,74,21,9,12
050,02,158,"Alaska","Kusilvak Census Area",1,75,22,13,9
050,02,158,"Alaska","Kusilvak Census Area",1,76,20,7,13
050,02,158,"Alaska","Kusilvak Census Area",1,77,11,4,7
050,02,158,"Alaska","Kusilvak Census Area",1,78,12,3,9
050,02,158,"Alaska","Kusilvak Census Area",1,79,12,5,7
050,02,158,"Alaska","Kusilvak Census Area",1,80,8,3,5
050,02,158,"Alaska","Kusilvak Census Area",1,81,7,3,4
050,02,158,"Alaska","Kusilvak Census Area",1,82,6,3,3
050,02,158,"Alaska","Kusilvak Census Area",1,83,10,3,7
050,02,158,"Alaska","Kusilvak Census Area",1,84,8,2,6
050,02,158,"Alaska","Kusilvak Census Area",1,85,36,9,27
050,02,158,"Alaska","Kusilvak Census Area",2,0,230,113,117
050,02,158,"Alaska","Kusilvak Census Area",2,1,220,123,97
050,02,158,"Alaska","Kusilvak Census Area",2,2,224,119,105
050,02,158,"Alaska","Kusilvak Census Area",2,3,213,115,98
050,02,158,"Alaska","Kusilvak Census Area",2,4,196,104,92
050,02,158,"Alaska","Kusilvak Census Area",2,5,203,104,99
050,02,158,"Alaska","Kusilvak Census Area",2,6,204,108,96
050,02,158,"Alaska","Kusilvak Census Area",2,7,201,103,98
050,02,158,"Alaska","Kusilvak Census Area",2,8,211,113,98
050,02,158,"Alaska","Kusilvak Census Area",2,9,208,112,96
050,02,158,"Alaska","Kusilvak Census Area",2,10,187,103,84
050,02,158,"Alaska","Kusilvak Census Area",2,11,185,110,75
050,02,158,"Alaska","Kusilvak Census Area",2,12,174,99,75
050,02,158,"Alaska","Kusilvak Census Area",2,13,175,93,82
050,02,158,"Alaska","Kusilvak Census Area",2,14,165,90,75
050,02,158,"Alaska","Kusilvak Census Area",2,15,161,81,80
050,02,158,"Alaska","Kusilvak Census Area",2,16,165,90,75
050,02,158,"Alaska","Kusilvak Census Area",2,17,164,86,78
050,02,158,"Alaska","Kusilvak Census Area",2,18,142,69,73
050,02,158,"Alaska","Kusilvak Census Area",2,19,122,60,62
050,02,158,"Alaska","Kusilvak Census Area",2,20,119,65,54
050,02,158,"Alaska","Kusilvak Census Area",2,21,119,69,50
050,02,158,"Alaska","Kusilvak Census Area",2,22,132,71,61
050,02,158,"Alaska","Kusilvak Census Area",2,23,131,69,62
050,02,158,"Alaska","Kusilvak Census Area",2,24,119,68,51
050,02,158,"Alaska","Kusilvak Census Area",2,25,108,58,50
050,02,158,"Alaska","Kusilvak Census Area",2,26,120,54,66
050,02,158,"Alaska","Kusilvak Census Area",2,27,127,58,69
050,02,158,"Alaska","Kusilvak Census Area",2,28,121,55,66
050,02,158,"Alaska","Kusilvak Census Area",2,29,124,66,58
050,02,158,"Alaska","Kusilvak Census Area",2,30,133,81,52
050,02,158,"Alaska","Kusilvak Census Area",2,31,135,79,56
050,02,158,"Alaska","Kusilvak Census Area",2,32,136,78,58
050,02,158,"Alaska","Kusilvak Census Area",2,33,119,70,49
050,02,158,"Alaska","Kusilvak Census Area",2,34,108,61,47
050,02,158,"Alaska","Kusilvak Census Area",2,35,103,51,52
050,02,158,"Alaska","Kusilvak Census Area",2,36,89,45,44
050,02,158,"Alaska","Kusilvak Census Area",2,37,92,53,39
050,02,158,"Alaska","Kusilvak Census Area",2,38,76,44,32
050,02,158,"Alaska","Kusilvak Census Area",2,39,76,42,34
050,02,158,"Alaska","Kusilvak Census Area",2,40,82,47,35
050,02,158,"Alaska","Kusilvak Census Area",2,41,69,38,31
050,02,158,"Alaska","Kusilvak Census Area",2,42,64,31,33
050,02,158,"Alaska","Kusilvak Census Area",2,43,65,33,32
050,02,158,"Alaska","Kusilvak Census Area",2,44,60,31,29
050,02,158,"Alaska","Kusilvak Census Area",2,45,64,34,30
050,02,158,"Alaska","Kusilvak Census Area",2,46,61,34,27
050,02,158,"Alaska","Kusilvak Census Area",2,47,63,35,28
050,02,158,"Alaska","Kusilvak Census Area",2,48,68,36,32
050,02,158,"Alaska","Kusilvak Census Area",2,49,63,34,29
050,02,158,"Alaska","Kusilvak Census Area",2,50,61,32,29
050,02,158,"Alaska","Kusilvak Census Area",2,51,74,38,36
050,02,158,"Alaska","Kusilvak Census Area",2,52,80,45,35
050,02,158,"Alaska","Kusilvak Census Area",2,53,80,45,35
050,02,158,"Alaska","Kusilvak Census Area",2,54,71,42,29
050,02,158,"Alaska","Kusilvak Census Area",2,55,80,43,37
050,02,158,"Alaska","Kusilvak Census Area",2,56,90,45,45
050,02,158,"Alaska","Kusilvak Census Area",2,57,91,52,39
050,02,158,"Alaska","Kusilvak Census Area",2,58,79,42,37
050,02,158,"Alaska","Kusilvak Census Area",2,59,77,40,37
050,02,158,"Alaska","Kusilvak Census Area",2,60,80,44,36
050,02,158,"Alaska","Kusilvak Census Area",2,61,73,41,32
050,02,158,"Alaska","Kusilvak Census Area",2,62,70,41,29
050,02,158,"Alaska","Kusilvak Census Area",2,63,62,36,26
050,02,158,"Alaska","Kusilvak Census Area",2,64,57,33,24
050,02,158,"Alaska","Kusilvak Census Area",2,65,58,32,26
050,02,158,"Alaska","Kusilvak Census Area",2,66,58,30,28
050,02,158,"Alaska","Kusilvak Census Area",2,67,47,24,23
050,02,158,"Alaska","Kusilvak Census Area",2,68,44,23,21
050,02,158,"Alaska","Kusilvak Census Area",2,69,39,19,20
050,02,158,"Alaska","Kusilvak Census Area",2,70,40,18,22
050,02,158,"Alaska","Kusilvak Census Area",2,71,35,17,18
050,02,158,"Alaska","Kusilvak Census Area",2,72,32,15,17
050,02,158,"Alaska","Kusilvak Census Area",2,73,27,11,16
050,02,158,"Alaska","Kusilvak Census Area",2,74,21,9,12
050,02,158,"Alaska","Kusilvak Census Area",2,75,19,12,7
050,02,158,"Alaska","Kusilvak Census Area",2,76,20,8,12
050,02,158,"Alaska","Kusilvak Census Area",2,77,14,5,9
050,02,158,"Alaska","Kusilvak Census Area",2,78,11,3,8
050,02,158,"Alaska","Kusilvak Census Area",2,79,13,5,8
050,02,158,"Alaska","Kusilvak Census Area",2,80,9,3,6
050,02,158,"Alaska","Kusilvak Census Area",2,81,7,3,4
050,02,158,"Alaska","Kusilvak Census Area",2,82,6,3,3
050,02,158,"Alaska","Kusilvak Census Area",2,83,9,3,6
050,02,158,"Alaska","Kusilvak Census Area",2,84,9,2,7
050,02,158,"Alaska","Kusilvak Census Area",2,85,32,7,25
050,02,158,"Alaska","Kusilvak Census Area",3,0,223,117,106
050,02,158,"Alaska","Kusilvak Census Area",3,1,225,109,116
050,02,158,"Alaska","Kusilvak Census Area",3,2,206,115,91
050,02,158,"Alaska","Kusilvak Census Area",3,3,222,118,104
050,02,158,"Alaska","Kusilvak Census Area",3,4,203,108,95
050,02,158,"Alaska","Kusilvak Census Area",3,5,193,104,89
050,02,158,"Alaska","Kusilvak Census Area",3,6,203,104,99
050,02,158,"Alaska","Kusilvak Census Area",3,7,199,108,91
050,02,158,"Alaska","Kusilvak Census Area",3,8,200,101,99
050,02,158,"Alaska","Kusilvak Census Area",3,9,214,112,102
050,02,158,"Alaska","Kusilvak Census Area",3,10,208,112,96
050,02,158,"Alaska","Kusilvak Census Area",3,11,185,97,88
050,02,158,"Alaska","Kusilvak Census Area",3,12,183,102,81
050,02,158,"Alaska","Kusilvak Census Area",3,13,170,96,74
050,02,158,"Alaska","Kusilvak Census Area",3,14,176,93,83
050,02,158,"Alaska","Kusilvak Census Area",3,15,169,96,73
050,02,158,"Alaska","Kusilvak Census Area",3,16,157,82,75
050,02,158,"Alaska","Kusilvak Census Area",3,17,168,90,78
050,02,158,"Alaska","Kusilvak Census Area",3,18,148,80,68
050,02,158,"Alaska","Kusilvak Census Area",3,19,118,58,60
050,02,158,"Alaska","Kusilvak Census Area",3,20,110,54,56
050,02,158,"Alaska","Kusilvak Census Area",3,21,115,62,53
050,02,158,"Alaska","Kusilvak Census Area",3,22,111,61,50
050,02,158,"Alaska","Kusilvak Census Area",3,23,121,65,56
050,02,158,"Alaska","Kusilvak Census Area",3,24,129,70,59
050,02,158,"Alaska","Kusilvak Census Area",3,25,123,66,57
050,02,158,"Alaska","Kusilvak Census Area",3,26,111,58,53
050,02,158,"Alaska","Kusilvak Census Area",3,27,114,52,62
050,02,158,"Alaska","Kusilvak Census Area",3,28,127,60,67
050,02,158,"Alaska","Kusilvak Census Area",3,29,122,57,65
050,02,158,"Alaska","Kusilvak Census Area",3,30,114,65,49
050,02,158,"Alaska","Kusilvak Census Area",3,31,125,77,48
050,02,158,"Alaska","Kusilvak Census Area",3,32,129,74,55
050,02,158,"Alaska","Kusilvak Census Area",3,33,132,72,60
050,02,158,"Alaska","Kusilvak Census Area",3,34,118,69,49
050,02,158,"Alaska","Kusilvak Census Area",3,35,109,62,47
050,02,158,"Alaska","Kusilvak Census Area",3,36,96,47,49
050,02,158,"Alaska","Kusilvak Census Area",3,37,88,43,45
050,02,158,"Alaska","Kusilvak Census Area",3,38,92,49,43
050,02,158,"Alaska","Kusilvak Census Area",3,39,77,43,34
050,02,158,"Alaska","Kusilvak Census Area",3,40,76,43,33
050,02,158,"Alaska","Kusilvak Census Area",3,41,82,48,34
050,02,158,"Alaska","Kusilvak Census Area",3,42,69,38,31
050,02,158,"Alaska","Kusilvak Census Area",3,43,58,29,29
050,02,158,"Alaska","Kusilvak Census Area",3,44,65,29,36
050,02,158,"Alaska","Kusilvak Census Area",3,45,58,29,29
050,02,158,"Alaska","Kusilvak Census Area",3,46,66,33,33
050,02,158,"Alaska","Kusilvak Census Area",3,47,58,33,25
050,02,158,"Alaska","Kusilvak Census Area",3,48,61,35,26
050,02,158,"Alaska","Kusilvak Census Area",3,49,70,38,32
050,02,158,"Alaska","Kusilvak Census Area",3,50,62,34,28
050,02,158,"Alaska","Kusilvak Census Area",3,51,64,31,33
050,02,158,"Alaska","Kusilvak Census Area",3,52,69,37,32
050,02,158,"Alaska","Kusilvak Census Area",3,53,79,45,34
050,02,158,"Alaska","Kusilvak Census Area",3,54,79,44,35
050,02,158,"Alaska","Kusilvak Census Area",3,55,69,42,27
050,02,158,"Alaska","Kusilvak Census Area",3,56,76,39,37
050,02,158,"Alaska","Kusilvak Census Area",3,57,88,44,44
050,02,158,"Alaska","Kusilvak Census Area",3,58,92,54,38
050,02,158,"Alaska","Kusilvak Census Area",3,59,79,42,37
050,02,158,"Alaska","Kusilvak Census Area",3,60,75,38,37
050,02,158,"Alaska","Kusilvak Census Area",3,61,79,41,38
050,02,158,"Alaska","Kusilvak Census Area",3,62,72,41,31
050,02,158,"Alaska","Kusilvak Census Area",3,63,69,40,29
050,02,158,"Alaska","Kusilvak Census Area",3,64,60,36,24
050,02,158,"Alaska","Kusilvak Census Area",3,65,56,33,23
050,02,158,"Alaska","Kusilvak Census Area",3,66,58,32,26
050,02,158,"Alaska","Kusilvak Census Area",3,67,55,27,28
050,02,158,"Alaska","Kusilvak Census Area",3,68,44,23,21
050,02,158,"Alaska","Kusilvak Census Area",3,69,42,21,21
050,02,158,"Alaska","Kusilvak Census Area",3,70,36,17,19
050,02,158,"Alaska","Kusilvak Census Area",3,71,38,18,20
050,02,158,"Alaska","Kusilvak Census Area",3,72,34,16,18
050,02,158,"Alaska","Kusilvak Census Area",3,73,32,15,17
050,02,158,"Alaska","Kusilvak Census Area",3,74,27,12,15
050,02,158,"Alaska","Kusilvak Census Area",3,75,21,9,12
050,02,158,"Alaska","Kusilvak Census Area",3,76,18,11,7
050,02,158,"Alaska","Kusilvak Census Area",3,77,18,7,11
050,02,158,"Alaska","Kusilvak Census Area",3,78,12,5,7
050,02,158,"Alaska","Kusilvak Census Area",3,79,10,2,8
050,02,158,"Alaska","Kusilvak Census Area",3,80,14,5,9
050,02,158,"Alaska","Kusilvak Census Area",3,81,8,2,6
050,02,158,"Alaska","Kusilvak Census Area",3,82,7,3,4
050,02,158,"Alaska","Kusilvak Census Area",3,83,6,3,3
050,02,158,"Alaska","Kusilvak Census Area",3,84,8,3,5
050,02,158,"Alaska","Kusilvak Census Area",3,85,25,1,24
050,02,158,"Alaska","Kusilvak Census Area",4,0,214,118,96
050,02,158,"Alaska","Kusilvak Census Area",4,1,204,117,87
050,02,158,"Alaska","Kusilvak Census Area",4,2,219,109,110
050,02,158,"Alaska","Kusilvak Census Area",4,3,204,115,89
050,02,158,"Alaska","Kusilvak Census Area",4,4,207,104,103
050,02,158,"Alaska","Kusilvak Census Area",4,5,194,106,88
050,02,158,"Alaska","Kusilvak Census Area",4,6,189,103,86
050,02,158,"Alaska","Kusilvak Census Area",4,7,193,100,93
050,02,158,"Alaska","Kusilvak Census Area",4,8,196,103,93
050,02,158,"Alaska","Kusilvak Census Area",4,9,196,99,97
050,02,158,"Alaska","Kusilvak Census Area",4,10,203,105,98
050,02,158,"Alaska","Kusilvak Census Area",4,11,198,109,89
050,02,158,"Alaska","Kusilvak Census Area",4,12,189,97,92
050,02,158,"Alaska","Kusilvak Census Area",4,13,185,106,79
050,02,158,"Alaska","Kusilvak Census Area",4,14,164,94,70
050,02,158,"Alaska","Kusilvak Census Area",4,15,171,91,80
050,02,158,"Alaska","Kusilvak Census Area",4,16,163,89,74
050,02,158,"Alaska","Kusilvak Census Area",4,17,157,82,75
050,02,158,"Alaska","Kusilvak Census Area",4,18,149,82,67
050,02,158,"Alaska","Kusilvak Census Area",4,19,124,69,55
050,02,158,"Alaska","Kusilvak Census Area",4,20,110,50,60
050,02,158,"Alaska","Kusilvak Census Area",4,21,110,52,58
050,02,158,"Alaska","Kusilvak Census Area",4,22,109,59,50
050,02,158,"Alaska","Kusilvak Census Area",4,23,107,56,51
050,02,158,"Alaska","Kusilvak Census Area",4,24,111,60,51
050,02,158,"Alaska","Kusilvak Census Area",4,25,123,67,56
050,02,158,"Alaska","Kusilvak Census Area",4,26,111,61,50
050,02,158,"Alaska","Kusilvak Census Area",4,27,100,54,46
050,02,158,"Alaska","Kusilvak Census Area",4,28,105,50,55
050,02,158,"Alaska","Kusilvak Census Area",4,29,120,57,63
050,02,158,"Alaska","Kusilvak Census Area",4,30,119,53,66
050,02,158,"Alaska","Kusilvak Census Area",4,31,115,65,50
050,02,158,"Alaska","Kusilvak Census Area",4,32,124,77,47
050,02,158,"Alaska","Kusilvak Census Area",4,33,127,74,53
050,02,158,"Alaska","Kusilvak Census Area",4,34,117,60,57
050,02,158,"Alaska","Kusilvak Census Area",4,35,114,69,45
050,02,158,"Alaska","Kusilvak Census Area",4,36,110,63,47
050,02,158,"Alaska","Kusilvak Census Area",4,37,87,43,44
050,02,158,"Alaska","Kusilvak Census Area",4,38,82,40,42
050,02,158,"Alaska","Kusilvak Census Area",4,39,85,44,41
050,02,158,"Alaska","Kusilvak Census Area",4,40,65,37,28
050,02,158,"Alaska","Kusilvak Census Area",4,41,76,43,33
050,02,158,"Alaska","Kusilvak Census Area",4,42,82,49,33
050,02,158,"Alaska","Kusilvak Census Area",4,43,72,40,32
050,02,158,"Alaska","Kusilvak Census Area",4,44,60,27,33
050,02,158,"Alaska","Kusilvak Census Area",4,45,63,31,32
050,02,158,"Alaska","Kusilvak Census Area",4,46,59,29,30
050,02,158,"Alaska","Kusilvak Census Area",4,47,63,30,33
050,02,158,"Alaska","Kusilvak Census Area",4,48,54,32,22
050,02,158,"Alaska","Kusilvak Census Area",4,49,57,31,26
050,02,158,"Alaska","Kusilvak Census Area",4,50,72,38,34
050,02,158,"Alaska","Kusilvak Census Area",4,51,62,34,28
050,02,158,"Alaska","Kusilvak Census Area",4,52,62,33,29
050,02,158,"Alaska","Kusilvak Census Area",4,53,67,37,30
050,02,158,"Alaska","Kusilvak Census Area",4,54,76,41,35
050,02,158,"Alaska","Kusilvak Census Area",4,55,75,43,32
050,02,158,"Alaska","Kusilvak Census Area",4,56,70,42,28
050,02,158,"Alaska","Kusilvak Census Area",4,57,76,41,35
050,02,158,"Alaska","Kusilvak Census Area",4,58,84,40,44
050,02,158,"Alaska","Kusilvak Census Area",4,59,81,44,37
050,02,158,"Alaska","Kusilvak Census Area",4,60,75,39,36
050,02,158,"Alaska","Kusilvak Census Area",4,61,71,36,35
050,02,158,"Alaska","Kusilvak Census Area",4,62,78,40,38
050,02,158,"Alaska","Kusilvak Census Area",4,63,70,39,31
050,02,158,"Alaska","Kusilvak Census Area",4,64,66,37,29
050,02,158,"Alaska","Kusilvak Census Area",4,65,57,34,23
050,02,158,"Alaska","Kusilvak Census Area",4,66,50,30,20
050,02,158,"Alaska","Kusilvak Census Area",4,67,54,29,25
050,02,158,"Alaska","Kusilvak Census Area",4,68,50,23,27
050,02,158,"Alaska","Kusilvak Census Area",4,69,41,20,21
050,02,158,"Alaska","Kusilvak Census Area",4,70,41,20,21
050,02,158,"Alaska","Kusilvak Census Area",4,71,33,15,18
050,02,158,"Alaska","Kusilvak Census Area",4,72,36,18,18
050,02,158,"Alaska","Kusilvak Census Area",4,73,33,15,18
050,02,158,"Alaska","Kusilvak Census Area",4,74,32,16,16
050,02,158,"Alaska","Kusilvak Census Area",4,75,26,11,15
050,02,158,"Alaska","Kusilvak Census Area",4,76,18,6,12
050,02,158,"Alaska","Kusilvak Census Area",4,77,16,9,7
050,02,158,"Alaska","Kusilvak Census Area",4,78,17,7,10
050,02,158,"Alaska","Kusilvak Census Area",4,79,10,4,6
050,02,158,"Alaska","Kusilvak Census Area",4,80,9,1,8
050,02,158,"Alaska","Kusilvak Census Area",4,81,13,4,9
050,02,158,"Alaska","Kusilvak Census Area",4,82,7,1,6
050,02,158,"Alaska","Kusilvak Census Area",4,83,5,3,2
050,02,158,"Alaska","Kusilvak Census Area",4,84,3,1,2
050,02,158,"Alaska","Kusilvak Census Area",4,85,22,0,22
050,02,158,"Alaska","Kusilvak Census Area",5,0,213,119,94
050,02,158,"Alaska","Kusilvak Census Area",5,1,208,122,86
050,02,158,"Alaska","Kusilvak Census Area",5,2,197,113,84
050,02,158,"Alaska","Kusilvak Census Area",5,3,213,105,108
050,02,158,"Alaska","Kusilvak Census Area",5,4,194,110,84
050,02,158,"Alaska","Kusilvak Census Area",5,5,201,102,99
050,02,158,"Alaska","Kusilvak Census Area",5,6,182,95,87
050,02,158,"Alaska","Kusilvak Census Area",5,7,183,100,83
050,02,158,"Alaska","Kusilvak Census Area",5,8,187,98,89
050,02,158,"Alaska","Kusilvak Census Area",5,9,188,97,91
050,02,158,"Alaska","Kusilvak Census Area",5,10,185,99,86
050,02,158,"Alaska","Kusilvak Census Area",5,11,187,95,92
050,02,158,"Alaska","Kusilvak Census Area",5,12,188,106,82
050,02,158,"Alaska","Kusilvak Census Area",5,13,173,91,82
050,02,158,"Alaska","Kusilvak Census Area",5,14,181,105,76
050,02,158,"Alaska","Kusilvak Census Area",5,15,158,90,68
050,02,158,"Alaska","Kusilvak Census Area",5,16,161,87,74
050,02,158,"Alaska","Kusilvak Census Area",5,17,162,86,76
050,02,158,"Alaska","Kusilvak Census Area",5,18,139,72,67
050,02,158,"Alaska","Kusilvak Census Area",5,19,127,72,55
050,02,158,"Alaska","Kusilvak Census Area",5,20,114,66,48
050,02,158,"Alaska","Kusilvak Census Area",5,21,96,43,53
050,02,158,"Alaska","Kusilvak Census Area",5,22,100,45,55
050,02,158,"Alaska","Kusilvak Census Area",5,23,95,49,46
050,02,158,"Alaska","Kusilvak Census Area",5,24,101,55,46
050,02,158,"Alaska","Kusilvak Census Area",5,25,117,60,57
050,02,158,"Alaska","Kusilvak Census Area",5,26,120,65,55
050,02,158,"Alaska","Kusilvak Census Area",5,27,106,62,44
050,02,158,"Alaska","Kusilvak Census Area",5,28,90,50,40
050,02,158,"Alaska","Kusilvak Census Area",5,29,101,48,53
050,02,158,"Alaska","Kusilvak Census Area",5,30,118,54,64
050,02,158,"Alaska","Kusilvak Census Area",5,31,117,54,63
050,02,158,"Alaska","Kusilvak Census Area",5,32,109,59,50
050,02,158,"Alaska","Kusilvak Census Area",5,33,120,71,49
050,02,158,"Alaska","Kusilvak Census Area",5,34,119,73,46
050,02,158,"Alaska","Kusilvak Census Area",5,35,116,63,53
050,02,158,"Alaska","Kusilvak Census Area",5,36,106,65,41
050,02,158,"Alaska","Kusilvak Census Area",5,37,99,58,41
050,02,158,"Alaska","Kusilvak Census Area",5,38,83,42,41
050,02,158,"Alaska","Kusilvak Census Area",5,39,76,37,39
050,02,158,"Alaska","Kusilvak Census Area",5,40,80,42,38
050,02,158,"Alaska","Kusilvak Census Area",5,41,60,32,28
050,02,158,"Alaska","Kusilvak Census Area",5,42,77,43,34
050,02,158,"Alaska","Kusilvak Census Area",5,43,78,45,33
050,02,158,"Alaska","Kusilvak Census Area",5,44,61,33,28
050,02,158,"Alaska","Kusilvak Census Area",5,45,54,25,29
050,02,158,"Alaska","Kusilvak Census Area",5,46,61,29,32
050,02,158,"Alaska","Kusilvak Census Area",5,47,53,28,25
050,02,158,"Alaska","Kusilvak Census Area",5,48,64,33,31
050,02,158,"Alaska","Kusilvak Census Area",5,49,52,29,23
050,02,158,"Alaska","Kusilvak Census Area",5,50,56,31,25
050,02,158,"Alaska","Kusilvak Census Area",5,51,68,36,32
050,02,158,"Alaska","Kusilvak Census Area",5,52,58,31,27
050,02,158,"Alaska","Kusilvak Census Area",5,53,58,32,26
050,02,158,"Alaska","Kusilvak Census Area",5,54,63,35,28
050,02,158,"Alaska","Kusilvak Census Area",5,55,70,41,29
050,02,158,"Alaska","Kusilvak Census Area",5,56,69,37,32
050,02,158,"Alaska","Kusilvak Census Area",5,57,70,42,28
050,02,158,"Alaska","Kusilvak Census Area",5,58,76,41,35
050,02,158,"Alaska","Kusilvak Census Area",5,59,78,36,42
050,02,158,"Alaska","Kusilvak Census Area",5,60,81,44,37
050,02,158,"Alaska","Kusilvak Census Area",5,61,75,38,37
050,02,158,"Alaska","Kusilvak Census Area",5,62,69,34,35
050,02,158,"Alaska","Kusilvak Census Area",5,63,80,43,37
050,02,158,"Alaska","Kusilvak Census Area",5,64,68,37,31
050,02,158,"Alaska","Kusilvak Census Area",5,65,62,35,27
050,02,158,"Alaska","Kusilvak Census Area",5,66,55,33,22
050,02,158,"Alaska","Kusilvak Census Area",5,67,45,26,19
050,02,158,"Alaska","Kusilvak Census Area",5,68,50,26,24
050,02,158,"Alaska","Kusilvak Census Area",5,69,47,21,26
050,02,158,"Alaska","Kusilvak Census Area",5,70,38,18,20
050,02,158,"Alaska","Kusilvak Census Area",5,71,39,19,20
050,02,158,"Alaska","Kusilvak Census Area",5,72,31,15,16
050,02,158,"Alaska","Kusilvak Census Area",5,73,35,18,17
050,02,158,"Alaska","Kusilvak Census Area",5,74,32,15,17
050,02,158,"Alaska","Kusilvak Census Area",5,75,31,15,16
050,02,158,"Alaska","Kusilvak Census Area",5,76,25,11,14
050,02,158,"Alaska","Kusilvak Census Area",5,77,17,5,12
050,02,158,"Alaska","Kusilvak Census Area",5,78,14,8,6
050,02,158,"Alaska","Kusilvak Census Area",5,79,15,6,9
050,02,158,"Alaska","Kusilvak Census Area",5,80,9,3,6
050,02,158,"Alaska","Kusilvak Census Area",5,81,8,0,8
050,02,158,"Alaska","Kusilvak Census Area",5,82,13,4,9
050,02,158,"Alaska","Kusilvak Census Area",5,83,5,1,4
050,02,158,"Alaska","Kusilvak Census Area",5,84,3,2,1
050,02,158,"Alaska","Kusilvak Census Area",5,85,18,0,18
050,02,164,"Alaska","Lake and Peninsula Borough",1,0,26,13,13
050,02,164,"Alaska","Lake and Peninsula Borough",1,1,22,14,8
050,02,164,"Alaska","Lake and Peninsula Borough",1,2,29,16,13
050,02,164,"Alaska","Lake and Peninsula Borough",1,3,29,14,15
050,02,164,"Alaska","Lake and Peninsula Borough",1,4,27,17,10
050,02,164,"Alaska","Lake and Peninsula Borough",1,5,24,13,11
050,02,164,"Alaska","Lake and Peninsula Borough",1,6,22,8,14
050,02,164,"Alaska","Lake and Peninsula Borough",1,7,19,8,11
050,02,164,"Alaska","Lake and Peninsula Borough",1,8,26,8,18
050,02,164,"Alaska","Lake and Peninsula Borough",1,9,15,7,8
050,02,164,"Alaska","Lake and Peninsula Borough",1,10,29,11,18
050,02,164,"Alaska","Lake and Peninsula Borough",1,11,23,10,13
050,02,164,"Alaska","Lake and Peninsula Borough",1,12,19,11,8
050,02,164,"Alaska","Lake and Peninsula Borough",1,13,23,11,12
050,02,164,"Alaska","Lake and Peninsula Borough",1,14,20,9,11
050,02,164,"Alaska","Lake and Peninsula Borough",1,15,27,11,16
050,02,164,"Alaska","Lake and Peninsula Borough",1,16,24,9,15
050,02,164,"Alaska","Lake and Peninsula Borough",1,17,23,10,13
050,02,164,"Alaska","Lake and Peninsula Borough",1,18,20,12,8
050,02,164,"Alaska","Lake and Peninsula Borough",1,19,22,11,11
050,02,164,"Alaska","Lake and Peninsula Borough",1,20,16,7,9
050,02,164,"Alaska","Lake and Peninsula Borough",1,21,15,6,9
050,02,164,"Alaska","Lake and Peninsula Borough",1,22,15,6,9
050,02,164,"Alaska","Lake and Peninsula Borough",1,23,20,12,8
050,02,164,"Alaska","Lake and Peninsula Borough",1,24,18,10,8
050,02,164,"Alaska","Lake and Peninsula Borough",1,25,22,12,10
050,02,164,"Alaska","Lake and Peninsula Borough",1,26,18,8,10
050,02,164,"Alaska","Lake and Peninsula Borough",1,27,16,6,10
050,02,164,"Alaska","Lake and Peninsula Borough",1,28,21,10,11
050,02,164,"Alaska","Lake and Peninsula Borough",1,29,18,10,8
050,02,164,"Alaska","Lake and Peninsula Borough",1,30,18,7,11
050,02,164,"Alaska","Lake and Peninsula Borough",1,31,23,13,10
050,02,164,"Alaska","Lake and Peninsula Borough",1,32,21,11,10
050,02,164,"Alaska","Lake and Peninsula Borough",1,33,19,13,6
050,02,164,"Alaska","Lake and Peninsula Borough",1,34,12,7,5
050,02,164,"Alaska","Lake and Peninsula Borough",1,35,22,12,10
050,02,164,"Alaska","Lake and Peninsula Borough",1,36,18,8,10
050,02,164,"Alaska","Lake and Peninsula Borough",1,37,21,8,13
050,02,164,"Alaska","Lake and Peninsula Borough",1,38,17,8,9
050,02,164,"Alaska","Lake and Peninsula Borough",1,39,17,10,7
050,02,164,"Alaska","Lake and Peninsula Borough",1,40,22,11,11
050,02,164,"Alaska","Lake and Peninsula Borough",1,41,21,13,8
050,02,164,"Alaska","Lake and Peninsula Borough",1,42,15,11,4
050,02,164,"Alaska","Lake and Peninsula Borough",1,43,21,13,8
050,02,164,"Alaska","Lake and Peninsula Borough",1,44,17,9,8
050,02,164,"Alaska","Lake and Peninsula Borough",1,45,18,8,10
050,02,164,"Alaska","Lake and Peninsula Borough",1,46,17,11,6
050,02,164,"Alaska","Lake and Peninsula Borough",1,47,18,9,9
050,02,164,"Alaska","Lake and Peninsula Borough",1,48,13,5,8
050,02,164,"Alaska","Lake and Peninsula Borough",1,49,15,6,9
050,02,164,"Alaska","Lake and Peninsula Borough",1,50,18,10,8
050,02,164,"Alaska","Lake and Peninsula Borough",1,51,12,6,6
050,02,164,"Alaska","Lake and Peninsula Borough",1,52,19,13,6
050,02,164,"Alaska","Lake and Peninsula Borough",1,53,23,10,13
050,02,164,"Alaska","Lake and Peninsula Borough",1,54,22,12,10
050,02,164,"Alaska","Lake and Peninsula Borough",1,55,15,9,6
050,02,164,"Alaska","Lake and Peninsula Borough",1,56,18,12,6
050,02,164,"Alaska","Lake and Peninsula Borough",1,57,20,12,8
050,02,164,"Alaska","Lake and Peninsula Borough",1,58,20,12,8
050,02,164,"Alaska","Lake and Peninsula Borough",1,59,24,10,14
050,02,164,"Alaska","Lake and Peninsula Borough",1,60,23,11,12
050,02,164,"Alaska","Lake and Peninsula Borough",1,61,22,12,10
050,02,164,"Alaska","Lake and Peninsula Borough",1,62,16,11,5
050,02,164,"Alaska","Lake and Peninsula Borough",1,63,19,7,12
050,02,164,"Alaska","Lake and Peninsula Borough",1,64,21,12,9
050,02,164,"Alaska","Lake and Peninsula Borough",1,65,15,9,6
050,02,164,"Alaska","Lake and Peninsula Borough",1,66,12,6,6
050,02,164,"Alaska","Lake and Peninsula Borough",1,67,12,4,8
050,02,164,"Alaska","Lake and Peninsula Borough",1,68,10,5,5
050,02,164,"Alaska","Lake and Peninsula Borough",1,69,12,6,6
050,02,164,"Alaska","Lake and Peninsula Borough",1,70,15,7,8
050,02,164,"Alaska","Lake and Peninsula Borough",1,71,11,6,5
050,02,164,"Alaska","Lake and Peninsula Borough",1,72,10,6,4
050,02,164,"Alaska","Lake and Peninsula Borough",1,73,9,5,4
050,02,164,"Alaska","Lake and Peninsula Borough",1,74,7,5,2
050,02,164,"Alaska","Lake and Peninsula Borough",1,75,5,4,1
050,02,164,"Alaska","Lake and Peninsula Borough",1,76,8,3,5
050,02,164,"Alaska","Lake and Peninsula Borough",1,77,4,1,3
050,02,164,"Alaska","Lake and Peninsula Borough",1,78,4,2,2
050,02,164,"Alaska","Lake and Peninsula Borough",1,79,3,1,2
050,02,164,"Alaska","Lake and Peninsula Borough",1,80,4,1,3
050,02,164,"Alaska","Lake and Peninsula Borough",1,81,4,2,2
050,02,164,"Alaska","Lake and Peninsula Borough",1,82,4,1,3
050,02,164,"Alaska","Lake and Peninsula Borough",1,83,5,3,2
050,02,164,"Alaska","Lake and Peninsula Borough",1,84,4,3,1
050,02,164,"Alaska","Lake and Peninsula Borough",1,85,11,6,5
050,02,164,"Alaska","Lake and Peninsula Borough",2,0,24,15,9
050,02,164,"Alaska","Lake and Peninsula Borough",2,1,21,13,8
050,02,164,"Alaska","Lake and Peninsula Borough",2,2,27,15,12
050,02,164,"Alaska","Lake and Peninsula Borough",2,3,29,14,15
050,02,164,"Alaska","Lake and Peninsula Borough",2,4,27,16,11
050,02,164,"Alaska","Lake and Peninsula Borough",2,5,25,14,11
050,02,164,"Alaska","Lake and Peninsula Borough",2,6,21,9,12
050,02,164,"Alaska","Lake and Peninsula Borough",2,7,19,7,12
050,02,164,"Alaska","Lake and Peninsula Borough",2,8,23,8,15
050,02,164,"Alaska","Lake and Peninsula Borough",2,9,17,7,10
050,02,164,"Alaska","Lake and Peninsula Borough",2,10,26,10,16
050,02,164,"Alaska","Lake and Peninsula Borough",2,11,25,12,13
050,02,164,"Alaska","Lake and Peninsula Borough",2,12,18,10,8
050,02,164,"Alaska","Lake and Peninsula Borough",2,13,22,11,11
050,02,164,"Alaska","Lake and Peninsula Borough",2,14,21,9,12
050,02,164,"Alaska","Lake and Peninsula Borough",2,15,26,11,15
050,02,164,"Alaska","Lake and Peninsula Borough",2,16,25,10,15
050,02,164,"Alaska","Lake and Peninsula Borough",2,17,23,10,13
050,02,164,"Alaska","Lake and Peninsula Borough",2,18,19,11,8
050,02,164,"Alaska","Lake and Peninsula Borough",2,19,21,11,10
050,02,164,"Alaska","Lake and Peninsula Borough",2,20,18,8,10
050,02,164,"Alaska","Lake and Peninsula Borough",2,21,17,7,10
050,02,164,"Alaska","Lake and Peninsula Borough",2,22,15,6,9
050,02,164,"Alaska","Lake and Peninsula Borough",2,23,18,10,8
050,02,164,"Alaska","Lake and Peninsula Borough",2,24,18,10,8
050,02,164,"Alaska","Lake and Peninsula Borough",2,25,21,12,9
050,02,164,"Alaska","Lake and Peninsula Borough",2,26,20,10,10
050,02,164,"Alaska","Lake and Peninsula Borough",2,27,16,6,10
050,02,164,"Alaska","Lake and Peninsula Borough",2,28,19,9,10
050,02,164,"Alaska","Lake and Peninsula Borough",2,29,17,9,8
050,02,164,"Alaska","Lake and Peninsula Borough",2,30,18,7,11
050,02,164,"Alaska","Lake and Peninsula Borough",2,31,22,12,10
050,02,164,"Alaska","Lake and Peninsula Borough",2,32,21,12,9
050,02,164,"Alaska","Lake and Peninsula Borough",2,33,18,12,6
050,02,164,"Alaska","Lake and Peninsula Borough",2,34,13,8,5
050,02,164,"Alaska","Lake and Peninsula Borough",2,35,20,11,9
050,02,164,"Alaska","Lake and Peninsula Borough",2,36,18,8,10
050,02,164,"Alaska","Lake and Peninsula Borough",2,37,20,8,12
050,02,164,"Alaska","Lake and Peninsula Borough",2,38,18,8,10
050,02,164,"Alaska","Lake and Peninsula Borough",2,39,18,10,8
050,02,164,"Alaska","Lake and Peninsula Borough",2,40,20,10,10
050,02,164,"Alaska","Lake and Peninsula Borough",2,41,21,13,8
050,02,164,"Alaska","Lake and Peninsula Borough",2,42,17,12,5
050,02,164,"Alaska","Lake and Peninsula Borough",2,43,20,12,8
050,02,164,"Alaska","Lake and Peninsula Borough",2,44,18,10,8
050,02,164,"Alaska","Lake and Peninsula Borough",2,45,18,8,10
050,02,164,"Alaska","Lake and Peninsula Borough",2,46,17,11,6
050,02,164,"Alaska","Lake and Peninsula Borough",2,47,17,9,8
050,02,164,"Alaska","Lake and Peninsula Borough",2,48,12,5,7
050,02,164,"Alaska","Lake and Peninsula Borough",2,49,13,4,9
050,02,164,"Alaska","Lake and Peninsula Borough",2,50,18,9,9
050,02,164,"Alaska","Lake and Peninsula Borough",2,51,13,7,6
050,02,164,"Alaska","Lake and Peninsula Borough",2,52,18,12,6
050,02,164,"Alaska","Lake and Peninsula Borough",2,53,21,11,10
050,02,164,"Alaska","Lake and Peninsula Borough",2,54,23,12,11
050,02,164,"Alaska","Lake and Peninsula Borough",2,55,16,9,7
050,02,164,"Alaska","Lake and Peninsula Borough",2,56,18,12,6
050,02,164,"Alaska","Lake and Peninsula Borough",2,57,19,12,7
050,02,164,"Alaska","Lake and Peninsula Borough",2,58,20,12,8
050,02,164,"Alaska","Lake and Peninsula Borough",2,59,22,10,12
050,02,164,"Alaska","Lake and Peninsula Borough",2,60,23,11,12
050,02,164,"Alaska","Lake and Peninsula Borough",2,61,22,12,10
050,02,164,"Alaska","Lake and Peninsula Borough",2,62,16,10,6
050,02,164,"Alaska","Lake and Peninsula Borough",2,63,17,7,10
050,02,164,"Alaska","Lake and Peninsula Borough",2,64,20,11,9
050,02,164,"Alaska","Lake and Peninsula Borough",2,65,16,10,6
050,02,164,"Alaska","Lake and Peninsula Borough",2,66,11,6,5
050,02,164,"Alaska","Lake and Peninsula Borough",2,67,12,5,7
050,02,164,"Alaska","Lake and Peninsula Borough",2,68,11,5,6
050,02,164,"Alaska","Lake and Peninsula Borough",2,69,12,6,6
050,02,164,"Alaska","Lake and Peninsula Borough",2,70,15,7,8
050,02,164,"Alaska","Lake and Peninsula Borough",2,71,11,6,5
050,02,164,"Alaska","Lake and Peninsula Borough",2,72,10,5,5
050,02,164,"Alaska","Lake and Peninsula Borough",2,73,10,6,4
050,02,164,"Alaska","Lake and Peninsula Borough",2,74,6,4,2
050,02,164,"Alaska","Lake and Peninsula Borough",2,75,5,4,1
050,02,164,"Alaska","Lake and Peninsula Borough",2,76,7,3,4
050,02,164,"Alaska","Lake and Peninsula Borough",2,77,4,1,3
050,02,164,"Alaska","Lake and Peninsula Borough",2,78,4,2,2
050,02,164,"Alaska","Lake and Peninsula Borough",2,79,2,0,2
050,02,164,"Alaska","Lake and Peninsula Borough",2,80,4,1,3
050,02,164,"Alaska","Lake and Peninsula Borough",2,81,4,2,2
050,02,164,"Alaska","Lake and Peninsula Borough",2,82,4,1,3
050,02,164,"Alaska","Lake and Peninsula Borough",2,83,4,2,2
050,02,164,"Alaska","Lake and Peninsula Borough",2,84,4,3,1
050,02,164,"Alaska","Lake and Peninsula Borough",2,85,11,6,5
050,02,164,"Alaska","Lake and Peninsula Borough",3,0,26,13,13
050,02,164,"Alaska","Lake and Peninsula Borough",3,1,24,15,9
050,02,164,"Alaska","Lake and Peninsula Borough",3,2,18,12,6
050,02,164,"Alaska","Lake and Peninsula Borough",3,3,32,16,16
050,02,164,"Alaska","Lake and Peninsula Borough",3,4,28,14,14
050,02,164,"Alaska","Lake and Peninsula Borough",3,5,25,15,10
050,02,164,"Alaska","Lake and Peninsula Borough",3,6,23,13,10
050,02,164,"Alaska","Lake and Peninsula Borough",3,7,17,9,8
050,02,164,"Alaska","Lake and Peninsula Borough",3,8,19,7,12
050,02,164,"Alaska","Lake and Peninsula Borough",3,9,21,7,14
050,02,164,"Alaska","Lake and Peninsula Borough",3,10,20,9,11
050,02,164,"Alaska","Lake and Peninsula Borough",3,11,25,10,15
050,02,164,"Alaska","Lake and Peninsula Borough",3,12,25,13,12
050,02,164,"Alaska","Lake and Peninsula Borough",3,13,20,9,11
050,02,164,"Alaska","Lake and Peninsula Borough",3,14,23,10,13
050,02,164,"Alaska","Lake and Peninsula Borough",3,15,17,7,10
050,02,164,"Alaska","Lake and Peninsula Borough",3,16,23,10,13
050,02,164,"Alaska","Lake and Peninsula Borough",3,17,26,10,16
050,02,164,"Alaska","Lake and Peninsula Borough",3,18,20,10,10
050,02,164,"Alaska","Lake and Peninsula Borough",3,19,13,9,4
050,02,164,"Alaska","Lake and Peninsula Borough",3,20,18,11,7
050,02,164,"Alaska","Lake and Peninsula Borough",3,21,16,6,10
050,02,164,"Alaska","Lake and Peninsula Borough",3,22,16,7,9
050,02,164,"Alaska","Lake and Peninsula Borough",3,23,16,6,10
050,02,164,"Alaska","Lake and Peninsula Borough",3,24,15,7,8
050,02,164,"Alaska","Lake and Peninsula Borough",3,25,13,6,7
050,02,164,"Alaska","Lake and Peninsula Borough",3,26,21,10,11
050,02,164,"Alaska","Lake and Peninsula Borough",3,27,22,10,12
050,02,164,"Alaska","Lake and Peninsula Borough",3,28,15,6,9
050,02,164,"Alaska","Lake and Peninsula Borough",3,29,19,8,11
050,02,164,"Alaska","Lake and Peninsula Borough",3,30,19,11,8
050,02,164,"Alaska","Lake and Peninsula Borough",3,31,16,7,9
050,02,164,"Alaska","Lake and Peninsula Borough",3,32,22,11,11
050,02,164,"Alaska","Lake and Peninsula Borough",3,33,19,11,8
050,02,164,"Alaska","Lake and Peninsula Borough",3,34,16,10,6
050,02,164,"Alaska","Lake and Peninsula Borough",3,35,13,8,5
050,02,164,"Alaska","Lake and Peninsula Borough",3,36,21,11,10
050,02,164,"Alaska","Lake and Peninsula Borough",3,37,16,7,9
050,02,164,"Alaska","Lake and Peninsula Borough",3,38,21,8,13
050,02,164,"Alaska","Lake and Peninsula Borough",3,39,19,9,10
050,02,164,"Alaska","Lake and Peninsula Borough",3,40,12,6,6
050,02,164,"Alaska","Lake and Peninsula Borough",3,41,20,12,8
050,02,164,"Alaska","Lake and Peninsula Borough",3,42,20,12,8
050,02,164,"Alaska","Lake and Peninsula Borough",3,43,17,11,6
050,02,164,"Alaska","Lake and Peninsula Borough",3,44,20,12,8
050,02,164,"Alaska","Lake and Peninsula Borough",3,45,16,10,6
050,02,164,"Alaska","Lake and Peninsula Borough",3,46,22,12,10
050,02,164,"Alaska","Lake and Peninsula Borough",3,47,16,10,6
050,02,164,"Alaska","Lake and Peninsula Borough",3,48,16,7,9
050,02,164,"Alaska","Lake and Peninsula Borough",3,49,14,6,8
050,02,164,"Alaska","Lake and Peninsula Borough",3,50,11,4,7
050,02,164,"Alaska","Lake and Peninsula Borough",3,51,19,11,8
050,02,164,"Alaska","Lake and Peninsula Borough",3,52,11,5,6
050,02,164,"Alaska","Lake and Peninsula Borough",3,53,13,8,5
050,02,164,"Alaska","Lake and Peninsula Borough",3,54,23,13,10
050,02,164,"Alaska","Lake and Peninsula Borough",3,55,20,11,9
050,02,164,"Alaska","Lake and Peninsula Borough",3,56,18,11,7
050,02,164,"Alaska","Lake and Peninsula Borough",3,57,17,10,7
050,02,164,"Alaska","Lake and Peninsula Borough",3,58,20,13,7
050,02,164,"Alaska","Lake and Peninsula Borough",3,59,18,10,8
050,02,164,"Alaska","Lake and Peninsula Borough",3,60,22,10,12
050,02,164,"Alaska","Lake and Peninsula Borough",3,61,23,10,13
050,02,164,"Alaska","Lake and Peninsula Borough",3,62,22,12,10
050,02,164,"Alaska","Lake and Peninsula Borough",3,63,15,10,5
050,02,164,"Alaska","Lake and Peninsula Borough",3,64,19,9,10
050,02,164,"Alaska","Lake and Peninsula Borough",3,65,20,12,8
050,02,164,"Alaska","Lake and Peninsula Borough",3,66,15,9,6
050,02,164,"Alaska","Lake and Peninsula Borough",3,67,13,7,6
050,02,164,"Alaska","Lake and Peninsula Borough",3,68,12,5,7
050,02,164,"Alaska","Lake and Peninsula Borough",3,69,12,6,6
050,02,164,"Alaska","Lake and Peninsula Borough",3,70,10,4,6
050,02,164,"Alaska","Lake and Peninsula Borough",3,71,15,7,8
050,02,164,"Alaska","Lake and Peninsula Borough",3,72,10,5,5
050,02,164,"Alaska","Lake and Peninsula Borough",3,73,8,4,4
050,02,164,"Alaska","Lake and Peninsula Borough",3,74,10,6,4
050,02,164,"Alaska","Lake and Peninsula Borough",3,75,5,3,2
050,02,164,"Alaska","Lake and Peninsula Borough",3,76,5,4,1
050,02,164,"Alaska","Lake and Peninsula Borough",3,77,7,3,4
050,02,164,"Alaska","Lake and Peninsula Borough",3,78,4,1,3
050,02,164,"Alaska","Lake and Peninsula Borough",3,79,4,2,2
050,02,164,"Alaska","Lake and Peninsula Borough",3,80,1,0,1
050,02,164,"Alaska","Lake and Peninsula Borough",3,81,4,1,3
050,02,164,"Alaska","Lake and Peninsula Borough",3,82,3,1,2
050,02,164,"Alaska","Lake and Peninsula Borough",3,83,3,1,2
050,02,164,"Alaska","Lake and Peninsula Borough",3,84,4,2,2
050,02,164,"Alaska","Lake and Peninsula Borough",3,85,12,6,6
050,02,164,"Alaska","Lake and Peninsula Borough",4,0,18,2,16
050,02,164,"Alaska","Lake and Peninsula Borough",4,1,18,13,5
050,02,164,"Alaska","Lake and Peninsula Borough",4,2,26,16,10
050,02,164,"Alaska","Lake and Peninsula Borough",4,3,16,9,7
050,02,164,"Alaska","Lake and Peninsula Borough",4,4,33,18,15
050,02,164,"Alaska","Lake and Peninsula Borough",4,5,27,14,13
050,02,164,"Alaska","Lake and Peninsula Borough",4,6,26,15,11
050,02,164,"Alaska","Lake and Peninsula Borough",4,7,23,13,10
050,02,164,"Alaska","Lake and Peninsula Borough",4,8,16,9,7
050,02,164,"Alaska","Lake and Peninsula Borough",4,9,20,8,12
050,02,164,"Alaska","Lake and Peninsula Borough",4,10,20,6,14
050,02,164,"Alaska","Lake and Peninsula Borough",4,11,21,9,12
050,02,164,"Alaska","Lake and Peninsula Borough",4,12,24,10,14
050,02,164,"Alaska","Lake and Peninsula Borough",4,13,24,13,11
050,02,164,"Alaska","Lake and Peninsula Borough",4,14,19,8,11
050,02,164,"Alaska","Lake and Peninsula Borough",4,15,23,11,12
050,02,164,"Alaska","Lake and Peninsula Borough",4,16,18,8,10
050,02,164,"Alaska","Lake and Peninsula Borough",4,17,22,10,12
050,02,164,"Alaska","Lake and Peninsula Borough",4,18,23,9,14
050,02,164,"Alaska","Lake and Peninsula Borough",4,19,17,9,8
050,02,164,"Alaska","Lake and Peninsula Borough",4,20,11,7,4
050,02,164,"Alaska","Lake and Peninsula Borough",4,21,18,10,8
050,02,164,"Alaska","Lake and Peninsula Borough",4,22,10,5,5
050,02,164,"Alaska","Lake and Peninsula Borough",4,23,15,7,8
050,02,164,"Alaska","Lake and Peninsula Borough",4,24,13,5,8
050,02,164,"Alaska","Lake and Peninsula Borough",4,25,13,7,6
050,02,164,"Alaska","Lake and Peninsula Borough",4,26,13,7,6
050,02,164,"Alaska","Lake and Peninsula Borough",4,27,20,9,11
050,02,164,"Alaska","Lake and Peninsula Borough",4,28,22,9,13
050,02,164,"Alaska","Lake and Peninsula Borough",4,29,10,4,6
050,02,164,"Alaska","Lake and Peninsula Borough",4,30,17,7,10
050,02,164,"Alaska","Lake and Peninsula Borough",4,31,17,9,8
050,02,164,"Alaska","Lake and Peninsula Borough",4,32,19,8,11
050,02,164,"Alaska","Lake and Peninsula Borough",4,33,23,12,11
050,02,164,"Alaska","Lake and Peninsula Borough",4,34,16,8,8
050,02,164,"Alaska","Lake and Peninsula Borough",4,35,20,13,7
050,02,164,"Alaska","Lake and Peninsula Borough",4,36,12,8,4
050,02,164,"Alaska","Lake and Peninsula Borough",4,37,17,9,8
050,02,164,"Alaska","Lake and Peninsula Borough",4,38,18,9,9
050,02,164,"Alaska","Lake and Peninsula Borough",4,39,19,8,11
050,02,164,"Alaska","Lake and Peninsula Borough",4,40,16,5,11
050,02,164,"Alaska","Lake and Peninsula Borough",4,41,14,8,6
050,02,164,"Alaska","Lake and Peninsula Borough",4,42,16,9,7
050,02,164,"Alaska","Lake and Peninsula Borough",4,43,20,12,8
050,02,164,"Alaska","Lake and Peninsula Borough",4,44,17,11,6
050,02,164,"Alaska","Lake and Peninsula Borough",4,45,19,11,8
050,02,164,"Alaska","Lake and Peninsula Borough",4,46,19,13,6
050,02,164,"Alaska","Lake and Peninsula Borough",4,47,22,11,11
050,02,164,"Alaska","Lake and Peninsula Borough",4,48,15,9,6
050,02,164,"Alaska","Lake and Peninsula Borough",4,49,15,6,9
050,02,164,"Alaska","Lake and Peninsula Borough",4,50,15,7,8
050,02,164,"Alaska","Lake and Peninsula Borough",4,51,12,5,7
050,02,164,"Alaska","Lake and Peninsula Borough",4,52,19,11,8
050,02,164,"Alaska","Lake and Peninsula Borough",4,53,9,3,6
050,02,164,"Alaska","Lake and Peninsula Borough",4,54,14,9,5
050,02,164,"Alaska","Lake and Peninsula Borough",4,55,18,10,8
050,02,164,"Alaska","Lake and Peninsula Borough",4,56,17,10,7
050,02,164,"Alaska","Lake and Peninsula Borough",4,57,17,10,7
050,02,164,"Alaska","Lake and Peninsula Borough",4,58,17,10,7
050,02,164,"Alaska","Lake and Peninsula Borough",4,59,19,12,7
050,02,164,"Alaska","Lake and Peninsula Borough",4,60,18,10,8
050,02,164,"Alaska","Lake and Peninsula Borough",4,61,20,10,10
050,02,164,"Alaska","Lake and Peninsula Borough",4,62,22,9,13
050,02,164,"Alaska","Lake and Peninsula Borough",4,63,23,13,10
050,02,164,"Alaska","Lake and Peninsula Borough",4,64,15,10,5
050,02,164,"Alaska","Lake and Peninsula Borough",4,65,16,8,8
050,02,164,"Alaska","Lake and Peninsula Borough",4,66,16,9,7
050,02,164,"Alaska","Lake and Peninsula Borough",4,67,16,11,5
050,02,164,"Alaska","Lake and Peninsula Borough",4,68,13,6,7
050,02,164,"Alaska","Lake and Peninsula Borough",4,69,13,6,7
050,02,164,"Alaska","Lake and Peninsula Borough",4,70,11,5,6
050,02,164,"Alaska","Lake and Peninsula Borough",4,71,11,5,6
050,02,164,"Alaska","Lake and Peninsula Borough",4,72,14,6,8
050,02,164,"Alaska","Lake and Peninsula Borough",4,73,10,5,5
050,02,164,"Alaska","Lake and Peninsula Borough",4,74,8,4,4
050,02,164,"Alaska","Lake and Peninsula Borough",4,75,10,6,4
050,02,164,"Alaska","Lake and Peninsula Borough",4,76,5,3,2
050,02,164,"Alaska","Lake and Peninsula Borough",4,77,6,4,2
050,02,164,"Alaska","Lake and Peninsula Borough",4,78,7,3,4
050,02,164,"Alaska","Lake and Peninsula Borough",4,79,4,1,3
050,02,164,"Alaska","Lake and Peninsula Borough",4,80,4,2,2
050,02,164,"Alaska","Lake and Peninsula Borough",4,81,1,0,1
050,02,164,"Alaska","Lake and Peninsula Borough",4,82,4,1,3
050,02,164,"Alaska","Lake and Peninsula Borough",4,83,3,1,2
050,02,164,"Alaska","Lake and Peninsula Borough",4,84,3,1,2
050,02,164,"Alaska","Lake and Peninsula Borough",4,85,17,10,7
050,02,164,"Alaska","Lake and Peninsula Borough",5,0,16,4,12
050,02,164,"Alaska","Lake and Peninsula Borough",5,1,18,2,16
050,02,164,"Alaska","Lake and Peninsula Borough",5,2,16,11,5
050,02,164,"Alaska","Lake and Peninsula Borough",5,3,26,16,10
050,02,164,"Alaska","Lake and Peninsula Borough",5,4,13,7,6
050,02,164,"Alaska","Lake and Peninsula Borough",5,5,31,18,13
050,02,164,"Alaska","Lake and Peninsula Borough",5,6,25,11,14
050,02,164,"Alaska","Lake and Peninsula Borough",5,7,25,14,11
050,02,164,"Alaska","Lake and Peninsula Borough",5,8,24,13,11
050,02,164,"Alaska","Lake and Peninsula Borough",5,9,18,11,7
050,02,164,"Alaska","Lake and Peninsula Borough",5,10,14,5,9
050,02,164,"Alaska","Lake and Peninsula Borough",5,11,21,7,14
050,02,164,"Alaska","Lake and Peninsula Borough",5,12,18,6,12
050,02,164,"Alaska","Lake and Peninsula Borough",5,13,23,9,14
050,02,164,"Alaska","Lake and Peninsula Borough",5,14,24,13,11
050,02,164,"Alaska","Lake and Peninsula Borough",5,15,18,7,11
050,02,164,"Alaska","Lake and Peninsula Borough",5,16,23,11,12
050,02,164,"Alaska","Lake and Peninsula Borough",5,17,14,7,7
050,02,164,"Alaska","Lake and Peninsula Borough",5,18,20,10,10
050,02,164,"Alaska","Lake and Peninsula Borough",5,19,22,8,14
050,02,164,"Alaska","Lake and Peninsula Borough",5,20,14,9,5
050,02,164,"Alaska","Lake and Peninsula Borough",5,21,12,7,5
050,02,164,"Alaska","Lake and Peninsula Borough",5,22,13,5,8
050,02,164,"Alaska","Lake and Peninsula Borough",5,23,7,5,2
050,02,164,"Alaska","Lake and Peninsula Borough",5,24,14,7,7
050,02,164,"Alaska","Lake and Peninsula Borough",5,25,11,4,7
050,02,164,"Alaska","Lake and Peninsula Borough",5,26,14,8,6
050,02,164,"Alaska","Lake and Peninsula Borough",5,27,13,7,6
050,02,164,"Alaska","Lake and Peninsula Borough",5,28,21,10,11
050,02,164,"Alaska","Lake and Peninsula Borough",5,29,19,7,12
050,02,164,"Alaska","Lake and Peninsula Borough",5,30,12,5,7
050,02,164,"Alaska","Lake and Peninsula Borough",5,31,16,8,8
050,02,164,"Alaska","Lake and Peninsula Borough",5,32,18,10,8
050,02,164,"Alaska","Lake and Peninsula Borough",5,33,19,8,11
050,02,164,"Alaska","Lake and Peninsula Borough",5,34,18,8,10
050,02,164,"Alaska","Lake and Peninsula Borough",5,35,20,12,8
050,02,164,"Alaska","Lake and Peninsula Borough",5,36,16,10,6
050,02,164,"Alaska","Lake and Peninsula Borough",5,37,13,9,4
050,02,164,"Alaska","Lake and Peninsula Borough",5,38,14,7,7
050,02,164,"Alaska","Lake and Peninsula Borough",5,39,21,11,10
050,02,164,"Alaska","Lake and Peninsula Borough",5,40,18,6,12
050,02,164,"Alaska","Lake and Peninsula Borough",5,41,19,6,13
050,02,164,"Alaska","Lake and Peninsula Borough",5,42,13,7,6
050,02,164,"Alaska","Lake and Peninsula Borough",5,43,18,11,7
050,02,164,"Alaska","Lake and Peninsula Borough",5,44,18,10,8
050,02,164,"Alaska","Lake and Peninsula Borough",5,45,14,10,4
050,02,164,"Alaska","Lake and Peninsula Borough",5,46,22,14,8
050,02,164,"Alaska","Lake and Peninsula Borough",5,47,18,12,6
050,02,164,"Alaska","Lake and Peninsula Borough",5,48,23,11,12
050,02,164,"Alaska","Lake and Peninsula Borough",5,49,14,8,6
050,02,164,"Alaska","Lake and Peninsula Borough",5,50,16,7,9
050,02,164,"Alaska","Lake and Peninsula Borough",5,51,15,7,8
050,02,164,"Alaska","Lake and Peninsula Borough",5,52,12,5,7
050,02,164,"Alaska","Lake and Peninsula Borough",5,53,14,6,8
050,02,164,"Alaska","Lake and Peninsula Borough",5,54,10,4,6
050,02,164,"Alaska","Lake and Peninsula Borough",5,55,13,8,5
050,02,164,"Alaska","Lake and Peninsula Borough",5,56,21,13,8
050,02,164,"Alaska","Lake and Peninsula Borough",5,57,16,9,7
050,02,164,"Alaska","Lake and Peninsula Borough",5,58,17,10,7
050,02,164,"Alaska","Lake and Peninsula Borough",5,59,16,9,7
050,02,164,"Alaska","Lake and Peninsula Borough",5,60,19,12,7
050,02,164,"Alaska","Lake and Peninsula Borough",5,61,18,10,8
050,02,164,"Alaska","Lake and Peninsula Borough",5,62,20,10,10
050,02,164,"Alaska","Lake and Peninsula Borough",5,63,18,8,10
050,02,164,"Alaska","Lake and Peninsula Borough",5,64,22,13,9
050,02,164,"Alaska","Lake and Peninsula Borough",5,65,14,10,4
050,02,164,"Alaska","Lake and Peninsula Borough",5,66,14,6,8
050,02,164,"Alaska","Lake and Peninsula Borough",5,67,15,8,7
050,02,164,"Alaska","Lake and Peninsula Borough",5,68,15,10,5
050,02,164,"Alaska","Lake and Peninsula Borough",5,69,14,7,7
050,02,164,"Alaska","Lake and Peninsula Borough",5,70,12,5,7
050,02,164,"Alaska","Lake and Peninsula Borough",5,71,10,5,5
050,02,164,"Alaska","Lake and Peninsula Borough",5,72,10,4,6
050,02,164,"Alaska","Lake and Peninsula Borough",5,73,10,4,6
050,02,164,"Alaska","Lake and Peninsula Borough",5,74,11,5,6
050,02,164,"Alaska","Lake and Peninsula Borough",5,75,8,4,4
050,02,164,"Alaska","Lake and Peninsula Borough",5,76,10,6,4
050,02,164,"Alaska","Lake and Peninsula Borough",5,77,5,3,2
050,02,164,"Alaska","Lake and Peninsula Borough",5,78,6,4,2
050,02,164,"Alaska","Lake and Peninsula Borough",5,79,7,3,4
050,02,164,"Alaska","Lake and Peninsula Borough",5,80,4,1,3
050,02,164,"Alaska","Lake and Peninsula Borough",5,81,4,2,2
050,02,164,"Alaska","Lake and Peninsula Borough",5,82,1,0,1
050,02,164,"Alaska","Lake and Peninsula Borough",5,83,3,1,2
050,02,164,"Alaska","Lake and Peninsula Borough",5,84,2,0,2
050,02,164,"Alaska","Lake and Peninsula Borough",5,85,18,9,9
050,02,170,"Alaska","Matanuska-Susitna Borough",1,0,1306,672,634
050,02,170,"Alaska","Matanuska-Susitna Borough",1,1,1348,713,635
050,02,170,"Alaska","Matanuska-Susitna Borough",1,2,1362,696,666
050,02,170,"Alaska","Matanuska-Susitna Borough",1,3,1431,722,709
050,02,170,"Alaska","Matanuska-Susitna Borough",1,4,1569,815,754
050,02,170,"Alaska","Matanuska-Susitna Borough",1,5,1528,781,747
050,02,170,"Alaska","Matanuska-Susitna Borough",1,6,1536,777,759
050,02,170,"Alaska","Matanuska-Susitna Borough",1,7,1546,767,779
050,02,170,"Alaska","Matanuska-Susitna Borough",1,8,1606,833,773
050,02,170,"Alaska","Matanuska-Susitna Borough",1,9,1580,817,763
050,02,170,"Alaska","Matanuska-Susitna Borough",1,10,1709,897,812
050,02,170,"Alaska","Matanuska-Susitna Borough",1,11,1669,873,796
050,02,170,"Alaska","Matanuska-Susitna Borough",1,12,1715,879,836
050,02,170,"Alaska","Matanuska-Susitna Borough",1,13,1727,908,819
050,02,170,"Alaska","Matanuska-Susitna Borough",1,14,1727,912,815
050,02,170,"Alaska","Matanuska-Susitna Borough",1,15,1691,877,814
050,02,170,"Alaska","Matanuska-Susitna Borough",1,16,1661,854,807
050,02,170,"Alaska","Matanuska-Susitna Borough",1,17,1575,832,743
050,02,170,"Alaska","Matanuska-Susitna Borough",1,18,1336,707,629
050,02,170,"Alaska","Matanuska-Susitna Borough",1,19,1090,592,498
050,02,170,"Alaska","Matanuska-Susitna Borough",1,20,1176,667,509
050,02,170,"Alaska","Matanuska-Susitna Borough",1,21,1099,598,501
050,02,170,"Alaska","Matanuska-Susitna Borough",1,22,1133,618,515
050,02,170,"Alaska","Matanuska-Susitna Borough",1,23,1230,684,546
050,02,170,"Alaska","Matanuska-Susitna Borough",1,24,1289,731,558
050,02,170,"Alaska","Matanuska-Susitna Borough",1,25,1264,674,590
050,02,170,"Alaska","Matanuska-Susitna Borough",1,26,1363,708,655
050,02,170,"Alaska","Matanuska-Susitna Borough",1,27,1459,763,696
050,02,170,"Alaska","Matanuska-Susitna Borough",1,28,1510,792,718
050,02,170,"Alaska","Matanuska-Susitna Borough",1,29,1602,871,731
050,02,170,"Alaska","Matanuska-Susitna Borough",1,30,1529,824,705
050,02,170,"Alaska","Matanuska-Susitna Borough",1,31,1554,868,686
050,02,170,"Alaska","Matanuska-Susitna Borough",1,32,1532,782,750
050,02,170,"Alaska","Matanuska-Susitna Borough",1,33,1532,785,747
050,02,170,"Alaska","Matanuska-Susitna Borough",1,34,1600,812,788
050,02,170,"Alaska","Matanuska-Susitna Borough",1,35,1567,799,768
050,02,170,"Alaska","Matanuska-Susitna Borough",1,36,1596,843,753
050,02,170,"Alaska","Matanuska-Susitna Borough",1,37,1662,866,796
050,02,170,"Alaska","Matanuska-Susitna Borough",1,38,1569,798,771
050,02,170,"Alaska","Matanuska-Susitna Borough",1,39,1573,823,750
050,02,170,"Alaska","Matanuska-Susitna Borough",1,40,1471,781,690
050,02,170,"Alaska","Matanuska-Susitna Borough",1,41,1371,719,652
050,02,170,"Alaska","Matanuska-Susitna Borough",1,42,1396,740,656
050,02,170,"Alaska","Matanuska-Susitna Borough",1,43,1387,731,656
050,02,170,"Alaska","Matanuska-Susitna Borough",1,44,1270,694,576
050,02,170,"Alaska","Matanuska-Susitna Borough",1,45,1296,705,591
050,02,170,"Alaska","Matanuska-Susitna Borough",1,46,1258,660,598
050,02,170,"Alaska","Matanuska-Susitna Borough",1,47,1272,685,587
050,02,170,"Alaska","Matanuska-Susitna Borough",1,48,1305,707,598
050,02,170,"Alaska","Matanuska-Susitna Borough",1,49,1385,721,664
050,02,170,"Alaska","Matanuska-Susitna Borough",1,50,1303,678,625
050,02,170,"Alaska","Matanuska-Susitna Borough",1,51,1257,684,573
050,02,170,"Alaska","Matanuska-Susitna Borough",1,52,1217,643,574
050,02,170,"Alaska","Matanuska-Susitna Borough",1,53,1232,613,619
050,02,170,"Alaska","Matanuska-Susitna Borough",1,54,1334,701,633
050,02,170,"Alaska","Matanuska-Susitna Borough",1,55,1380,733,647
050,02,170,"Alaska","Matanuska-Susitna Borough",1,56,1384,744,640
050,02,170,"Alaska","Matanuska-Susitna Borough",1,57,1425,768,657
050,02,170,"Alaska","Matanuska-Susitna Borough",1,58,1483,764,719
050,02,170,"Alaska","Matanuska-Susitna Borough",1,59,1476,771,705
050,02,170,"Alaska","Matanuska-Susitna Borough",1,60,1408,728,680
050,02,170,"Alaska","Matanuska-Susitna Borough",1,61,1441,755,686
050,02,170,"Alaska","Matanuska-Susitna Borough",1,62,1430,747,683
050,02,170,"Alaska","Matanuska-Susitna Borough",1,63,1370,717,653
050,02,170,"Alaska","Matanuska-Susitna Borough",1,64,1303,651,652
050,02,170,"Alaska","Matanuska-Susitna Borough",1,65,1285,669,616
050,02,170,"Alaska","Matanuska-Susitna Borough",1,66,1223,650,573
050,02,170,"Alaska","Matanuska-Susitna Borough",1,67,1155,572,583
050,02,170,"Alaska","Matanuska-Susitna Borough",1,68,1131,574,557
050,02,170,"Alaska","Matanuska-Susitna Borough",1,69,990,490,500
050,02,170,"Alaska","Matanuska-Susitna Borough",1,70,893,448,445
050,02,170,"Alaska","Matanuska-Susitna Borough",1,71,820,427,393
050,02,170,"Alaska","Matanuska-Susitna Borough",1,72,793,397,396
050,02,170,"Alaska","Matanuska-Susitna Borough",1,73,736,371,365
050,02,170,"Alaska","Matanuska-Susitna Borough",1,74,484,227,257
050,02,170,"Alaska","Matanuska-Susitna Borough",1,75,490,227,263
050,02,170,"Alaska","Matanuska-Susitna Borough",1,76,483,238,245
050,02,170,"Alaska","Matanuska-Susitna Borough",1,77,477,265,212
050,02,170,"Alaska","Matanuska-Susitna Borough",1,78,409,209,200
050,02,170,"Alaska","Matanuska-Susitna Borough",1,79,339,169,170
050,02,170,"Alaska","Matanuska-Susitna Borough",1,80,298,152,146
050,02,170,"Alaska","Matanuska-Susitna Borough",1,81,263,134,129
050,02,170,"Alaska","Matanuska-Susitna Borough",1,82,212,103,109
050,02,170,"Alaska","Matanuska-Susitna Borough",1,83,184,80,104
050,02,170,"Alaska","Matanuska-Susitna Borough",1,84,156,71,85
050,02,170,"Alaska","Matanuska-Susitna Borough",1,85,842,370,472
050,02,170,"Alaska","Matanuska-Susitna Borough",2,0,1323,695,628
050,02,170,"Alaska","Matanuska-Susitna Borough",2,1,1342,705,637
050,02,170,"Alaska","Matanuska-Susitna Borough",2,2,1370,703,667
050,02,170,"Alaska","Matanuska-Susitna Borough",2,3,1416,718,698
050,02,170,"Alaska","Matanuska-Susitna Borough",2,4,1544,797,747
050,02,170,"Alaska","Matanuska-Susitna Borough",2,5,1540,790,750
050,02,170,"Alaska","Matanuska-Susitna Borough",2,6,1542,782,760
050,02,170,"Alaska","Matanuska-Susitna Borough",2,7,1550,774,776
050,02,170,"Alaska","Matanuska-Susitna Borough",2,8,1585,810,775
050,02,170,"Alaska","Matanuska-Susitna Borough",2,9,1594,825,769
050,02,170,"Alaska","Matanuska-Susitna Borough",2,10,1688,880,808
050,02,170,"Alaska","Matanuska-Susitna Borough",2,11,1690,884,806
050,02,170,"Alaska","Matanuska-Susitna Borough",2,12,1722,891,831
050,02,170,"Alaska","Matanuska-Susitna Borough",2,13,1726,906,820
050,02,170,"Alaska","Matanuska-Susitna Borough",2,14,1727,912,815
050,02,170,"Alaska","Matanuska-Susitna Borough",2,15,1705,888,817
050,02,170,"Alaska","Matanuska-Susitna Borough",2,16,1681,866,815
050,02,170,"Alaska","Matanuska-Susitna Borough",2,17,1600,840,760
050,02,170,"Alaska","Matanuska-Susitna Borough",2,18,1328,710,618
050,02,170,"Alaska","Matanuska-Susitna Borough",2,19,1103,598,505
050,02,170,"Alaska","Matanuska-Susitna Borough",2,20,1181,662,519
050,02,170,"Alaska","Matanuska-Susitna Borough",2,21,1120,614,506
050,02,170,"Alaska","Matanuska-Susitna Borough",2,22,1132,620,512
050,02,170,"Alaska","Matanuska-Susitna Borough",2,23,1225,672,553
050,02,170,"Alaska","Matanuska-Susitna Borough",2,24,1285,724,561
050,02,170,"Alaska","Matanuska-Susitna Borough",2,25,1273,683,590
050,02,170,"Alaska","Matanuska-Susitna Borough",2,26,1355,709,646
050,02,170,"Alaska","Matanuska-Susitna Borough",2,27,1442,754,688
050,02,170,"Alaska","Matanuska-Susitna Borough",2,28,1506,790,716
050,02,170,"Alaska","Matanuska-Susitna Borough",2,29,1591,858,733
050,02,170,"Alaska","Matanuska-Susitna Borough",2,30,1555,840,715
050,02,170,"Alaska","Matanuska-Susitna Borough",2,31,1556,861,695
050,02,170,"Alaska","Matanuska-Susitna Borough",2,32,1526,789,737
050,02,170,"Alaska","Matanuska-Susitna Borough",2,33,1542,789,753
050,02,170,"Alaska","Matanuska-Susitna Borough",2,34,1582,801,781
050,02,170,"Alaska","Matanuska-Susitna Borough",2,35,1597,819,778
050,02,170,"Alaska","Matanuska-Susitna Borough",2,36,1590,834,756
050,02,170,"Alaska","Matanuska-Susitna Borough",2,37,1665,869,796
050,02,170,"Alaska","Matanuska-Susitna Borough",2,38,1605,822,783
050,02,170,"Alaska","Matanuska-Susitna Borough",2,39,1580,826,754
050,02,170,"Alaska","Matanuska-Susitna Borough",2,40,1512,795,717
050,02,170,"Alaska","Matanuska-Susitna Borough",2,41,1397,734,663
050,02,170,"Alaska","Matanuska-Susitna Borough",2,42,1386,733,653
050,02,170,"Alaska","Matanuska-Susitna Borough",2,43,1404,744,660
050,02,170,"Alaska","Matanuska-Susitna Borough",2,44,1287,696,591
050,02,170,"Alaska","Matanuska-Susitna Borough",2,45,1286,697,589
050,02,170,"Alaska","Matanuska-Susitna Borough",2,46,1271,676,595
050,02,170,"Alaska","Matanuska-Susitna Borough",2,47,1272,681,591
050,02,170,"Alaska","Matanuska-Susitna Borough",2,48,1294,702,592
050,02,170,"Alaska","Matanuska-Susitna Borough",2,49,1375,725,650
050,02,170,"Alaska","Matanuska-Susitna Borough",2,50,1321,688,633
050,02,170,"Alaska","Matanuska-Susitna Borough",2,51,1264,677,587
050,02,170,"Alaska","Matanuska-Susitna Borough",2,52,1236,657,579
050,02,170,"Alaska","Matanuska-Susitna Borough",2,53,1229,620,609
050,02,170,"Alaska","Matanuska-Susitna Borough",2,54,1304,677,627
050,02,170,"Alaska","Matanuska-Susitna Borough",2,55,1372,724,648
050,02,170,"Alaska","Matanuska-Susitna Borough",2,56,1389,743,646
050,02,170,"Alaska","Matanuska-Susitna Borough",2,57,1417,762,655
050,02,170,"Alaska","Matanuska-Susitna Borough",2,58,1469,766,703
050,02,170,"Alaska","Matanuska-Susitna Borough",2,59,1484,771,713
050,02,170,"Alaska","Matanuska-Susitna Borough",2,60,1428,742,686
050,02,170,"Alaska","Matanuska-Susitna Borough",2,61,1429,745,684
050,02,170,"Alaska","Matanuska-Susitna Borough",2,62,1429,749,680
050,02,170,"Alaska","Matanuska-Susitna Borough",2,63,1396,729,667
050,02,170,"Alaska","Matanuska-Susitna Borough",2,64,1310,660,650
050,02,170,"Alaska","Matanuska-Susitna Borough",2,65,1283,661,622
050,02,170,"Alaska","Matanuska-Susitna Borough",2,66,1234,652,582
050,02,170,"Alaska","Matanuska-Susitna Borough",2,67,1167,591,576
050,02,170,"Alaska","Matanuska-Susitna Borough",2,68,1127,566,561
050,02,170,"Alaska","Matanuska-Susitna Borough",2,69,1028,512,516
050,02,170,"Alaska","Matanuska-Susitna Borough",2,70,907,451,456
050,02,170,"Alaska","Matanuska-Susitna Borough",2,71,838,430,408
050,02,170,"Alaska","Matanuska-Susitna Borough",2,72,782,396,386
050,02,170,"Alaska","Matanuska-Susitna Borough",2,73,782,396,386
050,02,170,"Alaska","Matanuska-Susitna Borough",2,74,513,245,268
050,02,170,"Alaska","Matanuska-Susitna Borough",2,75,477,219,258
050,02,170,"Alaska","Matanuska-Susitna Borough",2,76,478,231,247
050,02,170,"Alaska","Matanuska-Susitna Borough",2,77,483,259,224
050,02,170,"Alaska","Matanuska-Susitna Borough",2,78,415,216,199
050,02,170,"Alaska","Matanuska-Susitna Borough",2,79,349,175,174
050,02,170,"Alaska","Matanuska-Susitna Borough",2,80,305,150,155
050,02,170,"Alaska","Matanuska-Susitna Borough",2,81,263,135,128
050,02,170,"Alaska","Matanuska-Susitna Borough",2,82,223,108,115
050,02,170,"Alaska","Matanuska-Susitna Borough",2,83,187,84,103
050,02,170,"Alaska","Matanuska-Susitna Borough",2,84,162,73,89
050,02,170,"Alaska","Matanuska-Susitna Borough",2,85,856,379,477
050,02,170,"Alaska","Matanuska-Susitna Borough",3,0,1310,681,629
050,02,170,"Alaska","Matanuska-Susitna Borough",3,1,1408,731,677
050,02,170,"Alaska","Matanuska-Susitna Borough",3,2,1404,730,674
050,02,170,"Alaska","Matanuska-Susitna Borough",3,3,1435,724,711
050,02,170,"Alaska","Matanuska-Susitna Borough",3,4,1477,747,730
050,02,170,"Alaska","Matanuska-Susitna Borough",3,5,1608,826,782
050,02,170,"Alaska","Matanuska-Susitna Borough",3,6,1597,823,774
050,02,170,"Alaska","Matanuska-Susitna Borough",3,7,1596,800,796
050,02,170,"Alaska","Matanuska-Susitna Borough",3,8,1611,791,820
050,02,170,"Alaska","Matanuska-Susitna Borough",3,9,1646,851,795
050,02,170,"Alaska","Matanuska-Susitna Borough",3,10,1662,859,803
050,02,170,"Alaska","Matanuska-Susitna Borough",3,11,1721,889,832
050,02,170,"Alaska","Matanuska-Susitna Borough",3,12,1723,890,833
050,02,170,"Alaska","Matanuska-Susitna Borough",3,13,1735,906,829
050,02,170,"Alaska","Matanuska-Susitna Borough",3,14,1763,900,863
050,02,170,"Alaska","Matanuska-Susitna Borough",3,15,1761,931,830
050,02,170,"Alaska","Matanuska-Susitna Borough",3,16,1736,908,828
050,02,170,"Alaska","Matanuska-Susitna Borough",3,17,1661,867,794
050,02,170,"Alaska","Matanuska-Susitna Borough",3,18,1384,756,628
050,02,170,"Alaska","Matanuska-Susitna Borough",3,19,1106,610,496
050,02,170,"Alaska","Matanuska-Susitna Borough",3,20,1235,679,556
050,02,170,"Alaska","Matanuska-Susitna Borough",3,21,1266,711,555
050,02,170,"Alaska","Matanuska-Susitna Borough",3,22,1279,714,565
050,02,170,"Alaska","Matanuska-Susitna Borough",3,23,1267,699,568
050,02,170,"Alaska","Matanuska-Susitna Borough",3,24,1340,737,603
050,02,170,"Alaska","Matanuska-Susitna Borough",3,25,1334,732,602
050,02,170,"Alaska","Matanuska-Susitna Borough",3,26,1382,748,634
050,02,170,"Alaska","Matanuska-Susitna Borough",3,27,1443,761,682
050,02,170,"Alaska","Matanuska-Susitna Borough",3,28,1535,797,738
050,02,170,"Alaska","Matanuska-Susitna Borough",3,29,1643,845,798
050,02,170,"Alaska","Matanuska-Susitna Borough",3,30,1655,893,762
050,02,170,"Alaska","Matanuska-Susitna Borough",3,31,1691,938,753
050,02,170,"Alaska","Matanuska-Susitna Borough",3,32,1606,857,749
050,02,170,"Alaska","Matanuska-Susitna Borough",3,33,1632,845,787
050,02,170,"Alaska","Matanuska-Susitna Borough",3,34,1600,810,790
050,02,170,"Alaska","Matanuska-Susitna Borough",3,35,1664,861,803
050,02,170,"Alaska","Matanuska-Susitna Borough",3,36,1692,886,806
050,02,170,"Alaska","Matanuska-Susitna Borough",3,37,1671,875,796
050,02,170,"Alaska","Matanuska-Susitna Borough",3,38,1706,901,805
050,02,170,"Alaska","Matanuska-Susitna Borough",3,39,1688,880,808
050,02,170,"Alaska","Matanuska-Susitna Borough",3,40,1597,835,762
050,02,170,"Alaska","Matanuska-Susitna Borough",3,41,1536,815,721
050,02,170,"Alaska","Matanuska-Susitna Borough",3,42,1418,740,678
050,02,170,"Alaska","Matanuska-Susitna Borough",3,43,1471,803,668
050,02,170,"Alaska","Matanuska-Susitna Borough",3,44,1404,751,653
050,02,170,"Alaska","Matanuska-Susitna Borough",3,45,1264,668,596
050,02,170,"Alaska","Matanuska-Susitna Borough",3,46,1315,724,591
050,02,170,"Alaska","Matanuska-Susitna Borough",3,47,1296,697,599
050,02,170,"Alaska","Matanuska-Susitna Borough",3,48,1287,685,602
050,02,170,"Alaska","Matanuska-Susitna Borough",3,49,1345,740,605
050,02,170,"Alaska","Matanuska-Susitna Borough",3,50,1398,734,664
050,02,170,"Alaska","Matanuska-Susitna Borough",3,51,1333,695,638
050,02,170,"Alaska","Matanuska-Susitna Borough",3,52,1287,691,596
050,02,170,"Alaska","Matanuska-Susitna Borough",3,53,1230,649,581
050,02,170,"Alaska","Matanuska-Susitna Borough",3,54,1235,626,609
050,02,170,"Alaska","Matanuska-Susitna Borough",3,55,1308,678,630
050,02,170,"Alaska","Matanuska-Susitna Borough",3,56,1395,726,669
050,02,170,"Alaska","Matanuska-Susitna Borough",3,57,1382,738,644
050,02,170,"Alaska","Matanuska-Susitna Borough",3,58,1444,769,675
050,02,170,"Alaska","Matanuska-Susitna Borough",3,59,1459,766,693
050,02,170,"Alaska","Matanuska-Susitna Borough",3,60,1484,768,716
050,02,170,"Alaska","Matanuska-Susitna Borough",3,61,1449,766,683
050,02,170,"Alaska","Matanuska-Susitna Borough",3,62,1458,757,701
050,02,170,"Alaska","Matanuska-Susitna Borough",3,63,1431,740,691
050,02,170,"Alaska","Matanuska-Susitna Borough",3,64,1387,729,658
050,02,170,"Alaska","Matanuska-Susitna Borough",3,65,1303,663,640
050,02,170,"Alaska","Matanuska-Susitna Borough",3,66,1290,667,623
050,02,170,"Alaska","Matanuska-Susitna Borough",3,67,1237,658,579
050,02,170,"Alaska","Matanuska-Susitna Borough",3,68,1163,579,584
050,02,170,"Alaska","Matanuska-Susitna Borough",3,69,1102,551,551
050,02,170,"Alaska","Matanuska-Susitna Borough",3,70,1029,510,519
050,02,170,"Alaska","Matanuska-Susitna Borough",3,71,905,447,458
050,02,170,"Alaska","Matanuska-Susitna Borough",3,72,819,415,404
050,02,170,"Alaska","Matanuska-Susitna Borough",3,73,758,378,380
050,02,170,"Alaska","Matanuska-Susitna Borough",3,74,772,385,387
050,02,170,"Alaska","Matanuska-Susitna Borough",3,75,483,226,257
050,02,170,"Alaska","Matanuska-Susitna Borough",3,76,468,212,256
050,02,170,"Alaska","Matanuska-Susitna Borough",3,77,446,211,235
050,02,170,"Alaska","Matanuska-Susitna Borough",3,78,477,248,229
050,02,170,"Alaska","Matanuska-Susitna Borough",3,79,390,211,179
050,02,170,"Alaska","Matanuska-Susitna Borough",3,80,334,161,173
050,02,170,"Alaska","Matanuska-Susitna Borough",3,81,283,136,147
050,02,170,"Alaska","Matanuska-Susitna Borough",3,82,249,134,115
050,02,170,"Alaska","Matanuska-Susitna Borough",3,83,188,84,104
050,02,170,"Alaska","Matanuska-Susitna Borough",3,84,178,77,101
050,02,170,"Alaska","Matanuska-Susitna Borough",3,85,838,362,476
050,02,170,"Alaska","Matanuska-Susitna Borough",4,0,1367,723,644
050,02,170,"Alaska","Matanuska-Susitna Borough",4,1,1384,728,656
050,02,170,"Alaska","Matanuska-Susitna Borough",4,2,1425,752,673
050,02,170,"Alaska","Matanuska-Susitna Borough",4,3,1481,769,712
050,02,170,"Alaska","Matanuska-Susitna Borough",4,4,1463,749,714
050,02,170,"Alaska","Matanuska-Susitna Borough",4,5,1541,783,758
050,02,170,"Alaska","Matanuska-Susitna Borough",4,6,1633,854,779
050,02,170,"Alaska","Matanuska-Susitna Borough",4,7,1650,869,781
050,02,170,"Alaska","Matanuska-Susitna Borough",4,8,1622,806,816
050,02,170,"Alaska","Matanuska-Susitna Borough",4,9,1678,828,850
050,02,170,"Alaska","Matanuska-Susitna Borough",4,10,1677,866,811
050,02,170,"Alaska","Matanuska-Susitna Borough",4,11,1710,869,841
050,02,170,"Alaska","Matanuska-Susitna Borough",4,12,1721,891,830
050,02,170,"Alaska","Matanuska-Susitna Borough",4,13,1766,930,836
050,02,170,"Alaska","Matanuska-Susitna Borough",4,14,1766,931,835
050,02,170,"Alaska","Matanuska-Susitna Borough",4,15,1772,923,849
050,02,170,"Alaska","Matanuska-Susitna Borough",4,16,1770,951,819
050,02,170,"Alaska","Matanuska-Susitna Borough",4,17,1726,899,827
050,02,170,"Alaska","Matanuska-Susitna Borough",4,18,1464,792,672
050,02,170,"Alaska","Matanuska-Susitna Borough",4,19,1131,624,507
050,02,170,"Alaska","Matanuska-Susitna Borough",4,20,1186,667,519
050,02,170,"Alaska","Matanuska-Susitna Borough",4,21,1269,686,583
050,02,170,"Alaska","Matanuska-Susitna Borough",4,22,1357,787,570
050,02,170,"Alaska","Matanuska-Susitna Borough",4,23,1343,761,582
050,02,170,"Alaska","Matanuska-Susitna Borough",4,24,1375,770,605
050,02,170,"Alaska","Matanuska-Susitna Borough",4,25,1305,699,606
050,02,170,"Alaska","Matanuska-Susitna Borough",4,26,1393,785,608
050,02,170,"Alaska","Matanuska-Susitna Borough",4,27,1443,795,648
050,02,170,"Alaska","Matanuska-Susitna Borough",4,28,1504,785,719
050,02,170,"Alaska","Matanuska-Susitna Borough",4,29,1634,876,758
050,02,170,"Alaska","Matanuska-Susitna Borough",4,30,1677,866,811
050,02,170,"Alaska","Matanuska-Susitna Borough",4,31,1783,993,790
050,02,170,"Alaska","Matanuska-Susitna Borough",4,32,1724,925,799
050,02,170,"Alaska","Matanuska-Susitna Borough",4,33,1692,907,785
050,02,170,"Alaska","Matanuska-Susitna Borough",4,34,1646,827,819
050,02,170,"Alaska","Matanuska-Susitna Borough",4,35,1681,857,824
050,02,170,"Alaska","Matanuska-Susitna Borough",4,36,1746,895,851
050,02,170,"Alaska","Matanuska-Susitna Borough",4,37,1771,930,841
050,02,170,"Alaska","Matanuska-Susitna Borough",4,38,1705,888,817
050,02,170,"Alaska","Matanuska-Susitna Borough",4,39,1774,950,824
050,02,170,"Alaska","Matanuska-Susitna Borough",4,40,1711,896,815
050,02,170,"Alaska","Matanuska-Susitna Borough",4,41,1610,849,761
050,02,170,"Alaska","Matanuska-Susitna Borough",4,42,1562,826,736
050,02,170,"Alaska","Matanuska-Susitna Borough",4,43,1473,778,695
050,02,170,"Alaska","Matanuska-Susitna Borough",4,44,1495,822,673
050,02,170,"Alaska","Matanuska-Susitna Borough",4,45,1401,748,653
050,02,170,"Alaska","Matanuska-Susitna Borough",4,46,1295,694,601
050,02,170,"Alaska","Matanuska-Susitna Borough",4,47,1333,734,599
050,02,170,"Alaska","Matanuska-Susitna Borough",4,48,1298,701,597
050,02,170,"Alaska","Matanuska-Susitna Borough",4,49,1326,712,614
050,02,170,"Alaska","Matanuska-Susitna Borough",4,50,1347,732,615
050,02,170,"Alaska","Matanuska-Susitna Borough",4,51,1410,740,670
050,02,170,"Alaska","Matanuska-Susitna Borough",4,52,1381,721,660
050,02,170,"Alaska","Matanuska-Susitna Borough",4,53,1279,662,617
050,02,170,"Alaska","Matanuska-Susitna Borough",4,54,1230,650,580
050,02,170,"Alaska","Matanuska-Susitna Borough",4,55,1244,647,597
050,02,170,"Alaska","Matanuska-Susitna Borough",4,56,1294,664,630
050,02,170,"Alaska","Matanuska-Susitna Borough",4,57,1378,723,655
050,02,170,"Alaska","Matanuska-Susitna Borough",4,58,1400,754,646
050,02,170,"Alaska","Matanuska-Susitna Borough",4,59,1433,764,669
050,02,170,"Alaska","Matanuska-Susitna Borough",4,60,1472,779,693
050,02,170,"Alaska","Matanuska-Susitna Borough",4,61,1462,753,709
050,02,170,"Alaska","Matanuska-Susitna Borough",4,62,1447,770,677
050,02,170,"Alaska","Matanuska-Susitna Borough",4,63,1471,757,714
050,02,170,"Alaska","Matanuska-Susitna Borough",4,64,1403,721,682
050,02,170,"Alaska","Matanuska-Susitna Borough",4,65,1372,719,653
050,02,170,"Alaska","Matanuska-Susitna Borough",4,66,1298,653,645
050,02,170,"Alaska","Matanuska-Susitna Borough",4,67,1275,662,613
050,02,170,"Alaska","Matanuska-Susitna Borough",4,68,1218,639,579
050,02,170,"Alaska","Matanuska-Susitna Borough",4,69,1153,577,576
050,02,170,"Alaska","Matanuska-Susitna Borough",4,70,1080,543,537
050,02,170,"Alaska","Matanuska-Susitna Borough",4,71,1011,492,519
050,02,170,"Alaska","Matanuska-Susitna Borough",4,72,880,425,455
050,02,170,"Alaska","Matanuska-Susitna Borough",4,73,810,404,406
050,02,170,"Alaska","Matanuska-Susitna Borough",4,74,741,364,377
050,02,170,"Alaska","Matanuska-Susitna Borough",4,75,727,356,371
050,02,170,"Alaska","Matanuska-Susitna Borough",4,76,478,225,253
050,02,170,"Alaska","Matanuska-Susitna Borough",4,77,428,183,245
050,02,170,"Alaska","Matanuska-Susitna Borough",4,78,452,211,241
050,02,170,"Alaska","Matanuska-Susitna Borough",4,79,435,224,211
050,02,170,"Alaska","Matanuska-Susitna Borough",4,80,381,202,179
050,02,170,"Alaska","Matanuska-Susitna Borough",4,81,311,158,153
050,02,170,"Alaska","Matanuska-Susitna Borough",4,82,267,128,139
050,02,170,"Alaska","Matanuska-Susitna Borough",4,83,221,113,108
050,02,170,"Alaska","Matanuska-Susitna Borough",4,84,178,81,97
050,02,170,"Alaska","Matanuska-Susitna Borough",4,85,846,354,492
050,02,170,"Alaska","Matanuska-Susitna Borough",5,0,1358,718,640
050,02,170,"Alaska","Matanuska-Susitna Borough",5,1,1411,758,653
050,02,170,"Alaska","Matanuska-Susitna Borough",5,2,1428,766,662
050,02,170,"Alaska","Matanuska-Susitna Borough",5,3,1440,757,683
050,02,170,"Alaska","Matanuska-Susitna Borough",5,4,1523,804,719
050,02,170,"Alaska","Matanuska-Susitna Borough",5,5,1498,787,711
050,02,170,"Alaska","Matanuska-Susitna Borough",5,6,1578,807,771
050,02,170,"Alaska","Matanuska-Susitna Borough",5,7,1644,856,788
050,02,170,"Alaska","Matanuska-Susitna Borough",5,8,1690,890,800
050,02,170,"Alaska","Matanuska-Susitna Borough",5,9,1614,805,809
050,02,170,"Alaska","Matanuska-Susitna Borough",5,10,1719,842,877
050,02,170,"Alaska","Matanuska-Susitna Borough",5,11,1725,874,851
050,02,170,"Alaska","Matanuska-Susitna Borough",5,12,1724,898,826
050,02,170,"Alaska","Matanuska-Susitna Borough",5,13,1722,888,834
050,02,170,"Alaska","Matanuska-Susitna Borough",5,14,1758,917,841
050,02,170,"Alaska","Matanuska-Susitna Borough",5,15,1769,928,841
050,02,170,"Alaska","Matanuska-Susitna Borough",5,16,1763,913,850
050,02,170,"Alaska","Matanuska-Susitna Borough",5,17,1750,942,808
050,02,170,"Alaska","Matanuska-Susitna Borough",5,18,1463,797,666
050,02,170,"Alaska","Matanuska-Susitna Borough",5,19,1195,655,540
050,02,170,"Alaska","Matanuska-Susitna Borough",5,20,1245,698,547
050,02,170,"Alaska","Matanuska-Susitna Borough",5,21,1209,671,538
050,02,170,"Alaska","Matanuska-Susitna Borough",5,22,1347,743,604
050,02,170,"Alaska","Matanuska-Susitna Borough",5,23,1449,838,611
050,02,170,"Alaska","Matanuska-Susitna Borough",5,24,1430,829,601
050,02,170,"Alaska","Matanuska-Susitna Borough",5,25,1351,728,623
050,02,170,"Alaska","Matanuska-Susitna Borough",5,26,1393,749,644
050,02,170,"Alaska","Matanuska-Susitna Borough",5,27,1456,826,630
050,02,170,"Alaska","Matanuska-Susitna Borough",5,28,1464,776,688
050,02,170,"Alaska","Matanuska-Susitna Borough",5,29,1569,838,731
050,02,170,"Alaska","Matanuska-Susitna Borough",5,30,1652,863,789
050,02,170,"Alaska","Matanuska-Susitna Borough",5,31,1774,938,836
050,02,170,"Alaska","Matanuska-Susitna Borough",5,32,1795,961,834
050,02,170,"Alaska","Matanuska-Susitna Borough",5,33,1802,987,815
050,02,170,"Alaska","Matanuska-Susitna Borough",5,34,1697,878,819
050,02,170,"Alaska","Matanuska-Susitna Borough",5,35,1738,886,852
050,02,170,"Alaska","Matanuska-Susitna Borough",5,36,1738,889,849
050,02,170,"Alaska","Matanuska-Susitna Borough",5,37,1812,933,879
050,02,170,"Alaska","Matanuska-Susitna Borough",5,38,1774,933,841
050,02,170,"Alaska","Matanuska-Susitna Borough",5,39,1759,929,830
050,02,170,"Alaska","Matanuska-Susitna Borough",5,40,1794,951,843
050,02,170,"Alaska","Matanuska-Susitna Borough",5,41,1735,917,818
050,02,170,"Alaska","Matanuska-Susitna Borough",5,42,1628,852,776
050,02,170,"Alaska","Matanuska-Susitna Borough",5,43,1606,869,737
050,02,170,"Alaska","Matanuska-Susitna Borough",5,44,1467,766,701
050,02,170,"Alaska","Matanuska-Susitna Borough",5,45,1464,781,683
050,02,170,"Alaska","Matanuska-Susitna Borough",5,46,1422,766,656
050,02,170,"Alaska","Matanuska-Susitna Borough",5,47,1325,710,615
050,02,170,"Alaska","Matanuska-Susitna Borough",5,48,1352,747,605
050,02,170,"Alaska","Matanuska-Susitna Borough",5,49,1322,716,606
050,02,170,"Alaska","Matanuska-Susitna Borough",5,50,1330,719,611
050,02,170,"Alaska","Matanuska-Susitna Borough",5,51,1369,739,630
050,02,170,"Alaska","Matanuska-Susitna Borough",5,52,1400,734,666
050,02,170,"Alaska","Matanuska-Susitna Borough",5,53,1341,698,643
050,02,170,"Alaska","Matanuska-Susitna Borough",5,54,1273,658,615
050,02,170,"Alaska","Matanuska-Susitna Borough",5,55,1231,654,577
050,02,170,"Alaska","Matanuska-Susitna Borough",5,56,1242,644,598
050,02,170,"Alaska","Matanuska-Susitna Borough",5,57,1287,659,628
050,02,170,"Alaska","Matanuska-Susitna Borough",5,58,1388,725,663
050,02,170,"Alaska","Matanuska-Susitna Borough",5,59,1395,737,658
050,02,170,"Alaska","Matanuska-Susitna Borough",5,60,1436,780,656
050,02,170,"Alaska","Matanuska-Susitna Borough",5,61,1468,778,690
050,02,170,"Alaska","Matanuska-Susitna Borough",5,62,1465,763,702
050,02,170,"Alaska","Matanuska-Susitna Borough",5,63,1422,748,674
050,02,170,"Alaska","Matanuska-Susitna Borough",5,64,1461,751,710
050,02,170,"Alaska","Matanuska-Susitna Borough",5,65,1389,713,676
050,02,170,"Alaska","Matanuska-Susitna Borough",5,66,1356,713,643
050,02,170,"Alaska","Matanuska-Susitna Borough",5,67,1269,646,623
050,02,170,"Alaska","Matanuska-Susitna Borough",5,68,1268,647,621
050,02,170,"Alaska","Matanuska-Susitna Borough",5,69,1208,641,567
050,02,170,"Alaska","Matanuska-Susitna Borough",5,70,1162,578,584
050,02,170,"Alaska","Matanuska-Susitna Borough",5,71,1058,527,531
050,02,170,"Alaska","Matanuska-Susitna Borough",5,72,982,478,504
050,02,170,"Alaska","Matanuska-Susitna Borough",5,73,858,412,446
050,02,170,"Alaska","Matanuska-Susitna Borough",5,74,792,394,398
050,02,170,"Alaska","Matanuska-Susitna Borough",5,75,698,338,360
050,02,170,"Alaska","Matanuska-Susitna Borough",5,76,707,344,363
050,02,170,"Alaska","Matanuska-Susitna Borough",5,77,447,201,246
050,02,170,"Alaska","Matanuska-Susitna Borough",5,78,421,173,248
050,02,170,"Alaska","Matanuska-Susitna Borough",5,79,415,198,217
050,02,170,"Alaska","Matanuska-Susitna Borough",5,80,424,213,211
050,02,170,"Alaska","Matanuska-Susitna Borough",5,81,344,189,155
050,02,170,"Alaska","Matanuska-Susitna Borough",5,82,289,148,141
050,02,170,"Alaska","Matanuska-Susitna Borough",5,83,245,116,129
050,02,170,"Alaska","Matanuska-Susitna Borough",5,84,210,105,105
050,02,170,"Alaska","Matanuska-Susitna Borough",5,85,848,355,493
050,02,180,"Alaska","Nome Census Area",1,0,161,79,82
050,02,180,"Alaska","Nome Census Area",1,1,157,67,90
050,02,180,"Alaska","Nome Census Area",1,2,185,99,86
050,02,180,"Alaska","Nome Census Area",1,3,207,105,102
050,02,180,"Alaska","Nome Census Area",1,4,206,104,102
050,02,180,"Alaska","Nome Census Area",1,5,210,95,115
050,02,180,"Alaska","Nome Census Area",1,6,185,94,91
050,02,180,"Alaska","Nome Census Area",1,7,200,103,97
050,02,180,"Alaska","Nome Census Area",1,8,250,129,121
050,02,180,"Alaska","Nome Census Area",1,9,228,122,106
050,02,180,"Alaska","Nome Census Area",1,10,200,105,95
050,02,180,"Alaska","Nome Census Area",1,11,192,111,81
050,02,180,"Alaska","Nome Census Area",1,12,195,95,100
050,02,180,"Alaska","Nome Census Area",1,13,178,90,88
050,02,180,"Alaska","Nome Census Area",1,14,175,95,80
050,02,180,"Alaska","Nome Census Area",1,15,176,94,82
050,02,180,"Alaska","Nome Census Area",1,16,167,82,85
050,02,180,"Alaska","Nome Census Area",1,17,163,79,84
050,02,180,"Alaska","Nome Census Area",1,18,152,77,75
050,02,180,"Alaska","Nome Census Area",1,19,137,75,62
050,02,180,"Alaska","Nome Census Area",1,20,155,93,62
050,02,180,"Alaska","Nome Census Area",1,21,149,88,61
050,02,180,"Alaska","Nome Census Area",1,22,145,79,66
050,02,180,"Alaska","Nome Census Area",1,23,149,86,63
050,02,180,"Alaska","Nome Census Area",1,24,136,75,61
050,02,180,"Alaska","Nome Census Area",1,25,133,77,56
050,02,180,"Alaska","Nome Census Area",1,26,140,71,69
050,02,180,"Alaska","Nome Census Area",1,27,168,90,78
050,02,180,"Alaska","Nome Census Area",1,28,178,82,96
050,02,180,"Alaska","Nome Census Area",1,29,157,80,77
050,02,180,"Alaska","Nome Census Area",1,30,160,82,78
050,02,180,"Alaska","Nome Census Area",1,31,160,77,83
050,02,180,"Alaska","Nome Census Area",1,32,160,79,81
050,02,180,"Alaska","Nome Census Area",1,33,139,75,64
050,02,180,"Alaska","Nome Census Area",1,34,146,82,64
050,02,180,"Alaska","Nome Census Area",1,35,140,77,63
050,02,180,"Alaska","Nome Census Area",1,36,119,64,55
050,02,180,"Alaska","Nome Census Area",1,37,155,82,73
050,02,180,"Alaska","Nome Census Area",1,38,116,56,60
050,02,180,"Alaska","Nome Census Area",1,39,115,62,53
050,02,180,"Alaska","Nome Census Area",1,40,105,60,45
050,02,180,"Alaska","Nome Census Area",1,41,121,70,51
050,02,180,"Alaska","Nome Census Area",1,42,121,67,54
050,02,180,"Alaska","Nome Census Area",1,43,106,51,55
050,02,180,"Alaska","Nome Census Area",1,44,104,48,56
050,02,180,"Alaska","Nome Census Area",1,45,92,47,45
050,02,180,"Alaska","Nome Census Area",1,46,96,52,44
050,02,180,"Alaska","Nome Census Area",1,47,109,58,51
050,02,180,"Alaska","Nome Census Area",1,48,111,53,58
050,02,180,"Alaska","Nome Census Area",1,49,104,53,51
050,02,180,"Alaska","Nome Census Area",1,50,95,45,50
050,02,180,"Alaska","Nome Census Area",1,51,97,59,38
050,02,180,"Alaska","Nome Census Area",1,52,90,52,38
050,02,180,"Alaska","Nome Census Area",1,53,90,53,37
050,02,180,"Alaska","Nome Census Area",1,54,98,60,38
050,02,180,"Alaska","Nome Census Area",1,55,113,60,53
050,02,180,"Alaska","Nome Census Area",1,56,110,55,55
050,02,180,"Alaska","Nome Census Area",1,57,124,68,56
050,02,180,"Alaska","Nome Census Area",1,58,116,70,46
050,02,180,"Alaska","Nome Census Area",1,59,98,52,46
050,02,180,"Alaska","Nome Census Area",1,60,102,49,53
050,02,180,"Alaska","Nome Census Area",1,61,107,65,42
050,02,180,"Alaska","Nome Census Area",1,62,106,61,45
050,02,180,"Alaska","Nome Census Area",1,63,91,52,39
050,02,180,"Alaska","Nome Census Area",1,64,77,47,30
050,02,180,"Alaska","Nome Census Area",1,65,76,47,29
050,02,180,"Alaska","Nome Census Area",1,66,85,43,42
050,02,180,"Alaska","Nome Census Area",1,67,72,35,37
050,02,180,"Alaska","Nome Census Area",1,68,52,24,28
050,02,180,"Alaska","Nome Census Area",1,69,59,33,26
050,02,180,"Alaska","Nome Census Area",1,70,57,39,18
050,02,180,"Alaska","Nome Census Area",1,71,55,36,19
050,02,180,"Alaska","Nome Census Area",1,72,51,29,22
050,02,180,"Alaska","Nome Census Area",1,73,45,29,16
050,02,180,"Alaska","Nome Census Area",1,74,28,16,12
050,02,180,"Alaska","Nome Census Area",1,75,37,18,19
050,02,180,"Alaska","Nome Census Area",1,76,34,20,14
050,02,180,"Alaska","Nome Census Area",1,77,19,7,12
050,02,180,"Alaska","Nome Census Area",1,78,21,6,15
050,02,180,"Alaska","Nome Census Area",1,79,21,12,9
050,02,180,"Alaska","Nome Census Area",1,80,15,8,7
050,02,180,"Alaska","Nome Census Area",1,81,18,7,11
050,02,180,"Alaska","Nome Census Area",1,82,14,6,8
050,02,180,"Alaska","Nome Census Area",1,83,10,4,6
050,02,180,"Alaska","Nome Census Area",1,84,7,3,4
050,02,180,"Alaska","Nome Census Area",1,85,47,19,28
050,02,180,"Alaska","Nome Census Area",2,0,169,84,85
050,02,180,"Alaska","Nome Census Area",2,1,158,70,88
050,02,180,"Alaska","Nome Census Area",2,2,177,91,86
050,02,180,"Alaska","Nome Census Area",2,3,202,104,98
050,02,180,"Alaska","Nome Census Area",2,4,207,104,103
050,02,180,"Alaska","Nome Census Area",2,5,207,96,111
050,02,180,"Alaska","Nome Census Area",2,6,187,92,95
050,02,180,"Alaska","Nome Census Area",2,7,196,101,95
050,02,180,"Alaska","Nome Census Area",2,8,235,121,114
050,02,180,"Alaska","Nome Census Area",2,9,232,124,108
050,02,180,"Alaska","Nome Census Area",2,10,207,109,98
050,02,180,"Alaska","Nome Census Area",2,11,194,109,85
050,02,180,"Alaska","Nome Census Area",2,12,195,99,96
050,02,180,"Alaska","Nome Census Area",2,13,181,91,90
050,02,180,"Alaska","Nome Census Area",2,14,175,93,82
050,02,180,"Alaska","Nome Census Area",2,15,175,94,81
050,02,180,"Alaska","Nome Census Area",2,16,170,86,84
050,02,180,"Alaska","Nome Census Area",2,17,162,80,82
050,02,180,"Alaska","Nome Census Area",2,18,150,76,74
050,02,180,"Alaska","Nome Census Area",2,19,138,73,65
050,02,180,"Alaska","Nome Census Area",2,20,151,89,62
050,02,180,"Alaska","Nome Census Area",2,21,151,89,62
050,02,180,"Alaska","Nome Census Area",2,22,147,81,66
050,02,180,"Alaska","Nome Census Area",2,23,146,82,64
050,02,180,"Alaska","Nome Census Area",2,24,137,77,60
050,02,180,"Alaska","Nome Census Area",2,25,135,77,58
050,02,180,"Alaska","Nome Census Area",2,26,137,72,65
050,02,180,"Alaska","Nome Census Area",2,27,160,84,76
050,02,180,"Alaska","Nome Census Area",2,28,176,84,92
050,02,180,"Alaska","Nome Census Area",2,29,162,81,81
050,02,180,"Alaska","Nome Census Area",2,30,159,82,77
050,02,180,"Alaska","Nome Census Area",2,31,162,78,84
050,02,180,"Alaska","Nome Census Area",2,32,156,76,80
050,02,180,"Alaska","Nome Census Area",2,33,146,79,67
050,02,180,"Alaska","Nome Census Area",2,34,145,81,64
050,02,180,"Alaska","Nome Census Area",2,35,139,76,63
050,02,180,"Alaska","Nome Census Area",2,36,121,66,55
050,02,180,"Alaska","Nome Census Area",2,37,145,77,68
050,02,180,"Alaska","Nome Census Area",2,38,126,63,63
050,02,180,"Alaska","Nome Census Area",2,39,113,59,54
050,02,180,"Alaska","Nome Census Area",2,40,109,62,47
050,02,180,"Alaska","Nome Census Area",2,41,117,69,48
050,02,180,"Alaska","Nome Census Area",2,42,120,68,52
050,02,180,"Alaska","Nome Census Area",2,43,114,58,56
050,02,180,"Alaska","Nome Census Area",2,44,101,48,53
050,02,180,"Alaska","Nome Census Area",2,45,94,45,49
050,02,180,"Alaska","Nome Census Area",2,46,95,51,44
050,02,180,"Alaska","Nome Census Area",2,47,110,59,51
050,02,180,"Alaska","Nome Census Area",2,48,108,54,54
050,02,180,"Alaska","Nome Census Area",2,49,105,53,52
050,02,180,"Alaska","Nome Census Area",2,50,96,46,50
050,02,180,"Alaska","Nome Census Area",2,51,97,56,41
050,02,180,"Alaska","Nome Census Area",2,52,86,50,36
050,02,180,"Alaska","Nome Census Area",2,53,89,53,36
050,02,180,"Alaska","Nome Census Area",2,54,94,57,37
050,02,180,"Alaska","Nome Census Area",2,55,108,59,49
050,02,180,"Alaska","Nome Census Area",2,56,109,54,55
050,02,180,"Alaska","Nome Census Area",2,57,119,64,55
050,02,180,"Alaska","Nome Census Area",2,58,116,68,48
050,02,180,"Alaska","Nome Census Area",2,59,101,56,45
050,02,180,"Alaska","Nome Census Area",2,60,101,50,51
050,02,180,"Alaska","Nome Census Area",2,61,104,59,45
050,02,180,"Alaska","Nome Census Area",2,62,105,61,44
050,02,180,"Alaska","Nome Census Area",2,63,95,55,40
050,02,180,"Alaska","Nome Census Area",2,64,77,46,31
050,02,180,"Alaska","Nome Census Area",2,65,76,47,29
050,02,180,"Alaska","Nome Census Area",2,66,82,43,39
050,02,180,"Alaska","Nome Census Area",2,67,76,38,38
050,02,180,"Alaska","Nome Census Area",2,68,56,27,29
050,02,180,"Alaska","Nome Census Area",2,69,58,32,26
050,02,180,"Alaska","Nome Census Area",2,70,57,37,20
050,02,180,"Alaska","Nome Census Area",2,71,56,37,19
050,02,180,"Alaska","Nome Census Area",2,72,52,30,22
050,02,180,"Alaska","Nome Census Area",2,73,48,30,18
050,02,180,"Alaska","Nome Census Area",2,74,29,18,11
050,02,180,"Alaska","Nome Census Area",2,75,32,14,18
050,02,180,"Alaska","Nome Census Area",2,76,34,19,15
050,02,180,"Alaska","Nome Census Area",2,77,22,9,13
050,02,180,"Alaska","Nome Census Area",2,78,20,6,14
050,02,180,"Alaska","Nome Census Area",2,79,19,9,10
050,02,180,"Alaska","Nome Census Area",2,80,15,9,6
050,02,180,"Alaska","Nome Census Area",2,81,16,7,9
050,02,180,"Alaska","Nome Census Area",2,82,14,5,9
050,02,180,"Alaska","Nome Census Area",2,83,11,5,6
050,02,180,"Alaska","Nome Census Area",2,84,7,3,4
050,02,180,"Alaska","Nome Census Area",2,85,48,20,28
050,02,180,"Alaska","Nome Census Area",3,0,180,80,100
050,02,180,"Alaska","Nome Census Area",3,1,152,76,76
050,02,180,"Alaska","Nome Census Area",3,2,154,69,85
050,02,180,"Alaska","Nome Census Area",3,3,175,91,84
050,02,180,"Alaska","Nome Census Area",3,4,194,101,93
050,02,180,"Alaska","Nome Census Area",3,5,199,101,98
050,02,180,"Alaska","Nome Census Area",3,6,198,92,106
050,02,180,"Alaska","Nome Census Area",3,7,177,87,90
050,02,180,"Alaska","Nome Census Area",3,8,186,97,89
050,02,180,"Alaska","Nome Census Area",3,9,219,116,103
050,02,180,"Alaska","Nome Census Area",3,10,228,120,108
050,02,180,"Alaska","Nome Census Area",3,11,200,105,95
050,02,180,"Alaska","Nome Census Area",3,12,196,109,87
050,02,180,"Alaska","Nome Census Area",3,13,191,96,95
050,02,180,"Alaska","Nome Census Area",3,14,176,89,87
050,02,180,"Alaska","Nome Census Area",3,15,167,88,79
050,02,180,"Alaska","Nome Census Area",3,16,174,92,82
050,02,180,"Alaska","Nome Census Area",3,17,166,85,81
050,02,180,"Alaska","Nome Census Area",3,18,145,72,73
050,02,180,"Alaska","Nome Census Area",3,19,139,66,73
050,02,180,"Alaska","Nome Census Area",3,20,144,81,63
050,02,180,"Alaska","Nome Census Area",3,21,150,88,62
050,02,180,"Alaska","Nome Census Area",3,22,159,89,70
050,02,180,"Alaska","Nome Census Area",3,23,139,71,68
050,02,180,"Alaska","Nome Census Area",3,24,139,79,60
050,02,180,"Alaska","Nome Census Area",3,25,137,79,58
050,02,180,"Alaska","Nome Census Area",3,26,130,74,56
050,02,180,"Alaska","Nome Census Area",3,27,134,69,65
050,02,180,"Alaska","Nome Census Area",3,28,159,79,80
050,02,180,"Alaska","Nome Census Area",3,29,173,86,87
050,02,180,"Alaska","Nome Census Area",3,30,161,80,81
050,02,180,"Alaska","Nome Census Area",3,31,155,74,81
050,02,180,"Alaska","Nome Census Area",3,32,153,74,79
050,02,180,"Alaska","Nome Census Area",3,33,153,83,70
050,02,180,"Alaska","Nome Census Area",3,34,142,76,66
050,02,180,"Alaska","Nome Census Area",3,35,132,75,57
050,02,180,"Alaska","Nome Census Area",3,36,134,77,57
050,02,180,"Alaska","Nome Census Area",3,37,119,63,56
050,02,180,"Alaska","Nome Census Area",3,38,135,67,68
050,02,180,"Alaska","Nome Census Area",3,39,119,59,60
050,02,180,"Alaska","Nome Census Area",3,40,109,59,50
050,02,180,"Alaska","Nome Census Area",3,41,107,60,47
050,02,180,"Alaska","Nome Census Area",3,42,117,69,48
050,02,180,"Alaska","Nome Census Area",3,43,122,66,56
050,02,180,"Alaska","Nome Census Area",3,44,113,61,52
050,02,180,"Alaska","Nome Census Area",3,45,96,44,52
050,02,180,"Alaska","Nome Census Area",3,46,102,51,51
050,02,180,"Alaska","Nome Census Area",3,47,103,54,49
050,02,180,"Alaska","Nome Census Area",3,48,106,55,51
050,02,180,"Alaska","Nome Census Area",3,49,99,53,46
050,02,180,"Alaska","Nome Census Area",3,50,94,45,49
050,02,180,"Alaska","Nome Census Area",3,51,100,54,46
050,02,180,"Alaska","Nome Census Area",3,52,84,43,41
050,02,180,"Alaska","Nome Census Area",3,53,87,50,37
050,02,180,"Alaska","Nome Census Area",3,54,91,52,39
050,02,180,"Alaska","Nome Census Area",3,55,95,56,39
050,02,180,"Alaska","Nome Census Area",3,56,108,56,52
050,02,180,"Alaska","Nome Census Area",3,57,92,46,46
050,02,180,"Alaska","Nome Census Area",3,58,124,67,57
050,02,180,"Alaska","Nome Census Area",3,59,115,68,47
050,02,180,"Alaska","Nome Census Area",3,60,100,52,48
050,02,180,"Alaska","Nome Census Area",3,61,102,49,53
050,02,180,"Alaska","Nome Census Area",3,62,96,54,42
050,02,180,"Alaska","Nome Census Area",3,63,105,60,45
050,02,180,"Alaska","Nome Census Area",3,64,92,53,39
050,02,180,"Alaska","Nome Census Area",3,65,75,44,31
050,02,180,"Alaska","Nome Census Area",3,66,74,44,30
050,02,180,"Alaska","Nome Census Area",3,67,84,44,40
050,02,180,"Alaska","Nome Census Area",3,68,65,33,32
050,02,180,"Alaska","Nome Census Area",3,69,58,28,30
050,02,180,"Alaska","Nome Census Area",3,70,52,28,24
050,02,180,"Alaska","Nome Census Area",3,71,57,38,19
050,02,180,"Alaska","Nome Census Area",3,72,52,34,18
050,02,180,"Alaska","Nome Census Area",3,73,50,28,22
050,02,180,"Alaska","Nome Census Area",3,74,45,28,17
050,02,180,"Alaska","Nome Census Area",3,75,30,18,12
050,02,180,"Alaska","Nome Census Area",3,76,31,14,17
050,02,180,"Alaska","Nome Census Area",3,77,33,18,15
050,02,180,"Alaska","Nome Census Area",3,78,19,8,11
050,02,180,"Alaska","Nome Census Area",3,79,19,4,15
050,02,180,"Alaska","Nome Census Area",3,80,19,9,10
050,02,180,"Alaska","Nome Census Area",3,81,9,6,3
050,02,180,"Alaska","Nome Census Area",3,82,12,5,7
050,02,180,"Alaska","Nome Census Area",3,83,11,5,6
050,02,180,"Alaska","Nome Census Area",3,84,10,5,5
050,02,180,"Alaska","Nome Census Area",3,85,47,18,29
050,02,180,"Alaska","Nome Census Area",4,0,170,83,87
050,02,180,"Alaska","Nome Census Area",4,1,179,78,101
050,02,180,"Alaska","Nome Census Area",4,2,158,84,74
050,02,180,"Alaska","Nome Census Area",4,3,151,69,82
050,02,180,"Alaska","Nome Census Area",4,4,176,92,84
050,02,180,"Alaska","Nome Census Area",4,5,194,102,92
050,02,180,"Alaska","Nome Census Area",4,6,195,100,95
050,02,180,"Alaska","Nome Census Area",4,7,201,94,107
050,02,180,"Alaska","Nome Census Area",4,8,172,82,90
050,02,180,"Alaska","Nome Census Area",4,9,179,92,87
050,02,180,"Alaska","Nome Census Area",4,10,217,111,106
050,02,180,"Alaska","Nome Census Area",4,11,221,118,103
050,02,180,"Alaska","Nome Census Area",4,12,193,106,87
050,02,180,"Alaska","Nome Census Area",4,13,188,105,83
050,02,180,"Alaska","Nome Census Area",4,14,188,95,93
050,02,180,"Alaska","Nome Census Area",4,15,176,88,88
050,02,180,"Alaska","Nome Census Area",4,16,168,90,78
050,02,180,"Alaska","Nome Census Area",4,17,167,87,80
050,02,180,"Alaska","Nome Census Area",4,18,145,77,68
050,02,180,"Alaska","Nome Census Area",4,19,131,66,65
050,02,180,"Alaska","Nome Census Area",4,20,136,64,72
050,02,180,"Alaska","Nome Census Area",4,21,148,87,61
050,02,180,"Alaska","Nome Census Area",4,22,157,88,69
050,02,180,"Alaska","Nome Census Area",4,23,144,78,66
050,02,180,"Alaska","Nome Census Area",4,24,135,70,65
050,02,180,"Alaska","Nome Census Area",4,25,155,89,66
050,02,180,"Alaska","Nome Census Area",4,26,141,83,58
050,02,180,"Alaska","Nome Census Area",4,27,133,75,58
050,02,180,"Alaska","Nome Census Area",4,28,131,66,65
050,02,180,"Alaska","Nome Census Area",4,29,154,78,76
050,02,180,"Alaska","Nome Census Area",4,30,169,84,85
050,02,180,"Alaska","Nome Census Area",4,31,160,75,85
050,02,180,"Alaska","Nome Census Area",4,32,144,69,75
050,02,180,"Alaska","Nome Census Area",4,33,152,77,75
050,02,180,"Alaska","Nome Census Area",4,34,144,74,70
050,02,180,"Alaska","Nome Census Area",4,35,127,67,60
050,02,180,"Alaska","Nome Census Area",4,36,128,72,56
050,02,180,"Alaska","Nome Census Area",4,37,132,73,59
050,02,180,"Alaska","Nome Census Area",4,38,113,63,50
050,02,180,"Alaska","Nome Census Area",4,39,132,69,63
050,02,180,"Alaska","Nome Census Area",4,40,120,62,58
050,02,180,"Alaska","Nome Census Area",4,41,108,59,49
050,02,180,"Alaska","Nome Census Area",4,42,105,57,48
050,02,180,"Alaska","Nome Census Area",4,43,120,66,54
050,02,180,"Alaska","Nome Census Area",4,44,117,67,50
050,02,180,"Alaska","Nome Census Area",4,45,108,57,51
050,02,180,"Alaska","Nome Census Area",4,46,95,47,48
050,02,180,"Alaska","Nome Census Area",4,47,109,55,54
050,02,180,"Alaska","Nome Census Area",4,48,96,50,46
050,02,180,"Alaska","Nome Census Area",4,49,97,58,39
050,02,180,"Alaska","Nome Census Area",4,50,94,49,45
050,02,180,"Alaska","Nome Census Area",4,51,108,56,52
050,02,180,"Alaska","Nome Census Area",4,52,85,41,44
050,02,180,"Alaska","Nome Census Area",4,53,87,43,44
050,02,180,"Alaska","Nome Census Area",4,54,86,49,37
050,02,180,"Alaska","Nome Census Area",4,55,93,55,38
050,02,180,"Alaska","Nome Census Area",4,56,91,50,41
050,02,180,"Alaska","Nome Census Area",4,57,95,53,42
050,02,180,"Alaska","Nome Census Area",4,58,92,47,45
050,02,180,"Alaska","Nome Census Area",4,59,128,71,57
050,02,180,"Alaska","Nome Census Area",4,60,110,63,47
050,02,180,"Alaska","Nome Census Area",4,61,95,49,46
050,02,180,"Alaska","Nome Census Area",4,62,96,42,54
050,02,180,"Alaska","Nome Census Area",4,63,87,48,39
050,02,180,"Alaska","Nome Census Area",4,64,99,57,42
050,02,180,"Alaska","Nome Census Area",4,65,84,45,39
050,02,180,"Alaska","Nome Census Area",4,66,70,41,29
050,02,180,"Alaska","Nome Census Area",4,67,66,38,28
050,02,180,"Alaska","Nome Census Area",4,68,76,40,36
050,02,180,"Alaska","Nome Census Area",4,69,61,35,26
050,02,180,"Alaska","Nome Census Area",4,70,54,26,28
050,02,180,"Alaska","Nome Census Area",4,71,51,28,23
050,02,180,"Alaska","Nome Census Area",4,72,56,37,19
050,02,180,"Alaska","Nome Census Area",4,73,51,33,18
050,02,180,"Alaska","Nome Census Area",4,74,45,25,20
050,02,180,"Alaska","Nome Census Area",4,75,47,30,17
050,02,180,"Alaska","Nome Census Area",4,76,28,18,10
050,02,180,"Alaska","Nome Census Area",4,77,31,14,17
050,02,180,"Alaska","Nome Census Area",4,78,30,18,12
050,02,180,"Alaska","Nome Census Area",4,79,18,8,10
050,02,180,"Alaska","Nome Census Area",4,80,17,4,13
050,02,180,"Alaska","Nome Census Area",4,81,17,7,10
050,02,180,"Alaska","Nome Census Area",4,82,5,4,1
050,02,180,"Alaska","Nome Census Area",4,83,9,4,5
050,02,180,"Alaska","Nome Census Area",4,84,10,5,5
050,02,180,"Alaska","Nome Census Area",4,85,40,14,26
050,02,180,"Alaska","Nome Census Area",5,0,167,81,86
050,02,180,"Alaska","Nome Census Area",5,1,165,78,87
050,02,180,"Alaska","Nome Census Area",5,2,171,72,99
050,02,180,"Alaska","Nome Census Area",5,3,159,82,77
050,02,180,"Alaska","Nome Census Area",5,4,147,67,80
050,02,180,"Alaska","Nome Census Area",5,5,172,87,85
050,02,180,"Alaska","Nome Census Area",5,6,200,107,93
050,02,180,"Alaska","Nome Census Area",5,7,196,103,93
050,02,180,"Alaska","Nome Census Area",5,8,204,98,106
050,02,180,"Alaska","Nome Census Area",5,9,172,79,93
050,02,180,"Alaska","Nome Census Area",5,10,181,94,87
050,02,180,"Alaska","Nome Census Area",5,11,221,111,110
050,02,180,"Alaska","Nome Census Area",5,12,223,119,104
050,02,180,"Alaska","Nome Census Area",5,13,189,104,85
050,02,180,"Alaska","Nome Census Area",5,14,186,103,83
050,02,180,"Alaska","Nome Census Area",5,15,188,92,96
050,02,180,"Alaska","Nome Census Area",5,16,175,89,86
050,02,180,"Alaska","Nome Census Area",5,17,160,84,76
050,02,180,"Alaska","Nome Census Area",5,18,151,80,71
050,02,180,"Alaska","Nome Census Area",5,19,133,66,67
050,02,180,"Alaska","Nome Census Area",5,20,130,71,59
050,02,180,"Alaska","Nome Census Area",5,21,142,66,76
050,02,180,"Alaska","Nome Census Area",5,22,151,87,64
050,02,180,"Alaska","Nome Census Area",5,23,143,80,63
050,02,180,"Alaska","Nome Census Area",5,24,144,78,66
050,02,180,"Alaska","Nome Census Area",5,25,137,78,59
050,02,180,"Alaska","Nome Census Area",5,26,148,84,64
050,02,180,"Alaska","Nome Census Area",5,27,138,83,55
050,02,180,"Alaska","Nome Census Area",5,28,126,73,53
050,02,180,"Alaska","Nome Census Area",5,29,125,62,63
050,02,180,"Alaska","Nome Census Area",5,30,155,80,75
050,02,180,"Alaska","Nome Census Area",5,31,171,78,93
050,02,180,"Alaska","Nome Census Area",5,32,153,69,84
050,02,180,"Alaska","Nome Census Area",5,33,150,78,72
050,02,180,"Alaska","Nome Census Area",5,34,159,75,84
050,02,180,"Alaska","Nome Census Area",5,35,137,71,66
050,02,180,"Alaska","Nome Census Area",5,36,118,64,54
050,02,180,"Alaska","Nome Census Area",5,37,128,73,55
050,02,180,"Alaska","Nome Census Area",5,38,131,70,61
050,02,180,"Alaska","Nome Census Area",5,39,110,62,48
050,02,180,"Alaska","Nome Census Area",5,40,135,69,66
050,02,180,"Alaska","Nome Census Area",5,41,115,58,57
050,02,180,"Alaska","Nome Census Area",5,42,107,57,50
050,02,180,"Alaska","Nome Census Area",5,43,112,59,53
050,02,180,"Alaska","Nome Census Area",5,44,115,68,47
050,02,180,"Alaska","Nome Census Area",5,45,106,60,46
050,02,180,"Alaska","Nome Census Area",5,46,108,59,49
050,02,180,"Alaska","Nome Census Area",5,47,102,49,53
050,02,180,"Alaska","Nome Census Area",5,48,99,47,52
050,02,180,"Alaska","Nome Census Area",5,49,85,48,37
050,02,180,"Alaska","Nome Census Area",5,50,95,57,38
050,02,180,"Alaska","Nome Census Area",5,51,99,55,44
050,02,180,"Alaska","Nome Census Area",5,52,94,44,50
050,02,180,"Alaska","Nome Census Area",5,53,83,38,45
050,02,180,"Alaska","Nome Census Area",5,54,83,40,43
050,02,180,"Alaska","Nome Census Area",5,55,85,47,38
050,02,180,"Alaska","Nome Census Area",5,56,99,56,43
050,02,180,"Alaska","Nome Census Area",5,57,82,49,33
050,02,180,"Alaska","Nome Census Area",5,58,99,56,43
050,02,180,"Alaska","Nome Census Area",5,59,92,47,45
050,02,180,"Alaska","Nome Census Area",5,60,123,63,60
050,02,180,"Alaska","Nome Census Area",5,61,101,57,44
050,02,180,"Alaska","Nome Census Area",5,62,97,49,48
050,02,180,"Alaska","Nome Census Area",5,63,95,43,52
050,02,180,"Alaska","Nome Census Area",5,64,85,47,38
050,02,180,"Alaska","Nome Census Area",5,65,94,52,42
050,02,180,"Alaska","Nome Census Area",5,66,79,44,35
050,02,180,"Alaska","Nome Census Area",5,67,63,35,28
050,02,180,"Alaska","Nome Census Area",5,68,62,35,27
050,02,180,"Alaska","Nome Census Area",5,69,76,40,36
050,02,180,"Alaska","Nome Census Area",5,70,59,33,26
050,02,180,"Alaska","Nome Census Area",5,71,50,23,27
050,02,180,"Alaska","Nome Census Area",5,72,50,28,22
050,02,180,"Alaska","Nome Census Area",5,73,56,36,20
050,02,180,"Alaska","Nome Census Area",5,74,50,33,17
050,02,180,"Alaska","Nome Census Area",5,75,43,24,19
050,02,180,"Alaska","Nome Census Area",5,76,44,28,16
050,02,180,"Alaska","Nome Census Area",5,77,27,17,10
050,02,180,"Alaska","Nome Census Area",5,78,28,14,14
050,02,180,"Alaska","Nome Census Area",5,79,29,18,11
050,02,180,"Alaska","Nome Census Area",5,80,18,9,9
050,02,180,"Alaska","Nome Census Area",5,81,17,4,13
050,02,180,"Alaska","Nome Census Area",5,82,15,7,8
050,02,180,"Alaska","Nome Census Area",5,83,6,4,2
050,02,180,"Alaska","Nome Census Area",5,84,8,4,4
050,02,180,"Alaska","Nome Census Area",5,85,37,13,24
050,02,185,"Alaska","North Slope Borough",1,0,155,82,73
050,02,185,"Alaska","North Slope Borough",1,1,155,82,73
050,02,185,"Alaska","North Slope Borough",1,2,158,77,81
050,02,185,"Alaska","North Slope Borough",1,3,181,94,87
050,02,185,"Alaska","North Slope Borough",1,4,167,88,79
050,02,185,"Alaska","North Slope Borough",1,5,186,101,85
050,02,185,"Alaska","North Slope Borough",1,6,161,68,93
050,02,185,"Alaska","North Slope Borough",1,7,164,97,67
050,02,185,"Alaska","North Slope Borough",1,8,184,95,89
050,02,185,"Alaska","North Slope Borough",1,9,186,85,101
050,02,185,"Alaska","North Slope Borough",1,10,174,85,89
050,02,185,"Alaska","North Slope Borough",1,11,156,74,82
050,02,185,"Alaska","North Slope Borough",1,12,153,73,80
050,02,185,"Alaska","North Slope Borough",1,13,159,84,75
050,02,185,"Alaska","North Slope Borough",1,14,164,85,79
050,02,185,"Alaska","North Slope Borough",1,15,149,78,71
050,02,185,"Alaska","North Slope Borough",1,16,139,65,74
050,02,185,"Alaska","North Slope Borough",1,17,126,68,58
050,02,185,"Alaska","North Slope Borough",1,18,117,64,53
050,02,185,"Alaska","North Slope Borough",1,19,97,51,46
050,02,185,"Alaska","North Slope Borough",1,20,129,70,59
050,02,185,"Alaska","North Slope Borough",1,21,104,52,52
050,02,185,"Alaska","North Slope Borough",1,22,115,69,46
050,02,185,"Alaska","North Slope Borough",1,23,154,108,46
050,02,185,"Alaska","North Slope Borough",1,24,134,91,43
050,02,185,"Alaska","North Slope Borough",1,25,152,96,56
050,02,185,"Alaska","North Slope Borough",1,26,155,104,51
050,02,185,"Alaska","North Slope Borough",1,27,164,105,59
050,02,185,"Alaska","North Slope Borough",1,28,178,125,53
050,02,185,"Alaska","North Slope Borough",1,29,199,123,76
050,02,185,"Alaska","North Slope Borough",1,30,211,128,83
050,02,185,"Alaska","North Slope Borough",1,31,187,123,64
050,02,185,"Alaska","North Slope Borough",1,32,191,119,72
050,02,185,"Alaska","North Slope Borough",1,33,153,101,52
050,02,185,"Alaska","North Slope Borough",1,34,188,138,50
050,02,185,"Alaska","North Slope Borough",1,35,198,137,61
050,02,185,"Alaska","North Slope Borough",1,36,182,129,53
050,02,185,"Alaska","North Slope Borough",1,37,152,103,49
050,02,185,"Alaska","North Slope Borough",1,38,180,138,42
050,02,185,"Alaska","North Slope Borough",1,39,142,97,45
050,02,185,"Alaska","North Slope Borough",1,40,150,106,44
050,02,185,"Alaska","North Slope Borough",1,41,166,116,50
050,02,185,"Alaska","North Slope Borough",1,42,132,80,52
050,02,185,"Alaska","North Slope Borough",1,43,107,68,39
050,02,185,"Alaska","North Slope Borough",1,44,132,95,37
050,02,185,"Alaska","North Slope Borough",1,45,167,123,44
050,02,185,"Alaska","North Slope Borough",1,46,138,102,36
050,02,185,"Alaska","North Slope Borough",1,47,139,93,46
050,02,185,"Alaska","North Slope Borough",1,48,137,101,36
050,02,185,"Alaska","North Slope Borough",1,49,133,95,38
050,02,185,"Alaska","North Slope Borough",1,50,144,107,37
050,02,185,"Alaska","North Slope Borough",1,51,132,99,33
050,02,185,"Alaska","North Slope Borough",1,52,116,82,34
050,02,185,"Alaska","North Slope Borough",1,53,225,172,53
050,02,185,"Alaska","North Slope Borough",1,54,207,154,53
050,02,185,"Alaska","North Slope Borough",1,55,245,192,53
050,02,185,"Alaska","North Slope Borough",1,56,189,145,44
050,02,185,"Alaska","North Slope Borough",1,57,226,181,45
050,02,185,"Alaska","North Slope Borough",1,58,194,142,52
050,02,185,"Alaska","North Slope Borough",1,59,153,103,50
050,02,185,"Alaska","North Slope Borough",1,60,175,130,45
050,02,185,"Alaska","North Slope Borough",1,61,134,96,38
050,02,185,"Alaska","North Slope Borough",1,62,112,79,33
050,02,185,"Alaska","North Slope Borough",1,63,109,75,34
050,02,185,"Alaska","North Slope Borough",1,64,91,60,31
050,02,185,"Alaska","North Slope Borough",1,65,87,54,33
050,02,185,"Alaska","North Slope Borough",1,66,90,54,36
050,02,185,"Alaska","North Slope Borough",1,67,73,48,25
050,02,185,"Alaska","North Slope Borough",1,68,67,40,27
050,02,185,"Alaska","North Slope Borough",1,69,62,43,19
050,02,185,"Alaska","North Slope Borough",1,70,57,37,20
050,02,185,"Alaska","North Slope Borough",1,71,45,29,16
050,02,185,"Alaska","North Slope Borough",1,72,29,14,15
050,02,185,"Alaska","North Slope Borough",1,73,28,10,18
050,02,185,"Alaska","North Slope Borough",1,74,33,18,15
050,02,185,"Alaska","North Slope Borough",1,75,37,25,12
050,02,185,"Alaska","North Slope Borough",1,76,25,15,10
050,02,185,"Alaska","North Slope Borough",1,77,25,18,7
050,02,185,"Alaska","North Slope Borough",1,78,16,7,9
050,02,185,"Alaska","North Slope Borough",1,79,19,5,14
050,02,185,"Alaska","North Slope Borough",1,80,9,4,5
050,02,185,"Alaska","North Slope Borough",1,81,8,4,4
050,02,185,"Alaska","North Slope Borough",1,82,11,2,9
050,02,185,"Alaska","North Slope Borough",1,83,10,2,8
050,02,185,"Alaska","North Slope Borough",1,84,10,3,7
050,02,185,"Alaska","North Slope Borough",1,85,39,10,29
050,02,185,"Alaska","North Slope Borough",2,0,150,77,73
050,02,185,"Alaska","North Slope Borough",2,1,154,80,74
050,02,185,"Alaska","North Slope Borough",2,2,154,76,78
050,02,185,"Alaska","North Slope Borough",2,3,174,89,85
050,02,185,"Alaska","North Slope Borough",2,4,169,88,81
050,02,185,"Alaska","North Slope Borough",2,5,177,95,82
050,02,185,"Alaska","North Slope Borough",2,6,167,76,91
050,02,185,"Alaska","North Slope Borough",2,7,162,89,73
050,02,185,"Alaska","North Slope Borough",2,8,179,93,86
050,02,185,"Alaska","North Slope Borough",2,9,182,87,95
050,02,185,"Alaska","North Slope Borough",2,10,177,85,92
050,02,185,"Alaska","North Slope Borough",2,11,160,76,84
050,02,185,"Alaska","North Slope Borough",2,12,157,75,82
050,02,185,"Alaska","North Slope Borough",2,13,158,81,77
050,02,185,"Alaska","North Slope Borough",2,14,162,84,78
050,02,185,"Alaska","North Slope Borough",2,15,154,80,74
050,02,185,"Alaska","North Slope Borough",2,16,141,69,72
050,02,185,"Alaska","North Slope Borough",2,17,126,65,61
050,02,185,"Alaska","North Slope Borough",2,18,112,60,52
050,02,185,"Alaska","North Slope Borough",2,19,102,54,48
050,02,185,"Alaska","North Slope Borough",2,20,125,69,56
050,02,185,"Alaska","North Slope Borough",2,21,111,55,56
050,02,185,"Alaska","North Slope Borough",2,22,114,68,46
050,02,185,"Alaska","North Slope Borough",2,23,151,106,45
050,02,185,"Alaska","North Slope Borough",2,24,138,93,45
050,02,185,"Alaska","North Slope Borough",2,25,152,97,55
050,02,185,"Alaska","North Slope Borough",2,26,149,100,49
050,02,185,"Alaska","North Slope Borough",2,27,165,107,58
050,02,185,"Alaska","North Slope Borough",2,28,174,122,52
050,02,185,"Alaska","North Slope Borough",2,29,190,119,71
050,02,185,"Alaska","North Slope Borough",2,30,209,128,81
050,02,185,"Alaska","North Slope Borough",2,31,188,121,67
050,02,185,"Alaska","North Slope Borough",2,32,189,118,71
050,02,185,"Alaska","North Slope Borough",2,33,158,104,54
050,02,185,"Alaska","North Slope Borough",2,34,183,133,50
050,02,185,"Alaska","North Slope Borough",2,35,198,137,61
050,02,185,"Alaska","North Slope Borough",2,36,184,129,55
050,02,185,"Alaska","North Slope Borough",2,37,154,105,49
050,02,185,"Alaska","North Slope Borough",2,38,182,139,43
050,02,185,"Alaska","North Slope Borough",2,39,144,99,45
050,02,185,"Alaska","North Slope Borough",2,40,152,106,46
050,02,185,"Alaska","North Slope Borough",2,41,165,117,48
050,02,185,"Alaska","North Slope Borough",2,42,130,79,51
050,02,185,"Alaska","North Slope Borough",2,43,111,68,43
050,02,185,"Alaska","North Slope Borough",2,44,129,93,36
050,02,185,"Alaska","North Slope Borough",2,45,165,123,42
050,02,185,"Alaska","North Slope Borough",2,46,137,100,37
050,02,185,"Alaska","North Slope Borough",2,47,139,94,45
050,02,185,"Alaska","North Slope Borough",2,48,139,101,38
050,02,185,"Alaska","North Slope Borough",2,49,134,96,38
050,02,185,"Alaska","North Slope Borough",2,50,143,107,36
050,02,185,"Alaska","North Slope Borough",2,51,130,99,31
050,02,185,"Alaska","North Slope Borough",2,52,118,84,34
050,02,185,"Alaska","North Slope Borough",2,53,216,165,51
050,02,185,"Alaska","North Slope Borough",2,54,203,151,52
050,02,185,"Alaska","North Slope Borough",2,55,243,190,53
050,02,185,"Alaska","North Slope Borough",2,56,197,151,46
050,02,185,"Alaska","North Slope Borough",2,57,223,180,43
050,02,185,"Alaska","North Slope Borough",2,58,194,143,51
050,02,185,"Alaska","North Slope Borough",2,59,148,101,47
050,02,185,"Alaska","North Slope Borough",2,60,174,127,47
050,02,185,"Alaska","North Slope Borough",2,61,133,94,39
050,02,185,"Alaska","North Slope Borough",2,62,111,77,34
050,02,185,"Alaska","North Slope Borough",2,63,113,78,35
050,02,185,"Alaska","North Slope Borough",2,64,88,57,31
050,02,185,"Alaska","North Slope Borough",2,65,87,54,33
050,02,185,"Alaska","North Slope Borough",2,66,89,54,35
050,02,185,"Alaska","North Slope Borough",2,67,78,49,29
050,02,185,"Alaska","North Slope Borough",2,68,66,40,26
050,02,185,"Alaska","North Slope Borough",2,69,65,44,21
050,02,185,"Alaska","North Slope Borough",2,70,59,38,21
050,02,185,"Alaska","North Slope Borough",2,71,47,30,17
050,02,185,"Alaska","North Slope Borough",2,72,33,17,16
050,02,185,"Alaska","North Slope Borough",2,73,30,12,18
050,02,185,"Alaska","North Slope Borough",2,74,30,15,15
050,02,185,"Alaska","North Slope Borough",2,75,37,24,13
050,02,185,"Alaska","North Slope Borough",2,76,23,15,8
050,02,185,"Alaska","North Slope Borough",2,77,25,17,8
050,02,185,"Alaska","North Slope Borough",2,78,18,9,9
050,02,185,"Alaska","North Slope Borough",2,79,19,6,13
050,02,185,"Alaska","North Slope Borough",2,80,11,4,7
050,02,185,"Alaska","North Slope Borough",2,81,8,4,4
050,02,185,"Alaska","North Slope Borough",2,82,10,2,8
050,02,185,"Alaska","North Slope Borough",2,83,10,2,8
050,02,185,"Alaska","North Slope Borough",2,84,11,3,8
050,02,185,"Alaska","North Slope Borough",2,85,38,8,30
050,02,185,"Alaska","North Slope Borough",3,0,131,65,66
050,02,185,"Alaska","North Slope Borough",3,1,144,78,66
050,02,185,"Alaska","North Slope Borough",3,2,150,78,72
050,02,185,"Alaska","North Slope Borough",3,3,149,76,73
050,02,185,"Alaska","North Slope Borough",3,4,175,88,87
050,02,185,"Alaska","North Slope Borough",3,5,169,86,83
050,02,185,"Alaska","North Slope Borough",3,6,172,90,82
050,02,185,"Alaska","North Slope Borough",3,7,168,78,90
050,02,185,"Alaska","North Slope Borough",3,8,167,89,78
050,02,185,"Alaska","North Slope Borough",3,9,182,95,87
050,02,185,"Alaska","North Slope Borough",3,10,185,86,99
050,02,185,"Alaska","North Slope Borough",3,11,174,84,90
050,02,185,"Alaska","North Slope Borough",3,12,163,78,85
050,02,185,"Alaska","North Slope Borough",3,13,161,81,80
050,02,185,"Alaska","North Slope Borough",3,14,156,82,74
050,02,185,"Alaska","North Slope Borough",3,15,174,89,85
050,02,185,"Alaska","North Slope Borough",3,16,173,91,82
050,02,185,"Alaska","North Slope Borough",3,17,146,74,72
050,02,185,"Alaska","North Slope Borough",3,18,114,57,57
050,02,185,"Alaska","North Slope Borough",3,19,112,60,52
050,02,185,"Alaska","North Slope Borough",3,20,120,73,47
050,02,185,"Alaska","North Slope Borough",3,21,116,56,60
050,02,185,"Alaska","North Slope Borough",3,22,112,67,45
050,02,185,"Alaska","North Slope Borough",3,23,140,93,47
050,02,185,"Alaska","North Slope Borough",3,24,148,97,51
050,02,185,"Alaska","North Slope Borough",3,25,163,106,57
050,02,185,"Alaska","North Slope Borough",3,26,132,86,46
050,02,185,"Alaska","North Slope Borough",3,27,155,105,50
050,02,185,"Alaska","North Slope Borough",3,28,166,115,51
050,02,185,"Alaska","North Slope Borough",3,29,166,109,57
050,02,185,"Alaska","North Slope Borough",3,30,202,127,75
050,02,185,"Alaska","North Slope Borough",3,31,199,122,77
050,02,185,"Alaska","North Slope Borough",3,32,189,116,73
050,02,185,"Alaska","North Slope Borough",3,33,177,114,63
050,02,185,"Alaska","North Slope Borough",3,34,173,121,52
050,02,185,"Alaska","North Slope Borough",3,35,183,133,50
050,02,185,"Alaska","North Slope Borough",3,36,188,124,64
050,02,185,"Alaska","North Slope Borough",3,37,163,110,53
050,02,185,"Alaska","North Slope Borough",3,38,197,147,50
050,02,185,"Alaska","North Slope Borough",3,39,146,107,39
050,02,185,"Alaska","North Slope Borough",3,40,147,101,46
050,02,185,"Alaska","North Slope Borough",3,41,170,123,47
050,02,185,"Alaska","North Slope Borough",3,42,133,89,44
050,02,185,"Alaska","North Slope Borough",3,43,120,67,53
050,02,185,"Alaska","North Slope Borough",3,44,132,87,45
050,02,185,"Alaska","North Slope Borough",3,45,153,118,35
050,02,185,"Alaska","North Slope Borough",3,46,137,97,40
050,02,185,"Alaska","North Slope Borough",3,47,128,85,43
050,02,185,"Alaska","North Slope Borough",3,48,146,103,43
050,02,185,"Alaska","North Slope Borough",3,49,135,95,40
050,02,185,"Alaska","North Slope Borough",3,50,143,103,40
050,02,185,"Alaska","North Slope Borough",3,51,133,102,31
050,02,185,"Alaska","North Slope Borough",3,52,126,92,34
050,02,185,"Alaska","North Slope Borough",3,53,211,161,50
050,02,185,"Alaska","North Slope Borough",3,54,183,136,47
050,02,185,"Alaska","North Slope Borough",3,55,227,185,42
050,02,185,"Alaska","North Slope Borough",3,56,209,160,49
050,02,185,"Alaska","North Slope Borough",3,57,227,186,41
050,02,185,"Alaska","North Slope Borough",3,58,199,150,49
050,02,185,"Alaska","North Slope Borough",3,59,149,104,45
050,02,185,"Alaska","North Slope Borough",3,60,173,122,51
050,02,185,"Alaska","North Slope Borough",3,61,130,87,43
050,02,185,"Alaska","North Slope Borough",3,62,111,74,37
050,02,185,"Alaska","North Slope Borough",3,63,119,84,35
050,02,185,"Alaska","North Slope Borough",3,64,92,62,30
050,02,185,"Alaska","North Slope Borough",3,65,72,43,29
050,02,185,"Alaska","North Slope Borough",3,66,82,50,32
050,02,185,"Alaska","North Slope Borough",3,67,82,49,33
050,02,185,"Alaska","North Slope Borough",3,68,70,41,29
050,02,185,"Alaska","North Slope Borough",3,69,68,44,24
050,02,185,"Alaska","North Slope Borough",3,70,61,42,19
050,02,185,"Alaska","North Slope Borough",3,71,53,33,20
050,02,185,"Alaska","North Slope Borough",3,72,44,28,16
050,02,185,"Alaska","North Slope Borough",3,73,29,14,15
050,02,185,"Alaska","North Slope Borough",3,74,30,12,18
050,02,185,"Alaska","North Slope Borough",3,75,31,16,15
050,02,185,"Alaska","North Slope Borough",3,76,35,23,12
050,02,185,"Alaska","North Slope Borough",3,77,22,15,7
050,02,185,"Alaska","North Slope Borough",3,78,26,18,8
050,02,185,"Alaska","North Slope Borough",3,79,17,9,8
050,02,185,"Alaska","North Slope Borough",3,80,18,5,13
050,02,185,"Alaska","North Slope Borough",3,81,10,4,6
050,02,185,"Alaska","North Slope Borough",3,82,8,4,4
050,02,185,"Alaska","North Slope Borough",3,83,8,1,7
050,02,185,"Alaska","North Slope Borough",3,84,8,2,6
050,02,185,"Alaska","North Slope Borough",3,85,47,11,36
050,02,185,"Alaska","North Slope Borough",4,0,131,72,59
050,02,185,"Alaska","North Slope Borough",4,1,125,62,63
050,02,185,"Alaska","North Slope Borough",4,2,120,65,55
050,02,185,"Alaska","North Slope Borough",4,3,142,79,63
050,02,185,"Alaska","North Slope Borough",4,4,147,74,73
050,02,185,"Alaska","North Slope Borough",4,5,174,88,86
050,02,185,"Alaska","North Slope Borough",4,6,164,86,78
050,02,185,"Alaska","North Slope Borough",4,7,160,82,78
050,02,185,"Alaska","North Slope Borough",4,8,161,76,85
050,02,185,"Alaska","North Slope Borough",4,9,168,91,77
050,02,185,"Alaska","North Slope Borough",4,10,173,88,85
050,02,185,"Alaska","North Slope Borough",4,11,184,86,98
050,02,185,"Alaska","North Slope Borough",4,12,173,83,90
050,02,185,"Alaska","North Slope Borough",4,13,159,78,81
050,02,185,"Alaska","North Slope Borough",4,14,153,75,78
050,02,185,"Alaska","North Slope Borough",4,15,149,80,69
050,02,185,"Alaska","North Slope Borough",4,16,160,83,77
050,02,185,"Alaska","North Slope Borough",4,17,151,80,71
050,02,185,"Alaska","North Slope Borough",4,18,115,56,59
050,02,185,"Alaska","North Slope Borough",4,19,106,55,51
050,02,185,"Alaska","North Slope Borough",4,20,130,80,50
050,02,185,"Alaska","North Slope Borough",4,21,112,64,48
050,02,185,"Alaska","North Slope Borough",4,22,109,61,48
050,02,185,"Alaska","North Slope Borough",4,23,150,100,50
050,02,185,"Alaska","North Slope Borough",4,24,130,81,49
050,02,185,"Alaska","North Slope Borough",4,25,159,102,57
050,02,185,"Alaska","North Slope Borough",4,26,138,97,41
050,02,185,"Alaska","North Slope Borough",4,27,134,93,41
050,02,185,"Alaska","North Slope Borough",4,28,156,109,47
050,02,185,"Alaska","North Slope Borough",4,29,152,98,54
050,02,185,"Alaska","North Slope Borough",4,30,179,120,59
050,02,185,"Alaska","North Slope Borough",4,31,189,121,68
050,02,185,"Alaska","North Slope Borough",4,32,196,119,77
050,02,185,"Alaska","North Slope Borough",4,33,180,115,65
050,02,185,"Alaska","North Slope Borough",4,34,185,126,59
050,02,185,"Alaska","North Slope Borough",4,35,166,119,47
050,02,185,"Alaska","North Slope Borough",4,36,178,122,56
050,02,185,"Alaska","North Slope Borough",4,37,176,102,74
050,02,185,"Alaska","North Slope Borough",4,38,194,145,49
050,02,185,"Alaska","North Slope Borough",4,39,163,117,46
050,02,185,"Alaska","North Slope Borough",4,40,145,105,40
050,02,185,"Alaska","North Slope Borough",4,41,163,117,46
050,02,185,"Alaska","North Slope Borough",4,42,135,98,37
050,02,185,"Alaska","North Slope Borough",4,43,121,78,43
050,02,185,"Alaska","North Slope Borough",4,44,135,86,49
050,02,185,"Alaska","North Slope Borough",4,45,159,113,46
050,02,185,"Alaska","North Slope Borough",4,46,124,91,33
050,02,185,"Alaska","North Slope Borough",4,47,130,83,47
050,02,185,"Alaska","North Slope Borough",4,48,127,92,35
050,02,185,"Alaska","North Slope Borough",4,49,149,103,46
050,02,185,"Alaska","North Slope Borough",4,50,138,103,35
050,02,185,"Alaska","North Slope Borough",4,51,135,100,35
050,02,185,"Alaska","North Slope Borough",4,52,132,96,36
050,02,185,"Alaska","North Slope Borough",4,53,217,167,50
050,02,185,"Alaska","North Slope Borough",4,54,169,124,45
050,02,185,"Alaska","North Slope Borough",4,55,211,170,41
050,02,185,"Alaska","North Slope Borough",4,56,195,157,38
050,02,185,"Alaska","North Slope Borough",4,57,235,192,43
050,02,185,"Alaska","North Slope Borough",4,58,192,150,42
050,02,185,"Alaska","North Slope Borough",4,59,151,109,42
050,02,185,"Alaska","North Slope Borough",4,60,172,125,47
050,02,185,"Alaska","North Slope Borough",4,61,123,85,38
050,02,185,"Alaska","North Slope Borough",4,62,107,70,37
050,02,185,"Alaska","North Slope Borough",4,63,112,79,33
050,02,185,"Alaska","North Slope Borough",4,64,92,64,28
050,02,185,"Alaska","North Slope Borough",4,65,77,47,30
050,02,185,"Alaska","North Slope Borough",4,66,70,41,29
050,02,185,"Alaska","North Slope Borough",4,67,76,47,29
050,02,185,"Alaska","North Slope Borough",4,68,73,42,31
050,02,185,"Alaska","North Slope Borough",4,69,68,40,28
050,02,185,"Alaska","North Slope Borough",4,70,67,42,25
050,02,185,"Alaska","North Slope Borough",4,71,58,41,17
050,02,185,"Alaska","North Slope Borough",4,72,53,33,20
050,02,185,"Alaska","North Slope Borough",4,73,44,27,17
050,02,185,"Alaska","North Slope Borough",4,74,29,15,14
050,02,185,"Alaska","North Slope Borough",4,75,28,11,17
050,02,185,"Alaska","North Slope Borough",4,76,31,16,15
050,02,185,"Alaska","North Slope Borough",4,77,34,22,12
050,02,185,"Alaska","North Slope Borough",4,78,22,15,7
050,02,185,"Alaska","North Slope Borough",4,79,27,19,8
050,02,185,"Alaska","North Slope Borough",4,80,14,8,6
050,02,185,"Alaska","North Slope Borough",4,81,16,4,12
050,02,185,"Alaska","North Slope Borough",4,82,6,2,4
050,02,185,"Alaska","North Slope Borough",4,83,6,4,2
050,02,185,"Alaska","North Slope Borough",4,84,5,1,4
050,02,185,"Alaska","North Slope Borough",4,85,47,10,37
050,02,185,"Alaska","North Slope Borough",5,0,124,68,56
050,02,185,"Alaska","North Slope Borough",5,1,129,71,58
050,02,185,"Alaska","North Slope Borough",5,2,120,59,61
050,02,185,"Alaska","North Slope Borough",5,3,113,61,52
050,02,185,"Alaska","North Slope Borough",5,4,133,70,63
050,02,185,"Alaska","North Slope Borough",5,5,138,73,65
050,02,185,"Alaska","North Slope Borough",5,6,155,79,76
050,02,185,"Alaska","North Slope Borough",5,7,160,83,77
050,02,185,"Alaska","North Slope Borough",5,8,153,77,76
050,02,185,"Alaska","North Slope Borough",5,9,154,76,78
050,02,185,"Alaska","North Slope Borough",5,10,161,89,72
050,02,185,"Alaska","North Slope Borough",5,11,167,83,84
050,02,185,"Alaska","North Slope Borough",5,12,179,84,95
050,02,185,"Alaska","North Slope Borough",5,13,168,83,85
050,02,185,"Alaska","North Slope Borough",5,14,145,67,78
050,02,185,"Alaska","North Slope Borough",5,15,151,76,75
050,02,185,"Alaska","North Slope Borough",5,16,152,83,69
050,02,185,"Alaska","North Slope Borough",5,17,153,76,77
050,02,185,"Alaska","North Slope Borough",5,18,128,69,59
050,02,185,"Alaska","North Slope Borough",5,19,114,55,59
050,02,185,"Alaska","North Slope Borough",5,20,122,72,50
050,02,185,"Alaska","North Slope Borough",5,21,126,71,55
050,02,185,"Alaska","North Slope Borough",5,22,119,75,44
050,02,185,"Alaska","North Slope Borough",5,23,144,94,50
050,02,185,"Alaska","North Slope Borough",5,24,145,90,55
050,02,185,"Alaska","North Slope Borough",5,25,155,92,63
050,02,185,"Alaska","North Slope Borough",5,26,130,89,41
050,02,185,"Alaska","North Slope Borough",5,27,144,100,44
050,02,185,"Alaska","North Slope Borough",5,28,139,104,35
050,02,185,"Alaska","North Slope Borough",5,29,142,98,44
050,02,185,"Alaska","North Slope Borough",5,30,164,108,56
050,02,185,"Alaska","North Slope Borough",5,31,168,112,56
050,02,185,"Alaska","North Slope Borough",5,32,181,117,64
050,02,185,"Alaska","North Slope Borough",5,33,178,117,61
050,02,185,"Alaska","North Slope Borough",5,34,189,129,60
050,02,185,"Alaska","North Slope Borough",5,35,184,127,57
050,02,185,"Alaska","North Slope Borough",5,36,159,110,49
050,02,185,"Alaska","North Slope Borough",5,37,161,94,67
050,02,185,"Alaska","North Slope Borough",5,38,211,142,69
050,02,185,"Alaska","North Slope Borough",5,39,163,117,46
050,02,185,"Alaska","North Slope Borough",5,40,162,115,47
050,02,185,"Alaska","North Slope Borough",5,41,162,121,41
050,02,185,"Alaska","North Slope Borough",5,42,132,91,41
050,02,185,"Alaska","North Slope Borough",5,43,117,82,35
050,02,185,"Alaska","North Slope Borough",5,44,134,93,41
050,02,185,"Alaska","North Slope Borough",5,45,157,111,46
050,02,185,"Alaska","North Slope Borough",5,46,126,84,42
050,02,185,"Alaska","North Slope Borough",5,47,114,79,35
050,02,185,"Alaska","North Slope Borough",5,48,128,89,39
050,02,185,"Alaska","North Slope Borough",5,49,126,90,36
050,02,185,"Alaska","North Slope Borough",5,50,151,108,43
050,02,185,"Alaska","North Slope Borough",5,51,123,95,28
050,02,185,"Alaska","North Slope Borough",5,52,124,88,36
050,02,185,"Alaska","North Slope Borough",5,53,218,168,50
050,02,185,"Alaska","North Slope Borough",5,54,179,134,45
050,02,185,"Alaska","North Slope Borough",5,55,194,159,35
050,02,185,"Alaska","North Slope Borough",5,56,173,138,35
050,02,185,"Alaska","North Slope Borough",5,57,216,184,32
050,02,185,"Alaska","North Slope Borough",5,58,202,157,45
050,02,185,"Alaska","North Slope Borough",5,59,144,108,36
050,02,185,"Alaska","North Slope Borough",5,60,170,129,41
050,02,185,"Alaska","North Slope Borough",5,61,131,87,44
050,02,185,"Alaska","North Slope Borough",5,62,99,66,33
050,02,185,"Alaska","North Slope Borough",5,63,116,76,40
050,02,185,"Alaska","North Slope Borough",5,64,92,61,31
050,02,185,"Alaska","North Slope Borough",5,65,76,46,30
050,02,185,"Alaska","North Slope Borough",5,66,77,47,30
050,02,185,"Alaska","North Slope Borough",5,67,69,40,29
050,02,185,"Alaska","North Slope Borough",5,68,66,38,28
050,02,185,"Alaska","North Slope Borough",5,69,76,45,31
050,02,185,"Alaska","North Slope Borough",5,70,65,38,27
050,02,185,"Alaska","North Slope Borough",5,71,67,41,26
050,02,185,"Alaska","North Slope Borough",5,72,55,39,16
050,02,185,"Alaska","North Slope Borough",5,73,53,32,21
050,02,185,"Alaska","North Slope Borough",5,74,43,27,16
050,02,185,"Alaska","North Slope Borough",5,75,29,15,14
050,02,185,"Alaska","North Slope Borough",5,76,28,11,17
050,02,185,"Alaska","North Slope Borough",5,77,30,15,15
050,02,185,"Alaska","North Slope Borough",5,78,30,18,12
050,02,185,"Alaska","North Slope Borough",5,79,22,15,7
050,02,185,"Alaska","North Slope Borough",5,80,26,18,8
050,02,185,"Alaska","North Slope Borough",5,81,12,7,5
050,02,185,"Alaska","North Slope Borough",5,82,15,4,11
050,02,185,"Alaska","North Slope Borough",5,83,4,2,2
050,02,185,"Alaska","North Slope Borough",5,84,4,4,0
050,02,185,"Alaska","North Slope Borough",5,85,45,8,37
050,02,188,"Alaska","Northwest Arctic Borough",1,0,168,85,83
050,02,188,"Alaska","Northwest Arctic Borough",1,1,163,76,87
050,02,188,"Alaska","Northwest Arctic Borough",1,2,154,78,76
050,02,188,"Alaska","Northwest Arctic Borough",1,3,173,90,83
050,02,188,"Alaska","Northwest Arctic Borough",1,4,166,87,79
050,02,188,"Alaska","Northwest Arctic Borough",1,5,151,78,73
050,02,188,"Alaska","Northwest Arctic Borough",1,6,173,93,80
050,02,188,"Alaska","Northwest Arctic Borough",1,7,176,99,77
050,02,188,"Alaska","Northwest Arctic Borough",1,8,180,106,74
050,02,188,"Alaska","Northwest Arctic Borough",1,9,201,106,95
050,02,188,"Alaska","Northwest Arctic Borough",1,10,174,80,94
050,02,188,"Alaska","Northwest Arctic Borough",1,11,169,99,70
050,02,188,"Alaska","Northwest Arctic Borough",1,12,160,90,70
050,02,188,"Alaska","Northwest Arctic Borough",1,13,158,88,70
050,02,188,"Alaska","Northwest Arctic Borough",1,14,156,80,76
050,02,188,"Alaska","Northwest Arctic Borough",1,15,142,77,65
050,02,188,"Alaska","Northwest Arctic Borough",1,16,133,71,62
050,02,188,"Alaska","Northwest Arctic Borough",1,17,138,67,71
050,02,188,"Alaska","Northwest Arctic Borough",1,18,116,57,59
050,02,188,"Alaska","Northwest Arctic Borough",1,19,96,49,47
050,02,188,"Alaska","Northwest Arctic Borough",1,20,95,44,51
050,02,188,"Alaska","Northwest Arctic Borough",1,21,115,54,61
050,02,188,"Alaska","Northwest Arctic Borough",1,22,101,58,43
050,02,188,"Alaska","Northwest Arctic Borough",1,23,89,44,45
050,02,188,"Alaska","Northwest Arctic Borough",1,24,81,42,39
050,02,188,"Alaska","Northwest Arctic Borough",1,25,98,43,55
050,02,188,"Alaska","Northwest Arctic Borough",1,26,112,56,56
050,02,188,"Alaska","Northwest Arctic Borough",1,27,106,61,45
050,02,188,"Alaska","Northwest Arctic Borough",1,28,133,74,59
050,02,188,"Alaska","Northwest Arctic Borough",1,29,144,84,60
050,02,188,"Alaska","Northwest Arctic Borough",1,30,129,75,54
050,02,188,"Alaska","Northwest Arctic Borough",1,31,133,66,67
050,02,188,"Alaska","Northwest Arctic Borough",1,32,120,60,60
050,02,188,"Alaska","Northwest Arctic Borough",1,33,121,69,52
050,02,188,"Alaska","Northwest Arctic Borough",1,34,95,55,40
050,02,188,"Alaska","Northwest Arctic Borough",1,35,84,43,41
050,02,188,"Alaska","Northwest Arctic Borough",1,36,83,44,39
050,02,188,"Alaska","Northwest Arctic Borough",1,37,83,47,36
050,02,188,"Alaska","Northwest Arctic Borough",1,38,90,49,41
050,02,188,"Alaska","Northwest Arctic Borough",1,39,92,53,39
050,02,188,"Alaska","Northwest Arctic Borough",1,40,87,45,42
050,02,188,"Alaska","Northwest Arctic Borough",1,41,93,50,43
050,02,188,"Alaska","Northwest Arctic Borough",1,42,66,36,30
050,02,188,"Alaska","Northwest Arctic Borough",1,43,73,45,28
050,02,188,"Alaska","Northwest Arctic Borough",1,44,70,33,37
050,02,188,"Alaska","Northwest Arctic Borough",1,45,73,41,32
050,02,188,"Alaska","Northwest Arctic Borough",1,46,62,36,26
050,02,188,"Alaska","Northwest Arctic Borough",1,47,74,37,37
050,02,188,"Alaska","Northwest Arctic Borough",1,48,67,30,37
050,02,188,"Alaska","Northwest Arctic Borough",1,49,70,40,30
050,02,188,"Alaska","Northwest Arctic Borough",1,50,68,42,26
050,02,188,"Alaska","Northwest Arctic Borough",1,51,69,42,27
050,02,188,"Alaska","Northwest Arctic Borough",1,52,83,48,35
050,02,188,"Alaska","Northwest Arctic Borough",1,53,95,63,32
050,02,188,"Alaska","Northwest Arctic Borough",1,54,88,54,34
050,02,188,"Alaska","Northwest Arctic Borough",1,55,87,51,36
050,02,188,"Alaska","Northwest Arctic Borough",1,56,95,56,39
050,02,188,"Alaska","Northwest Arctic Borough",1,57,88,49,39
050,02,188,"Alaska","Northwest Arctic Borough",1,58,81,43,38
050,02,188,"Alaska","Northwest Arctic Borough",1,59,84,50,34
050,02,188,"Alaska","Northwest Arctic Borough",1,60,78,47,31
050,02,188,"Alaska","Northwest Arctic Borough",1,61,73,43,30
050,02,188,"Alaska","Northwest Arctic Borough",1,62,64,32,32
050,02,188,"Alaska","Northwest Arctic Borough",1,63,72,42,30
050,02,188,"Alaska","Northwest Arctic Borough",1,64,70,36,34
050,02,188,"Alaska","Northwest Arctic Borough",1,65,60,35,25
050,02,188,"Alaska","Northwest Arctic Borough",1,66,52,29,23
050,02,188,"Alaska","Northwest Arctic Borough",1,67,40,24,16
050,02,188,"Alaska","Northwest Arctic Borough",1,68,38,23,15
050,02,188,"Alaska","Northwest Arctic Borough",1,69,29,15,14
050,02,188,"Alaska","Northwest Arctic Borough",1,70,22,12,10
050,02,188,"Alaska","Northwest Arctic Borough",1,71,39,20,19
050,02,188,"Alaska","Northwest Arctic Borough",1,72,38,18,20
050,02,188,"Alaska","Northwest Arctic Borough",1,73,34,17,17
050,02,188,"Alaska","Northwest Arctic Borough",1,74,26,11,15
050,02,188,"Alaska","Northwest Arctic Borough",1,75,23,10,13
050,02,188,"Alaska","Northwest Arctic Borough",1,76,15,8,7
050,02,188,"Alaska","Northwest Arctic Borough",1,77,15,9,6
050,02,188,"Alaska","Northwest Arctic Borough",1,78,20,12,8
050,02,188,"Alaska","Northwest Arctic Borough",1,79,14,7,7
050,02,188,"Alaska","Northwest Arctic Borough",1,80,17,8,9
050,02,188,"Alaska","Northwest Arctic Borough",1,81,20,12,8
050,02,188,"Alaska","Northwest Arctic Borough",1,82,19,11,8
050,02,188,"Alaska","Northwest Arctic Borough",1,83,14,6,8
050,02,188,"Alaska","Northwest Arctic Borough",1,84,6,3,3
050,02,188,"Alaska","Northwest Arctic Borough",1,85,74,18,56
050,02,188,"Alaska","Northwest Arctic Borough",2,0,165,78,87
050,02,188,"Alaska","Northwest Arctic Borough",2,1,161,77,84
050,02,188,"Alaska","Northwest Arctic Borough",2,2,152,76,76
050,02,188,"Alaska","Northwest Arctic Borough",2,3,168,87,81
050,02,188,"Alaska","Northwest Arctic Borough",2,4,167,88,79
050,02,188,"Alaska","Northwest Arctic Borough",2,5,155,81,74
050,02,188,"Alaska","Northwest Arctic Borough",2,6,168,90,78
050,02,188,"Alaska","Northwest Arctic Borough",2,7,175,97,78
050,02,188,"Alaska","Northwest Arctic Borough",2,8,180,105,75
050,02,188,"Alaska","Northwest Arctic Borough",2,9,194,106,88
050,02,188,"Alaska","Northwest Arctic Borough",2,10,180,85,95
050,02,188,"Alaska","Northwest Arctic Borough",2,11,170,94,76
050,02,188,"Alaska","Northwest Arctic Borough",2,12,163,92,71
050,02,188,"Alaska","Northwest Arctic Borough",2,13,157,87,70
050,02,188,"Alaska","Northwest Arctic Borough",2,14,156,83,73
050,02,188,"Alaska","Northwest Arctic Borough",2,15,145,78,67
050,02,188,"Alaska","Northwest Arctic Borough",2,16,137,74,63
050,02,188,"Alaska","Northwest Arctic Borough",2,17,136,68,68
050,02,188,"Alaska","Northwest Arctic Borough",2,18,116,57,59
050,02,188,"Alaska","Northwest Arctic Borough",2,19,98,50,48
050,02,188,"Alaska","Northwest Arctic Borough",2,20,96,46,50
050,02,188,"Alaska","Northwest Arctic Borough",2,21,107,51,56
050,02,188,"Alaska","Northwest Arctic Borough",2,22,103,57,46
050,02,188,"Alaska","Northwest Arctic Borough",2,23,91,47,44
050,02,188,"Alaska","Northwest Arctic Borough",2,24,84,44,40
050,02,188,"Alaska","Northwest Arctic Borough",2,25,96,43,53
050,02,188,"Alaska","Northwest Arctic Borough",2,26,109,54,55
050,02,188,"Alaska","Northwest Arctic Borough",2,27,108,60,48
050,02,188,"Alaska","Northwest Arctic Borough",2,28,126,70,56
050,02,188,"Alaska","Northwest Arctic Borough",2,29,140,79,61
050,02,188,"Alaska","Northwest Arctic Borough",2,30,133,76,57
050,02,188,"Alaska","Northwest Arctic Borough",2,31,132,69,63
050,02,188,"Alaska","Northwest Arctic Borough",2,32,122,60,62
050,02,188,"Alaska","Northwest Arctic Borough",2,33,120,66,54
050,02,188,"Alaska","Northwest Arctic Borough",2,34,99,57,42
050,02,188,"Alaska","Northwest Arctic Borough",2,35,87,47,40
050,02,188,"Alaska","Northwest Arctic Borough",2,36,82,43,39
050,02,188,"Alaska","Northwest Arctic Borough",2,37,82,45,37
050,02,188,"Alaska","Northwest Arctic Borough",2,38,88,48,40
050,02,188,"Alaska","Northwest Arctic Borough",2,39,93,53,40
050,02,188,"Alaska","Northwest Arctic Borough",2,40,90,48,42
050,02,188,"Alaska","Northwest Arctic Borough",2,41,90,47,43
050,02,188,"Alaska","Northwest Arctic Borough",2,42,73,40,33
050,02,188,"Alaska","Northwest Arctic Borough",2,43,73,43,30
050,02,188,"Alaska","Northwest Arctic Borough",2,44,69,34,35
050,02,188,"Alaska","Northwest Arctic Borough",2,45,72,39,33
050,02,188,"Alaska","Northwest Arctic Borough",2,46,63,36,27
050,02,188,"Alaska","Northwest Arctic Borough",2,47,70,36,34
050,02,188,"Alaska","Northwest Arctic Borough",2,48,69,33,36
050,02,188,"Alaska","Northwest Arctic Borough",2,49,67,36,31
050,02,188,"Alaska","Northwest Arctic Borough",2,50,67,40,27
050,02,188,"Alaska","Northwest Arctic Borough",2,51,70,43,27
050,02,188,"Alaska","Northwest Arctic Borough",2,52,81,48,33
050,02,188,"Alaska","Northwest Arctic Borough",2,53,92,59,33
050,02,188,"Alaska","Northwest Arctic Borough",2,54,90,57,33
050,02,188,"Alaska","Northwest Arctic Borough",2,55,88,52,36
050,02,188,"Alaska","Northwest Arctic Borough",2,56,94,55,39
050,02,188,"Alaska","Northwest Arctic Borough",2,57,90,50,40
050,02,188,"Alaska","Northwest Arctic Borough",2,58,82,45,37
050,02,188,"Alaska","Northwest Arctic Borough",2,59,84,47,37
050,02,188,"Alaska","Northwest Arctic Borough",2,60,77,46,31
050,02,188,"Alaska","Northwest Arctic Borough",2,61,75,45,30
050,02,188,"Alaska","Northwest Arctic Borough",2,62,65,34,31
050,02,188,"Alaska","Northwest Arctic Borough",2,63,71,41,30
050,02,188,"Alaska","Northwest Arctic Borough",2,64,69,37,32
050,02,188,"Alaska","Northwest Arctic Borough",2,65,64,36,28
050,02,188,"Alaska","Northwest Arctic Borough",2,66,54,30,24
050,02,188,"Alaska","Northwest Arctic Borough",2,67,41,25,16
050,02,188,"Alaska","Northwest Arctic Borough",2,68,37,22,15
050,02,188,"Alaska","Northwest Arctic Borough",2,69,30,17,13
050,02,188,"Alaska","Northwest Arctic Borough",2,70,23,12,11
050,02,188,"Alaska","Northwest Arctic Borough",2,71,35,18,17
050,02,188,"Alaska","Northwest Arctic Borough",2,72,37,18,19
050,02,188,"Alaska","Northwest Arctic Borough",2,73,36,18,18
050,02,188,"Alaska","Northwest Arctic Borough",2,74,27,11,16
050,02,188,"Alaska","Northwest Arctic Borough",2,75,24,10,14
050,02,188,"Alaska","Northwest Arctic Borough",2,76,15,7,8
050,02,188,"Alaska","Northwest Arctic Borough",2,77,16,9,7
050,02,188,"Alaska","Northwest Arctic Borough",2,78,19,12,7
050,02,188,"Alaska","Northwest Arctic Borough",2,79,15,8,7
050,02,188,"Alaska","Northwest Arctic Borough",2,80,16,8,8
050,02,188,"Alaska","Northwest Arctic Borough",2,81,19,11,8
050,02,188,"Alaska","Northwest Arctic Borough",2,82,20,12,8
050,02,188,"Alaska","Northwest Arctic Borough",2,83,15,7,8
050,02,188,"Alaska","Northwest Arctic Borough",2,84,8,4,4
050,02,188,"Alaska","Northwest Arctic Borough",2,85,74,19,55
050,02,188,"Alaska","Northwest Arctic Borough",3,0,175,88,87
050,02,188,"Alaska","Northwest Arctic Borough",3,1,149,62,87
050,02,188,"Alaska","Northwest Arctic Borough",3,2,158,79,79
050,02,188,"Alaska","Northwest Arctic Borough",3,3,141,66,75
050,02,188,"Alaska","Northwest Arctic Borough",3,4,164,85,79
050,02,188,"Alaska","Northwest Arctic Borough",3,5,158,77,81
050,02,188,"Alaska","Northwest Arctic Borough",3,6,152,77,75
050,02,188,"Alaska","Northwest Arctic Borough",3,7,161,90,71
050,02,188,"Alaska","Northwest Arctic Borough",3,8,177,95,82
050,02,188,"Alaska","Northwest Arctic Borough",3,9,165,98,67
050,02,188,"Alaska","Northwest Arctic Borough",3,10,188,100,88
050,02,188,"Alaska","Northwest Arctic Borough",3,11,166,77,89
050,02,188,"Alaska","Northwest Arctic Borough",3,12,164,90,74
050,02,188,"Alaska","Northwest Arctic Borough",3,13,162,94,68
050,02,188,"Alaska","Northwest Arctic Borough",3,14,153,87,66
050,02,188,"Alaska","Northwest Arctic Borough",3,15,156,83,73
050,02,188,"Alaska","Northwest Arctic Borough",3,16,146,79,67
050,02,188,"Alaska","Northwest Arctic Borough",3,17,131,72,59
050,02,188,"Alaska","Northwest Arctic Borough",3,18,120,58,62
050,02,188,"Alaska","Northwest Arctic Borough",3,19,108,57,51
050,02,188,"Alaska","Northwest Arctic Borough",3,20,109,58,51
050,02,188,"Alaska","Northwest Arctic Borough",3,21,98,42,56
050,02,188,"Alaska","Northwest Arctic Borough",3,22,100,47,53
050,02,188,"Alaska","Northwest Arctic Borough",3,23,103,55,48
050,02,188,"Alaska","Northwest Arctic Borough",3,24,89,50,39
050,02,188,"Alaska","Northwest Arctic Borough",3,25,79,38,41
050,02,188,"Alaska","Northwest Arctic Borough",3,26,92,43,49
050,02,188,"Alaska","Northwest Arctic Borough",3,27,102,50,52
050,02,188,"Alaska","Northwest Arctic Borough",3,28,96,49,47
050,02,188,"Alaska","Northwest Arctic Borough",3,29,122,68,54
050,02,188,"Alaska","Northwest Arctic Borough",3,30,135,76,59
050,02,188,"Alaska","Northwest Arctic Borough",3,31,130,80,50
050,02,188,"Alaska","Northwest Arctic Borough",3,32,114,61,53
050,02,188,"Alaska","Northwest Arctic Borough",3,33,117,58,59
050,02,188,"Alaska","Northwest Arctic Borough",3,34,109,60,49
050,02,188,"Alaska","Northwest Arctic Borough",3,35,95,54,41
050,02,188,"Alaska","Northwest Arctic Borough",3,36,86,45,41
050,02,188,"Alaska","Northwest Arctic Borough",3,37,78,39,39
050,02,188,"Alaska","Northwest Arctic Borough",3,38,82,44,38
050,02,188,"Alaska","Northwest Arctic Borough",3,39,86,49,37
050,02,188,"Alaska","Northwest Arctic Borough",3,40,90,49,41
050,02,188,"Alaska","Northwest Arctic Borough",3,41,86,48,38
050,02,188,"Alaska","Northwest Arctic Borough",3,42,85,47,38
050,02,188,"Alaska","Northwest Arctic Borough",3,43,68,38,30
050,02,188,"Alaska","Northwest Arctic Borough",3,44,70,41,29
050,02,188,"Alaska","Northwest Arctic Borough",3,45,64,33,31
050,02,188,"Alaska","Northwest Arctic Borough",3,46,68,36,32
050,02,188,"Alaska","Northwest Arctic Borough",3,47,67,41,26
050,02,188,"Alaska","Northwest Arctic Borough",3,48,65,35,30
050,02,188,"Alaska","Northwest Arctic Borough",3,49,56,22,34
050,02,188,"Alaska","Northwest Arctic Borough",3,50,65,33,32
050,02,188,"Alaska","Northwest Arctic Borough",3,51,62,39,23
050,02,188,"Alaska","Northwest Arctic Borough",3,52,70,42,28
050,02,188,"Alaska","Northwest Arctic Borough",3,53,76,44,32
050,02,188,"Alaska","Northwest Arctic Borough",3,54,83,53,30
050,02,188,"Alaska","Northwest Arctic Borough",3,55,89,57,32
050,02,188,"Alaska","Northwest Arctic Borough",3,56,85,49,36
050,02,188,"Alaska","Northwest Arctic Borough",3,57,97,57,40
050,02,188,"Alaska","Northwest Arctic Borough",3,58,74,42,32
050,02,188,"Alaska","Northwest Arctic Borough",3,59,79,45,34
050,02,188,"Alaska","Northwest Arctic Borough",3,60,86,47,39
050,02,188,"Alaska","Northwest Arctic Borough",3,61,75,44,31
050,02,188,"Alaska","Northwest Arctic Borough",3,62,66,41,25
050,02,188,"Alaska","Northwest Arctic Borough",3,63,64,35,29
050,02,188,"Alaska","Northwest Arctic Borough",3,64,68,37,31
050,02,188,"Alaska","Northwest Arctic Borough",3,65,60,32,28
050,02,188,"Alaska","Northwest Arctic Borough",3,66,63,33,30
050,02,188,"Alaska","Northwest Arctic Borough",3,67,51,27,24
050,02,188,"Alaska","Northwest Arctic Borough",3,68,40,25,15
050,02,188,"Alaska","Northwest Arctic Borough",3,69,35,20,15
050,02,188,"Alaska","Northwest Arctic Borough",3,70,26,15,11
050,02,188,"Alaska","Northwest Arctic Borough",3,71,21,11,10
050,02,188,"Alaska","Northwest Arctic Borough",3,72,34,16,18
050,02,188,"Alaska","Northwest Arctic Borough",3,73,35,16,19
050,02,188,"Alaska","Northwest Arctic Borough",3,74,41,18,23
050,02,188,"Alaska","Northwest Arctic Borough",3,75,28,11,17
050,02,188,"Alaska","Northwest Arctic Borough",3,76,19,8,11
050,02,188,"Alaska","Northwest Arctic Borough",3,77,16,7,9
050,02,188,"Alaska","Northwest Arctic Borough",3,78,13,7,6
050,02,188,"Alaska","Northwest Arctic Borough",3,79,20,11,9
050,02,188,"Alaska","Northwest Arctic Borough",3,80,14,6,8
050,02,188,"Alaska","Northwest Arctic Borough",3,81,15,7,8
050,02,188,"Alaska","Northwest Arctic Borough",3,82,17,9,8
050,02,188,"Alaska","Northwest Arctic Borough",3,83,21,12,9
050,02,188,"Alaska","Northwest Arctic Borough",3,84,16,7,9
050,02,188,"Alaska","Northwest Arctic Borough",3,85,76,23,53
050,02,188,"Alaska","Northwest Arctic Borough",4,0,141,63,78
050,02,188,"Alaska","Northwest Arctic Borough",4,1,179,86,93
050,02,188,"Alaska","Northwest Arctic Borough",4,2,140,54,86
050,02,188,"Alaska","Northwest Arctic Borough",4,3,156,75,81
050,02,188,"Alaska","Northwest Arctic Borough",4,4,138,68,70
050,02,188,"Alaska","Northwest Arctic Borough",4,5,153,76,77
050,02,188,"Alaska","Northwest Arctic Borough",4,6,155,74,81
050,02,188,"Alaska","Northwest Arctic Borough",4,7,150,76,74
050,02,188,"Alaska","Northwest Arctic Borough",4,8,157,86,71
050,02,188,"Alaska","Northwest Arctic Borough",4,9,178,97,81
050,02,188,"Alaska","Northwest Arctic Borough",4,10,168,101,67
050,02,188,"Alaska","Northwest Arctic Borough",4,11,188,101,87
050,02,188,"Alaska","Northwest Arctic Borough",4,12,166,79,87
050,02,188,"Alaska","Northwest Arctic Borough",4,13,163,92,71
050,02,188,"Alaska","Northwest Arctic Borough",4,14,158,88,70
050,02,188,"Alaska","Northwest Arctic Borough",4,15,146,82,64
050,02,188,"Alaska","Northwest Arctic Borough",4,16,155,82,73
050,02,188,"Alaska","Northwest Arctic Borough",4,17,139,77,62
050,02,188,"Alaska","Northwest Arctic Borough",4,18,111,62,49
050,02,188,"Alaska","Northwest Arctic Borough",4,19,99,47,52
050,02,188,"Alaska","Northwest Arctic Borough",4,20,95,54,41
050,02,188,"Alaska","Northwest Arctic Borough",4,21,92,50,42
050,02,188,"Alaska","Northwest Arctic Borough",4,22,90,39,51
050,02,188,"Alaska","Northwest Arctic Borough",4,23,92,42,50
050,02,188,"Alaska","Northwest Arctic Borough",4,24,98,57,41
050,02,188,"Alaska","Northwest Arctic Borough",4,25,82,44,38
050,02,188,"Alaska","Northwest Arctic Borough",4,26,75,39,36
050,02,188,"Alaska","Northwest Arctic Borough",4,27,93,43,50
050,02,188,"Alaska","Northwest Arctic Borough",4,28,102,52,50
050,02,188,"Alaska","Northwest Arctic Borough",4,29,93,49,44
050,02,188,"Alaska","Northwest Arctic Borough",4,30,117,67,50
050,02,188,"Alaska","Northwest Arctic Borough",4,31,129,71,58
050,02,188,"Alaska","Northwest Arctic Borough",4,32,121,73,48
050,02,188,"Alaska","Northwest Arctic Borough",4,33,123,66,57
050,02,188,"Alaska","Northwest Arctic Borough",4,34,116,63,53
050,02,188,"Alaska","Northwest Arctic Borough",4,35,109,63,46
050,02,188,"Alaska","Northwest Arctic Borough",4,36,94,53,41
050,02,188,"Alaska","Northwest Arctic Borough",4,37,84,45,39
050,02,188,"Alaska","Northwest Arctic Borough",4,38,79,43,36
050,02,188,"Alaska","Northwest Arctic Borough",4,39,79,46,33
050,02,188,"Alaska","Northwest Arctic Borough",4,40,82,43,39
050,02,188,"Alaska","Northwest Arctic Borough",4,41,84,46,38
050,02,188,"Alaska","Northwest Arctic Borough",4,42,78,42,36
050,02,188,"Alaska","Northwest Arctic Borough",4,43,83,44,39
050,02,188,"Alaska","Northwest Arctic Borough",4,44,61,34,27
050,02,188,"Alaska","Northwest Arctic Borough",4,45,66,41,25
050,02,188,"Alaska","Northwest Arctic Borough",4,46,61,30,31
050,02,188,"Alaska","Northwest Arctic Borough",4,47,65,35,30
050,02,188,"Alaska","Northwest Arctic Borough",4,48,68,39,29
050,02,188,"Alaska","Northwest Arctic Borough",4,49,60,31,29
050,02,188,"Alaska","Northwest Arctic Borough",4,50,50,20,30
050,02,188,"Alaska","Northwest Arctic Borough",4,51,66,33,33
050,02,188,"Alaska","Northwest Arctic Borough",4,52,59,35,24
050,02,188,"Alaska","Northwest Arctic Borough",4,53,65,41,24
050,02,188,"Alaska","Northwest Arctic Borough",4,54,75,46,29
050,02,188,"Alaska","Northwest Arctic Borough",4,55,77,51,26
050,02,188,"Alaska","Northwest Arctic Borough",4,56,82,53,29
050,02,188,"Alaska","Northwest Arctic Borough",4,57,84,48,36
050,02,188,"Alaska","Northwest Arctic Borough",4,58,91,55,36
050,02,188,"Alaska","Northwest Arctic Borough",4,59,68,42,26
050,02,188,"Alaska","Northwest Arctic Borough",4,60,72,38,34
050,02,188,"Alaska","Northwest Arctic Borough",4,61,80,46,34
050,02,188,"Alaska","Northwest Arctic Borough",4,62,71,40,31
050,02,188,"Alaska","Northwest Arctic Borough",4,63,60,37,23
050,02,188,"Alaska","Northwest Arctic Borough",4,64,57,26,31
050,02,188,"Alaska","Northwest Arctic Borough",4,65,68,38,30
050,02,188,"Alaska","Northwest Arctic Borough",4,66,58,30,28
050,02,188,"Alaska","Northwest Arctic Borough",4,67,59,29,30
050,02,188,"Alaska","Northwest Arctic Borough",4,68,54,30,24
050,02,188,"Alaska","Northwest Arctic Borough",4,69,37,22,15
050,02,188,"Alaska","Northwest Arctic Borough",4,70,31,16,15
050,02,188,"Alaska","Northwest Arctic Borough",4,71,23,14,9
050,02,188,"Alaska","Northwest Arctic Borough",4,72,18,9,9
050,02,188,"Alaska","Northwest Arctic Borough",4,73,29,13,16
050,02,188,"Alaska","Northwest Arctic Borough",4,74,36,16,20
050,02,188,"Alaska","Northwest Arctic Borough",4,75,40,17,23
050,02,188,"Alaska","Northwest Arctic Borough",4,76,23,10,13
050,02,188,"Alaska","Northwest Arctic Borough",4,77,21,8,13
050,02,188,"Alaska","Northwest Arctic Borough",4,78,13,5,8
050,02,188,"Alaska","Northwest Arctic Borough",4,79,13,5,8
050,02,188,"Alaska","Northwest Arctic Borough",4,80,20,11,9
050,02,188,"Alaska","Northwest Arctic Borough",4,81,13,6,7
050,02,188,"Alaska","Northwest Arctic Borough",4,82,10,2,8
050,02,188,"Alaska","Northwest Arctic Borough",4,83,16,8,8
050,02,188,"Alaska","Northwest Arctic Borough",4,84,20,12,8
050,02,188,"Alaska","Northwest Arctic Borough",4,85,83,28,55
050,02,188,"Alaska","Northwest Arctic Borough",5,0,141,62,79
050,02,188,"Alaska","Northwest Arctic Borough",5,1,131,57,74
050,02,188,"Alaska","Northwest Arctic Borough",5,2,163,81,82
050,02,188,"Alaska","Northwest Arctic Borough",5,3,138,51,87
050,02,188,"Alaska","Northwest Arctic Borough",5,4,154,75,79
050,02,188,"Alaska","Northwest Arctic Borough",5,5,143,67,76
050,02,188,"Alaska","Northwest Arctic Borough",5,6,160,77,83
050,02,188,"Alaska","Northwest Arctic Borough",5,7,154,73,81
050,02,188,"Alaska","Northwest Arctic Borough",5,8,148,77,71
050,02,188,"Alaska","Northwest Arctic Borough",5,9,157,87,70
050,02,188,"Alaska","Northwest Arctic Borough",5,10,175,95,80
050,02,188,"Alaska","Northwest Arctic Borough",5,11,164,99,65
050,02,188,"Alaska","Northwest Arctic Borough",5,12,190,100,90
050,02,188,"Alaska","Northwest Arctic Borough",5,13,172,84,88
050,02,188,"Alaska","Northwest Arctic Borough",5,14,161,89,72
050,02,188,"Alaska","Northwest Arctic Borough",5,15,161,89,72
050,02,188,"Alaska","Northwest Arctic Borough",5,16,144,77,67
050,02,188,"Alaska","Northwest Arctic Borough",5,17,154,83,71
050,02,188,"Alaska","Northwest Arctic Borough",5,18,117,68,49
050,02,188,"Alaska","Northwest Arctic Borough",5,19,93,53,40
050,02,188,"Alaska","Northwest Arctic Borough",5,20,99,51,48
050,02,188,"Alaska","Northwest Arctic Borough",5,21,94,48,46
050,02,188,"Alaska","Northwest Arctic Borough",5,22,87,48,39
050,02,188,"Alaska","Northwest Arctic Borough",5,23,84,39,45
050,02,188,"Alaska","Northwest Arctic Borough",5,24,95,45,50
050,02,188,"Alaska","Northwest Arctic Borough",5,25,95,52,43
050,02,188,"Alaska","Northwest Arctic Borough",5,26,82,47,35
050,02,188,"Alaska","Northwest Arctic Borough",5,27,77,39,38
050,02,188,"Alaska","Northwest Arctic Borough",5,28,93,46,47
050,02,188,"Alaska","Northwest Arctic Borough",5,29,105,53,52
050,02,188,"Alaska","Northwest Arctic Borough",5,30,94,49,45
050,02,188,"Alaska","Northwest Arctic Borough",5,31,113,64,49
050,02,188,"Alaska","Northwest Arctic Borough",5,32,117,66,51
050,02,188,"Alaska","Northwest Arctic Borough",5,33,116,72,44
050,02,188,"Alaska","Northwest Arctic Borough",5,34,115,65,50
050,02,188,"Alaska","Northwest Arctic Borough",5,35,105,62,43
050,02,188,"Alaska","Northwest Arctic Borough",5,36,111,64,47
050,02,188,"Alaska","Northwest Arctic Borough",5,37,86,47,39
050,02,188,"Alaska","Northwest Arctic Borough",5,38,82,44,38
050,02,188,"Alaska","Northwest Arctic Borough",5,39,84,48,36
050,02,188,"Alaska","Northwest Arctic Borough",5,40,73,42,31
050,02,188,"Alaska","Northwest Arctic Borough",5,41,80,41,39
050,02,188,"Alaska","Northwest Arctic Borough",5,42,87,47,40
050,02,188,"Alaska","Northwest Arctic Borough",5,43,77,38,39
050,02,188,"Alaska","Northwest Arctic Borough",5,44,81,43,38
050,02,188,"Alaska","Northwest Arctic Borough",5,45,55,33,22
050,02,188,"Alaska","Northwest Arctic Borough",5,46,64,38,26
050,02,188,"Alaska","Northwest Arctic Borough",5,47,63,31,32
050,02,188,"Alaska","Northwest Arctic Borough",5,48,66,36,30
050,02,188,"Alaska","Northwest Arctic Borough",5,49,63,34,29
050,02,188,"Alaska","Northwest Arctic Borough",5,50,59,32,27
050,02,188,"Alaska","Northwest Arctic Borough",5,51,48,23,25
050,02,188,"Alaska","Northwest Arctic Borough",5,52,63,32,31
050,02,188,"Alaska","Northwest Arctic Borough",5,53,65,39,26
050,02,188,"Alaska","Northwest Arctic Borough",5,54,61,38,23
050,02,188,"Alaska","Northwest Arctic Borough",5,55,71,41,30
050,02,188,"Alaska","Northwest Arctic Borough",5,56,76,52,24
050,02,188,"Alaska","Northwest Arctic Borough",5,57,80,49,31
050,02,188,"Alaska","Northwest Arctic Borough",5,58,77,45,32
050,02,188,"Alaska","Northwest Arctic Borough",5,59,81,47,34
050,02,188,"Alaska","Northwest Arctic Borough",5,60,60,34,26
050,02,188,"Alaska","Northwest Arctic Borough",5,61,70,40,30
050,02,188,"Alaska","Northwest Arctic Borough",5,62,77,43,34
050,02,188,"Alaska","Northwest Arctic Borough",5,63,70,42,28
050,02,188,"Alaska","Northwest Arctic Borough",5,64,51,28,23
050,02,188,"Alaska","Northwest Arctic Borough",5,65,58,27,31
050,02,188,"Alaska","Northwest Arctic Borough",5,66,65,36,29
050,02,188,"Alaska","Northwest Arctic Borough",5,67,54,26,28
050,02,188,"Alaska","Northwest Arctic Borough",5,68,58,30,28
050,02,188,"Alaska","Northwest Arctic Borough",5,69,53,27,26
050,02,188,"Alaska","Northwest Arctic Borough",5,70,34,18,16
050,02,188,"Alaska","Northwest Arctic Borough",5,71,29,15,14
050,02,188,"Alaska","Northwest Arctic Borough",5,72,18,11,7
050,02,188,"Alaska","Northwest Arctic Borough",5,73,14,7,7
050,02,188,"Alaska","Northwest Arctic Borough",5,74,29,12,17
050,02,188,"Alaska","Northwest Arctic Borough",5,75,33,14,19
050,02,188,"Alaska","Northwest Arctic Borough",5,76,35,15,20
050,02,188,"Alaska","Northwest Arctic Borough",5,77,23,10,13
050,02,188,"Alaska","Northwest Arctic Borough",5,78,17,6,11
050,02,188,"Alaska","Northwest Arctic Borough",5,79,13,3,10
050,02,188,"Alaska","Northwest Arctic Borough",5,80,13,5,8
050,02,188,"Alaska","Northwest Arctic Borough",5,81,20,11,9
050,02,188,"Alaska","Northwest Arctic Borough",5,82,9,2,7
050,02,188,"Alaska","Northwest Arctic Borough",5,83,9,1,8
050,02,188,"Alaska","Northwest Arctic Borough",5,84,15,8,7
050,02,188,"Alaska","Northwest Arctic Borough",5,85,90,35,55
050,02,195,"Alaska","Petersburg Borough",1,0,26,14,12
050,02,195,"Alaska","Petersburg Borough",1,1,27,13,14
050,02,195,"Alaska","Petersburg Borough",1,2,42,22,20
050,02,195,"Alaska","Petersburg Borough",1,3,37,22,15
050,02,195,"Alaska","Petersburg Borough",1,4,41,22,19
050,02,195,"Alaska","Petersburg Borough",1,5,48,19,29
050,02,195,"Alaska","Petersburg Borough",1,6,44,16,28
050,02,195,"Alaska","Petersburg Borough",1,7,40,14,26
050,02,195,"Alaska","Petersburg Borough",1,8,48,20,28
050,02,195,"Alaska","Petersburg Borough",1,9,43,22,21
050,02,195,"Alaska","Petersburg Borough",1,10,42,20,22
050,02,195,"Alaska","Petersburg Borough",1,11,44,22,22
050,02,195,"Alaska","Petersburg Borough",1,12,36,17,19
050,02,195,"Alaska","Petersburg Borough",1,13,42,20,22
050,02,195,"Alaska","Petersburg Borough",1,14,39,18,21
050,02,195,"Alaska","Petersburg Borough",1,15,33,16,17
050,02,195,"Alaska","Petersburg Borough",1,16,35,19,16
050,02,195,"Alaska","Petersburg Borough",1,17,36,18,18
050,02,195,"Alaska","Petersburg Borough",1,18,35,17,18
050,02,195,"Alaska","Petersburg Borough",1,19,43,23,20
050,02,195,"Alaska","Petersburg Borough",1,20,53,35,18
050,02,195,"Alaska","Petersburg Borough",1,21,55,37,18
050,02,195,"Alaska","Petersburg Borough",1,22,51,35,16
050,02,195,"Alaska","Petersburg Borough",1,23,48,31,17
050,02,195,"Alaska","Petersburg Borough",1,24,37,24,13
050,02,195,"Alaska","Petersburg Borough",1,25,37,20,17
050,02,195,"Alaska","Petersburg Borough",1,26,40,24,16
050,02,195,"Alaska","Petersburg Borough",1,27,40,18,22
050,02,195,"Alaska","Petersburg Borough",1,28,34,14,20
050,02,195,"Alaska","Petersburg Borough",1,29,44,20,24
050,02,195,"Alaska","Petersburg Borough",1,30,45,26,19
050,02,195,"Alaska","Petersburg Borough",1,31,37,18,19
050,02,195,"Alaska","Petersburg Borough",1,32,47,24,23
050,02,195,"Alaska","Petersburg Borough",1,33,49,26,23
050,02,195,"Alaska","Petersburg Borough",1,34,53,30,23
050,02,195,"Alaska","Petersburg Borough",1,35,43,22,21
050,02,195,"Alaska","Petersburg Borough",1,36,37,15,22
050,02,195,"Alaska","Petersburg Borough",1,37,42,20,22
050,02,195,"Alaska","Petersburg Borough",1,38,45,20,25
050,02,195,"Alaska","Petersburg Borough",1,39,39,19,20
050,02,195,"Alaska","Petersburg Borough",1,40,34,18,16
050,02,195,"Alaska","Petersburg Borough",1,41,54,31,23
050,02,195,"Alaska","Petersburg Borough",1,42,44,20,24
050,02,195,"Alaska","Petersburg Borough",1,43,33,17,16
050,02,195,"Alaska","Petersburg Borough",1,44,24,12,12
050,02,195,"Alaska","Petersburg Borough",1,45,36,21,15
050,02,195,"Alaska","Petersburg Borough",1,46,33,20,13
050,02,195,"Alaska","Petersburg Borough",1,47,34,16,18
050,02,195,"Alaska","Petersburg Borough",1,48,36,18,18
050,02,195,"Alaska","Petersburg Borough",1,49,49,28,21
050,02,195,"Alaska","Petersburg Borough",1,50,45,26,19
050,02,195,"Alaska","Petersburg Borough",1,51,41,24,17
050,02,195,"Alaska","Petersburg Borough",1,52,41,27,14
050,02,195,"Alaska","Petersburg Borough",1,53,38,25,13
050,02,195,"Alaska","Petersburg Borough",1,54,42,22,20
050,02,195,"Alaska","Petersburg Borough",1,55,49,27,22
050,02,195,"Alaska","Petersburg Borough",1,56,48,32,16
050,02,195,"Alaska","Petersburg Borough",1,57,50,28,22
050,02,195,"Alaska","Petersburg Borough",1,58,50,22,28
050,02,195,"Alaska","Petersburg Borough",1,59,54,25,29
050,02,195,"Alaska","Petersburg Borough",1,60,44,26,18
050,02,195,"Alaska","Petersburg Borough",1,61,43,19,24
050,02,195,"Alaska","Petersburg Borough",1,62,51,30,21
050,02,195,"Alaska","Petersburg Borough",1,63,48,26,22
050,02,195,"Alaska","Petersburg Borough",1,64,59,27,32
050,02,195,"Alaska","Petersburg Borough",1,65,48,25,23
050,02,195,"Alaska","Petersburg Borough",1,66,47,27,20
050,02,195,"Alaska","Petersburg Borough",1,67,55,28,27
050,02,195,"Alaska","Petersburg Borough",1,68,54,31,23
050,02,195,"Alaska","Petersburg Borough",1,69,47,28,19
050,02,195,"Alaska","Petersburg Borough",1,70,44,26,18
050,02,195,"Alaska","Petersburg Borough",1,71,48,30,18
050,02,195,"Alaska","Petersburg Borough",1,72,36,20,16
050,02,195,"Alaska","Petersburg Borough",1,73,27,12,15
050,02,195,"Alaska","Petersburg Borough",1,74,23,12,11
050,02,195,"Alaska","Petersburg Borough",1,75,25,14,11
050,02,195,"Alaska","Petersburg Borough",1,76,32,18,14
050,02,195,"Alaska","Petersburg Borough",1,77,23,13,10
050,02,195,"Alaska","Petersburg Borough",1,78,22,17,5
050,02,195,"Alaska","Petersburg Borough",1,79,24,13,11
050,02,195,"Alaska","Petersburg Borough",1,80,15,7,8
050,02,195,"Alaska","Petersburg Borough",1,81,11,3,8
050,02,195,"Alaska","Petersburg Borough",1,82,8,2,6
050,02,195,"Alaska","Petersburg Borough",1,83,9,3,6
050,02,195,"Alaska","Petersburg Borough",1,84,8,6,2
050,02,195,"Alaska","Petersburg Borough",1,85,54,22,32
050,02,195,"Alaska","Petersburg Borough",2,0,34,17,17
050,02,195,"Alaska","Petersburg Borough",2,1,27,13,14
050,02,195,"Alaska","Petersburg Borough",2,2,40,21,19
050,02,195,"Alaska","Petersburg Borough",2,3,38,22,16
050,02,195,"Alaska","Petersburg Borough",2,4,40,22,18
050,02,195,"Alaska","Petersburg Borough",2,5,45,19,26
050,02,195,"Alaska","Petersburg Borough",2,6,45,17,28
050,02,195,"Alaska","Petersburg Borough",2,7,41,16,25
050,02,195,"Alaska","Petersburg Borough",2,8,45,19,26
050,02,195,"Alaska","Petersburg Borough",2,9,45,22,23
050,02,195,"Alaska","Petersburg Borough",2,10,42,21,21
050,02,195,"Alaska","Petersburg Borough",2,11,43,21,22
050,02,195,"Alaska","Petersburg Borough",2,12,38,18,20
050,02,195,"Alaska","Petersburg Borough",2,13,42,20,22
050,02,195,"Alaska","Petersburg Borough",2,14,40,18,22
050,02,195,"Alaska","Petersburg Borough",2,15,34,17,17
050,02,195,"Alaska","Petersburg Borough",2,16,35,18,17
050,02,195,"Alaska","Petersburg Borough",2,17,36,18,18
050,02,195,"Alaska","Petersburg Borough",2,18,33,16,17
050,02,195,"Alaska","Petersburg Borough",2,19,41,22,19
050,02,195,"Alaska","Petersburg Borough",2,20,54,35,19
050,02,195,"Alaska","Petersburg Borough",2,21,53,35,18
050,02,195,"Alaska","Petersburg Borough",2,22,51,35,16
050,02,195,"Alaska","Petersburg Borough",2,23,49,31,18
050,02,195,"Alaska","Petersburg Borough",2,24,39,26,13
050,02,195,"Alaska","Petersburg Borough",2,25,36,20,16
050,02,195,"Alaska","Petersburg Borough",2,26,38,23,15
050,02,195,"Alaska","Petersburg Borough",2,27,40,18,22
050,02,195,"Alaska","Petersburg Borough",2,28,36,15,21
050,02,195,"Alaska","Petersburg Borough",2,29,43,19,24
050,02,195,"Alaska","Petersburg Borough",2,30,44,24,20
050,02,195,"Alaska","Petersburg Borough",2,31,40,21,19
050,02,195,"Alaska","Petersburg Borough",2,32,46,24,22
050,02,195,"Alaska","Petersburg Borough",2,33,49,26,23
050,02,195,"Alaska","Petersburg Borough",2,34,53,30,23
050,02,195,"Alaska","Petersburg Borough",2,35,46,25,21
050,02,195,"Alaska","Petersburg Borough",2,36,38,16,22
050,02,195,"Alaska","Petersburg Borough",2,37,44,21,23
050,02,195,"Alaska","Petersburg Borough",2,38,45,20,25
050,02,195,"Alaska","Petersburg Borough",2,39,39,19,20
050,02,195,"Alaska","Petersburg Borough",2,40,37,19,18
050,02,195,"Alaska","Petersburg Borough",2,41,49,28,21
050,02,195,"Alaska","Petersburg Borough",2,42,44,21,23
050,02,195,"Alaska","Petersburg Borough",2,43,36,18,18
050,02,195,"Alaska","Petersburg Borough",2,44,26,13,13
050,02,195,"Alaska","Petersburg Borough",2,45,36,21,15
050,02,195,"Alaska","Petersburg Borough",2,46,32,19,13
050,02,195,"Alaska","Petersburg Borough",2,47,34,17,17
050,02,195,"Alaska","Petersburg Borough",2,48,36,18,18
050,02,195,"Alaska","Petersburg Borough",2,49,47,26,21
050,02,195,"Alaska","Petersburg Borough",2,50,47,26,21
050,02,195,"Alaska","Petersburg Borough",2,51,42,25,17
050,02,195,"Alaska","Petersburg Borough",2,52,41,27,14
050,02,195,"Alaska","Petersburg Borough",2,53,38,25,13
050,02,195,"Alaska","Petersburg Borough",2,54,38,21,17
050,02,195,"Alaska","Petersburg Borough",2,55,49,26,23
050,02,195,"Alaska","Petersburg Borough",2,56,48,31,17
050,02,195,"Alaska","Petersburg Borough",2,57,49,28,21
050,02,195,"Alaska","Petersburg Borough",2,58,50,24,26
050,02,195,"Alaska","Petersburg Borough",2,59,52,25,27
050,02,195,"Alaska","Petersburg Borough",2,60,46,26,20
050,02,195,"Alaska","Petersburg Borough",2,61,42,20,22
050,02,195,"Alaska","Petersburg Borough",2,62,48,27,21
050,02,195,"Alaska","Petersburg Borough",2,63,49,27,22
050,02,195,"Alaska","Petersburg Borough",2,64,57,27,30
050,02,195,"Alaska","Petersburg Borough",2,65,49,24,25
050,02,195,"Alaska","Petersburg Borough",2,66,47,27,20
050,02,195,"Alaska","Petersburg Borough",2,67,54,28,26
050,02,195,"Alaska","Petersburg Borough",2,68,54,30,24
050,02,195,"Alaska","Petersburg Borough",2,69,49,29,20
050,02,195,"Alaska","Petersburg Borough",2,70,43,26,17
050,02,195,"Alaska","Petersburg Borough",2,71,46,28,18
050,02,195,"Alaska","Petersburg Borough",2,72,38,23,15
050,02,195,"Alaska","Petersburg Borough",2,73,31,15,16
050,02,195,"Alaska","Petersburg Borough",2,74,22,11,11
050,02,195,"Alaska","Petersburg Borough",2,75,25,14,11
050,02,195,"Alaska","Petersburg Borough",2,76,30,17,13
050,02,195,"Alaska","Petersburg Borough",2,77,25,14,11
050,02,195,"Alaska","Petersburg Borough",2,78,21,16,5
050,02,195,"Alaska","Petersburg Borough",2,79,24,14,10
050,02,195,"Alaska","Petersburg Borough",2,80,16,8,8
050,02,195,"Alaska","Petersburg Borough",2,81,11,3,8
050,02,195,"Alaska","Petersburg Borough",2,82,9,2,7
050,02,195,"Alaska","Petersburg Borough",2,83,8,3,5
050,02,195,"Alaska","Petersburg Borough",2,84,8,5,3
050,02,195,"Alaska","Petersburg Borough",2,85,53,23,30
050,02,195,"Alaska","Petersburg Borough",3,0,30,16,14
050,02,195,"Alaska","Petersburg Borough",3,1,37,17,20
050,02,195,"Alaska","Petersburg Borough",3,2,28,14,14
050,02,195,"Alaska","Petersburg Borough",3,3,38,19,19
050,02,195,"Alaska","Petersburg Borough",3,4,37,22,15
050,02,195,"Alaska","Petersburg Borough",3,5,36,22,14
050,02,195,"Alaska","Petersburg Borough",3,6,45,19,26
050,02,195,"Alaska","Petersburg Borough",3,7,44,19,25
050,02,195,"Alaska","Petersburg Borough",3,8,44,19,25
050,02,195,"Alaska","Petersburg Borough",3,9,43,18,25
050,02,195,"Alaska","Petersburg Borough",3,10,46,25,21
050,02,195,"Alaska","Petersburg Borough",3,11,42,22,20
050,02,195,"Alaska","Petersburg Borough",3,12,41,21,20
050,02,195,"Alaska","Petersburg Borough",3,13,42,21,21
050,02,195,"Alaska","Petersburg Borough",3,14,38,18,20
050,02,195,"Alaska","Petersburg Borough",3,15,41,19,22
050,02,195,"Alaska","Petersburg Borough",3,16,35,19,16
050,02,195,"Alaska","Petersburg Borough",3,17,35,18,17
050,02,195,"Alaska","Petersburg Borough",3,18,30,15,15
050,02,195,"Alaska","Petersburg Borough",3,19,36,21,15
050,02,195,"Alaska","Petersburg Borough",3,20,45,29,16
050,02,195,"Alaska","Petersburg Borough",3,21,48,32,16
050,02,195,"Alaska","Petersburg Borough",3,22,51,33,18
050,02,195,"Alaska","Petersburg Borough",3,23,51,34,17
050,02,195,"Alaska","Petersburg Borough",3,24,44,31,13
050,02,195,"Alaska","Petersburg Borough",3,25,31,18,13
050,02,195,"Alaska","Petersburg Borough",3,26,35,18,17
050,02,195,"Alaska","Petersburg Borough",3,27,36,22,14
050,02,195,"Alaska","Petersburg Borough",3,28,40,17,23
050,02,195,"Alaska","Petersburg Borough",3,29,31,13,18
050,02,195,"Alaska","Petersburg Borough",3,30,47,21,26
050,02,195,"Alaska","Petersburg Borough",3,31,40,22,18
050,02,195,"Alaska","Petersburg Borough",3,32,44,22,22
050,02,195,"Alaska","Petersburg Borough",3,33,48,26,22
050,02,195,"Alaska","Petersburg Borough",3,34,53,28,25
050,02,195,"Alaska","Petersburg Borough",3,35,50,27,23
050,02,195,"Alaska","Petersburg Borough",3,36,44,21,23
050,02,195,"Alaska","Petersburg Borough",3,37,42,18,24
050,02,195,"Alaska","Petersburg Borough",3,38,47,21,26
050,02,195,"Alaska","Petersburg Borough",3,39,38,18,20
050,02,195,"Alaska","Petersburg Borough",3,40,39,19,20
050,02,195,"Alaska","Petersburg Borough",3,41,39,21,18
050,02,195,"Alaska","Petersburg Borough",3,42,45,25,20
050,02,195,"Alaska","Petersburg Borough",3,43,45,21,24
050,02,195,"Alaska","Petersburg Borough",3,44,35,18,17
050,02,195,"Alaska","Petersburg Borough",3,45,28,16,12
050,02,195,"Alaska","Petersburg Borough",3,46,32,17,15
050,02,195,"Alaska","Petersburg Borough",3,47,34,22,12
050,02,195,"Alaska","Petersburg Borough",3,48,33,17,16
050,02,195,"Alaska","Petersburg Borough",3,49,40,22,18
050,02,195,"Alaska","Petersburg Borough",3,50,41,21,20
050,02,195,"Alaska","Petersburg Borough",3,51,52,31,21
050,02,195,"Alaska","Petersburg Borough",3,52,45,28,17
050,02,195,"Alaska","Petersburg Borough",3,53,44,28,16
050,02,195,"Alaska","Petersburg Borough",3,54,33,20,13
050,02,195,"Alaska","Petersburg Borough",3,55,40,19,21
050,02,195,"Alaska","Petersburg Borough",3,56,40,21,19
050,02,195,"Alaska","Petersburg Borough",3,57,46,29,17
050,02,195,"Alaska","Petersburg Borough",3,58,43,24,19
050,02,195,"Alaska","Petersburg Borough",3,59,50,26,24
050,02,195,"Alaska","Petersburg Borough",3,60,51,24,27
050,02,195,"Alaska","Petersburg Borough",3,61,41,25,16
050,02,195,"Alaska","Petersburg Borough",3,62,40,20,20
050,02,195,"Alaska","Petersburg Borough",3,63,53,26,27
050,02,195,"Alaska","Petersburg Borough",3,64,50,26,24
050,02,195,"Alaska","Petersburg Borough",3,65,54,24,30
050,02,195,"Alaska","Petersburg Borough",3,66,51,26,25
050,02,195,"Alaska","Petersburg Borough",3,67,46,26,20
050,02,195,"Alaska","Petersburg Borough",3,68,54,28,26
050,02,195,"Alaska","Petersburg Borough",3,69,55,31,24
050,02,195,"Alaska","Petersburg Borough",3,70,50,30,20
050,02,195,"Alaska","Petersburg Borough",3,71,41,25,16
050,02,195,"Alaska","Petersburg Borough",3,72,44,28,16
050,02,195,"Alaska","Petersburg Borough",3,73,36,22,14
050,02,195,"Alaska","Petersburg Borough",3,74,33,15,18
050,02,195,"Alaska","Petersburg Borough",3,75,23,12,11
050,02,195,"Alaska","Petersburg Borough",3,76,25,14,11
050,02,195,"Alaska","Petersburg Borough",3,77,32,18,14
050,02,195,"Alaska","Petersburg Borough",3,78,24,14,10
050,02,195,"Alaska","Petersburg Borough",3,79,20,14,6
050,02,195,"Alaska","Petersburg Borough",3,80,25,14,11
050,02,195,"Alaska","Petersburg Borough",3,81,15,8,7
050,02,195,"Alaska","Petersburg Borough",3,82,11,2,9
050,02,195,"Alaska","Petersburg Borough",3,83,8,2,6
050,02,195,"Alaska","Petersburg Borough",3,84,8,3,5
050,02,195,"Alaska","Petersburg Borough",3,85,54,24,30
050,02,195,"Alaska","Petersburg Borough",4,0,27,18,9
050,02,195,"Alaska","Petersburg Borough",4,1,29,17,12
050,02,195,"Alaska","Petersburg Borough",4,2,36,16,20
050,02,195,"Alaska","Petersburg Borough",4,3,25,12,13
050,02,195,"Alaska","Petersburg Borough",4,4,37,18,19
050,02,195,"Alaska","Petersburg Borough",4,5,35,20,15
050,02,195,"Alaska","Petersburg Borough",4,6,34,18,16
050,02,195,"Alaska","Petersburg Borough",4,7,45,19,26
050,02,195,"Alaska","Petersburg Borough",4,8,41,16,25
050,02,195,"Alaska","Petersburg Borough",4,9,43,19,24
050,02,195,"Alaska","Petersburg Borough",4,10,43,19,24
050,02,195,"Alaska","Petersburg Borough",4,11,49,26,23
050,02,195,"Alaska","Petersburg Borough",4,12,43,23,20
050,02,195,"Alaska","Petersburg Borough",4,13,38,21,17
050,02,195,"Alaska","Petersburg Borough",4,14,40,19,21
050,02,195,"Alaska","Petersburg Borough",4,15,41,18,23
050,02,195,"Alaska","Petersburg Borough",4,16,44,20,24
050,02,195,"Alaska","Petersburg Borough",4,17,32,19,13
050,02,195,"Alaska","Petersburg Borough",4,18,32,17,15
050,02,195,"Alaska","Petersburg Borough",4,19,31,19,12
050,02,195,"Alaska","Petersburg Borough",4,20,47,30,17
050,02,195,"Alaska","Petersburg Borough",4,21,42,26,16
050,02,195,"Alaska","Petersburg Borough",4,22,54,35,19
050,02,195,"Alaska","Petersburg Borough",4,23,52,30,22
050,02,195,"Alaska","Petersburg Borough",4,24,39,30,9
050,02,195,"Alaska","Petersburg Borough",4,25,39,24,15
050,02,195,"Alaska","Petersburg Borough",4,26,31,19,12
050,02,195,"Alaska","Petersburg Borough",4,27,32,16,16
050,02,195,"Alaska","Petersburg Borough",4,28,37,21,16
050,02,195,"Alaska","Petersburg Borough",4,29,40,17,23
050,02,195,"Alaska","Petersburg Borough",4,30,36,18,18
050,02,195,"Alaska","Petersburg Borough",4,31,42,17,25
050,02,195,"Alaska","Petersburg Borough",4,32,48,27,21
050,02,195,"Alaska","Petersburg Borough",4,33,48,25,23
050,02,195,"Alaska","Petersburg Borough",4,34,42,23,19
050,02,195,"Alaska","Petersburg Borough",4,35,48,26,22
050,02,195,"Alaska","Petersburg Borough",4,36,46,23,23
050,02,195,"Alaska","Petersburg Borough",4,37,51,24,27
050,02,195,"Alaska","Petersburg Borough",4,38,46,17,29
050,02,195,"Alaska","Petersburg Borough",4,39,40,17,23
050,02,195,"Alaska","Petersburg Borough",4,40,42,22,20
050,02,195,"Alaska","Petersburg Borough",4,41,42,22,20
050,02,195,"Alaska","Petersburg Borough",4,42,37,17,20
050,02,195,"Alaska","Petersburg Borough",4,43,48,27,21
050,02,195,"Alaska","Petersburg Borough",4,44,42,20,22
050,02,195,"Alaska","Petersburg Borough",4,45,39,23,16
050,02,195,"Alaska","Petersburg Borough",4,46,24,12,12
050,02,195,"Alaska","Petersburg Borough",4,47,35,19,16
050,02,195,"Alaska","Petersburg Borough",4,48,37,25,12
050,02,195,"Alaska","Petersburg Borough",4,49,34,18,16
050,02,195,"Alaska","Petersburg Borough",4,50,33,14,19
050,02,195,"Alaska","Petersburg Borough",4,51,48,29,19
050,02,195,"Alaska","Petersburg Borough",4,52,54,33,21
050,02,195,"Alaska","Petersburg Borough",4,53,46,30,16
050,02,195,"Alaska","Petersburg Borough",4,54,42,27,15
050,02,195,"Alaska","Petersburg Borough",4,55,38,20,18
050,02,195,"Alaska","Petersburg Borough",4,56,31,16,15
050,02,195,"Alaska","Petersburg Borough",4,57,41,20,21
050,02,195,"Alaska","Petersburg Borough",4,58,47,30,17
050,02,195,"Alaska","Petersburg Borough",4,59,45,28,17
050,02,195,"Alaska","Petersburg Borough",4,60,47,23,24
050,02,195,"Alaska","Petersburg Borough",4,61,50,25,25
050,02,195,"Alaska","Petersburg Borough",4,62,41,26,15
050,02,195,"Alaska","Petersburg Borough",4,63,36,18,18
050,02,195,"Alaska","Petersburg Borough",4,64,49,22,27
050,02,195,"Alaska","Petersburg Borough",4,65,48,24,24
050,02,195,"Alaska","Petersburg Borough",4,66,55,23,32
050,02,195,"Alaska","Petersburg Borough",4,67,48,27,21
050,02,195,"Alaska","Petersburg Borough",4,68,47,26,21
050,02,195,"Alaska","Petersburg Borough",4,69,54,27,27
050,02,195,"Alaska","Petersburg Borough",4,70,54,29,25
050,02,195,"Alaska","Petersburg Borough",4,71,51,31,20
050,02,195,"Alaska","Petersburg Borough",4,72,40,25,15
050,02,195,"Alaska","Petersburg Borough",4,73,44,28,16
050,02,195,"Alaska","Petersburg Borough",4,74,38,23,15
050,02,195,"Alaska","Petersburg Borough",4,75,31,16,15
050,02,195,"Alaska","Petersburg Borough",4,76,24,13,11
050,02,195,"Alaska","Petersburg Borough",4,77,25,13,12
050,02,195,"Alaska","Petersburg Borough",4,78,32,18,14
050,02,195,"Alaska","Petersburg Borough",4,79,21,10,11
050,02,195,"Alaska","Petersburg Borough",4,80,20,14,6
050,02,195,"Alaska","Petersburg Borough",4,81,21,13,8
050,02,195,"Alaska","Petersburg Borough",4,82,16,8,8
050,02,195,"Alaska","Petersburg Borough",4,83,10,2,8
050,02,195,"Alaska","Petersburg Borough",4,84,7,2,5
050,02,195,"Alaska","Petersburg Borough",4,85,51,22,29
050,02,195,"Alaska","Petersburg Borough",5,0,25,18,7
050,02,195,"Alaska","Petersburg Borough",5,1,27,16,11
050,02,195,"Alaska","Petersburg Borough",5,2,27,17,10
050,02,195,"Alaska","Petersburg Borough",5,3,39,15,24
050,02,195,"Alaska","Petersburg Borough",5,4,32,12,20
050,02,195,"Alaska","Petersburg Borough",5,5,32,13,19
050,02,195,"Alaska","Petersburg Borough",5,6,40,21,19
050,02,195,"Alaska","Petersburg Borough",5,7,32,18,14
050,02,195,"Alaska","Petersburg Borough",5,8,47,19,28
050,02,195,"Alaska","Petersburg Borough",5,9,43,16,27
050,02,195,"Alaska","Petersburg Borough",5,10,43,18,25
050,02,195,"Alaska","Petersburg Borough",5,11,43,19,24
050,02,195,"Alaska","Petersburg Borough",5,12,52,27,25
050,02,195,"Alaska","Petersburg Borough",5,13,46,25,21
050,02,195,"Alaska","Petersburg Borough",5,14,36,19,17
050,02,195,"Alaska","Petersburg Borough",5,15,46,20,26
050,02,195,"Alaska","Petersburg Borough",5,16,46,22,24
050,02,195,"Alaska","Petersburg Borough",5,17,42,20,22
050,02,195,"Alaska","Petersburg Borough",5,18,29,17,12
050,02,195,"Alaska","Petersburg Borough",5,19,34,19,15
050,02,195,"Alaska","Petersburg Borough",5,20,41,27,14
050,02,195,"Alaska","Petersburg Borough",5,21,50,31,19
050,02,195,"Alaska","Petersburg Borough",5,22,44,27,17
050,02,195,"Alaska","Petersburg Borough",5,23,49,29,20
050,02,195,"Alaska","Petersburg Borough",5,24,41,29,12
050,02,195,"Alaska","Petersburg Borough",5,25,30,21,9
050,02,195,"Alaska","Petersburg Borough",5,26,41,23,18
050,02,195,"Alaska","Petersburg Borough",5,27,30,19,11
050,02,195,"Alaska","Petersburg Borough",5,28,30,18,12
050,02,195,"Alaska","Petersburg Borough",5,29,34,19,15
050,02,195,"Alaska","Petersburg Borough",5,30,44,18,26
050,02,195,"Alaska","Petersburg Borough",5,31,40,21,19
050,02,195,"Alaska","Petersburg Borough",5,32,47,21,26
050,02,195,"Alaska","Petersburg Borough",5,33,56,30,26
050,02,195,"Alaska","Petersburg Borough",5,34,53,26,27
050,02,195,"Alaska","Petersburg Borough",5,35,44,25,19
050,02,195,"Alaska","Petersburg Borough",5,36,49,24,25
050,02,195,"Alaska","Petersburg Borough",5,37,50,25,25
050,02,195,"Alaska","Petersburg Borough",5,38,53,23,30
050,02,195,"Alaska","Petersburg Borough",5,39,38,13,25
050,02,195,"Alaska","Petersburg Borough",5,40,41,18,23
050,02,195,"Alaska","Petersburg Borough",5,41,46,28,18
050,02,195,"Alaska","Petersburg Borough",5,42,38,17,21
050,02,195,"Alaska","Petersburg Borough",5,43,36,16,20
050,02,195,"Alaska","Petersburg Borough",5,44,43,25,18
050,02,195,"Alaska","Petersburg Borough",5,45,47,25,22
050,02,195,"Alaska","Petersburg Borough",5,46,35,19,16
050,02,195,"Alaska","Petersburg Borough",5,47,28,14,14
050,02,195,"Alaska","Petersburg Borough",5,48,39,22,17
050,02,195,"Alaska","Petersburg Borough",5,49,40,27,13
050,02,195,"Alaska","Petersburg Borough",5,50,31,16,15
050,02,195,"Alaska","Petersburg Borough",5,51,38,19,19
050,02,195,"Alaska","Petersburg Borough",5,52,51,32,19
050,02,195,"Alaska","Petersburg Borough",5,53,53,32,21
050,02,195,"Alaska","Petersburg Borough",5,54,42,25,17
050,02,195,"Alaska","Petersburg Borough",5,55,58,33,25
050,02,195,"Alaska","Petersburg Borough",5,56,32,19,13
050,02,195,"Alaska","Petersburg Borough",5,57,30,15,15
050,02,195,"Alaska","Petersburg Borough",5,58,42,20,22
050,02,195,"Alaska","Petersburg Borough",5,59,47,30,17
050,02,195,"Alaska","Petersburg Borough",5,60,39,26,13
050,02,195,"Alaska","Petersburg Borough",5,61,47,24,23
050,02,195,"Alaska","Petersburg Borough",5,62,52,27,25
050,02,195,"Alaska","Petersburg Borough",5,63,40,24,16
050,02,195,"Alaska","Petersburg Borough",5,64,35,18,17
050,02,195,"Alaska","Petersburg Borough",5,65,47,22,25
050,02,195,"Alaska","Petersburg Borough",5,66,49,25,24
050,02,195,"Alaska","Petersburg Borough",5,67,54,23,31
050,02,195,"Alaska","Petersburg Borough",5,68,47,27,20
050,02,195,"Alaska","Petersburg Borough",5,69,51,29,22
050,02,195,"Alaska","Petersburg Borough",5,70,54,27,27
050,02,195,"Alaska","Petersburg Borough",5,71,54,29,25
050,02,195,"Alaska","Petersburg Borough",5,72,50,31,19
050,02,195,"Alaska","Petersburg Borough",5,73,40,24,16
050,02,195,"Alaska","Petersburg Borough",5,74,45,28,17
050,02,195,"Alaska","Petersburg Borough",5,75,34,20,14
050,02,195,"Alaska","Petersburg Borough",5,76,31,16,15
050,02,195,"Alaska","Petersburg Borough",5,77,24,12,12
050,02,195,"Alaska","Petersburg Borough",5,78,25,14,11
050,02,195,"Alaska","Petersburg Borough",5,79,28,14,14
050,02,195,"Alaska","Petersburg Borough",5,80,21,10,11
050,02,195,"Alaska","Petersburg Borough",5,81,17,13,4
050,02,195,"Alaska","Petersburg Borough",5,82,21,12,9
050,02,195,"Alaska","Petersburg Borough",5,83,15,8,7
050,02,195,"Alaska","Petersburg Borough",5,84,9,1,8
050,02,195,"Alaska","Petersburg Borough",5,85,56,22,34
050,02,198,"Alaska","Prince of Wales-Hyder Census Area",1,0,58,30,28
050,02,198,"Alaska","Prince of Wales-Hyder Census Area",1,1,58,29,29
050,02,198,"Alaska","Prince of Wales-Hyder Census Area",1,2,58,31,27
050,02,198,"Alaska","Prince of Wales-Hyder Census Area",1,3,58,34,24
050,02,198,"Alaska","Prince of Wales-Hyder Census Area",1,4,68,43,25
050,02,198,"Alaska","Prince of Wales-Hyder Census Area",1,5,72,46,26
050,02,198,"Alaska","Prince of Wales-Hyder Census Area",1,6,57,30,27
050,02,198,"Alaska","Prince of Wales-Hyder Census Area",1,7,65,37,28
050,02,198,"Alaska","Prince of Wales-Hyder Census Area",1,8,84,50,34
050,02,198,"Alaska","Prince of Wales-Hyder Census Area",1,9,80,39,41
050,02,198,"Alaska","Prince of Wales-Hyder Census Area",1,10,72,31,41
050,02,198,"Alaska","Prince of Wales-Hyder Census Area",1,11,83,46,37
050,02,198,"Alaska","Prince of Wales-Hyder Census Area",1,12,97,47,50
050,02,198,"Alaska","Prince of Wales-Hyder Census Area",1,13,91,50,41
050,02,198,"Alaska","Prince of Wales-Hyder Census Area",1,14,72,47,25
050,02,198,"Alaska","Prince of Wales-Hyder Census Area",1,15,67,44,23
050,02,198,"Alaska","Prince of Wales-Hyder Census Area",1,16,65,33,32
050,02,198,"Alaska","Prince of Wales-Hyder Census Area",1,17,70,40,30
050,02,198,"Alaska","Prince of Wales-Hyder Census Area",1,18,66,39,27
050,02,198,"Alaska","Prince of Wales-Hyder Census Area",1,19,59,31,28
050,02,198,"Alaska","Prince of Wales-Hyder Census Area",1,20,71,41,30
050,02,198,"Alaska","Prince of Wales-Hyder Census Area",1,21,59,34,25
050,02,198,"Alaska","Prince of Wales-Hyder Census Area",1,22,51,30,21
050,02,198,"Alaska","Prince of Wales-Hyder Census Area",1,23,46,23,23
050,02,198,"Alaska","Prince of Wales-Hyder Census Area",1,24,64,31,33
050,02,198,"Alaska","Prince of Wales-Hyder Census Area",1,25,61,32,29
050,02,198,"Alaska","Prince of Wales-Hyder Census Area",1,26,48,25,23
050,02,198,"Alaska","Prince of Wales-Hyder Census Area",1,27,56,33,23
050,02,198,"Alaska","Prince of Wales-Hyder Census Area",1,28,66,35,31
050,02,198,"Alaska","Prince of Wales-Hyder Census Area",1,29,69,32,37
050,02,198,"Alaska","Prince of Wales-Hyder Census Area",1,30,71,38,33
050,02,198,"Alaska","Prince of Wales-Hyder Census Area",1,31,72,32,40
050,02,198,"Alaska","Prince of Wales-Hyder Census Area",1,32,69,27,42
050,02,198,"Alaska","Prince of Wales-Hyder Census Area",1,33,73,31,42
050,02,198,"Alaska","Prince of Wales-Hyder Census Area",1,34,72,32,40
050,02,198,"Alaska","Prince of Wales-Hyder Census Area",1,35,73,41,32
050,02,198,"Alaska","Prince of Wales-Hyder Census Area",1,36,77,42,35
050,02,198,"Alaska","Prince of Wales-Hyder Census Area",1,37,65,39,26
050,02,198,"Alaska","Prince of Wales-Hyder Census Area",1,38,60,34,26
050,02,198,"Alaska","Prince of Wales-Hyder Census Area",1,39,67,40,27
050,02,198,"Alaska","Prince of Wales-Hyder Census Area",1,40,73,45,28
050,02,198,"Alaska","Prince of Wales-Hyder Census Area",1,41,68,40,28
050,02,198,"Alaska","Prince of Wales-Hyder Census Area",1,42,60,29,31
050,02,198,"Alaska","Prince of Wales-Hyder Census Area",1,43,57,34,23
050,02,198,"Alaska","Prince of Wales-Hyder Census Area",1,44,64,36,28
050,02,198,"Alaska","Prince of Wales-Hyder Census Area",1,45,68,36,32
050,02,198,"Alaska","Prince of Wales-Hyder Census Area",1,46,64,36,28
050,02,198,"Alaska","Prince of Wales-Hyder Census Area",1,47,57,33,24
050,02,198,"Alaska","Prince of Wales-Hyder Census Area",1,48,61,37,24
050,02,198,"Alaska","Prince of Wales-Hyder Census Area",1,49,66,35,31
050,02,198,"Alaska","Prince of Wales-Hyder Census Area",1,50,82,44,38
050,02,198,"Alaska","Prince of Wales-Hyder Census Area",1,51,78,39,39
050,02,198,"Alaska","Prince of Wales-Hyder Census Area",1,52,77,45,32
050,02,198,"Alaska","Prince of Wales-Hyder Census Area",1,53,78,40,38
050,02,198,"Alaska","Prince of Wales-Hyder Census Area",1,54,82,42,40
050,02,198,"Alaska","Prince of Wales-Hyder Census Area",1,55,92,58,34
050,02,198,"Alaska","Prince of Wales-Hyder Census Area",1,56,100,60,40
050,02,198,"Alaska","Prince of Wales-Hyder Census Area",1,57,91,52,39
050,02,198,"Alaska","Prince of Wales-Hyder Census Area",1,58,94,53,41
050,02,198,"Alaska","Prince of Wales-Hyder Census Area",1,59,98,52,46
050,02,198,"Alaska","Prince of Wales-Hyder Census Area",1,60,93,53,40
050,02,198,"Alaska","Prince of Wales-Hyder Census Area",1,61,96,46,50
050,02,198,"Alaska","Prince of Wales-Hyder Census Area",1,62,89,42,47
050,02,198,"Alaska","Prince of Wales-Hyder Census Area",1,63,98,49,49
050,02,198,"Alaska","Prince of Wales-Hyder Census Area",1,64,103,64,39
050,02,198,"Alaska","Prince of Wales-Hyder Census Area",1,65,105,68,37
050,02,198,"Alaska","Prince of Wales-Hyder Census Area",1,66,98,56,42
050,02,198,"Alaska","Prince of Wales-Hyder Census Area",1,67,100,53,47
050,02,198,"Alaska","Prince of Wales-Hyder Census Area",1,68,87,45,42
050,02,198,"Alaska","Prince of Wales-Hyder Census Area",1,69,71,39,32
050,02,198,"Alaska","Prince of Wales-Hyder Census Area",1,70,81,46,35
050,02,198,"Alaska","Prince of Wales-Hyder Census Area",1,71,62,36,26
050,02,198,"Alaska","Prince of Wales-Hyder Census Area",1,72,64,39,25
050,02,198,"Alaska","Prince of Wales-Hyder Census Area",1,73,67,40,27
050,02,198,"Alaska","Prince of Wales-Hyder Census Area",1,74,48,27,21
050,02,198,"Alaska","Prince of Wales-Hyder Census Area",1,75,40,26,14
050,02,198,"Alaska","Prince of Wales-Hyder Census Area",1,76,38,23,15
050,02,198,"Alaska","Prince of Wales-Hyder Census Area",1,77,20,10,10
050,02,198,"Alaska","Prince of Wales-Hyder Census Area",1,78,28,17,11
050,02,198,"Alaska","Prince of Wales-Hyder Census Area",1,79,34,20,14
050,02,198,"Alaska","Prince of Wales-Hyder Census Area",1,80,19,13,6
050,02,198,"Alaska","Prince of Wales-Hyder Census Area",1,81,19,10,9
050,02,198,"Alaska","Prince of Wales-Hyder Census Area",1,82,19,11,8
050,02,198,"Alaska","Prince of Wales-Hyder Census Area",1,83,12,8,4
050,02,198,"Alaska","Prince of Wales-Hyder Census Area",1,84,16,11,5
050,02,198,"Alaska","Prince of Wales-Hyder Census Area",1,85,48,23,25
050,02,198,"Alaska","Prince of Wales-Hyder Census Area",2,0,54,28,26
050,02,198,"Alaska","Prince of Wales-Hyder Census Area",2,1,58,30,28
050,02,198,"Alaska","Prince of Wales-Hyder Census Area",2,2,59,32,27
050,02,198,"Alaska","Prince of Wales-Hyder Census Area",2,3,58,34,24
050,02,198,"Alaska","Prince of Wales-Hyder Census Area",2,4,67,42,25
050,02,198,"Alaska","Prince of Wales-Hyder Census Area",2,5,70,44,26
050,02,198,"Alaska","Prince of Wales-Hyder Census Area",2,6,59,32,27
050,02,198,"Alaska","Prince of Wales-Hyder Census Area",2,7,62,34,28
050,02,198,"Alaska","Prince of Wales-Hyder Census Area",2,8,79,47,32
050,02,198,"Alaska","Prince of Wales-Hyder Census Area",2,9,80,40,40
050,02,198,"Alaska","Prince of Wales-Hyder Census Area",2,10,74,33,41
050,02,198,"Alaska","Prince of Wales-Hyder Census Area",2,11,78,42,36
050,02,198,"Alaska","Prince of Wales-Hyder Census Area",2,12,94,47,47
050,02,198,"Alaska","Prince of Wales-Hyder Census Area",2,13,90,49,41
050,02,198,"Alaska","Prince of Wales-Hyder Census Area",2,14,76,48,28
050,02,198,"Alaska","Prince of Wales-Hyder Census Area",2,15,67,44,23
050,02,198,"Alaska","Prince of Wales-Hyder Census Area",2,16,66,36,30
050,02,198,"Alaska","Prince of Wales-Hyder Census Area",2,17,69,39,30
050,02,198,"Alaska","Prince of Wales-Hyder Census Area",2,18,63,37,26
050,02,198,"Alaska","Prince of Wales-Hyder Census Area",2,19,58,32,26
050,02,198,"Alaska","Prince of Wales-Hyder Census Area",2,20,69,39,30
050,02,198,"Alaska","Prince of Wales-Hyder Census Area",2,21,63,36,27
050,02,198,"Alaska","Prince of Wales-Hyder Census Area",2,22,53,31,22
050,02,198,"Alaska","Prince of Wales-Hyder Census Area",2,23,47,24,23
050,02,198,"Alaska","Prince of Wales-Hyder Census Area",2,24,60,30,30
050,02,198,"Alaska","Prince of Wales-Hyder Census Area",2,25,60,31,29
050,02,198,"Alaska","Prince of Wales-Hyder Census Area",2,26,52,28,24
050,02,198,"Alaska","Prince of Wales-Hyder Census Area",2,27,54,31,23
050,02,198,"Alaska","Prince of Wales-Hyder Census Area",2,28,67,36,31
050,02,198,"Alaska","Prince of Wales-Hyder Census Area",2,29,68,33,35
050,02,198,"Alaska","Prince of Wales-Hyder Census Area",2,30,70,35,35
050,02,198,"Alaska","Prince of Wales-Hyder Census Area",2,31,70,32,38
050,02,198,"Alaska","Prince of Wales-Hyder Census Area",2,32,69,28,41
050,02,198,"Alaska","Prince of Wales-Hyder Census Area",2,33,73,30,43
050,02,198,"Alaska","Prince of Wales-Hyder Census Area",2,34,72,31,41
050,02,198,"Alaska","Prince of Wales-Hyder Census Area",2,35,72,39,33
050,02,198,"Alaska","Prince of Wales-Hyder Census Area",2,36,74,41,33
050,02,198,"Alaska","Prince of Wales-Hyder Census Area",2,37,70,42,28
050,02,198,"Alaska","Prince of Wales-Hyder Census Area",2,38,64,37,27
050,02,198,"Alaska","Prince of Wales-Hyder Census Area",2,39,64,39,25
050,02,198,"Alaska","Prince of Wales-Hyder Census Area",2,40,72,45,27
050,02,198,"Alaska","Prince of Wales-Hyder Census Area",2,41,68,41,27
050,02,198,"Alaska","Prince of Wales-Hyder Census Area",2,42,59,31,28
050,02,198,"Alaska","Prince of Wales-Hyder Census Area",2,43,59,34,25
050,02,198,"Alaska","Prince of Wales-Hyder Census Area",2,44,62,35,27
050,02,198,"Alaska","Prince of Wales-Hyder Census Area",2,45,65,35,30
050,02,198,"Alaska","Prince of Wales-Hyder Census Area",2,46,66,37,29
050,02,198,"Alaska","Prince of Wales-Hyder Census Area",2,47,58,34,24
050,02,198,"Alaska","Prince of Wales-Hyder Census Area",2,48,61,37,24
050,02,198,"Alaska","Prince of Wales-Hyder Census Area",2,49,64,34,30
050,02,198,"Alaska","Prince of Wales-Hyder Census Area",2,50,81,43,38
050,02,198,"Alaska","Prince of Wales-Hyder Census Area",2,51,77,39,38
050,02,198,"Alaska","Prince of Wales-Hyder Census Area",2,52,78,44,34
050,02,198,"Alaska","Prince of Wales-Hyder Census Area",2,53,79,42,37
050,02,198,"Alaska","Prince of Wales-Hyder Census Area",2,54,81,41,40
050,02,198,"Alaska","Prince of Wales-Hyder Census Area",2,55,89,53,36
050,02,198,"Alaska","Prince of Wales-Hyder Census Area",2,56,97,59,38
050,02,198,"Alaska","Prince of Wales-Hyder Census Area",2,57,93,54,39
050,02,198,"Alaska","Prince of Wales-Hyder Census Area",2,58,93,53,40
050,02,198,"Alaska","Prince of Wales-Hyder Census Area",2,59,98,52,46
050,02,198,"Alaska","Prince of Wales-Hyder Census Area",2,60,96,54,42
050,02,198,"Alaska","Prince of Wales-Hyder Census Area",2,61,94,47,47
050,02,198,"Alaska","Prince of Wales-Hyder Census Area",2,62,90,42,48
050,02,198,"Alaska","Prince of Wales-Hyder Census Area",2,63,97,47,50
050,02,198,"Alaska","Prince of Wales-Hyder Census Area",2,64,102,60,42
050,02,198,"Alaska","Prince of Wales-Hyder Census Area",2,65,103,67,36
050,02,198,"Alaska","Prince of Wales-Hyder Census Area",2,66,101,60,41
050,02,198,"Alaska","Prince of Wales-Hyder Census Area",2,67,98,53,45
050,02,198,"Alaska","Prince of Wales-Hyder Census Area",2,68,90,47,43
050,02,198,"Alaska","Prince of Wales-Hyder Census Area",2,69,74,40,34
050,02,198,"Alaska","Prince of Wales-Hyder Census Area",2,70,78,44,34
050,02,198,"Alaska","Prince of Wales-Hyder Census Area",2,71,66,38,28
050,02,198,"Alaska","Prince of Wales-Hyder Census Area",2,72,64,38,26
050,02,198,"Alaska","Prince of Wales-Hyder Census Area",2,73,69,41,28
050,02,198,"Alaska","Prince of Wales-Hyder Census Area",2,74,49,29,20
050,02,198,"Alaska","Prince of Wales-Hyder Census Area",2,75,40,25,15
050,02,198,"Alaska","Prince of Wales-Hyder Census Area",2,76,34,20,14
050,02,198,"Alaska","Prince of Wales-Hyder Census Area",2,77,24,13,11
050,02,198,"Alaska","Prince of Wales-Hyder Census Area",2,78,26,15,11
050,02,198,"Alaska","Prince of Wales-Hyder Census Area",2,79,33,20,13
050,02,198,"Alaska","Prince of Wales-Hyder Census Area",2,80,24,16,8
050,02,198,"Alaska","Prince of Wales-Hyder Census Area",2,81,19,11,8
050,02,198,"Alaska","Prince of Wales-Hyder Census Area",2,82,18,11,7
050,02,198,"Alaska","Prince of Wales-Hyder Census Area",2,83,14,9,5
050,02,198,"Alaska","Prince of Wales-Hyder Census Area",2,84,14,10,4
050,02,198,"Alaska","Prince of Wales-Hyder Census Area",2,85,52,25,27
050,02,198,"Alaska","Prince of Wales-Hyder Census Area",3,0,65,31,34
050,02,198,"Alaska","Prince of Wales-Hyder Census Area",3,1,40,24,16
050,02,198,"Alaska","Prince of Wales-Hyder Census Area",3,2,60,33,27
050,02,198,"Alaska","Prince of Wales-Hyder Census Area",3,3,60,29,31
050,02,198,"Alaska","Prince of Wales-Hyder Census Area",3,4,61,36,25
050,02,198,"Alaska","Prince of Wales-Hyder Census Area",3,5,62,40,22
050,02,198,"Alaska","Prince of Wales-Hyder Census Area",3,6,71,42,29
050,02,198,"Alaska","Prince of Wales-Hyder Census Area",3,7,61,32,29
050,02,198,"Alaska","Prince of Wales-Hyder Census Area",3,8,60,34,26
050,02,198,"Alaska","Prince of Wales-Hyder Census Area",3,9,75,44,31
050,02,198,"Alaska","Prince of Wales-Hyder Census Area",3,10,81,43,38
050,02,198,"Alaska","Prince of Wales-Hyder Census Area",3,11,71,32,39
050,02,198,"Alaska","Prince of Wales-Hyder Census Area",3,12,74,39,35
050,02,198,"Alaska","Prince of Wales-Hyder Census Area",3,13,96,47,49
050,02,198,"Alaska","Prince of Wales-Hyder Census Area",3,14,88,47,41
050,02,198,"Alaska","Prince of Wales-Hyder Census Area",3,15,78,49,29
050,02,198,"Alaska","Prince of Wales-Hyder Census Area",3,16,67,43,24
050,02,198,"Alaska","Prince of Wales-Hyder Census Area",3,17,59,32,27
050,02,198,"Alaska","Prince of Wales-Hyder Census Area",3,18,64,36,28
050,02,198,"Alaska","Prince of Wales-Hyder Census Area",3,19,55,29,26
050,02,198,"Alaska","Prince of Wales-Hyder Census Area",3,20,59,33,26
050,02,198,"Alaska","Prince of Wales-Hyder Census Area",3,21,65,35,30
050,02,198,"Alaska","Prince of Wales-Hyder Census Area",3,22,65,40,25
050,02,198,"Alaska","Prince of Wales-Hyder Census Area",3,23,45,23,22
050,02,198,"Alaska","Prince of Wales-Hyder Census Area",3,24,48,28,20
050,02,198,"Alaska","Prince of Wales-Hyder Census Area",3,25,64,32,32
050,02,198,"Alaska","Prince of Wales-Hyder Census Area",3,26,58,29,29
050,02,198,"Alaska","Prince of Wales-Hyder Census Area",3,27,49,25,24
050,02,198,"Alaska","Prince of Wales-Hyder Census Area",3,28,54,33,21
050,02,198,"Alaska","Prince of Wales-Hyder Census Area",3,29,67,37,30
050,02,198,"Alaska","Prince of Wales-Hyder Census Area",3,30,70,29,41
050,02,198,"Alaska","Prince of Wales-Hyder Census Area",3,31,66,33,33
050,02,198,"Alaska","Prince of Wales-Hyder Census Area",3,32,72,38,34
050,02,198,"Alaska","Prince of Wales-Hyder Census Area",3,33,67,25,42
050,02,198,"Alaska","Prince of Wales-Hyder Census Area",3,34,71,28,43
050,02,198,"Alaska","Prince of Wales-Hyder Census Area",3,35,74,34,40
050,02,198,"Alaska","Prince of Wales-Hyder Census Area",3,36,78,42,36
050,02,198,"Alaska","Prince of Wales-Hyder Census Area",3,37,71,43,28
050,02,198,"Alaska","Prince of Wales-Hyder Census Area",3,38,70,41,29
050,02,198,"Alaska","Prince of Wales-Hyder Census Area",3,39,68,39,29
050,02,198,"Alaska","Prince of Wales-Hyder Census Area",3,40,62,37,25
050,02,198,"Alaska","Prince of Wales-Hyder Census Area",3,41,70,38,32
050,02,198,"Alaska","Prince of Wales-Hyder Census Area",3,42,64,40,24
050,02,198,"Alaska","Prince of Wales-Hyder Census Area",3,43,56,26,30
050,02,198,"Alaska","Prince of Wales-Hyder Census Area",3,44,56,34,22
050,02,198,"Alaska","Prince of Wales-Hyder Census Area",3,45,59,32,27
050,02,198,"Alaska","Prince of Wales-Hyder Census Area",3,46,68,38,30
050,02,198,"Alaska","Prince of Wales-Hyder Census Area",3,47,67,35,32
050,02,198,"Alaska","Prince of Wales-Hyder Census Area",3,48,59,34,25
050,02,198,"Alaska","Prince of Wales-Hyder Census Area",3,49,62,37,25
050,02,198,"Alaska","Prince of Wales-Hyder Census Area",3,50,67,34,33
050,02,198,"Alaska","Prince of Wales-Hyder Census Area",3,51,74,36,38
050,02,198,"Alaska","Prince of Wales-Hyder Census Area",3,52,79,40,39
050,02,198,"Alaska","Prince of Wales-Hyder Census Area",3,53,84,47,37
050,02,198,"Alaska","Prince of Wales-Hyder Census Area",3,54,83,42,41
050,02,198,"Alaska","Prince of Wales-Hyder Census Area",3,55,82,40,42
050,02,198,"Alaska","Prince of Wales-Hyder Census Area",3,56,100,58,42
050,02,198,"Alaska","Prince of Wales-Hyder Census Area",3,57,98,62,36
050,02,198,"Alaska","Prince of Wales-Hyder Census Area",3,58,102,59,43
050,02,198,"Alaska","Prince of Wales-Hyder Census Area",3,59,98,56,42
050,02,198,"Alaska","Prince of Wales-Hyder Census Area",3,60,100,54,46
050,02,198,"Alaska","Prince of Wales-Hyder Census Area",3,61,96,54,42
050,02,198,"Alaska","Prince of Wales-Hyder Census Area",3,62,92,46,46
050,02,198,"Alaska","Prince of Wales-Hyder Census Area",3,63,89,41,48
050,02,198,"Alaska","Prince of Wales-Hyder Census Area",3,64,96,46,50
050,02,198,"Alaska","Prince of Wales-Hyder Census Area",3,65,104,64,40
050,02,198,"Alaska","Prince of Wales-Hyder Census Area",3,66,102,63,39
050,02,198,"Alaska","Prince of Wales-Hyder Census Area",3,67,95,55,40
050,02,198,"Alaska","Prince of Wales-Hyder Census Area",3,68,93,48,45
050,02,198,"Alaska","Prince of Wales-Hyder Census Area",3,69,86,45,41
050,02,198,"Alaska","Prince of Wales-Hyder Census Area",3,70,72,39,33
050,02,198,"Alaska","Prince of Wales-Hyder Census Area",3,71,75,41,34
050,02,198,"Alaska","Prince of Wales-Hyder Census Area",3,72,64,37,27
050,02,198,"Alaska","Prince of Wales-Hyder Census Area",3,73,61,35,26
050,02,198,"Alaska","Prince of Wales-Hyder Census Area",3,74,60,35,25
050,02,198,"Alaska","Prince of Wales-Hyder Census Area",3,75,46,27,19
050,02,198,"Alaska","Prince of Wales-Hyder Census Area",3,76,39,24,15
050,02,198,"Alaska","Prince of Wales-Hyder Census Area",3,77,34,20,14
050,02,198,"Alaska","Prince of Wales-Hyder Census Area",3,78,23,13,10
050,02,198,"Alaska","Prince of Wales-Hyder Census Area",3,79,24,14,10
050,02,198,"Alaska","Prince of Wales-Hyder Census Area",3,80,27,17,10
050,02,198,"Alaska","Prince of Wales-Hyder Census Area",3,81,20,15,5
050,02,198,"Alaska","Prince of Wales-Hyder Census Area",3,82,16,9,7
050,02,198,"Alaska","Prince of Wales-Hyder Census Area",3,83,17,11,6
050,02,198,"Alaska","Prince of Wales-Hyder Census Area",3,84,13,9,4
050,02,198,"Alaska","Prince of Wales-Hyder Census Area",3,85,57,31,26
050,02,198,"Alaska","Prince of Wales-Hyder Census Area",4,0,72,45,27
050,02,198,"Alaska","Prince of Wales-Hyder Census Area",4,1,63,31,32
050,02,198,"Alaska","Prince of Wales-Hyder Census Area",4,2,40,22,18
050,02,198,"Alaska","Prince of Wales-Hyder Census Area",4,3,59,33,26
050,02,198,"Alaska","Prince of Wales-Hyder Census Area",4,4,60,29,31
050,02,198,"Alaska","Prince of Wales-Hyder Census Area",4,5,62,37,25
050,02,198,"Alaska","Prince of Wales-Hyder Census Area",4,6,63,40,23
050,02,198,"Alaska","Prince of Wales-Hyder Census Area",4,7,76,45,31
050,02,198,"Alaska","Prince of Wales-Hyder Census Area",4,8,59,33,26
050,02,198,"Alaska","Prince of Wales-Hyder Census Area",4,9,65,34,31
050,02,198,"Alaska","Prince of Wales-Hyder Census Area",4,10,74,42,32
050,02,198,"Alaska","Prince of Wales-Hyder Census Area",4,11,75,41,34
050,02,198,"Alaska","Prince of Wales-Hyder Census Area",4,12,70,33,37
050,02,198,"Alaska","Prince of Wales-Hyder Census Area",4,13,71,38,33
050,02,198,"Alaska","Prince of Wales-Hyder Census Area",4,14,97,52,45
050,02,198,"Alaska","Prince of Wales-Hyder Census Area",4,15,83,45,38
050,02,198,"Alaska","Prince of Wales-Hyder Census Area",4,16,76,47,29
050,02,198,"Alaska","Prince of Wales-Hyder Census Area",4,17,68,46,22
050,02,198,"Alaska","Prince of Wales-Hyder Census Area",4,18,52,28,24
050,02,198,"Alaska","Prince of Wales-Hyder Census Area",4,19,51,30,21
050,02,198,"Alaska","Prince of Wales-Hyder Census Area",4,20,53,27,26
050,02,198,"Alaska","Prince of Wales-Hyder Census Area",4,21,45,25,20
050,02,198,"Alaska","Prince of Wales-Hyder Census Area",4,22,66,34,32
050,02,198,"Alaska","Prince of Wales-Hyder Census Area",4,23,56,33,23
050,02,198,"Alaska","Prince of Wales-Hyder Census Area",4,24,47,22,25
050,02,198,"Alaska","Prince of Wales-Hyder Census Area",4,25,48,31,17
050,02,198,"Alaska","Prince of Wales-Hyder Census Area",4,26,63,31,32
050,02,198,"Alaska","Prince of Wales-Hyder Census Area",4,27,56,28,28
050,02,198,"Alaska","Prince of Wales-Hyder Census Area",4,28,49,23,26
050,02,198,"Alaska","Prince of Wales-Hyder Census Area",4,29,57,32,25
050,02,198,"Alaska","Prince of Wales-Hyder Census Area",4,30,72,41,31
050,02,198,"Alaska","Prince of Wales-Hyder Census Area",4,31,75,30,45
050,02,198,"Alaska","Prince of Wales-Hyder Census Area",4,32,61,34,27
050,02,198,"Alaska","Prince of Wales-Hyder Census Area",4,33,70,35,35
050,02,198,"Alaska","Prince of Wales-Hyder Census Area",4,34,67,27,40
050,02,198,"Alaska","Prince of Wales-Hyder Census Area",4,35,71,32,39
050,02,198,"Alaska","Prince of Wales-Hyder Census Area",4,36,75,35,40
050,02,198,"Alaska","Prince of Wales-Hyder Census Area",4,37,76,41,35
050,02,198,"Alaska","Prince of Wales-Hyder Census Area",4,38,77,48,29
050,02,198,"Alaska","Prince of Wales-Hyder Census Area",4,39,74,41,33
050,02,198,"Alaska","Prince of Wales-Hyder Census Area",4,40,74,44,30
050,02,198,"Alaska","Prince of Wales-Hyder Census Area",4,41,56,34,22
050,02,198,"Alaska","Prince of Wales-Hyder Census Area",4,42,63,32,31
050,02,198,"Alaska","Prince of Wales-Hyder Census Area",4,43,65,36,29
050,02,198,"Alaska","Prince of Wales-Hyder Census Area",4,44,53,25,28
050,02,198,"Alaska","Prince of Wales-Hyder Census Area",4,45,59,37,22
050,02,198,"Alaska","Prince of Wales-Hyder Census Area",4,46,59,33,26
050,02,198,"Alaska","Prince of Wales-Hyder Census Area",4,47,67,37,30
050,02,198,"Alaska","Prince of Wales-Hyder Census Area",4,48,66,35,31
050,02,198,"Alaska","Prince of Wales-Hyder Census Area",4,49,59,31,28
050,02,198,"Alaska","Prince of Wales-Hyder Census Area",4,50,59,36,23
050,02,198,"Alaska","Prince of Wales-Hyder Census Area",4,51,61,29,32
050,02,198,"Alaska","Prince of Wales-Hyder Census Area",4,52,73,40,33
050,02,198,"Alaska","Prince of Wales-Hyder Census Area",4,53,72,38,34
050,02,198,"Alaska","Prince of Wales-Hyder Census Area",4,54,81,48,33
050,02,198,"Alaska","Prince of Wales-Hyder Census Area",4,55,78,39,39
050,02,198,"Alaska","Prince of Wales-Hyder Census Area",4,56,85,43,42
050,02,198,"Alaska","Prince of Wales-Hyder Census Area",4,57,95,56,39
050,02,198,"Alaska","Prince of Wales-Hyder Census Area",4,58,93,60,33
050,02,198,"Alaska","Prince of Wales-Hyder Census Area",4,59,98,55,43
050,02,198,"Alaska","Prince of Wales-Hyder Census Area",4,60,94,53,41
050,02,198,"Alaska","Prince of Wales-Hyder Census Area",4,61,98,52,46
050,02,198,"Alaska","Prince of Wales-Hyder Census Area",4,62,91,51,40
050,02,198,"Alaska","Prince of Wales-Hyder Census Area",4,63,92,47,45
050,02,198,"Alaska","Prince of Wales-Hyder Census Area",4,64,93,43,50
050,02,198,"Alaska","Prince of Wales-Hyder Census Area",4,65,94,45,49
050,02,198,"Alaska","Prince of Wales-Hyder Census Area",4,66,102,62,40
050,02,198,"Alaska","Prince of Wales-Hyder Census Area",4,67,103,61,42
050,02,198,"Alaska","Prince of Wales-Hyder Census Area",4,68,97,56,41
050,02,198,"Alaska","Prince of Wales-Hyder Census Area",4,69,88,44,44
050,02,198,"Alaska","Prince of Wales-Hyder Census Area",4,70,84,44,40
050,02,198,"Alaska","Prince of Wales-Hyder Census Area",4,71,72,38,34
050,02,198,"Alaska","Prince of Wales-Hyder Census Area",4,72,73,41,32
050,02,198,"Alaska","Prince of Wales-Hyder Census Area",4,73,59,34,25
050,02,198,"Alaska","Prince of Wales-Hyder Census Area",4,74,58,33,25
050,02,198,"Alaska","Prince of Wales-Hyder Census Area",4,75,61,34,27
050,02,198,"Alaska","Prince of Wales-Hyder Census Area",4,76,47,28,19
050,02,198,"Alaska","Prince of Wales-Hyder Census Area",4,77,37,22,15
050,02,198,"Alaska","Prince of Wales-Hyder Census Area",4,78,30,18,12
050,02,198,"Alaska","Prince of Wales-Hyder Census Area",4,79,20,12,8
050,02,198,"Alaska","Prince of Wales-Hyder Census Area",4,80,19,14,5
050,02,198,"Alaska","Prince of Wales-Hyder Census Area",4,81,26,15,11
050,02,198,"Alaska","Prince of Wales-Hyder Census Area",4,82,19,15,4
050,02,198,"Alaska","Prince of Wales-Hyder Census Area",4,83,15,8,7
050,02,198,"Alaska","Prince of Wales-Hyder Census Area",4,84,13,7,6
050,02,198,"Alaska","Prince of Wales-Hyder Census Area",4,85,55,32,23
050,02,198,"Alaska","Prince of Wales-Hyder Census Area",5,0,70,44,26
050,02,198,"Alaska","Prince of Wales-Hyder Census Area",5,1,69,42,27
050,02,198,"Alaska","Prince of Wales-Hyder Census Area",5,2,67,33,34
050,02,198,"Alaska","Prince of Wales-Hyder Census Area",5,3,48,28,20
050,02,198,"Alaska","Prince of Wales-Hyder Census Area",5,4,60,34,26
050,02,198,"Alaska","Prince of Wales-Hyder Census Area",5,5,63,31,32
050,02,198,"Alaska","Prince of Wales-Hyder Census Area",5,6,59,33,26
050,02,198,"Alaska","Prince of Wales-Hyder Census Area",5,7,68,44,24
050,02,198,"Alaska","Prince of Wales-Hyder Census Area",5,8,76,43,33
050,02,198,"Alaska","Prince of Wales-Hyder Census Area",5,9,61,34,27
050,02,198,"Alaska","Prince of Wales-Hyder Census Area",5,10,81,41,40
050,02,198,"Alaska","Prince of Wales-Hyder Census Area",5,11,71,41,30
050,02,198,"Alaska","Prince of Wales-Hyder Census Area",5,12,78,42,36
050,02,198,"Alaska","Prince of Wales-Hyder Census Area",5,13,70,31,39
050,02,198,"Alaska","Prince of Wales-Hyder Census Area",5,14,70,40,30
050,02,198,"Alaska","Prince of Wales-Hyder Census Area",5,15,99,53,46
050,02,198,"Alaska","Prince of Wales-Hyder Census Area",5,16,81,43,38
050,02,198,"Alaska","Prince of Wales-Hyder Census Area",5,17,76,50,26
050,02,198,"Alaska","Prince of Wales-Hyder Census Area",5,18,63,42,21
050,02,198,"Alaska","Prince of Wales-Hyder Census Area",5,19,44,24,20
050,02,198,"Alaska","Prince of Wales-Hyder Census Area",5,20,48,28,20
050,02,198,"Alaska","Prince of Wales-Hyder Census Area",5,21,51,26,25
050,02,198,"Alaska","Prince of Wales-Hyder Census Area",5,22,50,29,21
050,02,198,"Alaska","Prince of Wales-Hyder Census Area",5,23,74,37,37
050,02,198,"Alaska","Prince of Wales-Hyder Census Area",5,24,59,36,23
050,02,198,"Alaska","Prince of Wales-Hyder Census Area",5,25,50,23,27
050,02,198,"Alaska","Prince of Wales-Hyder Census Area",5,26,53,33,20
050,02,198,"Alaska","Prince of Wales-Hyder Census Area",5,27,62,31,31
050,02,198,"Alaska","Prince of Wales-Hyder Census Area",5,28,60,28,32
050,02,198,"Alaska","Prince of Wales-Hyder Census Area",5,29,51,24,27
050,02,198,"Alaska","Prince of Wales-Hyder Census Area",5,30,52,26,26
050,02,198,"Alaska","Prince of Wales-Hyder Census Area",5,31,78,42,36
050,02,198,"Alaska","Prince of Wales-Hyder Census Area",5,32,75,29,46
050,02,198,"Alaska","Prince of Wales-Hyder Census Area",5,33,70,38,32
050,02,198,"Alaska","Prince of Wales-Hyder Census Area",5,34,64,31,33
050,02,198,"Alaska","Prince of Wales-Hyder Census Area",5,35,73,29,44
050,02,198,"Alaska","Prince of Wales-Hyder Census Area",5,36,68,27,41
050,02,198,"Alaska","Prince of Wales-Hyder Census Area",5,37,77,40,37
050,02,198,"Alaska","Prince of Wales-Hyder Census Area",5,38,77,39,38
050,02,198,"Alaska","Prince of Wales-Hyder Census Area",5,39,86,50,36
050,02,198,"Alaska","Prince of Wales-Hyder Census Area",5,40,69,37,32
050,02,198,"Alaska","Prince of Wales-Hyder Census Area",5,41,71,46,25
050,02,198,"Alaska","Prince of Wales-Hyder Census Area",5,42,54,30,24
050,02,198,"Alaska","Prince of Wales-Hyder Census Area",5,43,67,34,33
050,02,198,"Alaska","Prince of Wales-Hyder Census Area",5,44,62,35,27
050,02,198,"Alaska","Prince of Wales-Hyder Census Area",5,45,63,32,31
050,02,198,"Alaska","Prince of Wales-Hyder Census Area",5,46,55,34,21
050,02,198,"Alaska","Prince of Wales-Hyder Census Area",5,47,61,32,29
050,02,198,"Alaska","Prince of Wales-Hyder Census Area",5,48,68,38,30
050,02,198,"Alaska","Prince of Wales-Hyder Census Area",5,49,65,34,31
050,02,198,"Alaska","Prince of Wales-Hyder Census Area",5,50,64,36,28
050,02,198,"Alaska","Prince of Wales-Hyder Census Area",5,51,52,28,24
050,02,198,"Alaska","Prince of Wales-Hyder Census Area",5,52,61,29,32
050,02,198,"Alaska","Prince of Wales-Hyder Census Area",5,53,78,41,37
050,02,198,"Alaska","Prince of Wales-Hyder Census Area",5,54,74,36,38
050,02,198,"Alaska","Prince of Wales-Hyder Census Area",5,55,77,46,31
050,02,198,"Alaska","Prince of Wales-Hyder Census Area",5,56,81,42,39
050,02,198,"Alaska","Prince of Wales-Hyder Census Area",5,57,91,45,46
050,02,198,"Alaska","Prince of Wales-Hyder Census Area",5,58,95,56,39
050,02,198,"Alaska","Prince of Wales-Hyder Census Area",5,59,96,64,32
050,02,198,"Alaska","Prince of Wales-Hyder Census Area",5,60,95,54,41
050,02,198,"Alaska","Prince of Wales-Hyder Census Area",5,61,94,50,44
050,02,198,"Alaska","Prince of Wales-Hyder Census Area",5,62,97,53,44
050,02,198,"Alaska","Prince of Wales-Hyder Census Area",5,63,94,53,41
050,02,198,"Alaska","Prince of Wales-Hyder Census Area",5,64,90,44,46
050,02,198,"Alaska","Prince of Wales-Hyder Census Area",5,65,90,43,47
050,02,198,"Alaska","Prince of Wales-Hyder Census Area",5,66,90,43,47
050,02,198,"Alaska","Prince of Wales-Hyder Census Area",5,67,92,58,34
050,02,198,"Alaska","Prince of Wales-Hyder Census Area",5,68,98,57,41
050,02,198,"Alaska","Prince of Wales-Hyder Census Area",5,69,93,55,38
050,02,198,"Alaska","Prince of Wales-Hyder Census Area",5,70,86,42,44
050,02,198,"Alaska","Prince of Wales-Hyder Census Area",5,71,79,40,39
050,02,198,"Alaska","Prince of Wales-Hyder Census Area",5,72,67,37,30
050,02,198,"Alaska","Prince of Wales-Hyder Census Area",5,73,67,39,28
050,02,198,"Alaska","Prince of Wales-Hyder Census Area",5,74,52,31,21
050,02,198,"Alaska","Prince of Wales-Hyder Census Area",5,75,55,30,25
050,02,198,"Alaska","Prince of Wales-Hyder Census Area",5,76,58,32,26
050,02,198,"Alaska","Prince of Wales-Hyder Census Area",5,77,42,26,16
050,02,198,"Alaska","Prince of Wales-Hyder Census Area",5,78,30,18,12
050,02,198,"Alaska","Prince of Wales-Hyder Census Area",5,79,27,16,11
050,02,198,"Alaska","Prince of Wales-Hyder Census Area",5,80,17,12,5
050,02,198,"Alaska","Prince of Wales-Hyder Census Area",5,81,17,12,5
050,02,198,"Alaska","Prince of Wales-Hyder Census Area",5,82,25,15,10
050,02,198,"Alaska","Prince of Wales-Hyder Census Area",5,83,19,15,4
050,02,198,"Alaska","Prince of Wales-Hyder Census Area",5,84,15,8,7
050,02,198,"Alaska","Prince of Wales-Hyder Census Area",5,85,51,28,23
050,02,220,"Alaska","Sitka City and Borough",1,0,76,39,37
050,02,220,"Alaska","Sitka City and Borough",1,1,76,40,36
050,02,220,"Alaska","Sitka City and Borough",1,2,96,56,40
050,02,220,"Alaska","Sitka City and Borough",1,3,92,50,42
050,02,220,"Alaska","Sitka City and Borough",1,4,82,46,36
050,02,220,"Alaska","Sitka City and Borough",1,5,68,30,38
050,02,220,"Alaska","Sitka City and Borough",1,6,70,34,36
050,02,220,"Alaska","Sitka City and Borough",1,7,99,50,49
050,02,220,"Alaska","Sitka City and Borough",1,8,97,55,42
050,02,220,"Alaska","Sitka City and Borough",1,9,108,48,60
050,02,220,"Alaska","Sitka City and Borough",1,10,105,54,51
050,02,220,"Alaska","Sitka City and Borough",1,11,115,62,53
050,02,220,"Alaska","Sitka City and Borough",1,12,127,73,54
050,02,220,"Alaska","Sitka City and Borough",1,13,119,65,54
050,02,220,"Alaska","Sitka City and Borough",1,14,104,54,50
050,02,220,"Alaska","Sitka City and Borough",1,15,107,60,47
050,02,220,"Alaska","Sitka City and Borough",1,16,95,43,52
050,02,220,"Alaska","Sitka City and Borough",1,17,96,46,50
050,02,220,"Alaska","Sitka City and Borough",1,18,83,45,38
050,02,220,"Alaska","Sitka City and Borough",1,19,86,48,38
050,02,220,"Alaska","Sitka City and Borough",1,20,90,48,42
050,02,220,"Alaska","Sitka City and Borough",1,21,97,60,37
050,02,220,"Alaska","Sitka City and Borough",1,22,97,56,41
050,02,220,"Alaska","Sitka City and Borough",1,23,95,61,34
050,02,220,"Alaska","Sitka City and Borough",1,24,89,52,37
050,02,220,"Alaska","Sitka City and Borough",1,25,107,53,54
050,02,220,"Alaska","Sitka City and Borough",1,26,118,54,64
050,02,220,"Alaska","Sitka City and Borough",1,27,111,58,53
050,02,220,"Alaska","Sitka City and Borough",1,28,133,73,60
050,02,220,"Alaska","Sitka City and Borough",1,29,124,66,58
050,02,220,"Alaska","Sitka City and Borough",1,30,133,69,64
050,02,220,"Alaska","Sitka City and Borough",1,31,112,65,47
050,02,220,"Alaska","Sitka City and Borough",1,32,126,53,73
050,02,220,"Alaska","Sitka City and Borough",1,33,141,68,73
050,02,220,"Alaska","Sitka City and Borough",1,34,122,62,60
050,02,220,"Alaska","Sitka City and Borough",1,35,133,61,72
050,02,220,"Alaska","Sitka City and Borough",1,36,125,70,55
050,02,220,"Alaska","Sitka City and Borough",1,37,106,60,46
050,02,220,"Alaska","Sitka City and Borough",1,38,114,58,56
050,02,220,"Alaska","Sitka City and Borough",1,39,117,60,57
050,02,220,"Alaska","Sitka City and Borough",1,40,126,63,63
050,02,220,"Alaska","Sitka City and Borough",1,41,111,61,50
050,02,220,"Alaska","Sitka City and Borough",1,42,117,61,56
050,02,220,"Alaska","Sitka City and Borough",1,43,143,74,69
050,02,220,"Alaska","Sitka City and Borough",1,44,109,62,47
050,02,220,"Alaska","Sitka City and Borough",1,45,94,51,43
050,02,220,"Alaska","Sitka City and Borough",1,46,104,52,52
050,02,220,"Alaska","Sitka City and Borough",1,47,112,60,52
050,02,220,"Alaska","Sitka City and Borough",1,48,117,59,58
050,02,220,"Alaska","Sitka City and Borough",1,49,104,59,45
050,02,220,"Alaska","Sitka City and Borough",1,50,91,50,41
050,02,220,"Alaska","Sitka City and Borough",1,51,97,47,50
050,02,220,"Alaska","Sitka City and Borough",1,52,96,50,46
050,02,220,"Alaska","Sitka City and Borough",1,53,98,52,46
050,02,220,"Alaska","Sitka City and Borough",1,54,98,52,46
050,02,220,"Alaska","Sitka City and Borough",1,55,112,54,58
050,02,220,"Alaska","Sitka City and Borough",1,56,108,50,58
050,02,220,"Alaska","Sitka City and Borough",1,57,114,55,59
050,02,220,"Alaska","Sitka City and Borough",1,58,134,70,64
050,02,220,"Alaska","Sitka City and Borough",1,59,132,79,53
050,02,220,"Alaska","Sitka City and Borough",1,60,130,76,54
050,02,220,"Alaska","Sitka City and Borough",1,61,126,63,63
050,02,220,"Alaska","Sitka City and Borough",1,62,130,61,69
050,02,220,"Alaska","Sitka City and Borough",1,63,139,77,62
050,02,220,"Alaska","Sitka City and Borough",1,64,115,57,58
050,02,220,"Alaska","Sitka City and Borough",1,65,113,55,58
050,02,220,"Alaska","Sitka City and Borough",1,66,101,50,51
050,02,220,"Alaska","Sitka City and Borough",1,67,107,49,58
050,02,220,"Alaska","Sitka City and Borough",1,68,99,50,49
050,02,220,"Alaska","Sitka City and Borough",1,69,83,42,41
050,02,220,"Alaska","Sitka City and Borough",1,70,81,40,41
050,02,220,"Alaska","Sitka City and Borough",1,71,81,37,44
050,02,220,"Alaska","Sitka City and Borough",1,72,79,42,37
050,02,220,"Alaska","Sitka City and Borough",1,73,85,47,38
050,02,220,"Alaska","Sitka City and Borough",1,74,45,24,21
050,02,220,"Alaska","Sitka City and Borough",1,75,50,21,29
050,02,220,"Alaska","Sitka City and Borough",1,76,48,21,27
050,02,220,"Alaska","Sitka City and Borough",1,77,46,24,22
050,02,220,"Alaska","Sitka City and Borough",1,78,42,24,18
050,02,220,"Alaska","Sitka City and Borough",1,79,44,20,24
050,02,220,"Alaska","Sitka City and Borough",1,80,34,15,19
050,02,220,"Alaska","Sitka City and Borough",1,81,32,15,17
050,02,220,"Alaska","Sitka City and Borough",1,82,33,14,19
050,02,220,"Alaska","Sitka City and Borough",1,83,34,15,19
050,02,220,"Alaska","Sitka City and Borough",1,84,28,11,17
050,02,220,"Alaska","Sitka City and Borough",1,85,136,48,88
050,02,220,"Alaska","Sitka City and Borough",2,0,76,35,41
050,02,220,"Alaska","Sitka City and Borough",2,1,76,40,36
050,02,220,"Alaska","Sitka City and Borough",2,2,93,52,41
050,02,220,"Alaska","Sitka City and Borough",2,3,91,49,42
050,02,220,"Alaska","Sitka City and Borough",2,4,83,46,37
050,02,220,"Alaska","Sitka City and Borough",2,5,72,35,37
050,02,220,"Alaska","Sitka City and Borough",2,6,71,35,36
050,02,220,"Alaska","Sitka City and Borough",2,7,94,48,46
050,02,220,"Alaska","Sitka City and Borough",2,8,99,55,44
050,02,220,"Alaska","Sitka City and Borough",2,9,104,49,55
050,02,220,"Alaska","Sitka City and Borough",2,10,103,51,52
050,02,220,"Alaska","Sitka City and Borough",2,11,111,60,51
050,02,220,"Alaska","Sitka City and Borough",2,12,122,69,53
050,02,220,"Alaska","Sitka City and Borough",2,13,120,66,54
050,02,220,"Alaska","Sitka City and Borough",2,14,105,55,50
050,02,220,"Alaska","Sitka City and Borough",2,15,106,59,47
050,02,220,"Alaska","Sitka City and Borough",2,16,99,47,52
050,02,220,"Alaska","Sitka City and Borough",2,17,95,45,50
050,02,220,"Alaska","Sitka City and Borough",2,18,82,44,38
050,02,220,"Alaska","Sitka City and Borough",2,19,86,47,39
050,02,220,"Alaska","Sitka City and Borough",2,20,90,49,41
050,02,220,"Alaska","Sitka City and Borough",2,21,99,60,39
050,02,220,"Alaska","Sitka City and Borough",2,22,98,57,41
050,02,220,"Alaska","Sitka City and Borough",2,23,96,59,37
050,02,220,"Alaska","Sitka City and Borough",2,24,90,53,37
050,02,220,"Alaska","Sitka City and Borough",2,25,101,52,49
050,02,220,"Alaska","Sitka City and Borough",2,26,113,53,60
050,02,220,"Alaska","Sitka City and Borough",2,27,113,57,56
050,02,220,"Alaska","Sitka City and Borough",2,28,127,68,59
050,02,220,"Alaska","Sitka City and Borough",2,29,125,67,58
050,02,220,"Alaska","Sitka City and Borough",2,30,130,69,61
050,02,220,"Alaska","Sitka City and Borough",2,31,113,64,49
050,02,220,"Alaska","Sitka City and Borough",2,32,126,58,68
050,02,220,"Alaska","Sitka City and Borough",2,33,135,64,71
050,02,220,"Alaska","Sitka City and Borough",2,34,125,63,62
050,02,220,"Alaska","Sitka City and Borough",2,35,132,62,70
050,02,220,"Alaska","Sitka City and Borough",2,36,128,70,58
050,02,220,"Alaska","Sitka City and Borough",2,37,109,60,49
050,02,220,"Alaska","Sitka City and Borough",2,38,114,59,55
050,02,220,"Alaska","Sitka City and Borough",2,39,115,59,56
050,02,220,"Alaska","Sitka City and Borough",2,40,124,63,61
050,02,220,"Alaska","Sitka City and Borough",2,41,112,61,51
050,02,220,"Alaska","Sitka City and Borough",2,42,113,60,53
050,02,220,"Alaska","Sitka City and Borough",2,43,138,74,64
050,02,220,"Alaska","Sitka City and Borough",2,44,113,63,50
050,02,220,"Alaska","Sitka City and Borough",2,45,96,52,44
050,02,220,"Alaska","Sitka City and Borough",2,46,98,50,48
050,02,220,"Alaska","Sitka City and Borough",2,47,108,57,51
050,02,220,"Alaska","Sitka City and Borough",2,48,114,58,56
050,02,220,"Alaska","Sitka City and Borough",2,49,106,59,47
050,02,220,"Alaska","Sitka City and Borough",2,50,91,49,42
050,02,220,"Alaska","Sitka City and Borough",2,51,97,50,47
050,02,220,"Alaska","Sitka City and Borough",2,52,95,48,47
050,02,220,"Alaska","Sitka City and Borough",2,53,95,50,45
050,02,220,"Alaska","Sitka City and Borough",2,54,99,52,47
050,02,220,"Alaska","Sitka City and Borough",2,55,111,53,58
050,02,220,"Alaska","Sitka City and Borough",2,56,111,53,58
050,02,220,"Alaska","Sitka City and Borough",2,57,113,55,58
050,02,220,"Alaska","Sitka City and Borough",2,58,129,67,62
050,02,220,"Alaska","Sitka City and Borough",2,59,133,77,56
050,02,220,"Alaska","Sitka City and Borough",2,60,132,79,53
050,02,220,"Alaska","Sitka City and Borough",2,61,125,64,61
050,02,220,"Alaska","Sitka City and Borough",2,62,130,63,67
050,02,220,"Alaska","Sitka City and Borough",2,63,137,73,64
050,02,220,"Alaska","Sitka City and Borough",2,64,118,59,59
050,02,220,"Alaska","Sitka City and Borough",2,65,113,56,57
050,02,220,"Alaska","Sitka City and Borough",2,66,104,51,53
050,02,220,"Alaska","Sitka City and Borough",2,67,105,49,56
050,02,220,"Alaska","Sitka City and Borough",2,68,101,50,51
050,02,220,"Alaska","Sitka City and Borough",2,69,87,44,43
050,02,220,"Alaska","Sitka City and Borough",2,70,81,40,41
050,02,220,"Alaska","Sitka City and Borough",2,71,81,37,44
050,02,220,"Alaska","Sitka City and Borough",2,72,78,40,38
050,02,220,"Alaska","Sitka City and Borough",2,73,88,48,40
050,02,220,"Alaska","Sitka City and Borough",2,74,50,27,23
050,02,220,"Alaska","Sitka City and Borough",2,75,51,22,29
050,02,220,"Alaska","Sitka City and Borough",2,76,48,21,27
050,02,220,"Alaska","Sitka City and Borough",2,77,47,23,24
050,02,220,"Alaska","Sitka City and Borough",2,78,43,24,19
050,02,220,"Alaska","Sitka City and Borough",2,79,43,21,22
050,02,220,"Alaska","Sitka City and Borough",2,80,35,16,19
050,02,220,"Alaska","Sitka City and Borough",2,81,32,15,17
050,02,220,"Alaska","Sitka City and Borough",2,82,33,14,19
050,02,220,"Alaska","Sitka City and Borough",2,83,33,14,19
050,02,220,"Alaska","Sitka City and Borough",2,84,28,10,18
050,02,220,"Alaska","Sitka City and Borough",2,85,140,49,91
050,02,220,"Alaska","Sitka City and Borough",3,0,75,42,33
050,02,220,"Alaska","Sitka City and Borough",3,1,79,32,47
050,02,220,"Alaska","Sitka City and Borough",3,2,75,41,34
050,02,220,"Alaska","Sitka City and Borough",3,3,91,50,41
050,02,220,"Alaska","Sitka City and Borough",3,4,81,41,40
050,02,220,"Alaska","Sitka City and Borough",3,5,78,40,38
050,02,220,"Alaska","Sitka City and Borough",3,6,68,37,31
050,02,220,"Alaska","Sitka City and Borough",3,7,73,37,36
050,02,220,"Alaska","Sitka City and Borough",3,8,92,48,44
050,02,220,"Alaska","Sitka City and Borough",3,9,95,53,42
050,02,220,"Alaska","Sitka City and Borough",3,10,107,49,58
050,02,220,"Alaska","Sitka City and Borough",3,11,94,46,48
050,02,220,"Alaska","Sitka City and Borough",3,12,116,59,57
050,02,220,"Alaska","Sitka City and Borough",3,13,126,71,55
050,02,220,"Alaska","Sitka City and Borough",3,14,114,67,47
050,02,220,"Alaska","Sitka City and Borough",3,15,110,56,54
050,02,220,"Alaska","Sitka City and Borough",3,16,106,64,42
050,02,220,"Alaska","Sitka City and Borough",3,17,97,46,51
050,02,220,"Alaska","Sitka City and Borough",3,18,83,43,40
050,02,220,"Alaska","Sitka City and Borough",3,19,76,45,31
050,02,220,"Alaska","Sitka City and Borough",3,20,91,48,43
050,02,220,"Alaska","Sitka City and Borough",3,21,111,58,53
050,02,220,"Alaska","Sitka City and Borough",3,22,91,59,32
050,02,220,"Alaska","Sitka City and Borough",3,23,102,60,42
050,02,220,"Alaska","Sitka City and Borough",3,24,106,59,47
050,02,220,"Alaska","Sitka City and Borough",3,25,105,61,44
050,02,220,"Alaska","Sitka City and Borough",3,26,108,57,51
050,02,220,"Alaska","Sitka City and Borough",3,27,114,51,63
050,02,220,"Alaska","Sitka City and Borough",3,28,120,66,54
050,02,220,"Alaska","Sitka City and Borough",3,29,141,76,65
050,02,220,"Alaska","Sitka City and Borough",3,30,124,66,58
050,02,220,"Alaska","Sitka City and Borough",3,31,119,62,57
050,02,220,"Alaska","Sitka City and Borough",3,32,123,66,57
050,02,220,"Alaska","Sitka City and Borough",3,33,123,54,69
050,02,220,"Alaska","Sitka City and Borough",3,34,117,53,64
050,02,220,"Alaska","Sitka City and Borough",3,35,112,55,57
050,02,220,"Alaska","Sitka City and Borough",3,36,143,71,72
050,02,220,"Alaska","Sitka City and Borough",3,37,121,61,60
050,02,220,"Alaska","Sitka City and Borough",3,38,109,55,54
050,02,220,"Alaska","Sitka City and Borough",3,39,106,54,52
050,02,220,"Alaska","Sitka City and Borough",3,40,121,58,63
050,02,220,"Alaska","Sitka City and Borough",3,41,122,65,57
050,02,220,"Alaska","Sitka City and Borough",3,42,110,57,53
050,02,220,"Alaska","Sitka City and Borough",3,43,114,64,50
050,02,220,"Alaska","Sitka City and Borough",3,44,131,70,61
050,02,220,"Alaska","Sitka City and Borough",3,45,110,58,52
050,02,220,"Alaska","Sitka City and Borough",3,46,96,52,44
050,02,220,"Alaska","Sitka City and Borough",3,47,99,50,49
050,02,220,"Alaska","Sitka City and Borough",3,48,106,53,53
050,02,220,"Alaska","Sitka City and Borough",3,49,115,58,57
050,02,220,"Alaska","Sitka City and Borough",3,50,109,56,53
050,02,220,"Alaska","Sitka City and Borough",3,51,93,54,39
050,02,220,"Alaska","Sitka City and Borough",3,52,95,47,48
050,02,220,"Alaska","Sitka City and Borough",3,53,86,42,44
050,02,220,"Alaska","Sitka City and Borough",3,54,99,53,46
050,02,220,"Alaska","Sitka City and Borough",3,55,94,46,48
050,02,220,"Alaska","Sitka City and Borough",3,56,106,53,53
050,02,220,"Alaska","Sitka City and Borough",3,57,109,51,58
050,02,220,"Alaska","Sitka City and Borough",3,58,117,52,65
050,02,220,"Alaska","Sitka City and Borough",3,59,123,64,59
050,02,220,"Alaska","Sitka City and Borough",3,60,136,80,56
050,02,220,"Alaska","Sitka City and Borough",3,61,126,74,52
050,02,220,"Alaska","Sitka City and Borough",3,62,130,67,63
050,02,220,"Alaska","Sitka City and Borough",3,63,120,56,64
050,02,220,"Alaska","Sitka City and Borough",3,64,132,69,63
050,02,220,"Alaska","Sitka City and Borough",3,65,112,59,53
050,02,220,"Alaska","Sitka City and Borough",3,66,112,57,55
050,02,220,"Alaska","Sitka City and Borough",3,67,98,48,50
050,02,220,"Alaska","Sitka City and Borough",3,68,96,46,50
050,02,220,"Alaska","Sitka City and Borough",3,69,98,48,50
050,02,220,"Alaska","Sitka City and Borough",3,70,82,44,38
050,02,220,"Alaska","Sitka City and Borough",3,71,74,40,34
050,02,220,"Alaska","Sitka City and Borough",3,72,81,35,46
050,02,220,"Alaska","Sitka City and Borough",3,73,76,39,37
050,02,220,"Alaska","Sitka City and Borough",3,74,82,46,36
050,02,220,"Alaska","Sitka City and Borough",3,75,53,28,25
050,02,220,"Alaska","Sitka City and Borough",3,76,49,22,27
050,02,220,"Alaska","Sitka City and Borough",3,77,48,18,30
050,02,220,"Alaska","Sitka City and Borough",3,78,48,26,22
050,02,220,"Alaska","Sitka City and Borough",3,79,42,21,21
050,02,220,"Alaska","Sitka City and Borough",3,80,34,16,18
050,02,220,"Alaska","Sitka City and Borough",3,81,34,17,17
050,02,220,"Alaska","Sitka City and Borough",3,82,31,14,17
050,02,220,"Alaska","Sitka City and Borough",3,83,36,12,24
050,02,220,"Alaska","Sitka City and Borough",3,84,33,14,19
050,02,220,"Alaska","Sitka City and Borough",3,85,143,49,94
050,02,220,"Alaska","Sitka City and Borough",4,0,78,40,38
050,02,220,"Alaska","Sitka City and Borough",4,1,75,43,32
050,02,220,"Alaska","Sitka City and Borough",4,2,74,29,45
050,02,220,"Alaska","Sitka City and Borough",4,3,71,38,33
050,02,220,"Alaska","Sitka City and Borough",4,4,90,50,40
050,02,220,"Alaska","Sitka City and Borough",4,5,82,38,44
050,02,220,"Alaska","Sitka City and Borough",4,6,73,39,34
050,02,220,"Alaska","Sitka City and Borough",4,7,62,32,30
050,02,220,"Alaska","Sitka City and Borough",4,8,71,37,34
050,02,220,"Alaska","Sitka City and Borough",4,9,79,49,30
050,02,220,"Alaska","Sitka City and Borough",4,10,95,53,42
050,02,220,"Alaska","Sitka City and Borough",4,11,104,47,57
050,02,220,"Alaska","Sitka City and Borough",4,12,97,46,51
050,02,220,"Alaska","Sitka City and Borough",4,13,118,61,57
050,02,220,"Alaska","Sitka City and Borough",4,14,119,67,52
050,02,220,"Alaska","Sitka City and Borough",4,15,117,68,49
050,02,220,"Alaska","Sitka City and Borough",4,16,110,55,55
050,02,220,"Alaska","Sitka City and Borough",4,17,101,64,37
050,02,220,"Alaska","Sitka City and Borough",4,18,87,43,44
050,02,220,"Alaska","Sitka City and Borough",4,19,77,41,36
050,02,220,"Alaska","Sitka City and Borough",4,20,79,46,33
050,02,220,"Alaska","Sitka City and Borough",4,21,102,56,46
050,02,220,"Alaska","Sitka City and Borough",4,22,109,58,51
050,02,220,"Alaska","Sitka City and Borough",4,23,106,69,37
050,02,220,"Alaska","Sitka City and Borough",4,24,104,58,46
050,02,220,"Alaska","Sitka City and Borough",4,25,118,62,56
050,02,220,"Alaska","Sitka City and Borough",4,26,106,56,50
050,02,220,"Alaska","Sitka City and Borough",4,27,101,57,44
050,02,220,"Alaska","Sitka City and Borough",4,28,128,62,66
050,02,220,"Alaska","Sitka City and Borough",4,29,118,60,58
050,02,220,"Alaska","Sitka City and Borough",4,30,139,75,64
050,02,220,"Alaska","Sitka City and Borough",4,31,105,58,47
050,02,220,"Alaska","Sitka City and Borough",4,32,124,63,61
050,02,220,"Alaska","Sitka City and Borough",4,33,134,74,60
050,02,220,"Alaska","Sitka City and Borough",4,34,117,52,65
050,02,220,"Alaska","Sitka City and Borough",4,35,114,53,61
050,02,220,"Alaska","Sitka City and Borough",4,36,121,63,58
050,02,220,"Alaska","Sitka City and Borough",4,37,141,68,73
050,02,220,"Alaska","Sitka City and Borough",4,38,114,57,57
050,02,220,"Alaska","Sitka City and Borough",4,39,113,59,54
050,02,220,"Alaska","Sitka City and Borough",4,40,119,64,55
050,02,220,"Alaska","Sitka City and Borough",4,41,113,59,54
050,02,220,"Alaska","Sitka City and Borough",4,42,115,55,60
050,02,220,"Alaska","Sitka City and Borough",4,43,119,70,49
050,02,220,"Alaska","Sitka City and Borough",4,44,110,60,50
050,02,220,"Alaska","Sitka City and Borough",4,45,131,68,63
050,02,220,"Alaska","Sitka City and Borough",4,46,109,58,51
050,02,220,"Alaska","Sitka City and Borough",4,47,101,55,46
050,02,220,"Alaska","Sitka City and Borough",4,48,94,44,50
050,02,220,"Alaska","Sitka City and Borough",4,49,107,52,55
050,02,220,"Alaska","Sitka City and Borough",4,50,113,56,57
050,02,220,"Alaska","Sitka City and Borough",4,51,114,64,50
050,02,220,"Alaska","Sitka City and Borough",4,52,97,56,41
050,02,220,"Alaska","Sitka City and Borough",4,53,91,44,47
050,02,220,"Alaska","Sitka City and Borough",4,54,84,42,42
050,02,220,"Alaska","Sitka City and Borough",4,55,98,50,48
050,02,220,"Alaska","Sitka City and Borough",4,56,93,48,45
050,02,220,"Alaska","Sitka City and Borough",4,57,99,52,47
050,02,220,"Alaska","Sitka City and Borough",4,58,112,51,61
050,02,220,"Alaska","Sitka City and Borough",4,59,118,57,61
050,02,220,"Alaska","Sitka City and Borough",4,60,121,64,57
050,02,220,"Alaska","Sitka City and Borough",4,61,121,68,53
050,02,220,"Alaska","Sitka City and Borough",4,62,131,76,55
050,02,220,"Alaska","Sitka City and Borough",4,63,130,68,62
050,02,220,"Alaska","Sitka City and Borough",4,64,108,51,57
050,02,220,"Alaska","Sitka City and Borough",4,65,127,64,63
050,02,220,"Alaska","Sitka City and Borough",4,66,114,61,53
050,02,220,"Alaska","Sitka City and Borough",4,67,110,56,54
050,02,220,"Alaska","Sitka City and Borough",4,68,94,46,48
050,02,220,"Alaska","Sitka City and Borough",4,69,95,45,50
050,02,220,"Alaska","Sitka City and Borough",4,70,94,46,48
050,02,220,"Alaska","Sitka City and Borough",4,71,82,43,39
050,02,220,"Alaska","Sitka City and Borough",4,72,72,37,35
050,02,220,"Alaska","Sitka City and Borough",4,73,78,32,46
050,02,220,"Alaska","Sitka City and Borough",4,74,74,37,37
050,02,220,"Alaska","Sitka City and Borough",4,75,83,44,39
050,02,220,"Alaska","Sitka City and Borough",4,76,51,28,23
050,02,220,"Alaska","Sitka City and Borough",4,77,51,20,31
050,02,220,"Alaska","Sitka City and Borough",4,78,49,20,29
050,02,220,"Alaska","Sitka City and Borough",4,79,45,22,23
050,02,220,"Alaska","Sitka City and Borough",4,80,35,16,19
050,02,220,"Alaska","Sitka City and Borough",4,81,34,17,17
050,02,220,"Alaska","Sitka City and Borough",4,82,31,13,18
050,02,220,"Alaska","Sitka City and Borough",4,83,31,11,20
050,02,220,"Alaska","Sitka City and Borough",4,84,35,12,23
050,02,220,"Alaska","Sitka City and Borough",4,85,147,54,93
050,02,220,"Alaska","Sitka City and Borough",5,0,76,40,36
050,02,220,"Alaska","Sitka City and Borough",5,1,71,37,34
050,02,220,"Alaska","Sitka City and Borough",5,2,73,40,33
050,02,220,"Alaska","Sitka City and Borough",5,3,68,30,38
050,02,220,"Alaska","Sitka City and Borough",5,4,68,39,29
050,02,220,"Alaska","Sitka City and Borough",5,5,82,47,35
050,02,220,"Alaska","Sitka City and Borough",5,6,77,37,40
050,02,220,"Alaska","Sitka City and Borough",5,7,73,37,36
050,02,220,"Alaska","Sitka City and Borough",5,8,61,31,30
050,02,220,"Alaska","Sitka City and Borough",5,9,70,38,32
050,02,220,"Alaska","Sitka City and Borough",5,10,82,50,32
050,02,220,"Alaska","Sitka City and Borough",5,11,85,51,34
050,02,220,"Alaska","Sitka City and Borough",5,12,108,47,61
050,02,220,"Alaska","Sitka City and Borough",5,13,102,52,50
050,02,220,"Alaska","Sitka City and Borough",5,14,114,60,54
050,02,220,"Alaska","Sitka City and Borough",5,15,123,74,49
050,02,220,"Alaska","Sitka City and Borough",5,16,117,66,51
050,02,220,"Alaska","Sitka City and Borough",5,17,104,53,51
050,02,220,"Alaska","Sitka City and Borough",5,18,91,59,32
050,02,220,"Alaska","Sitka City and Borough",5,19,73,38,35
050,02,220,"Alaska","Sitka City and Borough",5,20,80,38,42
050,02,220,"Alaska","Sitka City and Borough",5,21,91,53,38
050,02,220,"Alaska","Sitka City and Borough",5,22,101,53,48
050,02,220,"Alaska","Sitka City and Borough",5,23,118,63,55
050,02,220,"Alaska","Sitka City and Borough",5,24,117,68,49
050,02,220,"Alaska","Sitka City and Borough",5,25,105,58,47
050,02,220,"Alaska","Sitka City and Borough",5,26,115,60,55
050,02,220,"Alaska","Sitka City and Borough",5,27,104,56,48
050,02,220,"Alaska","Sitka City and Borough",5,28,102,60,42
050,02,220,"Alaska","Sitka City and Borough",5,29,123,58,65
050,02,220,"Alaska","Sitka City and Borough",5,30,126,69,57
050,02,220,"Alaska","Sitka City and Borough",5,31,119,57,62
050,02,220,"Alaska","Sitka City and Borough",5,32,98,51,47
050,02,220,"Alaska","Sitka City and Borough",5,33,125,66,59
050,02,220,"Alaska","Sitka City and Borough",5,34,126,69,57
050,02,220,"Alaska","Sitka City and Borough",5,35,113,52,61
050,02,220,"Alaska","Sitka City and Borough",5,36,124,65,59
050,02,220,"Alaska","Sitka City and Borough",5,37,115,52,63
050,02,220,"Alaska","Sitka City and Borough",5,38,138,66,72
050,02,220,"Alaska","Sitka City and Borough",5,39,109,55,54
050,02,220,"Alaska","Sitka City and Borough",5,40,131,72,59
050,02,220,"Alaska","Sitka City and Borough",5,41,115,62,53
050,02,220,"Alaska","Sitka City and Borough",5,42,111,55,56
050,02,220,"Alaska","Sitka City and Borough",5,43,125,65,60
050,02,220,"Alaska","Sitka City and Borough",5,44,109,65,44
050,02,220,"Alaska","Sitka City and Borough",5,45,113,59,54
050,02,220,"Alaska","Sitka City and Borough",5,46,121,63,58
050,02,220,"Alaska","Sitka City and Borough",5,47,114,62,52
050,02,220,"Alaska","Sitka City and Borough",5,48,93,52,41
050,02,220,"Alaska","Sitka City and Borough",5,49,86,45,41
050,02,220,"Alaska","Sitka City and Borough",5,50,104,46,58
050,02,220,"Alaska","Sitka City and Borough",5,51,118,64,54
050,02,220,"Alaska","Sitka City and Borough",5,52,112,60,52
050,02,220,"Alaska","Sitka City and Borough",5,53,88,47,41
050,02,220,"Alaska","Sitka City and Borough",5,54,89,43,46
050,02,220,"Alaska","Sitka City and Borough",5,55,80,34,46
050,02,220,"Alaska","Sitka City and Borough",5,56,93,50,43
050,02,220,"Alaska","Sitka City and Borough",5,57,95,50,45
050,02,220,"Alaska","Sitka City and Borough",5,58,98,52,46
050,02,220,"Alaska","Sitka City and Borough",5,59,105,49,56
050,02,220,"Alaska","Sitka City and Borough",5,60,125,60,65
050,02,220,"Alaska","Sitka City and Borough",5,61,112,56,56
050,02,220,"Alaska","Sitka City and Borough",5,62,127,74,53
050,02,220,"Alaska","Sitka City and Borough",5,63,131,75,56
050,02,220,"Alaska","Sitka City and Borough",5,64,126,66,60
050,02,220,"Alaska","Sitka City and Borough",5,65,110,54,56
050,02,220,"Alaska","Sitka City and Borough",5,66,128,64,64
050,02,220,"Alaska","Sitka City and Borough",5,67,109,56,53
050,02,220,"Alaska","Sitka City and Borough",5,68,108,56,52
050,02,220,"Alaska","Sitka City and Borough",5,69,92,45,47
050,02,220,"Alaska","Sitka City and Borough",5,70,97,44,53
050,02,220,"Alaska","Sitka City and Borough",5,71,93,46,47
050,02,220,"Alaska","Sitka City and Borough",5,72,81,42,39
050,02,220,"Alaska","Sitka City and Borough",5,73,71,35,36
050,02,220,"Alaska","Sitka City and Borough",5,74,79,33,46
050,02,220,"Alaska","Sitka City and Borough",5,75,76,34,42
050,02,220,"Alaska","Sitka City and Borough",5,76,82,43,39
050,02,220,"Alaska","Sitka City and Borough",5,77,53,27,26
050,02,220,"Alaska","Sitka City and Borough",5,78,53,24,29
050,02,220,"Alaska","Sitka City and Borough",5,79,47,17,30
050,02,220,"Alaska","Sitka City and Borough",5,80,37,18,19
050,02,220,"Alaska","Sitka City and Borough",5,81,32,15,17
050,02,220,"Alaska","Sitka City and Borough",5,82,30,14,16
050,02,220,"Alaska","Sitka City and Borough",5,83,28,9,19
050,02,220,"Alaska","Sitka City and Borough",5,84,31,12,19
050,02,220,"Alaska","Sitka City and Borough",5,85,157,57,100
050,02,230,"Alaska","Skagway Municipality",1,0,5,2,3
050,02,230,"Alaska","Skagway Municipality",1,1,9,6,3
050,02,230,"Alaska","Skagway Municipality",1,2,11,4,7
050,02,230,"Alaska","Skagway Municipality",1,3,10,6,4
050,02,230,"Alaska","Skagway Municipality",1,4,16,7,9
050,02,230,"Alaska","Skagway Municipality",1,5,9,4,5
050,02,230,"Alaska","Skagway Municipality",1,6,8,3,5
050,02,230,"Alaska","Skagway Municipality",1,7,16,7,9
050,02,230,"Alaska","Skagway Municipality",1,8,9,5,4
050,02,230,"Alaska","Skagway Municipality",1,9,15,9,6
050,02,230,"Alaska","Skagway Municipality",1,10,18,10,8
050,02,230,"Alaska","Skagway Municipality",1,11,8,2,6
050,02,230,"Alaska","Skagway Municipality",1,12,9,7,2
050,02,230,"Alaska","Skagway Municipality",1,13,7,5,2
050,02,230,"Alaska","Skagway Municipality",1,14,9,3,6
050,02,230,"Alaska","Skagway Municipality",1,15,6,3,3
050,02,230,"Alaska","Skagway Municipality",1,16,6,6,0
050,02,230,"Alaska","Skagway Municipality",1,17,9,3,6
050,02,230,"Alaska","Skagway Municipality",1,18,3,2,1
050,02,230,"Alaska","Skagway Municipality",1,19,6,3,3
050,02,230,"Alaska","Skagway Municipality",1,20,3,2,1
050,02,230,"Alaska","Skagway Municipality",1,21,5,3,2
050,02,230,"Alaska","Skagway Municipality",1,22,10,5,5
050,02,230,"Alaska","Skagway Municipality",1,23,9,2,7
050,02,230,"Alaska","Skagway Municipality",1,24,7,3,4
050,02,230,"Alaska","Skagway Municipality",1,25,14,8,6
050,02,230,"Alaska","Skagway Municipality",1,26,19,9,10
050,02,230,"Alaska","Skagway Municipality",1,27,22,11,11
050,02,230,"Alaska","Skagway Municipality",1,28,25,13,12
050,02,230,"Alaska","Skagway Municipality",1,29,20,9,11
050,02,230,"Alaska","Skagway Municipality",1,30,24,13,11
050,02,230,"Alaska","Skagway Municipality",1,31,21,12,9
050,02,230,"Alaska","Skagway Municipality",1,32,24,11,13
050,02,230,"Alaska","Skagway Municipality",1,33,23,11,12
050,02,230,"Alaska","Skagway Municipality",1,34,23,13,10
050,02,230,"Alaska","Skagway Municipality",1,35,27,16,11
050,02,230,"Alaska","Skagway Municipality",1,36,36,20,16
050,02,230,"Alaska","Skagway Municipality",1,37,34,12,22
050,02,230,"Alaska","Skagway Municipality",1,38,33,18,15
050,02,230,"Alaska","Skagway Municipality",1,39,24,13,11
050,02,230,"Alaska","Skagway Municipality",1,40,29,19,10
050,02,230,"Alaska","Skagway Municipality",1,41,27,16,11
050,02,230,"Alaska","Skagway Municipality",1,42,25,13,12
050,02,230,"Alaska","Skagway Municipality",1,43,21,9,12
050,02,230,"Alaska","Skagway Municipality",1,44,19,7,12
050,02,230,"Alaska","Skagway Municipality",1,45,22,10,12
050,02,230,"Alaska","Skagway Municipality",1,46,15,9,6
050,02,230,"Alaska","Skagway Municipality",1,47,12,7,5
050,02,230,"Alaska","Skagway Municipality",1,48,15,11,4
050,02,230,"Alaska","Skagway Municipality",1,49,19,9,10
050,02,230,"Alaska","Skagway Municipality",1,50,24,9,15
050,02,230,"Alaska","Skagway Municipality",1,51,18,8,10
050,02,230,"Alaska","Skagway Municipality",1,52,17,8,9
050,02,230,"Alaska","Skagway Municipality",1,53,20,13,7
050,02,230,"Alaska","Skagway Municipality",1,54,14,9,5
050,02,230,"Alaska","Skagway Municipality",1,55,13,4,9
050,02,230,"Alaska","Skagway Municipality",1,56,13,7,6
050,02,230,"Alaska","Skagway Municipality",1,57,13,10,3
050,02,230,"Alaska","Skagway Municipality",1,58,15,11,4
050,02,230,"Alaska","Skagway Municipality",1,59,16,8,8
050,02,230,"Alaska","Skagway Municipality",1,60,14,6,8
050,02,230,"Alaska","Skagway Municipality",1,61,16,8,8
050,02,230,"Alaska","Skagway Municipality",1,62,21,11,10
050,02,230,"Alaska","Skagway Municipality",1,63,23,13,10
050,02,230,"Alaska","Skagway Municipality",1,64,16,11,5
050,02,230,"Alaska","Skagway Municipality",1,65,18,10,8
050,02,230,"Alaska","Skagway Municipality",1,66,18,13,5
050,02,230,"Alaska","Skagway Municipality",1,67,16,12,4
050,02,230,"Alaska","Skagway Municipality",1,68,15,9,6
050,02,230,"Alaska","Skagway Municipality",1,69,12,7,5
050,02,230,"Alaska","Skagway Municipality",1,70,11,4,7
050,02,230,"Alaska","Skagway Municipality",1,71,9,4,5
050,02,230,"Alaska","Skagway Municipality",1,72,9,6,3
050,02,230,"Alaska","Skagway Municipality",1,73,6,3,3
050,02,230,"Alaska","Skagway Municipality",1,74,8,5,3
050,02,230,"Alaska","Skagway Municipality",1,75,5,4,1
050,02,230,"Alaska","Skagway Municipality",1,76,6,3,3
050,02,230,"Alaska","Skagway Municipality",1,77,8,3,5
050,02,230,"Alaska","Skagway Municipality",1,78,9,2,7
050,02,230,"Alaska","Skagway Municipality",1,79,8,4,4
050,02,230,"Alaska","Skagway Municipality",1,80,4,3,1
050,02,230,"Alaska","Skagway Municipality",1,81,1,1,0
050,02,230,"Alaska","Skagway Municipality",1,82,5,4,1
050,02,230,"Alaska","Skagway Municipality",1,83,3,2,1
050,02,230,"Alaska","Skagway Municipality",1,84,3,1,2
050,02,230,"Alaska","Skagway Municipality",1,85,17,5,12
050,02,230,"Alaska","Skagway Municipality",2,0,4,2,2
050,02,230,"Alaska","Skagway Municipality",2,1,8,5,3
050,02,230,"Alaska","Skagway Municipality",2,2,10,4,6
050,02,230,"Alaska","Skagway Municipality",2,3,11,6,5
050,02,230,"Alaska","Skagway Municipality",2,4,14,6,8
050,02,230,"Alaska","Skagway Municipality",2,5,11,5,6
050,02,230,"Alaska","Skagway Municipality",2,6,10,3,7
050,02,230,"Alaska","Skagway Municipality",2,7,15,7,8
050,02,230,"Alaska","Skagway Municipality",2,8,10,5,5
050,02,230,"Alaska","Skagway Municipality",2,9,15,9,6
050,02,230,"Alaska","Skagway Municipality",2,10,16,8,8
050,02,230,"Alaska","Skagway Municipality",2,11,9,3,6
050,02,230,"Alaska","Skagway Municipality",2,12,8,6,2
050,02,230,"Alaska","Skagway Municipality",2,13,8,6,2
050,02,230,"Alaska","Skagway Municipality",2,14,9,4,5
050,02,230,"Alaska","Skagway Municipality",2,15,6,3,3
050,02,230,"Alaska","Skagway Municipality",2,16,6,5,1
050,02,230,"Alaska","Skagway Municipality",2,17,8,3,5
050,02,230,"Alaska","Skagway Municipality",2,18,4,2,2
050,02,230,"Alaska","Skagway Municipality",2,19,5,2,3
050,02,230,"Alaska","Skagway Municipality",2,20,3,2,1
050,02,230,"Alaska","Skagway Municipality",2,21,5,3,2
050,02,230,"Alaska","Skagway Municipality",2,22,10,5,5
050,02,230,"Alaska","Skagway Municipality",2,23,9,2,7
050,02,230,"Alaska","Skagway Municipality",2,24,7,3,4
050,02,230,"Alaska","Skagway Municipality",2,25,13,7,6
050,02,230,"Alaska","Skagway Municipality",2,26,17,9,8
050,02,230,"Alaska","Skagway Municipality",2,27,22,11,11
050,02,230,"Alaska","Skagway Municipality",2,28,23,12,11
050,02,230,"Alaska","Skagway Municipality",2,29,22,10,12
050,02,230,"Alaska","Skagway Municipality",2,30,23,12,11
050,02,230,"Alaska","Skagway Municipality",2,31,23,13,10
050,02,230,"Alaska","Skagway Municipality",2,32,24,12,12
050,02,230,"Alaska","Skagway Municipality",2,33,24,10,14
050,02,230,"Alaska","Skagway Municipality",2,34,23,13,10
050,02,230,"Alaska","Skagway Municipality",2,35,27,16,11
050,02,230,"Alaska","Skagway Municipality",2,36,34,19,15
050,02,230,"Alaska","Skagway Municipality",2,37,34,13,21
050,02,230,"Alaska","Skagway Municipality",2,38,33,17,16
050,02,230,"Alaska","Skagway Municipality",2,39,27,15,12
050,02,230,"Alaska","Skagway Municipality",2,40,29,18,11
050,02,230,"Alaska","Skagway Municipality",2,41,28,16,12
050,02,230,"Alaska","Skagway Municipality",2,42,26,14,12
050,02,230,"Alaska","Skagway Municipality",2,43,24,11,13
050,02,230,"Alaska","Skagway Municipality",2,44,19,6,13
050,02,230,"Alaska","Skagway Municipality",2,45,22,10,12
050,02,230,"Alaska","Skagway Municipality",2,46,16,9,7
050,02,230,"Alaska","Skagway Municipality",2,47,13,8,5
050,02,230,"Alaska","Skagway Municipality",2,48,14,10,4
050,02,230,"Alaska","Skagway Municipality",2,49,18,10,8
050,02,230,"Alaska","Skagway Municipality",2,50,22,8,14
050,02,230,"Alaska","Skagway Municipality",2,51,19,8,11
050,02,230,"Alaska","Skagway Municipality",2,52,17,8,9
050,02,230,"Alaska","Skagway Municipality",2,53,20,13,7
050,02,230,"Alaska","Skagway Municipality",2,54,13,8,5
050,02,230,"Alaska","Skagway Municipality",2,55,13,5,8
050,02,230,"Alaska","Skagway Municipality",2,56,14,7,7
050,02,230,"Alaska","Skagway Municipality",2,57,12,9,3
050,02,230,"Alaska","Skagway Municipality",2,58,14,11,3
050,02,230,"Alaska","Skagway Municipality",2,59,15,8,7
050,02,230,"Alaska","Skagway Municipality",2,60,15,7,8
050,02,230,"Alaska","Skagway Municipality",2,61,16,8,8
050,02,230,"Alaska","Skagway Municipality",2,62,19,10,9
050,02,230,"Alaska","Skagway Municipality",2,63,21,12,9
050,02,230,"Alaska","Skagway Municipality",2,64,17,11,6
050,02,230,"Alaska","Skagway Municipality",2,65,17,10,7
050,02,230,"Alaska","Skagway Municipality",2,66,19,13,6
050,02,230,"Alaska","Skagway Municipality",2,67,16,12,4
050,02,230,"Alaska","Skagway Municipality",2,68,15,10,5
050,02,230,"Alaska","Skagway Municipality",2,69,13,8,5
050,02,230,"Alaska","Skagway Municipality",2,70,10,4,6
050,02,230,"Alaska","Skagway Municipality",2,71,10,4,6
050,02,230,"Alaska","Skagway Municipality",2,72,8,5,3
050,02,230,"Alaska","Skagway Municipality",2,73,7,4,3
050,02,230,"Alaska","Skagway Municipality",2,74,7,4,3
050,02,230,"Alaska","Skagway Municipality",2,75,7,5,2
050,02,230,"Alaska","Skagway Municipality",2,76,5,3,2
050,02,230,"Alaska","Skagway Municipality",2,77,8,3,5
050,02,230,"Alaska","Skagway Municipality",2,78,8,2,6
050,02,230,"Alaska","Skagway Municipality",2,79,8,4,4
050,02,230,"Alaska","Skagway Municipality",2,80,5,3,2
050,02,230,"Alaska","Skagway Municipality",2,81,1,1,0
050,02,230,"Alaska","Skagway Municipality",2,82,5,4,1
050,02,230,"Alaska","Skagway Municipality",2,83,3,2,1
050,02,230,"Alaska","Skagway Municipality",2,84,3,1,2
050,02,230,"Alaska","Skagway Municipality",2,85,17,5,12
050,02,230,"Alaska","Skagway Municipality",3,0,11,7,4
050,02,230,"Alaska","Skagway Municipality",3,1,5,1,4
050,02,230,"Alaska","Skagway Municipality",3,2,8,5,3
050,02,230,"Alaska","Skagway Municipality",3,3,7,3,4
050,02,230,"Alaska","Skagway Municipality",3,4,10,6,4
050,02,230,"Alaska","Skagway Municipality",3,5,9,2,7
050,02,230,"Alaska","Skagway Municipality",3,6,11,5,6
050,02,230,"Alaska","Skagway Municipality",3,7,10,3,7
050,02,230,"Alaska","Skagway Municipality",3,8,14,7,7
050,02,230,"Alaska","Skagway Municipality",3,9,10,6,4
050,02,230,"Alaska","Skagway Municipality",3,10,14,8,6
050,02,230,"Alaska","Skagway Municipality",3,11,15,7,8
050,02,230,"Alaska","Skagway Municipality",3,12,10,4,6
050,02,230,"Alaska","Skagway Municipality",3,13,6,4,2
050,02,230,"Alaska","Skagway Municipality",3,14,8,6,2
050,02,230,"Alaska","Skagway Municipality",3,15,9,4,5
050,02,230,"Alaska","Skagway Municipality",3,16,6,3,3
050,02,230,"Alaska","Skagway Municipality",3,17,7,6,1
050,02,230,"Alaska","Skagway Municipality",3,18,6,1,5
050,02,230,"Alaska","Skagway Municipality",3,19,6,3,3
050,02,230,"Alaska","Skagway Municipality",3,20,6,3,3
050,02,230,"Alaska","Skagway Municipality",3,21,6,4,2
050,02,230,"Alaska","Skagway Municipality",3,22,3,2,1
050,02,230,"Alaska","Skagway Municipality",3,23,8,3,5
050,02,230,"Alaska","Skagway Municipality",3,24,7,3,4
050,02,230,"Alaska","Skagway Municipality",3,25,7,4,3
050,02,230,"Alaska","Skagway Municipality",3,26,13,9,4
050,02,230,"Alaska","Skagway Municipality",3,27,20,10,10
050,02,230,"Alaska","Skagway Municipality",3,28,18,7,11
050,02,230,"Alaska","Skagway Municipality",3,29,19,10,9
050,02,230,"Alaska","Skagway Municipality",3,30,14,9,5
050,02,230,"Alaska","Skagway Municipality",3,31,20,12,8
050,02,230,"Alaska","Skagway Municipality",3,32,25,14,11
050,02,230,"Alaska","Skagway Municipality",3,33,15,6,9
050,02,230,"Alaska","Skagway Municipality",3,34,18,8,10
050,02,230,"Alaska","Skagway Municipality",3,35,18,9,9
050,02,230,"Alaska","Skagway Municipality",3,36,24,16,8
050,02,230,"Alaska","Skagway Municipality",3,37,31,16,15
050,02,230,"Alaska","Skagway Municipality",3,38,25,11,14
050,02,230,"Alaska","Skagway Municipality",3,39,33,19,14
050,02,230,"Alaska","Skagway Municipality",3,40,28,15,13
050,02,230,"Alaska","Skagway Municipality",3,41,25,13,12
050,02,230,"Alaska","Skagway Municipality",3,42,28,17,11
050,02,230,"Alaska","Skagway Municipality",3,43,24,15,9
050,02,230,"Alaska","Skagway Municipality",3,44,29,15,14
050,02,230,"Alaska","Skagway Municipality",3,45,19,6,13
050,02,230,"Alaska","Skagway Municipality",3,46,20,9,11
050,02,230,"Alaska","Skagway Municipality",3,47,12,6,6
050,02,230,"Alaska","Skagway Municipality",3,48,14,9,5
050,02,230,"Alaska","Skagway Municipality",3,49,13,9,4
050,02,230,"Alaska","Skagway Municipality",3,50,15,9,6
050,02,230,"Alaska","Skagway Municipality",3,51,21,8,13
050,02,230,"Alaska","Skagway Municipality",3,52,18,7,11
050,02,230,"Alaska","Skagway Municipality",3,53,20,11,9
050,02,230,"Alaska","Skagway Municipality",3,54,13,7,6
050,02,230,"Alaska","Skagway Municipality",3,55,13,8,5
050,02,230,"Alaska","Skagway Municipality",3,56,13,5,8
050,02,230,"Alaska","Skagway Municipality",3,57,10,7,3
050,02,230,"Alaska","Skagway Municipality",3,58,9,6,3
050,02,230,"Alaska","Skagway Municipality",3,59,13,11,2
050,02,230,"Alaska","Skagway Municipality",3,60,17,10,7
050,02,230,"Alaska","Skagway Municipality",3,61,15,7,8
050,02,230,"Alaska","Skagway Municipality",3,62,11,5,6
050,02,230,"Alaska","Skagway Municipality",3,63,15,7,8
050,02,230,"Alaska","Skagway Municipality",3,64,19,11,8
050,02,230,"Alaska","Skagway Municipality",3,65,16,10,6
050,02,230,"Alaska","Skagway Municipality",3,66,19,12,7
050,02,230,"Alaska","Skagway Municipality",3,67,17,11,6
050,02,230,"Alaska","Skagway Municipality",3,68,16,11,5
050,02,230,"Alaska","Skagway Municipality",3,69,15,10,5
050,02,230,"Alaska","Skagway Municipality",3,70,13,8,5
050,02,230,"Alaska","Skagway Municipality",3,71,9,5,4
050,02,230,"Alaska","Skagway Municipality",3,72,11,4,7
050,02,230,"Alaska","Skagway Municipality",3,73,9,5,4
050,02,230,"Alaska","Skagway Municipality",3,74,6,3,3
050,02,230,"Alaska","Skagway Municipality",3,75,4,1,3
050,02,230,"Alaska","Skagway Municipality",3,76,7,5,2
050,02,230,"Alaska","Skagway Municipality",3,77,4,3,1
050,02,230,"Alaska","Skagway Municipality",3,78,8,3,5
050,02,230,"Alaska","Skagway Municipality",3,79,8,2,6
050,02,230,"Alaska","Skagway Municipality",3,80,8,4,4
050,02,230,"Alaska","Skagway Municipality",3,81,4,2,2
050,02,230,"Alaska","Skagway Municipality",3,82,1,1,0
050,02,230,"Alaska","Skagway Municipality",3,83,5,4,1
050,02,230,"Alaska","Skagway Municipality",3,84,3,2,1
050,02,230,"Alaska","Skagway Municipality",3,85,18,6,12
050,02,230,"Alaska","Skagway Municipality",4,0,9,6,3
050,02,230,"Alaska","Skagway Municipality",4,1,10,6,4
050,02,230,"Alaska","Skagway Municipality",4,2,5,1,4
050,02,230,"Alaska","Skagway Municipality",4,3,9,5,4
050,02,230,"Alaska","Skagway Municipality",4,4,7,3,4
050,02,230,"Alaska","Skagway Municipality",4,5,10,6,4
050,02,230,"Alaska","Skagway Municipality",4,6,8,2,6
050,02,230,"Alaska","Skagway Municipality",4,7,11,5,6
050,02,230,"Alaska","Skagway Municipality",4,8,10,3,7
050,02,230,"Alaska","Skagway Municipality",4,9,13,7,6
050,02,230,"Alaska","Skagway Municipality",4,10,10,5,5
050,02,230,"Alaska","Skagway Municipality",4,11,13,9,4
050,02,230,"Alaska","Skagway Municipality",4,12,15,7,8
050,02,230,"Alaska","Skagway Municipality",4,13,10,4,6
050,02,230,"Alaska","Skagway Municipality",4,14,5,3,2
050,02,230,"Alaska","Skagway Municipality",4,15,8,5,3
050,02,230,"Alaska","Skagway Municipality",4,16,9,4,5
050,02,230,"Alaska","Skagway Municipality",4,17,6,4,2
050,02,230,"Alaska","Skagway Municipality",4,18,5,4,1
050,02,230,"Alaska","Skagway Municipality",4,19,7,2,5
050,02,230,"Alaska","Skagway Municipality",4,20,6,3,3
050,02,230,"Alaska","Skagway Municipality",4,21,5,2,3
050,02,230,"Alaska","Skagway Municipality",4,22,6,3,3
050,02,230,"Alaska","Skagway Municipality",4,23,4,2,2
050,02,230,"Alaska","Skagway Municipality",4,24,5,2,3
050,02,230,"Alaska","Skagway Municipality",4,25,8,3,5
050,02,230,"Alaska","Skagway Municipality",4,26,6,3,3
050,02,230,"Alaska","Skagway Municipality",4,27,15,10,5
050,02,230,"Alaska","Skagway Municipality",4,28,18,9,9
050,02,230,"Alaska","Skagway Municipality",4,29,16,8,8
050,02,230,"Alaska","Skagway Municipality",4,30,18,8,10
050,02,230,"Alaska","Skagway Municipality",4,31,13,7,6
050,02,230,"Alaska","Skagway Municipality",4,32,17,12,5
050,02,230,"Alaska","Skagway Municipality",4,33,22,12,10
050,02,230,"Alaska","Skagway Municipality",4,34,9,5,4
050,02,230,"Alaska","Skagway Municipality",4,35,18,8,10
050,02,230,"Alaska","Skagway Municipality",4,36,20,11,9
050,02,230,"Alaska","Skagway Municipality",4,37,22,15,7
050,02,230,"Alaska","Skagway Municipality",4,38,28,12,16
050,02,230,"Alaska","Skagway Municipality",4,39,24,11,13
050,02,230,"Alaska","Skagway Municipality",4,40,28,16,12
050,02,230,"Alaska","Skagway Municipality",4,41,25,14,11
050,02,230,"Alaska","Skagway Municipality",4,42,23,12,11
050,02,230,"Alaska","Skagway Municipality",4,43,27,18,9
050,02,230,"Alaska","Skagway Municipality",4,44,19,12,7
050,02,230,"Alaska","Skagway Municipality",4,45,26,12,14
050,02,230,"Alaska","Skagway Municipality",4,46,17,6,11
050,02,230,"Alaska","Skagway Municipality",4,47,23,10,13
050,02,230,"Alaska","Skagway Municipality",4,48,11,5,6
050,02,230,"Alaska","Skagway Municipality",4,49,12,7,5
050,02,230,"Alaska","Skagway Municipality",4,50,16,9,7
050,02,230,"Alaska","Skagway Municipality",4,51,14,9,5
050,02,230,"Alaska","Skagway Municipality",4,52,19,6,13
050,02,230,"Alaska","Skagway Municipality",4,53,22,10,12
050,02,230,"Alaska","Skagway Municipality",4,54,17,10,7
050,02,230,"Alaska","Skagway Municipality",4,55,11,4,7
050,02,230,"Alaska","Skagway Municipality",4,56,14,8,6
050,02,230,"Alaska","Skagway Municipality",4,57,11,5,6
050,02,230,"Alaska","Skagway Municipality",4,58,10,7,3
050,02,230,"Alaska","Skagway Municipality",4,59,5,3,2
050,02,230,"Alaska","Skagway Municipality",4,60,14,12,2
050,02,230,"Alaska","Skagway Municipality",4,61,14,7,7
050,02,230,"Alaska","Skagway Municipality",4,62,14,6,8
050,02,230,"Alaska","Skagway Municipality",4,63,11,4,7
050,02,230,"Alaska","Skagway Municipality",4,64,16,7,9
050,02,230,"Alaska","Skagway Municipality",4,65,19,11,8
050,02,230,"Alaska","Skagway Municipality",4,66,15,9,6
050,02,230,"Alaska","Skagway Municipality",4,67,17,10,7
050,02,230,"Alaska","Skagway Municipality",4,68,17,11,6
050,02,230,"Alaska","Skagway Municipality",4,69,15,10,5
050,02,230,"Alaska","Skagway Municipality",4,70,12,7,5
050,02,230,"Alaska","Skagway Municipality",4,71,14,8,6
050,02,230,"Alaska","Skagway Municipality",4,72,10,5,5
050,02,230,"Alaska","Skagway Municipality",4,73,12,5,7
050,02,230,"Alaska","Skagway Municipality",4,74,9,5,4
050,02,230,"Alaska","Skagway Municipality",4,75,5,2,3
050,02,230,"Alaska","Skagway Municipality",4,76,4,1,3
050,02,230,"Alaska","Skagway Municipality",4,77,7,5,2
050,02,230,"Alaska","Skagway Municipality",4,78,4,3,1
050,02,230,"Alaska","Skagway Municipality",4,79,8,3,5
050,02,230,"Alaska","Skagway Municipality",4,80,8,2,6
050,02,230,"Alaska","Skagway Municipality",4,81,7,3,4
050,02,230,"Alaska","Skagway Municipality",4,82,4,2,2
050,02,230,"Alaska","Skagway Municipality",4,83,1,1,0
050,02,230,"Alaska","Skagway Municipality",4,84,5,4,1
050,02,230,"Alaska","Skagway Municipality",4,85,20,7,13
050,02,230,"Alaska","Skagway Municipality",5,0,9,6,3
050,02,230,"Alaska","Skagway Municipality",5,1,9,6,3
050,02,230,"Alaska","Skagway Municipality",5,2,10,6,4
050,02,230,"Alaska","Skagway Municipality",5,3,5,1,4
050,02,230,"Alaska","Skagway Municipality",5,4,9,5,4
050,02,230,"Alaska","Skagway Municipality",5,5,4,3,1
050,02,230,"Alaska","Skagway Municipality",5,6,12,8,4
050,02,230,"Alaska","Skagway Municipality",5,7,9,2,7
050,02,230,"Alaska","Skagway Municipality",5,8,10,5,5
050,02,230,"Alaska","Skagway Municipality",5,9,8,2,6
050,02,230,"Alaska","Skagway Municipality",5,10,11,5,6
050,02,230,"Alaska","Skagway Municipality",5,11,9,5,4
050,02,230,"Alaska","Skagway Municipality",5,12,12,8,4
050,02,230,"Alaska","Skagway Municipality",5,13,15,6,9
050,02,230,"Alaska","Skagway Municipality",5,14,14,5,9
050,02,230,"Alaska","Skagway Municipality",5,15,6,5,1
050,02,230,"Alaska","Skagway Municipality",5,16,9,5,4
050,02,230,"Alaska","Skagway Municipality",5,17,9,4,5
050,02,230,"Alaska","Skagway Municipality",5,18,7,5,2
050,02,230,"Alaska","Skagway Municipality",5,19,5,4,1
050,02,230,"Alaska","Skagway Municipality",5,20,6,2,4
050,02,230,"Alaska","Skagway Municipality",5,21,6,3,3
050,02,230,"Alaska","Skagway Municipality",5,22,11,5,6
050,02,230,"Alaska","Skagway Municipality",5,23,10,3,7
050,02,230,"Alaska","Skagway Municipality",5,24,6,5,1
050,02,230,"Alaska","Skagway Municipality",5,25,6,4,2
050,02,230,"Alaska","Skagway Municipality",5,26,10,3,7
050,02,230,"Alaska","Skagway Municipality",5,27,7,5,2
050,02,230,"Alaska","Skagway Municipality",5,28,15,9,6
050,02,230,"Alaska","Skagway Municipality",5,29,17,10,7
050,02,230,"Alaska","Skagway Municipality",5,30,13,6,7
050,02,230,"Alaska","Skagway Municipality",5,31,19,8,11
050,02,230,"Alaska","Skagway Municipality",5,32,13,6,7
050,02,230,"Alaska","Skagway Municipality",5,33,18,11,7
050,02,230,"Alaska","Skagway Municipality",5,34,19,9,10
050,02,230,"Alaska","Skagway Municipality",5,35,10,6,4
050,02,230,"Alaska","Skagway Municipality",5,36,16,8,8
050,02,230,"Alaska","Skagway Municipality",5,37,23,13,10
050,02,230,"Alaska","Skagway Municipality",5,38,23,15,8
050,02,230,"Alaska","Skagway Municipality",5,39,34,18,16
050,02,230,"Alaska","Skagway Municipality",5,40,23,11,12
050,02,230,"Alaska","Skagway Municipality",5,41,29,15,14
050,02,230,"Alaska","Skagway Municipality",5,42,24,15,9
050,02,230,"Alaska","Skagway Municipality",5,43,25,15,10
050,02,230,"Alaska","Skagway Municipality",5,44,23,16,7
050,02,230,"Alaska","Skagway Municipality",5,45,17,11,6
050,02,230,"Alaska","Skagway Municipality",5,46,23,10,13
050,02,230,"Alaska","Skagway Municipality",5,47,15,6,9
050,02,230,"Alaska","Skagway Municipality",5,48,25,13,12
050,02,230,"Alaska","Skagway Municipality",5,49,12,5,7
050,02,230,"Alaska","Skagway Municipality",5,50,16,7,9
050,02,230,"Alaska","Skagway Municipality",5,51,17,10,7
050,02,230,"Alaska","Skagway Municipality",5,52,13,8,5
050,02,230,"Alaska","Skagway Municipality",5,53,20,7,13
050,02,230,"Alaska","Skagway Municipality",5,54,18,8,10
050,02,230,"Alaska","Skagway Municipality",5,55,14,7,7
050,02,230,"Alaska","Skagway Municipality",5,56,11,3,8
050,02,230,"Alaska","Skagway Municipality",5,57,13,8,5
050,02,230,"Alaska","Skagway Municipality",5,58,11,5,6
050,02,230,"Alaska","Skagway Municipality",5,59,9,7,2
050,02,230,"Alaska","Skagway Municipality",5,60,5,3,2
050,02,230,"Alaska","Skagway Municipality",5,61,11,9,2
050,02,230,"Alaska","Skagway Municipality",5,62,14,7,7
050,02,230,"Alaska","Skagway Municipality",5,63,14,5,9
050,02,230,"Alaska","Skagway Municipality",5,64,9,4,5
050,02,230,"Alaska","Skagway Municipality",5,65,15,7,8
050,02,230,"Alaska","Skagway Municipality",5,66,20,12,8
050,02,230,"Alaska","Skagway Municipality",5,67,12,9,3
050,02,230,"Alaska","Skagway Municipality",5,68,17,10,7
050,02,230,"Alaska","Skagway Municipality",5,69,17,11,6
050,02,230,"Alaska","Skagway Municipality",5,70,15,10,5
050,02,230,"Alaska","Skagway Municipality",5,71,13,8,5
050,02,230,"Alaska","Skagway Municipality",5,72,13,7,6
050,02,230,"Alaska","Skagway Municipality",5,73,9,4,5
050,02,230,"Alaska","Skagway Municipality",5,74,11,4,7
050,02,230,"Alaska","Skagway Municipality",5,75,7,3,4
050,02,230,"Alaska","Skagway Municipality",5,76,5,2,3
050,02,230,"Alaska","Skagway Municipality",5,77,4,1,3
050,02,230,"Alaska","Skagway Municipality",5,78,8,5,3
050,02,230,"Alaska","Skagway Municipality",5,79,4,3,1
050,02,230,"Alaska","Skagway Municipality",5,80,8,3,5
050,02,230,"Alaska","Skagway Municipality",5,81,7,1,6
050,02,230,"Alaska","Skagway Municipality",5,82,6,3,3
050,02,230,"Alaska","Skagway Municipality",5,83,4,2,2
050,02,230,"Alaska","Skagway Municipality",5,84,1,1,0
050,02,230,"Alaska","Skagway Municipality",5,85,24,10,14
050,02,240,"Alaska","Southeast Fairbanks Census Area",1,0,92,45,47
050,02,240,"Alaska","Southeast Fairbanks Census Area",1,1,98,52,46
050,02,240,"Alaska","Southeast Fairbanks Census Area",1,2,93,48,45
050,02,240,"Alaska","Southeast Fairbanks Census Area",1,3,86,47,39
050,02,240,"Alaska","Southeast Fairbanks Census Area",1,4,105,51,54
050,02,240,"Alaska","Southeast Fairbanks Census Area",1,5,116,52,64
050,02,240,"Alaska","Southeast Fairbanks Census Area",1,6,99,48,51
050,02,240,"Alaska","Southeast Fairbanks Census Area",1,7,90,43,47
050,02,240,"Alaska","Southeast Fairbanks Census Area",1,8,92,38,54
050,02,240,"Alaska","Southeast Fairbanks Census Area",1,9,99,51,48
050,02,240,"Alaska","Southeast Fairbanks Census Area",1,10,104,61,43
050,02,240,"Alaska","Southeast Fairbanks Census Area",1,11,87,46,41
050,02,240,"Alaska","Southeast Fairbanks Census Area",1,12,88,41,47
050,02,240,"Alaska","Southeast Fairbanks Census Area",1,13,95,45,50
050,02,240,"Alaska","Southeast Fairbanks Census Area",1,14,82,39,43
050,02,240,"Alaska","Southeast Fairbanks Census Area",1,15,90,45,45
050,02,240,"Alaska","Southeast Fairbanks Census Area",1,16,90,47,43
050,02,240,"Alaska","Southeast Fairbanks Census Area",1,17,81,44,37
050,02,240,"Alaska","Southeast Fairbanks Census Area",1,18,72,40,32
050,02,240,"Alaska","Southeast Fairbanks Census Area",1,19,61,38,23
050,02,240,"Alaska","Southeast Fairbanks Census Area",1,20,54,30,24
050,02,240,"Alaska","Southeast Fairbanks Census Area",1,21,56,30,26
050,02,240,"Alaska","Southeast Fairbanks Census Area",1,22,64,36,28
050,02,240,"Alaska","Southeast Fairbanks Census Area",1,23,67,39,28
050,02,240,"Alaska","Southeast Fairbanks Census Area",1,24,68,37,31
050,02,240,"Alaska","Southeast Fairbanks Census Area",1,25,80,49,31
050,02,240,"Alaska","Southeast Fairbanks Census Area",1,26,81,44,37
050,02,240,"Alaska","Southeast Fairbanks Census Area",1,27,98,56,42
050,02,240,"Alaska","Southeast Fairbanks Census Area",1,28,95,65,30
050,02,240,"Alaska","Southeast Fairbanks Census Area",1,29,92,58,34
050,02,240,"Alaska","Southeast Fairbanks Census Area",1,30,116,66,50
050,02,240,"Alaska","Southeast Fairbanks Census Area",1,31,97,53,44
050,02,240,"Alaska","Southeast Fairbanks Census Area",1,32,108,58,50
050,02,240,"Alaska","Southeast Fairbanks Census Area",1,33,86,54,32
050,02,240,"Alaska","Southeast Fairbanks Census Area",1,34,95,57,38
050,02,240,"Alaska","Southeast Fairbanks Census Area",1,35,87,55,32
050,02,240,"Alaska","Southeast Fairbanks Census Area",1,36,102,67,35
050,02,240,"Alaska","Southeast Fairbanks Census Area",1,37,94,53,41
050,02,240,"Alaska","Southeast Fairbanks Census Area",1,38,85,43,42
050,02,240,"Alaska","Southeast Fairbanks Census Area",1,39,92,56,36
050,02,240,"Alaska","Southeast Fairbanks Census Area",1,40,93,51,42
050,02,240,"Alaska","Southeast Fairbanks Census Area",1,41,84,46,38
050,02,240,"Alaska","Southeast Fairbanks Census Area",1,42,100,64,36
050,02,240,"Alaska","Southeast Fairbanks Census Area",1,43,88,52,36
050,02,240,"Alaska","Southeast Fairbanks Census Area",1,44,85,56,29
050,02,240,"Alaska","Southeast Fairbanks Census Area",1,45,83,57,26
050,02,240,"Alaska","Southeast Fairbanks Census Area",1,46,81,43,38
050,02,240,"Alaska","Southeast Fairbanks Census Area",1,47,70,45,25
050,02,240,"Alaska","Southeast Fairbanks Census Area",1,48,74,46,28
050,02,240,"Alaska","Southeast Fairbanks Census Area",1,49,87,53,34
050,02,240,"Alaska","Southeast Fairbanks Census Area",1,50,119,74,45
050,02,240,"Alaska","Southeast Fairbanks Census Area",1,51,88,54,34
050,02,240,"Alaska","Southeast Fairbanks Census Area",1,52,84,48,36
050,02,240,"Alaska","Southeast Fairbanks Census Area",1,53,96,59,37
050,02,240,"Alaska","Southeast Fairbanks Census Area",1,54,85,47,38
050,02,240,"Alaska","Southeast Fairbanks Census Area",1,55,91,52,39
050,02,240,"Alaska","Southeast Fairbanks Census Area",1,56,83,52,31
050,02,240,"Alaska","Southeast Fairbanks Census Area",1,57,103,61,42
050,02,240,"Alaska","Southeast Fairbanks Census Area",1,58,85,49,36
050,02,240,"Alaska","Southeast Fairbanks Census Area",1,59,105,70,35
050,02,240,"Alaska","Southeast Fairbanks Census Area",1,60,105,64,41
050,02,240,"Alaska","Southeast Fairbanks Census Area",1,61,93,51,42
050,02,240,"Alaska","Southeast Fairbanks Census Area",1,62,87,51,36
050,02,240,"Alaska","Southeast Fairbanks Census Area",1,63,93,49,44
050,02,240,"Alaska","Southeast Fairbanks Census Area",1,64,81,39,42
050,02,240,"Alaska","Southeast Fairbanks Census Area",1,65,98,56,42
050,02,240,"Alaska","Southeast Fairbanks Census Area",1,66,85,47,38
050,02,240,"Alaska","Southeast Fairbanks Census Area",1,67,74,41,33
050,02,240,"Alaska","Southeast Fairbanks Census Area",1,68,72,41,31
050,02,240,"Alaska","Southeast Fairbanks Census Area",1,69,77,42,35
050,02,240,"Alaska","Southeast Fairbanks Census Area",1,70,71,39,32
050,02,240,"Alaska","Southeast Fairbanks Census Area",1,71,61,35,26
050,02,240,"Alaska","Southeast Fairbanks Census Area",1,72,70,42,28
050,02,240,"Alaska","Southeast Fairbanks Census Area",1,73,54,32,22
050,02,240,"Alaska","Southeast Fairbanks Census Area",1,74,34,18,16
050,02,240,"Alaska","Southeast Fairbanks Census Area",1,75,37,21,16
050,02,240,"Alaska","Southeast Fairbanks Census Area",1,76,42,29,13
050,02,240,"Alaska","Southeast Fairbanks Census Area",1,77,42,28,14
050,02,240,"Alaska","Southeast Fairbanks Census Area",1,78,31,16,15
050,02,240,"Alaska","Southeast Fairbanks Census Area",1,79,27,14,13
050,02,240,"Alaska","Southeast Fairbanks Census Area",1,80,25,11,14
050,02,240,"Alaska","Southeast Fairbanks Census Area",1,81,21,10,11
050,02,240,"Alaska","Southeast Fairbanks Census Area",1,82,24,14,10
050,02,240,"Alaska","Southeast Fairbanks Census Area",1,83,14,9,5
050,02,240,"Alaska","Southeast Fairbanks Census Area",1,84,12,6,6
050,02,240,"Alaska","Southeast Fairbanks Census Area",1,85,56,20,36
050,02,240,"Alaska","Southeast Fairbanks Census Area",2,0,101,47,54
050,02,240,"Alaska","Southeast Fairbanks Census Area",2,1,95,50,45
050,02,240,"Alaska","Southeast Fairbanks Census Area",2,2,96,49,47
050,02,240,"Alaska","Southeast Fairbanks Census Area",2,3,89,49,40
050,02,240,"Alaska","Southeast Fairbanks Census Area",2,4,102,52,50
050,02,240,"Alaska","Southeast Fairbanks Census Area",2,5,113,51,62
050,02,240,"Alaska","Southeast Fairbanks Census Area",2,6,101,48,53
050,02,240,"Alaska","Southeast Fairbanks Census Area",2,7,93,45,48
050,02,240,"Alaska","Southeast Fairbanks Census Area",2,8,93,40,53
050,02,240,"Alaska","Southeast Fairbanks Census Area",2,9,96,47,49
050,02,240,"Alaska","Southeast Fairbanks Census Area",2,10,103,59,44
050,02,240,"Alaska","Southeast Fairbanks Census Area",2,11,92,49,43
050,02,240,"Alaska","Southeast Fairbanks Census Area",2,12,89,43,46
050,02,240,"Alaska","Southeast Fairbanks Census Area",2,13,91,43,48
050,02,240,"Alaska","Southeast Fairbanks Census Area",2,14,87,41,46
050,02,240,"Alaska","Southeast Fairbanks Census Area",2,15,89,44,45
050,02,240,"Alaska","Southeast Fairbanks Census Area",2,16,89,47,42
050,02,240,"Alaska","Southeast Fairbanks Census Area",2,17,82,45,37
050,02,240,"Alaska","Southeast Fairbanks Census Area",2,18,70,38,32
050,02,240,"Alaska","Southeast Fairbanks Census Area",2,19,60,37,23
050,02,240,"Alaska","Southeast Fairbanks Census Area",2,20,55,32,23
050,02,240,"Alaska","Southeast Fairbanks Census Area",2,21,56,31,25
050,02,240,"Alaska","Southeast Fairbanks Census Area",2,22,67,36,31
050,02,240,"Alaska","Southeast Fairbanks Census Area",2,23,67,40,27
050,02,240,"Alaska","Southeast Fairbanks Census Area",2,24,70,39,31
050,02,240,"Alaska","Southeast Fairbanks Census Area",2,25,80,49,31
050,02,240,"Alaska","Southeast Fairbanks Census Area",2,26,81,46,35
050,02,240,"Alaska","Southeast Fairbanks Census Area",2,27,92,50,42
050,02,240,"Alaska","Southeast Fairbanks Census Area",2,28,98,66,32
050,02,240,"Alaska","Southeast Fairbanks Census Area",2,29,92,59,33
050,02,240,"Alaska","Southeast Fairbanks Census Area",2,30,111,66,45
050,02,240,"Alaska","Southeast Fairbanks Census Area",2,31,104,58,46
050,02,240,"Alaska","Southeast Fairbanks Census Area",2,32,107,58,49
050,02,240,"Alaska","Southeast Fairbanks Census Area",2,33,87,53,34
050,02,240,"Alaska","Southeast Fairbanks Census Area",2,34,94,57,37
050,02,240,"Alaska","Southeast Fairbanks Census Area",2,35,90,55,35
050,02,240,"Alaska","Southeast Fairbanks Census Area",2,36,100,65,35
050,02,240,"Alaska","Southeast Fairbanks Census Area",2,37,94,54,40
050,02,240,"Alaska","Southeast Fairbanks Census Area",2,38,88,46,42
050,02,240,"Alaska","Southeast Fairbanks Census Area",2,39,93,56,37
050,02,240,"Alaska","Southeast Fairbanks Census Area",2,40,92,50,42
050,02,240,"Alaska","Southeast Fairbanks Census Area",2,41,85,47,38
050,02,240,"Alaska","Southeast Fairbanks Census Area",2,42,99,63,36
050,02,240,"Alaska","Southeast Fairbanks Census Area",2,43,89,54,35
050,02,240,"Alaska","Southeast Fairbanks Census Area",2,44,88,57,31
050,02,240,"Alaska","Southeast Fairbanks Census Area",2,45,83,57,26
050,02,240,"Alaska","Southeast Fairbanks Census Area",2,46,80,44,36
050,02,240,"Alaska","Southeast Fairbanks Census Area",2,47,73,46,27
050,02,240,"Alaska","Southeast Fairbanks Census Area",2,48,72,45,27
050,02,240,"Alaska","Southeast Fairbanks Census Area",2,49,87,53,34
050,02,240,"Alaska","Southeast Fairbanks Census Area",2,50,115,71,44
050,02,240,"Alaska","Southeast Fairbanks Census Area",2,51,92,58,34
050,02,240,"Alaska","Southeast Fairbanks Census Area",2,52,84,48,36
050,02,240,"Alaska","Southeast Fairbanks Census Area",2,53,95,58,37
050,02,240,"Alaska","Southeast Fairbanks Census Area",2,54,85,47,38
050,02,240,"Alaska","Southeast Fairbanks Census Area",2,55,88,50,38
050,02,240,"Alaska","Southeast Fairbanks Census Area",2,56,83,51,32
050,02,240,"Alaska","Southeast Fairbanks Census Area",2,57,100,60,40
050,02,240,"Alaska","Southeast Fairbanks Census Area",2,58,87,50,37
050,02,240,"Alaska","Southeast Fairbanks Census Area",2,59,99,66,33
050,02,240,"Alaska","Southeast Fairbanks Census Area",2,60,103,64,39
050,02,240,"Alaska","Southeast Fairbanks Census Area",2,61,94,53,41
050,02,240,"Alaska","Southeast Fairbanks Census Area",2,62,87,50,37
050,02,240,"Alaska","Southeast Fairbanks Census Area",2,63,90,48,42
050,02,240,"Alaska","Southeast Fairbanks Census Area",2,64,83,42,41
050,02,240,"Alaska","Southeast Fairbanks Census Area",2,65,95,52,43
050,02,240,"Alaska","Southeast Fairbanks Census Area",2,66,86,48,38
050,02,240,"Alaska","Southeast Fairbanks Census Area",2,67,75,42,33
050,02,240,"Alaska","Southeast Fairbanks Census Area",2,68,72,41,31
050,02,240,"Alaska","Southeast Fairbanks Census Area",2,69,76,41,35
050,02,240,"Alaska","Southeast Fairbanks Census Area",2,70,69,37,32
050,02,240,"Alaska","Southeast Fairbanks Census Area",2,71,63,36,27
050,02,240,"Alaska","Southeast Fairbanks Census Area",2,72,67,39,28
050,02,240,"Alaska","Southeast Fairbanks Census Area",2,73,62,36,26
050,02,240,"Alaska","Southeast Fairbanks Census Area",2,74,36,20,16
050,02,240,"Alaska","Southeast Fairbanks Census Area",2,75,36,20,16
050,02,240,"Alaska","Southeast Fairbanks Census Area",2,76,41,27,14
050,02,240,"Alaska","Southeast Fairbanks Census Area",2,77,44,29,15
050,02,240,"Alaska","Southeast Fairbanks Census Area",2,78,32,18,14
050,02,240,"Alaska","Southeast Fairbanks Census Area",2,79,28,15,13
050,02,240,"Alaska","Southeast Fairbanks Census Area",2,80,24,10,14
050,02,240,"Alaska","Southeast Fairbanks Census Area",2,81,21,10,11
050,02,240,"Alaska","Southeast Fairbanks Census Area",2,82,23,13,10
050,02,240,"Alaska","Southeast Fairbanks Census Area",2,83,14,9,5
050,02,240,"Alaska","Southeast Fairbanks Census Area",2,84,12,7,5
050,02,240,"Alaska","Southeast Fairbanks Census Area",2,85,55,22,33
050,02,240,"Alaska","Southeast Fairbanks Census Area",3,0,103,54,49
050,02,240,"Alaska","Southeast Fairbanks Census Area",3,1,109,57,52
050,02,240,"Alaska","Southeast Fairbanks Census Area",3,2,104,60,44
050,02,240,"Alaska","Southeast Fairbanks Census Area",3,3,92,45,47
050,02,240,"Alaska","Southeast Fairbanks Census Area",3,4,103,59,44
050,02,240,"Alaska","Southeast Fairbanks Census Area",3,5,101,54,47
050,02,240,"Alaska","Southeast Fairbanks Census Area",3,6,119,53,66
050,02,240,"Alaska","Southeast Fairbanks Census Area",3,7,102,50,52
050,02,240,"Alaska","Southeast Fairbanks Census Area",3,8,98,51,47
050,02,240,"Alaska","Southeast Fairbanks Census Area",3,9,91,40,51
050,02,240,"Alaska","Southeast Fairbanks Census Area",3,10,100,49,51
050,02,240,"Alaska","Southeast Fairbanks Census Area",3,11,108,63,45
050,02,240,"Alaska","Southeast Fairbanks Census Area",3,12,98,50,48
050,02,240,"Alaska","Southeast Fairbanks Census Area",3,13,90,45,45
050,02,240,"Alaska","Southeast Fairbanks Census Area",3,14,91,44,47
050,02,240,"Alaska","Southeast Fairbanks Census Area",3,15,86,41,45
050,02,240,"Alaska","Southeast Fairbanks Census Area",3,16,93,43,50
050,02,240,"Alaska","Southeast Fairbanks Census Area",3,17,92,49,43
050,02,240,"Alaska","Southeast Fairbanks Census Area",3,18,76,43,33
050,02,240,"Alaska","Southeast Fairbanks Census Area",3,19,61,33,28
050,02,240,"Alaska","Southeast Fairbanks Census Area",3,20,68,43,25
050,02,240,"Alaska","Southeast Fairbanks Census Area",3,21,55,35,20
050,02,240,"Alaska","Southeast Fairbanks Census Area",3,22,77,40,37
050,02,240,"Alaska","Southeast Fairbanks Census Area",3,23,66,37,29
050,02,240,"Alaska","Southeast Fairbanks Census Area",3,24,76,45,31
050,02,240,"Alaska","Southeast Fairbanks Census Area",3,25,97,63,34
050,02,240,"Alaska","Southeast Fairbanks Census Area",3,26,81,48,33
050,02,240,"Alaska","Southeast Fairbanks Census Area",3,27,82,43,39
050,02,240,"Alaska","Southeast Fairbanks Census Area",3,28,100,65,35
050,02,240,"Alaska","Southeast Fairbanks Census Area",3,29,83,52,31
050,02,240,"Alaska","Southeast Fairbanks Census Area",3,30,107,69,38
050,02,240,"Alaska","Southeast Fairbanks Census Area",3,31,115,70,45
050,02,240,"Alaska","Southeast Fairbanks Census Area",3,32,113,62,51
050,02,240,"Alaska","Southeast Fairbanks Census Area",3,33,105,57,48
050,02,240,"Alaska","Southeast Fairbanks Census Area",3,34,93,54,39
050,02,240,"Alaska","Southeast Fairbanks Census Area",3,35,102,64,38
050,02,240,"Alaska","Southeast Fairbanks Census Area",3,36,117,74,43
050,02,240,"Alaska","Southeast Fairbanks Census Area",3,37,94,60,34
050,02,240,"Alaska","Southeast Fairbanks Census Area",3,38,88,50,38
050,02,240,"Alaska","Southeast Fairbanks Census Area",3,39,99,57,42
050,02,240,"Alaska","Southeast Fairbanks Census Area",3,40,91,49,42
050,02,240,"Alaska","Southeast Fairbanks Census Area",3,41,97,55,42
050,02,240,"Alaska","Southeast Fairbanks Census Area",3,42,97,64,33
050,02,240,"Alaska","Southeast Fairbanks Census Area",3,43,97,59,38
050,02,240,"Alaska","Southeast Fairbanks Census Area",3,44,102,65,37
050,02,240,"Alaska","Southeast Fairbanks Census Area",3,45,80,51,29
050,02,240,"Alaska","Southeast Fairbanks Census Area",3,46,83,49,34
050,02,240,"Alaska","Southeast Fairbanks Census Area",3,47,78,47,31
050,02,240,"Alaska","Southeast Fairbanks Census Area",3,48,69,39,30
050,02,240,"Alaska","Southeast Fairbanks Census Area",3,49,76,51,25
050,02,240,"Alaska","Southeast Fairbanks Census Area",3,50,102,61,41
050,02,240,"Alaska","Southeast Fairbanks Census Area",3,51,98,66,32
050,02,240,"Alaska","Southeast Fairbanks Census Area",3,52,94,57,37
050,02,240,"Alaska","Southeast Fairbanks Census Area",3,53,90,60,30
050,02,240,"Alaska","Southeast Fairbanks Census Area",3,54,76,38,38
050,02,240,"Alaska","Southeast Fairbanks Census Area",3,55,79,43,36
050,02,240,"Alaska","Southeast Fairbanks Census Area",3,56,86,49,37
050,02,240,"Alaska","Southeast Fairbanks Census Area",3,57,90,56,34
050,02,240,"Alaska","Southeast Fairbanks Census Area",3,58,86,54,32
050,02,240,"Alaska","Southeast Fairbanks Census Area",3,59,90,56,34
050,02,240,"Alaska","Southeast Fairbanks Census Area",3,60,100,67,33
050,02,240,"Alaska","Southeast Fairbanks Census Area",3,61,94,54,40
050,02,240,"Alaska","Southeast Fairbanks Census Area",3,62,89,52,37
050,02,240,"Alaska","Southeast Fairbanks Census Area",3,63,89,52,37
050,02,240,"Alaska","Southeast Fairbanks Census Area",3,64,80,42,38
050,02,240,"Alaska","Southeast Fairbanks Census Area",3,65,84,45,39
050,02,240,"Alaska","Southeast Fairbanks Census Area",3,66,91,50,41
050,02,240,"Alaska","Southeast Fairbanks Census Area",3,67,84,46,38
050,02,240,"Alaska","Southeast Fairbanks Census Area",3,68,77,43,34
050,02,240,"Alaska","Southeast Fairbanks Census Area",3,69,71,38,33
050,02,240,"Alaska","Southeast Fairbanks Census Area",3,70,72,39,33
050,02,240,"Alaska","Southeast Fairbanks Census Area",3,71,65,35,30
050,02,240,"Alaska","Southeast Fairbanks Census Area",3,72,59,33,26
050,02,240,"Alaska","Southeast Fairbanks Census Area",3,73,65,40,25
050,02,240,"Alaska","Southeast Fairbanks Census Area",3,74,62,35,27
050,02,240,"Alaska","Southeast Fairbanks Census Area",3,75,35,19,16
050,02,240,"Alaska","Southeast Fairbanks Census Area",3,76,34,19,15
050,02,240,"Alaska","Southeast Fairbanks Census Area",3,77,40,27,13
050,02,240,"Alaska","Southeast Fairbanks Census Area",3,78,40,28,12
050,02,240,"Alaska","Southeast Fairbanks Census Area",3,79,30,18,12
050,02,240,"Alaska","Southeast Fairbanks Census Area",3,80,24,11,13
050,02,240,"Alaska","Southeast Fairbanks Census Area",3,81,22,9,13
050,02,240,"Alaska","Southeast Fairbanks Census Area",3,82,20,12,8
050,02,240,"Alaska","Southeast Fairbanks Census Area",3,83,22,13,9
050,02,240,"Alaska","Southeast Fairbanks Census Area",3,84,14,9,5
050,02,240,"Alaska","Southeast Fairbanks Census Area",3,85,48,21,27
050,02,240,"Alaska","Southeast Fairbanks Census Area",4,0,103,53,50
050,02,240,"Alaska","Southeast Fairbanks Census Area",4,1,91,52,39
050,02,240,"Alaska","Southeast Fairbanks Census Area",4,2,120,64,56
050,02,240,"Alaska","Southeast Fairbanks Census Area",4,3,91,54,37
050,02,240,"Alaska","Southeast Fairbanks Census Area",4,4,96,44,52
050,02,240,"Alaska","Southeast Fairbanks Census Area",4,5,107,50,57
050,02,240,"Alaska","Southeast Fairbanks Census Area",4,6,98,53,45
050,02,240,"Alaska","Southeast Fairbanks Census Area",4,7,111,52,59
050,02,240,"Alaska","Southeast Fairbanks Census Area",4,8,107,51,56
050,02,240,"Alaska","Southeast Fairbanks Census Area",4,9,95,49,46
050,02,240,"Alaska","Southeast Fairbanks Census Area",4,10,100,45,55
050,02,240,"Alaska","Southeast Fairbanks Census Area",4,11,96,45,51
050,02,240,"Alaska","Southeast Fairbanks Census Area",4,12,114,65,49
050,02,240,"Alaska","Southeast Fairbanks Census Area",4,13,101,51,50
050,02,240,"Alaska","Southeast Fairbanks Census Area",4,14,92,47,45
050,02,240,"Alaska","Southeast Fairbanks Census Area",4,15,93,45,48
050,02,240,"Alaska","Southeast Fairbanks Census Area",4,16,90,43,47
050,02,240,"Alaska","Southeast Fairbanks Census Area",4,17,90,40,50
050,02,240,"Alaska","Southeast Fairbanks Census Area",4,18,83,45,38
050,02,240,"Alaska","Southeast Fairbanks Census Area",4,19,59,36,23
050,02,240,"Alaska","Southeast Fairbanks Census Area",4,20,58,33,25
050,02,240,"Alaska","Southeast Fairbanks Census Area",4,21,64,41,23
050,02,240,"Alaska","Southeast Fairbanks Census Area",4,22,63,38,25
050,02,240,"Alaska","Southeast Fairbanks Census Area",4,23,68,40,28
050,02,240,"Alaska","Southeast Fairbanks Census Area",4,24,71,43,28
050,02,240,"Alaska","Southeast Fairbanks Census Area",4,25,87,54,33
050,02,240,"Alaska","Southeast Fairbanks Census Area",4,26,92,56,36
050,02,240,"Alaska","Southeast Fairbanks Census Area",4,27,69,38,31
050,02,240,"Alaska","Southeast Fairbanks Census Area",4,28,93,55,38
050,02,240,"Alaska","Southeast Fairbanks Census Area",4,29,87,54,33
050,02,240,"Alaska","Southeast Fairbanks Census Area",4,30,90,56,34
050,02,240,"Alaska","Southeast Fairbanks Census Area",4,31,115,77,38
050,02,240,"Alaska","Southeast Fairbanks Census Area",4,32,121,73,48
050,02,240,"Alaska","Southeast Fairbanks Census Area",4,33,105,56,49
050,02,240,"Alaska","Southeast Fairbanks Census Area",4,34,102,49,53
050,02,240,"Alaska","Southeast Fairbanks Census Area",4,35,90,52,38
050,02,240,"Alaska","Southeast Fairbanks Census Area",4,36,117,75,42
050,02,240,"Alaska","Southeast Fairbanks Census Area",4,37,97,60,37
050,02,240,"Alaska","Southeast Fairbanks Census Area",4,38,85,54,31
050,02,240,"Alaska","Southeast Fairbanks Census Area",4,39,107,64,43
050,02,240,"Alaska","Southeast Fairbanks Census Area",4,40,91,46,45
050,02,240,"Alaska","Southeast Fairbanks Census Area",4,41,86,50,36
050,02,240,"Alaska","Southeast Fairbanks Census Area",4,42,115,77,38
050,02,240,"Alaska","Southeast Fairbanks Census Area",4,43,91,57,34
050,02,240,"Alaska","Southeast Fairbanks Census Area",4,44,110,65,45
050,02,240,"Alaska","Southeast Fairbanks Census Area",4,45,90,56,34
050,02,240,"Alaska","Southeast Fairbanks Census Area",4,46,81,43,38
050,02,240,"Alaska","Southeast Fairbanks Census Area",4,47,74,50,24
050,02,240,"Alaska","Southeast Fairbanks Census Area",4,48,76,45,31
050,02,240,"Alaska","Southeast Fairbanks Census Area",4,49,78,49,29
050,02,240,"Alaska","Southeast Fairbanks Census Area",4,50,89,55,34
050,02,240,"Alaska","Southeast Fairbanks Census Area",4,51,92,56,36
050,02,240,"Alaska","Southeast Fairbanks Census Area",4,52,96,61,35
050,02,240,"Alaska","Southeast Fairbanks Census Area",4,53,101,65,36
050,02,240,"Alaska","Southeast Fairbanks Census Area",4,54,69,42,27
050,02,240,"Alaska","Southeast Fairbanks Census Area",4,55,75,35,40
050,02,240,"Alaska","Southeast Fairbanks Census Area",4,56,78,43,35
050,02,240,"Alaska","Southeast Fairbanks Census Area",4,57,95,54,41
050,02,240,"Alaska","Southeast Fairbanks Census Area",4,58,81,46,35
050,02,240,"Alaska","Southeast Fairbanks Census Area",4,59,90,62,28
050,02,240,"Alaska","Southeast Fairbanks Census Area",4,60,88,50,38
050,02,240,"Alaska","Southeast Fairbanks Census Area",4,61,95,64,31
050,02,240,"Alaska","Southeast Fairbanks Census Area",4,62,88,51,37
050,02,240,"Alaska","Southeast Fairbanks Census Area",4,63,86,49,37
050,02,240,"Alaska","Southeast Fairbanks Census Area",4,64,81,47,34
050,02,240,"Alaska","Southeast Fairbanks Census Area",4,65,85,48,37
050,02,240,"Alaska","Southeast Fairbanks Census Area",4,66,83,44,39
050,02,240,"Alaska","Southeast Fairbanks Census Area",4,67,93,51,42
050,02,240,"Alaska","Southeast Fairbanks Census Area",4,68,82,45,37
050,02,240,"Alaska","Southeast Fairbanks Census Area",4,69,79,42,37
050,02,240,"Alaska","Southeast Fairbanks Census Area",4,70,67,35,32
050,02,240,"Alaska","Southeast Fairbanks Census Area",4,71,66,35,31
050,02,240,"Alaska","Southeast Fairbanks Census Area",4,72,65,35,30
050,02,240,"Alaska","Southeast Fairbanks Census Area",4,73,57,32,25
050,02,240,"Alaska","Southeast Fairbanks Census Area",4,74,66,41,25
050,02,240,"Alaska","Southeast Fairbanks Census Area",4,75,56,31,25
050,02,240,"Alaska","Southeast Fairbanks Census Area",4,76,33,18,15
050,02,240,"Alaska","Southeast Fairbanks Census Area",4,77,34,19,15
050,02,240,"Alaska","Southeast Fairbanks Census Area",4,78,37,27,10
050,02,240,"Alaska","Southeast Fairbanks Census Area",4,79,35,26,9
050,02,240,"Alaska","Southeast Fairbanks Census Area",4,80,30,16,14
050,02,240,"Alaska","Southeast Fairbanks Census Area",4,81,22,11,11
050,02,240,"Alaska","Southeast Fairbanks Census Area",4,82,22,9,13
050,02,240,"Alaska","Southeast Fairbanks Census Area",4,83,21,12,9
050,02,240,"Alaska","Southeast Fairbanks Census Area",4,84,19,10,9
050,02,240,"Alaska","Southeast Fairbanks Census Area",4,85,50,24,26
050,02,240,"Alaska","Southeast Fairbanks Census Area",5,0,101,51,50
050,02,240,"Alaska","Southeast Fairbanks Census Area",5,1,99,54,45
050,02,240,"Alaska","Southeast Fairbanks Census Area",5,2,96,51,45
050,02,240,"Alaska","Southeast Fairbanks Census Area",5,3,112,60,52
050,02,240,"Alaska","Southeast Fairbanks Census Area",5,4,99,59,40
050,02,240,"Alaska","Southeast Fairbanks Census Area",5,5,104,44,60
050,02,240,"Alaska","Southeast Fairbanks Census Area",5,6,102,50,52
050,02,240,"Alaska","Southeast Fairbanks Census Area",5,7,105,51,54
050,02,240,"Alaska","Southeast Fairbanks Census Area",5,8,119,59,60
050,02,240,"Alaska","Southeast Fairbanks Census Area",5,9,110,51,59
050,02,240,"Alaska","Southeast Fairbanks Census Area",5,10,95,49,46
050,02,240,"Alaska","Southeast Fairbanks Census Area",5,11,99,45,54
050,02,240,"Alaska","Southeast Fairbanks Census Area",5,12,95,47,48
050,02,240,"Alaska","Southeast Fairbanks Census Area",5,13,116,66,50
050,02,240,"Alaska","Southeast Fairbanks Census Area",5,14,90,47,43
050,02,240,"Alaska","Southeast Fairbanks Census Area",5,15,92,48,44
050,02,240,"Alaska","Southeast Fairbanks Census Area",5,16,94,45,49
050,02,240,"Alaska","Southeast Fairbanks Census Area",5,17,87,41,46
050,02,240,"Alaska","Southeast Fairbanks Census Area",5,18,77,37,40
050,02,240,"Alaska","Southeast Fairbanks Census Area",5,19,60,34,26
050,02,240,"Alaska","Southeast Fairbanks Census Area",5,20,62,39,23
050,02,240,"Alaska","Southeast Fairbanks Census Area",5,21,64,34,30
050,02,240,"Alaska","Southeast Fairbanks Census Area",5,22,77,42,35
050,02,240,"Alaska","Southeast Fairbanks Census Area",5,23,67,42,25
050,02,240,"Alaska","Southeast Fairbanks Census Area",5,24,72,43,29
050,02,240,"Alaska","Southeast Fairbanks Census Area",5,25,90,58,32
050,02,240,"Alaska","Southeast Fairbanks Census Area",5,26,91,57,34
050,02,240,"Alaska","Southeast Fairbanks Census Area",5,27,95,52,43
050,02,240,"Alaska","Southeast Fairbanks Census Area",5,28,87,55,32
050,02,240,"Alaska","Southeast Fairbanks Census Area",5,29,91,53,38
050,02,240,"Alaska","Southeast Fairbanks Census Area",5,30,97,64,33
050,02,240,"Alaska","Southeast Fairbanks Census Area",5,31,94,61,33
050,02,240,"Alaska","Southeast Fairbanks Census Area",5,32,125,83,42
050,02,240,"Alaska","Southeast Fairbanks Census Area",5,33,114,68,46
050,02,240,"Alaska","Southeast Fairbanks Census Area",5,34,116,60,56
050,02,240,"Alaska","Southeast Fairbanks Census Area",5,35,102,47,55
050,02,240,"Alaska","Southeast Fairbanks Census Area",5,36,103,62,41
050,02,240,"Alaska","Southeast Fairbanks Census Area",5,37,100,62,38
050,02,240,"Alaska","Southeast Fairbanks Census Area",5,38,90,56,34
050,02,240,"Alaska","Southeast Fairbanks Census Area",5,39,92,61,31
050,02,240,"Alaska","Southeast Fairbanks Census Area",5,40,107,58,49
050,02,240,"Alaska","Southeast Fairbanks Census Area",5,41,89,46,43
050,02,240,"Alaska","Southeast Fairbanks Census Area",5,42,97,64,33
050,02,240,"Alaska","Southeast Fairbanks Census Area",5,43,105,70,35
050,02,240,"Alaska","Southeast Fairbanks Census Area",5,44,97,64,33
050,02,240,"Alaska","Southeast Fairbanks Census Area",5,45,111,61,50
050,02,240,"Alaska","Southeast Fairbanks Census Area",5,46,93,53,40
050,02,240,"Alaska","Southeast Fairbanks Census Area",5,47,80,48,32
050,02,240,"Alaska","Southeast Fairbanks Census Area",5,48,74,46,28
050,02,240,"Alaska","Southeast Fairbanks Census Area",5,49,75,48,27
050,02,240,"Alaska","Southeast Fairbanks Census Area",5,50,91,53,38
050,02,240,"Alaska","Southeast Fairbanks Census Area",5,51,73,46,27
050,02,240,"Alaska","Southeast Fairbanks Census Area",5,52,88,54,34
050,02,240,"Alaska","Southeast Fairbanks Census Area",5,53,105,72,33
050,02,240,"Alaska","Southeast Fairbanks Census Area",5,54,80,47,33
050,02,240,"Alaska","Southeast Fairbanks Census Area",5,55,68,40,28
050,02,240,"Alaska","Southeast Fairbanks Census Area",5,56,79,38,41
050,02,240,"Alaska","Southeast Fairbanks Census Area",5,57,83,47,36
050,02,240,"Alaska","Southeast Fairbanks Census Area",5,58,83,47,36
050,02,240,"Alaska","Southeast Fairbanks Census Area",5,59,81,53,28
050,02,240,"Alaska","Southeast Fairbanks Census Area",5,60,85,54,31
050,02,240,"Alaska","Southeast Fairbanks Census Area",5,61,85,49,36
050,02,240,"Alaska","Southeast Fairbanks Census Area",5,62,87,57,30
050,02,240,"Alaska","Southeast Fairbanks Census Area",5,63,82,46,36
050,02,240,"Alaska","Southeast Fairbanks Census Area",5,64,79,45,34
050,02,240,"Alaska","Southeast Fairbanks Census Area",5,65,82,46,36
050,02,240,"Alaska","Southeast Fairbanks Census Area",5,66,81,47,34
050,02,240,"Alaska","Southeast Fairbanks Census Area",5,67,83,44,39
050,02,240,"Alaska","Southeast Fairbanks Census Area",5,68,91,52,39
050,02,240,"Alaska","Southeast Fairbanks Census Area",5,69,79,43,36
050,02,240,"Alaska","Southeast Fairbanks Census Area",5,70,68,36,32
050,02,240,"Alaska","Southeast Fairbanks Census Area",5,71,66,35,31
050,02,240,"Alaska","Southeast Fairbanks Census Area",5,72,67,36,31
050,02,240,"Alaska","Southeast Fairbanks Census Area",5,73,59,33,26
050,02,240,"Alaska","Southeast Fairbanks Census Area",5,74,56,32,24
050,02,240,"Alaska","Southeast Fairbanks Census Area",5,75,62,38,24
050,02,240,"Alaska","Southeast Fairbanks Census Area",5,76,53,29,24
050,02,240,"Alaska","Southeast Fairbanks Census Area",5,77,30,16,14
050,02,240,"Alaska","Southeast Fairbanks Census Area",5,78,30,18,12
050,02,240,"Alaska","Southeast Fairbanks Census Area",5,79,35,27,8
050,02,240,"Alaska","Southeast Fairbanks Census Area",5,80,34,24,10
050,02,240,"Alaska","Southeast Fairbanks Census Area",5,81,28,16,12
050,02,240,"Alaska","Southeast Fairbanks Census Area",5,82,21,12,9
050,02,240,"Alaska","Southeast Fairbanks Census Area",5,83,21,8,13
050,02,240,"Alaska","Southeast Fairbanks Census Area",5,84,18,9,9
050,02,240,"Alaska","Southeast Fairbanks Census Area",5,85,55,27,28
050,02,275,"Alaska","Wrangell City and Borough",1,0,21,11,10
050,02,275,"Alaska","Wrangell City and Borough",1,1,22,13,9
050,02,275,"Alaska","Wrangell City and Borough",1,2,20,10,10
050,02,275,"Alaska","Wrangell City and Borough",1,3,15,6,9
050,02,275,"Alaska","Wrangell City and Borough",1,4,19,9,10
050,02,275,"Alaska","Wrangell City and Borough",1,5,23,10,13
050,02,275,"Alaska","Wrangell City and Borough",1,6,25,11,14
050,02,275,"Alaska","Wrangell City and Borough",1,7,24,8,16
050,02,275,"Alaska","Wrangell City and Borough",1,8,24,8,16
050,02,275,"Alaska","Wrangell City and Borough",1,9,29,14,15
050,02,275,"Alaska","Wrangell City and Borough",1,10,27,15,12
050,02,275,"Alaska","Wrangell City and Borough",1,11,25,12,13
050,02,275,"Alaska","Wrangell City and Borough",1,12,23,15,8
050,02,275,"Alaska","Wrangell City and Borough",1,13,24,13,11
050,02,275,"Alaska","Wrangell City and Borough",1,14,21,11,10
050,02,275,"Alaska","Wrangell City and Borough",1,15,24,13,11
050,02,275,"Alaska","Wrangell City and Borough",1,16,18,8,10
050,02,275,"Alaska","Wrangell City and Borough",1,17,22,10,12
050,02,275,"Alaska","Wrangell City and Borough",1,18,23,12,11
050,02,275,"Alaska","Wrangell City and Borough",1,19,20,12,8
050,02,275,"Alaska","Wrangell City and Borough",1,20,17,13,4
050,02,275,"Alaska","Wrangell City and Borough",1,21,17,11,6
050,02,275,"Alaska","Wrangell City and Borough",1,22,16,10,6
050,02,275,"Alaska","Wrangell City and Borough",1,23,18,10,8
050,02,275,"Alaska","Wrangell City and Borough",1,24,27,12,15
050,02,275,"Alaska","Wrangell City and Borough",1,25,28,15,13
050,02,275,"Alaska","Wrangell City and Borough",1,26,17,11,6
050,02,275,"Alaska","Wrangell City and Borough",1,27,18,12,6
050,02,275,"Alaska","Wrangell City and Borough",1,28,23,11,12
050,02,275,"Alaska","Wrangell City and Borough",1,29,24,10,14
050,02,275,"Alaska","Wrangell City and Borough",1,30,20,10,10
050,02,275,"Alaska","Wrangell City and Borough",1,31,27,17,10
050,02,275,"Alaska","Wrangell City and Borough",1,32,24,14,10
050,02,275,"Alaska","Wrangell City and Borough",1,33,19,9,10
050,02,275,"Alaska","Wrangell City and Borough",1,34,21,11,10
050,02,275,"Alaska","Wrangell City and Borough",1,35,22,11,11
050,02,275,"Alaska","Wrangell City and Borough",1,36,20,10,10
050,02,275,"Alaska","Wrangell City and Borough",1,37,23,12,11
050,02,275,"Alaska","Wrangell City and Borough",1,38,24,14,10
050,02,275,"Alaska","Wrangell City and Borough",1,39,19,12,7
050,02,275,"Alaska","Wrangell City and Borough",1,40,27,17,10
050,02,275,"Alaska","Wrangell City and Borough",1,41,22,12,10
050,02,275,"Alaska","Wrangell City and Borough",1,42,17,11,6
050,02,275,"Alaska","Wrangell City and Borough",1,43,16,8,8
050,02,275,"Alaska","Wrangell City and Borough",1,44,19,5,14
050,02,275,"Alaska","Wrangell City and Borough",1,45,19,11,8
050,02,275,"Alaska","Wrangell City and Borough",1,46,16,9,7
050,02,275,"Alaska","Wrangell City and Borough",1,47,27,13,14
050,02,275,"Alaska","Wrangell City and Borough",1,48,26,14,12
050,02,275,"Alaska","Wrangell City and Borough",1,49,18,8,10
050,02,275,"Alaska","Wrangell City and Borough",1,50,30,13,17
050,02,275,"Alaska","Wrangell City and Borough",1,51,24,13,11
050,02,275,"Alaska","Wrangell City and Borough",1,52,28,13,15
050,02,275,"Alaska","Wrangell City and Borough",1,53,25,13,12
050,02,275,"Alaska","Wrangell City and Borough",1,54,22,10,12
050,02,275,"Alaska","Wrangell City and Borough",1,55,37,23,14
050,02,275,"Alaska","Wrangell City and Borough",1,56,30,19,11
050,02,275,"Alaska","Wrangell City and Borough",1,57,37,20,17
050,02,275,"Alaska","Wrangell City and Borough",1,58,30,17,13
050,02,275,"Alaska","Wrangell City and Borough",1,59,38,19,19
050,02,275,"Alaska","Wrangell City and Borough",1,60,36,19,17
050,02,275,"Alaska","Wrangell City and Borough",1,61,46,28,18
050,02,275,"Alaska","Wrangell City and Borough",1,62,43,23,20
050,02,275,"Alaska","Wrangell City and Borough",1,63,47,25,22
050,02,275,"Alaska","Wrangell City and Borough",1,64,39,21,18
050,02,275,"Alaska","Wrangell City and Borough",1,65,45,19,26
050,02,275,"Alaska","Wrangell City and Borough",1,66,43,26,17
050,02,275,"Alaska","Wrangell City and Borough",1,67,34,16,18
050,02,275,"Alaska","Wrangell City and Borough",1,68,39,22,17
050,02,275,"Alaska","Wrangell City and Borough",1,69,33,23,10
050,02,275,"Alaska","Wrangell City and Borough",1,70,31,20,11
050,02,275,"Alaska","Wrangell City and Borough",1,71,36,23,13
050,02,275,"Alaska","Wrangell City and Borough",1,72,29,17,12
050,02,275,"Alaska","Wrangell City and Borough",1,73,31,18,13
050,02,275,"Alaska","Wrangell City and Borough",1,74,21,10,11
050,02,275,"Alaska","Wrangell City and Borough",1,75,18,8,10
050,02,275,"Alaska","Wrangell City and Borough",1,76,15,7,8
050,02,275,"Alaska","Wrangell City and Borough",1,77,16,7,9
050,02,275,"Alaska","Wrangell City and Borough",1,78,17,8,9
050,02,275,"Alaska","Wrangell City and Borough",1,79,11,5,6
050,02,275,"Alaska","Wrangell City and Borough",1,80,13,6,7
050,02,275,"Alaska","Wrangell City and Borough",1,81,9,5,4
050,02,275,"Alaska","Wrangell City and Borough",1,82,18,11,7
050,02,275,"Alaska","Wrangell City and Borough",1,83,14,9,5
050,02,275,"Alaska","Wrangell City and Borough",1,84,12,7,5
050,02,275,"Alaska","Wrangell City and Borough",1,85,48,18,30
050,02,275,"Alaska","Wrangell City and Borough",2,0,21,12,9
050,02,275,"Alaska","Wrangell City and Borough",2,1,22,13,9
050,02,275,"Alaska","Wrangell City and Borough",2,2,21,11,10
050,02,275,"Alaska","Wrangell City and Borough",2,3,15,6,9
050,02,275,"Alaska","Wrangell City and Borough",2,4,19,9,10
050,02,275,"Alaska","Wrangell City and Borough",2,5,22,10,12
050,02,275,"Alaska","Wrangell City and Borough",2,6,24,10,14
050,02,275,"Alaska","Wrangell City and Borough",2,7,23,8,15
050,02,275,"Alaska","Wrangell City and Borough",2,8,24,8,16
050,02,275,"Alaska","Wrangell City and Borough",2,9,28,13,15
050,02,275,"Alaska","Wrangell City and Borough",2,10,26,14,12
050,02,275,"Alaska","Wrangell City and Borough",2,11,25,12,13
050,02,275,"Alaska","Wrangell City and Borough",2,12,23,14,9
050,02,275,"Alaska","Wrangell City and Borough",2,13,23,13,10
050,02,275,"Alaska","Wrangell City and Borough",2,14,21,11,10
050,02,275,"Alaska","Wrangell City and Borough",2,15,23,13,10
050,02,275,"Alaska","Wrangell City and Borough",2,16,21,10,11
050,02,275,"Alaska","Wrangell City and Borough",2,17,22,10,12
050,02,275,"Alaska","Wrangell City and Borough",2,18,23,12,11
050,02,275,"Alaska","Wrangell City and Borough",2,19,19,12,7
050,02,275,"Alaska","Wrangell City and Borough",2,20,18,13,5
050,02,275,"Alaska","Wrangell City and Borough",2,21,17,11,6
050,02,275,"Alaska","Wrangell City and Borough",2,22,15,9,6
050,02,275,"Alaska","Wrangell City and Borough",2,23,18,10,8
050,02,275,"Alaska","Wrangell City and Borough",2,24,26,12,14
050,02,275,"Alaska","Wrangell City and Borough",2,25,28,14,14
050,02,275,"Alaska","Wrangell City and Borough",2,26,21,12,9
050,02,275,"Alaska","Wrangell City and Borough",2,27,19,13,6
050,02,275,"Alaska","Wrangell City and Borough",2,28,23,11,12
050,02,275,"Alaska","Wrangell City and Borough",2,29,24,11,13
050,02,275,"Alaska","Wrangell City and Borough",2,30,22,11,11
050,02,275,"Alaska","Wrangell City and Borough",2,31,28,17,11
050,02,275,"Alaska","Wrangell City and Borough",2,32,26,15,11
050,02,275,"Alaska","Wrangell City and Borough",2,33,21,10,11
050,02,275,"Alaska","Wrangell City and Borough",2,34,21,11,10
050,02,275,"Alaska","Wrangell City and Borough",2,35,22,11,11
050,02,275,"Alaska","Wrangell City and Borough",2,36,20,10,10
050,02,275,"Alaska","Wrangell City and Borough",2,37,22,12,10
050,02,275,"Alaska","Wrangell City and Borough",2,38,24,13,11
050,02,275,"Alaska","Wrangell City and Borough",2,39,19,12,7
050,02,275,"Alaska","Wrangell City and Borough",2,40,28,18,10
050,02,275,"Alaska","Wrangell City and Borough",2,41,24,14,10
050,02,275,"Alaska","Wrangell City and Borough",2,42,18,11,7
050,02,275,"Alaska","Wrangell City and Borough",2,43,16,9,7
050,02,275,"Alaska","Wrangell City and Borough",2,44,17,5,12
050,02,275,"Alaska","Wrangell City and Borough",2,45,20,10,10
050,02,275,"Alaska","Wrangell City and Borough",2,46,17,10,7
050,02,275,"Alaska","Wrangell City and Borough",2,47,24,12,12
050,02,275,"Alaska","Wrangell City and Borough",2,48,25,13,12
050,02,275,"Alaska","Wrangell City and Borough",2,49,20,10,10
050,02,275,"Alaska","Wrangell City and Borough",2,50,27,11,16
050,02,275,"Alaska","Wrangell City and Borough",2,51,25,13,12
050,02,275,"Alaska","Wrangell City and Borough",2,52,27,13,14
050,02,275,"Alaska","Wrangell City and Borough",2,53,25,12,13
050,02,275,"Alaska","Wrangell City and Borough",2,54,22,10,12
050,02,275,"Alaska","Wrangell City and Borough",2,55,31,18,13
050,02,275,"Alaska","Wrangell City and Borough",2,56,32,20,12
050,02,275,"Alaska","Wrangell City and Borough",2,57,35,19,16
050,02,275,"Alaska","Wrangell City and Borough",2,58,31,17,14
050,02,275,"Alaska","Wrangell City and Borough",2,59,35,19,16
050,02,275,"Alaska","Wrangell City and Borough",2,60,36,19,17
050,02,275,"Alaska","Wrangell City and Borough",2,61,42,24,18
050,02,275,"Alaska","Wrangell City and Borough",2,62,44,24,20
050,02,275,"Alaska","Wrangell City and Borough",2,63,47,25,22
050,02,275,"Alaska","Wrangell City and Borough",2,64,37,19,18
050,02,275,"Alaska","Wrangell City and Borough",2,65,43,20,23
050,02,275,"Alaska","Wrangell City and Borough",2,66,44,24,20
050,02,275,"Alaska","Wrangell City and Borough",2,67,37,20,17
050,02,275,"Alaska","Wrangell City and Borough",2,68,37,20,17
050,02,275,"Alaska","Wrangell City and Borough",2,69,34,23,11
050,02,275,"Alaska","Wrangell City and Borough",2,70,33,22,11
050,02,275,"Alaska","Wrangell City and Borough",2,71,36,23,13
050,02,275,"Alaska","Wrangell City and Borough",2,72,30,18,12
050,02,275,"Alaska","Wrangell City and Borough",2,73,33,20,13
050,02,275,"Alaska","Wrangell City and Borough",2,74,22,11,11
050,02,275,"Alaska","Wrangell City and Borough",2,75,19,9,10
050,02,275,"Alaska","Wrangell City and Borough",2,76,15,7,8
050,02,275,"Alaska","Wrangell City and Borough",2,77,16,7,9
050,02,275,"Alaska","Wrangell City and Borough",2,78,17,8,9
050,02,275,"Alaska","Wrangell City and Borough",2,79,11,5,6
050,02,275,"Alaska","Wrangell City and Borough",2,80,13,6,7
050,02,275,"Alaska","Wrangell City and Borough",2,81,9,5,4
050,02,275,"Alaska","Wrangell City and Borough",2,82,16,10,6
050,02,275,"Alaska","Wrangell City and Borough",2,83,14,9,5
050,02,275,"Alaska","Wrangell City and Borough",2,84,13,8,5
050,02,275,"Alaska","Wrangell City and Borough",2,85,50,19,31
050,02,275,"Alaska","Wrangell City and Borough",3,0,21,9,12
050,02,275,"Alaska","Wrangell City and Borough",3,1,23,14,9
050,02,275,"Alaska","Wrangell City and Borough",3,2,26,16,10
050,02,275,"Alaska","Wrangell City and Borough",3,3,21,11,10
050,02,275,"Alaska","Wrangell City and Borough",3,4,17,8,9
050,02,275,"Alaska","Wrangell City and Borough",3,5,19,8,11
050,02,275,"Alaska","Wrangell City and Borough",3,6,25,12,13
050,02,275,"Alaska","Wrangell City and Borough",3,7,23,10,13
050,02,275,"Alaska","Wrangell City and Borough",3,8,22,8,14
050,02,275,"Alaska","Wrangell City and Borough",3,9,26,9,17
050,02,275,"Alaska","Wrangell City and Borough",3,10,25,12,13
050,02,275,"Alaska","Wrangell City and Borough",3,11,26,12,14
050,02,275,"Alaska","Wrangell City and Borough",3,12,25,13,12
050,02,275,"Alaska","Wrangell City and Borough",3,13,22,14,8
050,02,275,"Alaska","Wrangell City and Borough",3,14,21,11,10
050,02,275,"Alaska","Wrangell City and Borough",3,15,21,9,12
050,02,275,"Alaska","Wrangell City and Borough",3,16,19,11,8
050,02,275,"Alaska","Wrangell City and Borough",3,17,20,10,10
050,02,275,"Alaska","Wrangell City and Borough",3,18,20,11,9
050,02,275,"Alaska","Wrangell City and Borough",3,19,18,11,7
050,02,275,"Alaska","Wrangell City and Borough",3,20,18,12,6
050,02,275,"Alaska","Wrangell City and Borough",3,21,14,8,6
050,02,275,"Alaska","Wrangell City and Borough",3,22,19,12,7
050,02,275,"Alaska","Wrangell City and Borough",3,23,17,10,7
050,02,275,"Alaska","Wrangell City and Borough",3,24,18,9,9
050,02,275,"Alaska","Wrangell City and Borough",3,25,25,10,15
050,02,275,"Alaska","Wrangell City and Borough",3,26,28,15,13
050,02,275,"Alaska","Wrangell City and Borough",3,27,22,11,11
050,02,275,"Alaska","Wrangell City and Borough",3,28,21,14,7
050,02,275,"Alaska","Wrangell City and Borough",3,29,22,12,10
050,02,275,"Alaska","Wrangell City and Borough",3,30,23,10,13
050,02,275,"Alaska","Wrangell City and Borough",3,31,23,12,11
050,02,275,"Alaska","Wrangell City and Borough",3,32,26,17,9
050,02,275,"Alaska","Wrangell City and Borough",3,33,32,20,12
050,02,275,"Alaska","Wrangell City and Borough",3,34,20,8,12
050,02,275,"Alaska","Wrangell City and Borough",3,35,20,9,11
050,02,275,"Alaska","Wrangell City and Borough",3,36,21,8,13
050,02,275,"Alaska","Wrangell City and Borough",3,37,18,9,9
050,02,275,"Alaska","Wrangell City and Borough",3,38,20,12,8
050,02,275,"Alaska","Wrangell City and Borough",3,39,19,11,8
050,02,275,"Alaska","Wrangell City and Borough",3,40,18,11,7
050,02,275,"Alaska","Wrangell City and Borough",3,41,27,18,9
050,02,275,"Alaska","Wrangell City and Borough",3,42,25,16,9
050,02,275,"Alaska","Wrangell City and Borough",3,43,16,9,7
050,02,275,"Alaska","Wrangell City and Borough",3,44,15,9,6
050,02,275,"Alaska","Wrangell City and Borough",3,45,16,5,11
050,02,275,"Alaska","Wrangell City and Borough",3,46,20,11,9
050,02,275,"Alaska","Wrangell City and Borough",3,47,17,10,7
050,02,275,"Alaska","Wrangell City and Borough",3,48,25,13,12
050,02,275,"Alaska","Wrangell City and Borough",3,49,26,13,13
050,02,275,"Alaska","Wrangell City and Borough",3,50,21,11,10
050,02,275,"Alaska","Wrangell City and Borough",3,51,26,10,16
050,02,275,"Alaska","Wrangell City and Borough",3,52,26,13,13
050,02,275,"Alaska","Wrangell City and Borough",3,53,27,13,14
050,02,275,"Alaska","Wrangell City and Borough",3,54,25,11,14
050,02,275,"Alaska","Wrangell City and Borough",3,55,23,11,12
050,02,275,"Alaska","Wrangell City and Borough",3,56,28,16,12
050,02,275,"Alaska","Wrangell City and Borough",3,57,30,18,12
050,02,275,"Alaska","Wrangell City and Borough",3,58,34,19,15
050,02,275,"Alaska","Wrangell City and Borough",3,59,31,17,14
050,02,275,"Alaska","Wrangell City and Borough",3,60,28,14,14
050,02,275,"Alaska","Wrangell City and Borough",3,61,37,20,17
050,02,275,"Alaska","Wrangell City and Borough",3,62,42,24,18
050,02,275,"Alaska","Wrangell City and Borough",3,63,41,22,19
050,02,275,"Alaska","Wrangell City and Borough",3,64,45,23,22
050,02,275,"Alaska","Wrangell City and Borough",3,65,36,19,17
050,02,275,"Alaska","Wrangell City and Borough",3,66,41,19,22
050,02,275,"Alaska","Wrangell City and Borough",3,67,45,25,20
050,02,275,"Alaska","Wrangell City and Borough",3,68,36,20,16
050,02,275,"Alaska","Wrangell City and Borough",3,69,34,17,17
050,02,275,"Alaska","Wrangell City and Borough",3,70,34,23,11
050,02,275,"Alaska","Wrangell City and Borough",3,71,32,21,11
050,02,275,"Alaska","Wrangell City and Borough",3,72,35,22,13
050,02,275,"Alaska","Wrangell City and Borough",3,73,30,18,12
050,02,275,"Alaska","Wrangell City and Borough",3,74,33,19,14
050,02,275,"Alaska","Wrangell City and Borough",3,75,21,11,10
050,02,275,"Alaska","Wrangell City and Borough",3,76,18,9,9
050,02,275,"Alaska","Wrangell City and Borough",3,77,16,7,9
050,02,275,"Alaska","Wrangell City and Borough",3,78,15,7,8
050,02,275,"Alaska","Wrangell City and Borough",3,79,17,7,10
050,02,275,"Alaska","Wrangell City and Borough",3,80,11,5,6
050,02,275,"Alaska","Wrangell City and Borough",3,81,13,6,7
050,02,275,"Alaska","Wrangell City and Borough",3,82,8,5,3
050,02,275,"Alaska","Wrangell City and Borough",3,83,14,8,6
050,02,275,"Alaska","Wrangell City and Borough",3,84,14,9,5
050,02,275,"Alaska","Wrangell City and Borough",3,85,64,29,35
050,02,275,"Alaska","Wrangell City and Borough",4,0,19,5,14
050,02,275,"Alaska","Wrangell City and Borough",4,1,19,7,12
050,02,275,"Alaska","Wrangell City and Borough",4,2,24,15,9
050,02,275,"Alaska","Wrangell City and Borough",4,3,27,15,12
050,02,275,"Alaska","Wrangell City and Borough",4,4,20,10,10
050,02,275,"Alaska","Wrangell City and Borough",4,5,16,7,9
050,02,275,"Alaska","Wrangell City and Borough",4,6,23,13,10
050,02,275,"Alaska","Wrangell City and Borough",4,7,23,10,13
050,02,275,"Alaska","Wrangell City and Borough",4,8,23,11,12
050,02,275,"Alaska","Wrangell City and Borough",4,9,20,7,13
050,02,275,"Alaska","Wrangell City and Borough",4,10,25,8,17
050,02,275,"Alaska","Wrangell City and Borough",4,11,24,11,13
050,02,275,"Alaska","Wrangell City and Borough",4,12,26,12,14
050,02,275,"Alaska","Wrangell City and Borough",4,13,21,13,8
050,02,275,"Alaska","Wrangell City and Borough",4,14,21,12,9
050,02,275,"Alaska","Wrangell City and Borough",4,15,20,11,9
050,02,275,"Alaska","Wrangell City and Borough",4,16,22,10,12
050,02,275,"Alaska","Wrangell City and Borough",4,17,22,11,11
050,02,275,"Alaska","Wrangell City and Borough",4,18,19,9,10
050,02,275,"Alaska","Wrangell City and Borough",4,19,17,9,8
050,02,275,"Alaska","Wrangell City and Borough",4,20,18,12,6
050,02,275,"Alaska","Wrangell City and Borough",4,21,19,12,7
050,02,275,"Alaska","Wrangell City and Borough",4,22,15,8,7
050,02,275,"Alaska","Wrangell City and Borough",4,23,16,10,6
050,02,275,"Alaska","Wrangell City and Borough",4,24,16,10,6
050,02,275,"Alaska","Wrangell City and Borough",4,25,17,8,9
050,02,275,"Alaska","Wrangell City and Borough",4,26,28,12,16
050,02,275,"Alaska","Wrangell City and Borough",4,27,28,13,15
050,02,275,"Alaska","Wrangell City and Borough",4,28,22,11,11
050,02,275,"Alaska","Wrangell City and Borough",4,29,24,16,8
050,02,275,"Alaska","Wrangell City and Borough",4,30,23,11,12
050,02,275,"Alaska","Wrangell City and Borough",4,31,24,10,14
050,02,275,"Alaska","Wrangell City and Borough",4,32,22,13,9
050,02,275,"Alaska","Wrangell City and Borough",4,33,20,14,6
050,02,275,"Alaska","Wrangell City and Borough",4,34,30,18,12
050,02,275,"Alaska","Wrangell City and Borough",4,35,20,8,12
050,02,275,"Alaska","Wrangell City and Borough",4,36,21,10,11
050,02,275,"Alaska","Wrangell City and Borough",4,37,16,6,10
050,02,275,"Alaska","Wrangell City and Borough",4,38,22,11,11
050,02,275,"Alaska","Wrangell City and Borough",4,39,20,13,7
050,02,275,"Alaska","Wrangell City and Borough",4,40,17,10,7
050,02,275,"Alaska","Wrangell City and Borough",4,41,15,10,5
050,02,275,"Alaska","Wrangell City and Borough",4,42,26,18,8
050,02,275,"Alaska","Wrangell City and Borough",4,43,23,15,8
050,02,275,"Alaska","Wrangell City and Borough",4,44,15,10,5
050,02,275,"Alaska","Wrangell City and Borough",4,45,13,7,6
050,02,275,"Alaska","Wrangell City and Borough",4,46,17,6,11
050,02,275,"Alaska","Wrangell City and Borough",4,47,19,11,8
050,02,275,"Alaska","Wrangell City and Borough",4,48,18,11,7
050,02,275,"Alaska","Wrangell City and Borough",4,49,26,13,13
050,02,275,"Alaska","Wrangell City and Borough",4,50,22,11,11
050,02,275,"Alaska","Wrangell City and Borough",4,51,22,12,10
050,02,275,"Alaska","Wrangell City and Borough",4,52,25,10,15
050,02,275,"Alaska","Wrangell City and Borough",4,53,25,11,14
050,02,275,"Alaska","Wrangell City and Borough",4,54,25,11,14
050,02,275,"Alaska","Wrangell City and Borough",4,55,24,12,12
050,02,275,"Alaska","Wrangell City and Borough",4,56,16,6,10
050,02,275,"Alaska","Wrangell City and Borough",4,57,27,15,12
050,02,275,"Alaska","Wrangell City and Borough",4,58,29,18,11
050,02,275,"Alaska","Wrangell City and Borough",4,59,35,20,15
050,02,275,"Alaska","Wrangell City and Borough",4,60,29,15,14
050,02,275,"Alaska","Wrangell City and Borough",4,61,28,15,13
050,02,275,"Alaska","Wrangell City and Borough",4,62,37,20,17
050,02,275,"Alaska","Wrangell City and Borough",4,63,45,24,21
050,02,275,"Alaska","Wrangell City and Borough",4,64,45,25,20
050,02,275,"Alaska","Wrangell City and Borough",4,65,43,22,21
050,02,275,"Alaska","Wrangell City and Borough",4,66,39,21,18
050,02,275,"Alaska","Wrangell City and Borough",4,67,42,19,23
050,02,275,"Alaska","Wrangell City and Borough",4,68,46,25,21
050,02,275,"Alaska","Wrangell City and Borough",4,69,38,22,16
050,02,275,"Alaska","Wrangell City and Borough",4,70,38,21,17
050,02,275,"Alaska","Wrangell City and Borough",4,71,31,21,10
050,02,275,"Alaska","Wrangell City and Borough",4,72,31,20,11
050,02,275,"Alaska","Wrangell City and Borough",4,73,35,22,13
050,02,275,"Alaska","Wrangell City and Borough",4,74,29,17,12
050,02,275,"Alaska","Wrangell City and Borough",4,75,32,18,14
050,02,275,"Alaska","Wrangell City and Borough",4,76,20,11,9
050,02,275,"Alaska","Wrangell City and Borough",4,77,18,9,9
050,02,275,"Alaska","Wrangell City and Borough",4,78,15,7,8
050,02,275,"Alaska","Wrangell City and Borough",4,79,14,5,9
050,02,275,"Alaska","Wrangell City and Borough",4,80,17,7,10
050,02,275,"Alaska","Wrangell City and Borough",4,81,11,5,6
050,02,275,"Alaska","Wrangell City and Borough",4,82,10,5,5
050,02,275,"Alaska","Wrangell City and Borough",4,83,5,3,2
050,02,275,"Alaska","Wrangell City and Borough",4,84,14,8,6
050,02,275,"Alaska","Wrangell City and Borough",4,85,68,32,36
050,02,275,"Alaska","Wrangell City and Borough",5,0,19,5,14
050,02,275,"Alaska","Wrangell City and Borough",5,1,21,7,14
050,02,275,"Alaska","Wrangell City and Borough",5,2,19,6,13
050,02,275,"Alaska","Wrangell City and Borough",5,3,24,15,9
050,02,275,"Alaska","Wrangell City and Borough",5,4,31,14,17
050,02,275,"Alaska","Wrangell City and Borough",5,5,16,10,6
050,02,275,"Alaska","Wrangell City and Borough",5,6,16,6,10
050,02,275,"Alaska","Wrangell City and Borough",5,7,22,13,9
050,02,275,"Alaska","Wrangell City and Borough",5,8,22,10,12
050,02,275,"Alaska","Wrangell City and Borough",5,9,22,10,12
050,02,275,"Alaska","Wrangell City and Borough",5,10,19,7,12
050,02,275,"Alaska","Wrangell City and Borough",5,11,23,8,15
050,02,275,"Alaska","Wrangell City and Borough",5,12,23,11,12
050,02,275,"Alaska","Wrangell City and Borough",5,13,24,10,14
050,02,275,"Alaska","Wrangell City and Borough",5,14,22,13,9
050,02,275,"Alaska","Wrangell City and Borough",5,15,20,13,7
050,02,275,"Alaska","Wrangell City and Borough",5,16,17,10,7
050,02,275,"Alaska","Wrangell City and Borough",5,17,18,9,9
050,02,275,"Alaska","Wrangell City and Borough",5,18,19,9,10
050,02,275,"Alaska","Wrangell City and Borough",5,19,17,9,8
050,02,275,"Alaska","Wrangell City and Borough",5,20,20,11,9
050,02,275,"Alaska","Wrangell City and Borough",5,21,21,14,7
050,02,275,"Alaska","Wrangell City and Borough",5,22,21,12,9
050,02,275,"Alaska","Wrangell City and Borough",5,23,18,7,11
050,02,275,"Alaska","Wrangell City and Borough",5,24,19,13,6
050,02,275,"Alaska","Wrangell City and Borough",5,25,16,9,7
050,02,275,"Alaska","Wrangell City and Borough",5,26,18,8,10
050,02,275,"Alaska","Wrangell City and Borough",5,27,28,12,16
050,02,275,"Alaska","Wrangell City and Borough",5,28,29,15,14
050,02,275,"Alaska","Wrangell City and Borough",5,29,17,9,8
050,02,275,"Alaska","Wrangell City and Borough",5,30,19,12,7
050,02,275,"Alaska","Wrangell City and Borough",5,31,23,10,13
050,02,275,"Alaska","Wrangell City and Borough",5,32,26,13,13
050,02,275,"Alaska","Wrangell City and Borough",5,33,20,10,10
050,02,275,"Alaska","Wrangell City and Borough",5,34,18,12,6
050,02,275,"Alaska","Wrangell City and Borough",5,35,29,18,11
050,02,275,"Alaska","Wrangell City and Borough",5,36,25,12,13
050,02,275,"Alaska","Wrangell City and Borough",5,37,20,11,9
050,02,275,"Alaska","Wrangell City and Borough",5,38,15,7,8
050,02,275,"Alaska","Wrangell City and Borough",5,39,21,10,11
050,02,275,"Alaska","Wrangell City and Borough",5,40,20,13,7
050,02,275,"Alaska","Wrangell City and Borough",5,41,16,9,7
050,02,275,"Alaska","Wrangell City and Borough",5,42,15,10,5
050,02,275,"Alaska","Wrangell City and Borough",5,43,30,18,12
050,02,275,"Alaska","Wrangell City and Borough",5,44,21,15,6
050,02,275,"Alaska","Wrangell City and Borough",5,45,15,10,5
050,02,275,"Alaska","Wrangell City and Borough",5,46,14,8,6
050,02,275,"Alaska","Wrangell City and Borough",5,47,19,6,13
050,02,275,"Alaska","Wrangell City and Borough",5,48,21,13,8
050,02,275,"Alaska","Wrangell City and Borough",5,49,17,10,7
050,02,275,"Alaska","Wrangell City and Borough",5,50,24,13,11
050,02,275,"Alaska","Wrangell City and Borough",5,51,26,14,12
050,02,275,"Alaska","Wrangell City and Borough",5,52,24,15,9
050,02,275,"Alaska","Wrangell City and Borough",5,53,26,11,15
050,02,275,"Alaska","Wrangell City and Borough",5,54,24,10,14
050,02,275,"Alaska","Wrangell City and Borough",5,55,27,12,15
050,02,275,"Alaska","Wrangell City and Borough",5,56,25,12,13
050,02,275,"Alaska","Wrangell City and Borough",5,57,19,7,12
050,02,275,"Alaska","Wrangell City and Borough",5,58,29,16,13
050,02,275,"Alaska","Wrangell City and Borough",5,59,30,19,11
050,02,275,"Alaska","Wrangell City and Borough",5,60,34,19,15
050,02,275,"Alaska","Wrangell City and Borough",5,61,28,14,14
050,02,275,"Alaska","Wrangell City and Borough",5,62,28,15,13
050,02,275,"Alaska","Wrangell City and Borough",5,63,40,23,17
050,02,275,"Alaska","Wrangell City and Borough",5,64,44,22,22
050,02,275,"Alaska","Wrangell City and Borough",5,65,45,22,23
050,02,275,"Alaska","Wrangell City and Borough",5,66,42,22,20
050,02,275,"Alaska","Wrangell City and Borough",5,67,38,20,18
050,02,275,"Alaska","Wrangell City and Borough",5,68,43,20,23
050,02,275,"Alaska","Wrangell City and Borough",5,69,46,25,21
050,02,275,"Alaska","Wrangell City and Borough",5,70,37,21,16
050,02,275,"Alaska","Wrangell City and Borough",5,71,35,19,16
050,02,275,"Alaska","Wrangell City and Borough",5,72,30,20,10
050,02,275,"Alaska","Wrangell City and Borough",5,73,30,19,11
050,02,275,"Alaska","Wrangell City and Borough",5,74,34,22,12
050,02,275,"Alaska","Wrangell City and Borough",5,75,29,17,12
050,02,275,"Alaska","Wrangell City and Borough",5,76,31,18,13
050,02,275,"Alaska","Wrangell City and Borough",5,77,20,11,9
050,02,275,"Alaska","Wrangell City and Borough",5,78,17,9,8
050,02,275,"Alaska","Wrangell City and Borough",5,79,14,5,9
050,02,275,"Alaska","Wrangell City and Borough",5,80,14,5,9
050,02,275,"Alaska","Wrangell City and Borough",5,81,17,7,10
050,02,275,"Alaska","Wrangell City and Borough",5,82,9,4,5
050,02,275,"Alaska","Wrangell City and Borough",5,83,7,3,4
050,02,275,"Alaska","Wrangell City and Borough",5,84,4,2,2
050,02,275,"Alaska","Wrangell City and Borough",5,85,69,33,36
050,02,282,"Alaska","Yakutat City and Borough",1,0,6,3,3
050,02,282,"Alaska","Yakutat City and Borough",1,1,7,5,2
050,02,282,"Alaska","Yakutat City and Borough",1,2,2,1,1
050,02,282,"Alaska","Yakutat City and Borough",1,3,9,6,3
050,02,282,"Alaska","Yakutat City and Borough",1,4,8,4,4
050,02,282,"Alaska","Yakutat City and Borough",1,5,8,3,5
050,02,282,"Alaska","Yakutat City and Borough",1,6,6,3,3
050,02,282,"Alaska","Yakutat City and Borough",1,7,8,3,5
050,02,282,"Alaska","Yakutat City and Borough",1,8,15,6,9
050,02,282,"Alaska","Yakutat City and Borough",1,9,11,2,9
050,02,282,"Alaska","Yakutat City and Borough",1,10,5,1,4
050,02,282,"Alaska","Yakutat City and Borough",1,11,4,2,2
050,02,282,"Alaska","Yakutat City and Borough",1,12,7,3,4
050,02,282,"Alaska","Yakutat City and Borough",1,13,6,2,4
050,02,282,"Alaska","Yakutat City and Borough",1,14,6,2,4
050,02,282,"Alaska","Yakutat City and Borough",1,15,9,4,5
050,02,282,"Alaska","Yakutat City and Borough",1,16,8,6,2
050,02,282,"Alaska","Yakutat City and Borough",1,17,5,2,3
050,02,282,"Alaska","Yakutat City and Borough",1,18,7,5,2
050,02,282,"Alaska","Yakutat City and Borough",1,19,8,4,4
050,02,282,"Alaska","Yakutat City and Borough",1,20,1,1,0
050,02,282,"Alaska","Yakutat City and Borough",1,21,4,1,3
050,02,282,"Alaska","Yakutat City and Borough",1,22,5,3,2
050,02,282,"Alaska","Yakutat City and Borough",1,23,7,3,4
050,02,282,"Alaska","Yakutat City and Borough",1,24,8,4,4
050,02,282,"Alaska","Yakutat City and Borough",1,25,8,5,3
050,02,282,"Alaska","Yakutat City and Borough",1,26,5,4,1
050,02,282,"Alaska","Yakutat City and Borough",1,27,14,9,5
050,02,282,"Alaska","Yakutat City and Borough",1,28,7,6,1
050,02,282,"Alaska","Yakutat City and Borough",1,29,8,4,4
050,02,282,"Alaska","Yakutat City and Borough",1,30,10,6,4
050,02,282,"Alaska","Yakutat City and Borough",1,31,11,5,6
050,02,282,"Alaska","Yakutat City and Borough",1,32,11,6,5
050,02,282,"Alaska","Yakutat City and Borough",1,33,10,5,5
050,02,282,"Alaska","Yakutat City and Borough",1,34,8,5,3
050,02,282,"Alaska","Yakutat City and Borough",1,35,7,4,3
050,02,282,"Alaska","Yakutat City and Borough",1,36,8,5,3
050,02,282,"Alaska","Yakutat City and Borough",1,37,9,6,3
050,02,282,"Alaska","Yakutat City and Borough",1,38,8,6,2
050,02,282,"Alaska","Yakutat City and Borough",1,39,9,7,2
050,02,282,"Alaska","Yakutat City and Borough",1,40,12,8,4
050,02,282,"Alaska","Yakutat City and Borough",1,41,6,3,3
050,02,282,"Alaska","Yakutat City and Borough",1,42,4,2,2
050,02,282,"Alaska","Yakutat City and Borough",1,43,8,2,6
050,02,282,"Alaska","Yakutat City and Borough",1,44,4,1,3
050,02,282,"Alaska","Yakutat City and Borough",1,45,8,7,1
050,02,282,"Alaska","Yakutat City and Borough",1,46,8,7,1
050,02,282,"Alaska","Yakutat City and Borough",1,47,8,6,2
050,02,282,"Alaska","Yakutat City and Borough",1,48,4,2,2
050,02,282,"Alaska","Yakutat City and Borough",1,49,8,5,3
050,02,282,"Alaska","Yakutat City and Borough",1,50,10,5,5
050,02,282,"Alaska","Yakutat City and Borough",1,51,10,7,3
050,02,282,"Alaska","Yakutat City and Borough",1,52,13,9,4
050,02,282,"Alaska","Yakutat City and Borough",1,53,12,7,5
050,02,282,"Alaska","Yakutat City and Borough",1,54,9,7,2
050,02,282,"Alaska","Yakutat City and Borough",1,55,15,11,4
050,02,282,"Alaska","Yakutat City and Borough",1,56,14,6,8
050,02,282,"Alaska","Yakutat City and Borough",1,57,7,6,1
050,02,282,"Alaska","Yakutat City and Borough",1,58,12,7,5
050,02,282,"Alaska","Yakutat City and Borough",1,59,7,3,4
050,02,282,"Alaska","Yakutat City and Borough",1,60,12,5,7
050,02,282,"Alaska","Yakutat City and Borough",1,61,11,9,2
050,02,282,"Alaska","Yakutat City and Borough",1,62,12,8,4
050,02,282,"Alaska","Yakutat City and Borough",1,63,7,4,3
050,02,282,"Alaska","Yakutat City and Borough",1,64,12,7,5
050,02,282,"Alaska","Yakutat City and Borough",1,65,13,8,5
050,02,282,"Alaska","Yakutat City and Borough",1,66,8,6,2
050,02,282,"Alaska","Yakutat City and Borough",1,67,7,6,1
050,02,282,"Alaska","Yakutat City and Borough",1,68,8,6,2
050,02,282,"Alaska","Yakutat City and Borough",1,69,9,8,1
050,02,282,"Alaska","Yakutat City and Borough",1,70,6,4,2
050,02,282,"Alaska","Yakutat City and Borough",1,71,9,4,5
050,02,282,"Alaska","Yakutat City and Borough",1,72,8,3,5
050,02,282,"Alaska","Yakutat City and Borough",1,73,8,5,3
050,02,282,"Alaska","Yakutat City and Borough",1,74,5,4,1
050,02,282,"Alaska","Yakutat City and Borough",1,75,4,2,2
050,02,282,"Alaska","Yakutat City and Borough",1,76,5,4,1
050,02,282,"Alaska","Yakutat City and Borough",1,77,3,3,0
050,02,282,"Alaska","Yakutat City and Borough",1,78,2,1,1
050,02,282,"Alaska","Yakutat City and Borough",1,79,3,3,0
050,02,282,"Alaska","Yakutat City and Borough",1,80,4,3,1
050,02,282,"Alaska","Yakutat City and Borough",1,81,3,1,2
050,02,282,"Alaska","Yakutat City and Borough",1,82,4,3,1
050,02,282,"Alaska","Yakutat City and Borough",1,83,4,3,1
050,02,282,"Alaska","Yakutat City and Borough",1,84,2,1,1
050,02,282,"Alaska","Yakutat City and Borough",1,85,12,4,8
050,02,282,"Alaska","Yakutat City and Borough",2,0,7,3,4
050,02,282,"Alaska","Yakutat City and Borough",2,1,7,5,2
050,02,282,"Alaska","Yakutat City and Borough",2,2,2,1,1
050,02,282,"Alaska","Yakutat City and Borough",2,3,8,5,3
050,02,282,"Alaska","Yakutat City and Borough",2,4,8,4,4
050,02,282,"Alaska","Yakutat City and Borough",2,5,8,3,5
050,02,282,"Alaska","Yakutat City and Borough",2,6,6,3,3
050,02,282,"Alaska","Yakutat City and Borough",2,7,9,3,6
050,02,282,"Alaska","Yakutat City and Borough",2,8,15,6,9
050,02,282,"Alaska","Yakutat City and Borough",2,9,13,3,10
050,02,282,"Alaska","Yakutat City and Borough",2,10,6,1,5
050,02,282,"Alaska","Yakutat City and Borough",2,11,4,2,2
050,02,282,"Alaska","Yakutat City and Borough",2,12,7,3,4
050,02,282,"Alaska","Yakutat City and Borough",2,13,7,2,5
050,02,282,"Alaska","Yakutat City and Borough",2,14,6,2,4
050,02,282,"Alaska","Yakutat City and Borough",2,15,9,4,5
050,02,282,"Alaska","Yakutat City and Borough",2,16,8,5,3
050,02,282,"Alaska","Yakutat City and Borough",2,17,6,3,3
050,02,282,"Alaska","Yakutat City and Borough",2,18,6,4,2
050,02,282,"Alaska","Yakutat City and Borough",2,19,8,4,4
050,02,282,"Alaska","Yakutat City and Borough",2,20,2,1,1
050,02,282,"Alaska","Yakutat City and Borough",2,21,4,1,3
050,02,282,"Alaska","Yakutat City and Borough",2,22,5,3,2
050,02,282,"Alaska","Yakutat City and Borough",2,23,7,3,4
050,02,282,"Alaska","Yakutat City and Borough",2,24,8,4,4
050,02,282,"Alaska","Yakutat City and Borough",2,25,8,5,3
050,02,282,"Alaska","Yakutat City and Borough",2,26,5,4,1
050,02,282,"Alaska","Yakutat City and Borough",2,27,13,8,5
050,02,282,"Alaska","Yakutat City and Borough",2,28,9,8,1
050,02,282,"Alaska","Yakutat City and Borough",2,29,8,4,4
050,02,282,"Alaska","Yakutat City and Borough",2,30,9,5,4
050,02,282,"Alaska","Yakutat City and Borough",2,31,11,5,6
050,02,282,"Alaska","Yakutat City and Borough",2,32,11,6,5
050,02,282,"Alaska","Yakutat City and Borough",2,33,10,5,5
050,02,282,"Alaska","Yakutat City and Borough",2,34,9,5,4
050,02,282,"Alaska","Yakutat City and Borough",2,35,7,4,3
050,02,282,"Alaska","Yakutat City and Borough",2,36,8,5,3
050,02,282,"Alaska","Yakutat City and Borough",2,37,8,5,3
050,02,282,"Alaska","Yakutat City and Borough",2,38,9,7,2
050,02,282,"Alaska","Yakutat City and Borough",2,39,9,7,2
050,02,282,"Alaska","Yakutat City and Borough",2,40,13,9,4
050,02,282,"Alaska","Yakutat City and Borough",2,41,8,5,3
050,02,282,"Alaska","Yakutat City and Borough",2,42,4,2,2
050,02,282,"Alaska","Yakutat City and Borough",2,43,8,2,6
050,02,282,"Alaska","Yakutat City and Borough",2,44,5,2,3
050,02,282,"Alaska","Yakutat City and Borough",2,45,9,7,2
050,02,282,"Alaska","Yakutat City and Borough",2,46,8,7,1
050,02,282,"Alaska","Yakutat City and Borough",2,47,8,6,2
050,02,282,"Alaska","Yakutat City and Borough",2,48,4,2,2
050,02,282,"Alaska","Yakutat City and Borough",2,49,8,5,3
050,02,282,"Alaska","Yakutat City and Borough",2,50,10,5,5
050,02,282,"Alaska","Yakutat City and Borough",2,51,10,7,3
050,02,282,"Alaska","Yakutat City and Borough",2,52,13,9,4
050,02,282,"Alaska","Yakutat City and Borough",2,53,13,8,5
050,02,282,"Alaska","Yakutat City and Borough",2,54,10,7,3
050,02,282,"Alaska","Yakutat City and Borough",2,55,15,11,4
050,02,282,"Alaska","Yakutat City and Borough",2,56,15,7,8
050,02,282,"Alaska","Yakutat City and Borough",2,57,8,6,2
050,02,282,"Alaska","Yakutat City and Borough",2,58,12,7,5
050,02,282,"Alaska","Yakutat City and Borough",2,59,9,4,5
050,02,282,"Alaska","Yakutat City and Borough",2,60,11,5,6
050,02,282,"Alaska","Yakutat City and Borough",2,61,9,7,2
050,02,282,"Alaska","Yakutat City and Borough",2,62,12,8,4
050,02,282,"Alaska","Yakutat City and Borough",2,63,9,6,3
050,02,282,"Alaska","Yakutat City and Borough",2,64,11,6,5
050,02,282,"Alaska","Yakutat City and Borough",2,65,13,8,5
050,02,282,"Alaska","Yakutat City and Borough",2,66,9,6,3
050,02,282,"Alaska","Yakutat City and Borough",2,67,7,6,1
050,02,282,"Alaska","Yakutat City and Borough",2,68,8,6,2
050,02,282,"Alaska","Yakutat City and Borough",2,69,9,8,1
050,02,282,"Alaska","Yakutat City and Borough",2,70,7,5,2
050,02,282,"Alaska","Yakutat City and Borough",2,71,9,4,5
050,02,282,"Alaska","Yakutat City and Borough",2,72,8,3,5
050,02,282,"Alaska","Yakutat City and Borough",2,73,9,5,4
050,02,282,"Alaska","Yakutat City and Borough",2,74,5,4,1
050,02,282,"Alaska","Yakutat City and Borough",2,75,5,3,2
050,02,282,"Alaska","Yakutat City and Borough",2,76,5,4,1
050,02,282,"Alaska","Yakutat City and Borough",2,77,3,3,0
050,02,282,"Alaska","Yakutat City and Borough",2,78,2,1,1
050,02,282,"Alaska","Yakutat City and Borough",2,79,2,2,0
050,02,282,"Alaska","Yakutat City and Borough",2,80,4,3,1
050,02,282,"Alaska","Yakutat City and Borough",2,81,3,1,2
050,02,282,"Alaska","Yakutat City and Borough",2,82,4,3,1
050,02,282,"Alaska","Yakutat City and Borough",2,83,4,3,1
050,02,282,"Alaska","Yakutat City and Borough",2,84,2,1,1
050,02,282,"Alaska","Yakutat City and Borough",2,85,12,4,8
050,02,282,"Alaska","Yakutat City and Borough",3,0,10,4,6
050,02,282,"Alaska","Yakutat City and Borough",3,1,7,3,4
050,02,282,"Alaska","Yakutat City and Borough",3,2,8,6,2
050,02,282,"Alaska","Yakutat City and Borough",3,3,2,1,1
050,02,282,"Alaska","Yakutat City and Borough",3,4,10,7,3
050,02,282,"Alaska","Yakutat City and Borough",3,5,8,4,4
050,02,282,"Alaska","Yakutat City and Borough",3,6,8,3,5
050,02,282,"Alaska","Yakutat City and Borough",3,7,7,4,3
050,02,282,"Alaska","Yakutat City and Borough",3,8,9,3,6
050,02,282,"Alaska","Yakutat City and Borough",3,9,17,8,9
050,02,282,"Alaska","Yakutat City and Borough",3,10,12,3,9
050,02,282,"Alaska","Yakutat City and Borough",3,11,6,1,5
050,02,282,"Alaska","Yakutat City and Borough",3,12,4,2,2
050,02,282,"Alaska","Yakutat City and Borough",3,13,9,3,6
050,02,282,"Alaska","Yakutat City and Borough",3,14,7,2,5
050,02,282,"Alaska","Yakutat City and Borough",3,15,7,2,5
050,02,282,"Alaska","Yakutat City and Borough",3,16,7,4,3
050,02,282,"Alaska","Yakutat City and Borough",3,17,6,3,3
050,02,282,"Alaska","Yakutat City and Borough",3,18,7,3,4
050,02,282,"Alaska","Yakutat City and Borough",3,19,5,4,1
050,02,282,"Alaska","Yakutat City and Borough",3,20,7,4,3
050,02,282,"Alaska","Yakutat City and Borough",3,21,2,1,1
050,02,282,"Alaska","Yakutat City and Borough",3,22,4,1,3
050,02,282,"Alaska","Yakutat City and Borough",3,23,4,2,2
050,02,282,"Alaska","Yakutat City and Borough",3,24,8,4,4
050,02,282,"Alaska","Yakutat City and Borough",3,25,11,4,7
050,02,282,"Alaska","Yakutat City and Borough",3,26,7,4,3
050,02,282,"Alaska","Yakutat City and Borough",3,27,7,5,2
050,02,282,"Alaska","Yakutat City and Borough",3,28,17,11,6
050,02,282,"Alaska","Yakutat City and Borough",3,29,11,9,2
050,02,282,"Alaska","Yakutat City and Borough",3,30,7,4,3
050,02,282,"Alaska","Yakutat City and Borough",3,31,7,3,4
050,02,282,"Alaska","Yakutat City and Borough",3,32,15,8,7
050,02,282,"Alaska","Yakutat City and Borough",3,33,12,7,5
050,02,282,"Alaska","Yakutat City and Borough",3,34,10,5,5
050,02,282,"Alaska","Yakutat City and Borough",3,35,8,4,4
050,02,282,"Alaska","Yakutat City and Borough",3,36,8,5,3
050,02,282,"Alaska","Yakutat City and Borough",3,37,7,4,3
050,02,282,"Alaska","Yakutat City and Borough",3,38,10,6,4
050,02,282,"Alaska","Yakutat City and Borough",3,39,9,7,2
050,02,282,"Alaska","Yakutat City and Borough",3,40,9,7,2
050,02,282,"Alaska","Yakutat City and Borough",3,41,11,7,4
050,02,282,"Alaska","Yakutat City and Borough",3,42,7,4,3
050,02,282,"Alaska","Yakutat City and Borough",3,43,6,4,2
050,02,282,"Alaska","Yakutat City and Borough",3,44,8,2,6
050,02,282,"Alaska","Yakutat City and Borough",3,45,5,3,2
050,02,282,"Alaska","Yakutat City and Borough",3,46,8,6,2
050,02,282,"Alaska","Yakutat City and Borough",3,47,8,7,1
050,02,282,"Alaska","Yakutat City and Borough",3,48,9,7,2
050,02,282,"Alaska","Yakutat City and Borough",3,49,5,2,3
050,02,282,"Alaska","Yakutat City and Borough",3,50,8,5,3
050,02,282,"Alaska","Yakutat City and Borough",3,51,10,5,5
050,02,282,"Alaska","Yakutat City and Borough",3,52,10,7,3
050,02,282,"Alaska","Yakutat City and Borough",3,53,12,8,4
050,02,282,"Alaska","Yakutat City and Borough",3,54,14,9,5
050,02,282,"Alaska","Yakutat City and Borough",3,55,12,9,3
050,02,282,"Alaska","Yakutat City and Borough",3,56,15,11,4
050,02,282,"Alaska","Yakutat City and Borough",3,57,15,7,8
050,02,282,"Alaska","Yakutat City and Borough",3,58,13,8,5
050,02,282,"Alaska","Yakutat City and Borough",3,59,12,7,5
050,02,282,"Alaska","Yakutat City and Borough",3,60,9,4,5
050,02,282,"Alaska","Yakutat City and Borough",3,61,9,4,5
050,02,282,"Alaska","Yakutat City and Borough",3,62,9,7,2
050,02,282,"Alaska","Yakutat City and Borough",3,63,12,8,4
050,02,282,"Alaska","Yakutat City and Borough",3,64,9,6,3
050,02,282,"Alaska","Yakutat City and Borough",3,65,10,5,5
050,02,282,"Alaska","Yakutat City and Borough",3,66,13,8,5
050,02,282,"Alaska","Yakutat City and Borough",3,67,9,6,3
050,02,282,"Alaska","Yakutat City and Borough",3,68,7,6,1
050,02,282,"Alaska","Yakutat City and Borough",3,69,8,6,2
050,02,282,"Alaska","Yakutat City and Borough",3,70,9,8,1
050,02,282,"Alaska","Yakutat City and Borough",3,71,7,5,2
050,02,282,"Alaska","Yakutat City and Borough",3,72,10,5,5
050,02,282,"Alaska","Yakutat City and Borough",3,73,7,3,4
050,02,282,"Alaska","Yakutat City and Borough",3,74,9,5,4
050,02,282,"Alaska","Yakutat City and Borough",3,75,5,4,1
050,02,282,"Alaska","Yakutat City and Borough",3,76,5,3,2
050,02,282,"Alaska","Yakutat City and Borough",3,77,5,4,1
050,02,282,"Alaska","Yakutat City and Borough",3,78,3,3,0
050,02,282,"Alaska","Yakutat City and Borough",3,79,2,1,1
050,02,282,"Alaska","Yakutat City and Borough",3,80,2,2,0
050,02,282,"Alaska","Yakutat City and Borough",3,81,4,3,1
050,02,282,"Alaska","Yakutat City and Borough",3,82,3,1,2
050,02,282,"Alaska","Yakutat City and Borough",3,83,4,3,1
050,02,282,"Alaska","Yakutat City and Borough",3,84,4,3,1
050,02,282,"Alaska","Yakutat City and Borough",3,85,12,3,9
050,02,282,"Alaska","Yakutat City and Borough",4,0,2,0,2
050,02,282,"Alaska","Yakutat City and Borough",4,1,8,2,6
050,02,282,"Alaska","Yakutat City and Borough",4,2,7,3,4
050,02,282,"Alaska","Yakutat City and Borough",4,3,5,3,2
050,02,282,"Alaska","Yakutat City and Borough",4,4,2,1,1
050,02,282,"Alaska","Yakutat City and Borough",4,5,10,7,3
050,02,282,"Alaska","Yakutat City and Borough",4,6,8,4,4
050,02,282,"Alaska","Yakutat City and Borough",4,7,9,4,5
050,02,282,"Alaska","Yakutat City and Borough",4,8,7,4,3
050,02,282,"Alaska","Yakutat City and Borough",4,9,10,5,5
050,02,282,"Alaska","Yakutat City and Borough",4,10,17,8,9
050,02,282,"Alaska","Yakutat City and Borough",4,11,12,3,9
050,02,282,"Alaska","Yakutat City and Borough",4,12,6,2,4
050,02,282,"Alaska","Yakutat City and Borough",4,13,5,2,3
050,02,282,"Alaska","Yakutat City and Borough",4,14,7,3,4
050,02,282,"Alaska","Yakutat City and Borough",4,15,7,2,5
050,02,282,"Alaska","Yakutat City and Borough",4,16,6,2,4
050,02,282,"Alaska","Yakutat City and Borough",4,17,7,4,3
050,02,282,"Alaska","Yakutat City and Borough",4,18,6,4,2
050,02,282,"Alaska","Yakutat City and Borough",4,19,5,2,3
050,02,282,"Alaska","Yakutat City and Borough",4,20,5,4,1
050,02,282,"Alaska","Yakutat City and Borough",4,21,8,5,3
050,02,282,"Alaska","Yakutat City and Borough",4,22,2,1,1
050,02,282,"Alaska","Yakutat City and Borough",4,23,4,1,3
050,02,282,"Alaska","Yakutat City and Borough",4,24,5,3,2
050,02,282,"Alaska","Yakutat City and Borough",4,25,9,4,5
050,02,282,"Alaska","Yakutat City and Borough",4,26,9,4,5
050,02,282,"Alaska","Yakutat City and Borough",4,27,6,4,2
050,02,282,"Alaska","Yakutat City and Borough",4,28,6,6,0
050,02,282,"Alaska","Yakutat City and Borough",4,29,12,10,2
050,02,282,"Alaska","Yakutat City and Borough",4,30,8,6,2
050,02,282,"Alaska","Yakutat City and Borough",4,31,6,4,2
050,02,282,"Alaska","Yakutat City and Borough",4,32,7,4,3
050,02,282,"Alaska","Yakutat City and Borough",4,33,15,8,7
050,02,282,"Alaska","Yakutat City and Borough",4,34,13,6,7
050,02,282,"Alaska","Yakutat City and Borough",4,35,12,7,5
050,02,282,"Alaska","Yakutat City and Borough",4,36,7,4,3
050,02,282,"Alaska","Yakutat City and Borough",4,37,7,4,3
050,02,282,"Alaska","Yakutat City and Borough",4,38,8,5,3
050,02,282,"Alaska","Yakutat City and Borough",4,39,9,4,5
050,02,282,"Alaska","Yakutat City and Borough",4,40,9,7,2
050,02,282,"Alaska","Yakutat City and Borough",4,41,9,7,2
050,02,282,"Alaska","Yakutat City and Borough",4,42,10,6,4
050,02,282,"Alaska","Yakutat City and Borough",4,43,9,5,4
050,02,282,"Alaska","Yakutat City and Borough",4,44,4,3,1
050,02,282,"Alaska","Yakutat City and Borough",4,45,8,2,6
050,02,282,"Alaska","Yakutat City and Borough",4,46,5,3,2
050,02,282,"Alaska","Yakutat City and Borough",4,47,7,5,2
050,02,282,"Alaska","Yakutat City and Borough",4,48,9,8,1
050,02,282,"Alaska","Yakutat City and Borough",4,49,9,7,2
050,02,282,"Alaska","Yakutat City and Borough",4,50,6,2,4
050,02,282,"Alaska","Yakutat City and Borough",4,51,9,6,3
050,02,282,"Alaska","Yakutat City and Borough",4,52,10,5,5
050,02,282,"Alaska","Yakutat City and Borough",4,53,10,7,3
050,02,282,"Alaska","Yakutat City and Borough",4,54,13,9,4
050,02,282,"Alaska","Yakutat City and Borough",4,55,13,9,4
050,02,282,"Alaska","Yakutat City and Borough",4,56,12,9,3
050,02,282,"Alaska","Yakutat City and Borough",4,57,16,12,4
050,02,282,"Alaska","Yakutat City and Borough",4,58,13,7,6
050,02,282,"Alaska","Yakutat City and Borough",4,59,11,8,3
050,02,282,"Alaska","Yakutat City and Borough",4,60,9,4,5
050,02,282,"Alaska","Yakutat City and Borough",4,61,8,3,5
050,02,282,"Alaska","Yakutat City and Borough",4,62,9,4,5
050,02,282,"Alaska","Yakutat City and Borough",4,63,8,6,2
050,02,282,"Alaska","Yakutat City and Borough",4,64,12,8,4
050,02,282,"Alaska","Yakutat City and Borough",4,65,9,6,3
050,02,282,"Alaska","Yakutat City and Borough",4,66,9,5,4
050,02,282,"Alaska","Yakutat City and Borough",4,67,14,9,5
050,02,282,"Alaska","Yakutat City and Borough",4,68,10,6,4
050,02,282,"Alaska","Yakutat City and Borough",4,69,7,6,1
050,02,282,"Alaska","Yakutat City and Borough",4,70,8,6,2
050,02,282,"Alaska","Yakutat City and Borough",4,71,7,6,1
050,02,282,"Alaska","Yakutat City and Borough",4,72,6,4,2
050,02,282,"Alaska","Yakutat City and Borough",4,73,10,5,5
050,02,282,"Alaska","Yakutat City and Borough",4,74,7,3,4
050,02,282,"Alaska","Yakutat City and Borough",4,75,9,5,4
050,02,282,"Alaska","Yakutat City and Borough",4,76,5,4,1
050,02,282,"Alaska","Yakutat City and Borough",4,77,5,3,2
050,02,282,"Alaska","Yakutat City and Borough",4,78,4,3,1
050,02,282,"Alaska","Yakutat City and Borough",4,79,3,3,0
050,02,282,"Alaska","Yakutat City and Borough",4,80,2,1,1
050,02,282,"Alaska","Yakutat City and Borough",4,81,2,2,0
050,02,282,"Alaska","Yakutat City and Borough",4,82,4,3,1
050,02,282,"Alaska","Yakutat City and Borough",4,83,3,1,2
050,02,282,"Alaska","Yakutat City and Borough",4,84,4,3,1
050,02,282,"Alaska","Yakutat City and Borough",4,85,15,5,10
050,02,282,"Alaska","Yakutat City and Borough",5,0,3,0,3
050,02,282,"Alaska","Yakutat City and Borough",5,1,2,0,2
050,02,282,"Alaska","Yakutat City and Borough",5,2,8,2,6
050,02,282,"Alaska","Yakutat City and Borough",5,3,7,3,4
050,02,282,"Alaska","Yakutat City and Borough",5,4,6,3,3
050,02,282,"Alaska","Yakutat City and Borough",5,5,2,1,1
050,02,282,"Alaska","Yakutat City and Borough",5,6,10,7,3
050,02,282,"Alaska","Yakutat City and Borough",5,7,8,4,4
050,02,282,"Alaska","Yakutat City and Borough",5,8,10,5,5
050,02,282,"Alaska","Yakutat City and Borough",5,9,7,4,3
050,02,282,"Alaska","Yakutat City and Borough",5,10,10,5,5
050,02,282,"Alaska","Yakutat City and Borough",5,11,15,6,9
050,02,282,"Alaska","Yakutat City and Borough",5,12,14,4,10
050,02,282,"Alaska","Yakutat City and Borough",5,13,6,2,4
050,02,282,"Alaska","Yakutat City and Borough",5,14,5,3,2
050,02,282,"Alaska","Yakutat City and Borough",5,15,7,3,4
050,02,282,"Alaska","Yakutat City and Borough",5,16,7,2,5
050,02,282,"Alaska","Yakutat City and Borough",5,17,5,2,3
050,02,282,"Alaska","Yakutat City and Borough",5,18,7,4,3
050,02,282,"Alaska","Yakutat City and Borough",5,19,5,3,2
050,02,282,"Alaska","Yakutat City and Borough",5,20,6,2,4
050,02,282,"Alaska","Yakutat City and Borough",5,21,5,4,1
050,02,282,"Alaska","Yakutat City and Borough",5,22,7,4,3
050,02,282,"Alaska","Yakutat City and Borough",5,23,2,1,1
050,02,282,"Alaska","Yakutat City and Borough",5,24,4,2,2
050,02,282,"Alaska","Yakutat City and Borough",5,25,5,3,2
050,02,282,"Alaska","Yakutat City and Borough",5,26,11,4,7
050,02,282,"Alaska","Yakutat City and Borough",5,27,10,5,5
050,02,282,"Alaska","Yakutat City and Borough",5,28,6,4,2
050,02,282,"Alaska","Yakutat City and Borough",5,29,6,6,0
050,02,282,"Alaska","Yakutat City and Borough",5,30,13,9,4
050,02,282,"Alaska","Yakutat City and Borough",5,31,9,7,2
050,02,282,"Alaska","Yakutat City and Borough",5,32,6,4,2
050,02,282,"Alaska","Yakutat City and Borough",5,33,7,4,3
050,02,282,"Alaska","Yakutat City and Borough",5,34,17,8,9
050,02,282,"Alaska","Yakutat City and Borough",5,35,13,6,7
050,02,282,"Alaska","Yakutat City and Borough",5,36,12,7,5
050,02,282,"Alaska","Yakutat City and Borough",5,37,5,2,3
050,02,282,"Alaska","Yakutat City and Borough",5,38,8,5,3
050,02,282,"Alaska","Yakutat City and Borough",5,39,8,5,3
050,02,282,"Alaska","Yakutat City and Borough",5,40,6,4,2
050,02,282,"Alaska","Yakutat City and Borough",5,41,9,7,2
050,02,282,"Alaska","Yakutat City and Borough",5,42,10,7,3
050,02,282,"Alaska","Yakutat City and Borough",5,43,10,6,4
050,02,282,"Alaska","Yakutat City and Borough",5,44,10,6,4
050,02,282,"Alaska","Yakutat City and Borough",5,45,4,2,2
050,02,282,"Alaska","Yakutat City and Borough",5,46,8,2,6
050,02,282,"Alaska","Yakutat City and Borough",5,47,5,3,2
050,02,282,"Alaska","Yakutat City and Borough",5,48,8,6,2
050,02,282,"Alaska","Yakutat City and Borough",5,49,8,7,1
050,02,282,"Alaska","Yakutat City and Borough",5,50,6,4,2
050,02,282,"Alaska","Yakutat City and Borough",5,51,6,2,4
050,02,282,"Alaska","Yakutat City and Borough",5,52,9,6,3
050,02,282,"Alaska","Yakutat City and Borough",5,53,10,5,5
050,02,282,"Alaska","Yakutat City and Borough",5,54,10,7,3
050,02,282,"Alaska","Yakutat City and Borough",5,55,13,9,4
050,02,282,"Alaska","Yakutat City and Borough",5,56,15,11,4
050,02,282,"Alaska","Yakutat City and Borough",5,57,11,8,3
050,02,282,"Alaska","Yakutat City and Borough",5,58,16,12,4
050,02,282,"Alaska","Yakutat City and Borough",5,59,13,7,6
050,02,282,"Alaska","Yakutat City and Borough",5,60,11,8,3
050,02,282,"Alaska","Yakutat City and Borough",5,61,9,4,5
050,02,282,"Alaska","Yakutat City and Borough",5,62,6,3,3
050,02,282,"Alaska","Yakutat City and Borough",5,63,9,4,5
050,02,282,"Alaska","Yakutat City and Borough",5,64,8,6,2
050,02,282,"Alaska","Yakutat City and Borough",5,65,12,8,4
050,02,282,"Alaska","Yakutat City and Borough",5,66,9,6,3
050,02,282,"Alaska","Yakutat City and Borough",5,67,9,5,4
050,02,282,"Alaska","Yakutat City and Borough",5,68,15,9,6
050,02,282,"Alaska","Yakutat City and Borough",5,69,10,6,4
050,02,282,"Alaska","Yakutat City and Borough",5,70,7,6,1
050,02,282,"Alaska","Yakutat City and Borough",5,71,9,6,3
050,02,282,"Alaska","Yakutat City and Borough",5,72,7,6,1
050,02,282,"Alaska","Yakutat City and Borough",5,73,7,5,2
050,02,282,"Alaska","Yakutat City and Borough",5,74,10,5,5
050,02,282,"Alaska","Yakutat City and Borough",5,75,7,3,4
050,02,282,"Alaska","Yakutat City and Borough",5,76,8,4,4
050,02,282,"Alaska","Yakutat City and Borough",5,77,5,4,1
050,02,282,"Alaska","Yakutat City and Borough",5,78,5,3,2
050,02,282,"Alaska","Yakutat City and Borough",5,79,4,3,1
050,02,282,"Alaska","Yakutat City and Borough",5,80,1,1,0
050,02,282,"Alaska","Yakutat City and Borough",5,81,2,1,1
050,02,282,"Alaska","Yakutat City and Borough",5,82,1,1,0
050,02,282,"Alaska","Yakutat City and Borough",5,83,4,3,1
050,02,282,"Alaska","Yakutat City and Borough",5,84,3,1,2
050,02,282,"Alaska","Yakutat City and Borough",5,85,18,7,11
050,02,290,"Alaska","Yukon-Koyukuk Census Area",1,0,80,43,37
050,02,290,"Alaska","Yukon-Koyukuk Census Area",1,1,75,39,36
050,02,290,"Alaska","Yukon-Koyukuk Census Area",1,2,78,39,39
050,02,290,"Alaska","Yukon-Koyukuk Census Area",1,3,78,34,44
050,02,290,"Alaska","Yukon-Koyukuk Census Area",1,4,80,36,44
050,02,290,"Alaska","Yukon-Koyukuk Census Area",1,5,89,39,50
050,02,290,"Alaska","Yukon-Koyukuk Census Area",1,6,83,45,38
050,02,290,"Alaska","Yukon-Koyukuk Census Area",1,7,90,40,50
050,02,290,"Alaska","Yukon-Koyukuk Census Area",1,8,82,37,45
050,02,290,"Alaska","Yukon-Koyukuk Census Area",1,9,83,42,41
050,02,290,"Alaska","Yukon-Koyukuk Census Area",1,10,94,48,46
050,02,290,"Alaska","Yukon-Koyukuk Census Area",1,11,103,56,47
050,02,290,"Alaska","Yukon-Koyukuk Census Area",1,12,91,47,44
050,02,290,"Alaska","Yukon-Koyukuk Census Area",1,13,85,49,36
050,02,290,"Alaska","Yukon-Koyukuk Census Area",1,14,74,40,34
050,02,290,"Alaska","Yukon-Koyukuk Census Area",1,15,61,36,25
050,02,290,"Alaska","Yukon-Koyukuk Census Area",1,16,72,39,33
050,02,290,"Alaska","Yukon-Koyukuk Census Area",1,17,70,37,33
050,02,290,"Alaska","Yukon-Koyukuk Census Area",1,18,66,33,33
050,02,290,"Alaska","Yukon-Koyukuk Census Area",1,19,62,28,34
050,02,290,"Alaska","Yukon-Koyukuk Census Area",1,20,62,29,33
050,02,290,"Alaska","Yukon-Koyukuk Census Area",1,21,59,31,28
050,02,290,"Alaska","Yukon-Koyukuk Census Area",1,22,60,28,32
050,02,290,"Alaska","Yukon-Koyukuk Census Area",1,23,56,29,27
050,02,290,"Alaska","Yukon-Koyukuk Census Area",1,24,56,31,25
050,02,290,"Alaska","Yukon-Koyukuk Census Area",1,25,51,23,28
050,02,290,"Alaska","Yukon-Koyukuk Census Area",1,26,59,29,30
050,02,290,"Alaska","Yukon-Koyukuk Census Area",1,27,64,33,31
050,02,290,"Alaska","Yukon-Koyukuk Census Area",1,28,78,50,28
050,02,290,"Alaska","Yukon-Koyukuk Census Area",1,29,68,38,30
050,02,290,"Alaska","Yukon-Koyukuk Census Area",1,30,70,38,32
050,02,290,"Alaska","Yukon-Koyukuk Census Area",1,31,66,32,34
050,02,290,"Alaska","Yukon-Koyukuk Census Area",1,32,69,35,34
050,02,290,"Alaska","Yukon-Koyukuk Census Area",1,33,65,36,29
050,02,290,"Alaska","Yukon-Koyukuk Census Area",1,34,66,35,31
050,02,290,"Alaska","Yukon-Koyukuk Census Area",1,35,78,45,33
050,02,290,"Alaska","Yukon-Koyukuk Census Area",1,36,66,39,27
050,02,290,"Alaska","Yukon-Koyukuk Census Area",1,37,63,37,26
050,02,290,"Alaska","Yukon-Koyukuk Census Area",1,38,58,32,26
050,02,290,"Alaska","Yukon-Koyukuk Census Area",1,39,70,39,31
050,02,290,"Alaska","Yukon-Koyukuk Census Area",1,40,71,44,27
050,02,290,"Alaska","Yukon-Koyukuk Census Area",1,41,60,40,20
050,02,290,"Alaska","Yukon-Koyukuk Census Area",1,42,48,26,22
050,02,290,"Alaska","Yukon-Koyukuk Census Area",1,43,62,33,29
050,02,290,"Alaska","Yukon-Koyukuk Census Area",1,44,68,40,28
050,02,290,"Alaska","Yukon-Koyukuk Census Area",1,45,61,33,28
050,02,290,"Alaska","Yukon-Koyukuk Census Area",1,46,54,31,23
050,02,290,"Alaska","Yukon-Koyukuk Census Area",1,47,45,24,21
050,02,290,"Alaska","Yukon-Koyukuk Census Area",1,48,49,28,21
050,02,290,"Alaska","Yukon-Koyukuk Census Area",1,49,57,33,24
050,02,290,"Alaska","Yukon-Koyukuk Census Area",1,50,50,24,26
050,02,290,"Alaska","Yukon-Koyukuk Census Area",1,51,44,24,20
050,02,290,"Alaska","Yukon-Koyukuk Census Area",1,52,51,30,21
050,02,290,"Alaska","Yukon-Koyukuk Census Area",1,53,65,36,29
050,02,290,"Alaska","Yukon-Koyukuk Census Area",1,54,79,41,38
050,02,290,"Alaska","Yukon-Koyukuk Census Area",1,55,66,35,31
050,02,290,"Alaska","Yukon-Koyukuk Census Area",1,56,72,39,33
050,02,290,"Alaska","Yukon-Koyukuk Census Area",1,57,82,42,40
050,02,290,"Alaska","Yukon-Koyukuk Census Area",1,58,67,39,28
050,02,290,"Alaska","Yukon-Koyukuk Census Area",1,59,62,36,26
050,02,290,"Alaska","Yukon-Koyukuk Census Area",1,60,67,36,31
050,02,290,"Alaska","Yukon-Koyukuk Census Area",1,61,80,43,37
050,02,290,"Alaska","Yukon-Koyukuk Census Area",1,62,90,46,44
050,02,290,"Alaska","Yukon-Koyukuk Census Area",1,63,86,45,41
050,02,290,"Alaska","Yukon-Koyukuk Census Area",1,64,73,40,33
050,02,290,"Alaska","Yukon-Koyukuk Census Area",1,65,69,40,29
050,02,290,"Alaska","Yukon-Koyukuk Census Area",1,66,67,45,22
050,02,290,"Alaska","Yukon-Koyukuk Census Area",1,67,74,45,29
050,02,290,"Alaska","Yukon-Koyukuk Census Area",1,68,72,35,37
050,02,290,"Alaska","Yukon-Koyukuk Census Area",1,69,68,44,24
050,02,290,"Alaska","Yukon-Koyukuk Census Area",1,70,65,37,28
050,02,290,"Alaska","Yukon-Koyukuk Census Area",1,71,55,27,28
050,02,290,"Alaska","Yukon-Koyukuk Census Area",1,72,44,27,17
050,02,290,"Alaska","Yukon-Koyukuk Census Area",1,73,38,21,17
050,02,290,"Alaska","Yukon-Koyukuk Census Area",1,74,37,20,17
050,02,290,"Alaska","Yukon-Koyukuk Census Area",1,75,37,22,15
050,02,290,"Alaska","Yukon-Koyukuk Census Area",1,76,28,17,11
050,02,290,"Alaska","Yukon-Koyukuk Census Area",1,77,30,20,10
050,02,290,"Alaska","Yukon-Koyukuk Census Area",1,78,21,11,10
050,02,290,"Alaska","Yukon-Koyukuk Census Area",1,79,24,12,12
050,02,290,"Alaska","Yukon-Koyukuk Census Area",1,80,21,13,8
050,02,290,"Alaska","Yukon-Koyukuk Census Area",1,81,19,8,11
050,02,290,"Alaska","Yukon-Koyukuk Census Area",1,82,11,3,8
050,02,290,"Alaska","Yukon-Koyukuk Census Area",1,83,12,5,7
050,02,290,"Alaska","Yukon-Koyukuk Census Area",1,84,12,6,6
050,02,290,"Alaska","Yukon-Koyukuk Census Area",1,85,58,28,30
050,02,290,"Alaska","Yukon-Koyukuk Census Area",2,0,78,46,32
050,02,290,"Alaska","Yukon-Koyukuk Census Area",2,1,74,39,35
050,02,290,"Alaska","Yukon-Koyukuk Census Area",2,2,76,38,38
050,02,290,"Alaska","Yukon-Koyukuk Census Area",2,3,78,36,42
050,02,290,"Alaska","Yukon-Koyukuk Census Area",2,4,81,36,45
050,02,290,"Alaska","Yukon-Koyukuk Census Area",2,5,86,39,47
050,02,290,"Alaska","Yukon-Koyukuk Census Area",2,6,85,45,40
050,02,290,"Alaska","Yukon-Koyukuk Census Area",2,7,88,40,48
050,02,290,"Alaska","Yukon-Koyukuk Census Area",2,8,82,37,45
050,02,290,"Alaska","Yukon-Koyukuk Census Area",2,9,80,40,40
050,02,290,"Alaska","Yukon-Koyukuk Census Area",2,10,88,45,43
050,02,290,"Alaska","Yukon-Koyukuk Census Area",2,11,100,54,46
050,02,290,"Alaska","Yukon-Koyukuk Census Area",2,12,93,49,44
050,02,290,"Alaska","Yukon-Koyukuk Census Area",2,13,84,48,36
050,02,290,"Alaska","Yukon-Koyukuk Census Area",2,14,76,42,34
050,02,290,"Alaska","Yukon-Koyukuk Census Area",2,15,65,38,27
050,02,290,"Alaska","Yukon-Koyukuk Census Area",2,16,70,39,31
050,02,290,"Alaska","Yukon-Koyukuk Census Area",2,17,71,38,33
050,02,290,"Alaska","Yukon-Koyukuk Census Area",2,18,64,33,31
050,02,290,"Alaska","Yukon-Koyukuk Census Area",2,19,60,28,32
050,02,290,"Alaska","Yukon-Koyukuk Census Area",2,20,60,28,32
050,02,290,"Alaska","Yukon-Koyukuk Census Area",2,21,59,30,29
050,02,290,"Alaska","Yukon-Koyukuk Census Area",2,22,60,29,31
050,02,290,"Alaska","Yukon-Koyukuk Census Area",2,23,57,30,27
050,02,290,"Alaska","Yukon-Koyukuk Census Area",2,24,54,28,26
050,02,290,"Alaska","Yukon-Koyukuk Census Area",2,25,50,25,25
050,02,290,"Alaska","Yukon-Koyukuk Census Area",2,26,56,27,29
050,02,290,"Alaska","Yukon-Koyukuk Census Area",2,27,63,31,32
050,02,290,"Alaska","Yukon-Koyukuk Census Area",2,28,73,45,28
050,02,290,"Alaska","Yukon-Koyukuk Census Area",2,29,71,41,30
050,02,290,"Alaska","Yukon-Koyukuk Census Area",2,30,68,36,32
050,02,290,"Alaska","Yukon-Koyukuk Census Area",2,31,65,32,33
050,02,290,"Alaska","Yukon-Koyukuk Census Area",2,32,67,33,34
050,02,290,"Alaska","Yukon-Koyukuk Census Area",2,33,67,36,31
050,02,290,"Alaska","Yukon-Koyukuk Census Area",2,34,66,36,30
050,02,290,"Alaska","Yukon-Koyukuk Census Area",2,35,74,42,32
050,02,290,"Alaska","Yukon-Koyukuk Census Area",2,36,68,41,27
050,02,290,"Alaska","Yukon-Koyukuk Census Area",2,37,64,37,27
050,02,290,"Alaska","Yukon-Koyukuk Census Area",2,38,59,33,26
050,02,290,"Alaska","Yukon-Koyukuk Census Area",2,39,67,37,30
050,02,290,"Alaska","Yukon-Koyukuk Census Area",2,40,71,43,28
050,02,290,"Alaska","Yukon-Koyukuk Census Area",2,41,62,41,21
050,02,290,"Alaska","Yukon-Koyukuk Census Area",2,42,51,30,21
050,02,290,"Alaska","Yukon-Koyukuk Census Area",2,43,60,32,28
050,02,290,"Alaska","Yukon-Koyukuk Census Area",2,44,65,37,28
050,02,290,"Alaska","Yukon-Koyukuk Census Area",2,45,60,33,27
050,02,290,"Alaska","Yukon-Koyukuk Census Area",2,46,55,31,24
050,02,290,"Alaska","Yukon-Koyukuk Census Area",2,47,47,25,22
050,02,290,"Alaska","Yukon-Koyukuk Census Area",2,48,48,28,20
050,02,290,"Alaska","Yukon-Koyukuk Census Area",2,49,54,31,23
050,02,290,"Alaska","Yukon-Koyukuk Census Area",2,50,50,26,24
050,02,290,"Alaska","Yukon-Koyukuk Census Area",2,51,47,24,23
050,02,290,"Alaska","Yukon-Koyukuk Census Area",2,52,47,27,20
050,02,290,"Alaska","Yukon-Koyukuk Census Area",2,53,62,34,28
050,02,290,"Alaska","Yukon-Koyukuk Census Area",2,54,75,40,35
050,02,290,"Alaska","Yukon-Koyukuk Census Area",2,55,69,37,32
050,02,290,"Alaska","Yukon-Koyukuk Census Area",2,56,72,39,33
050,02,290,"Alaska","Yukon-Koyukuk Census Area",2,57,79,42,37
050,02,290,"Alaska","Yukon-Koyukuk Census Area",2,58,70,39,31
050,02,290,"Alaska","Yukon-Koyukuk Census Area",2,59,63,37,26
050,02,290,"Alaska","Yukon-Koyukuk Census Area",2,60,64,35,29
050,02,290,"Alaska","Yukon-Koyukuk Census Area",2,61,76,41,35
050,02,290,"Alaska","Yukon-Koyukuk Census Area",2,62,87,45,42
050,02,290,"Alaska","Yukon-Koyukuk Census Area",2,63,87,44,43
050,02,290,"Alaska","Yukon-Koyukuk Census Area",2,64,74,40,34
050,02,290,"Alaska","Yukon-Koyukuk Census Area",2,65,68,39,29
050,02,290,"Alaska","Yukon-Koyukuk Census Area",2,66,67,43,24
050,02,290,"Alaska","Yukon-Koyukuk Census Area",2,67,74,46,28
050,02,290,"Alaska","Yukon-Koyukuk Census Area",2,68,72,37,35
050,02,290,"Alaska","Yukon-Koyukuk Census Area",2,69,69,42,27
050,02,290,"Alaska","Yukon-Koyukuk Census Area",2,70,65,38,27
050,02,290,"Alaska","Yukon-Koyukuk Census Area",2,71,55,28,27
050,02,290,"Alaska","Yukon-Koyukuk Census Area",2,72,45,26,19
050,02,290,"Alaska","Yukon-Koyukuk Census Area",2,73,42,24,18
050,02,290,"Alaska","Yukon-Koyukuk Census Area",2,74,35,19,16
050,02,290,"Alaska","Yukon-Koyukuk Census Area",2,75,37,21,16
050,02,290,"Alaska","Yukon-Koyukuk Census Area",2,76,30,18,12
050,02,290,"Alaska","Yukon-Koyukuk Census Area",2,77,30,19,11
050,02,290,"Alaska","Yukon-Koyukuk Census Area",2,78,21,12,9
050,02,290,"Alaska","Yukon-Koyukuk Census Area",2,79,23,12,11
050,02,290,"Alaska","Yukon-Koyukuk Census Area",2,80,22,13,9
050,02,290,"Alaska","Yukon-Koyukuk Census Area",2,81,18,9,9
050,02,290,"Alaska","Yukon-Koyukuk Census Area",2,82,13,5,8
050,02,290,"Alaska","Yukon-Koyukuk Census Area",2,83,11,4,7
050,02,290,"Alaska","Yukon-Koyukuk Census Area",2,84,11,5,6
050,02,290,"Alaska","Yukon-Koyukuk Census Area",2,85,59,28,31
050,02,290,"Alaska","Yukon-Koyukuk Census Area",3,0,60,28,32
050,02,290,"Alaska","Yukon-Koyukuk Census Area",3,1,84,52,32
050,02,290,"Alaska","Yukon-Koyukuk Census Area",3,2,79,44,35
050,02,290,"Alaska","Yukon-Koyukuk Census Area",3,3,71,30,41
050,02,290,"Alaska","Yukon-Koyukuk Census Area",3,4,74,31,43
050,02,290,"Alaska","Yukon-Koyukuk Census Area",3,5,85,39,46
050,02,290,"Alaska","Yukon-Koyukuk Census Area",3,6,80,39,41
050,02,290,"Alaska","Yukon-Koyukuk Census Area",3,7,85,49,36
050,02,290,"Alaska","Yukon-Koyukuk Census Area",3,8,86,38,48
050,02,290,"Alaska","Yukon-Koyukuk Census Area",3,9,84,39,45
050,02,290,"Alaska","Yukon-Koyukuk Census Area",3,10,80,39,41
050,02,290,"Alaska","Yukon-Koyukuk Census Area",3,11,90,49,41
050,02,290,"Alaska","Yukon-Koyukuk Census Area",3,12,104,57,47
050,02,290,"Alaska","Yukon-Koyukuk Census Area",3,13,88,46,42
050,02,290,"Alaska","Yukon-Koyukuk Census Area",3,14,80,47,33
050,02,290,"Alaska","Yukon-Koyukuk Census Area",3,15,75,42,33
050,02,290,"Alaska","Yukon-Koyukuk Census Area",3,16,66,39,27
050,02,290,"Alaska","Yukon-Koyukuk Census Area",3,17,69,38,31
050,02,290,"Alaska","Yukon-Koyukuk Census Area",3,18,65,37,28
050,02,290,"Alaska","Yukon-Koyukuk Census Area",3,19,54,30,24
050,02,290,"Alaska","Yukon-Koyukuk Census Area",3,20,62,29,33
050,02,290,"Alaska","Yukon-Koyukuk Census Area",3,21,53,23,30
050,02,290,"Alaska","Yukon-Koyukuk Census Area",3,22,67,35,32
050,02,290,"Alaska","Yukon-Koyukuk Census Area",3,23,61,31,30
050,02,290,"Alaska","Yukon-Koyukuk Census Area",3,24,66,36,30
050,02,290,"Alaska","Yukon-Koyukuk Census Area",3,25,57,31,26
050,02,290,"Alaska","Yukon-Koyukuk Census Area",3,26,51,23,28
050,02,290,"Alaska","Yukon-Koyukuk Census Area",3,27,55,25,30
050,02,290,"Alaska","Yukon-Koyukuk Census Area",3,28,63,34,29
050,02,290,"Alaska","Yukon-Koyukuk Census Area",3,29,70,42,28
050,02,290,"Alaska","Yukon-Koyukuk Census Area",3,30,74,37,37
050,02,290,"Alaska","Yukon-Koyukuk Census Area",3,31,67,37,30
050,02,290,"Alaska","Yukon-Koyukuk Census Area",3,32,64,31,33
050,02,290,"Alaska","Yukon-Koyukuk Census Area",3,33,61,30,31
050,02,290,"Alaska","Yukon-Koyukuk Census Area",3,34,68,36,32
050,02,290,"Alaska","Yukon-Koyukuk Census Area",3,35,59,32,27
050,02,290,"Alaska","Yukon-Koyukuk Census Area",3,36,77,45,32
050,02,290,"Alaska","Yukon-Koyukuk Census Area",3,37,73,45,28
050,02,290,"Alaska","Yukon-Koyukuk Census Area",3,38,61,36,25
050,02,290,"Alaska","Yukon-Koyukuk Census Area",3,39,61,33,28
050,02,290,"Alaska","Yukon-Koyukuk Census Area",3,40,68,38,30
050,02,290,"Alaska","Yukon-Koyukuk Census Area",3,41,68,41,27
050,02,290,"Alaska","Yukon-Koyukuk Census Area",3,42,61,40,21
050,02,290,"Alaska","Yukon-Koyukuk Census Area",3,43,51,31,20
050,02,290,"Alaska","Yukon-Koyukuk Census Area",3,44,55,32,23
050,02,290,"Alaska","Yukon-Koyukuk Census Area",3,45,62,35,27
050,02,290,"Alaska","Yukon-Koyukuk Census Area",3,46,59,34,25
050,02,290,"Alaska","Yukon-Koyukuk Census Area",3,47,56,30,26
050,02,290,"Alaska","Yukon-Koyukuk Census Area",3,48,50,28,22
050,02,290,"Alaska","Yukon-Koyukuk Census Area",3,49,46,26,20
050,02,290,"Alaska","Yukon-Koyukuk Census Area",3,50,48,27,21
050,02,290,"Alaska","Yukon-Koyukuk Census Area",3,51,46,23,23
050,02,290,"Alaska","Yukon-Koyukuk Census Area",3,52,46,23,23
050,02,290,"Alaska","Yukon-Koyukuk Census Area",3,53,52,30,22
050,02,290,"Alaska","Yukon-Koyukuk Census Area",3,54,55,30,25
050,02,290,"Alaska","Yukon-Koyukuk Census Area",3,55,70,36,34
050,02,290,"Alaska","Yukon-Koyukuk Census Area",3,56,72,36,36
050,02,290,"Alaska","Yukon-Koyukuk Census Area",3,57,66,35,31
050,02,290,"Alaska","Yukon-Koyukuk Census Area",3,58,80,45,35
050,02,290,"Alaska","Yukon-Koyukuk Census Area",3,59,69,37,32
050,02,290,"Alaska","Yukon-Koyukuk Census Area",3,60,67,40,27
050,02,290,"Alaska","Yukon-Koyukuk Census Area",3,61,60,33,27
050,02,290,"Alaska","Yukon-Koyukuk Census Area",3,62,76,39,37
050,02,290,"Alaska","Yukon-Koyukuk Census Area",3,63,86,44,42
050,02,290,"Alaska","Yukon-Koyukuk Census Area",3,64,88,45,43
050,02,290,"Alaska","Yukon-Koyukuk Census Area",3,65,75,41,34
050,02,290,"Alaska","Yukon-Koyukuk Census Area",3,66,61,34,27
050,02,290,"Alaska","Yukon-Koyukuk Census Area",3,67,63,39,24
050,02,290,"Alaska","Yukon-Koyukuk Census Area",3,68,70,44,26
050,02,290,"Alaska","Yukon-Koyukuk Census Area",3,69,69,35,34
050,02,290,"Alaska","Yukon-Koyukuk Census Area",3,70,64,38,26
050,02,290,"Alaska","Yukon-Koyukuk Census Area",3,71,62,35,27
050,02,290,"Alaska","Yukon-Koyukuk Census Area",3,72,50,26,24
050,02,290,"Alaska","Yukon-Koyukuk Census Area",3,73,43,25,18
050,02,290,"Alaska","Yukon-Koyukuk Census Area",3,74,42,23,19
050,02,290,"Alaska","Yukon-Koyukuk Census Area",3,75,32,17,15
050,02,290,"Alaska","Yukon-Koyukuk Census Area",3,76,34,18,16
050,02,290,"Alaska","Yukon-Koyukuk Census Area",3,77,28,18,10
050,02,290,"Alaska","Yukon-Koyukuk Census Area",3,78,31,20,11
050,02,290,"Alaska","Yukon-Koyukuk Census Area",3,79,22,13,9
050,02,290,"Alaska","Yukon-Koyukuk Census Area",3,80,22,10,12
050,02,290,"Alaska","Yukon-Koyukuk Census Area",3,81,22,13,9
050,02,290,"Alaska","Yukon-Koyukuk Census Area",3,82,17,7,10
050,02,290,"Alaska","Yukon-Koyukuk Census Area",3,83,13,5,8
050,02,290,"Alaska","Yukon-Koyukuk Census Area",3,84,11,4,7
050,02,290,"Alaska","Yukon-Koyukuk Census Area",3,85,61,29,32
050,02,290,"Alaska","Yukon-Koyukuk Census Area",4,0,54,25,29
050,02,290,"Alaska","Yukon-Koyukuk Census Area",4,1,68,28,40
050,02,290,"Alaska","Yukon-Koyukuk Census Area",4,2,79,47,32
050,02,290,"Alaska","Yukon-Koyukuk Census Area",4,3,76,38,38
050,02,290,"Alaska","Yukon-Koyukuk Census Area",4,4,68,29,39
050,02,290,"Alaska","Yukon-Koyukuk Census Area",4,5,73,29,44
050,02,290,"Alaska","Yukon-Koyukuk Census Area",4,6,81,36,45
050,02,290,"Alaska","Yukon-Koyukuk Census Area",4,7,76,36,40
050,02,290,"Alaska","Yukon-Koyukuk Census Area",4,8,80,47,33
050,02,290,"Alaska","Yukon-Koyukuk Census Area",4,9,83,38,45
050,02,290,"Alaska","Yukon-Koyukuk Census Area",4,10,79,41,38
050,02,290,"Alaska","Yukon-Koyukuk Census Area",4,11,83,41,42
050,02,290,"Alaska","Yukon-Koyukuk Census Area",4,12,90,46,44
050,02,290,"Alaska","Yukon-Koyukuk Census Area",4,13,101,56,45
050,02,290,"Alaska","Yukon-Koyukuk Census Area",4,14,80,42,38
050,02,290,"Alaska","Yukon-Koyukuk Census Area",4,15,78,44,34
050,02,290,"Alaska","Yukon-Koyukuk Census Area",4,16,74,41,33
050,02,290,"Alaska","Yukon-Koyukuk Census Area",4,17,60,38,22
050,02,290,"Alaska","Yukon-Koyukuk Census Area",4,18,62,34,28
050,02,290,"Alaska","Yukon-Koyukuk Census Area",4,19,60,36,24
050,02,290,"Alaska","Yukon-Koyukuk Census Area",4,20,55,33,22
050,02,290,"Alaska","Yukon-Koyukuk Census Area",4,21,59,29,30
050,02,290,"Alaska","Yukon-Koyukuk Census Area",4,22,51,24,27
050,02,290,"Alaska","Yukon-Koyukuk Census Area",4,23,61,30,31
050,02,290,"Alaska","Yukon-Koyukuk Census Area",4,24,62,34,28
050,02,290,"Alaska","Yukon-Koyukuk Census Area",4,25,55,32,23
050,02,290,"Alaska","Yukon-Koyukuk Census Area",4,26,58,30,28
050,02,290,"Alaska","Yukon-Koyukuk Census Area",4,27,48,22,26
050,02,290,"Alaska","Yukon-Koyukuk Census Area",4,28,54,24,30
050,02,290,"Alaska","Yukon-Koyukuk Census Area",4,29,67,37,30
050,02,290,"Alaska","Yukon-Koyukuk Census Area",4,30,70,42,28
050,02,290,"Alaska","Yukon-Koyukuk Census Area",4,31,76,39,37
050,02,290,"Alaska","Yukon-Koyukuk Census Area",4,32,76,47,29
050,02,290,"Alaska","Yukon-Koyukuk Census Area",4,33,72,41,31
050,02,290,"Alaska","Yukon-Koyukuk Census Area",4,34,70,34,36
050,02,290,"Alaska","Yukon-Koyukuk Census Area",4,35,66,37,29
050,02,290,"Alaska","Yukon-Koyukuk Census Area",4,36,54,37,17
050,02,290,"Alaska","Yukon-Koyukuk Census Area",4,37,72,42,30
050,02,290,"Alaska","Yukon-Koyukuk Census Area",4,38,67,39,28
050,02,290,"Alaska","Yukon-Koyukuk Census Area",4,39,66,41,25
050,02,290,"Alaska","Yukon-Koyukuk Census Area",4,40,59,34,25
050,02,290,"Alaska","Yukon-Koyukuk Census Area",4,41,63,35,28
050,02,290,"Alaska","Yukon-Koyukuk Census Area",4,42,65,38,27
050,02,290,"Alaska","Yukon-Koyukuk Census Area",4,43,62,40,22
050,02,290,"Alaska","Yukon-Koyukuk Census Area",4,44,55,35,20
050,02,290,"Alaska","Yukon-Koyukuk Census Area",4,45,52,31,21
050,02,290,"Alaska","Yukon-Koyukuk Census Area",4,46,65,38,27
050,02,290,"Alaska","Yukon-Koyukuk Census Area",4,47,57,34,23
050,02,290,"Alaska","Yukon-Koyukuk Census Area",4,48,56,31,25
050,02,290,"Alaska","Yukon-Koyukuk Census Area",4,49,50,27,23
050,02,290,"Alaska","Yukon-Koyukuk Census Area",4,50,45,26,19
050,02,290,"Alaska","Yukon-Koyukuk Census Area",4,51,45,24,21
050,02,290,"Alaska","Yukon-Koyukuk Census Area",4,52,40,19,21
050,02,290,"Alaska","Yukon-Koyukuk Census Area",4,53,47,21,26
050,02,290,"Alaska","Yukon-Koyukuk Census Area",4,54,48,28,20
050,02,290,"Alaska","Yukon-Koyukuk Census Area",4,55,55,32,23
050,02,290,"Alaska","Yukon-Koyukuk Census Area",4,56,62,31,31
050,02,290,"Alaska","Yukon-Koyukuk Census Area",4,57,69,33,36
050,02,290,"Alaska","Yukon-Koyukuk Census Area",4,58,61,30,31
050,02,290,"Alaska","Yukon-Koyukuk Census Area",4,59,78,45,33
050,02,290,"Alaska","Yukon-Koyukuk Census Area",4,60,65,33,32
050,02,290,"Alaska","Yukon-Koyukuk Census Area",4,61,63,37,26
050,02,290,"Alaska","Yukon-Koyukuk Census Area",4,62,61,33,28
050,02,290,"Alaska","Yukon-Koyukuk Census Area",4,63,73,38,35
050,02,290,"Alaska","Yukon-Koyukuk Census Area",4,64,81,41,40
050,02,290,"Alaska","Yukon-Koyukuk Census Area",4,65,85,43,42
050,02,290,"Alaska","Yukon-Koyukuk Census Area",4,66,67,37,30
050,02,290,"Alaska","Yukon-Koyukuk Census Area",4,67,61,36,25
050,02,290,"Alaska","Yukon-Koyukuk Census Area",4,68,62,38,24
050,02,290,"Alaska","Yukon-Koyukuk Census Area",4,69,67,44,23
050,02,290,"Alaska","Yukon-Koyukuk Census Area",4,70,61,28,33
050,02,290,"Alaska","Yukon-Koyukuk Census Area",4,71,64,38,26
050,02,290,"Alaska","Yukon-Koyukuk Census Area",4,72,57,35,22
050,02,290,"Alaska","Yukon-Koyukuk Census Area",4,73,46,27,19
050,02,290,"Alaska","Yukon-Koyukuk Census Area",4,74,43,25,18
050,02,290,"Alaska","Yukon-Koyukuk Census Area",4,75,41,22,19
050,02,290,"Alaska","Yukon-Koyukuk Census Area",4,76,28,13,15
050,02,290,"Alaska","Yukon-Koyukuk Census Area",4,77,32,16,16
050,02,290,"Alaska","Yukon-Koyukuk Census Area",4,78,28,18,10
050,02,290,"Alaska","Yukon-Koyukuk Census Area",4,79,31,19,12
050,02,290,"Alaska","Yukon-Koyukuk Census Area",4,80,19,10,9
050,02,290,"Alaska","Yukon-Koyukuk Census Area",4,81,19,9,10
050,02,290,"Alaska","Yukon-Koyukuk Census Area",4,82,23,13,10
050,02,290,"Alaska","Yukon-Koyukuk Census Area",4,83,16,7,9
050,02,290,"Alaska","Yukon-Koyukuk Census Area",4,84,13,4,9
050,02,290,"Alaska","Yukon-Koyukuk Census Area",4,85,65,28,37
050,02,290,"Alaska","Yukon-Koyukuk Census Area",5,0,55,25,30
050,02,290,"Alaska","Yukon-Koyukuk Census Area",5,1,55,28,27
050,02,290,"Alaska","Yukon-Koyukuk Census Area",5,2,65,29,36
050,02,290,"Alaska","Yukon-Koyukuk Census Area",5,3,77,45,32
050,02,290,"Alaska","Yukon-Koyukuk Census Area",5,4,74,32,42
050,02,290,"Alaska","Yukon-Koyukuk Census Area",5,5,77,36,41
050,02,290,"Alaska","Yukon-Koyukuk Census Area",5,6,70,27,43
050,02,290,"Alaska","Yukon-Koyukuk Census Area",5,7,87,36,51
050,02,290,"Alaska","Yukon-Koyukuk Census Area",5,8,77,37,40
050,02,290,"Alaska","Yukon-Koyukuk Census Area",5,9,82,47,35
050,02,290,"Alaska","Yukon-Koyukuk Census Area",5,10,82,36,46
050,02,290,"Alaska","Yukon-Koyukuk Census Area",5,11,80,42,38
050,02,290,"Alaska","Yukon-Koyukuk Census Area",5,12,86,41,45
050,02,290,"Alaska","Yukon-Koyukuk Census Area",5,13,93,49,44
050,02,290,"Alaska","Yukon-Koyukuk Census Area",5,14,106,56,50
050,02,290,"Alaska","Yukon-Koyukuk Census Area",5,15,80,44,36
050,02,290,"Alaska","Yukon-Koyukuk Census Area",5,16,72,41,31
050,02,290,"Alaska","Yukon-Koyukuk Census Area",5,17,79,46,33
050,02,290,"Alaska","Yukon-Koyukuk Census Area",5,18,55,35,20
050,02,290,"Alaska","Yukon-Koyukuk Census Area",5,19,62,37,25
050,02,290,"Alaska","Yukon-Koyukuk Census Area",5,20,64,37,27
050,02,290,"Alaska","Yukon-Koyukuk Census Area",5,21,47,32,15
050,02,290,"Alaska","Yukon-Koyukuk Census Area",5,22,47,24,23
050,02,290,"Alaska","Yukon-Koyukuk Census Area",5,23,49,22,27
050,02,290,"Alaska","Yukon-Koyukuk Census Area",5,24,55,30,25
050,02,290,"Alaska","Yukon-Koyukuk Census Area",5,25,66,35,31
050,02,290,"Alaska","Yukon-Koyukuk Census Area",5,26,52,29,23
050,02,290,"Alaska","Yukon-Koyukuk Census Area",5,27,52,27,25
050,02,290,"Alaska","Yukon-Koyukuk Census Area",5,28,54,28,26
050,02,290,"Alaska","Yukon-Koyukuk Census Area",5,29,52,24,28
050,02,290,"Alaska","Yukon-Koyukuk Census Area",5,30,71,41,30
050,02,290,"Alaska","Yukon-Koyukuk Census Area",5,31,65,40,25
050,02,290,"Alaska","Yukon-Koyukuk Census Area",5,32,75,41,34
050,02,290,"Alaska","Yukon-Koyukuk Census Area",5,33,74,46,28
050,02,290,"Alaska","Yukon-Koyukuk Census Area",5,34,74,39,35
050,02,290,"Alaska","Yukon-Koyukuk Census Area",5,35,67,34,33
050,02,290,"Alaska","Yukon-Koyukuk Census Area",5,36,76,45,31
050,02,290,"Alaska","Yukon-Koyukuk Census Area",5,37,53,36,17
050,02,290,"Alaska","Yukon-Koyukuk Census Area",5,38,69,39,30
050,02,290,"Alaska","Yukon-Koyukuk Census Area",5,39,70,43,27
050,02,290,"Alaska","Yukon-Koyukuk Census Area",5,40,64,40,24
050,02,290,"Alaska","Yukon-Koyukuk Census Area",5,41,52,26,26
050,02,290,"Alaska","Yukon-Koyukuk Census Area",5,42,62,34,28
050,02,290,"Alaska","Yukon-Koyukuk Census Area",5,43,67,39,28
050,02,290,"Alaska","Yukon-Koyukuk Census Area",5,44,60,39,21
050,02,290,"Alaska","Yukon-Koyukuk Census Area",5,45,57,36,21
050,02,290,"Alaska","Yukon-Koyukuk Census Area",5,46,52,29,23
050,02,290,"Alaska","Yukon-Koyukuk Census Area",5,47,64,38,26
050,02,290,"Alaska","Yukon-Koyukuk Census Area",5,48,60,35,25
050,02,290,"Alaska","Yukon-Koyukuk Census Area",5,49,68,33,35
050,02,290,"Alaska","Yukon-Koyukuk Census Area",5,50,49,29,20
050,02,290,"Alaska","Yukon-Koyukuk Census Area",5,51,45,25,20
050,02,290,"Alaska","Yukon-Koyukuk Census Area",5,52,46,23,23
050,02,290,"Alaska","Yukon-Koyukuk Census Area",5,53,45,23,22
050,02,290,"Alaska","Yukon-Koyukuk Census Area",5,54,46,18,28
050,02,290,"Alaska","Yukon-Koyukuk Census Area",5,55,52,31,21
050,02,290,"Alaska","Yukon-Koyukuk Census Area",5,56,53,30,23
050,02,290,"Alaska","Yukon-Koyukuk Census Area",5,57,60,31,29
050,02,290,"Alaska","Yukon-Koyukuk Census Area",5,58,63,30,33
050,02,290,"Alaska","Yukon-Koyukuk Census Area",5,59,64,32,32
050,02,290,"Alaska","Yukon-Koyukuk Census Area",5,60,76,44,32
050,02,290,"Alaska","Yukon-Koyukuk Census Area",5,61,58,29,29
050,02,290,"Alaska","Yukon-Koyukuk Census Area",5,62,61,34,27
050,02,290,"Alaska","Yukon-Koyukuk Census Area",5,63,58,30,28
050,02,290,"Alaska","Yukon-Koyukuk Census Area",5,64,69,36,33
050,02,290,"Alaska","Yukon-Koyukuk Census Area",5,65,77,37,40
050,02,290,"Alaska","Yukon-Koyukuk Census Area",5,66,77,39,38
050,02,290,"Alaska","Yukon-Koyukuk Census Area",5,67,66,37,29
050,02,290,"Alaska","Yukon-Koyukuk Census Area",5,68,58,34,24
050,02,290,"Alaska","Yukon-Koyukuk Census Area",5,69,58,37,21
050,02,290,"Alaska","Yukon-Koyukuk Census Area",5,70,58,39,19
050,02,290,"Alaska","Yukon-Koyukuk Census Area",5,71,60,26,34
050,02,290,"Alaska","Yukon-Koyukuk Census Area",5,72,57,37,20
050,02,290,"Alaska","Yukon-Koyukuk Census Area",5,73,52,34,18
050,02,290,"Alaska","Yukon-Koyukuk Census Area",5,74,46,26,20
050,02,290,"Alaska","Yukon-Koyukuk Census Area",5,75,41,24,17
050,02,290,"Alaska","Yukon-Koyukuk Census Area",5,76,34,15,19
050,02,290,"Alaska","Yukon-Koyukuk Census Area",5,77,26,11,15
050,02,290,"Alaska","Yukon-Koyukuk Census Area",5,78,31,15,16
050,02,290,"Alaska","Yukon-Koyukuk Census Area",5,79,27,17,10
050,02,290,"Alaska","Yukon-Koyukuk Census Area",5,80,27,15,12
050,02,290,"Alaska","Yukon-Koyukuk Census Area",5,81,16,8,8
050,02,290,"Alaska","Yukon-Koyukuk Census Area",5,82,19,8,11
050,02,290,"Alaska","Yukon-Koyukuk Census Area",5,83,19,11,8
050,02,290,"Alaska","Yukon-Koyukuk Census Area",5,84,15,7,8
050,02,290,"Alaska","Yukon-Koyukuk Census Area",5,85,68,24,44

