"SUMLEV","STATE","COUNTY","STNAME","CTYNAME","YEAR","AGE","TOT_POP","TOT_MALE","TOT_FEMALE"
050,35,001,"New Mexico","Bernalillo County",1,0,6785,3462,3323
050,35,001,"New Mexico","Bernalillo County",1,1,6886,3478,3408
050,35,001,"New Mexico","Bernalillo County",1,2,7074,3592,3482
050,35,001,"New Mexico","Bernalillo County",1,3,7163,3650,3513
050,35,001,"New Mexico","Bernalillo County",1,4,7513,3796,3717
050,35,001,"New Mexico","Bernalillo County",1,5,7599,3878,3721
050,35,001,"New Mexico","Bernalillo County",1,6,7707,3920,3787
050,35,001,"New Mexico","Bernalillo County",1,7,7831,4117,3714
050,35,001,"New Mexico","Bernalillo County",1,8,7922,4113,3809
050,35,001,"New Mexico","Bernalillo County",1,9,7932,4030,3902
050,35,001,"New Mexico","Bernalillo County",1,10,8396,4318,4078
050,35,001,"New Mexico","Bernalillo County",1,11,8680,4428,4252
050,35,001,"New Mexico","Bernalillo County",1,12,8853,4567,4286
050,35,001,"New Mexico","Bernalillo County",1,13,8825,4555,4270
050,35,001,"New Mexico","Bernalillo County",1,14,8597,4355,4242
050,35,001,"New Mexico","Bernalillo County",1,15,8565,4330,4235
050,35,001,"New Mexico","Bernalillo County",1,16,8607,4326,4281
050,35,001,"New Mexico","Bernalillo County",1,17,8740,4409,4331
050,35,001,"New Mexico","Bernalillo County",1,18,8407,4336,4071
050,35,001,"New Mexico","Bernalillo County",1,19,8332,4237,4095
050,35,001,"New Mexico","Bernalillo County",1,20,8381,4309,4072
050,35,001,"New Mexico","Bernalillo County",1,21,8343,4272,4071
050,35,001,"New Mexico","Bernalillo County",1,22,8385,4259,4126
050,35,001,"New Mexico","Bernalillo County",1,23,8683,4349,4334
050,35,001,"New Mexico","Bernalillo County",1,24,8982,4539,4443
050,35,001,"New Mexico","Bernalillo County",1,25,9245,4706,4539
050,35,001,"New Mexico","Bernalillo County",1,26,9449,4793,4656
050,35,001,"New Mexico","Bernalillo County",1,27,9701,4896,4805
050,35,001,"New Mexico","Bernalillo County",1,28,10093,5181,4912
050,35,001,"New Mexico","Bernalillo County",1,29,10124,5065,5059
050,35,001,"New Mexico","Bernalillo County",1,30,10043,5010,5033
050,35,001,"New Mexico","Bernalillo County",1,31,9974,5085,4889
050,35,001,"New Mexico","Bernalillo County",1,32,10071,5186,4885
050,35,001,"New Mexico","Bernalillo County",1,33,9975,5095,4880
050,35,001,"New Mexico","Bernalillo County",1,34,9881,5033,4848
050,35,001,"New Mexico","Bernalillo County",1,35,9862,4948,4914
050,35,001,"New Mexico","Bernalillo County",1,36,9752,4905,4847
050,35,001,"New Mexico","Bernalillo County",1,37,9868,4987,4881
050,35,001,"New Mexico","Bernalillo County",1,38,9558,4786,4772
050,35,001,"New Mexico","Bernalillo County",1,39,9364,4664,4700
050,35,001,"New Mexico","Bernalillo County",1,40,9089,4631,4458
050,35,001,"New Mexico","Bernalillo County",1,41,8635,4335,4300
050,35,001,"New Mexico","Bernalillo County",1,42,8361,4188,4173
050,35,001,"New Mexico","Bernalillo County",1,43,7964,4033,3931
050,35,001,"New Mexico","Bernalillo County",1,44,8004,4057,3947
050,35,001,"New Mexico","Bernalillo County",1,45,7907,3968,3939
050,35,001,"New Mexico","Bernalillo County",1,46,7674,3840,3834
050,35,001,"New Mexico","Bernalillo County",1,47,7832,3929,3903
050,35,001,"New Mexico","Bernalillo County",1,48,7990,3924,4066
050,35,001,"New Mexico","Bernalillo County",1,49,8445,4168,4277
050,35,001,"New Mexico","Bernalillo County",1,50,8253,4072,4181
050,35,001,"New Mexico","Bernalillo County",1,51,8015,3981,4034
050,35,001,"New Mexico","Bernalillo County",1,52,7703,3795,3908
050,35,001,"New Mexico","Bernalillo County",1,53,7861,3890,3971
050,35,001,"New Mexico","Bernalillo County",1,54,8086,3935,4151
050,35,001,"New Mexico","Bernalillo County",1,55,8560,4150,4410
050,35,001,"New Mexico","Bernalillo County",1,56,8800,4355,4445
050,35,001,"New Mexico","Bernalillo County",1,57,8937,4322,4615
050,35,001,"New Mexico","Bernalillo County",1,58,9258,4536,4722
050,35,001,"New Mexico","Bernalillo County",1,59,9212,4484,4728
050,35,001,"New Mexico","Bernalillo County",1,60,8974,4316,4658
050,35,001,"New Mexico","Bernalillo County",1,61,8911,4281,4630
050,35,001,"New Mexico","Bernalillo County",1,62,8917,4199,4718
050,35,001,"New Mexico","Bernalillo County",1,63,8702,4048,4654
050,35,001,"New Mexico","Bernalillo County",1,64,8460,3881,4579
050,35,001,"New Mexico","Bernalillo County",1,65,8167,3798,4369
050,35,001,"New Mexico","Bernalillo County",1,66,8052,3717,4335
050,35,001,"New Mexico","Bernalillo County",1,67,7911,3601,4310
050,35,001,"New Mexico","Bernalillo County",1,68,7651,3480,4171
050,35,001,"New Mexico","Bernalillo County",1,69,7018,3190,3828
050,35,001,"New Mexico","Bernalillo County",1,70,6991,3330,3661
050,35,001,"New Mexico","Bernalillo County",1,71,6837,3217,3620
050,35,001,"New Mexico","Bernalillo County",1,72,6810,3150,3660
050,35,001,"New Mexico","Bernalillo County",1,73,6586,3054,3532
050,35,001,"New Mexico","Bernalillo County",1,74,4692,2156,2536
050,35,001,"New Mexico","Bernalillo County",1,75,4533,2066,2467
050,35,001,"New Mexico","Bernalillo County",1,76,4360,1966,2394
050,35,001,"New Mexico","Bernalillo County",1,77,4290,1896,2394
050,35,001,"New Mexico","Bernalillo County",1,78,3624,1607,2017
050,35,001,"New Mexico","Bernalillo County",1,79,3290,1505,1785
050,35,001,"New Mexico","Bernalillo County",1,80,2977,1306,1671
050,35,001,"New Mexico","Bernalillo County",1,81,2817,1189,1628
050,35,001,"New Mexico","Bernalillo County",1,82,2578,1085,1493
050,35,001,"New Mexico","Bernalillo County",1,83,2289,973,1316
050,35,001,"New Mexico","Bernalillo County",1,84,2034,855,1179
050,35,001,"New Mexico","Bernalillo County",1,85,12247,4524,7723
050,35,001,"New Mexico","Bernalillo County",2,0,6682,3417,3265
050,35,001,"New Mexico","Bernalillo County",2,1,6867,3478,3389
050,35,001,"New Mexico","Bernalillo County",2,2,7037,3564,3473
050,35,001,"New Mexico","Bernalillo County",2,3,7115,3622,3493
050,35,001,"New Mexico","Bernalillo County",2,4,7422,3760,3662
050,35,001,"New Mexico","Bernalillo County",2,5,7554,3846,3708
050,35,001,"New Mexico","Bernalillo County",2,6,7675,3912,3763
050,35,001,"New Mexico","Bernalillo County",2,7,7772,4048,3724
050,35,001,"New Mexico","Bernalillo County",2,8,7863,4092,3771
050,35,001,"New Mexico","Bernalillo County",2,9,7909,4043,3866
050,35,001,"New Mexico","Bernalillo County",2,10,8276,4239,4037
050,35,001,"New Mexico","Bernalillo County",2,11,8573,4382,4191
050,35,001,"New Mexico","Bernalillo County",2,12,8837,4549,4288
050,35,001,"New Mexico","Bernalillo County",2,13,8813,4549,4264
050,35,001,"New Mexico","Bernalillo County",2,14,8658,4404,4254
050,35,001,"New Mexico","Bernalillo County",2,15,8568,4337,4231
050,35,001,"New Mexico","Bernalillo County",2,16,8617,4342,4275
050,35,001,"New Mexico","Bernalillo County",2,17,8712,4400,4312
050,35,001,"New Mexico","Bernalillo County",2,18,8465,4342,4123
050,35,001,"New Mexico","Bernalillo County",2,19,8377,4268,4109
050,35,001,"New Mexico","Bernalillo County",2,20,8466,4355,4111
050,35,001,"New Mexico","Bernalillo County",2,21,8348,4272,4076
050,35,001,"New Mexico","Bernalillo County",2,22,8448,4286,4162
050,35,001,"New Mexico","Bernalillo County",2,23,8685,4363,4322
050,35,001,"New Mexico","Bernalillo County",2,24,8916,4499,4417
050,35,001,"New Mexico","Bernalillo County",2,25,9209,4673,4536
050,35,001,"New Mexico","Bernalillo County",2,26,9415,4781,4634
050,35,001,"New Mexico","Bernalillo County",2,27,9644,4882,4762
050,35,001,"New Mexico","Bernalillo County",2,28,10034,5135,4899
050,35,001,"New Mexico","Bernalillo County",2,29,10104,5081,5023
050,35,001,"New Mexico","Bernalillo County",2,30,10110,5044,5066
050,35,001,"New Mexico","Bernalillo County",2,31,9957,5058,4899
050,35,001,"New Mexico","Bernalillo County",2,32,10031,5155,4876
050,35,001,"New Mexico","Bernalillo County",2,33,9993,5112,4881
050,35,001,"New Mexico","Bernalillo County",2,34,9909,5049,4860
050,35,001,"New Mexico","Bernalillo County",2,35,9913,4994,4919
050,35,001,"New Mexico","Bernalillo County",2,36,9729,4896,4833
050,35,001,"New Mexico","Bernalillo County",2,37,9834,4966,4868
050,35,001,"New Mexico","Bernalillo County",2,38,9677,4864,4813
050,35,001,"New Mexico","Bernalillo County",2,39,9370,4668,4702
050,35,001,"New Mexico","Bernalillo County",2,40,9226,4678,4548
050,35,001,"New Mexico","Bernalillo County",2,41,8721,4389,4332
050,35,001,"New Mexico","Bernalillo County",2,42,8407,4220,4187
050,35,001,"New Mexico","Bernalillo County",2,43,8114,4097,4017
050,35,001,"New Mexico","Bernalillo County",2,44,7953,4037,3916
050,35,001,"New Mexico","Bernalillo County",2,45,7957,4000,3957
050,35,001,"New Mexico","Bernalillo County",2,46,7717,3867,3850
050,35,001,"New Mexico","Bernalillo County",2,47,7770,3892,3878
050,35,001,"New Mexico","Bernalillo County",2,48,7944,3910,4034
050,35,001,"New Mexico","Bernalillo County",2,49,8376,4134,4242
050,35,001,"New Mexico","Bernalillo County",2,50,8294,4092,4202
050,35,001,"New Mexico","Bernalillo County",2,51,8046,3997,4049
050,35,001,"New Mexico","Bernalillo County",2,52,7777,3836,3941
050,35,001,"New Mexico","Bernalillo County",2,53,7804,3856,3948
050,35,001,"New Mexico","Bernalillo County",2,54,8008,3903,4105
050,35,001,"New Mexico","Bernalillo County",2,55,8463,4110,4353
050,35,001,"New Mexico","Bernalillo County",2,56,8755,4310,4445
050,35,001,"New Mexico","Bernalillo County",2,57,8895,4328,4567
050,35,001,"New Mexico","Bernalillo County",2,58,9175,4466,4709
050,35,001,"New Mexico","Bernalillo County",2,59,9209,4486,4723
050,35,001,"New Mexico","Bernalillo County",2,60,9048,4358,4690
050,35,001,"New Mexico","Bernalillo County",2,61,8912,4282,4630
050,35,001,"New Mexico","Bernalillo County",2,62,8856,4183,4673
050,35,001,"New Mexico","Bernalillo County",2,63,8800,4108,4692
050,35,001,"New Mexico","Bernalillo County",2,64,8454,3893,4561
050,35,001,"New Mexico","Bernalillo County",2,65,8220,3817,4403
050,35,001,"New Mexico","Bernalillo County",2,66,8067,3728,4339
050,35,001,"New Mexico","Bernalillo County",2,67,7897,3609,4288
050,35,001,"New Mexico","Bernalillo County",2,68,7619,3460,4159
050,35,001,"New Mexico","Bernalillo County",2,69,7171,3262,3909
050,35,001,"New Mexico","Bernalillo County",2,70,6957,3274,3683
050,35,001,"New Mexico","Bernalillo County",2,71,6853,3231,3622
050,35,001,"New Mexico","Bernalillo County",2,72,6694,3112,3582
050,35,001,"New Mexico","Bernalillo County",2,73,6876,3185,3691
050,35,001,"New Mexico","Bernalillo County",2,74,4878,2243,2635
050,35,001,"New Mexico","Bernalillo County",2,75,4564,2083,2481
050,35,001,"New Mexico","Bernalillo County",2,76,4338,1959,2379
050,35,001,"New Mexico","Bernalillo County",2,77,4354,1929,2425
050,35,001,"New Mexico","Bernalillo County",2,78,3704,1636,2068
050,35,001,"New Mexico","Bernalillo County",2,79,3319,1501,1818
050,35,001,"New Mexico","Bernalillo County",2,80,3017,1335,1682
050,35,001,"New Mexico","Bernalillo County",2,81,2810,1207,1603
050,35,001,"New Mexico","Bernalillo County",2,82,2620,1099,1521
050,35,001,"New Mexico","Bernalillo County",2,83,2307,979,1328
050,35,001,"New Mexico","Bernalillo County",2,84,2055,859,1196
050,35,001,"New Mexico","Bernalillo County",2,85,12268,4547,7721
050,35,001,"New Mexico","Bernalillo County",3,0,6362,3258,3104
050,35,001,"New Mexico","Bernalillo County",3,1,6563,3354,3209
050,35,001,"New Mexico","Bernalillo County",3,2,6814,3449,3365
050,35,001,"New Mexico","Bernalillo County",3,3,6971,3557,3414
050,35,001,"New Mexico","Bernalillo County",3,4,7061,3557,3504
050,35,001,"New Mexico","Bernalillo County",3,5,7392,3737,3655
050,35,001,"New Mexico","Bernalillo County",3,6,7511,3829,3682
050,35,001,"New Mexico","Bernalillo County",3,7,7610,3855,3755
050,35,001,"New Mexico","Bernalillo County",3,8,7696,3996,3700
050,35,001,"New Mexico","Bernalillo County",3,9,7834,4085,3749
050,35,001,"New Mexico","Bernalillo County",3,10,7844,4028,3816
050,35,001,"New Mexico","Bernalillo County",3,11,8272,4212,4060
050,35,001,"New Mexico","Bernalillo County",3,12,8471,4324,4147
050,35,001,"New Mexico","Bernalillo County",3,13,8742,4486,4256
050,35,001,"New Mexico","Bernalillo County",3,14,8769,4534,4235
050,35,001,"New Mexico","Bernalillo County",3,15,8556,4366,4190
050,35,001,"New Mexico","Bernalillo County",3,16,8510,4302,4208
050,35,001,"New Mexico","Bernalillo County",3,17,8577,4307,4270
050,35,001,"New Mexico","Bernalillo County",3,18,8625,4370,4255
050,35,001,"New Mexico","Bernalillo County",3,19,8389,4261,4128
050,35,001,"New Mexico","Bernalillo County",3,20,8515,4399,4116
050,35,001,"New Mexico","Bernalillo County",3,21,8470,4300,4170
050,35,001,"New Mexico","Bernalillo County",3,22,8564,4307,4257
050,35,001,"New Mexico","Bernalillo County",3,23,8690,4433,4257
050,35,001,"New Mexico","Bernalillo County",3,24,8936,4519,4417
050,35,001,"New Mexico","Bernalillo County",3,25,9095,4583,4512
050,35,001,"New Mexico","Bernalillo County",3,26,9293,4699,4594
050,35,001,"New Mexico","Bernalillo County",3,27,9436,4769,4667
050,35,001,"New Mexico","Bernalillo County",3,28,9760,4938,4822
050,35,001,"New Mexico","Bernalillo County",3,29,10038,5183,4855
050,35,001,"New Mexico","Bernalillo County",3,30,9993,4996,4997
050,35,001,"New Mexico","Bernalillo County",3,31,10158,5056,5102
050,35,001,"New Mexico","Bernalillo County",3,32,9876,4971,4905
050,35,001,"New Mexico","Bernalillo County",3,33,9969,5102,4867
050,35,001,"New Mexico","Bernalillo County",3,34,9872,5073,4799
050,35,001,"New Mexico","Bernalillo County",3,35,9874,5087,4787
050,35,001,"New Mexico","Bernalillo County",3,36,9861,4993,4868
050,35,001,"New Mexico","Bernalillo County",3,37,9637,4832,4805
050,35,001,"New Mexico","Bernalillo County",3,38,9730,4904,4826
050,35,001,"New Mexico","Bernalillo County",3,39,9559,4755,4804
050,35,001,"New Mexico","Bernalillo County",3,40,9315,4637,4678
050,35,001,"New Mexico","Bernalillo County",3,41,9200,4656,4544
050,35,001,"New Mexico","Bernalillo County",3,42,8651,4359,4292
050,35,001,"New Mexico","Bernalillo County",3,43,8402,4198,4204
050,35,001,"New Mexico","Bernalillo County",3,44,7957,4014,3943
050,35,001,"New Mexico","Bernalillo County",3,45,7901,3981,3920
050,35,001,"New Mexico","Bernalillo County",3,46,7878,3948,3930
050,35,001,"New Mexico","Bernalillo County",3,47,7666,3829,3837
050,35,001,"New Mexico","Bernalillo County",3,48,7728,3835,3893
050,35,001,"New Mexico","Bernalillo County",3,49,7919,3908,4011
050,35,001,"New Mexico","Bernalillo County",3,50,8225,4002,4223
050,35,001,"New Mexico","Bernalillo County",3,51,8200,4072,4128
050,35,001,"New Mexico","Bernalillo County",3,52,7975,3959,4016
050,35,001,"New Mexico","Bernalillo County",3,53,7756,3811,3945
050,35,001,"New Mexico","Bernalillo County",3,54,7739,3803,3936
050,35,001,"New Mexico","Bernalillo County",3,55,8007,3882,4125
050,35,001,"New Mexico","Bernalillo County",3,56,8324,4015,4309
050,35,001,"New Mexico","Bernalillo County",3,57,8717,4296,4421
050,35,001,"New Mexico","Bernalillo County",3,58,8747,4204,4543
050,35,001,"New Mexico","Bernalillo County",3,59,9051,4405,4646
050,35,001,"New Mexico","Bernalillo County",3,60,9126,4445,4681
050,35,001,"New Mexico","Bernalillo County",3,61,8991,4314,4677
050,35,001,"New Mexico","Bernalillo County",3,62,8729,4170,4559
050,35,001,"New Mexico","Bernalillo County",3,63,8694,4085,4609
050,35,001,"New Mexico","Bernalillo County",3,64,8659,4023,4636
050,35,001,"New Mexico","Bernalillo County",3,65,8308,3801,4507
050,35,001,"New Mexico","Bernalillo County",3,66,8093,3756,4337
050,35,001,"New Mexico","Bernalillo County",3,67,7934,3615,4319
050,35,001,"New Mexico","Bernalillo County",3,68,7730,3517,4213
050,35,001,"New Mexico","Bernalillo County",3,69,7452,3376,4076
050,35,001,"New Mexico","Bernalillo County",3,70,7055,3198,3857
050,35,001,"New Mexico","Bernalillo County",3,71,6855,3213,3642
050,35,001,"New Mexico","Bernalillo County",3,72,6704,3134,3570
050,35,001,"New Mexico","Bernalillo County",3,73,6531,3003,3528
050,35,001,"New Mexico","Bernalillo County",3,74,6672,3065,3607
050,35,001,"New Mexico","Bernalillo County",3,75,4740,2164,2576
050,35,001,"New Mexico","Bernalillo County",3,76,4407,2015,2392
050,35,001,"New Mexico","Bernalillo County",3,77,4190,1881,2309
050,35,001,"New Mexico","Bernalillo County",3,78,4224,1865,2359
050,35,001,"New Mexico","Bernalillo County",3,79,3525,1535,1990
050,35,001,"New Mexico","Bernalillo County",3,80,3154,1402,1752
050,35,001,"New Mexico","Bernalillo County",3,81,2827,1251,1576
050,35,001,"New Mexico","Bernalillo County",3,82,2669,1131,1538
050,35,001,"New Mexico","Bernalillo County",3,83,2411,992,1419
050,35,001,"New Mexico","Bernalillo County",3,84,2091,856,1235
050,35,001,"New Mexico","Bernalillo County",3,85,12262,4623,7639
050,35,001,"New Mexico","Bernalillo County",4,0,6456,3343,3113
050,35,001,"New Mexico","Bernalillo County",4,1,6265,3240,3025
050,35,001,"New Mexico","Bernalillo County",4,2,6411,3297,3114
050,35,001,"New Mexico","Bernalillo County",4,3,6707,3395,3312
050,35,001,"New Mexico","Bernalillo County",4,4,6914,3529,3385
050,35,001,"New Mexico","Bernalillo County",4,5,6935,3523,3412
050,35,001,"New Mexico","Bernalillo County",4,6,7315,3718,3597
050,35,001,"New Mexico","Bernalillo County",4,7,7479,3843,3636
050,35,001,"New Mexico","Bernalillo County",4,8,7517,3792,3725
050,35,001,"New Mexico","Bernalillo County",4,9,7641,3946,3695
050,35,001,"New Mexico","Bernalillo County",4,10,7825,4073,3752
050,35,001,"New Mexico","Bernalillo County",4,11,7772,3976,3796
050,35,001,"New Mexico","Bernalillo County",4,12,8199,4158,4041
050,35,001,"New Mexico","Bernalillo County",4,13,8431,4287,4144
050,35,001,"New Mexico","Bernalillo County",4,14,8723,4462,4261
050,35,001,"New Mexico","Bernalillo County",4,15,8680,4473,4207
050,35,001,"New Mexico","Bernalillo County",4,16,8549,4360,4189
050,35,001,"New Mexico","Bernalillo County",4,17,8538,4328,4210
050,35,001,"New Mexico","Bernalillo County",4,18,8431,4245,4186
050,35,001,"New Mexico","Bernalillo County",4,19,8476,4265,4211
050,35,001,"New Mexico","Bernalillo County",4,20,8490,4363,4127
050,35,001,"New Mexico","Bernalillo County",4,21,8512,4389,4123
050,35,001,"New Mexico","Bernalillo County",4,22,8701,4406,4295
050,35,001,"New Mexico","Bernalillo County",4,23,8803,4470,4333
050,35,001,"New Mexico","Bernalillo County",4,24,8904,4544,4360
050,35,001,"New Mexico","Bernalillo County",4,25,9053,4539,4514
050,35,001,"New Mexico","Bernalillo County",4,26,9205,4611,4594
050,35,001,"New Mexico","Bernalillo County",4,27,9347,4729,4618
050,35,001,"New Mexico","Bernalillo County",4,28,9600,4875,4725
050,35,001,"New Mexico","Bernalillo County",4,29,9800,4923,4877
050,35,001,"New Mexico","Bernalillo County",4,30,9964,5182,4782
050,35,001,"New Mexico","Bernalillo County",4,31,9915,4971,4944
050,35,001,"New Mexico","Bernalillo County",4,32,10081,5032,5049
050,35,001,"New Mexico","Bernalillo County",4,33,9863,4954,4909
050,35,001,"New Mexico","Bernalillo County",4,34,9864,5084,4780
050,35,001,"New Mexico","Bernalillo County",4,35,9885,5068,4817
050,35,001,"New Mexico","Bernalillo County",4,36,9758,5026,4732
050,35,001,"New Mexico","Bernalillo County",4,37,9759,4975,4784
050,35,001,"New Mexico","Bernalillo County",4,38,9537,4797,4740
050,35,001,"New Mexico","Bernalillo County",4,39,9655,4830,4825
050,35,001,"New Mexico","Bernalillo County",4,40,9472,4726,4746
050,35,001,"New Mexico","Bernalillo County",4,41,9224,4587,4637
050,35,001,"New Mexico","Bernalillo County",4,42,9075,4572,4503
050,35,001,"New Mexico","Bernalillo County",4,43,8625,4361,4264
050,35,001,"New Mexico","Bernalillo County",4,44,8290,4157,4133
050,35,001,"New Mexico","Bernalillo County",4,45,8003,3999,4004
050,35,001,"New Mexico","Bernalillo County",4,46,7814,3930,3884
050,35,001,"New Mexico","Bernalillo County",4,47,7860,3945,3915
050,35,001,"New Mexico","Bernalillo County",4,48,7616,3777,3839
050,35,001,"New Mexico","Bernalillo County",4,49,7746,3883,3863
050,35,001,"New Mexico","Bernalillo County",4,50,7778,3811,3967
050,35,001,"New Mexico","Bernalillo County",4,51,8137,3983,4154
050,35,001,"New Mexico","Bernalillo County",4,52,8072,4007,4065
050,35,001,"New Mexico","Bernalillo County",4,53,7916,3931,3985
050,35,001,"New Mexico","Bernalillo County",4,54,7672,3703,3969
050,35,001,"New Mexico","Bernalillo County",4,55,7701,3768,3933
050,35,001,"New Mexico","Bernalillo County",4,56,7884,3827,4057
050,35,001,"New Mexico","Bernalillo County",4,57,8289,4021,4268
050,35,001,"New Mexico","Bernalillo County",4,58,8537,4171,4366
050,35,001,"New Mexico","Bernalillo County",4,59,8625,4175,4450
050,35,001,"New Mexico","Bernalillo County",4,60,8898,4328,4570
050,35,001,"New Mexico","Bernalillo County",4,61,8963,4319,4644
050,35,001,"New Mexico","Bernalillo County",4,62,8814,4201,4613
050,35,001,"New Mexico","Bernalillo County",4,63,8511,4016,4495
050,35,001,"New Mexico","Bernalillo County",4,64,8479,3963,4516
050,35,001,"New Mexico","Bernalillo County",4,65,8464,3893,4571
050,35,001,"New Mexico","Bernalillo County",4,66,8184,3720,4464
050,35,001,"New Mexico","Bernalillo County",4,67,7959,3655,4304
050,35,001,"New Mexico","Bernalillo County",4,68,7815,3525,4290
050,35,001,"New Mexico","Bernalillo County",4,69,7611,3442,4169
050,35,001,"New Mexico","Bernalillo County",4,70,7262,3254,4008
050,35,001,"New Mexico","Bernalillo County",4,71,6898,3123,3775
050,35,001,"New Mexico","Bernalillo County",4,72,6697,3116,3581
050,35,001,"New Mexico","Bernalillo County",4,73,6510,3032,3478
050,35,001,"New Mexico","Bernalillo County",4,74,6298,2853,3445
050,35,001,"New Mexico","Bernalillo County",4,75,6461,2958,3503
050,35,001,"New Mexico","Bernalillo County",4,76,4585,2098,2487
050,35,001,"New Mexico","Bernalillo County",4,77,4285,1931,2354
050,35,001,"New Mexico","Bernalillo County",4,78,4095,1825,2270
050,35,001,"New Mexico","Bernalillo County",4,79,3936,1725,2211
050,35,001,"New Mexico","Bernalillo County",4,80,3357,1442,1915
050,35,001,"New Mexico","Bernalillo County",4,81,2975,1321,1654
050,35,001,"New Mexico","Bernalillo County",4,82,2675,1177,1498
050,35,001,"New Mexico","Bernalillo County",4,83,2490,1035,1455
050,35,001,"New Mexico","Bernalillo County",4,84,2206,882,1324
050,35,001,"New Mexico","Bernalillo County",4,85,12233,4597,7636
050,35,001,"New Mexico","Bernalillo County",5,0,6440,3340,3100
050,35,001,"New Mexico","Bernalillo County",5,1,6348,3293,3055
050,35,001,"New Mexico","Bernalillo County",5,2,6161,3165,2996
050,35,001,"New Mexico","Bernalillo County",5,3,6370,3290,3080
050,35,001,"New Mexico","Bernalillo County",5,4,6645,3348,3297
050,35,001,"New Mexico","Bernalillo County",5,5,6901,3522,3379
050,35,001,"New Mexico","Bernalillo County",5,6,6883,3502,3381
050,35,001,"New Mexico","Bernalillo County",5,7,7262,3696,3566
050,35,001,"New Mexico","Bernalillo County",5,8,7326,3771,3555
050,35,001,"New Mexico","Bernalillo County",5,9,7477,3781,3696
050,35,001,"New Mexico","Bernalillo County",5,10,7584,3904,3680
050,35,001,"New Mexico","Bernalillo County",5,11,7743,4031,3712
050,35,001,"New Mexico","Bernalillo County",5,12,7704,3939,3765
050,35,001,"New Mexico","Bernalillo County",5,13,8081,4131,3950
050,35,001,"New Mexico","Bernalillo County",5,14,8304,4215,4089
050,35,001,"New Mexico","Bernalillo County",5,15,8595,4392,4203
050,35,001,"New Mexico","Bernalillo County",5,16,8665,4456,4209
050,35,001,"New Mexico","Bernalillo County",5,17,8560,4389,4171
050,35,001,"New Mexico","Bernalillo County",5,18,8383,4244,4139
050,35,001,"New Mexico","Bernalillo County",5,19,8341,4179,4162
050,35,001,"New Mexico","Bernalillo County",5,20,8594,4365,4229
050,35,001,"New Mexico","Bernalillo County",5,21,8486,4303,4183
050,35,001,"New Mexico","Bernalillo County",5,22,8728,4454,4274
050,35,001,"New Mexico","Bernalillo County",5,23,8909,4528,4381
050,35,001,"New Mexico","Bernalillo County",5,24,9025,4571,4454
050,35,001,"New Mexico","Bernalillo County",5,25,9111,4655,4456
050,35,001,"New Mexico","Bernalillo County",5,26,9132,4527,4605
050,35,001,"New Mexico","Bernalillo County",5,27,9248,4683,4565
050,35,001,"New Mexico","Bernalillo County",5,28,9489,4840,4649
050,35,001,"New Mexico","Bernalillo County",5,29,9511,4791,4720
050,35,001,"New Mexico","Bernalillo County",5,30,9743,4863,4880
050,35,001,"New Mexico","Bernalillo County",5,31,9982,5197,4785
050,35,001,"New Mexico","Bernalillo County",5,32,9883,4964,4919
050,35,001,"New Mexico","Bernalillo County",5,33,10098,5044,5054
050,35,001,"New Mexico","Bernalillo County",5,34,9760,4916,4844
050,35,001,"New Mexico","Bernalillo County",5,35,9831,5075,4756
050,35,001,"New Mexico","Bernalillo County",5,36,9796,5014,4782
050,35,001,"New Mexico","Bernalillo County",5,37,9614,4964,4650
050,35,001,"New Mexico","Bernalillo County",5,38,9690,4954,4736
050,35,001,"New Mexico","Bernalillo County",5,39,9380,4707,4673
050,35,001,"New Mexico","Bernalillo County",5,40,9599,4806,4793
050,35,001,"New Mexico","Bernalillo County",5,41,9348,4656,4692
050,35,001,"New Mexico","Bernalillo County",5,42,9118,4532,4586
050,35,001,"New Mexico","Bernalillo County",5,43,9035,4535,4500
050,35,001,"New Mexico","Bernalillo County",5,44,8480,4284,4196
050,35,001,"New Mexico","Bernalillo County",5,45,8260,4134,4126
050,35,001,"New Mexico","Bernalillo County",5,46,7919,3947,3972
050,35,001,"New Mexico","Bernalillo County",5,47,7785,3896,3889
050,35,001,"New Mexico","Bernalillo County",5,48,7745,3875,3870
050,35,001,"New Mexico","Bernalillo County",5,49,7604,3786,3818
050,35,001,"New Mexico","Bernalillo County",5,50,7626,3800,3826
050,35,001,"New Mexico","Bernalillo County",5,51,7755,3823,3932
050,35,001,"New Mexico","Bernalillo County",5,52,7995,3909,4086
050,35,001,"New Mexico","Bernalillo County",5,53,8061,4005,4056
050,35,001,"New Mexico","Bernalillo County",5,54,7898,3914,3984
050,35,001,"New Mexico","Bernalillo County",5,55,7651,3697,3954
050,35,001,"New Mexico","Bernalillo County",5,56,7588,3714,3874
050,35,001,"New Mexico","Bernalillo County",5,57,7852,3840,4012
050,35,001,"New Mexico","Bernalillo County",5,58,8175,3928,4247
050,35,001,"New Mexico","Bernalillo County",5,59,8478,4175,4303
050,35,001,"New Mexico","Bernalillo County",5,60,8514,4098,4416
050,35,001,"New Mexico","Bernalillo County",5,61,8762,4278,4484
050,35,001,"New Mexico","Bernalillo County",5,62,8828,4221,4607
050,35,001,"New Mexico","Bernalillo County",5,63,8697,4120,4577
050,35,001,"New Mexico","Bernalillo County",5,64,8391,3928,4463
050,35,001,"New Mexico","Bernalillo County",5,65,8352,3877,4475
050,35,001,"New Mexico","Bernalillo County",5,66,8347,3828,4519
050,35,001,"New Mexico","Bernalillo County",5,67,8057,3617,4440
050,35,001,"New Mexico","Bernalillo County",5,68,7802,3550,4252
050,35,001,"New Mexico","Bernalillo County",5,69,7678,3433,4245
050,35,001,"New Mexico","Bernalillo County",5,70,7478,3362,4116
050,35,001,"New Mexico","Bernalillo County",5,71,7136,3180,3956
050,35,001,"New Mexico","Bernalillo County",5,72,6749,3030,3719
050,35,001,"New Mexico","Bernalillo County",5,73,6555,3021,3534
050,35,001,"New Mexico","Bernalillo County",5,74,6360,2953,3407
050,35,001,"New Mexico","Bernalillo County",5,75,6157,2804,3353
050,35,001,"New Mexico","Bernalillo County",5,76,6315,2886,3429
050,35,001,"New Mexico","Bernalillo County",5,77,4462,2023,2439
050,35,001,"New Mexico","Bernalillo County",5,78,4180,1891,2289
050,35,001,"New Mexico","Bernalillo County",5,79,3880,1735,2145
050,35,001,"New Mexico","Bernalillo County",5,80,3790,1655,2135
050,35,001,"New Mexico","Bernalillo County",5,81,3189,1370,1819
050,35,001,"New Mexico","Bernalillo County",5,82,2843,1251,1592
050,35,001,"New Mexico","Bernalillo County",5,83,2514,1088,1426
050,35,001,"New Mexico","Bernalillo County",5,84,2291,929,1362
050,35,001,"New Mexico","Bernalillo County",5,85,12504,4710,7794
050,35,003,"New Mexico","Catron County",1,0,11,6,5
050,35,003,"New Mexico","Catron County",1,1,14,7,7
050,35,003,"New Mexico","Catron County",1,2,12,5,7
050,35,003,"New Mexico","Catron County",1,3,13,9,4
050,35,003,"New Mexico","Catron County",1,4,22,15,7
050,35,003,"New Mexico","Catron County",1,5,30,20,10
050,35,003,"New Mexico","Catron County",1,6,23,10,13
050,35,003,"New Mexico","Catron County",1,7,20,11,9
050,35,003,"New Mexico","Catron County",1,8,27,15,12
050,35,003,"New Mexico","Catron County",1,9,19,13,6
050,35,003,"New Mexico","Catron County",1,10,26,18,8
050,35,003,"New Mexico","Catron County",1,11,27,13,14
050,35,003,"New Mexico","Catron County",1,12,29,10,19
050,35,003,"New Mexico","Catron County",1,13,30,13,17
050,35,003,"New Mexico","Catron County",1,14,29,14,15
050,35,003,"New Mexico","Catron County",1,15,30,17,13
050,35,003,"New Mexico","Catron County",1,16,29,16,13
050,35,003,"New Mexico","Catron County",1,17,32,13,19
050,35,003,"New Mexico","Catron County",1,18,27,16,11
050,35,003,"New Mexico","Catron County",1,19,18,11,7
050,35,003,"New Mexico","Catron County",1,20,19,10,9
050,35,003,"New Mexico","Catron County",1,21,22,11,11
050,35,003,"New Mexico","Catron County",1,22,26,11,15
050,35,003,"New Mexico","Catron County",1,23,20,10,10
050,35,003,"New Mexico","Catron County",1,24,23,11,12
050,35,003,"New Mexico","Catron County",1,25,26,13,13
050,35,003,"New Mexico","Catron County",1,26,24,15,9
050,35,003,"New Mexico","Catron County",1,27,24,15,9
050,35,003,"New Mexico","Catron County",1,28,21,11,10
050,35,003,"New Mexico","Catron County",1,29,21,11,10
050,35,003,"New Mexico","Catron County",1,30,28,17,11
050,35,003,"New Mexico","Catron County",1,31,17,10,7
050,35,003,"New Mexico","Catron County",1,32,21,12,9
050,35,003,"New Mexico","Catron County",1,33,20,13,7
050,35,003,"New Mexico","Catron County",1,34,16,8,8
050,35,003,"New Mexico","Catron County",1,35,22,11,11
050,35,003,"New Mexico","Catron County",1,36,19,7,12
050,35,003,"New Mexico","Catron County",1,37,18,10,8
050,35,003,"New Mexico","Catron County",1,38,25,15,10
050,35,003,"New Mexico","Catron County",1,39,20,10,10
050,35,003,"New Mexico","Catron County",1,40,27,15,12
050,35,003,"New Mexico","Catron County",1,41,30,17,13
050,35,003,"New Mexico","Catron County",1,42,28,11,17
050,35,003,"New Mexico","Catron County",1,43,31,12,19
050,35,003,"New Mexico","Catron County",1,44,26,17,9
050,35,003,"New Mexico","Catron County",1,45,21,8,13
050,35,003,"New Mexico","Catron County",1,46,23,10,13
050,35,003,"New Mexico","Catron County",1,47,26,18,8
050,35,003,"New Mexico","Catron County",1,48,33,21,12
050,35,003,"New Mexico","Catron County",1,49,36,19,17
050,35,003,"New Mexico","Catron County",1,50,30,15,15
050,35,003,"New Mexico","Catron County",1,51,30,15,15
050,35,003,"New Mexico","Catron County",1,52,23,14,9
050,35,003,"New Mexico","Catron County",1,53,34,23,11
050,35,003,"New Mexico","Catron County",1,54,29,18,11
050,35,003,"New Mexico","Catron County",1,55,42,20,22
050,35,003,"New Mexico","Catron County",1,56,39,19,20
050,35,003,"New Mexico","Catron County",1,57,57,24,33
050,35,003,"New Mexico","Catron County",1,58,80,33,47
050,35,003,"New Mexico","Catron County",1,59,88,39,49
050,35,003,"New Mexico","Catron County",1,60,68,29,39
050,35,003,"New Mexico","Catron County",1,61,64,33,31
050,35,003,"New Mexico","Catron County",1,62,80,39,41
050,35,003,"New Mexico","Catron County",1,63,99,51,48
050,35,003,"New Mexico","Catron County",1,64,82,42,40
050,35,003,"New Mexico","Catron County",1,65,87,40,47
050,35,003,"New Mexico","Catron County",1,66,102,58,44
050,35,003,"New Mexico","Catron County",1,67,98,49,49
050,35,003,"New Mexico","Catron County",1,68,99,45,54
050,35,003,"New Mexico","Catron County",1,69,83,44,39
050,35,003,"New Mexico","Catron County",1,70,109,58,51
050,35,003,"New Mexico","Catron County",1,71,100,55,45
050,35,003,"New Mexico","Catron County",1,72,100,57,43
050,35,003,"New Mexico","Catron County",1,73,88,46,42
050,35,003,"New Mexico","Catron County",1,74,70,40,30
050,35,003,"New Mexico","Catron County",1,75,79,45,34
050,35,003,"New Mexico","Catron County",1,76,70,43,27
050,35,003,"New Mexico","Catron County",1,77,68,39,29
050,35,003,"New Mexico","Catron County",1,78,63,35,28
050,35,003,"New Mexico","Catron County",1,79,45,27,18
050,35,003,"New Mexico","Catron County",1,80,39,20,19
050,35,003,"New Mexico","Catron County",1,81,36,24,12
050,35,003,"New Mexico","Catron County",1,82,41,22,19
050,35,003,"New Mexico","Catron County",1,83,30,20,10
050,35,003,"New Mexico","Catron County",1,84,31,19,12
050,35,003,"New Mexico","Catron County",1,85,113,55,58
050,35,003,"New Mexico","Catron County",2,0,10,6,4
050,35,003,"New Mexico","Catron County",2,1,14,7,7
050,35,003,"New Mexico","Catron County",2,2,13,6,7
050,35,003,"New Mexico","Catron County",2,3,14,9,5
050,35,003,"New Mexico","Catron County",2,4,21,14,7
050,35,003,"New Mexico","Catron County",2,5,29,19,10
050,35,003,"New Mexico","Catron County",2,6,26,14,12
050,35,003,"New Mexico","Catron County",2,7,21,11,10
050,35,003,"New Mexico","Catron County",2,8,27,15,12
050,35,003,"New Mexico","Catron County",2,9,21,14,7
050,35,003,"New Mexico","Catron County",2,10,24,17,7
050,35,003,"New Mexico","Catron County",2,11,27,14,13
050,35,003,"New Mexico","Catron County",2,12,29,11,18
050,35,003,"New Mexico","Catron County",2,13,29,12,17
050,35,003,"New Mexico","Catron County",2,14,30,14,16
050,35,003,"New Mexico","Catron County",2,15,31,17,14
050,35,003,"New Mexico","Catron County",2,16,29,16,13
050,35,003,"New Mexico","Catron County",2,17,30,13,17
050,35,003,"New Mexico","Catron County",2,18,27,15,12
050,35,003,"New Mexico","Catron County",2,19,18,11,7
050,35,003,"New Mexico","Catron County",2,20,19,10,9
050,35,003,"New Mexico","Catron County",2,21,22,11,11
050,35,003,"New Mexico","Catron County",2,22,27,11,16
050,35,003,"New Mexico","Catron County",2,23,20,10,10
050,35,003,"New Mexico","Catron County",2,24,23,11,12
050,35,003,"New Mexico","Catron County",2,25,27,13,14
050,35,003,"New Mexico","Catron County",2,26,26,15,11
050,35,003,"New Mexico","Catron County",2,27,25,15,10
050,35,003,"New Mexico","Catron County",2,28,24,13,11
050,35,003,"New Mexico","Catron County",2,29,21,11,10
050,35,003,"New Mexico","Catron County",2,30,27,16,11
050,35,003,"New Mexico","Catron County",2,31,18,10,8
050,35,003,"New Mexico","Catron County",2,32,20,11,9
050,35,003,"New Mexico","Catron County",2,33,18,11,7
050,35,003,"New Mexico","Catron County",2,34,17,9,8
050,35,003,"New Mexico","Catron County",2,35,20,10,10
050,35,003,"New Mexico","Catron County",2,36,19,7,12
050,35,003,"New Mexico","Catron County",2,37,18,9,9
050,35,003,"New Mexico","Catron County",2,38,24,14,10
050,35,003,"New Mexico","Catron County",2,39,21,11,10
050,35,003,"New Mexico","Catron County",2,40,25,14,11
050,35,003,"New Mexico","Catron County",2,41,31,17,14
050,35,003,"New Mexico","Catron County",2,42,29,12,17
050,35,003,"New Mexico","Catron County",2,43,32,13,19
050,35,003,"New Mexico","Catron County",2,44,26,15,11
050,35,003,"New Mexico","Catron County",2,45,23,10,13
050,35,003,"New Mexico","Catron County",2,46,23,11,12
050,35,003,"New Mexico","Catron County",2,47,26,16,10
050,35,003,"New Mexico","Catron County",2,48,32,21,11
050,35,003,"New Mexico","Catron County",2,49,35,19,16
050,35,003,"New Mexico","Catron County",2,50,33,17,16
050,35,003,"New Mexico","Catron County",2,51,29,14,15
050,35,003,"New Mexico","Catron County",2,52,26,15,11
050,35,003,"New Mexico","Catron County",2,53,32,21,11
050,35,003,"New Mexico","Catron County",2,54,31,20,11
050,35,003,"New Mexico","Catron County",2,55,40,19,21
050,35,003,"New Mexico","Catron County",2,56,42,20,22
050,35,003,"New Mexico","Catron County",2,57,54,23,31
050,35,003,"New Mexico","Catron County",2,58,77,31,46
050,35,003,"New Mexico","Catron County",2,59,87,38,49
050,35,003,"New Mexico","Catron County",2,60,73,32,41
050,35,003,"New Mexico","Catron County",2,61,67,33,34
050,35,003,"New Mexico","Catron County",2,62,78,39,39
050,35,003,"New Mexico","Catron County",2,63,97,50,47
050,35,003,"New Mexico","Catron County",2,64,85,43,42
050,35,003,"New Mexico","Catron County",2,65,89,42,47
050,35,003,"New Mexico","Catron County",2,66,99,54,45
050,35,003,"New Mexico","Catron County",2,67,99,51,48
050,35,003,"New Mexico","Catron County",2,68,97,45,52
050,35,003,"New Mexico","Catron County",2,69,89,45,44
050,35,003,"New Mexico","Catron County",2,70,105,55,50
050,35,003,"New Mexico","Catron County",2,71,102,56,46
050,35,003,"New Mexico","Catron County",2,72,98,56,42
050,35,003,"New Mexico","Catron County",2,73,97,52,45
050,35,003,"New Mexico","Catron County",2,74,69,38,31
050,35,003,"New Mexico","Catron County",2,75,78,46,32
050,35,003,"New Mexico","Catron County",2,76,73,44,29
050,35,003,"New Mexico","Catron County",2,77,69,40,29
050,35,003,"New Mexico","Catron County",2,78,63,35,28
050,35,003,"New Mexico","Catron County",2,79,46,26,20
050,35,003,"New Mexico","Catron County",2,80,39,21,18
050,35,003,"New Mexico","Catron County",2,81,36,22,14
050,35,003,"New Mexico","Catron County",2,82,41,23,18
050,35,003,"New Mexico","Catron County",2,83,32,20,12
050,35,003,"New Mexico","Catron County",2,84,29,19,10
050,35,003,"New Mexico","Catron County",2,85,117,58,59
050,35,003,"New Mexico","Catron County",3,0,14,10,4
050,35,003,"New Mexico","Catron County",3,1,14,9,5
050,35,003,"New Mexico","Catron County",3,2,16,9,7
050,35,003,"New Mexico","Catron County",3,3,14,8,6
050,35,003,"New Mexico","Catron County",3,4,19,9,10
050,35,003,"New Mexico","Catron County",3,5,23,17,6
050,35,003,"New Mexico","Catron County",3,6,31,20,11
050,35,003,"New Mexico","Catron County",3,7,29,16,13
050,35,003,"New Mexico","Catron County",3,8,25,16,9
050,35,003,"New Mexico","Catron County",3,9,24,12,12
050,35,003,"New Mexico","Catron County",3,10,27,17,10
050,35,003,"New Mexico","Catron County",3,11,28,21,7
050,35,003,"New Mexico","Catron County",3,12,23,12,11
050,35,003,"New Mexico","Catron County",3,13,34,12,22
050,35,003,"New Mexico","Catron County",3,14,36,19,17
050,35,003,"New Mexico","Catron County",3,15,37,19,18
050,35,003,"New Mexico","Catron County",3,16,30,17,13
050,35,003,"New Mexico","Catron County",3,17,26,17,9
050,35,003,"New Mexico","Catron County",3,18,28,13,15
050,35,003,"New Mexico","Catron County",3,19,23,12,11
050,35,003,"New Mexico","Catron County",3,20,18,10,8
050,35,003,"New Mexico","Catron County",3,21,22,14,8
050,35,003,"New Mexico","Catron County",3,22,20,9,11
050,35,003,"New Mexico","Catron County",3,23,30,13,17
050,35,003,"New Mexico","Catron County",3,24,19,9,10
050,35,003,"New Mexico","Catron County",3,25,20,7,13
050,35,003,"New Mexico","Catron County",3,26,31,13,18
050,35,003,"New Mexico","Catron County",3,27,22,14,8
050,35,003,"New Mexico","Catron County",3,28,30,18,12
050,35,003,"New Mexico","Catron County",3,29,26,12,14
050,35,003,"New Mexico","Catron County",3,30,24,12,12
050,35,003,"New Mexico","Catron County",3,31,23,14,9
050,35,003,"New Mexico","Catron County",3,32,19,11,8
050,35,003,"New Mexico","Catron County",3,33,24,16,8
050,35,003,"New Mexico","Catron County",3,34,20,11,9
050,35,003,"New Mexico","Catron County",3,35,18,8,10
050,35,003,"New Mexico","Catron County",3,36,22,11,11
050,35,003,"New Mexico","Catron County",3,37,28,12,16
050,35,003,"New Mexico","Catron County",3,38,19,9,10
050,35,003,"New Mexico","Catron County",3,39,26,16,10
050,35,003,"New Mexico","Catron County",3,40,27,13,14
050,35,003,"New Mexico","Catron County",3,41,25,14,11
050,35,003,"New Mexico","Catron County",3,42,33,20,13
050,35,003,"New Mexico","Catron County",3,43,30,11,19
050,35,003,"New Mexico","Catron County",3,44,32,13,19
050,35,003,"New Mexico","Catron County",3,45,29,15,14
050,35,003,"New Mexico","Catron County",3,46,25,12,13
050,35,003,"New Mexico","Catron County",3,47,24,10,14
050,35,003,"New Mexico","Catron County",3,48,29,19,10
050,35,003,"New Mexico","Catron County",3,49,31,20,11
050,35,003,"New Mexico","Catron County",3,50,33,19,14
050,35,003,"New Mexico","Catron County",3,51,38,21,17
050,35,003,"New Mexico","Catron County",3,52,31,14,17
050,35,003,"New Mexico","Catron County",3,53,25,13,12
050,35,003,"New Mexico","Catron County",3,54,36,20,16
050,35,003,"New Mexico","Catron County",3,55,39,22,17
050,35,003,"New Mexico","Catron County",3,56,46,20,26
050,35,003,"New Mexico","Catron County",3,57,41,19,22
050,35,003,"New Mexico","Catron County",3,58,57,26,31
050,35,003,"New Mexico","Catron County",3,59,88,39,49
050,35,003,"New Mexico","Catron County",3,60,93,41,52
050,35,003,"New Mexico","Catron County",3,61,76,30,46
050,35,003,"New Mexico","Catron County",3,62,78,39,39
050,35,003,"New Mexico","Catron County",3,63,80,41,39
050,35,003,"New Mexico","Catron County",3,64,101,52,49
050,35,003,"New Mexico","Catron County",3,65,84,42,42
050,35,003,"New Mexico","Catron County",3,66,95,47,48
050,35,003,"New Mexico","Catron County",3,67,100,55,45
050,35,003,"New Mexico","Catron County",3,68,99,54,45
050,35,003,"New Mexico","Catron County",3,69,96,44,52
050,35,003,"New Mexico","Catron County",3,70,89,45,44
050,35,003,"New Mexico","Catron County",3,71,99,52,47
050,35,003,"New Mexico","Catron County",3,72,101,56,45
050,35,003,"New Mexico","Catron County",3,73,96,53,43
050,35,003,"New Mexico","Catron County",3,74,94,52,42
050,35,003,"New Mexico","Catron County",3,75,65,36,29
050,35,003,"New Mexico","Catron County",3,76,77,46,31
050,35,003,"New Mexico","Catron County",3,77,73,43,30
050,35,003,"New Mexico","Catron County",3,78,68,39,29
050,35,003,"New Mexico","Catron County",3,79,55,31,24
050,35,003,"New Mexico","Catron County",3,80,46,26,20
050,35,003,"New Mexico","Catron County",3,81,37,20,17
050,35,003,"New Mexico","Catron County",3,82,33,19,14
050,35,003,"New Mexico","Catron County",3,83,41,22,19
050,35,003,"New Mexico","Catron County",3,84,24,13,11
050,35,003,"New Mexico","Catron County",3,85,129,68,61
050,35,003,"New Mexico","Catron County",4,0,21,11,10
050,35,003,"New Mexico","Catron County",4,1,16,12,4
050,35,003,"New Mexico","Catron County",4,2,19,11,8
050,35,003,"New Mexico","Catron County",4,3,18,8,10
050,35,003,"New Mexico","Catron County",4,4,17,7,10
050,35,003,"New Mexico","Catron County",4,5,20,9,11
050,35,003,"New Mexico","Catron County",4,6,25,18,7
050,35,003,"New Mexico","Catron County",4,7,29,19,10
050,35,003,"New Mexico","Catron County",4,8,29,16,13
050,35,003,"New Mexico","Catron County",4,9,30,16,14
050,35,003,"New Mexico","Catron County",4,10,28,11,17
050,35,003,"New Mexico","Catron County",4,11,29,17,12
050,35,003,"New Mexico","Catron County",4,12,28,17,11
050,35,003,"New Mexico","Catron County",4,13,24,12,12
050,35,003,"New Mexico","Catron County",4,14,30,12,18
050,35,003,"New Mexico","Catron County",4,15,37,18,19
050,35,003,"New Mexico","Catron County",4,16,34,19,15
050,35,003,"New Mexico","Catron County",4,17,31,19,12
050,35,003,"New Mexico","Catron County",4,18,23,13,10
050,35,003,"New Mexico","Catron County",4,19,22,12,10
050,35,003,"New Mexico","Catron County",4,20,25,11,14
050,35,003,"New Mexico","Catron County",4,21,17,12,5
050,35,003,"New Mexico","Catron County",4,22,28,20,8
050,35,003,"New Mexico","Catron County",4,23,18,7,11
050,35,003,"New Mexico","Catron County",4,24,29,12,17
050,35,003,"New Mexico","Catron County",4,25,18,10,8
050,35,003,"New Mexico","Catron County",4,26,25,8,17
050,35,003,"New Mexico","Catron County",4,27,25,11,14
050,35,003,"New Mexico","Catron County",4,28,27,16,11
050,35,003,"New Mexico","Catron County",4,29,29,16,13
050,35,003,"New Mexico","Catron County",4,30,27,11,16
050,35,003,"New Mexico","Catron County",4,31,21,10,11
050,35,003,"New Mexico","Catron County",4,32,29,17,12
050,35,003,"New Mexico","Catron County",4,33,22,14,8
050,35,003,"New Mexico","Catron County",4,34,22,12,10
050,35,003,"New Mexico","Catron County",4,35,21,13,8
050,35,003,"New Mexico","Catron County",4,36,25,12,13
050,35,003,"New Mexico","Catron County",4,37,21,10,11
050,35,003,"New Mexico","Catron County",4,38,30,12,18
050,35,003,"New Mexico","Catron County",4,39,25,11,14
050,35,003,"New Mexico","Catron County",4,40,25,16,9
050,35,003,"New Mexico","Catron County",4,41,31,14,17
050,35,003,"New Mexico","Catron County",4,42,28,16,12
050,35,003,"New Mexico","Catron County",4,43,31,22,9
050,35,003,"New Mexico","Catron County",4,44,34,14,20
050,35,003,"New Mexico","Catron County",4,45,29,12,17
050,35,003,"New Mexico","Catron County",4,46,33,18,15
050,35,003,"New Mexico","Catron County",4,47,27,15,12
050,35,003,"New Mexico","Catron County",4,48,26,10,16
050,35,003,"New Mexico","Catron County",4,49,31,19,12
050,35,003,"New Mexico","Catron County",4,50,31,21,10
050,35,003,"New Mexico","Catron County",4,51,37,21,16
050,35,003,"New Mexico","Catron County",4,52,40,20,20
050,35,003,"New Mexico","Catron County",4,53,36,16,20
050,35,003,"New Mexico","Catron County",4,54,33,12,21
050,35,003,"New Mexico","Catron County",4,55,52,25,27
050,35,003,"New Mexico","Catron County",4,56,45,26,19
050,35,003,"New Mexico","Catron County",4,57,48,23,25
050,35,003,"New Mexico","Catron County",4,58,48,20,28
050,35,003,"New Mexico","Catron County",4,59,56,28,28
050,35,003,"New Mexico","Catron County",4,60,96,43,53
050,35,003,"New Mexico","Catron County",4,61,100,39,61
050,35,003,"New Mexico","Catron County",4,62,84,38,46
050,35,003,"New Mexico","Catron County",4,63,86,44,42
050,35,003,"New Mexico","Catron County",4,64,88,41,47
050,35,003,"New Mexico","Catron County",4,65,110,58,52
050,35,003,"New Mexico","Catron County",4,66,85,48,37
050,35,003,"New Mexico","Catron County",4,67,95,48,47
050,35,003,"New Mexico","Catron County",4,68,102,59,43
050,35,003,"New Mexico","Catron County",4,69,98,52,46
050,35,003,"New Mexico","Catron County",4,70,97,46,51
050,35,003,"New Mexico","Catron County",4,71,89,44,45
050,35,003,"New Mexico","Catron County",4,72,96,49,47
050,35,003,"New Mexico","Catron County",4,73,89,48,41
050,35,003,"New Mexico","Catron County",4,74,93,51,42
050,35,003,"New Mexico","Catron County",4,75,85,48,37
050,35,003,"New Mexico","Catron County",4,76,60,33,27
050,35,003,"New Mexico","Catron County",4,77,80,48,32
050,35,003,"New Mexico","Catron County",4,78,72,40,32
050,35,003,"New Mexico","Catron County",4,79,64,35,29
050,35,003,"New Mexico","Catron County",4,80,51,29,22
050,35,003,"New Mexico","Catron County",4,81,41,27,14
050,35,003,"New Mexico","Catron County",4,82,31,17,14
050,35,003,"New Mexico","Catron County",4,83,27,17,10
050,35,003,"New Mexico","Catron County",4,84,35,17,18
050,35,003,"New Mexico","Catron County",4,85,124,62,62
050,35,003,"New Mexico","Catron County",5,0,22,11,11
050,35,003,"New Mexico","Catron County",5,1,23,12,11
050,35,003,"New Mexico","Catron County",5,2,16,11,5
050,35,003,"New Mexico","Catron County",5,3,21,13,8
050,35,003,"New Mexico","Catron County",5,4,19,7,12
050,35,003,"New Mexico","Catron County",5,5,17,8,9
050,35,003,"New Mexico","Catron County",5,6,21,13,8
050,35,003,"New Mexico","Catron County",5,7,25,17,8
050,35,003,"New Mexico","Catron County",5,8,23,16,7
050,35,003,"New Mexico","Catron County",5,9,31,16,15
050,35,003,"New Mexico","Catron County",5,10,24,15,9
050,35,003,"New Mexico","Catron County",5,11,31,13,18
050,35,003,"New Mexico","Catron County",5,12,30,18,12
050,35,003,"New Mexico","Catron County",5,13,25,15,10
050,35,003,"New Mexico","Catron County",5,14,24,14,10
050,35,003,"New Mexico","Catron County",5,15,30,9,21
050,35,003,"New Mexico","Catron County",5,16,30,15,15
050,35,003,"New Mexico","Catron County",5,17,27,13,14
050,35,003,"New Mexico","Catron County",5,18,27,17,10
050,35,003,"New Mexico","Catron County",5,19,21,12,9
050,35,003,"New Mexico","Catron County",5,20,19,8,11
050,35,003,"New Mexico","Catron County",5,21,27,14,13
050,35,003,"New Mexico","Catron County",5,22,19,11,8
050,35,003,"New Mexico","Catron County",5,23,32,21,11
050,35,003,"New Mexico","Catron County",5,24,19,8,11
050,35,003,"New Mexico","Catron County",5,25,28,14,14
050,35,003,"New Mexico","Catron County",5,26,19,8,11
050,35,003,"New Mexico","Catron County",5,27,28,11,17
050,35,003,"New Mexico","Catron County",5,28,28,13,15
050,35,003,"New Mexico","Catron County",5,29,27,15,12
050,35,003,"New Mexico","Catron County",5,30,35,19,16
050,35,003,"New Mexico","Catron County",5,31,23,10,13
050,35,003,"New Mexico","Catron County",5,32,26,13,13
050,35,003,"New Mexico","Catron County",5,33,34,19,15
050,35,003,"New Mexico","Catron County",5,34,20,11,9
050,35,003,"New Mexico","Catron County",5,35,29,17,12
050,35,003,"New Mexico","Catron County",5,36,25,14,11
050,35,003,"New Mexico","Catron County",5,37,24,13,11
050,35,003,"New Mexico","Catron County",5,38,17,7,10
050,35,003,"New Mexico","Catron County",5,39,29,10,19
050,35,003,"New Mexico","Catron County",5,40,19,8,11
050,35,003,"New Mexico","Catron County",5,41,25,14,11
050,35,003,"New Mexico","Catron County",5,42,31,15,16
050,35,003,"New Mexico","Catron County",5,43,29,18,11
050,35,003,"New Mexico","Catron County",5,44,34,25,9
050,35,003,"New Mexico","Catron County",5,45,40,16,24
050,35,003,"New Mexico","Catron County",5,46,29,12,17
050,35,003,"New Mexico","Catron County",5,47,31,16,15
050,35,003,"New Mexico","Catron County",5,48,31,18,13
050,35,003,"New Mexico","Catron County",5,49,29,13,16
050,35,003,"New Mexico","Catron County",5,50,34,23,11
050,35,003,"New Mexico","Catron County",5,51,37,25,12
050,35,003,"New Mexico","Catron County",5,52,39,21,18
050,35,003,"New Mexico","Catron County",5,53,38,19,19
050,35,003,"New Mexico","Catron County",5,54,48,18,30
050,35,003,"New Mexico","Catron County",5,55,50,15,35
050,35,003,"New Mexico","Catron County",5,56,55,27,28
050,35,003,"New Mexico","Catron County",5,57,52,28,24
050,35,003,"New Mexico","Catron County",5,58,53,26,27
050,35,003,"New Mexico","Catron County",5,59,50,19,31
050,35,003,"New Mexico","Catron County",5,60,63,32,31
050,35,003,"New Mexico","Catron County",5,61,96,43,53
050,35,003,"New Mexico","Catron County",5,62,105,43,62
050,35,003,"New Mexico","Catron County",5,63,83,40,43
050,35,003,"New Mexico","Catron County",5,64,81,41,40
050,35,003,"New Mexico","Catron County",5,65,90,45,45
050,35,003,"New Mexico","Catron County",5,66,110,57,53
050,35,003,"New Mexico","Catron County",5,67,88,51,37
050,35,003,"New Mexico","Catron County",5,68,99,52,47
050,35,003,"New Mexico","Catron County",5,69,102,57,45
050,35,003,"New Mexico","Catron County",5,70,104,57,47
050,35,003,"New Mexico","Catron County",5,71,95,46,49
050,35,003,"New Mexico","Catron County",5,72,83,43,40
050,35,003,"New Mexico","Catron County",5,73,85,39,46
050,35,003,"New Mexico","Catron County",5,74,85,46,39
050,35,003,"New Mexico","Catron County",5,75,86,46,40
050,35,003,"New Mexico","Catron County",5,76,83,46,37
050,35,003,"New Mexico","Catron County",5,77,61,33,28
050,35,003,"New Mexico","Catron County",5,78,78,46,32
050,35,003,"New Mexico","Catron County",5,79,71,41,30
050,35,003,"New Mexico","Catron County",5,80,60,34,26
050,35,003,"New Mexico","Catron County",5,81,45,25,20
050,35,003,"New Mexico","Catron County",5,82,36,22,14
050,35,003,"New Mexico","Catron County",5,83,30,14,16
050,35,003,"New Mexico","Catron County",5,84,22,14,8
050,35,003,"New Mexico","Catron County",5,85,135,64,71
050,35,005,"New Mexico","Chaves County",1,0,779,402,377
050,35,005,"New Mexico","Chaves County",1,1,810,421,389
050,35,005,"New Mexico","Chaves County",1,2,845,422,423
050,35,005,"New Mexico","Chaves County",1,3,844,443,401
050,35,005,"New Mexico","Chaves County",1,4,864,422,442
050,35,005,"New Mexico","Chaves County",1,5,868,439,429
050,35,005,"New Mexico","Chaves County",1,6,907,470,437
050,35,005,"New Mexico","Chaves County",1,7,934,484,450
050,35,005,"New Mexico","Chaves County",1,8,880,437,443
050,35,005,"New Mexico","Chaves County",1,9,893,455,438
050,35,005,"New Mexico","Chaves County",1,10,964,475,489
050,35,005,"New Mexico","Chaves County",1,11,1014,521,493
050,35,005,"New Mexico","Chaves County",1,12,1036,532,504
050,35,005,"New Mexico","Chaves County",1,13,1033,532,501
050,35,005,"New Mexico","Chaves County",1,14,1005,509,496
050,35,005,"New Mexico","Chaves County",1,15,996,508,488
050,35,005,"New Mexico","Chaves County",1,16,1070,589,481
050,35,005,"New Mexico","Chaves County",1,17,1064,565,499
050,35,005,"New Mexico","Chaves County",1,18,1031,562,469
050,35,005,"New Mexico","Chaves County",1,19,946,537,409
050,35,005,"New Mexico","Chaves County",1,20,926,523,403
050,35,005,"New Mexico","Chaves County",1,21,849,440,409
050,35,005,"New Mexico","Chaves County",1,22,816,460,356
050,35,005,"New Mexico","Chaves County",1,23,786,429,357
050,35,005,"New Mexico","Chaves County",1,24,796,410,386
050,35,005,"New Mexico","Chaves County",1,25,799,406,393
050,35,005,"New Mexico","Chaves County",1,26,826,430,396
050,35,005,"New Mexico","Chaves County",1,27,878,454,424
050,35,005,"New Mexico","Chaves County",1,28,893,470,423
050,35,005,"New Mexico","Chaves County",1,29,894,442,452
050,35,005,"New Mexico","Chaves County",1,30,865,437,428
050,35,005,"New Mexico","Chaves County",1,31,825,449,376
050,35,005,"New Mexico","Chaves County",1,32,822,426,396
050,35,005,"New Mexico","Chaves County",1,33,817,414,403
050,35,005,"New Mexico","Chaves County",1,34,823,408,415
050,35,005,"New Mexico","Chaves County",1,35,827,397,430
050,35,005,"New Mexico","Chaves County",1,36,865,445,420
050,35,005,"New Mexico","Chaves County",1,37,884,452,432
050,35,005,"New Mexico","Chaves County",1,38,888,440,448
050,35,005,"New Mexico","Chaves County",1,39,855,427,428
050,35,005,"New Mexico","Chaves County",1,40,854,441,413
050,35,005,"New Mexico","Chaves County",1,41,828,436,392
050,35,005,"New Mexico","Chaves County",1,42,773,385,388
050,35,005,"New Mexico","Chaves County",1,43,749,356,393
050,35,005,"New Mexico","Chaves County",1,44,712,353,359
050,35,005,"New Mexico","Chaves County",1,45,730,370,360
050,35,005,"New Mexico","Chaves County",1,46,692,324,368
050,35,005,"New Mexico","Chaves County",1,47,677,335,342
050,35,005,"New Mexico","Chaves County",1,48,735,371,364
050,35,005,"New Mexico","Chaves County",1,49,747,397,350
050,35,005,"New Mexico","Chaves County",1,50,682,351,331
050,35,005,"New Mexico","Chaves County",1,51,689,347,342
050,35,005,"New Mexico","Chaves County",1,52,734,368,366
050,35,005,"New Mexico","Chaves County",1,53,709,339,370
050,35,005,"New Mexico","Chaves County",1,54,758,361,397
050,35,005,"New Mexico","Chaves County",1,55,795,385,410
050,35,005,"New Mexico","Chaves County",1,56,794,383,411
050,35,005,"New Mexico","Chaves County",1,57,819,400,419
050,35,005,"New Mexico","Chaves County",1,58,843,412,431
050,35,005,"New Mexico","Chaves County",1,59,807,384,423
050,35,005,"New Mexico","Chaves County",1,60,835,424,411
050,35,005,"New Mexico","Chaves County",1,61,795,401,394
050,35,005,"New Mexico","Chaves County",1,62,782,382,400
050,35,005,"New Mexico","Chaves County",1,63,794,398,396
050,35,005,"New Mexico","Chaves County",1,64,750,365,385
050,35,005,"New Mexico","Chaves County",1,65,721,333,388
050,35,005,"New Mexico","Chaves County",1,66,675,324,351
050,35,005,"New Mexico","Chaves County",1,67,684,341,343
050,35,005,"New Mexico","Chaves County",1,68,683,320,363
050,35,005,"New Mexico","Chaves County",1,69,616,293,323
050,35,005,"New Mexico","Chaves County",1,70,559,276,283
050,35,005,"New Mexico","Chaves County",1,71,565,260,305
050,35,005,"New Mexico","Chaves County",1,72,576,276,300
050,35,005,"New Mexico","Chaves County",1,73,563,271,292
050,35,005,"New Mexico","Chaves County",1,74,412,196,216
050,35,005,"New Mexico","Chaves County",1,75,422,199,223
050,35,005,"New Mexico","Chaves County",1,76,395,179,216
050,35,005,"New Mexico","Chaves County",1,77,354,168,186
050,35,005,"New Mexico","Chaves County",1,78,310,133,177
050,35,005,"New Mexico","Chaves County",1,79,286,131,155
050,35,005,"New Mexico","Chaves County",1,80,269,120,149
050,35,005,"New Mexico","Chaves County",1,81,266,123,143
050,35,005,"New Mexico","Chaves County",1,82,263,117,146
050,35,005,"New Mexico","Chaves County",1,83,243,103,140
050,35,005,"New Mexico","Chaves County",1,84,227,98,129
050,35,005,"New Mexico","Chaves County",1,85,1267,476,791
050,35,005,"New Mexico","Chaves County",2,0,767,412,355
050,35,005,"New Mexico","Chaves County",2,1,810,420,390
050,35,005,"New Mexico","Chaves County",2,2,839,422,417
050,35,005,"New Mexico","Chaves County",2,3,845,438,407
050,35,005,"New Mexico","Chaves County",2,4,864,433,431
050,35,005,"New Mexico","Chaves County",2,5,871,437,434
050,35,005,"New Mexico","Chaves County",2,6,897,461,436
050,35,005,"New Mexico","Chaves County",2,7,924,477,447
050,35,005,"New Mexico","Chaves County",2,8,888,447,441
050,35,005,"New Mexico","Chaves County",2,9,888,449,439
050,35,005,"New Mexico","Chaves County",2,10,948,470,478
050,35,005,"New Mexico","Chaves County",2,11,997,505,492
050,35,005,"New Mexico","Chaves County",2,12,1037,533,504
050,35,005,"New Mexico","Chaves County",2,13,1033,531,502
050,35,005,"New Mexico","Chaves County",2,14,1005,511,494
050,35,005,"New Mexico","Chaves County",2,15,1002,511,491
050,35,005,"New Mexico","Chaves County",2,16,1068,581,487
050,35,005,"New Mexico","Chaves County",2,17,1069,572,497
050,35,005,"New Mexico","Chaves County",2,18,1026,561,465
050,35,005,"New Mexico","Chaves County",2,19,952,539,413
050,35,005,"New Mexico","Chaves County",2,20,934,526,408
050,35,005,"New Mexico","Chaves County",2,21,847,445,402
050,35,005,"New Mexico","Chaves County",2,22,829,462,367
050,35,005,"New Mexico","Chaves County",2,23,786,428,358
050,35,005,"New Mexico","Chaves County",2,24,795,415,380
050,35,005,"New Mexico","Chaves County",2,25,799,412,387
050,35,005,"New Mexico","Chaves County",2,26,820,422,398
050,35,005,"New Mexico","Chaves County",2,27,867,449,418
050,35,005,"New Mexico","Chaves County",2,28,893,470,423
050,35,005,"New Mexico","Chaves County",2,29,901,454,447
050,35,005,"New Mexico","Chaves County",2,30,880,441,439
050,35,005,"New Mexico","Chaves County",2,31,839,448,391
050,35,005,"New Mexico","Chaves County",2,32,823,430,393
050,35,005,"New Mexico","Chaves County",2,33,819,417,402
050,35,005,"New Mexico","Chaves County",2,34,827,412,415
050,35,005,"New Mexico","Chaves County",2,35,833,401,432
050,35,005,"New Mexico","Chaves County",2,36,859,438,421
050,35,005,"New Mexico","Chaves County",2,37,876,448,428
050,35,005,"New Mexico","Chaves County",2,38,888,442,446
050,35,005,"New Mexico","Chaves County",2,39,857,429,428
050,35,005,"New Mexico","Chaves County",2,40,859,440,419
050,35,005,"New Mexico","Chaves County",2,41,832,435,397
050,35,005,"New Mexico","Chaves County",2,42,789,394,395
050,35,005,"New Mexico","Chaves County",2,43,763,368,395
050,35,005,"New Mexico","Chaves County",2,44,721,355,366
050,35,005,"New Mexico","Chaves County",2,45,725,362,363
050,35,005,"New Mexico","Chaves County",2,46,696,336,360
050,35,005,"New Mexico","Chaves County",2,47,678,329,349
050,35,005,"New Mexico","Chaves County",2,48,721,363,358
050,35,005,"New Mexico","Chaves County",2,49,745,391,354
050,35,005,"New Mexico","Chaves County",2,50,694,361,333
050,35,005,"New Mexico","Chaves County",2,51,680,343,337
050,35,005,"New Mexico","Chaves County",2,52,721,363,358
050,35,005,"New Mexico","Chaves County",2,53,710,343,367
050,35,005,"New Mexico","Chaves County",2,54,740,353,387
050,35,005,"New Mexico","Chaves County",2,55,782,378,404
050,35,005,"New Mexico","Chaves County",2,56,795,384,411
050,35,005,"New Mexico","Chaves County",2,57,818,401,417
050,35,005,"New Mexico","Chaves County",2,58,838,412,426
050,35,005,"New Mexico","Chaves County",2,59,817,390,427
050,35,005,"New Mexico","Chaves County",2,60,828,417,411
050,35,005,"New Mexico","Chaves County",2,61,805,406,399
050,35,005,"New Mexico","Chaves County",2,62,778,382,396
050,35,005,"New Mexico","Chaves County",2,63,791,393,398
050,35,005,"New Mexico","Chaves County",2,64,752,368,384
050,35,005,"New Mexico","Chaves County",2,65,723,337,386
050,35,005,"New Mexico","Chaves County",2,66,687,326,361
050,35,005,"New Mexico","Chaves County",2,67,679,335,344
050,35,005,"New Mexico","Chaves County",2,68,677,322,355
050,35,005,"New Mexico","Chaves County",2,69,632,300,332
050,35,005,"New Mexico","Chaves County",2,70,569,279,290
050,35,005,"New Mexico","Chaves County",2,71,560,260,300
050,35,005,"New Mexico","Chaves County",2,72,556,264,292
050,35,005,"New Mexico","Chaves County",2,73,578,276,302
050,35,005,"New Mexico","Chaves County",2,74,420,201,219
050,35,005,"New Mexico","Chaves County",2,75,414,198,216
050,35,005,"New Mexico","Chaves County",2,76,397,180,217
050,35,005,"New Mexico","Chaves County",2,77,360,170,190
050,35,005,"New Mexico","Chaves County",2,78,309,137,172
050,35,005,"New Mexico","Chaves County",2,79,288,130,158
050,35,005,"New Mexico","Chaves County",2,80,270,120,150
050,35,005,"New Mexico","Chaves County",2,81,258,117,141
050,35,005,"New Mexico","Chaves County",2,82,260,117,143
050,35,005,"New Mexico","Chaves County",2,83,241,104,137
050,35,005,"New Mexico","Chaves County",2,84,222,98,124
050,35,005,"New Mexico","Chaves County",2,85,1269,476,793
050,35,005,"New Mexico","Chaves County",3,0,775,374,401
050,35,005,"New Mexico","Chaves County",3,1,744,393,351
050,35,005,"New Mexico","Chaves County",3,2,804,413,391
050,35,005,"New Mexico","Chaves County",3,3,831,422,409
050,35,005,"New Mexico","Chaves County",3,4,822,429,393
050,35,005,"New Mexico","Chaves County",3,5,866,433,433
050,35,005,"New Mexico","Chaves County",3,6,864,442,422
050,35,005,"New Mexico","Chaves County",3,7,886,462,424
050,35,005,"New Mexico","Chaves County",3,8,913,474,439
050,35,005,"New Mexico","Chaves County",3,9,873,435,438
050,35,005,"New Mexico","Chaves County",3,10,898,444,454
050,35,005,"New Mexico","Chaves County",3,11,954,470,484
050,35,005,"New Mexico","Chaves County",3,12,1009,513,496
050,35,005,"New Mexico","Chaves County",3,13,1008,517,491
050,35,005,"New Mexico","Chaves County",3,14,1019,524,495
050,35,005,"New Mexico","Chaves County",3,15,999,502,497
050,35,005,"New Mexico","Chaves County",3,16,1066,553,513
050,35,005,"New Mexico","Chaves County",3,17,1082,592,490
050,35,005,"New Mexico","Chaves County",3,18,1036,565,471
050,35,005,"New Mexico","Chaves County",3,19,946,535,411
050,35,005,"New Mexico","Chaves County",3,20,940,520,420
050,35,005,"New Mexico","Chaves County",3,21,856,464,392
050,35,005,"New Mexico","Chaves County",3,22,851,461,390
050,35,005,"New Mexico","Chaves County",3,23,793,431,362
050,35,005,"New Mexico","Chaves County",3,24,788,423,365
050,35,005,"New Mexico","Chaves County",3,25,752,392,360
050,35,005,"New Mexico","Chaves County",3,26,801,408,393
050,35,005,"New Mexico","Chaves County",3,27,819,419,400
050,35,005,"New Mexico","Chaves County",3,28,849,451,398
050,35,005,"New Mexico","Chaves County",3,29,908,472,436
050,35,005,"New Mexico","Chaves County",3,30,894,448,446
050,35,005,"New Mexico","Chaves County",3,31,909,462,447
050,35,005,"New Mexico","Chaves County",3,32,823,425,398
050,35,005,"New Mexico","Chaves County",3,33,834,431,403
050,35,005,"New Mexico","Chaves County",3,34,820,421,399
050,35,005,"New Mexico","Chaves County",3,35,796,399,397
050,35,005,"New Mexico","Chaves County",3,36,833,411,422
050,35,005,"New Mexico","Chaves County",3,37,857,426,431
050,35,005,"New Mexico","Chaves County",3,38,883,455,428
050,35,005,"New Mexico","Chaves County",3,39,888,451,437
050,35,005,"New Mexico","Chaves County",3,40,858,435,423
050,35,005,"New Mexico","Chaves County",3,41,863,446,417
050,35,005,"New Mexico","Chaves County",3,42,796,404,392
050,35,005,"New Mexico","Chaves County",3,43,779,390,389
050,35,005,"New Mexico","Chaves County",3,44,772,380,392
050,35,005,"New Mexico","Chaves County",3,45,723,350,373
050,35,005,"New Mexico","Chaves County",3,46,705,357,348
050,35,005,"New Mexico","Chaves County",3,47,674,327,347
050,35,005,"New Mexico","Chaves County",3,48,661,320,341
050,35,005,"New Mexico","Chaves County",3,49,704,357,347
050,35,005,"New Mexico","Chaves County",3,50,726,379,347
050,35,005,"New Mexico","Chaves County",3,51,687,347,340
050,35,005,"New Mexico","Chaves County",3,52,685,354,331
050,35,005,"New Mexico","Chaves County",3,53,712,352,360
050,35,005,"New Mexico","Chaves County",3,54,692,332,360
050,35,005,"New Mexico","Chaves County",3,55,723,354,369
050,35,005,"New Mexico","Chaves County",3,56,768,368,400
050,35,005,"New Mexico","Chaves County",3,57,803,393,410
050,35,005,"New Mexico","Chaves County",3,58,790,377,413
050,35,005,"New Mexico","Chaves County",3,59,828,404,424
050,35,005,"New Mexico","Chaves County",3,60,799,383,416
050,35,005,"New Mexico","Chaves County",3,61,827,409,418
050,35,005,"New Mexico","Chaves County",3,62,803,406,397
050,35,005,"New Mexico","Chaves County",3,63,763,369,394
050,35,005,"New Mexico","Chaves County",3,64,773,383,390
050,35,005,"New Mexico","Chaves County",3,65,729,366,363
050,35,005,"New Mexico","Chaves County",3,66,708,326,382
050,35,005,"New Mexico","Chaves County",3,67,665,310,355
050,35,005,"New Mexico","Chaves County",3,68,651,323,328
050,35,005,"New Mexico","Chaves County",3,69,648,308,340
050,35,005,"New Mexico","Chaves County",3,70,602,281,321
050,35,005,"New Mexico","Chaves County",3,71,549,269,280
050,35,005,"New Mexico","Chaves County",3,72,542,246,296
050,35,005,"New Mexico","Chaves County",3,73,529,247,282
050,35,005,"New Mexico","Chaves County",3,74,552,265,287
050,35,005,"New Mexico","Chaves County",3,75,402,188,214
050,35,005,"New Mexico","Chaves County",3,76,398,192,206
050,35,005,"New Mexico","Chaves County",3,77,374,169,205
050,35,005,"New Mexico","Chaves County",3,78,339,160,179
050,35,005,"New Mexico","Chaves County",3,79,290,129,161
050,35,005,"New Mexico","Chaves County",3,80,276,124,152
050,35,005,"New Mexico","Chaves County",3,81,247,110,137
050,35,005,"New Mexico","Chaves County",3,82,251,110,141
050,35,005,"New Mexico","Chaves County",3,83,247,107,140
050,35,005,"New Mexico","Chaves County",3,84,205,91,114
050,35,005,"New Mexico","Chaves County",3,85,1243,480,763
050,35,005,"New Mexico","Chaves County",4,0,733,363,370
050,35,005,"New Mexico","Chaves County",4,1,752,344,408
050,35,005,"New Mexico","Chaves County",4,2,728,378,350
050,35,005,"New Mexico","Chaves County",4,3,797,409,388
050,35,005,"New Mexico","Chaves County",4,4,836,425,411
050,35,005,"New Mexico","Chaves County",4,5,818,421,397
050,35,005,"New Mexico","Chaves County",4,6,848,425,423
050,35,005,"New Mexico","Chaves County",4,7,855,433,422
050,35,005,"New Mexico","Chaves County",4,8,863,450,413
050,35,005,"New Mexico","Chaves County",4,9,909,478,431
050,35,005,"New Mexico","Chaves County",4,10,872,445,427
050,35,005,"New Mexico","Chaves County",4,11,898,447,451
050,35,005,"New Mexico","Chaves County",4,12,929,456,473
050,35,005,"New Mexico","Chaves County",4,13,982,498,484
050,35,005,"New Mexico","Chaves County",4,14,1003,521,482
050,35,005,"New Mexico","Chaves County",4,15,1031,522,509
050,35,005,"New Mexico","Chaves County",4,16,1068,565,503
050,35,005,"New Mexico","Chaves County",4,17,1073,550,523
050,35,005,"New Mexico","Chaves County",4,18,1053,589,464
050,35,005,"New Mexico","Chaves County",4,19,972,560,412
050,35,005,"New Mexico","Chaves County",4,20,922,505,417
050,35,005,"New Mexico","Chaves County",4,21,845,452,393
050,35,005,"New Mexico","Chaves County",4,22,840,479,361
050,35,005,"New Mexico","Chaves County",4,23,811,436,375
050,35,005,"New Mexico","Chaves County",4,24,786,415,371
050,35,005,"New Mexico","Chaves County",4,25,801,417,384
050,35,005,"New Mexico","Chaves County",4,26,744,378,366
050,35,005,"New Mexico","Chaves County",4,27,807,410,397
050,35,005,"New Mexico","Chaves County",4,28,806,418,388
050,35,005,"New Mexico","Chaves County",4,29,813,437,376
050,35,005,"New Mexico","Chaves County",4,30,895,459,436
050,35,005,"New Mexico","Chaves County",4,31,912,483,429
050,35,005,"New Mexico","Chaves County",4,32,852,427,425
050,35,005,"New Mexico","Chaves County",4,33,827,419,408
050,35,005,"New Mexico","Chaves County",4,34,822,430,392
050,35,005,"New Mexico","Chaves County",4,35,793,393,400
050,35,005,"New Mexico","Chaves County",4,36,799,418,381
050,35,005,"New Mexico","Chaves County",4,37,819,402,417
050,35,005,"New Mexico","Chaves County",4,38,855,426,429
050,35,005,"New Mexico","Chaves County",4,39,858,452,406
050,35,005,"New Mexico","Chaves County",4,40,894,447,447
050,35,005,"New Mexico","Chaves County",4,41,862,443,419
050,35,005,"New Mexico","Chaves County",4,42,846,427,419
050,35,005,"New Mexico","Chaves County",4,43,803,406,397
050,35,005,"New Mexico","Chaves County",4,44,784,393,391
050,35,005,"New Mexico","Chaves County",4,45,763,364,399
050,35,005,"New Mexico","Chaves County",4,46,679,331,348
050,35,005,"New Mexico","Chaves County",4,47,682,342,340
050,35,005,"New Mexico","Chaves County",4,48,677,329,348
050,35,005,"New Mexico","Chaves County",4,49,654,324,330
050,35,005,"New Mexico","Chaves County",4,50,694,357,337
050,35,005,"New Mexico","Chaves County",4,51,699,353,346
050,35,005,"New Mexico","Chaves County",4,52,698,357,341
050,35,005,"New Mexico","Chaves County",4,53,665,342,323
050,35,005,"New Mexico","Chaves County",4,54,703,345,358
050,35,005,"New Mexico","Chaves County",4,55,681,336,345
050,35,005,"New Mexico","Chaves County",4,56,719,345,374
050,35,005,"New Mexico","Chaves County",4,57,760,362,398
050,35,005,"New Mexico","Chaves County",4,58,781,371,410
050,35,005,"New Mexico","Chaves County",4,59,771,361,410
050,35,005,"New Mexico","Chaves County",4,60,789,386,403
050,35,005,"New Mexico","Chaves County",4,61,775,363,412
050,35,005,"New Mexico","Chaves County",4,62,816,408,408
050,35,005,"New Mexico","Chaves County",4,63,775,387,388
050,35,005,"New Mexico","Chaves County",4,64,736,353,383
050,35,005,"New Mexico","Chaves County",4,65,750,373,377
050,35,005,"New Mexico","Chaves County",4,66,720,361,359
050,35,005,"New Mexico","Chaves County",4,67,691,318,373
050,35,005,"New Mexico","Chaves County",4,68,641,290,351
050,35,005,"New Mexico","Chaves County",4,69,634,320,314
050,35,005,"New Mexico","Chaves County",4,70,620,292,328
050,35,005,"New Mexico","Chaves County",4,71,581,272,309
050,35,005,"New Mexico","Chaves County",4,72,521,255,266
050,35,005,"New Mexico","Chaves County",4,73,523,239,284
050,35,005,"New Mexico","Chaves County",4,74,495,223,272
050,35,005,"New Mexico","Chaves County",4,75,522,249,273
050,35,005,"New Mexico","Chaves County",4,76,388,182,206
050,35,005,"New Mexico","Chaves County",4,77,371,177,194
050,35,005,"New Mexico","Chaves County",4,78,348,156,192
050,35,005,"New Mexico","Chaves County",4,79,321,153,168
050,35,005,"New Mexico","Chaves County",4,80,273,119,154
050,35,005,"New Mexico","Chaves County",4,81,245,105,140
050,35,005,"New Mexico","Chaves County",4,82,236,102,134
050,35,005,"New Mexico","Chaves County",4,83,236,98,138
050,35,005,"New Mexico","Chaves County",4,84,230,107,123
050,35,005,"New Mexico","Chaves County",4,85,1213,482,731
050,35,005,"New Mexico","Chaves County",5,0,728,365,363
050,35,005,"New Mexico","Chaves County",5,1,710,346,364
050,35,005,"New Mexico","Chaves County",5,2,749,338,411
050,35,005,"New Mexico","Chaves County",5,3,710,369,341
050,35,005,"New Mexico","Chaves County",5,4,779,396,383
050,35,005,"New Mexico","Chaves County",5,5,823,420,403
050,35,005,"New Mexico","Chaves County",5,6,809,416,393
050,35,005,"New Mexico","Chaves County",5,7,844,419,425
050,35,005,"New Mexico","Chaves County",5,8,849,430,419
050,35,005,"New Mexico","Chaves County",5,9,875,466,409
050,35,005,"New Mexico","Chaves County",5,10,864,450,414
050,35,005,"New Mexico","Chaves County",5,11,872,441,431
050,35,005,"New Mexico","Chaves County",5,12,873,435,438
050,35,005,"New Mexico","Chaves County",5,13,917,456,461
050,35,005,"New Mexico","Chaves County",5,14,990,501,489
050,35,005,"New Mexico","Chaves County",5,15,1025,525,500
050,35,005,"New Mexico","Chaves County",5,16,1102,582,520
050,35,005,"New Mexico","Chaves County",5,17,1112,589,523
050,35,005,"New Mexico","Chaves County",5,18,1048,562,486
050,35,005,"New Mexico","Chaves County",5,19,984,573,411
050,35,005,"New Mexico","Chaves County",5,20,955,540,415
050,35,005,"New Mexico","Chaves County",5,21,850,444,406
050,35,005,"New Mexico","Chaves County",5,22,873,477,396
050,35,005,"New Mexico","Chaves County",5,23,808,454,354
050,35,005,"New Mexico","Chaves County",5,24,806,433,373
050,35,005,"New Mexico","Chaves County",5,25,788,410,378
050,35,005,"New Mexico","Chaves County",5,26,809,416,393
050,35,005,"New Mexico","Chaves County",5,27,726,369,357
050,35,005,"New Mexico","Chaves County",5,28,785,403,382
050,35,005,"New Mexico","Chaves County",5,29,785,408,377
050,35,005,"New Mexico","Chaves County",5,30,804,428,376
050,35,005,"New Mexico","Chaves County",5,31,933,500,433
050,35,005,"New Mexico","Chaves County",5,32,903,454,449
050,35,005,"New Mexico","Chaves County",5,33,857,437,420
050,35,005,"New Mexico","Chaves County",5,34,821,409,412
050,35,005,"New Mexico","Chaves County",5,35,792,411,381
050,35,005,"New Mexico","Chaves County",5,36,801,400,401
050,35,005,"New Mexico","Chaves County",5,37,808,419,389
050,35,005,"New Mexico","Chaves County",5,38,826,407,419
050,35,005,"New Mexico","Chaves County",5,39,876,439,437
050,35,005,"New Mexico","Chaves County",5,40,851,435,416
050,35,005,"New Mexico","Chaves County",5,41,898,451,447
050,35,005,"New Mexico","Chaves County",5,42,833,420,413
050,35,005,"New Mexico","Chaves County",5,43,812,409,403
050,35,005,"New Mexico","Chaves County",5,44,807,404,403
050,35,005,"New Mexico","Chaves County",5,45,777,375,402
050,35,005,"New Mexico","Chaves County",5,46,743,353,390
050,35,005,"New Mexico","Chaves County",5,47,648,302,346
050,35,005,"New Mexico","Chaves County",5,48,673,334,339
050,35,005,"New Mexico","Chaves County",5,49,677,329,348
050,35,005,"New Mexico","Chaves County",5,50,652,325,327
050,35,005,"New Mexico","Chaves County",5,51,696,354,342
050,35,005,"New Mexico","Chaves County",5,52,706,353,353
050,35,005,"New Mexico","Chaves County",5,53,678,346,332
050,35,005,"New Mexico","Chaves County",5,54,650,339,311
050,35,005,"New Mexico","Chaves County",5,55,714,359,355
050,35,005,"New Mexico","Chaves County",5,56,664,326,338
050,35,005,"New Mexico","Chaves County",5,57,703,333,370
050,35,005,"New Mexico","Chaves County",5,58,737,350,387
050,35,005,"New Mexico","Chaves County",5,59,760,354,406
050,35,005,"New Mexico","Chaves County",5,60,775,365,410
050,35,005,"New Mexico","Chaves County",5,61,783,375,408
050,35,005,"New Mexico","Chaves County",5,62,772,365,407
050,35,005,"New Mexico","Chaves County",5,63,798,399,399
050,35,005,"New Mexico","Chaves County",5,64,757,378,379
050,35,005,"New Mexico","Chaves County",5,65,709,339,370
050,35,005,"New Mexico","Chaves County",5,66,757,374,383
050,35,005,"New Mexico","Chaves County",5,67,707,353,354
050,35,005,"New Mexico","Chaves County",5,68,669,301,368
050,35,005,"New Mexico","Chaves County",5,69,634,286,348
050,35,005,"New Mexico","Chaves County",5,70,611,306,305
050,35,005,"New Mexico","Chaves County",5,71,601,283,318
050,35,005,"New Mexico","Chaves County",5,72,564,266,298
050,35,005,"New Mexico","Chaves County",5,73,500,240,260
050,35,005,"New Mexico","Chaves County",5,74,504,226,278
050,35,005,"New Mexico","Chaves County",5,75,482,216,266
050,35,005,"New Mexico","Chaves County",5,76,497,231,266
050,35,005,"New Mexico","Chaves County",5,77,368,171,197
050,35,005,"New Mexico","Chaves County",5,78,353,169,184
050,35,005,"New Mexico","Chaves County",5,79,325,148,177
050,35,005,"New Mexico","Chaves County",5,80,303,142,161
050,35,005,"New Mexico","Chaves County",5,81,250,106,144
050,35,005,"New Mexico","Chaves County",5,82,230,98,132
050,35,005,"New Mexico","Chaves County",5,83,222,89,133
050,35,005,"New Mexico","Chaves County",5,84,212,91,121
050,35,005,"New Mexico","Chaves County",5,85,1230,500,730
050,35,006,"New Mexico","Cibola County",1,0,318,160,158
050,35,006,"New Mexico","Cibola County",1,1,282,145,137
050,35,006,"New Mexico","Cibola County",1,2,250,154,96
050,35,006,"New Mexico","Cibola County",1,3,313,167,146
050,35,006,"New Mexico","Cibola County",1,4,343,174,169
050,35,006,"New Mexico","Cibola County",1,5,366,175,191
050,35,006,"New Mexico","Cibola County",1,6,390,194,196
050,35,006,"New Mexico","Cibola County",1,7,395,193,202
050,35,006,"New Mexico","Cibola County",1,8,354,177,177
050,35,006,"New Mexico","Cibola County",1,9,389,196,193
050,35,006,"New Mexico","Cibola County",1,10,378,183,195
050,35,006,"New Mexico","Cibola County",1,11,384,200,184
050,35,006,"New Mexico","Cibola County",1,12,397,187,210
050,35,006,"New Mexico","Cibola County",1,13,408,216,192
050,35,006,"New Mexico","Cibola County",1,14,345,163,182
050,35,006,"New Mexico","Cibola County",1,15,365,176,189
050,35,006,"New Mexico","Cibola County",1,16,373,189,184
050,35,006,"New Mexico","Cibola County",1,17,353,183,170
050,35,006,"New Mexico","Cibola County",1,18,344,172,172
050,35,006,"New Mexico","Cibola County",1,19,291,145,146
050,35,006,"New Mexico","Cibola County",1,20,330,163,167
050,35,006,"New Mexico","Cibola County",1,21,338,166,172
050,35,006,"New Mexico","Cibola County",1,22,341,167,174
050,35,006,"New Mexico","Cibola County",1,23,326,185,141
050,35,006,"New Mexico","Cibola County",1,24,352,194,158
050,35,006,"New Mexico","Cibola County",1,25,356,186,170
050,35,006,"New Mexico","Cibola County",1,26,357,197,160
050,35,006,"New Mexico","Cibola County",1,27,380,204,176
050,35,006,"New Mexico","Cibola County",1,28,399,223,176
050,35,006,"New Mexico","Cibola County",1,29,410,210,200
050,35,006,"New Mexico","Cibola County",1,30,396,213,183
050,35,006,"New Mexico","Cibola County",1,31,400,200,200
050,35,006,"New Mexico","Cibola County",1,32,394,211,183
050,35,006,"New Mexico","Cibola County",1,33,338,177,161
050,35,006,"New Mexico","Cibola County",1,34,341,188,153
050,35,006,"New Mexico","Cibola County",1,35,344,190,154
050,35,006,"New Mexico","Cibola County",1,36,337,193,144
050,35,006,"New Mexico","Cibola County",1,37,350,200,150
050,35,006,"New Mexico","Cibola County",1,38,340,188,152
050,35,006,"New Mexico","Cibola County",1,39,388,199,189
050,35,006,"New Mexico","Cibola County",1,40,352,184,168
050,35,006,"New Mexico","Cibola County",1,41,341,191,150
050,35,006,"New Mexico","Cibola County",1,42,355,198,157
050,35,006,"New Mexico","Cibola County",1,43,347,208,139
050,35,006,"New Mexico","Cibola County",1,44,318,167,151
050,35,006,"New Mexico","Cibola County",1,45,282,136,146
050,35,006,"New Mexico","Cibola County",1,46,285,156,129
050,35,006,"New Mexico","Cibola County",1,47,285,159,126
050,35,006,"New Mexico","Cibola County",1,48,313,176,137
050,35,006,"New Mexico","Cibola County",1,49,319,187,132
050,35,006,"New Mexico","Cibola County",1,50,298,149,149
050,35,006,"New Mexico","Cibola County",1,51,323,165,158
050,35,006,"New Mexico","Cibola County",1,52,324,164,160
050,35,006,"New Mexico","Cibola County",1,53,295,153,142
050,35,006,"New Mexico","Cibola County",1,54,273,139,134
050,35,006,"New Mexico","Cibola County",1,55,321,146,175
050,35,006,"New Mexico","Cibola County",1,56,303,149,154
050,35,006,"New Mexico","Cibola County",1,57,328,163,165
050,35,006,"New Mexico","Cibola County",1,58,384,199,185
050,35,006,"New Mexico","Cibola County",1,59,357,177,180
050,35,006,"New Mexico","Cibola County",1,60,356,168,188
050,35,006,"New Mexico","Cibola County",1,61,364,169,195
050,35,006,"New Mexico","Cibola County",1,62,391,200,191
050,35,006,"New Mexico","Cibola County",1,63,379,177,202
050,35,006,"New Mexico","Cibola County",1,64,356,171,185
050,35,006,"New Mexico","Cibola County",1,65,371,177,194
050,35,006,"New Mexico","Cibola County",1,66,338,176,162
050,35,006,"New Mexico","Cibola County",1,67,315,159,156
050,35,006,"New Mexico","Cibola County",1,68,298,136,162
050,35,006,"New Mexico","Cibola County",1,69,285,129,156
050,35,006,"New Mexico","Cibola County",1,70,273,136,137
050,35,006,"New Mexico","Cibola County",1,71,246,115,131
050,35,006,"New Mexico","Cibola County",1,72,244,110,134
050,35,006,"New Mexico","Cibola County",1,73,253,109,144
050,35,006,"New Mexico","Cibola County",1,74,189,84,105
050,35,006,"New Mexico","Cibola County",1,75,177,92,85
050,35,006,"New Mexico","Cibola County",1,76,163,76,87
050,35,006,"New Mexico","Cibola County",1,77,172,77,95
050,35,006,"New Mexico","Cibola County",1,78,148,68,80
050,35,006,"New Mexico","Cibola County",1,79,132,56,76
050,35,006,"New Mexico","Cibola County",1,80,127,47,80
050,35,006,"New Mexico","Cibola County",1,81,106,47,59
050,35,006,"New Mexico","Cibola County",1,82,101,37,64
050,35,006,"New Mexico","Cibola County",1,83,106,37,69
050,35,006,"New Mexico","Cibola County",1,84,115,42,73
050,35,006,"New Mexico","Cibola County",1,85,512,223,289
050,35,006,"New Mexico","Cibola County",2,0,316,166,150
050,35,006,"New Mexico","Cibola County",2,1,290,149,141
050,35,006,"New Mexico","Cibola County",2,2,253,149,104
050,35,006,"New Mexico","Cibola County",2,3,297,162,135
050,35,006,"New Mexico","Cibola County",2,4,332,169,163
050,35,006,"New Mexico","Cibola County",2,5,360,174,186
050,35,006,"New Mexico","Cibola County",2,6,383,188,195
050,35,006,"New Mexico","Cibola County",2,7,391,191,200
050,35,006,"New Mexico","Cibola County",2,8,359,178,181
050,35,006,"New Mexico","Cibola County",2,9,377,189,188
050,35,006,"New Mexico","Cibola County",2,10,380,185,195
050,35,006,"New Mexico","Cibola County",2,11,379,192,187
050,35,006,"New Mexico","Cibola County",2,12,395,191,204
050,35,006,"New Mexico","Cibola County",2,13,407,208,199
050,35,006,"New Mexico","Cibola County",2,14,356,175,181
050,35,006,"New Mexico","Cibola County",2,15,362,173,189
050,35,006,"New Mexico","Cibola County",2,16,371,187,184
050,35,006,"New Mexico","Cibola County",2,17,357,185,172
050,35,006,"New Mexico","Cibola County",2,18,340,169,171
050,35,006,"New Mexico","Cibola County",2,19,291,146,145
050,35,006,"New Mexico","Cibola County",2,20,325,161,164
050,35,006,"New Mexico","Cibola County",2,21,340,165,175
050,35,006,"New Mexico","Cibola County",2,22,341,166,175
050,35,006,"New Mexico","Cibola County",2,23,327,186,141
050,35,006,"New Mexico","Cibola County",2,24,341,188,153
050,35,006,"New Mexico","Cibola County",2,25,356,188,168
050,35,006,"New Mexico","Cibola County",2,26,356,197,159
050,35,006,"New Mexico","Cibola County",2,27,376,206,170
050,35,006,"New Mexico","Cibola County",2,28,395,220,175
050,35,006,"New Mexico","Cibola County",2,29,411,214,197
050,35,006,"New Mexico","Cibola County",2,30,395,213,182
050,35,006,"New Mexico","Cibola County",2,31,402,197,205
050,35,006,"New Mexico","Cibola County",2,32,393,210,183
050,35,006,"New Mexico","Cibola County",2,33,344,183,161
050,35,006,"New Mexico","Cibola County",2,34,336,189,147
050,35,006,"New Mexico","Cibola County",2,35,348,188,160
050,35,006,"New Mexico","Cibola County",2,36,336,194,142
050,35,006,"New Mexico","Cibola County",2,37,351,201,150
050,35,006,"New Mexico","Cibola County",2,38,335,190,145
050,35,006,"New Mexico","Cibola County",2,39,376,193,183
050,35,006,"New Mexico","Cibola County",2,40,359,186,173
050,35,006,"New Mexico","Cibola County",2,41,344,191,153
050,35,006,"New Mexico","Cibola County",2,42,349,194,155
050,35,006,"New Mexico","Cibola County",2,43,352,209,143
050,35,006,"New Mexico","Cibola County",2,44,322,174,148
050,35,006,"New Mexico","Cibola County",2,45,289,144,145
050,35,006,"New Mexico","Cibola County",2,46,285,151,134
050,35,006,"New Mexico","Cibola County",2,47,283,156,127
050,35,006,"New Mexico","Cibola County",2,48,307,173,134
050,35,006,"New Mexico","Cibola County",2,49,315,184,131
050,35,006,"New Mexico","Cibola County",2,50,302,155,147
050,35,006,"New Mexico","Cibola County",2,51,320,164,156
050,35,006,"New Mexico","Cibola County",2,52,321,164,157
050,35,006,"New Mexico","Cibola County",2,53,298,153,145
050,35,006,"New Mexico","Cibola County",2,54,278,144,134
050,35,006,"New Mexico","Cibola County",2,55,312,144,168
050,35,006,"New Mexico","Cibola County",2,56,306,147,159
050,35,006,"New Mexico","Cibola County",2,57,319,159,160
050,35,006,"New Mexico","Cibola County",2,58,372,190,182
050,35,006,"New Mexico","Cibola County",2,59,359,180,179
050,35,006,"New Mexico","Cibola County",2,60,356,170,186
050,35,006,"New Mexico","Cibola County",2,61,363,170,193
050,35,006,"New Mexico","Cibola County",2,62,380,189,191
050,35,006,"New Mexico","Cibola County",2,63,380,180,200
050,35,006,"New Mexico","Cibola County",2,64,359,170,189
050,35,006,"New Mexico","Cibola County",2,65,366,174,192
050,35,006,"New Mexico","Cibola County",2,66,346,176,170
050,35,006,"New Mexico","Cibola County",2,67,320,162,158
050,35,006,"New Mexico","Cibola County",2,68,298,139,159
050,35,006,"New Mexico","Cibola County",2,69,288,132,156
050,35,006,"New Mexico","Cibola County",2,70,272,132,140
050,35,006,"New Mexico","Cibola County",2,71,252,120,132
050,35,006,"New Mexico","Cibola County",2,72,237,107,130
050,35,006,"New Mexico","Cibola County",2,73,254,114,140
050,35,006,"New Mexico","Cibola County",2,74,196,85,111
050,35,006,"New Mexico","Cibola County",2,75,180,90,90
050,35,006,"New Mexico","Cibola County",2,76,163,79,84
050,35,006,"New Mexico","Cibola County",2,77,171,77,94
050,35,006,"New Mexico","Cibola County",2,78,148,68,80
050,35,006,"New Mexico","Cibola County",2,79,135,59,76
050,35,006,"New Mexico","Cibola County",2,80,126,49,77
050,35,006,"New Mexico","Cibola County",2,81,109,46,63
050,35,006,"New Mexico","Cibola County",2,82,100,39,61
050,35,006,"New Mexico","Cibola County",2,83,98,35,63
050,35,006,"New Mexico","Cibola County",2,84,112,41,71
050,35,006,"New Mexico","Cibola County",2,85,520,224,296
050,35,006,"New Mexico","Cibola County",3,0,295,146,149
050,35,006,"New Mexico","Cibola County",3,1,314,166,148
050,35,006,"New Mexico","Cibola County",3,2,289,155,134
050,35,006,"New Mexico","Cibola County",3,3,262,151,111
050,35,006,"New Mexico","Cibola County",3,4,300,165,135
050,35,006,"New Mexico","Cibola County",3,5,324,163,161
050,35,006,"New Mexico","Cibola County",3,6,365,179,186
050,35,006,"New Mexico","Cibola County",3,7,386,188,198
050,35,006,"New Mexico","Cibola County",3,8,382,196,186
050,35,006,"New Mexico","Cibola County",3,9,360,179,181
050,35,006,"New Mexico","Cibola County",3,10,382,199,183
050,35,006,"New Mexico","Cibola County",3,11,381,189,192
050,35,006,"New Mexico","Cibola County",3,12,372,188,184
050,35,006,"New Mexico","Cibola County",3,13,401,198,203
050,35,006,"New Mexico","Cibola County",3,14,404,200,204
050,35,006,"New Mexico","Cibola County",3,15,379,177,202
050,35,006,"New Mexico","Cibola County",3,16,363,171,192
050,35,006,"New Mexico","Cibola County",3,17,389,195,194
050,35,006,"New Mexico","Cibola County",3,18,330,169,161
050,35,006,"New Mexico","Cibola County",3,19,281,146,135
050,35,006,"New Mexico","Cibola County",3,20,306,146,160
050,35,006,"New Mexico","Cibola County",3,21,342,174,168
050,35,006,"New Mexico","Cibola County",3,22,351,168,183
050,35,006,"New Mexico","Cibola County",3,23,335,186,149
050,35,006,"New Mexico","Cibola County",3,24,328,183,145
050,35,006,"New Mexico","Cibola County",3,25,360,193,167
050,35,006,"New Mexico","Cibola County",3,26,380,204,176
050,35,006,"New Mexico","Cibola County",3,27,365,210,155
050,35,006,"New Mexico","Cibola County",3,28,371,203,168
050,35,006,"New Mexico","Cibola County",3,29,417,231,186
050,35,006,"New Mexico","Cibola County",3,30,401,218,183
050,35,006,"New Mexico","Cibola County",3,31,426,198,228
050,35,006,"New Mexico","Cibola County",3,32,431,227,204
050,35,006,"New Mexico","Cibola County",3,33,372,209,163
050,35,006,"New Mexico","Cibola County",3,34,356,200,156
050,35,006,"New Mexico","Cibola County",3,35,365,185,180
050,35,006,"New Mexico","Cibola County",3,36,351,201,150
050,35,006,"New Mexico","Cibola County",3,37,348,196,152
050,35,006,"New Mexico","Cibola County",3,38,328,190,138
050,35,006,"New Mexico","Cibola County",3,39,358,194,164
050,35,006,"New Mexico","Cibola County",3,40,369,192,177
050,35,006,"New Mexico","Cibola County",3,41,394,205,189
050,35,006,"New Mexico","Cibola County",3,42,343,186,157
050,35,006,"New Mexico","Cibola County",3,43,346,201,145
050,35,006,"New Mexico","Cibola County",3,44,348,199,149
050,35,006,"New Mexico","Cibola County",3,45,315,179,136
050,35,006,"New Mexico","Cibola County",3,46,305,146,159
050,35,006,"New Mexico","Cibola County",3,47,279,148,131
050,35,006,"New Mexico","Cibola County",3,48,288,158,130
050,35,006,"New Mexico","Cibola County",3,49,297,175,122
050,35,006,"New Mexico","Cibola County",3,50,315,177,138
050,35,006,"New Mexico","Cibola County",3,51,304,155,149
050,35,006,"New Mexico","Cibola County",3,52,309,153,156
050,35,006,"New Mexico","Cibola County",3,53,305,151,154
050,35,006,"New Mexico","Cibola County",3,54,287,158,129
050,35,006,"New Mexico","Cibola County",3,55,274,142,132
050,35,006,"New Mexico","Cibola County",3,56,303,137,166
050,35,006,"New Mexico","Cibola County",3,57,298,146,152
050,35,006,"New Mexico","Cibola County",3,58,331,161,170
050,35,006,"New Mexico","Cibola County",3,59,362,187,175
050,35,006,"New Mexico","Cibola County",3,60,351,171,180
050,35,006,"New Mexico","Cibola County",3,61,367,175,192
050,35,006,"New Mexico","Cibola County",3,62,354,169,185
050,35,006,"New Mexico","Cibola County",3,63,373,183,190
050,35,006,"New Mexico","Cibola County",3,64,384,180,204
050,35,006,"New Mexico","Cibola County",3,65,339,153,186
050,35,006,"New Mexico","Cibola County",3,66,356,171,185
050,35,006,"New Mexico","Cibola County",3,67,337,168,169
050,35,006,"New Mexico","Cibola County",3,68,306,155,151
050,35,006,"New Mexico","Cibola County",3,69,289,135,154
050,35,006,"New Mexico","Cibola County",3,70,279,129,150
050,35,006,"New Mexico","Cibola County",3,71,270,128,142
050,35,006,"New Mexico","Cibola County",3,72,231,108,123
050,35,006,"New Mexico","Cibola County",3,73,226,103,123
050,35,006,"New Mexico","Cibola County",3,74,250,115,135
050,35,006,"New Mexico","Cibola County",3,75,181,78,103
050,35,006,"New Mexico","Cibola County",3,76,174,87,87
050,35,006,"New Mexico","Cibola County",3,77,153,69,84
050,35,006,"New Mexico","Cibola County",3,78,156,71,85
050,35,006,"New Mexico","Cibola County",3,79,135,64,71
050,35,006,"New Mexico","Cibola County",3,80,127,55,72
050,35,006,"New Mexico","Cibola County",3,81,120,46,74
050,35,006,"New Mexico","Cibola County",3,82,108,46,62
050,35,006,"New Mexico","Cibola County",3,83,84,34,50
050,35,006,"New Mexico","Cibola County",3,84,93,33,60
050,35,006,"New Mexico","Cibola County",3,85,520,213,307
050,35,006,"New Mexico","Cibola County",4,0,248,113,135
050,35,006,"New Mexico","Cibola County",4,1,316,153,163
050,35,006,"New Mexico","Cibola County",4,2,304,163,141
050,35,006,"New Mexico","Cibola County",4,3,286,157,129
050,35,006,"New Mexico","Cibola County",4,4,281,154,127
050,35,006,"New Mexico","Cibola County",4,5,303,165,138
050,35,006,"New Mexico","Cibola County",4,6,330,160,170
050,35,006,"New Mexico","Cibola County",4,7,359,182,177
050,35,006,"New Mexico","Cibola County",4,8,387,187,200
050,35,006,"New Mexico","Cibola County",4,9,386,202,184
050,35,006,"New Mexico","Cibola County",4,10,363,173,190
050,35,006,"New Mexico","Cibola County",4,11,381,198,183
050,35,006,"New Mexico","Cibola County",4,12,381,189,192
050,35,006,"New Mexico","Cibola County",4,13,387,201,186
050,35,006,"New Mexico","Cibola County",4,14,386,188,198
050,35,006,"New Mexico","Cibola County",4,15,415,200,215
050,35,006,"New Mexico","Cibola County",4,16,393,187,206
050,35,006,"New Mexico","Cibola County",4,17,359,164,195
050,35,006,"New Mexico","Cibola County",4,18,369,185,184
050,35,006,"New Mexico","Cibola County",4,19,275,151,124
050,35,006,"New Mexico","Cibola County",4,20,280,144,136
050,35,006,"New Mexico","Cibola County",4,21,330,155,175
050,35,006,"New Mexico","Cibola County",4,22,353,179,174
050,35,006,"New Mexico","Cibola County",4,23,339,188,151
050,35,006,"New Mexico","Cibola County",4,24,338,185,153
050,35,006,"New Mexico","Cibola County",4,25,333,188,145
050,35,006,"New Mexico","Cibola County",4,26,365,199,166
050,35,006,"New Mexico","Cibola County",4,27,380,216,164
050,35,006,"New Mexico","Cibola County",4,28,354,199,155
050,35,006,"New Mexico","Cibola County",4,29,378,202,176
050,35,006,"New Mexico","Cibola County",4,30,415,236,179
050,35,006,"New Mexico","Cibola County",4,31,411,195,216
050,35,006,"New Mexico","Cibola County",4,32,427,215,212
050,35,006,"New Mexico","Cibola County",4,33,379,204,175
050,35,006,"New Mexico","Cibola County",4,34,362,216,146
050,35,006,"New Mexico","Cibola County",4,35,370,190,180
050,35,006,"New Mexico","Cibola County",4,36,368,198,170
050,35,006,"New Mexico","Cibola County",4,37,362,205,157
050,35,006,"New Mexico","Cibola County",4,38,317,185,132
050,35,006,"New Mexico","Cibola County",4,39,333,181,152
050,35,006,"New Mexico","Cibola County",4,40,337,183,154
050,35,006,"New Mexico","Cibola County",4,41,387,204,183
050,35,006,"New Mexico","Cibola County",4,42,368,184,184
050,35,006,"New Mexico","Cibola County",4,43,324,177,147
050,35,006,"New Mexico","Cibola County",4,44,333,187,146
050,35,006,"New Mexico","Cibola County",4,45,329,195,134
050,35,006,"New Mexico","Cibola County",4,46,327,181,146
050,35,006,"New Mexico","Cibola County",4,47,289,136,153
050,35,006,"New Mexico","Cibola County",4,48,278,149,129
050,35,006,"New Mexico","Cibola County",4,49,265,151,114
050,35,006,"New Mexico","Cibola County",4,50,283,154,129
050,35,006,"New Mexico","Cibola County",4,51,323,180,143
050,35,006,"New Mexico","Cibola County",4,52,297,145,152
050,35,006,"New Mexico","Cibola County",4,53,294,137,157
050,35,006,"New Mexico","Cibola County",4,54,288,150,138
050,35,006,"New Mexico","Cibola County",4,55,286,155,131
050,35,006,"New Mexico","Cibola County",4,56,264,135,129
050,35,006,"New Mexico","Cibola County",4,57,296,132,164
050,35,006,"New Mexico","Cibola County",4,58,313,152,161
050,35,006,"New Mexico","Cibola County",4,59,313,157,156
050,35,006,"New Mexico","Cibola County",4,60,347,173,174
050,35,006,"New Mexico","Cibola County",4,61,357,170,187
050,35,006,"New Mexico","Cibola County",4,62,356,168,188
050,35,006,"New Mexico","Cibola County",4,63,349,167,182
050,35,006,"New Mexico","Cibola County",4,64,365,179,186
050,35,006,"New Mexico","Cibola County",4,65,373,171,202
050,35,006,"New Mexico","Cibola County",4,66,329,147,182
050,35,006,"New Mexico","Cibola County",4,67,350,168,182
050,35,006,"New Mexico","Cibola County",4,68,325,166,159
050,35,006,"New Mexico","Cibola County",4,69,301,156,145
050,35,006,"New Mexico","Cibola County",4,70,283,132,151
050,35,006,"New Mexico","Cibola County",4,71,271,123,148
050,35,006,"New Mexico","Cibola County",4,72,243,120,123
050,35,006,"New Mexico","Cibola County",4,73,225,108,117
050,35,006,"New Mexico","Cibola County",4,74,217,97,120
050,35,006,"New Mexico","Cibola County",4,75,231,106,125
050,35,006,"New Mexico","Cibola County",4,76,172,76,96
050,35,006,"New Mexico","Cibola County",4,77,164,78,86
050,35,006,"New Mexico","Cibola County",4,78,141,63,78
050,35,006,"New Mexico","Cibola County",4,79,144,69,75
050,35,006,"New Mexico","Cibola County",4,80,128,55,73
050,35,006,"New Mexico","Cibola County",4,81,119,51,68
050,35,006,"New Mexico","Cibola County",4,82,114,41,73
050,35,006,"New Mexico","Cibola County",4,83,91,36,55
050,35,006,"New Mexico","Cibola County",4,84,79,29,50
050,35,006,"New Mexico","Cibola County",4,85,500,202,298
050,35,006,"New Mexico","Cibola County",5,0,245,113,132
050,35,006,"New Mexico","Cibola County",5,1,233,109,124
050,35,006,"New Mexico","Cibola County",5,2,312,153,159
050,35,006,"New Mexico","Cibola County",5,3,295,158,137
050,35,006,"New Mexico","Cibola County",5,4,288,157,131
050,35,006,"New Mexico","Cibola County",5,5,283,164,119
050,35,006,"New Mexico","Cibola County",5,6,299,164,135
050,35,006,"New Mexico","Cibola County",5,7,348,172,176
050,35,006,"New Mexico","Cibola County",5,8,360,180,180
050,35,006,"New Mexico","Cibola County",5,9,391,195,196
050,35,006,"New Mexico","Cibola County",5,10,398,208,190
050,35,006,"New Mexico","Cibola County",5,11,359,170,189
050,35,006,"New Mexico","Cibola County",5,12,388,205,183
050,35,006,"New Mexico","Cibola County",5,13,389,191,198
050,35,006,"New Mexico","Cibola County",5,14,387,194,193
050,35,006,"New Mexico","Cibola County",5,15,400,186,214
050,35,006,"New Mexico","Cibola County",5,16,413,191,222
050,35,006,"New Mexico","Cibola County",5,17,385,183,202
050,35,006,"New Mexico","Cibola County",5,18,335,146,189
050,35,006,"New Mexico","Cibola County",5,19,298,158,140
050,35,006,"New Mexico","Cibola County",5,20,286,152,134
050,35,006,"New Mexico","Cibola County",5,21,299,153,146
050,35,006,"New Mexico","Cibola County",5,22,352,166,186
050,35,006,"New Mexico","Cibola County",5,23,340,186,154
050,35,006,"New Mexico","Cibola County",5,24,322,174,148
050,35,006,"New Mexico","Cibola County",5,25,362,201,161
050,35,006,"New Mexico","Cibola County",5,26,345,203,142
050,35,006,"New Mexico","Cibola County",5,27,364,204,160
050,35,006,"New Mexico","Cibola County",5,28,365,207,158
050,35,006,"New Mexico","Cibola County",5,29,366,202,164
050,35,006,"New Mexico","Cibola County",5,30,370,203,167
050,35,006,"New Mexico","Cibola County",5,31,435,219,216
050,35,006,"New Mexico","Cibola County",5,32,412,208,204
050,35,006,"New Mexico","Cibola County",5,33,392,202,190
050,35,006,"New Mexico","Cibola County",5,34,386,221,165
050,35,006,"New Mexico","Cibola County",5,35,378,202,176
050,35,006,"New Mexico","Cibola County",5,36,370,197,173
050,35,006,"New Mexico","Cibola County",5,37,382,201,181
050,35,006,"New Mexico","Cibola County",5,38,341,204,137
050,35,006,"New Mexico","Cibola County",5,39,325,179,146
050,35,006,"New Mexico","Cibola County",5,40,328,185,143
050,35,006,"New Mexico","Cibola County",5,41,356,196,160
050,35,006,"New Mexico","Cibola County",5,42,378,195,183
050,35,006,"New Mexico","Cibola County",5,43,358,185,173
050,35,006,"New Mexico","Cibola County",5,44,317,166,151
050,35,006,"New Mexico","Cibola County",5,45,333,189,144
050,35,006,"New Mexico","Cibola County",5,46,332,195,137
050,35,006,"New Mexico","Cibola County",5,47,308,166,142
050,35,006,"New Mexico","Cibola County",5,48,301,149,152
050,35,006,"New Mexico","Cibola County",5,49,270,153,117
050,35,006,"New Mexico","Cibola County",5,50,269,145,124
050,35,006,"New Mexico","Cibola County",5,51,276,155,121
050,35,006,"New Mexico","Cibola County",5,52,321,173,148
050,35,006,"New Mexico","Cibola County",5,53,297,140,157
050,35,006,"New Mexico","Cibola County",5,54,281,136,145
050,35,006,"New Mexico","Cibola County",5,55,290,150,140
050,35,006,"New Mexico","Cibola County",5,56,281,142,139
050,35,006,"New Mexico","Cibola County",5,57,264,139,125
050,35,006,"New Mexico","Cibola County",5,58,311,138,173
050,35,006,"New Mexico","Cibola County",5,59,293,144,149
050,35,006,"New Mexico","Cibola County",5,60,302,144,158
050,35,006,"New Mexico","Cibola County",5,61,355,175,180
050,35,006,"New Mexico","Cibola County",5,62,347,169,178
050,35,006,"New Mexico","Cibola County",5,63,351,164,187
050,35,006,"New Mexico","Cibola County",5,64,352,169,183
050,35,006,"New Mexico","Cibola County",5,65,357,178,179
050,35,006,"New Mexico","Cibola County",5,66,374,173,201
050,35,006,"New Mexico","Cibola County",5,67,328,142,186
050,35,006,"New Mexico","Cibola County",5,68,338,163,175
050,35,006,"New Mexico","Cibola County",5,69,319,164,155
050,35,006,"New Mexico","Cibola County",5,70,290,150,140
050,35,006,"New Mexico","Cibola County",5,71,278,126,152
050,35,006,"New Mexico","Cibola County",5,72,263,117,146
050,35,006,"New Mexico","Cibola County",5,73,240,116,124
050,35,006,"New Mexico","Cibola County",5,74,220,109,111
050,35,006,"New Mexico","Cibola County",5,75,201,87,114
050,35,006,"New Mexico","Cibola County",5,76,226,101,125
050,35,006,"New Mexico","Cibola County",5,77,167,69,98
050,35,006,"New Mexico","Cibola County",5,78,156,73,83
050,35,006,"New Mexico","Cibola County",5,79,132,62,70
050,35,006,"New Mexico","Cibola County",5,80,134,60,74
050,35,006,"New Mexico","Cibola County",5,81,116,51,65
050,35,006,"New Mexico","Cibola County",5,82,118,49,69
050,35,006,"New Mexico","Cibola County",5,83,94,31,63
050,35,006,"New Mexico","Cibola County",5,84,84,31,53
050,35,006,"New Mexico","Cibola County",5,85,476,193,283
050,35,007,"New Mexico","Colfax County",1,0,108,56,52
050,35,007,"New Mexico","Colfax County",1,1,103,51,52
050,35,007,"New Mexico","Colfax County",1,2,96,54,42
050,35,007,"New Mexico","Colfax County",1,3,110,53,57
050,35,007,"New Mexico","Colfax County",1,4,102,53,49
050,35,007,"New Mexico","Colfax County",1,5,108,56,52
050,35,007,"New Mexico","Colfax County",1,6,110,57,53
050,35,007,"New Mexico","Colfax County",1,7,119,64,55
050,35,007,"New Mexico","Colfax County",1,8,117,62,55
050,35,007,"New Mexico","Colfax County",1,9,114,62,52
050,35,007,"New Mexico","Colfax County",1,10,124,58,66
050,35,007,"New Mexico","Colfax County",1,11,145,74,71
050,35,007,"New Mexico","Colfax County",1,12,145,78,67
050,35,007,"New Mexico","Colfax County",1,13,124,66,58
050,35,007,"New Mexico","Colfax County",1,14,117,52,65
050,35,007,"New Mexico","Colfax County",1,15,114,54,60
050,35,007,"New Mexico","Colfax County",1,16,155,84,71
050,35,007,"New Mexico","Colfax County",1,17,124,66,58
050,35,007,"New Mexico","Colfax County",1,18,128,67,61
050,35,007,"New Mexico","Colfax County",1,19,104,57,47
050,35,007,"New Mexico","Colfax County",1,20,125,82,43
050,35,007,"New Mexico","Colfax County",1,21,111,69,42
050,35,007,"New Mexico","Colfax County",1,22,132,74,58
050,35,007,"New Mexico","Colfax County",1,23,133,69,64
050,35,007,"New Mexico","Colfax County",1,24,131,77,54
050,35,007,"New Mexico","Colfax County",1,25,137,81,56
050,35,007,"New Mexico","Colfax County",1,26,142,72,70
050,35,007,"New Mexico","Colfax County",1,27,147,78,69
050,35,007,"New Mexico","Colfax County",1,28,144,78,66
050,35,007,"New Mexico","Colfax County",1,29,152,105,47
050,35,007,"New Mexico","Colfax County",1,30,141,88,53
050,35,007,"New Mexico","Colfax County",1,31,159,95,64
050,35,007,"New Mexico","Colfax County",1,32,129,63,66
050,35,007,"New Mexico","Colfax County",1,33,116,68,48
050,35,007,"New Mexico","Colfax County",1,34,119,52,67
050,35,007,"New Mexico","Colfax County",1,35,118,66,52
050,35,007,"New Mexico","Colfax County",1,36,144,92,52
050,35,007,"New Mexico","Colfax County",1,37,133,73,60
050,35,007,"New Mexico","Colfax County",1,38,142,75,67
050,35,007,"New Mexico","Colfax County",1,39,124,69,55
050,35,007,"New Mexico","Colfax County",1,40,133,74,59
050,35,007,"New Mexico","Colfax County",1,41,119,61,58
050,35,007,"New Mexico","Colfax County",1,42,121,60,61
050,35,007,"New Mexico","Colfax County",1,43,108,62,46
050,35,007,"New Mexico","Colfax County",1,44,101,59,42
050,35,007,"New Mexico","Colfax County",1,45,121,76,45
050,35,007,"New Mexico","Colfax County",1,46,131,69,62
050,35,007,"New Mexico","Colfax County",1,47,125,63,62
050,35,007,"New Mexico","Colfax County",1,48,132,71,61
050,35,007,"New Mexico","Colfax County",1,49,116,67,49
050,35,007,"New Mexico","Colfax County",1,50,124,65,59
050,35,007,"New Mexico","Colfax County",1,51,156,78,78
050,35,007,"New Mexico","Colfax County",1,52,153,76,77
050,35,007,"New Mexico","Colfax County",1,53,162,83,79
050,35,007,"New Mexico","Colfax County",1,54,142,76,66
050,35,007,"New Mexico","Colfax County",1,55,155,80,75
050,35,007,"New Mexico","Colfax County",1,56,184,90,94
050,35,007,"New Mexico","Colfax County",1,57,197,97,100
050,35,007,"New Mexico","Colfax County",1,58,192,96,96
050,35,007,"New Mexico","Colfax County",1,59,193,98,95
050,35,007,"New Mexico","Colfax County",1,60,227,119,108
050,35,007,"New Mexico","Colfax County",1,61,193,94,99
050,35,007,"New Mexico","Colfax County",1,62,204,95,109
050,35,007,"New Mexico","Colfax County",1,63,232,114,118
050,35,007,"New Mexico","Colfax County",1,64,227,119,108
050,35,007,"New Mexico","Colfax County",1,65,220,115,105
050,35,007,"New Mexico","Colfax County",1,66,207,102,105
050,35,007,"New Mexico","Colfax County",1,67,239,118,121
050,35,007,"New Mexico","Colfax County",1,68,239,117,122
050,35,007,"New Mexico","Colfax County",1,69,189,103,86
050,35,007,"New Mexico","Colfax County",1,70,188,102,86
050,35,007,"New Mexico","Colfax County",1,71,201,108,93
050,35,007,"New Mexico","Colfax County",1,72,194,94,100
050,35,007,"New Mexico","Colfax County",1,73,197,93,104
050,35,007,"New Mexico","Colfax County",1,74,147,72,75
050,35,007,"New Mexico","Colfax County",1,75,141,69,72
050,35,007,"New Mexico","Colfax County",1,76,136,73,63
050,35,007,"New Mexico","Colfax County",1,77,115,61,54
050,35,007,"New Mexico","Colfax County",1,78,116,53,63
050,35,007,"New Mexico","Colfax County",1,79,104,53,51
050,35,007,"New Mexico","Colfax County",1,80,102,54,48
050,35,007,"New Mexico","Colfax County",1,81,93,46,47
050,35,007,"New Mexico","Colfax County",1,82,75,40,35
050,35,007,"New Mexico","Colfax County",1,83,68,31,37
050,35,007,"New Mexico","Colfax County",1,84,71,30,41
050,35,007,"New Mexico","Colfax County",1,85,348,129,219
050,35,007,"New Mexico","Colfax County",2,0,105,53,52
050,35,007,"New Mexico","Colfax County",2,1,102,50,52
050,35,007,"New Mexico","Colfax County",2,2,96,52,44
050,35,007,"New Mexico","Colfax County",2,3,104,52,52
050,35,007,"New Mexico","Colfax County",2,4,103,52,51
050,35,007,"New Mexico","Colfax County",2,5,106,56,50
050,35,007,"New Mexico","Colfax County",2,6,110,57,53
050,35,007,"New Mexico","Colfax County",2,7,117,62,55
050,35,007,"New Mexico","Colfax County",2,8,117,62,55
050,35,007,"New Mexico","Colfax County",2,9,116,62,54
050,35,007,"New Mexico","Colfax County",2,10,124,61,63
050,35,007,"New Mexico","Colfax County",2,11,140,69,71
050,35,007,"New Mexico","Colfax County",2,12,144,75,69
050,35,007,"New Mexico","Colfax County",2,13,128,67,61
050,35,007,"New Mexico","Colfax County",2,14,116,54,62
050,35,007,"New Mexico","Colfax County",2,15,115,54,61
050,35,007,"New Mexico","Colfax County",2,16,144,77,67
050,35,007,"New Mexico","Colfax County",2,17,132,71,61
050,35,007,"New Mexico","Colfax County",2,18,125,66,59
050,35,007,"New Mexico","Colfax County",2,19,109,59,50
050,35,007,"New Mexico","Colfax County",2,20,122,80,42
050,35,007,"New Mexico","Colfax County",2,21,113,71,42
050,35,007,"New Mexico","Colfax County",2,22,129,73,56
050,35,007,"New Mexico","Colfax County",2,23,135,73,62
050,35,007,"New Mexico","Colfax County",2,24,131,75,56
050,35,007,"New Mexico","Colfax County",2,25,134,79,55
050,35,007,"New Mexico","Colfax County",2,26,142,72,70
050,35,007,"New Mexico","Colfax County",2,27,147,78,69
050,35,007,"New Mexico","Colfax County",2,28,140,75,65
050,35,007,"New Mexico","Colfax County",2,29,155,105,50
050,35,007,"New Mexico","Colfax County",2,30,142,90,52
050,35,007,"New Mexico","Colfax County",2,31,155,94,61
050,35,007,"New Mexico","Colfax County",2,32,133,68,65
050,35,007,"New Mexico","Colfax County",2,33,118,66,52
050,35,007,"New Mexico","Colfax County",2,34,119,55,64
050,35,007,"New Mexico","Colfax County",2,35,120,65,55
050,35,007,"New Mexico","Colfax County",2,36,138,87,51
050,35,007,"New Mexico","Colfax County",2,37,134,75,59
050,35,007,"New Mexico","Colfax County",2,38,140,74,66
050,35,007,"New Mexico","Colfax County",2,39,127,70,57
050,35,007,"New Mexico","Colfax County",2,40,134,74,60
050,35,007,"New Mexico","Colfax County",2,41,119,60,59
050,35,007,"New Mexico","Colfax County",2,42,119,60,59
050,35,007,"New Mexico","Colfax County",2,43,111,62,49
050,35,007,"New Mexico","Colfax County",2,44,103,60,43
050,35,007,"New Mexico","Colfax County",2,45,119,74,45
050,35,007,"New Mexico","Colfax County",2,46,129,71,58
050,35,007,"New Mexico","Colfax County",2,47,124,62,62
050,35,007,"New Mexico","Colfax County",2,48,130,70,60
050,35,007,"New Mexico","Colfax County",2,49,121,68,53
050,35,007,"New Mexico","Colfax County",2,50,121,65,56
050,35,007,"New Mexico","Colfax County",2,51,148,75,73
050,35,007,"New Mexico","Colfax County",2,52,153,74,79
050,35,007,"New Mexico","Colfax County",2,53,158,80,78
050,35,007,"New Mexico","Colfax County",2,54,146,76,70
050,35,007,"New Mexico","Colfax County",2,55,153,79,74
050,35,007,"New Mexico","Colfax County",2,56,178,88,90
050,35,007,"New Mexico","Colfax County",2,57,194,96,98
050,35,007,"New Mexico","Colfax County",2,58,192,97,95
050,35,007,"New Mexico","Colfax County",2,59,192,98,94
050,35,007,"New Mexico","Colfax County",2,60,221,115,106
050,35,007,"New Mexico","Colfax County",2,61,198,97,101
050,35,007,"New Mexico","Colfax County",2,62,200,94,106
050,35,007,"New Mexico","Colfax County",2,63,227,110,117
050,35,007,"New Mexico","Colfax County",2,64,225,116,109
050,35,007,"New Mexico","Colfax County",2,65,221,116,105
050,35,007,"New Mexico","Colfax County",2,66,207,103,104
050,35,007,"New Mexico","Colfax County",2,67,230,113,117
050,35,007,"New Mexico","Colfax County",2,68,238,117,121
050,35,007,"New Mexico","Colfax County",2,69,202,106,96
050,35,007,"New Mexico","Colfax County",2,70,186,102,84
050,35,007,"New Mexico","Colfax County",2,71,198,107,91
050,35,007,"New Mexico","Colfax County",2,72,191,95,96
050,35,007,"New Mexico","Colfax County",2,73,205,98,107
050,35,007,"New Mexico","Colfax County",2,74,149,72,77
050,35,007,"New Mexico","Colfax County",2,75,143,70,73
050,35,007,"New Mexico","Colfax County",2,76,137,72,65
050,35,007,"New Mexico","Colfax County",2,77,122,65,57
050,35,007,"New Mexico","Colfax County",2,78,112,53,59
050,35,007,"New Mexico","Colfax County",2,79,105,53,52
050,35,007,"New Mexico","Colfax County",2,80,102,53,49
050,35,007,"New Mexico","Colfax County",2,81,92,46,46
050,35,007,"New Mexico","Colfax County",2,82,79,42,37
050,35,007,"New Mexico","Colfax County",2,83,68,32,36
050,35,007,"New Mexico","Colfax County",2,84,69,30,39
050,35,007,"New Mexico","Colfax County",2,85,354,130,224
050,35,007,"New Mexico","Colfax County",3,0,89,38,51
050,35,007,"New Mexico","Colfax County",3,1,97,48,49
050,35,007,"New Mexico","Colfax County",3,2,100,45,55
050,35,007,"New Mexico","Colfax County",3,3,100,53,47
050,35,007,"New Mexico","Colfax County",3,4,105,53,52
050,35,007,"New Mexico","Colfax County",3,5,105,49,56
050,35,007,"New Mexico","Colfax County",3,6,118,58,60
050,35,007,"New Mexico","Colfax County",3,7,110,56,54
050,35,007,"New Mexico","Colfax County",3,8,121,61,60
050,35,007,"New Mexico","Colfax County",3,9,112,61,51
050,35,007,"New Mexico","Colfax County",3,10,113,61,52
050,35,007,"New Mexico","Colfax County",3,11,120,59,61
050,35,007,"New Mexico","Colfax County",3,12,136,65,71
050,35,007,"New Mexico","Colfax County",3,13,148,76,72
050,35,007,"New Mexico","Colfax County",3,14,119,65,54
050,35,007,"New Mexico","Colfax County",3,15,110,53,57
050,35,007,"New Mexico","Colfax County",3,16,113,55,58
050,35,007,"New Mexico","Colfax County",3,17,145,78,67
050,35,007,"New Mexico","Colfax County",3,18,125,67,58
050,35,007,"New Mexico","Colfax County",3,19,115,60,55
050,35,007,"New Mexico","Colfax County",3,20,112,63,49
050,35,007,"New Mexico","Colfax County",3,21,113,72,41
050,35,007,"New Mexico","Colfax County",3,22,123,81,42
050,35,007,"New Mexico","Colfax County",3,23,132,75,57
050,35,007,"New Mexico","Colfax County",3,24,136,74,62
050,35,007,"New Mexico","Colfax County",3,25,133,83,50
050,35,007,"New Mexico","Colfax County",3,26,137,75,62
050,35,007,"New Mexico","Colfax County",3,27,155,86,69
050,35,007,"New Mexico","Colfax County",3,28,130,61,69
050,35,007,"New Mexico","Colfax County",3,29,160,91,69
050,35,007,"New Mexico","Colfax County",3,30,140,91,49
050,35,007,"New Mexico","Colfax County",3,31,162,103,59
050,35,007,"New Mexico","Colfax County",3,32,141,79,62
050,35,007,"New Mexico","Colfax County",3,33,133,70,63
050,35,007,"New Mexico","Colfax County",3,34,121,60,61
050,35,007,"New Mexico","Colfax County",3,35,130,61,69
050,35,007,"New Mexico","Colfax County",3,36,138,80,58
050,35,007,"New Mexico","Colfax County",3,37,124,72,52
050,35,007,"New Mexico","Colfax County",3,38,136,71,65
050,35,007,"New Mexico","Colfax County",3,39,135,74,61
050,35,007,"New Mexico","Colfax County",3,40,138,80,58
050,35,007,"New Mexico","Colfax County",3,41,117,57,60
050,35,007,"New Mexico","Colfax County",3,42,125,66,59
050,35,007,"New Mexico","Colfax County",3,43,129,65,64
050,35,007,"New Mexico","Colfax County",3,44,114,63,51
050,35,007,"New Mexico","Colfax County",3,45,105,63,42
050,35,007,"New Mexico","Colfax County",3,46,122,75,47
050,35,007,"New Mexico","Colfax County",3,47,126,66,60
050,35,007,"New Mexico","Colfax County",3,48,129,70,59
050,35,007,"New Mexico","Colfax County",3,49,135,69,66
050,35,007,"New Mexico","Colfax County",3,50,123,67,56
050,35,007,"New Mexico","Colfax County",3,51,127,71,56
050,35,007,"New Mexico","Colfax County",3,52,144,72,72
050,35,007,"New Mexico","Colfax County",3,53,162,81,81
050,35,007,"New Mexico","Colfax County",3,54,157,73,84
050,35,007,"New Mexico","Colfax County",3,55,143,75,68
050,35,007,"New Mexico","Colfax County",3,56,157,80,77
050,35,007,"New Mexico","Colfax County",3,57,179,89,90
050,35,007,"New Mexico","Colfax County",3,58,201,98,103
050,35,007,"New Mexico","Colfax County",3,59,195,101,94
050,35,007,"New Mexico","Colfax County",3,60,208,107,101
050,35,007,"New Mexico","Colfax County",3,61,215,104,111
050,35,007,"New Mexico","Colfax County",3,62,199,96,103
050,35,007,"New Mexico","Colfax County",3,63,208,100,108
050,35,007,"New Mexico","Colfax County",3,64,234,107,127
050,35,007,"New Mexico","Colfax County",3,65,226,117,109
050,35,007,"New Mexico","Colfax County",3,66,215,114,101
050,35,007,"New Mexico","Colfax County",3,67,195,101,94
050,35,007,"New Mexico","Colfax County",3,68,227,112,115
050,35,007,"New Mexico","Colfax County",3,69,224,110,114
050,35,007,"New Mexico","Colfax County",3,70,193,98,95
050,35,007,"New Mexico","Colfax County",3,71,180,98,82
050,35,007,"New Mexico","Colfax County",3,72,188,103,85
050,35,007,"New Mexico","Colfax County",3,73,181,89,92
050,35,007,"New Mexico","Colfax County",3,74,203,95,108
050,35,007,"New Mexico","Colfax County",3,75,139,67,72
050,35,007,"New Mexico","Colfax County",3,76,139,67,72
050,35,007,"New Mexico","Colfax County",3,77,139,74,65
050,35,007,"New Mexico","Colfax County",3,78,123,64,59
050,35,007,"New Mexico","Colfax County",3,79,102,48,54
050,35,007,"New Mexico","Colfax County",3,80,100,54,46
050,35,007,"New Mexico","Colfax County",3,81,97,49,48
050,35,007,"New Mexico","Colfax County",3,82,88,45,43
050,35,007,"New Mexico","Colfax County",3,83,73,35,38
050,35,007,"New Mexico","Colfax County",3,84,61,28,33
050,35,007,"New Mexico","Colfax County",3,85,369,138,231
050,35,007,"New Mexico","Colfax County",4,0,83,40,43
050,35,007,"New Mexico","Colfax County",4,1,86,33,53
050,35,007,"New Mexico","Colfax County",4,2,98,46,52
050,35,007,"New Mexico","Colfax County",4,3,108,50,58
050,35,007,"New Mexico","Colfax County",4,4,98,54,44
050,35,007,"New Mexico","Colfax County",4,5,111,54,57
050,35,007,"New Mexico","Colfax County",4,6,104,48,56
050,35,007,"New Mexico","Colfax County",4,7,124,59,65
050,35,007,"New Mexico","Colfax County",4,8,109,56,53
050,35,007,"New Mexico","Colfax County",4,9,122,59,63
050,35,007,"New Mexico","Colfax County",4,10,113,62,51
050,35,007,"New Mexico","Colfax County",4,11,119,61,58
050,35,007,"New Mexico","Colfax County",4,12,116,54,62
050,35,007,"New Mexico","Colfax County",4,13,131,65,66
050,35,007,"New Mexico","Colfax County",4,14,145,74,71
050,35,007,"New Mexico","Colfax County",4,15,125,64,61
050,35,007,"New Mexico","Colfax County",4,16,114,55,59
050,35,007,"New Mexico","Colfax County",4,17,115,56,59
050,35,007,"New Mexico","Colfax County",4,18,140,73,67
050,35,007,"New Mexico","Colfax County",4,19,108,59,49
050,35,007,"New Mexico","Colfax County",4,20,132,66,66
050,35,007,"New Mexico","Colfax County",4,21,113,61,52
050,35,007,"New Mexico","Colfax County",4,22,117,76,41
050,35,007,"New Mexico","Colfax County",4,23,140,86,54
050,35,007,"New Mexico","Colfax County",4,24,121,71,50
050,35,007,"New Mexico","Colfax County",4,25,137,72,65
050,35,007,"New Mexico","Colfax County",4,26,111,63,48
050,35,007,"New Mexico","Colfax County",4,27,146,88,58
050,35,007,"New Mexico","Colfax County",4,28,127,70,57
050,35,007,"New Mexico","Colfax County",4,29,160,86,74
050,35,007,"New Mexico","Colfax County",4,30,155,82,73
050,35,007,"New Mexico","Colfax County",4,31,161,108,53
050,35,007,"New Mexico","Colfax County",4,32,139,90,49
050,35,007,"New Mexico","Colfax County",4,33,134,76,58
050,35,007,"New Mexico","Colfax County",4,34,133,71,62
050,35,007,"New Mexico","Colfax County",4,35,123,66,57
050,35,007,"New Mexico","Colfax County",4,36,138,72,66
050,35,007,"New Mexico","Colfax County",4,37,124,65,59
050,35,007,"New Mexico","Colfax County",4,38,121,67,54
050,35,007,"New Mexico","Colfax County",4,39,133,71,62
050,35,007,"New Mexico","Colfax County",4,40,153,86,67
050,35,007,"New Mexico","Colfax County",4,41,127,65,62
050,35,007,"New Mexico","Colfax County",4,42,123,64,59
050,35,007,"New Mexico","Colfax County",4,43,133,70,63
050,35,007,"New Mexico","Colfax County",4,44,134,68,66
050,35,007,"New Mexico","Colfax County",4,45,124,71,53
050,35,007,"New Mexico","Colfax County",4,46,107,65,42
050,35,007,"New Mexico","Colfax County",4,47,120,72,48
050,35,007,"New Mexico","Colfax County",4,48,129,72,57
050,35,007,"New Mexico","Colfax County",4,49,129,66,63
050,35,007,"New Mexico","Colfax County",4,50,135,64,71
050,35,007,"New Mexico","Colfax County",4,51,126,68,58
050,35,007,"New Mexico","Colfax County",4,52,124,68,56
050,35,007,"New Mexico","Colfax County",4,53,138,67,71
050,35,007,"New Mexico","Colfax County",4,54,157,73,84
050,35,007,"New Mexico","Colfax County",4,55,157,73,84
050,35,007,"New Mexico","Colfax County",4,56,141,70,71
050,35,007,"New Mexico","Colfax County",4,57,159,82,77
050,35,007,"New Mexico","Colfax County",4,58,178,90,88
050,35,007,"New Mexico","Colfax County",4,59,193,96,97
050,35,007,"New Mexico","Colfax County",4,60,195,101,94
050,35,007,"New Mexico","Colfax County",4,61,194,97,97
050,35,007,"New Mexico","Colfax County",4,62,215,109,106
050,35,007,"New Mexico","Colfax County",4,63,211,103,108
050,35,007,"New Mexico","Colfax County",4,64,200,89,111
050,35,007,"New Mexico","Colfax County",4,65,233,103,130
050,35,007,"New Mexico","Colfax County",4,66,226,126,100
050,35,007,"New Mexico","Colfax County",4,67,218,120,98
050,35,007,"New Mexico","Colfax County",4,68,198,108,90
050,35,007,"New Mexico","Colfax County",4,69,215,106,109
050,35,007,"New Mexico","Colfax County",4,70,215,103,112
050,35,007,"New Mexico","Colfax County",4,71,190,100,90
050,35,007,"New Mexico","Colfax County",4,72,161,87,74
050,35,007,"New Mexico","Colfax County",4,73,180,102,78
050,35,007,"New Mexico","Colfax County",4,74,177,86,91
050,35,007,"New Mexico","Colfax County",4,75,191,87,104
050,35,007,"New Mexico","Colfax County",4,76,133,62,71
050,35,007,"New Mexico","Colfax County",4,77,139,69,70
050,35,007,"New Mexico","Colfax County",4,78,136,73,63
050,35,007,"New Mexico","Colfax County",4,79,110,54,56
050,35,007,"New Mexico","Colfax County",4,80,100,48,52
050,35,007,"New Mexico","Colfax County",4,81,98,51,47
050,35,007,"New Mexico","Colfax County",4,82,93,50,43
050,35,007,"New Mexico","Colfax County",4,83,81,39,42
050,35,007,"New Mexico","Colfax County",4,84,74,38,36
050,35,007,"New Mexico","Colfax County",4,85,368,140,228
050,35,007,"New Mexico","Colfax County",5,0,84,41,43
050,35,007,"New Mexico","Colfax County",5,1,93,49,44
050,35,007,"New Mexico","Colfax County",5,2,89,34,55
050,35,007,"New Mexico","Colfax County",5,3,104,50,54
050,35,007,"New Mexico","Colfax County",5,4,106,50,56
050,35,007,"New Mexico","Colfax County",5,5,100,54,46
050,35,007,"New Mexico","Colfax County",5,6,112,55,57
050,35,007,"New Mexico","Colfax County",5,7,98,48,50
050,35,007,"New Mexico","Colfax County",5,8,123,58,65
050,35,007,"New Mexico","Colfax County",5,9,111,57,54
050,35,007,"New Mexico","Colfax County",5,10,122,59,63
050,35,007,"New Mexico","Colfax County",5,11,118,64,54
050,35,007,"New Mexico","Colfax County",5,12,116,58,58
050,35,007,"New Mexico","Colfax County",5,13,115,55,60
050,35,007,"New Mexico","Colfax County",5,14,133,66,67
050,35,007,"New Mexico","Colfax County",5,15,145,75,70
050,35,007,"New Mexico","Colfax County",5,16,136,74,62
050,35,007,"New Mexico","Colfax County",5,17,124,62,62
050,35,007,"New Mexico","Colfax County",5,18,115,54,61
050,35,007,"New Mexico","Colfax County",5,19,119,64,55
050,35,007,"New Mexico","Colfax County",5,20,122,64,58
050,35,007,"New Mexico","Colfax County",5,21,128,58,70
050,35,007,"New Mexico","Colfax County",5,22,129,74,55
050,35,007,"New Mexico","Colfax County",5,23,135,85,50
050,35,007,"New Mexico","Colfax County",5,24,135,78,57
050,35,007,"New Mexico","Colfax County",5,25,124,73,51
050,35,007,"New Mexico","Colfax County",5,26,128,61,67
050,35,007,"New Mexico","Colfax County",5,27,126,76,50
050,35,007,"New Mexico","Colfax County",5,28,109,61,48
050,35,007,"New Mexico","Colfax County",5,29,159,98,61
050,35,007,"New Mexico","Colfax County",5,30,132,65,67
050,35,007,"New Mexico","Colfax County",5,31,166,98,68
050,35,007,"New Mexico","Colfax County",5,32,134,91,43
050,35,007,"New Mexico","Colfax County",5,33,132,82,50
050,35,007,"New Mexico","Colfax County",5,34,128,70,58
050,35,007,"New Mexico","Colfax County",5,35,147,84,63
050,35,007,"New Mexico","Colfax County",5,36,142,84,58
050,35,007,"New Mexico","Colfax County",5,37,139,67,72
050,35,007,"New Mexico","Colfax County",5,38,122,63,59
050,35,007,"New Mexico","Colfax County",5,39,124,72,52
050,35,007,"New Mexico","Colfax County",5,40,146,78,68
050,35,007,"New Mexico","Colfax County",5,41,145,79,66
050,35,007,"New Mexico","Colfax County",5,42,135,73,62
050,35,007,"New Mexico","Colfax County",5,43,120,59,61
050,35,007,"New Mexico","Colfax County",5,44,144,77,67
050,35,007,"New Mexico","Colfax County",5,45,141,75,66
050,35,007,"New Mexico","Colfax County",5,46,121,68,53
050,35,007,"New Mexico","Colfax County",5,47,98,56,42
050,35,007,"New Mexico","Colfax County",5,48,119,75,44
050,35,007,"New Mexico","Colfax County",5,49,124,68,56
050,35,007,"New Mexico","Colfax County",5,50,128,64,64
050,35,007,"New Mexico","Colfax County",5,51,133,64,69
050,35,007,"New Mexico","Colfax County",5,52,120,63,57
050,35,007,"New Mexico","Colfax County",5,53,129,70,59
050,35,007,"New Mexico","Colfax County",5,54,141,67,74
050,35,007,"New Mexico","Colfax County",5,55,154,71,83
050,35,007,"New Mexico","Colfax County",5,56,157,70,87
050,35,007,"New Mexico","Colfax County",5,57,146,73,73
050,35,007,"New Mexico","Colfax County",5,58,153,81,72
050,35,007,"New Mexico","Colfax County",5,59,186,96,90
050,35,007,"New Mexico","Colfax County",5,60,191,96,95
050,35,007,"New Mexico","Colfax County",5,61,189,96,93
050,35,007,"New Mexico","Colfax County",5,62,196,96,100
050,35,007,"New Mexico","Colfax County",5,63,213,109,104
050,35,007,"New Mexico","Colfax County",5,64,196,90,106
050,35,007,"New Mexico","Colfax County",5,65,203,89,114
050,35,007,"New Mexico","Colfax County",5,66,226,103,123
050,35,007,"New Mexico","Colfax County",5,67,228,126,102
050,35,007,"New Mexico","Colfax County",5,68,225,124,101
050,35,007,"New Mexico","Colfax County",5,69,189,100,89
050,35,007,"New Mexico","Colfax County",5,70,217,109,108
050,35,007,"New Mexico","Colfax County",5,71,217,106,111
050,35,007,"New Mexico","Colfax County",5,72,186,94,92
050,35,007,"New Mexico","Colfax County",5,73,159,86,73
050,35,007,"New Mexico","Colfax County",5,74,179,102,77
050,35,007,"New Mexico","Colfax County",5,75,164,78,86
050,35,007,"New Mexico","Colfax County",5,76,182,79,103
050,35,007,"New Mexico","Colfax County",5,77,129,61,68
050,35,007,"New Mexico","Colfax County",5,78,137,68,69
050,35,007,"New Mexico","Colfax County",5,79,127,68,59
050,35,007,"New Mexico","Colfax County",5,80,104,52,52
050,35,007,"New Mexico","Colfax County",5,81,95,42,53
050,35,007,"New Mexico","Colfax County",5,82,91,49,42
050,35,007,"New Mexico","Colfax County",5,83,89,46,43
050,35,007,"New Mexico","Colfax County",5,84,78,38,40
050,35,007,"New Mexico","Colfax County",5,85,381,157,224
050,35,009,"New Mexico","Curry County",1,0,790,405,385
050,35,009,"New Mexico","Curry County",1,1,767,401,366
050,35,009,"New Mexico","Curry County",1,2,769,408,361
050,35,009,"New Mexico","Curry County",1,3,771,387,384
050,35,009,"New Mexico","Curry County",1,4,724,364,360
050,35,009,"New Mexico","Curry County",1,5,748,379,369
050,35,009,"New Mexico","Curry County",1,6,754,376,378
050,35,009,"New Mexico","Curry County",1,7,700,364,336
050,35,009,"New Mexico","Curry County",1,8,711,357,354
050,35,009,"New Mexico","Curry County",1,9,748,375,373
050,35,009,"New Mexico","Curry County",1,10,716,364,352
050,35,009,"New Mexico","Curry County",1,11,745,375,370
050,35,009,"New Mexico","Curry County",1,12,702,357,345
050,35,009,"New Mexico","Curry County",1,13,705,362,343
050,35,009,"New Mexico","Curry County",1,14,680,360,320
050,35,009,"New Mexico","Curry County",1,15,683,351,332
050,35,009,"New Mexico","Curry County",1,16,658,326,332
050,35,009,"New Mexico","Curry County",1,17,609,332,277
050,35,009,"New Mexico","Curry County",1,18,579,317,262
050,35,009,"New Mexico","Curry County",1,19,689,403,286
050,35,009,"New Mexico","Curry County",1,20,827,493,334
050,35,009,"New Mexico","Curry County",1,21,914,562,352
050,35,009,"New Mexico","Curry County",1,22,856,524,332
050,35,009,"New Mexico","Curry County",1,23,850,519,331
050,35,009,"New Mexico","Curry County",1,24,853,493,360
050,35,009,"New Mexico","Curry County",1,25,851,489,362
050,35,009,"New Mexico","Curry County",1,26,898,531,367
050,35,009,"New Mexico","Curry County",1,27,896,507,389
050,35,009,"New Mexico","Curry County",1,28,880,475,405
050,35,009,"New Mexico","Curry County",1,29,856,455,401
050,35,009,"New Mexico","Curry County",1,30,813,413,400
050,35,009,"New Mexico","Curry County",1,31,750,400,350
050,35,009,"New Mexico","Curry County",1,32,746,393,353
050,35,009,"New Mexico","Curry County",1,33,755,392,363
050,35,009,"New Mexico","Curry County",1,34,755,388,367
050,35,009,"New Mexico","Curry County",1,35,689,351,338
050,35,009,"New Mexico","Curry County",1,36,694,361,333
050,35,009,"New Mexico","Curry County",1,37,690,358,332
050,35,009,"New Mexico","Curry County",1,38,613,307,306
050,35,009,"New Mexico","Curry County",1,39,558,289,269
050,35,009,"New Mexico","Curry County",1,40,605,308,297
050,35,009,"New Mexico","Curry County",1,41,519,275,244
050,35,009,"New Mexico","Curry County",1,42,519,280,239
050,35,009,"New Mexico","Curry County",1,43,506,270,236
050,35,009,"New Mexico","Curry County",1,44,477,221,256
050,35,009,"New Mexico","Curry County",1,45,475,224,251
050,35,009,"New Mexico","Curry County",1,46,419,214,205
050,35,009,"New Mexico","Curry County",1,47,442,227,215
050,35,009,"New Mexico","Curry County",1,48,488,244,244
050,35,009,"New Mexico","Curry County",1,49,479,244,235
050,35,009,"New Mexico","Curry County",1,50,433,211,222
050,35,009,"New Mexico","Curry County",1,51,425,208,217
050,35,009,"New Mexico","Curry County",1,52,423,216,207
050,35,009,"New Mexico","Curry County",1,53,458,227,231
050,35,009,"New Mexico","Curry County",1,54,469,226,243
050,35,009,"New Mexico","Curry County",1,55,512,235,277
050,35,009,"New Mexico","Curry County",1,56,515,241,274
050,35,009,"New Mexico","Curry County",1,57,516,247,269
050,35,009,"New Mexico","Curry County",1,58,571,287,284
050,35,009,"New Mexico","Curry County",1,59,528,273,255
050,35,009,"New Mexico","Curry County",1,60,505,246,259
050,35,009,"New Mexico","Curry County",1,61,493,250,243
050,35,009,"New Mexico","Curry County",1,62,522,271,251
050,35,009,"New Mexico","Curry County",1,63,490,246,244
050,35,009,"New Mexico","Curry County",1,64,478,234,244
050,35,009,"New Mexico","Curry County",1,65,451,210,241
050,35,009,"New Mexico","Curry County",1,66,403,200,203
050,35,009,"New Mexico","Curry County",1,67,383,183,200
050,35,009,"New Mexico","Curry County",1,68,358,164,194
050,35,009,"New Mexico","Curry County",1,69,351,168,183
050,35,009,"New Mexico","Curry County",1,70,367,181,186
050,35,009,"New Mexico","Curry County",1,71,340,172,168
050,35,009,"New Mexico","Curry County",1,72,323,149,174
050,35,009,"New Mexico","Curry County",1,73,344,161,183
050,35,009,"New Mexico","Curry County",1,74,253,108,145
050,35,009,"New Mexico","Curry County",1,75,229,98,131
050,35,009,"New Mexico","Curry County",1,76,249,112,137
050,35,009,"New Mexico","Curry County",1,77,226,107,119
050,35,009,"New Mexico","Curry County",1,78,188,81,107
050,35,009,"New Mexico","Curry County",1,79,180,73,107
050,35,009,"New Mexico","Curry County",1,80,179,74,105
050,35,009,"New Mexico","Curry County",1,81,180,77,103
050,35,009,"New Mexico","Curry County",1,82,162,66,96
050,35,009,"New Mexico","Curry County",1,83,154,71,83
050,35,009,"New Mexico","Curry County",1,84,142,56,86
050,35,009,"New Mexico","Curry County",1,85,705,257,448
050,35,009,"New Mexico","Curry County",2,0,803,401,402
050,35,009,"New Mexico","Curry County",2,1,766,398,368
050,35,009,"New Mexico","Curry County",2,2,771,408,363
050,35,009,"New Mexico","Curry County",2,3,761,386,375
050,35,009,"New Mexico","Curry County",2,4,730,367,363
050,35,009,"New Mexico","Curry County",2,5,734,370,364
050,35,009,"New Mexico","Curry County",2,6,748,374,374
050,35,009,"New Mexico","Curry County",2,7,708,362,346
050,35,009,"New Mexico","Curry County",2,8,703,356,347
050,35,009,"New Mexico","Curry County",2,9,737,370,367
050,35,009,"New Mexico","Curry County",2,10,721,367,354
050,35,009,"New Mexico","Curry County",2,11,728,370,358
050,35,009,"New Mexico","Curry County",2,12,711,359,352
050,35,009,"New Mexico","Curry County",2,13,701,358,343
050,35,009,"New Mexico","Curry County",2,14,681,358,323
050,35,009,"New Mexico","Curry County",2,15,681,353,328
050,35,009,"New Mexico","Curry County",2,16,655,329,326
050,35,009,"New Mexico","Curry County",2,17,618,327,291
050,35,009,"New Mexico","Curry County",2,18,581,317,264
050,35,009,"New Mexico","Curry County",2,19,695,409,286
050,35,009,"New Mexico","Curry County",2,20,821,487,334
050,35,009,"New Mexico","Curry County",2,21,903,552,351
050,35,009,"New Mexico","Curry County",2,22,863,525,338
050,35,009,"New Mexico","Curry County",2,23,860,520,340
050,35,009,"New Mexico","Curry County",2,24,848,495,353
050,35,009,"New Mexico","Curry County",2,25,856,496,360
050,35,009,"New Mexico","Curry County",2,26,884,516,368
050,35,009,"New Mexico","Curry County",2,27,891,506,385
050,35,009,"New Mexico","Curry County",2,28,876,477,399
050,35,009,"New Mexico","Curry County",2,29,849,454,395
050,35,009,"New Mexico","Curry County",2,30,818,419,399
050,35,009,"New Mexico","Curry County",2,31,757,397,360
050,35,009,"New Mexico","Curry County",2,32,738,386,352
050,35,009,"New Mexico","Curry County",2,33,748,389,359
050,35,009,"New Mexico","Curry County",2,34,751,388,363
050,35,009,"New Mexico","Curry County",2,35,701,356,345
050,35,009,"New Mexico","Curry County",2,36,686,355,331
050,35,009,"New Mexico","Curry County",2,37,682,354,328
050,35,009,"New Mexico","Curry County",2,38,626,316,310
050,35,009,"New Mexico","Curry County",2,39,563,287,276
050,35,009,"New Mexico","Curry County",2,40,585,300,285
050,35,009,"New Mexico","Curry County",2,41,535,283,252
050,35,009,"New Mexico","Curry County",2,42,513,277,236
050,35,009,"New Mexico","Curry County",2,43,503,267,236
050,35,009,"New Mexico","Curry County",2,44,482,233,249
050,35,009,"New Mexico","Curry County",2,45,471,221,250
050,35,009,"New Mexico","Curry County",2,46,429,217,212
050,35,009,"New Mexico","Curry County",2,47,435,222,213
050,35,009,"New Mexico","Curry County",2,48,472,238,234
050,35,009,"New Mexico","Curry County",2,49,477,242,235
050,35,009,"New Mexico","Curry County",2,50,446,221,225
050,35,009,"New Mexico","Curry County",2,51,423,207,216
050,35,009,"New Mexico","Curry County",2,52,425,216,209
050,35,009,"New Mexico","Curry County",2,53,446,221,225
050,35,009,"New Mexico","Curry County",2,54,461,222,239
050,35,009,"New Mexico","Curry County",2,55,501,232,269
050,35,009,"New Mexico","Curry County",2,56,515,238,277
050,35,009,"New Mexico","Curry County",2,57,511,242,269
050,35,009,"New Mexico","Curry County",2,58,557,278,279
050,35,009,"New Mexico","Curry County",2,59,539,276,263
050,35,009,"New Mexico","Curry County",2,60,510,252,258
050,35,009,"New Mexico","Curry County",2,61,494,247,247
050,35,009,"New Mexico","Curry County",2,62,507,262,245
050,35,009,"New Mexico","Curry County",2,63,499,254,245
050,35,009,"New Mexico","Curry County",2,64,476,236,240
050,35,009,"New Mexico","Curry County",2,65,458,216,242
050,35,009,"New Mexico","Curry County",2,66,414,201,213
050,35,009,"New Mexico","Curry County",2,67,387,187,200
050,35,009,"New Mexico","Curry County",2,68,363,167,196
050,35,009,"New Mexico","Curry County",2,69,352,165,187
050,35,009,"New Mexico","Curry County",2,70,358,176,182
050,35,009,"New Mexico","Curry County",2,71,345,173,172
050,35,009,"New Mexico","Curry County",2,72,324,154,170
050,35,009,"New Mexico","Curry County",2,73,348,162,186
050,35,009,"New Mexico","Curry County",2,74,258,113,145
050,35,009,"New Mexico","Curry County",2,75,231,100,131
050,35,009,"New Mexico","Curry County",2,76,242,109,133
050,35,009,"New Mexico","Curry County",2,77,230,109,121
050,35,009,"New Mexico","Curry County",2,78,194,85,109
050,35,009,"New Mexico","Curry County",2,79,181,73,108
050,35,009,"New Mexico","Curry County",2,80,169,65,104
050,35,009,"New Mexico","Curry County",2,81,179,75,104
050,35,009,"New Mexico","Curry County",2,82,166,68,98
050,35,009,"New Mexico","Curry County",2,83,151,68,83
050,35,009,"New Mexico","Curry County",2,84,142,60,82
050,35,009,"New Mexico","Curry County",2,85,712,259,453
050,35,009,"New Mexico","Curry County",3,0,764,391,373
050,35,009,"New Mexico","Curry County",3,1,772,387,385
050,35,009,"New Mexico","Curry County",3,2,776,399,377
050,35,009,"New Mexico","Curry County",3,3,762,423,339
050,35,009,"New Mexico","Curry County",3,4,748,396,352
050,35,009,"New Mexico","Curry County",3,5,692,359,333
050,35,009,"New Mexico","Curry County",3,6,713,373,340
050,35,009,"New Mexico","Curry County",3,7,740,369,371
050,35,009,"New Mexico","Curry County",3,8,708,345,363
050,35,009,"New Mexico","Curry County",3,9,700,356,344
050,35,009,"New Mexico","Curry County",3,10,700,354,346
050,35,009,"New Mexico","Curry County",3,11,697,351,346
050,35,009,"New Mexico","Curry County",3,12,714,369,345
050,35,009,"New Mexico","Curry County",3,13,686,353,333
050,35,009,"New Mexico","Curry County",3,14,691,370,321
050,35,009,"New Mexico","Curry County",3,15,671,337,334
050,35,009,"New Mexico","Curry County",3,16,681,356,325
050,35,009,"New Mexico","Curry County",3,17,644,323,321
050,35,009,"New Mexico","Curry County",3,18,585,315,270
050,35,009,"New Mexico","Curry County",3,19,651,381,270
050,35,009,"New Mexico","Curry County",3,20,761,448,313
050,35,009,"New Mexico","Curry County",3,21,857,516,341
050,35,009,"New Mexico","Curry County",3,22,875,536,339
050,35,009,"New Mexico","Curry County",3,23,853,489,364
050,35,009,"New Mexico","Curry County",3,24,856,518,338
050,35,009,"New Mexico","Curry County",3,25,841,483,358
050,35,009,"New Mexico","Curry County",3,26,862,495,367
050,35,009,"New Mexico","Curry County",3,27,870,500,370
050,35,009,"New Mexico","Curry County",3,28,871,488,383
050,35,009,"New Mexico","Curry County",3,29,838,444,394
050,35,009,"New Mexico","Curry County",3,30,827,443,384
050,35,009,"New Mexico","Curry County",3,31,809,417,392
050,35,009,"New Mexico","Curry County",3,32,739,374,365
050,35,009,"New Mexico","Curry County",3,33,703,373,330
050,35,009,"New Mexico","Curry County",3,34,734,385,349
050,35,009,"New Mexico","Curry County",3,35,708,362,346
050,35,009,"New Mexico","Curry County",3,36,678,348,330
050,35,009,"New Mexico","Curry County",3,37,667,349,318
050,35,009,"New Mexico","Curry County",3,38,660,340,320
050,35,009,"New Mexico","Curry County",3,39,601,307,294
050,35,009,"New Mexico","Curry County",3,40,535,272,263
050,35,009,"New Mexico","Curry County",3,41,562,291,271
050,35,009,"New Mexico","Curry County",3,42,548,293,255
050,35,009,"New Mexico","Curry County",3,43,498,260,238
050,35,009,"New Mexico","Curry County",3,44,471,249,222
050,35,009,"New Mexico","Curry County",3,45,449,215,234
050,35,009,"New Mexico","Curry County",3,46,468,213,255
050,35,009,"New Mexico","Curry County",3,47,419,209,210
050,35,009,"New Mexico","Curry County",3,48,419,214,205
050,35,009,"New Mexico","Curry County",3,49,460,233,227
050,35,009,"New Mexico","Curry County",3,50,475,243,232
050,35,009,"New Mexico","Curry County",3,51,439,218,221
050,35,009,"New Mexico","Curry County",3,52,418,205,213
050,35,009,"New Mexico","Curry County",3,53,413,208,205
050,35,009,"New Mexico","Curry County",3,54,433,212,221
050,35,009,"New Mexico","Curry County",3,55,450,217,233
050,35,009,"New Mexico","Curry County",3,56,488,224,264
050,35,009,"New Mexico","Curry County",3,57,485,219,266
050,35,009,"New Mexico","Curry County",3,58,489,235,254
050,35,009,"New Mexico","Curry County",3,59,542,266,276
050,35,009,"New Mexico","Curry County",3,60,527,257,270
050,35,009,"New Mexico","Curry County",3,61,493,250,243
050,35,009,"New Mexico","Curry County",3,62,465,231,234
050,35,009,"New Mexico","Curry County",3,63,498,256,242
050,35,009,"New Mexico","Curry County",3,64,485,247,238
050,35,009,"New Mexico","Curry County",3,65,449,222,227
050,35,009,"New Mexico","Curry County",3,66,440,204,236
050,35,009,"New Mexico","Curry County",3,67,407,193,214
050,35,009,"New Mexico","Curry County",3,68,379,181,198
050,35,009,"New Mexico","Curry County",3,69,355,167,188
050,35,009,"New Mexico","Curry County",3,70,345,155,190
050,35,009,"New Mexico","Curry County",3,71,345,168,177
050,35,009,"New Mexico","Curry County",3,72,342,169,173
050,35,009,"New Mexico","Curry County",3,73,310,152,158
050,35,009,"New Mexico","Curry County",3,74,337,159,178
050,35,009,"New Mexico","Curry County",3,75,246,112,134
050,35,009,"New Mexico","Curry County",3,76,225,98,127
050,35,009,"New Mexico","Curry County",3,77,227,99,128
050,35,009,"New Mexico","Curry County",3,78,218,103,115
050,35,009,"New Mexico","Curry County",3,79,181,78,103
050,35,009,"New Mexico","Curry County",3,80,170,73,97
050,35,009,"New Mexico","Curry County",3,81,160,59,101
050,35,009,"New Mexico","Curry County",3,82,153,66,87
050,35,009,"New Mexico","Curry County",3,83,163,68,95
050,35,009,"New Mexico","Curry County",3,84,139,58,81
050,35,009,"New Mexico","Curry County",3,85,711,254,457
050,35,009,"New Mexico","Curry County",4,0,772,373,399
050,35,009,"New Mexico","Curry County",4,1,709,365,344
050,35,009,"New Mexico","Curry County",4,2,758,381,377
050,35,009,"New Mexico","Curry County",4,3,758,392,366
050,35,009,"New Mexico","Curry County",4,4,722,390,332
050,35,009,"New Mexico","Curry County",4,5,703,363,340
050,35,009,"New Mexico","Curry County",4,6,678,352,326
050,35,009,"New Mexico","Curry County",4,7,688,363,325
050,35,009,"New Mexico","Curry County",4,8,713,369,344
050,35,009,"New Mexico","Curry County",4,9,700,335,365
050,35,009,"New Mexico","Curry County",4,10,667,335,332
050,35,009,"New Mexico","Curry County",4,11,685,344,341
050,35,009,"New Mexico","Curry County",4,12,686,340,346
050,35,009,"New Mexico","Curry County",4,13,713,363,350
050,35,009,"New Mexico","Curry County",4,14,686,355,331
050,35,009,"New Mexico","Curry County",4,15,684,356,328
050,35,009,"New Mexico","Curry County",4,16,660,342,318
050,35,009,"New Mexico","Curry County",4,17,660,328,332
050,35,009,"New Mexico","Curry County",4,18,605,316,289
050,35,009,"New Mexico","Curry County",4,19,672,403,269
050,35,009,"New Mexico","Curry County",4,20,751,449,302
050,35,009,"New Mexico","Curry County",4,21,824,498,326
050,35,009,"New Mexico","Curry County",4,22,847,496,351
050,35,009,"New Mexico","Curry County",4,23,884,542,342
050,35,009,"New Mexico","Curry County",4,24,811,461,350
050,35,009,"New Mexico","Curry County",4,25,837,478,359
050,35,009,"New Mexico","Curry County",4,26,831,474,357
050,35,009,"New Mexico","Curry County",4,27,863,503,360
050,35,009,"New Mexico","Curry County",4,28,834,467,367
050,35,009,"New Mexico","Curry County",4,29,870,472,398
050,35,009,"New Mexico","Curry County",4,30,795,421,374
050,35,009,"New Mexico","Curry County",4,31,791,423,368
050,35,009,"New Mexico","Curry County",4,32,785,399,386
050,35,009,"New Mexico","Curry County",4,33,699,362,337
050,35,009,"New Mexico","Curry County",4,34,688,378,310
050,35,009,"New Mexico","Curry County",4,35,680,345,335
050,35,009,"New Mexico","Curry County",4,36,683,357,326
050,35,009,"New Mexico","Curry County",4,37,660,338,322
050,35,009,"New Mexico","Curry County",4,38,644,335,309
050,35,009,"New Mexico","Curry County",4,39,625,327,298
050,35,009,"New Mexico","Curry County",4,40,567,292,275
050,35,009,"New Mexico","Curry County",4,41,510,258,252
050,35,009,"New Mexico","Curry County",4,42,545,293,252
050,35,009,"New Mexico","Curry County",4,43,533,285,248
050,35,009,"New Mexico","Curry County",4,44,493,251,242
050,35,009,"New Mexico","Curry County",4,45,464,241,223
050,35,009,"New Mexico","Curry County",4,46,442,213,229
050,35,009,"New Mexico","Curry County",4,47,462,214,248
050,35,009,"New Mexico","Curry County",4,48,419,213,206
050,35,009,"New Mexico","Curry County",4,49,396,202,194
050,35,009,"New Mexico","Curry County",4,50,466,235,231
050,35,009,"New Mexico","Curry County",4,51,472,241,231
050,35,009,"New Mexico","Curry County",4,52,424,210,214
050,35,009,"New Mexico","Curry County",4,53,412,196,216
050,35,009,"New Mexico","Curry County",4,54,416,206,210
050,35,009,"New Mexico","Curry County",4,55,412,204,208
050,35,009,"New Mexico","Curry County",4,56,443,215,228
050,35,009,"New Mexico","Curry County",4,57,466,213,253
050,35,009,"New Mexico","Curry County",4,58,468,214,254
050,35,009,"New Mexico","Curry County",4,59,464,225,239
050,35,009,"New Mexico","Curry County",4,60,529,263,266
050,35,009,"New Mexico","Curry County",4,61,516,254,262
050,35,009,"New Mexico","Curry County",4,62,483,242,241
050,35,009,"New Mexico","Curry County",4,63,443,210,233
050,35,009,"New Mexico","Curry County",4,64,484,249,235
050,35,009,"New Mexico","Curry County",4,65,463,231,232
050,35,009,"New Mexico","Curry County",4,66,432,210,222
050,35,009,"New Mexico","Curry County",4,67,437,203,234
050,35,009,"New Mexico","Curry County",4,68,392,181,211
050,35,009,"New Mexico","Curry County",4,69,362,173,189
050,35,009,"New Mexico","Curry County",4,70,337,154,183
050,35,009,"New Mexico","Curry County",4,71,334,151,183
050,35,009,"New Mexico","Curry County",4,72,340,164,176
050,35,009,"New Mexico","Curry County",4,73,335,165,170
050,35,009,"New Mexico","Curry County",4,74,291,141,150
050,35,009,"New Mexico","Curry County",4,75,324,149,175
050,35,009,"New Mexico","Curry County",4,76,242,106,136
050,35,009,"New Mexico","Curry County",4,77,209,91,118
050,35,009,"New Mexico","Curry County",4,78,215,93,122
050,35,009,"New Mexico","Curry County",4,79,211,100,111
050,35,009,"New Mexico","Curry County",4,80,170,77,93
050,35,009,"New Mexico","Curry County",4,81,163,64,99
050,35,009,"New Mexico","Curry County",4,82,142,54,88
050,35,009,"New Mexico","Curry County",4,83,142,61,81
050,35,009,"New Mexico","Curry County",4,84,142,56,86
050,35,009,"New Mexico","Curry County",4,85,697,253,444
050,35,009,"New Mexico","Curry County",5,0,744,354,390
050,35,009,"New Mexico","Curry County",5,1,750,344,406
050,35,009,"New Mexico","Curry County",5,2,699,329,370
050,35,009,"New Mexico","Curry County",5,3,739,372,367
050,35,009,"New Mexico","Curry County",5,4,713,359,354
050,35,009,"New Mexico","Curry County",5,5,735,385,350
050,35,009,"New Mexico","Curry County",5,6,706,365,341
050,35,009,"New Mexico","Curry County",5,7,659,334,325
050,35,009,"New Mexico","Curry County",5,8,695,365,330
050,35,009,"New Mexico","Curry County",5,9,694,349,345
050,35,009,"New Mexico","Curry County",5,10,683,336,347
050,35,009,"New Mexico","Curry County",5,11,663,330,333
050,35,009,"New Mexico","Curry County",5,12,658,321,337
050,35,009,"New Mexico","Curry County",5,13,655,322,333
050,35,009,"New Mexico","Curry County",5,14,683,353,330
050,35,009,"New Mexico","Curry County",5,15,665,345,320
050,35,009,"New Mexico","Curry County",5,16,676,351,325
050,35,009,"New Mexico","Curry County",5,17,664,338,326
050,35,009,"New Mexico","Curry County",5,18,603,316,287
050,35,009,"New Mexico","Curry County",5,19,678,381,297
050,35,009,"New Mexico","Curry County",5,20,816,506,310
050,35,009,"New Mexico","Curry County",5,21,829,493,336
050,35,009,"New Mexico","Curry County",5,22,818,482,336
050,35,009,"New Mexico","Curry County",5,23,873,519,354
050,35,009,"New Mexico","Curry County",5,24,914,562,352
050,35,009,"New Mexico","Curry County",5,25,808,447,361
050,35,009,"New Mexico","Curry County",5,26,813,472,341
050,35,009,"New Mexico","Curry County",5,27,848,485,363
050,35,009,"New Mexico","Curry County",5,28,853,478,375
050,35,009,"New Mexico","Curry County",5,29,825,455,370
050,35,009,"New Mexico","Curry County",5,30,823,466,357
050,35,009,"New Mexico","Curry County",5,31,760,389,371
050,35,009,"New Mexico","Curry County",5,32,768,408,360
050,35,009,"New Mexico","Curry County",5,33,753,397,356
050,35,009,"New Mexico","Curry County",5,34,699,370,329
050,35,009,"New Mexico","Curry County",5,35,652,355,297
050,35,009,"New Mexico","Curry County",5,36,672,344,328
050,35,009,"New Mexico","Curry County",5,37,659,351,308
050,35,009,"New Mexico","Curry County",5,38,647,326,321
050,35,009,"New Mexico","Curry County",5,39,650,333,317
050,35,009,"New Mexico","Curry County",5,40,612,323,289
050,35,009,"New Mexico","Curry County",5,41,556,281,275
050,35,009,"New Mexico","Curry County",5,42,480,231,249
050,35,009,"New Mexico","Curry County",5,43,518,265,253
050,35,009,"New Mexico","Curry County",5,44,509,268,241
050,35,009,"New Mexico","Curry County",5,45,466,234,232
050,35,009,"New Mexico","Curry County",5,46,463,244,219
050,35,009,"New Mexico","Curry County",5,47,431,202,229
050,35,009,"New Mexico","Curry County",5,48,454,213,241
050,35,009,"New Mexico","Curry County",5,49,384,198,186
050,35,009,"New Mexico","Curry County",5,50,390,195,195
050,35,009,"New Mexico","Curry County",5,51,445,223,222
050,35,009,"New Mexico","Curry County",5,52,475,241,234
050,35,009,"New Mexico","Curry County",5,53,407,193,214
050,35,009,"New Mexico","Curry County",5,54,403,189,214
050,35,009,"New Mexico","Curry County",5,55,404,204,200
050,35,009,"New Mexico","Curry County",5,56,411,201,210
050,35,009,"New Mexico","Curry County",5,57,431,210,221
050,35,009,"New Mexico","Curry County",5,58,454,210,244
050,35,009,"New Mexico","Curry County",5,59,463,210,253
050,35,009,"New Mexico","Curry County",5,60,446,213,233
050,35,009,"New Mexico","Curry County",5,61,517,259,258
050,35,009,"New Mexico","Curry County",5,62,494,239,255
050,35,009,"New Mexico","Curry County",5,63,465,231,234
050,35,009,"New Mexico","Curry County",5,64,433,202,231
050,35,009,"New Mexico","Curry County",5,65,467,239,228
050,35,009,"New Mexico","Curry County",5,66,452,222,230
050,35,009,"New Mexico","Curry County",5,67,426,208,218
050,35,009,"New Mexico","Curry County",5,68,418,195,223
050,35,009,"New Mexico","Curry County",5,69,377,176,201
050,35,009,"New Mexico","Curry County",5,70,341,156,185
050,35,009,"New Mexico","Curry County",5,71,326,148,178
050,35,009,"New Mexico","Curry County",5,72,327,148,179
050,35,009,"New Mexico","Curry County",5,73,326,160,166
050,35,009,"New Mexico","Curry County",5,74,314,158,156
050,35,009,"New Mexico","Curry County",5,75,282,134,148
050,35,009,"New Mexico","Curry County",5,76,317,144,173
050,35,009,"New Mexico","Curry County",5,77,226,98,128
050,35,009,"New Mexico","Curry County",5,78,195,83,112
050,35,009,"New Mexico","Curry County",5,79,201,88,113
050,35,009,"New Mexico","Curry County",5,80,206,100,106
050,35,009,"New Mexico","Curry County",5,81,154,67,87
050,35,009,"New Mexico","Curry County",5,82,150,59,91
050,35,009,"New Mexico","Curry County",5,83,134,51,83
050,35,009,"New Mexico","Curry County",5,84,121,46,75
050,35,009,"New Mexico","Curry County",5,85,709,258,451
050,35,011,"New Mexico","De Baca County",1,0,10,5,5
050,35,011,"New Mexico","De Baca County",1,1,10,2,8
050,35,011,"New Mexico","De Baca County",1,2,11,5,6
050,35,011,"New Mexico","De Baca County",1,3,17,9,8
050,35,011,"New Mexico","De Baca County",1,4,14,6,8
050,35,011,"New Mexico","De Baca County",1,5,18,7,11
050,35,011,"New Mexico","De Baca County",1,6,18,7,11
050,35,011,"New Mexico","De Baca County",1,7,22,11,11
050,35,011,"New Mexico","De Baca County",1,8,23,16,7
050,35,011,"New Mexico","De Baca County",1,9,24,16,8
050,35,011,"New Mexico","De Baca County",1,10,30,13,17
050,35,011,"New Mexico","De Baca County",1,11,27,9,18
050,35,011,"New Mexico","De Baca County",1,12,20,13,7
050,35,011,"New Mexico","De Baca County",1,13,21,12,9
050,35,011,"New Mexico","De Baca County",1,14,18,9,9
050,35,011,"New Mexico","De Baca County",1,15,26,14,12
050,35,011,"New Mexico","De Baca County",1,16,19,8,11
050,35,011,"New Mexico","De Baca County",1,17,24,11,13
050,35,011,"New Mexico","De Baca County",1,18,21,14,7
050,35,011,"New Mexico","De Baca County",1,19,18,12,6
050,35,011,"New Mexico","De Baca County",1,20,21,9,12
050,35,011,"New Mexico","De Baca County",1,21,14,7,7
050,35,011,"New Mexico","De Baca County",1,22,13,7,6
050,35,011,"New Mexico","De Baca County",1,23,11,7,4
050,35,011,"New Mexico","De Baca County",1,24,6,4,2
050,35,011,"New Mexico","De Baca County",1,25,14,10,4
050,35,011,"New Mexico","De Baca County",1,26,19,11,8
050,35,011,"New Mexico","De Baca County",1,27,17,8,9
050,35,011,"New Mexico","De Baca County",1,28,15,10,5
050,35,011,"New Mexico","De Baca County",1,29,7,4,3
050,35,011,"New Mexico","De Baca County",1,30,9,4,5
050,35,011,"New Mexico","De Baca County",1,31,12,5,7
050,35,011,"New Mexico","De Baca County",1,32,14,7,7
050,35,011,"New Mexico","De Baca County",1,33,14,7,7
050,35,011,"New Mexico","De Baca County",1,34,10,3,7
050,35,011,"New Mexico","De Baca County",1,35,14,9,5
050,35,011,"New Mexico","De Baca County",1,36,23,13,10
050,35,011,"New Mexico","De Baca County",1,37,19,12,7
050,35,011,"New Mexico","De Baca County",1,38,30,20,10
050,35,011,"New Mexico","De Baca County",1,39,25,12,13
050,35,011,"New Mexico","De Baca County",1,40,17,7,10
050,35,011,"New Mexico","De Baca County",1,41,11,6,5
050,35,011,"New Mexico","De Baca County",1,42,17,8,9
050,35,011,"New Mexico","De Baca County",1,43,16,6,10
050,35,011,"New Mexico","De Baca County",1,44,14,7,7
050,35,011,"New Mexico","De Baca County",1,45,11,6,5
050,35,011,"New Mexico","De Baca County",1,46,18,9,9
050,35,011,"New Mexico","De Baca County",1,47,15,5,10
050,35,011,"New Mexico","De Baca County",1,48,17,8,9
050,35,011,"New Mexico","De Baca County",1,49,14,8,6
050,35,011,"New Mexico","De Baca County",1,50,17,10,7
050,35,011,"New Mexico","De Baca County",1,51,20,11,9
050,35,011,"New Mexico","De Baca County",1,52,14,5,9
050,35,011,"New Mexico","De Baca County",1,53,17,9,8
050,35,011,"New Mexico","De Baca County",1,54,19,9,10
050,35,011,"New Mexico","De Baca County",1,55,25,17,8
050,35,011,"New Mexico","De Baca County",1,56,20,13,7
050,35,011,"New Mexico","De Baca County",1,57,26,12,14
050,35,011,"New Mexico","De Baca County",1,58,29,13,16
050,35,011,"New Mexico","De Baca County",1,59,29,16,13
050,35,011,"New Mexico","De Baca County",1,60,25,14,11
050,35,011,"New Mexico","De Baca County",1,61,26,12,14
050,35,011,"New Mexico","De Baca County",1,62,22,7,15
050,35,011,"New Mexico","De Baca County",1,63,28,11,17
050,35,011,"New Mexico","De Baca County",1,64,31,17,14
050,35,011,"New Mexico","De Baca County",1,65,24,10,14
050,35,011,"New Mexico","De Baca County",1,66,29,16,13
050,35,011,"New Mexico","De Baca County",1,67,31,18,13
050,35,011,"New Mexico","De Baca County",1,68,22,15,7
050,35,011,"New Mexico","De Baca County",1,69,38,26,12
050,35,011,"New Mexico","De Baca County",1,70,32,19,13
050,35,011,"New Mexico","De Baca County",1,71,30,15,15
050,35,011,"New Mexico","De Baca County",1,72,15,4,11
050,35,011,"New Mexico","De Baca County",1,73,30,15,15
050,35,011,"New Mexico","De Baca County",1,74,33,17,16
050,35,011,"New Mexico","De Baca County",1,75,25,8,17
050,35,011,"New Mexico","De Baca County",1,76,22,9,13
050,35,011,"New Mexico","De Baca County",1,77,20,9,11
050,35,011,"New Mexico","De Baca County",1,78,17,10,7
050,35,011,"New Mexico","De Baca County",1,79,13,4,9
050,35,011,"New Mexico","De Baca County",1,80,10,3,7
050,35,011,"New Mexico","De Baca County",1,81,11,6,5
050,35,011,"New Mexico","De Baca County",1,82,11,4,7
050,35,011,"New Mexico","De Baca County",1,83,11,6,5
050,35,011,"New Mexico","De Baca County",1,84,10,8,2
050,35,011,"New Mexico","De Baca County",1,85,65,24,41
050,35,011,"New Mexico","De Baca County",2,0,12,6,6
050,35,011,"New Mexico","De Baca County",2,1,11,3,8
050,35,011,"New Mexico","De Baca County",2,2,11,5,6
050,35,011,"New Mexico","De Baca County",2,3,15,8,7
050,35,011,"New Mexico","De Baca County",2,4,15,7,8
050,35,011,"New Mexico","De Baca County",2,5,18,7,11
050,35,011,"New Mexico","De Baca County",2,6,16,6,10
050,35,011,"New Mexico","De Baca County",2,7,20,10,10
050,35,011,"New Mexico","De Baca County",2,8,22,14,8
050,35,011,"New Mexico","De Baca County",2,9,24,16,8
050,35,011,"New Mexico","De Baca County",2,10,27,13,14
050,35,011,"New Mexico","De Baca County",2,11,27,10,17
050,35,011,"New Mexico","De Baca County",2,12,23,13,10
050,35,011,"New Mexico","De Baca County",2,13,20,12,8
050,35,011,"New Mexico","De Baca County",2,14,19,10,9
050,35,011,"New Mexico","De Baca County",2,15,23,12,11
050,35,011,"New Mexico","De Baca County",2,16,20,9,11
050,35,011,"New Mexico","De Baca County",2,17,23,11,12
050,35,011,"New Mexico","De Baca County",2,18,20,12,8
050,35,011,"New Mexico","De Baca County",2,19,19,13,6
050,35,011,"New Mexico","De Baca County",2,20,23,11,12
050,35,011,"New Mexico","De Baca County",2,21,16,7,9
050,35,011,"New Mexico","De Baca County",2,22,13,7,6
050,35,011,"New Mexico","De Baca County",2,23,12,8,4
050,35,011,"New Mexico","De Baca County",2,24,7,5,2
050,35,011,"New Mexico","De Baca County",2,25,13,9,4
050,35,011,"New Mexico","De Baca County",2,26,19,12,7
050,35,011,"New Mexico","De Baca County",2,27,18,9,9
050,35,011,"New Mexico","De Baca County",2,28,15,9,6
050,35,011,"New Mexico","De Baca County",2,29,8,5,3
050,35,011,"New Mexico","De Baca County",2,30,9,4,5
050,35,011,"New Mexico","De Baca County",2,31,10,4,6
050,35,011,"New Mexico","De Baca County",2,32,14,7,7
050,35,011,"New Mexico","De Baca County",2,33,14,7,7
050,35,011,"New Mexico","De Baca County",2,34,10,4,6
050,35,011,"New Mexico","De Baca County",2,35,12,7,5
050,35,011,"New Mexico","De Baca County",2,36,20,11,9
050,35,011,"New Mexico","De Baca County",2,37,19,11,8
050,35,011,"New Mexico","De Baca County",2,38,27,18,9
050,35,011,"New Mexico","De Baca County",2,39,24,13,11
050,35,011,"New Mexico","De Baca County",2,40,19,8,11
050,35,011,"New Mexico","De Baca County",2,41,11,5,6
050,35,011,"New Mexico","De Baca County",2,42,15,7,8
050,35,011,"New Mexico","De Baca County",2,43,17,7,10
050,35,011,"New Mexico","De Baca County",2,44,13,6,7
050,35,011,"New Mexico","De Baca County",2,45,12,6,6
050,35,011,"New Mexico","De Baca County",2,46,16,8,8
050,35,011,"New Mexico","De Baca County",2,47,15,5,10
050,35,011,"New Mexico","De Baca County",2,48,17,8,9
050,35,011,"New Mexico","De Baca County",2,49,13,7,6
050,35,011,"New Mexico","De Baca County",2,50,16,10,6
050,35,011,"New Mexico","De Baca County",2,51,20,11,9
050,35,011,"New Mexico","De Baca County",2,52,16,7,9
050,35,011,"New Mexico","De Baca County",2,53,16,8,8
050,35,011,"New Mexico","De Baca County",2,54,18,9,9
050,35,011,"New Mexico","De Baca County",2,55,24,15,9
050,35,011,"New Mexico","De Baca County",2,56,21,14,7
050,35,011,"New Mexico","De Baca County",2,57,25,12,13
050,35,011,"New Mexico","De Baca County",2,58,29,13,16
050,35,011,"New Mexico","De Baca County",2,59,29,15,14
050,35,011,"New Mexico","De Baca County",2,60,27,15,12
050,35,011,"New Mexico","De Baca County",2,61,25,12,13
050,35,011,"New Mexico","De Baca County",2,62,21,8,13
050,35,011,"New Mexico","De Baca County",2,63,28,12,16
050,35,011,"New Mexico","De Baca County",2,64,29,15,14
050,35,011,"New Mexico","De Baca County",2,65,26,12,14
050,35,011,"New Mexico","De Baca County",2,66,29,15,14
050,35,011,"New Mexico","De Baca County",2,67,31,18,13
050,35,011,"New Mexico","De Baca County",2,68,23,15,8
050,35,011,"New Mexico","De Baca County",2,69,33,22,11
050,35,011,"New Mexico","De Baca County",2,70,34,21,13
050,35,011,"New Mexico","De Baca County",2,71,32,17,15
050,35,011,"New Mexico","De Baca County",2,72,18,6,12
050,35,011,"New Mexico","De Baca County",2,73,27,13,14
050,35,011,"New Mexico","De Baca County",2,74,30,15,15
050,35,011,"New Mexico","De Baca County",2,75,26,10,16
050,35,011,"New Mexico","De Baca County",2,76,22,8,14
050,35,011,"New Mexico","De Baca County",2,77,21,9,12
050,35,011,"New Mexico","De Baca County",2,78,18,10,8
050,35,011,"New Mexico","De Baca County",2,79,13,5,8
050,35,011,"New Mexico","De Baca County",2,80,10,3,7
050,35,011,"New Mexico","De Baca County",2,81,10,5,5
050,35,011,"New Mexico","De Baca County",2,82,11,4,7
050,35,011,"New Mexico","De Baca County",2,83,12,6,6
050,35,011,"New Mexico","De Baca County",2,84,11,8,3
050,35,011,"New Mexico","De Baca County",2,85,64,23,41
050,35,011,"New Mexico","De Baca County",3,0,15,9,6
050,35,011,"New Mexico","De Baca County",3,1,12,6,6
050,35,011,"New Mexico","De Baca County",3,2,12,4,8
050,35,011,"New Mexico","De Baca County",3,3,13,7,6
050,35,011,"New Mexico","De Baca County",3,4,15,8,7
050,35,011,"New Mexico","De Baca County",3,5,14,6,8
050,35,011,"New Mexico","De Baca County",3,6,20,9,11
050,35,011,"New Mexico","De Baca County",3,7,17,6,11
050,35,011,"New Mexico","De Baca County",3,8,21,10,11
050,35,011,"New Mexico","De Baca County",3,9,23,15,8
050,35,011,"New Mexico","De Baca County",3,10,24,15,9
050,35,011,"New Mexico","De Baca County",3,11,29,14,15
050,35,011,"New Mexico","De Baca County",3,12,27,10,17
050,35,011,"New Mexico","De Baca County",3,13,26,13,13
050,35,011,"New Mexico","De Baca County",3,14,19,11,8
050,35,011,"New Mexico","De Baca County",3,15,19,11,8
050,35,011,"New Mexico","De Baca County",3,16,19,10,9
050,35,011,"New Mexico","De Baca County",3,17,20,9,11
050,35,011,"New Mexico","De Baca County",3,18,22,11,11
050,35,011,"New Mexico","De Baca County",3,19,18,10,8
050,35,011,"New Mexico","De Baca County",3,20,19,12,7
050,35,011,"New Mexico","De Baca County",3,21,22,9,13
050,35,011,"New Mexico","De Baca County",3,22,18,10,8
050,35,011,"New Mexico","De Baca County",3,23,15,7,8
050,35,011,"New Mexico","De Baca County",3,24,11,6,5
050,35,011,"New Mexico","De Baca County",3,25,8,6,2
050,35,011,"New Mexico","De Baca County",3,26,13,8,5
050,35,011,"New Mexico","De Baca County",3,27,20,12,8
050,35,011,"New Mexico","De Baca County",3,28,16,7,9
050,35,011,"New Mexico","De Baca County",3,29,13,7,6
050,35,011,"New Mexico","De Baca County",3,30,8,5,3
050,35,011,"New Mexico","De Baca County",3,31,10,5,5
050,35,011,"New Mexico","De Baca County",3,32,13,7,6
050,35,011,"New Mexico","De Baca County",3,33,16,7,9
050,35,011,"New Mexico","De Baca County",3,34,16,8,8
050,35,011,"New Mexico","De Baca County",3,35,10,4,6
050,35,011,"New Mexico","De Baca County",3,36,13,8,5
050,35,011,"New Mexico","De Baca County",3,37,20,13,7
050,35,011,"New Mexico","De Baca County",3,38,20,11,9
050,35,011,"New Mexico","De Baca County",3,39,24,14,10
050,35,011,"New Mexico","De Baca County",3,40,24,13,11
050,35,011,"New Mexico","De Baca County",3,41,19,8,11
050,35,011,"New Mexico","De Baca County",3,42,13,5,8
050,35,011,"New Mexico","De Baca County",3,43,14,7,7
050,35,011,"New Mexico","De Baca County",3,44,13,3,10
050,35,011,"New Mexico","De Baca County",3,45,13,6,7
050,35,011,"New Mexico","De Baca County",3,46,12,6,6
050,35,011,"New Mexico","De Baca County",3,47,17,9,8
050,35,011,"New Mexico","De Baca County",3,48,16,5,11
050,35,011,"New Mexico","De Baca County",3,49,19,10,9
050,35,011,"New Mexico","De Baca County",3,50,13,7,6
050,35,011,"New Mexico","De Baca County",3,51,15,10,5
050,35,011,"New Mexico","De Baca County",3,52,20,11,9
050,35,011,"New Mexico","De Baca County",3,53,17,8,9
050,35,011,"New Mexico","De Baca County",3,54,15,7,8
050,35,011,"New Mexico","De Baca County",3,55,17,9,8
050,35,011,"New Mexico","De Baca County",3,56,24,15,9
050,35,011,"New Mexico","De Baca County",3,57,22,15,7
050,35,011,"New Mexico","De Baca County",3,58,27,13,14
050,35,011,"New Mexico","De Baca County",3,59,28,12,16
050,35,011,"New Mexico","De Baca County",3,60,28,14,14
050,35,011,"New Mexico","De Baca County",3,61,28,15,13
050,35,011,"New Mexico","De Baca County",3,62,25,12,13
050,35,011,"New Mexico","De Baca County",3,63,19,6,13
050,35,011,"New Mexico","De Baca County",3,64,28,12,16
050,35,011,"New Mexico","De Baca County",3,65,27,15,12
050,35,011,"New Mexico","De Baca County",3,66,26,12,14
050,35,011,"New Mexico","De Baca County",3,67,29,15,14
050,35,011,"New Mexico","De Baca County",3,68,33,20,13
050,35,011,"New Mexico","De Baca County",3,69,21,14,7
050,35,011,"New Mexico","De Baca County",3,70,32,21,11
050,35,011,"New Mexico","De Baca County",3,71,37,24,13
050,35,011,"New Mexico","De Baca County",3,72,31,16,15
050,35,011,"New Mexico","De Baca County",3,73,18,6,12
050,35,011,"New Mexico","De Baca County",3,74,25,11,14
050,35,011,"New Mexico","De Baca County",3,75,27,15,12
050,35,011,"New Mexico","De Baca County",3,76,26,10,16
050,35,011,"New Mexico","De Baca County",3,77,21,7,14
050,35,011,"New Mexico","De Baca County",3,78,21,9,12
050,35,011,"New Mexico","De Baca County",3,79,17,10,7
050,35,011,"New Mexico","De Baca County",3,80,12,5,7
050,35,011,"New Mexico","De Baca County",3,81,9,3,6
050,35,011,"New Mexico","De Baca County",3,82,10,5,5
050,35,011,"New Mexico","De Baca County",3,83,10,4,6
050,35,011,"New Mexico","De Baca County",3,84,9,3,6
050,35,011,"New Mexico","De Baca County",3,85,62,27,35
050,35,011,"New Mexico","De Baca County",4,0,14,7,7
050,35,011,"New Mexico","De Baca County",4,1,14,9,5
050,35,011,"New Mexico","De Baca County",4,2,12,6,6
050,35,011,"New Mexico","De Baca County",4,3,14,6,8
050,35,011,"New Mexico","De Baca County",4,4,12,6,6
050,35,011,"New Mexico","De Baca County",4,5,17,10,7
050,35,011,"New Mexico","De Baca County",4,6,20,11,9
050,35,011,"New Mexico","De Baca County",4,7,21,9,12
050,35,011,"New Mexico","De Baca County",4,8,18,7,11
050,35,011,"New Mexico","De Baca County",4,9,23,13,10
050,35,011,"New Mexico","De Baca County",4,10,26,17,9
050,35,011,"New Mexico","De Baca County",4,11,24,14,10
050,35,011,"New Mexico","De Baca County",4,12,29,13,16
050,35,011,"New Mexico","De Baca County",4,13,32,11,21
050,35,011,"New Mexico","De Baca County",4,14,26,14,12
050,35,011,"New Mexico","De Baca County",4,15,23,14,9
050,35,011,"New Mexico","De Baca County",4,16,19,12,7
050,35,011,"New Mexico","De Baca County",4,17,22,11,11
050,35,011,"New Mexico","De Baca County",4,18,16,9,7
050,35,011,"New Mexico","De Baca County",4,19,16,8,8
050,35,011,"New Mexico","De Baca County",4,20,17,9,8
050,35,011,"New Mexico","De Baca County",4,21,19,10,9
050,35,011,"New Mexico","De Baca County",4,22,17,7,10
050,35,011,"New Mexico","De Baca County",4,23,16,8,8
050,35,011,"New Mexico","De Baca County",4,24,14,7,7
050,35,011,"New Mexico","De Baca County",4,25,11,6,5
050,35,011,"New Mexico","De Baca County",4,26,7,5,2
050,35,011,"New Mexico","De Baca County",4,27,14,8,6
050,35,011,"New Mexico","De Baca County",4,28,18,13,5
050,35,011,"New Mexico","De Baca County",4,29,15,5,10
050,35,011,"New Mexico","De Baca County",4,30,14,8,6
050,35,011,"New Mexico","De Baca County",4,31,8,6,2
050,35,011,"New Mexico","De Baca County",4,32,13,5,8
050,35,011,"New Mexico","De Baca County",4,33,16,8,8
050,35,011,"New Mexico","De Baca County",4,34,19,8,11
050,35,011,"New Mexico","De Baca County",4,35,15,8,7
050,35,011,"New Mexico","De Baca County",4,36,20,10,10
050,35,011,"New Mexico","De Baca County",4,37,16,10,6
050,35,011,"New Mexico","De Baca County",4,38,22,13,9
050,35,011,"New Mexico","De Baca County",4,39,19,9,10
050,35,011,"New Mexico","De Baca County",4,40,24,15,9
050,35,011,"New Mexico","De Baca County",4,41,26,13,13
050,35,011,"New Mexico","De Baca County",4,42,22,10,12
050,35,011,"New Mexico","De Baca County",4,43,14,6,8
050,35,011,"New Mexico","De Baca County",4,44,17,10,7
050,35,011,"New Mexico","De Baca County",4,45,14,3,11
050,35,011,"New Mexico","De Baca County",4,46,13,7,6
050,35,011,"New Mexico","De Baca County",4,47,12,7,5
050,35,011,"New Mexico","De Baca County",4,48,18,9,9
050,35,011,"New Mexico","De Baca County",4,49,16,5,11
050,35,011,"New Mexico","De Baca County",4,50,19,10,9
050,35,011,"New Mexico","De Baca County",4,51,13,7,6
050,35,011,"New Mexico","De Baca County",4,52,15,10,5
050,35,011,"New Mexico","De Baca County",4,53,20,11,9
050,35,011,"New Mexico","De Baca County",4,54,16,8,8
050,35,011,"New Mexico","De Baca County",4,55,14,7,7
050,35,011,"New Mexico","De Baca County",4,56,16,9,7
050,35,011,"New Mexico","De Baca County",4,57,23,14,9
050,35,011,"New Mexico","De Baca County",4,58,21,15,6
050,35,011,"New Mexico","De Baca County",4,59,27,13,14
050,35,011,"New Mexico","De Baca County",4,60,27,10,17
050,35,011,"New Mexico","De Baca County",4,61,28,14,14
050,35,011,"New Mexico","De Baca County",4,62,29,15,14
050,35,011,"New Mexico","De Baca County",4,63,28,12,16
050,35,011,"New Mexico","De Baca County",4,64,21,7,14
050,35,011,"New Mexico","De Baca County",4,65,28,11,17
050,35,011,"New Mexico","De Baca County",4,66,27,15,12
050,35,011,"New Mexico","De Baca County",4,67,25,12,13
050,35,011,"New Mexico","De Baca County",4,68,29,16,13
050,35,011,"New Mexico","De Baca County",4,69,31,20,11
050,35,011,"New Mexico","De Baca County",4,70,21,14,7
050,35,011,"New Mexico","De Baca County",4,71,31,20,11
050,35,011,"New Mexico","De Baca County",4,72,36,23,13
050,35,011,"New Mexico","De Baca County",4,73,32,19,13
050,35,011,"New Mexico","De Baca County",4,74,17,6,11
050,35,011,"New Mexico","De Baca County",4,75,22,11,11
050,35,011,"New Mexico","De Baca County",4,76,27,15,12
050,35,011,"New Mexico","De Baca County",4,77,22,7,15
050,35,011,"New Mexico","De Baca County",4,78,19,7,12
050,35,011,"New Mexico","De Baca County",4,79,22,9,13
050,35,011,"New Mexico","De Baca County",4,80,15,10,5
050,35,011,"New Mexico","De Baca County",4,81,10,5,5
050,35,011,"New Mexico","De Baca County",4,82,8,2,6
050,35,011,"New Mexico","De Baca County",4,83,8,4,4
050,35,011,"New Mexico","De Baca County",4,84,9,3,6
050,35,011,"New Mexico","De Baca County",4,85,52,24,28
050,35,011,"New Mexico","De Baca County",5,0,14,7,7
050,35,011,"New Mexico","De Baca County",5,1,14,7,7
050,35,011,"New Mexico","De Baca County",5,2,17,9,8
050,35,011,"New Mexico","De Baca County",5,3,16,7,9
050,35,011,"New Mexico","De Baca County",5,4,14,7,7
050,35,011,"New Mexico","De Baca County",5,5,16,8,8
050,35,011,"New Mexico","De Baca County",5,6,16,9,7
050,35,011,"New Mexico","De Baca County",5,7,18,9,9
050,35,011,"New Mexico","De Baca County",5,8,19,10,9
050,35,011,"New Mexico","De Baca County",5,9,16,6,10
050,35,011,"New Mexico","De Baca County",5,10,23,13,10
050,35,011,"New Mexico","De Baca County",5,11,26,16,10
050,35,011,"New Mexico","De Baca County",5,12,27,17,10
050,35,011,"New Mexico","De Baca County",5,13,30,13,17
050,35,011,"New Mexico","De Baca County",5,14,33,12,21
050,35,011,"New Mexico","De Baca County",5,15,25,13,12
050,35,011,"New Mexico","De Baca County",5,16,22,13,9
050,35,011,"New Mexico","De Baca County",5,17,17,11,6
050,35,011,"New Mexico","De Baca County",5,18,18,9,9
050,35,011,"New Mexico","De Baca County",5,19,9,7,2
050,35,011,"New Mexico","De Baca County",5,20,19,10,9
050,35,011,"New Mexico","De Baca County",5,21,14,9,5
050,35,011,"New Mexico","De Baca County",5,22,13,7,6
050,35,011,"New Mexico","De Baca County",5,23,18,6,12
050,35,011,"New Mexico","De Baca County",5,24,16,8,8
050,35,011,"New Mexico","De Baca County",5,25,14,7,7
050,35,011,"New Mexico","De Baca County",5,26,11,6,5
050,35,011,"New Mexico","De Baca County",5,27,10,7,3
050,35,011,"New Mexico","De Baca County",5,28,11,6,5
050,35,011,"New Mexico","De Baca County",5,29,16,10,6
050,35,011,"New Mexico","De Baca County",5,30,19,7,12
050,35,011,"New Mexico","De Baca County",5,31,12,6,6
050,35,011,"New Mexico","De Baca County",5,32,14,12,2
050,35,011,"New Mexico","De Baca County",5,33,17,7,10
050,35,011,"New Mexico","De Baca County",5,34,17,9,8
050,35,011,"New Mexico","De Baca County",5,35,19,8,11
050,35,011,"New Mexico","De Baca County",5,36,17,8,9
050,35,011,"New Mexico","De Baca County",5,37,21,12,9
050,35,011,"New Mexico","De Baca County",5,38,17,11,6
050,35,011,"New Mexico","De Baca County",5,39,21,13,8
050,35,011,"New Mexico","De Baca County",5,40,19,11,8
050,35,011,"New Mexico","De Baca County",5,41,24,15,9
050,35,011,"New Mexico","De Baca County",5,42,23,10,13
050,35,011,"New Mexico","De Baca County",5,43,22,10,12
050,35,011,"New Mexico","De Baca County",5,44,12,4,8
050,35,011,"New Mexico","De Baca County",5,45,18,10,8
050,35,011,"New Mexico","De Baca County",5,46,14,3,11
050,35,011,"New Mexico","De Baca County",5,47,14,7,7
050,35,011,"New Mexico","De Baca County",5,48,12,7,5
050,35,011,"New Mexico","De Baca County",5,49,18,8,10
050,35,011,"New Mexico","De Baca County",5,50,16,5,11
050,35,011,"New Mexico","De Baca County",5,51,19,10,9
050,35,011,"New Mexico","De Baca County",5,52,15,7,8
050,35,011,"New Mexico","De Baca County",5,53,15,10,5
050,35,011,"New Mexico","De Baca County",5,54,16,9,7
050,35,011,"New Mexico","De Baca County",5,55,13,8,5
050,35,011,"New Mexico","De Baca County",5,56,13,7,6
050,35,011,"New Mexico","De Baca County",5,57,14,8,6
050,35,011,"New Mexico","De Baca County",5,58,21,14,7
050,35,011,"New Mexico","De Baca County",5,59,20,14,6
050,35,011,"New Mexico","De Baca County",5,60,25,12,13
050,35,011,"New Mexico","De Baca County",5,61,28,11,17
050,35,011,"New Mexico","De Baca County",5,62,29,14,15
050,35,011,"New Mexico","De Baca County",5,63,30,15,15
050,35,011,"New Mexico","De Baca County",5,64,28,12,16
050,35,011,"New Mexico","De Baca County",5,65,23,8,15
050,35,011,"New Mexico","De Baca County",5,66,27,10,17
050,35,011,"New Mexico","De Baca County",5,67,27,15,12
050,35,011,"New Mexico","De Baca County",5,68,23,13,10
050,35,011,"New Mexico","De Baca County",5,69,28,15,13
050,35,011,"New Mexico","De Baca County",5,70,33,21,12
050,35,011,"New Mexico","De Baca County",5,71,19,13,6
050,35,011,"New Mexico","De Baca County",5,72,29,18,11
050,35,011,"New Mexico","De Baca County",5,73,35,22,13
050,35,011,"New Mexico","De Baca County",5,74,27,15,12
050,35,011,"New Mexico","De Baca County",5,75,14,7,7
050,35,011,"New Mexico","De Baca County",5,76,21,10,11
050,35,011,"New Mexico","De Baca County",5,77,24,13,11
050,35,011,"New Mexico","De Baca County",5,78,20,7,13
050,35,011,"New Mexico","De Baca County",5,79,19,7,12
050,35,011,"New Mexico","De Baca County",5,80,17,9,8
050,35,011,"New Mexico","De Baca County",5,81,15,10,5
050,35,011,"New Mexico","De Baca County",5,82,9,4,5
050,35,011,"New Mexico","De Baca County",5,83,7,2,5
050,35,011,"New Mexico","De Baca County",5,84,8,4,4
050,35,011,"New Mexico","De Baca County",5,85,48,23,25
050,35,013,"New Mexico","Doña Ana County",1,0,2524,1294,1230
050,35,013,"New Mexico","Doña Ana County",1,1,2568,1314,1254
050,35,013,"New Mexico","Doña Ana County",1,2,2611,1325,1286
050,35,013,"New Mexico","Doña Ana County",1,3,2738,1409,1329
050,35,013,"New Mexico","Doña Ana County",1,4,2866,1435,1431
050,35,013,"New Mexico","Doña Ana County",1,5,2845,1435,1410
050,35,013,"New Mexico","Doña Ana County",1,6,2809,1426,1383
050,35,013,"New Mexico","Doña Ana County",1,7,2891,1453,1438
050,35,013,"New Mexico","Doña Ana County",1,8,2944,1473,1471
050,35,013,"New Mexico","Doña Ana County",1,9,3103,1607,1496
050,35,013,"New Mexico","Doña Ana County",1,10,3080,1599,1481
050,35,013,"New Mexico","Doña Ana County",1,11,3116,1571,1545
050,35,013,"New Mexico","Doña Ana County",1,12,3162,1584,1578
050,35,013,"New Mexico","Doña Ana County",1,13,3205,1605,1600
050,35,013,"New Mexico","Doña Ana County",1,14,3086,1567,1519
050,35,013,"New Mexico","Doña Ana County",1,15,3051,1566,1485
050,35,013,"New Mexico","Doña Ana County",1,16,3087,1610,1477
050,35,013,"New Mexico","Doña Ana County",1,17,3242,1707,1535
050,35,013,"New Mexico","Doña Ana County",1,18,3836,1939,1897
050,35,013,"New Mexico","Doña Ana County",1,19,4962,2446,2516
050,35,013,"New Mexico","Doña Ana County",1,20,5055,2514,2541
050,35,013,"New Mexico","Doña Ana County",1,21,5126,2508,2618
050,35,013,"New Mexico","Doña Ana County",1,22,4460,2158,2302
050,35,013,"New Mexico","Doña Ana County",1,23,4429,2215,2214
050,35,013,"New Mexico","Doña Ana County",1,24,3798,2028,1770
050,35,013,"New Mexico","Doña Ana County",1,25,3471,1820,1651
050,35,013,"New Mexico","Doña Ana County",1,26,3231,1666,1565
050,35,013,"New Mexico","Doña Ana County",1,27,3054,1568,1486
050,35,013,"New Mexico","Doña Ana County",1,28,3037,1525,1512
050,35,013,"New Mexico","Doña Ana County",1,29,2823,1412,1411
050,35,013,"New Mexico","Doña Ana County",1,30,2634,1338,1296
050,35,013,"New Mexico","Doña Ana County",1,31,2556,1309,1247
050,35,013,"New Mexico","Doña Ana County",1,32,2480,1290,1190
050,35,013,"New Mexico","Doña Ana County",1,33,2400,1210,1190
050,35,013,"New Mexico","Doña Ana County",1,34,2618,1334,1284
050,35,013,"New Mexico","Doña Ana County",1,35,2682,1358,1324
050,35,013,"New Mexico","Doña Ana County",1,36,2696,1368,1328
050,35,013,"New Mexico","Doña Ana County",1,37,2672,1375,1297
050,35,013,"New Mexico","Doña Ana County",1,38,2558,1307,1251
050,35,013,"New Mexico","Doña Ana County",1,39,2522,1282,1240
050,35,013,"New Mexico","Doña Ana County",1,40,2458,1270,1188
050,35,013,"New Mexico","Doña Ana County",1,41,2316,1151,1165
050,35,013,"New Mexico","Doña Ana County",1,42,2281,1122,1159
050,35,013,"New Mexico","Doña Ana County",1,43,2219,1074,1145
050,35,013,"New Mexico","Doña Ana County",1,44,2211,1060,1151
050,35,013,"New Mexico","Doña Ana County",1,45,2244,1087,1157
050,35,013,"New Mexico","Doña Ana County",1,46,2162,1021,1141
050,35,013,"New Mexico","Doña Ana County",1,47,2205,1065,1140
050,35,013,"New Mexico","Doña Ana County",1,48,2200,1057,1143
050,35,013,"New Mexico","Doña Ana County",1,49,2302,1113,1189
050,35,013,"New Mexico","Doña Ana County",1,50,2197,1062,1135
050,35,013,"New Mexico","Doña Ana County",1,51,2141,1036,1105
050,35,013,"New Mexico","Doña Ana County",1,52,2104,1011,1093
050,35,013,"New Mexico","Doña Ana County",1,53,2125,1003,1122
050,35,013,"New Mexico","Doña Ana County",1,54,2181,1034,1147
050,35,013,"New Mexico","Doña Ana County",1,55,2333,1121,1212
050,35,013,"New Mexico","Doña Ana County",1,56,2348,1086,1262
050,35,013,"New Mexico","Doña Ana County",1,57,2443,1162,1281
050,35,013,"New Mexico","Doña Ana County",1,58,2524,1194,1330
050,35,013,"New Mexico","Doña Ana County",1,59,2523,1163,1360
050,35,013,"New Mexico","Doña Ana County",1,60,2443,1132,1311
050,35,013,"New Mexico","Doña Ana County",1,61,2403,1114,1289
050,35,013,"New Mexico","Doña Ana County",1,62,2412,1139,1273
050,35,013,"New Mexico","Doña Ana County",1,63,2391,1129,1262
050,35,013,"New Mexico","Doña Ana County",1,64,2358,1121,1237
050,35,013,"New Mexico","Doña Ana County",1,65,2337,1103,1234
050,35,013,"New Mexico","Doña Ana County",1,66,2350,1135,1215
050,35,013,"New Mexico","Doña Ana County",1,67,2279,1066,1213
050,35,013,"New Mexico","Doña Ana County",1,68,2188,1053,1135
050,35,013,"New Mexico","Doña Ana County",1,69,2133,1033,1100
050,35,013,"New Mexico","Doña Ana County",1,70,2157,1027,1130
050,35,013,"New Mexico","Doña Ana County",1,71,2087,1002,1085
050,35,013,"New Mexico","Doña Ana County",1,72,2092,1017,1075
050,35,013,"New Mexico","Doña Ana County",1,73,2011,961,1050
050,35,013,"New Mexico","Doña Ana County",1,74,1522,744,778
050,35,013,"New Mexico","Doña Ana County",1,75,1510,723,787
050,35,013,"New Mexico","Doña Ana County",1,76,1473,706,767
050,35,013,"New Mexico","Doña Ana County",1,77,1442,676,766
050,35,013,"New Mexico","Doña Ana County",1,78,1219,573,646
050,35,013,"New Mexico","Doña Ana County",1,79,1063,498,565
050,35,013,"New Mexico","Doña Ana County",1,80,984,453,531
050,35,013,"New Mexico","Doña Ana County",1,81,967,444,523
050,35,013,"New Mexico","Doña Ana County",1,82,884,418,466
050,35,013,"New Mexico","Doña Ana County",1,83,801,387,414
050,35,013,"New Mexico","Doña Ana County",1,84,728,345,383
050,35,013,"New Mexico","Doña Ana County",1,85,3790,1574,2216
050,35,013,"New Mexico","Doña Ana County",2,0,2450,1254,1196
050,35,013,"New Mexico","Doña Ana County",2,1,2577,1321,1256
050,35,013,"New Mexico","Doña Ana County",2,2,2612,1328,1284
050,35,013,"New Mexico","Doña Ana County",2,3,2703,1385,1318
050,35,013,"New Mexico","Doña Ana County",2,4,2843,1435,1408
050,35,013,"New Mexico","Doña Ana County",2,5,2848,1440,1408
050,35,013,"New Mexico","Doña Ana County",2,6,2817,1433,1384
050,35,013,"New Mexico","Doña Ana County",2,7,2865,1443,1422
050,35,013,"New Mexico","Doña Ana County",2,8,2920,1466,1454
050,35,013,"New Mexico","Doña Ana County",2,9,3060,1572,1488
050,35,013,"New Mexico","Doña Ana County",2,10,3091,1602,1489
050,35,013,"New Mexico","Doña Ana County",2,11,3090,1569,1521
050,35,013,"New Mexico","Doña Ana County",2,12,3157,1585,1572
050,35,013,"New Mexico","Doña Ana County",2,13,3194,1601,1593
050,35,013,"New Mexico","Doña Ana County",2,14,3114,1578,1536
050,35,013,"New Mexico","Doña Ana County",2,15,3058,1570,1488
050,35,013,"New Mexico","Doña Ana County",2,16,3088,1605,1483
050,35,013,"New Mexico","Doña Ana County",2,17,3213,1686,1527
050,35,013,"New Mexico","Doña Ana County",2,18,3868,1955,1913
050,35,013,"New Mexico","Doña Ana County",2,19,4977,2454,2523
050,35,013,"New Mexico","Doña Ana County",2,20,5089,2547,2542
050,35,013,"New Mexico","Doña Ana County",2,21,5112,2492,2620
050,35,013,"New Mexico","Doña Ana County",2,22,4505,2174,2331
050,35,013,"New Mexico","Doña Ana County",2,23,4429,2197,2232
050,35,013,"New Mexico","Doña Ana County",2,24,3774,2008,1766
050,35,013,"New Mexico","Doña Ana County",2,25,3476,1819,1657
050,35,013,"New Mexico","Doña Ana County",2,26,3214,1668,1546
050,35,013,"New Mexico","Doña Ana County",2,27,3048,1567,1481
050,35,013,"New Mexico","Doña Ana County",2,28,3030,1525,1505
050,35,013,"New Mexico","Doña Ana County",2,29,2872,1439,1433
050,35,013,"New Mexico","Doña Ana County",2,30,2711,1374,1337
050,35,013,"New Mexico","Doña Ana County",2,31,2567,1312,1255
050,35,013,"New Mexico","Doña Ana County",2,32,2496,1291,1205
050,35,013,"New Mexico","Doña Ana County",2,33,2425,1230,1195
050,35,013,"New Mexico","Doña Ana County",2,34,2574,1310,1264
050,35,013,"New Mexico","Doña Ana County",2,35,2686,1361,1325
050,35,013,"New Mexico","Doña Ana County",2,36,2682,1361,1321
050,35,013,"New Mexico","Doña Ana County",2,37,2670,1368,1302
050,35,013,"New Mexico","Doña Ana County",2,38,2597,1326,1271
050,35,013,"New Mexico","Doña Ana County",2,39,2522,1285,1237
050,35,013,"New Mexico","Doña Ana County",2,40,2507,1294,1213
050,35,013,"New Mexico","Doña Ana County",2,41,2344,1172,1172
050,35,013,"New Mexico","Doña Ana County",2,42,2289,1133,1156
050,35,013,"New Mexico","Doña Ana County",2,43,2243,1088,1155
050,35,013,"New Mexico","Doña Ana County",2,44,2208,1065,1143
050,35,013,"New Mexico","Doña Ana County",2,45,2242,1089,1153
050,35,013,"New Mexico","Doña Ana County",2,46,2180,1035,1145
050,35,013,"New Mexico","Doña Ana County",2,47,2196,1058,1138
050,35,013,"New Mexico","Doña Ana County",2,48,2206,1057,1149
050,35,013,"New Mexico","Doña Ana County",2,49,2284,1101,1183
050,35,013,"New Mexico","Doña Ana County",2,50,2237,1081,1156
050,35,013,"New Mexico","Doña Ana County",2,51,2142,1036,1106
050,35,013,"New Mexico","Doña Ana County",2,52,2125,1023,1102
050,35,013,"New Mexico","Doña Ana County",2,53,2126,1003,1123
050,35,013,"New Mexico","Doña Ana County",2,54,2174,1027,1147
050,35,013,"New Mexico","Doña Ana County",2,55,2303,1103,1200
050,35,013,"New Mexico","Doña Ana County",2,56,2350,1094,1256
050,35,013,"New Mexico","Doña Ana County",2,57,2419,1144,1275
050,35,013,"New Mexico","Doña Ana County",2,58,2518,1191,1327
050,35,013,"New Mexico","Doña Ana County",2,59,2517,1167,1350
050,35,013,"New Mexico","Doña Ana County",2,60,2482,1152,1330
050,35,013,"New Mexico","Doña Ana County",2,61,2421,1122,1299
050,35,013,"New Mexico","Doña Ana County",2,62,2411,1129,1282
050,35,013,"New Mexico","Doña Ana County",2,63,2415,1142,1273
050,35,013,"New Mexico","Doña Ana County",2,64,2361,1122,1239
050,35,013,"New Mexico","Doña Ana County",2,65,2355,1117,1238
050,35,013,"New Mexico","Doña Ana County",2,66,2353,1129,1224
050,35,013,"New Mexico","Doña Ana County",2,67,2295,1085,1210
050,35,013,"New Mexico","Doña Ana County",2,68,2203,1052,1151
050,35,013,"New Mexico","Doña Ana County",2,69,2161,1043,1118
050,35,013,"New Mexico","Doña Ana County",2,70,2156,1027,1129
050,35,013,"New Mexico","Doña Ana County",2,71,2106,1008,1098
050,35,013,"New Mexico","Doña Ana County",2,72,2076,1001,1075
050,35,013,"New Mexico","Doña Ana County",2,73,2098,1008,1090
050,35,013,"New Mexico","Doña Ana County",2,74,1570,760,810
050,35,013,"New Mexico","Doña Ana County",2,75,1506,723,783
050,35,013,"New Mexico","Doña Ana County",2,76,1459,703,756
050,35,013,"New Mexico","Doña Ana County",2,77,1469,694,775
050,35,013,"New Mexico","Doña Ana County",2,78,1252,589,663
050,35,013,"New Mexico","Doña Ana County",2,79,1073,500,573
050,35,013,"New Mexico","Doña Ana County",2,80,994,461,533
050,35,013,"New Mexico","Doña Ana County",2,81,963,438,525
050,35,013,"New Mexico","Doña Ana County",2,82,894,417,477
050,35,013,"New Mexico","Doña Ana County",2,83,806,387,419
050,35,013,"New Mexico","Doña Ana County",2,84,732,348,384
050,35,013,"New Mexico","Doña Ana County",2,85,3815,1603,2212
050,35,013,"New Mexico","Doña Ana County",3,0,2448,1288,1160
050,35,013,"New Mexico","Doña Ana County",3,1,2395,1236,1159
050,35,013,"New Mexico","Doña Ana County",3,2,2569,1309,1260
050,35,013,"New Mexico","Doña Ana County",3,3,2608,1322,1286
050,35,013,"New Mexico","Doña Ana County",3,4,2733,1431,1302
050,35,013,"New Mexico","Doña Ana County",3,5,2838,1414,1424
050,35,013,"New Mexico","Doña Ana County",3,6,2845,1434,1411
050,35,013,"New Mexico","Doña Ana County",3,7,2830,1454,1376
050,35,013,"New Mexico","Doña Ana County",3,8,2882,1441,1441
050,35,013,"New Mexico","Doña Ana County",3,9,2917,1460,1457
050,35,013,"New Mexico","Doña Ana County",3,10,3114,1590,1524
050,35,013,"New Mexico","Doña Ana County",3,11,3104,1591,1513
050,35,013,"New Mexico","Doña Ana County",3,12,3143,1595,1548
050,35,013,"New Mexico","Doña Ana County",3,13,3182,1591,1591
050,35,013,"New Mexico","Doña Ana County",3,14,3232,1622,1610
050,35,013,"New Mexico","Doña Ana County",3,15,3151,1587,1564
050,35,013,"New Mexico","Doña Ana County",3,16,3065,1572,1493
050,35,013,"New Mexico","Doña Ana County",3,17,3211,1674,1537
050,35,013,"New Mexico","Doña Ana County",3,18,3969,1981,1988
050,35,013,"New Mexico","Doña Ana County",3,19,5025,2499,2526
050,35,013,"New Mexico","Doña Ana County",3,20,5129,2603,2526
050,35,013,"New Mexico","Doña Ana County",3,21,5160,2532,2628
050,35,013,"New Mexico","Doña Ana County",3,22,4611,2214,2397
050,35,013,"New Mexico","Doña Ana County",3,23,4454,2173,2281
050,35,013,"New Mexico","Doña Ana County",3,24,3704,1940,1764
050,35,013,"New Mexico","Doña Ana County",3,25,3435,1794,1641
050,35,013,"New Mexico","Doña Ana County",3,26,3159,1684,1475
050,35,013,"New Mexico","Doña Ana County",3,27,3041,1568,1473
050,35,013,"New Mexico","Doña Ana County",3,28,3052,1562,1490
050,35,013,"New Mexico","Doña Ana County",3,29,3084,1543,1541
050,35,013,"New Mexico","Doña Ana County",3,30,2900,1483,1417
050,35,013,"New Mexico","Doña Ana County",3,31,2708,1360,1348
050,35,013,"New Mexico","Doña Ana County",3,32,2548,1308,1240
050,35,013,"New Mexico","Doña Ana County",3,33,2527,1327,1200
050,35,013,"New Mexico","Doña Ana County",3,34,2495,1259,1236
050,35,013,"New Mexico","Doña Ana County",3,35,2603,1349,1254
050,35,013,"New Mexico","Doña Ana County",3,36,2703,1378,1325
050,35,013,"New Mexico","Doña Ana County",3,37,2661,1349,1312
050,35,013,"New Mexico","Doña Ana County",3,38,2692,1374,1318
050,35,013,"New Mexico","Doña Ana County",3,39,2616,1334,1282
050,35,013,"New Mexico","Doña Ana County",3,40,2563,1327,1236
050,35,013,"New Mexico","Doña Ana County",3,41,2519,1301,1218
050,35,013,"New Mexico","Doña Ana County",3,42,2348,1176,1172
050,35,013,"New Mexico","Doña Ana County",3,43,2314,1145,1169
050,35,013,"New Mexico","Doña Ana County",3,44,2266,1098,1168
050,35,013,"New Mexico","Doña Ana County",3,45,2227,1063,1164
050,35,013,"New Mexico","Doña Ana County",3,46,2220,1067,1153
050,35,013,"New Mexico","Doña Ana County",3,47,2207,1049,1158
050,35,013,"New Mexico","Doña Ana County",3,48,2181,1039,1142
050,35,013,"New Mexico","Doña Ana County",3,49,2237,1052,1185
050,35,013,"New Mexico","Doña Ana County",3,50,2315,1121,1194
050,35,013,"New Mexico","Doña Ana County",3,51,2247,1066,1181
050,35,013,"New Mexico","Doña Ana County",3,52,2124,1016,1108
050,35,013,"New Mexico","Doña Ana County",3,53,2130,1019,1111
050,35,013,"New Mexico","Doña Ana County",3,54,2127,1013,1114
050,35,013,"New Mexico","Doña Ana County",3,55,2181,1032,1149
050,35,013,"New Mexico","Doña Ana County",3,56,2307,1104,1203
050,35,013,"New Mexico","Doña Ana County",3,57,2388,1109,1279
050,35,013,"New Mexico","Doña Ana County",3,58,2399,1129,1270
050,35,013,"New Mexico","Doña Ana County",3,59,2540,1187,1353
050,35,013,"New Mexico","Doña Ana County",3,60,2505,1154,1351
050,35,013,"New Mexico","Doña Ana County",3,61,2481,1137,1344
050,35,013,"New Mexico","Doña Ana County",3,62,2442,1120,1322
050,35,013,"New Mexico","Doña Ana County",3,63,2412,1127,1285
050,35,013,"New Mexico","Doña Ana County",3,64,2438,1154,1284
050,35,013,"New Mexico","Doña Ana County",3,65,2395,1138,1257
050,35,013,"New Mexico","Doña Ana County",3,66,2345,1101,1244
050,35,013,"New Mexico","Doña Ana County",3,67,2336,1111,1225
050,35,013,"New Mexico","Doña Ana County",3,68,2280,1079,1201
050,35,013,"New Mexico","Doña Ana County",3,69,2183,1041,1142
050,35,013,"New Mexico","Doña Ana County",3,70,2131,1029,1102
050,35,013,"New Mexico","Doña Ana County",3,71,2106,994,1112
050,35,013,"New Mexico","Doña Ana County",3,72,2051,978,1073
050,35,013,"New Mexico","Doña Ana County",3,73,2025,979,1046
050,35,013,"New Mexico","Doña Ana County",3,74,2056,982,1074
050,35,013,"New Mexico","Doña Ana County",3,75,1528,731,797
050,35,013,"New Mexico","Doña Ana County",3,76,1456,698,758
050,35,013,"New Mexico","Doña Ana County",3,77,1398,671,727
050,35,013,"New Mexico","Doña Ana County",3,78,1391,651,740
050,35,013,"New Mexico","Doña Ana County",3,79,1183,550,633
050,35,013,"New Mexico","Doña Ana County",3,80,1014,458,556
050,35,013,"New Mexico","Doña Ana County",3,81,935,430,505
050,35,013,"New Mexico","Doña Ana County",3,82,896,393,503
050,35,013,"New Mexico","Doña Ana County",3,83,831,374,457
050,35,013,"New Mexico","Doña Ana County",3,84,743,361,382
050,35,013,"New Mexico","Doña Ana County",3,85,3788,1621,2167
050,35,013,"New Mexico","Doña Ana County",4,0,2445,1272,1173
050,35,013,"New Mexico","Doña Ana County",4,1,2463,1296,1167
050,35,013,"New Mexico","Doña Ana County",4,2,2419,1249,1170
050,35,013,"New Mexico","Doña Ana County",4,3,2551,1308,1243
050,35,013,"New Mexico","Doña Ana County",4,4,2615,1314,1301
050,35,013,"New Mexico","Doña Ana County",4,5,2729,1429,1300
050,35,013,"New Mexico","Doña Ana County",4,6,2859,1428,1431
050,35,013,"New Mexico","Doña Ana County",4,7,2884,1480,1404
050,35,013,"New Mexico","Doña Ana County",4,8,2838,1464,1374
050,35,013,"New Mexico","Doña Ana County",4,9,2877,1442,1435
050,35,013,"New Mexico","Doña Ana County",4,10,2907,1465,1442
050,35,013,"New Mexico","Doña Ana County",4,11,3115,1606,1509
050,35,013,"New Mexico","Doña Ana County",4,12,3083,1584,1499
050,35,013,"New Mexico","Doña Ana County",4,13,3155,1602,1553
050,35,013,"New Mexico","Doña Ana County",4,14,3241,1601,1640
050,35,013,"New Mexico","Doña Ana County",4,15,3281,1637,1644
050,35,013,"New Mexico","Doña Ana County",4,16,3183,1602,1581
050,35,013,"New Mexico","Doña Ana County",4,17,3143,1599,1544
050,35,013,"New Mexico","Doña Ana County",4,18,3932,1951,1981
050,35,013,"New Mexico","Doña Ana County",4,19,5139,2551,2588
050,35,013,"New Mexico","Doña Ana County",4,20,5186,2657,2529
050,35,013,"New Mexico","Doña Ana County",4,21,5189,2578,2611
050,35,013,"New Mexico","Doña Ana County",4,22,4686,2263,2423
050,35,013,"New Mexico","Doña Ana County",4,23,4566,2191,2375
050,35,013,"New Mexico","Doña Ana County",4,24,3728,1947,1781
050,35,013,"New Mexico","Doña Ana County",4,25,3372,1710,1662
050,35,013,"New Mexico","Doña Ana County",4,26,3107,1641,1466
050,35,013,"New Mexico","Doña Ana County",4,27,3054,1633,1421
050,35,013,"New Mexico","Doña Ana County",4,28,3026,1541,1485
050,35,013,"New Mexico","Doña Ana County",4,29,3039,1538,1501
050,35,013,"New Mexico","Doña Ana County",4,30,3079,1530,1549
050,35,013,"New Mexico","Doña Ana County",4,31,2898,1490,1408
050,35,013,"New Mexico","Doña Ana County",4,32,2730,1360,1370
050,35,013,"New Mexico","Doña Ana County",4,33,2584,1331,1253
050,35,013,"New Mexico","Doña Ana County",4,34,2529,1324,1205
050,35,013,"New Mexico","Doña Ana County",4,35,2466,1227,1239
050,35,013,"New Mexico","Doña Ana County",4,36,2612,1358,1254
050,35,013,"New Mexico","Doña Ana County",4,37,2689,1371,1318
050,35,013,"New Mexico","Doña Ana County",4,38,2660,1365,1295
050,35,013,"New Mexico","Doña Ana County",4,39,2722,1413,1309
050,35,013,"New Mexico","Doña Ana County",4,40,2671,1379,1292
050,35,013,"New Mexico","Doña Ana County",4,41,2629,1352,1277
050,35,013,"New Mexico","Doña Ana County",4,42,2590,1338,1252
050,35,013,"New Mexico","Doña Ana County",4,43,2379,1174,1205
050,35,013,"New Mexico","Doña Ana County",4,44,2322,1157,1165
050,35,013,"New Mexico","Doña Ana County",4,45,2294,1123,1171
050,35,013,"New Mexico","Doña Ana County",4,46,2207,1050,1157
050,35,013,"New Mexico","Doña Ana County",4,47,2230,1085,1145
050,35,013,"New Mexico","Doña Ana County",4,48,2173,1018,1155
050,35,013,"New Mexico","Doña Ana County",4,49,2176,1037,1139
050,35,013,"New Mexico","Doña Ana County",4,50,2310,1098,1212
050,35,013,"New Mexico","Doña Ana County",4,51,2335,1138,1197
050,35,013,"New Mexico","Doña Ana County",4,52,2263,1065,1198
050,35,013,"New Mexico","Doña Ana County",4,53,2134,1016,1118
050,35,013,"New Mexico","Doña Ana County",4,54,2129,1006,1123
050,35,013,"New Mexico","Doña Ana County",4,55,2148,1022,1126
050,35,013,"New Mexico","Doña Ana County",4,56,2199,1036,1163
050,35,013,"New Mexico","Doña Ana County",4,57,2349,1113,1236
050,35,013,"New Mexico","Doña Ana County",4,58,2373,1100,1273
050,35,013,"New Mexico","Doña Ana County",4,59,2450,1153,1297
050,35,013,"New Mexico","Doña Ana County",4,60,2545,1194,1351
050,35,013,"New Mexico","Doña Ana County",4,61,2503,1140,1363
050,35,013,"New Mexico","Doña Ana County",4,62,2482,1121,1361
050,35,013,"New Mexico","Doña Ana County",4,63,2496,1146,1350
050,35,013,"New Mexico","Doña Ana County",4,64,2384,1112,1272
050,35,013,"New Mexico","Doña Ana County",4,65,2478,1156,1322
050,35,013,"New Mexico","Doña Ana County",4,66,2424,1142,1282
050,35,013,"New Mexico","Doña Ana County",4,67,2320,1084,1236
050,35,013,"New Mexico","Doña Ana County",4,68,2333,1104,1229
050,35,013,"New Mexico","Doña Ana County",4,69,2281,1089,1192
050,35,013,"New Mexico","Doña Ana County",4,70,2156,1034,1122
050,35,013,"New Mexico","Doña Ana County",4,71,2123,1028,1095
050,35,013,"New Mexico","Doña Ana County",4,72,2084,986,1098
050,35,013,"New Mexico","Doña Ana County",4,73,2010,955,1055
050,35,013,"New Mexico","Doña Ana County",4,74,1986,962,1024
050,35,013,"New Mexico","Doña Ana County",4,75,2023,963,1060
050,35,013,"New Mexico","Doña Ana County",4,76,1487,700,787
050,35,013,"New Mexico","Doña Ana County",4,77,1404,670,734
050,35,013,"New Mexico","Doña Ana County",4,78,1342,645,697
050,35,013,"New Mexico","Doña Ana County",4,79,1320,607,713
050,35,013,"New Mexico","Doña Ana County",4,80,1124,520,604
050,35,013,"New Mexico","Doña Ana County",4,81,943,424,519
050,35,013,"New Mexico","Doña Ana County",4,82,847,380,467
050,35,013,"New Mexico","Doña Ana County",4,83,823,359,464
050,35,013,"New Mexico","Doña Ana County",4,84,763,339,424
050,35,013,"New Mexico","Doña Ana County",4,85,3707,1604,2103
050,35,013,"New Mexico","Doña Ana County",5,0,2248,1171,1077
050,35,013,"New Mexico","Doña Ana County",5,1,2435,1270,1165
050,35,013,"New Mexico","Doña Ana County",5,2,2460,1293,1167
050,35,013,"New Mexico","Doña Ana County",5,3,2412,1247,1165
050,35,013,"New Mexico","Doña Ana County",5,4,2543,1307,1236
050,35,013,"New Mexico","Doña Ana County",5,5,2660,1346,1314
050,35,013,"New Mexico","Doña Ana County",5,6,2705,1411,1294
050,35,013,"New Mexico","Doña Ana County",5,7,2858,1443,1415
050,35,013,"New Mexico","Doña Ana County",5,8,2893,1467,1426
050,35,013,"New Mexico","Doña Ana County",5,9,2799,1425,1374
050,35,013,"New Mexico","Doña Ana County",5,10,2905,1448,1457
050,35,013,"New Mexico","Doña Ana County",5,11,2896,1446,1450
050,35,013,"New Mexico","Doña Ana County",5,12,3064,1564,1500
050,35,013,"New Mexico","Doña Ana County",5,13,3082,1573,1509
050,35,013,"New Mexico","Doña Ana County",5,14,3131,1588,1543
050,35,013,"New Mexico","Doña Ana County",5,15,3263,1624,1639
050,35,013,"New Mexico","Doña Ana County",5,16,3293,1632,1661
050,35,013,"New Mexico","Doña Ana County",5,17,3235,1621,1614
050,35,013,"New Mexico","Doña Ana County",5,18,3921,1909,2012
050,35,013,"New Mexico","Doña Ana County",5,19,5159,2570,2589
050,35,013,"New Mexico","Doña Ana County",5,20,5316,2712,2604
050,35,013,"New Mexico","Doña Ana County",5,21,5308,2656,2652
050,35,013,"New Mexico","Doña Ana County",5,22,4700,2277,2423
050,35,013,"New Mexico","Doña Ana County",5,23,4627,2258,2369
050,35,013,"New Mexico","Doña Ana County",5,24,3919,1982,1937
050,35,013,"New Mexico","Doña Ana County",5,25,3371,1719,1652
050,35,013,"New Mexico","Doña Ana County",5,26,3046,1558,1488
050,35,013,"New Mexico","Doña Ana County",5,27,2899,1525,1374
050,35,013,"New Mexico","Doña Ana County",5,28,3020,1567,1453
050,35,013,"New Mexico","Doña Ana County",5,29,3028,1545,1483
050,35,013,"New Mexico","Doña Ana County",5,30,3031,1530,1501
050,35,013,"New Mexico","Doña Ana County",5,31,3039,1486,1553
050,35,013,"New Mexico","Doña Ana County",5,32,2931,1507,1424
050,35,013,"New Mexico","Doña Ana County",5,33,2727,1359,1368
050,35,013,"New Mexico","Doña Ana County",5,34,2586,1337,1249
050,35,013,"New Mexico","Doña Ana County",5,35,2588,1356,1232
050,35,013,"New Mexico","Doña Ana County",5,36,2511,1260,1251
050,35,013,"New Mexico","Doña Ana County",5,37,2602,1367,1235
050,35,013,"New Mexico","Doña Ana County",5,38,2698,1369,1329
050,35,013,"New Mexico","Doña Ana County",5,39,2692,1378,1314
050,35,013,"New Mexico","Doña Ana County",5,40,2745,1410,1335
050,35,013,"New Mexico","Doña Ana County",5,41,2681,1397,1284
050,35,013,"New Mexico","Doña Ana County",5,42,2655,1363,1292
050,35,013,"New Mexico","Doña Ana County",5,43,2621,1342,1279
050,35,013,"New Mexico","Doña Ana County",5,44,2385,1171,1214
050,35,013,"New Mexico","Doña Ana County",5,45,2356,1188,1168
050,35,013,"New Mexico","Doña Ana County",5,46,2278,1117,1161
050,35,013,"New Mexico","Doña Ana County",5,47,2214,1065,1149
050,35,013,"New Mexico","Doña Ana County",5,48,2203,1062,1141
050,35,013,"New Mexico","Doña Ana County",5,49,2159,1001,1158
050,35,013,"New Mexico","Doña Ana County",5,50,2231,1056,1175
050,35,013,"New Mexico","Doña Ana County",5,51,2317,1086,1231
050,35,013,"New Mexico","Doña Ana County",5,52,2344,1134,1210
050,35,013,"New Mexico","Doña Ana County",5,53,2272,1080,1192
050,35,013,"New Mexico","Doña Ana County",5,54,2129,1027,1102
050,35,013,"New Mexico","Doña Ana County",5,55,2159,1008,1151
050,35,013,"New Mexico","Doña Ana County",5,56,2130,997,1133
050,35,013,"New Mexico","Doña Ana County",5,57,2249,1057,1192
050,35,013,"New Mexico","Doña Ana County",5,58,2376,1121,1255
050,35,013,"New Mexico","Doña Ana County",5,59,2366,1087,1279
050,35,013,"New Mexico","Doña Ana County",5,60,2479,1164,1315
050,35,013,"New Mexico","Doña Ana County",5,61,2539,1194,1345
050,35,013,"New Mexico","Doña Ana County",5,62,2550,1173,1377
050,35,013,"New Mexico","Doña Ana County",5,63,2496,1120,1376
050,35,013,"New Mexico","Doña Ana County",5,64,2533,1150,1383
050,35,013,"New Mexico","Doña Ana County",5,65,2432,1143,1289
050,35,013,"New Mexico","Doña Ana County",5,66,2494,1161,1333
050,35,013,"New Mexico","Doña Ana County",5,67,2402,1134,1268
050,35,013,"New Mexico","Doña Ana County",5,68,2318,1101,1217
050,35,013,"New Mexico","Doña Ana County",5,69,2320,1100,1220
050,35,013,"New Mexico","Doña Ana County",5,70,2294,1104,1190
050,35,013,"New Mexico","Doña Ana County",5,71,2142,1026,1116
050,35,013,"New Mexico","Doña Ana County",5,72,2098,1011,1087
050,35,013,"New Mexico","Doña Ana County",5,73,2075,983,1092
050,35,013,"New Mexico","Doña Ana County",5,74,1985,938,1047
050,35,013,"New Mexico","Doña Ana County",5,75,1953,931,1022
050,35,013,"New Mexico","Doña Ana County",5,76,1966,931,1035
050,35,013,"New Mexico","Doña Ana County",5,77,1452,692,760
050,35,013,"New Mexico","Doña Ana County",5,78,1366,655,711
050,35,013,"New Mexico","Doña Ana County",5,79,1297,617,680
050,35,013,"New Mexico","Doña Ana County",5,80,1272,587,685
050,35,013,"New Mexico","Doña Ana County",5,81,1066,495,571
050,35,013,"New Mexico","Doña Ana County",5,82,876,383,493
050,35,013,"New Mexico","Doña Ana County",5,83,793,342,451
050,35,013,"New Mexico","Doña Ana County",5,84,777,343,434
050,35,013,"New Mexico","Doña Ana County",5,85,3764,1627,2137
050,35,015,"New Mexico","Eddy County",1,0,870,446,424
050,35,015,"New Mexico","Eddy County",1,1,892,453,439
050,35,015,"New Mexico","Eddy County",1,2,872,465,407
050,35,015,"New Mexico","Eddy County",1,3,904,477,427
050,35,015,"New Mexico","Eddy County",1,4,928,482,446
050,35,015,"New Mexico","Eddy County",1,5,962,484,478
050,35,015,"New Mexico","Eddy County",1,6,970,504,466
050,35,015,"New Mexico","Eddy County",1,7,942,475,467
050,35,015,"New Mexico","Eddy County",1,8,912,452,460
050,35,015,"New Mexico","Eddy County",1,9,943,456,487
050,35,015,"New Mexico","Eddy County",1,10,958,502,456
050,35,015,"New Mexico","Eddy County",1,11,989,484,505
050,35,015,"New Mexico","Eddy County",1,12,979,488,491
050,35,015,"New Mexico","Eddy County",1,13,919,479,440
050,35,015,"New Mexico","Eddy County",1,14,908,454,454
050,35,015,"New Mexico","Eddy County",1,15,891,424,467
050,35,015,"New Mexico","Eddy County",1,16,910,447,463
050,35,015,"New Mexico","Eddy County",1,17,909,441,468
050,35,015,"New Mexico","Eddy County",1,18,834,421,413
050,35,015,"New Mexico","Eddy County",1,19,729,370,359
050,35,015,"New Mexico","Eddy County",1,20,764,400,364
050,35,015,"New Mexico","Eddy County",1,21,792,411,381
050,35,015,"New Mexico","Eddy County",1,22,799,420,379
050,35,015,"New Mexico","Eddy County",1,23,782,419,363
050,35,015,"New Mexico","Eddy County",1,24,801,420,381
050,35,015,"New Mexico","Eddy County",1,25,829,423,406
050,35,015,"New Mexico","Eddy County",1,26,841,430,411
050,35,015,"New Mexico","Eddy County",1,27,911,481,430
050,35,015,"New Mexico","Eddy County",1,28,958,517,441
050,35,015,"New Mexico","Eddy County",1,29,957,509,448
050,35,015,"New Mexico","Eddy County",1,30,856,451,405
050,35,015,"New Mexico","Eddy County",1,31,864,464,400
050,35,015,"New Mexico","Eddy County",1,32,860,451,409
050,35,015,"New Mexico","Eddy County",1,33,904,478,426
050,35,015,"New Mexico","Eddy County",1,34,870,459,411
050,35,015,"New Mexico","Eddy County",1,35,884,489,395
050,35,015,"New Mexico","Eddy County",1,36,914,489,425
050,35,015,"New Mexico","Eddy County",1,37,921,499,422
050,35,015,"New Mexico","Eddy County",1,38,860,482,378
050,35,015,"New Mexico","Eddy County",1,39,863,493,370
050,35,015,"New Mexico","Eddy County",1,40,818,435,383
050,35,015,"New Mexico","Eddy County",1,41,793,413,380
050,35,015,"New Mexico","Eddy County",1,42,769,393,376
050,35,015,"New Mexico","Eddy County",1,43,719,382,337
050,35,015,"New Mexico","Eddy County",1,44,698,369,329
050,35,015,"New Mexico","Eddy County",1,45,658,323,335
050,35,015,"New Mexico","Eddy County",1,46,630,324,306
050,35,015,"New Mexico","Eddy County",1,47,667,326,341
050,35,015,"New Mexico","Eddy County",1,48,701,355,346
050,35,015,"New Mexico","Eddy County",1,49,716,371,345
050,35,015,"New Mexico","Eddy County",1,50,678,343,335
050,35,015,"New Mexico","Eddy County",1,51,682,359,323
050,35,015,"New Mexico","Eddy County",1,52,669,344,325
050,35,015,"New Mexico","Eddy County",1,53,701,353,348
050,35,015,"New Mexico","Eddy County",1,54,678,351,327
050,35,015,"New Mexico","Eddy County",1,55,720,375,345
050,35,015,"New Mexico","Eddy County",1,56,745,399,346
050,35,015,"New Mexico","Eddy County",1,57,745,369,376
050,35,015,"New Mexico","Eddy County",1,58,804,383,421
050,35,015,"New Mexico","Eddy County",1,59,789,400,389
050,35,015,"New Mexico","Eddy County",1,60,786,412,374
050,35,015,"New Mexico","Eddy County",1,61,715,375,340
050,35,015,"New Mexico","Eddy County",1,62,745,383,362
050,35,015,"New Mexico","Eddy County",1,63,722,366,356
050,35,015,"New Mexico","Eddy County",1,64,720,358,362
050,35,015,"New Mexico","Eddy County",1,65,724,365,359
050,35,015,"New Mexico","Eddy County",1,66,658,339,319
050,35,015,"New Mexico","Eddy County",1,67,599,298,301
050,35,015,"New Mexico","Eddy County",1,68,542,269,273
050,35,015,"New Mexico","Eddy County",1,69,527,258,269
050,35,015,"New Mexico","Eddy County",1,70,502,245,257
050,35,015,"New Mexico","Eddy County",1,71,505,245,260
050,35,015,"New Mexico","Eddy County",1,72,468,221,247
050,35,015,"New Mexico","Eddy County",1,73,442,221,221
050,35,015,"New Mexico","Eddy County",1,74,324,150,174
050,35,015,"New Mexico","Eddy County",1,75,350,166,184
050,35,015,"New Mexico","Eddy County",1,76,309,142,167
050,35,015,"New Mexico","Eddy County",1,77,306,137,169
050,35,015,"New Mexico","Eddy County",1,78,301,145,156
050,35,015,"New Mexico","Eddy County",1,79,261,120,141
050,35,015,"New Mexico","Eddy County",1,80,216,100,116
050,35,015,"New Mexico","Eddy County",1,81,215,99,116
050,35,015,"New Mexico","Eddy County",1,82,221,99,122
050,35,015,"New Mexico","Eddy County",1,83,192,92,100
050,35,015,"New Mexico","Eddy County",1,84,171,64,107
050,35,015,"New Mexico","Eddy County",1,85,962,357,605
050,35,015,"New Mexico","Eddy County",2,0,855,447,408
050,35,015,"New Mexico","Eddy County",2,1,888,453,435
050,35,015,"New Mexico","Eddy County",2,2,876,460,416
050,35,015,"New Mexico","Eddy County",2,3,898,475,423
050,35,015,"New Mexico","Eddy County",2,4,927,483,444
050,35,015,"New Mexico","Eddy County",2,5,953,486,467
050,35,015,"New Mexico","Eddy County",2,6,966,500,466
050,35,015,"New Mexico","Eddy County",2,7,948,481,467
050,35,015,"New Mexico","Eddy County",2,8,919,454,465
050,35,015,"New Mexico","Eddy County",2,9,937,455,482
050,35,015,"New Mexico","Eddy County",2,10,955,487,468
050,35,015,"New Mexico","Eddy County",2,11,976,486,490
050,35,015,"New Mexico","Eddy County",2,12,986,492,494
050,35,015,"New Mexico","Eddy County",2,13,931,481,450
050,35,015,"New Mexico","Eddy County",2,14,908,458,450
050,35,015,"New Mexico","Eddy County",2,15,897,432,465
050,35,015,"New Mexico","Eddy County",2,16,905,438,467
050,35,015,"New Mexico","Eddy County",2,17,905,438,467
050,35,015,"New Mexico","Eddy County",2,18,824,415,409
050,35,015,"New Mexico","Eddy County",2,19,738,378,360
050,35,015,"New Mexico","Eddy County",2,20,765,401,364
050,35,015,"New Mexico","Eddy County",2,21,791,410,381
050,35,015,"New Mexico","Eddy County",2,22,794,415,379
050,35,015,"New Mexico","Eddy County",2,23,797,426,371
050,35,015,"New Mexico","Eddy County",2,24,796,420,376
050,35,015,"New Mexico","Eddy County",2,25,823,418,405
050,35,015,"New Mexico","Eddy County",2,26,845,434,411
050,35,015,"New Mexico","Eddy County",2,27,897,470,427
050,35,015,"New Mexico","Eddy County",2,28,953,511,442
050,35,015,"New Mexico","Eddy County",2,29,951,504,447
050,35,015,"New Mexico","Eddy County",2,30,887,468,419
050,35,015,"New Mexico","Eddy County",2,31,860,460,400
050,35,015,"New Mexico","Eddy County",2,32,859,455,404
050,35,015,"New Mexico","Eddy County",2,33,895,473,422
050,35,015,"New Mexico","Eddy County",2,34,882,468,414
050,35,015,"New Mexico","Eddy County",2,35,886,484,402
050,35,015,"New Mexico","Eddy County",2,36,904,487,417
050,35,015,"New Mexico","Eddy County",2,37,924,500,424
050,35,015,"New Mexico","Eddy County",2,38,884,491,393
050,35,015,"New Mexico","Eddy County",2,39,861,488,373
050,35,015,"New Mexico","Eddy County",2,40,834,453,381
050,35,015,"New Mexico","Eddy County",2,41,798,419,379
050,35,015,"New Mexico","Eddy County",2,42,775,401,374
050,35,015,"New Mexico","Eddy County",2,43,732,387,345
050,35,015,"New Mexico","Eddy County",2,44,697,369,328
050,35,015,"New Mexico","Eddy County",2,45,672,339,333
050,35,015,"New Mexico","Eddy County",2,46,632,320,312
050,35,015,"New Mexico","Eddy County",2,47,657,322,335
050,35,015,"New Mexico","Eddy County",2,48,687,343,344
050,35,015,"New Mexico","Eddy County",2,49,707,362,345
050,35,015,"New Mexico","Eddy County",2,50,685,347,338
050,35,015,"New Mexico","Eddy County",2,51,679,353,326
050,35,015,"New Mexico","Eddy County",2,52,676,352,324
050,35,015,"New Mexico","Eddy County",2,53,694,351,343
050,35,015,"New Mexico","Eddy County",2,54,682,350,332
050,35,015,"New Mexico","Eddy County",2,55,716,373,343
050,35,015,"New Mexico","Eddy County",2,56,743,395,348
050,35,015,"New Mexico","Eddy County",2,57,743,376,367
050,35,015,"New Mexico","Eddy County",2,58,788,379,409
050,35,015,"New Mexico","Eddy County",2,59,791,394,397
050,35,015,"New Mexico","Eddy County",2,60,783,408,375
050,35,015,"New Mexico","Eddy County",2,61,723,380,343
050,35,015,"New Mexico","Eddy County",2,62,733,379,354
050,35,015,"New Mexico","Eddy County",2,63,721,364,357
050,35,015,"New Mexico","Eddy County",2,64,710,355,355
050,35,015,"New Mexico","Eddy County",2,65,720,362,358
050,35,015,"New Mexico","Eddy County",2,66,671,344,327
050,35,015,"New Mexico","Eddy County",2,67,606,304,302
050,35,015,"New Mexico","Eddy County",2,68,548,272,276
050,35,015,"New Mexico","Eddy County",2,69,528,259,269
050,35,015,"New Mexico","Eddy County",2,70,502,245,257
050,35,015,"New Mexico","Eddy County",2,71,496,240,256
050,35,015,"New Mexico","Eddy County",2,72,466,220,246
050,35,015,"New Mexico","Eddy County",2,73,462,228,234
050,35,015,"New Mexico","Eddy County",2,74,331,157,174
050,35,015,"New Mexico","Eddy County",2,75,345,162,183
050,35,015,"New Mexico","Eddy County",2,76,313,146,167
050,35,015,"New Mexico","Eddy County",2,77,308,139,169
050,35,015,"New Mexico","Eddy County",2,78,298,142,156
050,35,015,"New Mexico","Eddy County",2,79,266,124,142
050,35,015,"New Mexico","Eddy County",2,80,220,102,118
050,35,015,"New Mexico","Eddy County",2,81,212,98,114
050,35,015,"New Mexico","Eddy County",2,82,218,99,119
050,35,015,"New Mexico","Eddy County",2,83,195,91,104
050,35,015,"New Mexico","Eddy County",2,84,172,69,103
050,35,015,"New Mexico","Eddy County",2,85,952,349,603
050,35,015,"New Mexico","Eddy County",3,0,795,420,375
050,35,015,"New Mexico","Eddy County",3,1,845,440,405
050,35,015,"New Mexico","Eddy County",3,2,837,437,400
050,35,015,"New Mexico","Eddy County",3,3,857,454,403
050,35,015,"New Mexico","Eddy County",3,4,857,461,396
050,35,015,"New Mexico","Eddy County",3,5,906,461,445
050,35,015,"New Mexico","Eddy County",3,6,919,481,438
050,35,015,"New Mexico","Eddy County",3,7,924,461,463
050,35,015,"New Mexico","Eddy County",3,8,934,478,456
050,35,015,"New Mexico","Eddy County",3,9,891,432,459
050,35,015,"New Mexico","Eddy County",3,10,908,438,470
050,35,015,"New Mexico","Eddy County",3,11,927,476,451
050,35,015,"New Mexico","Eddy County",3,12,939,472,467
050,35,015,"New Mexico","Eddy County",3,13,965,475,490
050,35,015,"New Mexico","Eddy County",3,14,924,481,443
050,35,015,"New Mexico","Eddy County",3,15,880,456,424
050,35,015,"New Mexico","Eddy County",3,16,879,430,449
050,35,015,"New Mexico","Eddy County",3,17,874,421,453
050,35,015,"New Mexico","Eddy County",3,18,811,424,387
050,35,015,"New Mexico","Eddy County",3,19,732,383,349
050,35,015,"New Mexico","Eddy County",3,20,724,385,339
050,35,015,"New Mexico","Eddy County",3,21,730,376,354
050,35,015,"New Mexico","Eddy County",3,22,776,395,381
050,35,015,"New Mexico","Eddy County",3,23,805,436,369
050,35,015,"New Mexico","Eddy County",3,24,788,433,355
050,35,015,"New Mexico","Eddy County",3,25,772,405,367
050,35,015,"New Mexico","Eddy County",3,26,771,392,379
050,35,015,"New Mexico","Eddy County",3,27,817,423,394
050,35,015,"New Mexico","Eddy County",3,28,846,436,410
050,35,015,"New Mexico","Eddy County",3,29,901,476,425
050,35,015,"New Mexico","Eddy County",3,30,931,495,436
050,35,015,"New Mexico","Eddy County",3,31,867,453,414
050,35,015,"New Mexico","Eddy County",3,32,812,427,385
050,35,015,"New Mexico","Eddy County",3,33,840,444,396
050,35,015,"New Mexico","Eddy County",3,34,868,454,414
050,35,015,"New Mexico","Eddy County",3,35,883,477,406
050,35,015,"New Mexico","Eddy County",3,36,891,486,405
050,35,015,"New Mexico","Eddy County",3,37,890,492,398
050,35,015,"New Mexico","Eddy County",3,38,901,490,411
050,35,015,"New Mexico","Eddy County",3,39,851,468,383
050,35,015,"New Mexico","Eddy County",3,40,848,479,369
050,35,015,"New Mexico","Eddy County",3,41,809,446,363
050,35,015,"New Mexico","Eddy County",3,42,769,409,360
050,35,015,"New Mexico","Eddy County",3,43,752,377,375
050,35,015,"New Mexico","Eddy County",3,44,717,378,339
050,35,015,"New Mexico","Eddy County",3,45,683,357,326
050,35,015,"New Mexico","Eddy County",3,46,657,332,325
050,35,015,"New Mexico","Eddy County",3,47,619,310,309
050,35,015,"New Mexico","Eddy County",3,48,632,312,320
050,35,015,"New Mexico","Eddy County",3,49,661,335,326
050,35,015,"New Mexico","Eddy County",3,50,711,355,356
050,35,015,"New Mexico","Eddy County",3,51,680,344,336
050,35,015,"New Mexico","Eddy County",3,52,662,341,321
050,35,015,"New Mexico","Eddy County",3,53,656,342,314
050,35,015,"New Mexico","Eddy County",3,54,665,340,325
050,35,015,"New Mexico","Eddy County",3,55,652,329,323
050,35,015,"New Mexico","Eddy County",3,56,698,363,335
050,35,015,"New Mexico","Eddy County",3,57,715,379,336
050,35,015,"New Mexico","Eddy County",3,58,733,372,361
050,35,015,"New Mexico","Eddy County",3,59,768,365,403
050,35,015,"New Mexico","Eddy County",3,60,755,376,379
050,35,015,"New Mexico","Eddy County",3,61,742,381,361
050,35,015,"New Mexico","Eddy County",3,62,679,351,328
050,35,015,"New Mexico","Eddy County",3,63,716,374,342
050,35,015,"New Mexico","Eddy County",3,64,691,345,346
050,35,015,"New Mexico","Eddy County",3,65,676,338,338
050,35,015,"New Mexico","Eddy County",3,66,696,348,348
050,35,015,"New Mexico","Eddy County",3,67,643,332,311
050,35,015,"New Mexico","Eddy County",3,68,579,287,292
050,35,015,"New Mexico","Eddy County",3,69,536,261,275
050,35,015,"New Mexico","Eddy County",3,70,501,245,256
050,35,015,"New Mexico","Eddy County",3,71,484,228,256
050,35,015,"New Mexico","Eddy County",3,72,477,228,249
050,35,015,"New Mexico","Eddy County",3,73,450,212,238
050,35,015,"New Mexico","Eddy County",3,74,443,219,224
050,35,015,"New Mexico","Eddy County",3,75,318,148,170
050,35,015,"New Mexico","Eddy County",3,76,322,152,170
050,35,015,"New Mexico","Eddy County",3,77,289,130,159
050,35,015,"New Mexico","Eddy County",3,78,281,128,153
050,35,015,"New Mexico","Eddy County",3,79,273,132,141
050,35,015,"New Mexico","Eddy County",3,80,244,108,136
050,35,015,"New Mexico","Eddy County",3,81,208,96,112
050,35,015,"New Mexico","Eddy County",3,82,186,86,100
050,35,015,"New Mexico","Eddy County",3,83,200,89,111
050,35,015,"New Mexico","Eddy County",3,84,172,82,90
050,35,015,"New Mexico","Eddy County",3,85,939,337,602
050,35,015,"New Mexico","Eddy County",4,0,757,387,370
050,35,015,"New Mexico","Eddy County",4,1,803,433,370
050,35,015,"New Mexico","Eddy County",4,2,827,435,392
050,35,015,"New Mexico","Eddy County",4,3,854,446,408
050,35,015,"New Mexico","Eddy County",4,4,862,455,407
050,35,015,"New Mexico","Eddy County",4,5,887,480,407
050,35,015,"New Mexico","Eddy County",4,6,877,443,434
050,35,015,"New Mexico","Eddy County",4,7,915,473,442
050,35,015,"New Mexico","Eddy County",4,8,926,463,463
050,35,015,"New Mexico","Eddy County",4,9,940,483,457
050,35,015,"New Mexico","Eddy County",4,10,879,427,452
050,35,015,"New Mexico","Eddy County",4,11,869,429,440
050,35,015,"New Mexico","Eddy County",4,12,930,468,462
050,35,015,"New Mexico","Eddy County",4,13,939,470,469
050,35,015,"New Mexico","Eddy County",4,14,964,469,495
050,35,015,"New Mexico","Eddy County",4,15,909,474,435
050,35,015,"New Mexico","Eddy County",4,16,892,462,430
050,35,015,"New Mexico","Eddy County",4,17,884,428,456
050,35,015,"New Mexico","Eddy County",4,18,809,398,411
050,35,015,"New Mexico","Eddy County",4,19,739,397,342
050,35,015,"New Mexico","Eddy County",4,20,762,401,361
050,35,015,"New Mexico","Eddy County",4,21,709,367,342
050,35,015,"New Mexico","Eddy County",4,22,722,372,350
050,35,015,"New Mexico","Eddy County",4,23,809,435,374
050,35,015,"New Mexico","Eddy County",4,24,790,420,370
050,35,015,"New Mexico","Eddy County",4,25,771,394,377
050,35,015,"New Mexico","Eddy County",4,26,756,398,358
050,35,015,"New Mexico","Eddy County",4,27,756,378,378
050,35,015,"New Mexico","Eddy County",4,28,795,419,376
050,35,015,"New Mexico","Eddy County",4,29,830,411,419
050,35,015,"New Mexico","Eddy County",4,30,885,468,417
050,35,015,"New Mexico","Eddy County",4,31,935,487,448
050,35,015,"New Mexico","Eddy County",4,32,864,457,407
050,35,015,"New Mexico","Eddy County",4,33,813,435,378
050,35,015,"New Mexico","Eddy County",4,34,814,426,388
050,35,015,"New Mexico","Eddy County",4,35,866,451,415
050,35,015,"New Mexico","Eddy County",4,36,859,463,396
050,35,015,"New Mexico","Eddy County",4,37,876,474,402
050,35,015,"New Mexico","Eddy County",4,38,876,470,406
050,35,015,"New Mexico","Eddy County",4,39,867,462,405
050,35,015,"New Mexico","Eddy County",4,40,845,463,382
050,35,015,"New Mexico","Eddy County",4,41,818,455,363
050,35,015,"New Mexico","Eddy County",4,42,793,426,367
050,35,015,"New Mexico","Eddy County",4,43,760,398,362
050,35,015,"New Mexico","Eddy County",4,44,735,365,370
050,35,015,"New Mexico","Eddy County",4,45,705,381,324
050,35,015,"New Mexico","Eddy County",4,46,673,347,326
050,35,015,"New Mexico","Eddy County",4,47,650,329,321
050,35,015,"New Mexico","Eddy County",4,48,595,301,294
050,35,015,"New Mexico","Eddy County",4,49,610,303,307
050,35,015,"New Mexico","Eddy County",4,50,636,327,309
050,35,015,"New Mexico","Eddy County",4,51,709,363,346
050,35,015,"New Mexico","Eddy County",4,52,670,336,334
050,35,015,"New Mexico","Eddy County",4,53,674,344,330
050,35,015,"New Mexico","Eddy County",4,54,641,331,310
050,35,015,"New Mexico","Eddy County",4,55,654,332,322
050,35,015,"New Mexico","Eddy County",4,56,626,322,304
050,35,015,"New Mexico","Eddy County",4,57,694,355,339
050,35,015,"New Mexico","Eddy County",4,58,674,369,305
050,35,015,"New Mexico","Eddy County",4,59,719,361,358
050,35,015,"New Mexico","Eddy County",4,60,752,362,390
050,35,015,"New Mexico","Eddy County",4,61,710,351,359
050,35,015,"New Mexico","Eddy County",4,62,723,364,359
050,35,015,"New Mexico","Eddy County",4,63,644,328,316
050,35,015,"New Mexico","Eddy County",4,64,695,359,336
050,35,015,"New Mexico","Eddy County",4,65,667,330,337
050,35,015,"New Mexico","Eddy County",4,66,654,335,319
050,35,015,"New Mexico","Eddy County",4,67,662,332,330
050,35,015,"New Mexico","Eddy County",4,68,622,317,305
050,35,015,"New Mexico","Eddy County",4,69,558,278,280
050,35,015,"New Mexico","Eddy County",4,70,512,253,259
050,35,015,"New Mexico","Eddy County",4,71,478,230,248
050,35,015,"New Mexico","Eddy County",4,72,465,219,246
050,35,015,"New Mexico","Eddy County",4,73,458,217,241
050,35,015,"New Mexico","Eddy County",4,74,426,198,228
050,35,015,"New Mexico","Eddy County",4,75,433,213,220
050,35,015,"New Mexico","Eddy County",4,76,294,135,159
050,35,015,"New Mexico","Eddy County",4,77,305,140,165
050,35,015,"New Mexico","Eddy County",4,78,260,114,146
050,35,015,"New Mexico","Eddy County",4,79,260,120,140
050,35,015,"New Mexico","Eddy County",4,80,246,122,124
050,35,015,"New Mexico","Eddy County",4,81,232,101,131
050,35,015,"New Mexico","Eddy County",4,82,189,92,97
050,35,015,"New Mexico","Eddy County",4,83,158,71,87
050,35,015,"New Mexico","Eddy County",4,84,178,78,100
050,35,015,"New Mexico","Eddy County",4,85,924,342,582
050,35,015,"New Mexico","Eddy County",5,0,734,372,362
050,35,015,"New Mexico","Eddy County",5,1,787,401,386
050,35,015,"New Mexico","Eddy County",5,2,816,438,378
050,35,015,"New Mexico","Eddy County",5,3,834,435,399
050,35,015,"New Mexico","Eddy County",5,4,862,456,406
050,35,015,"New Mexico","Eddy County",5,5,884,478,406
050,35,015,"New Mexico","Eddy County",5,6,904,483,421
050,35,015,"New Mexico","Eddy County",5,7,890,446,444
050,35,015,"New Mexico","Eddy County",5,8,902,470,432
050,35,015,"New Mexico","Eddy County",5,9,947,468,479
050,35,015,"New Mexico","Eddy County",5,10,975,504,471
050,35,015,"New Mexico","Eddy County",5,11,872,426,446
050,35,015,"New Mexico","Eddy County",5,12,869,431,438
050,35,015,"New Mexico","Eddy County",5,13,946,483,463
050,35,015,"New Mexico","Eddy County",5,14,923,458,465
050,35,015,"New Mexico","Eddy County",5,15,947,472,475
050,35,015,"New Mexico","Eddy County",5,16,917,466,451
050,35,015,"New Mexico","Eddy County",5,17,882,453,429
050,35,015,"New Mexico","Eddy County",5,18,805,403,402
050,35,015,"New Mexico","Eddy County",5,19,735,373,362
050,35,015,"New Mexico","Eddy County",5,20,786,435,351
050,35,015,"New Mexico","Eddy County",5,21,760,398,362
050,35,015,"New Mexico","Eddy County",5,22,735,384,351
050,35,015,"New Mexico","Eddy County",5,23,783,405,378
050,35,015,"New Mexico","Eddy County",5,24,804,426,378
050,35,015,"New Mexico","Eddy County",5,25,798,412,386
050,35,015,"New Mexico","Eddy County",5,26,775,402,373
050,35,015,"New Mexico","Eddy County",5,27,766,395,371
050,35,015,"New Mexico","Eddy County",5,28,765,393,372
050,35,015,"New Mexico","Eddy County",5,29,794,413,381
050,35,015,"New Mexico","Eddy County",5,30,833,417,416
050,35,015,"New Mexico","Eddy County",5,31,919,490,429
050,35,015,"New Mexico","Eddy County",5,32,929,492,437
050,35,015,"New Mexico","Eddy County",5,33,859,455,404
050,35,015,"New Mexico","Eddy County",5,34,798,426,372
050,35,015,"New Mexico","Eddy County",5,35,814,427,387
050,35,015,"New Mexico","Eddy County",5,36,865,448,417
050,35,015,"New Mexico","Eddy County",5,37,830,446,384
050,35,015,"New Mexico","Eddy County",5,38,866,472,394
050,35,015,"New Mexico","Eddy County",5,39,899,476,423
050,35,015,"New Mexico","Eddy County",5,40,846,438,408
050,35,015,"New Mexico","Eddy County",5,41,848,466,382
050,35,015,"New Mexico","Eddy County",5,42,817,458,359
050,35,015,"New Mexico","Eddy County",5,43,792,423,369
050,35,015,"New Mexico","Eddy County",5,44,750,402,348
050,35,015,"New Mexico","Eddy County",5,45,738,370,368
050,35,015,"New Mexico","Eddy County",5,46,695,367,328
050,35,015,"New Mexico","Eddy County",5,47,675,350,325
050,35,015,"New Mexico","Eddy County",5,48,656,329,327
050,35,015,"New Mexico","Eddy County",5,49,598,297,301
050,35,015,"New Mexico","Eddy County",5,50,613,302,311
050,35,015,"New Mexico","Eddy County",5,51,629,319,310
050,35,015,"New Mexico","Eddy County",5,52,701,353,348
050,35,015,"New Mexico","Eddy County",5,53,687,349,338
050,35,015,"New Mexico","Eddy County",5,54,656,333,323
050,35,015,"New Mexico","Eddy County",5,55,628,326,302
050,35,015,"New Mexico","Eddy County",5,56,645,330,315
050,35,015,"New Mexico","Eddy County",5,57,612,310,302
050,35,015,"New Mexico","Eddy County",5,58,673,346,327
050,35,015,"New Mexico","Eddy County",5,59,657,350,307
050,35,015,"New Mexico","Eddy County",5,60,716,362,354
050,35,015,"New Mexico","Eddy County",5,61,725,335,390
050,35,015,"New Mexico","Eddy County",5,62,687,342,345
050,35,015,"New Mexico","Eddy County",5,63,702,360,342
050,35,015,"New Mexico","Eddy County",5,64,616,318,298
050,35,015,"New Mexico","Eddy County",5,65,670,347,323
050,35,015,"New Mexico","Eddy County",5,66,651,315,336
050,35,015,"New Mexico","Eddy County",5,67,643,331,312
050,35,015,"New Mexico","Eddy County",5,68,649,325,324
050,35,015,"New Mexico","Eddy County",5,69,602,306,296
050,35,015,"New Mexico","Eddy County",5,70,532,270,262
050,35,015,"New Mexico","Eddy County",5,71,489,240,249
050,35,015,"New Mexico","Eddy County",5,72,452,220,232
050,35,015,"New Mexico","Eddy County",5,73,437,205,232
050,35,015,"New Mexico","Eddy County",5,74,437,207,230
050,35,015,"New Mexico","Eddy County",5,75,409,187,222
050,35,015,"New Mexico","Eddy County",5,76,409,194,215
050,35,015,"New Mexico","Eddy County",5,77,275,129,146
050,35,015,"New Mexico","Eddy County",5,78,285,127,158
050,35,015,"New Mexico","Eddy County",5,79,239,102,137
050,35,015,"New Mexico","Eddy County",5,80,233,106,127
050,35,015,"New Mexico","Eddy County",5,81,236,116,120
050,35,015,"New Mexico","Eddy County",5,82,215,97,118
050,35,015,"New Mexico","Eddy County",5,83,161,75,86
050,35,015,"New Mexico","Eddy County",5,84,136,62,74
050,35,015,"New Mexico","Eddy County",5,85,944,353,591
050,35,017,"New Mexico","Grant County",1,0,239,121,118
050,35,017,"New Mexico","Grant County",1,1,241,113,128
050,35,017,"New Mexico","Grant County",1,2,261,131,130
050,35,017,"New Mexico","Grant County",1,3,277,143,134
050,35,017,"New Mexico","Grant County",1,4,291,136,155
050,35,017,"New Mexico","Grant County",1,5,308,157,151
050,35,017,"New Mexico","Grant County",1,6,312,164,148
050,35,017,"New Mexico","Grant County",1,7,286,145,141
050,35,017,"New Mexico","Grant County",1,8,294,154,140
050,35,017,"New Mexico","Grant County",1,9,330,158,172
050,35,017,"New Mexico","Grant County",1,10,348,181,167
050,35,017,"New Mexico","Grant County",1,11,334,175,159
050,35,017,"New Mexico","Grant County",1,12,339,179,160
050,35,017,"New Mexico","Grant County",1,13,320,161,159
050,35,017,"New Mexico","Grant County",1,14,323,167,156
050,35,017,"New Mexico","Grant County",1,15,307,158,149
050,35,017,"New Mexico","Grant County",1,16,309,159,150
050,35,017,"New Mexico","Grant County",1,17,323,164,159
050,35,017,"New Mexico","Grant County",1,18,364,193,171
050,35,017,"New Mexico","Grant County",1,19,357,186,171
050,35,017,"New Mexico","Grant County",1,20,338,183,155
050,35,017,"New Mexico","Grant County",1,21,314,163,151
050,35,017,"New Mexico","Grant County",1,22,296,166,130
050,35,017,"New Mexico","Grant County",1,23,254,143,111
050,35,017,"New Mexico","Grant County",1,24,275,139,136
050,35,017,"New Mexico","Grant County",1,25,267,140,127
050,35,017,"New Mexico","Grant County",1,26,273,142,131
050,35,017,"New Mexico","Grant County",1,27,280,149,131
050,35,017,"New Mexico","Grant County",1,28,280,147,133
050,35,017,"New Mexico","Grant County",1,29,246,117,129
050,35,017,"New Mexico","Grant County",1,30,234,119,115
050,35,017,"New Mexico","Grant County",1,31,235,121,114
050,35,017,"New Mexico","Grant County",1,32,274,135,139
050,35,017,"New Mexico","Grant County",1,33,277,143,134
050,35,017,"New Mexico","Grant County",1,34,276,136,140
050,35,017,"New Mexico","Grant County",1,35,287,151,136
050,35,017,"New Mexico","Grant County",1,36,290,149,141
050,35,017,"New Mexico","Grant County",1,37,283,151,132
050,35,017,"New Mexico","Grant County",1,38,295,141,154
050,35,017,"New Mexico","Grant County",1,39,294,147,147
050,35,017,"New Mexico","Grant County",1,40,300,139,161
050,35,017,"New Mexico","Grant County",1,41,313,152,161
050,35,017,"New Mexico","Grant County",1,42,315,153,162
050,35,017,"New Mexico","Grant County",1,43,287,138,149
050,35,017,"New Mexico","Grant County",1,44,264,131,133
050,35,017,"New Mexico","Grant County",1,45,269,141,128
050,35,017,"New Mexico","Grant County",1,46,274,141,133
050,35,017,"New Mexico","Grant County",1,47,270,137,133
050,35,017,"New Mexico","Grant County",1,48,299,158,141
050,35,017,"New Mexico","Grant County",1,49,296,149,147
050,35,017,"New Mexico","Grant County",1,50,284,138,146
050,35,017,"New Mexico","Grant County",1,51,268,121,147
050,35,017,"New Mexico","Grant County",1,52,265,125,140
050,35,017,"New Mexico","Grant County",1,53,297,153,144
050,35,017,"New Mexico","Grant County",1,54,285,141,144
050,35,017,"New Mexico","Grant County",1,55,323,152,171
050,35,017,"New Mexico","Grant County",1,56,347,151,196
050,35,017,"New Mexico","Grant County",1,57,382,177,205
050,35,017,"New Mexico","Grant County",1,58,422,197,225
050,35,017,"New Mexico","Grant County",1,59,411,206,205
050,35,017,"New Mexico","Grant County",1,60,405,190,215
050,35,017,"New Mexico","Grant County",1,61,419,211,208
050,35,017,"New Mexico","Grant County",1,62,455,224,231
050,35,017,"New Mexico","Grant County",1,63,479,223,256
050,35,017,"New Mexico","Grant County",1,64,476,223,253
050,35,017,"New Mexico","Grant County",1,65,454,218,236
050,35,017,"New Mexico","Grant County",1,66,483,225,258
050,35,017,"New Mexico","Grant County",1,67,515,239,276
050,35,017,"New Mexico","Grant County",1,68,529,244,285
050,35,017,"New Mexico","Grant County",1,69,491,243,248
050,35,017,"New Mexico","Grant County",1,70,509,251,258
050,35,017,"New Mexico","Grant County",1,71,471,230,241
050,35,017,"New Mexico","Grant County",1,72,457,232,225
050,35,017,"New Mexico","Grant County",1,73,469,241,228
050,35,017,"New Mexico","Grant County",1,74,334,169,165
050,35,017,"New Mexico","Grant County",1,75,344,181,163
050,35,017,"New Mexico","Grant County",1,76,349,175,174
050,35,017,"New Mexico","Grant County",1,77,347,184,163
050,35,017,"New Mexico","Grant County",1,78,293,148,145
050,35,017,"New Mexico","Grant County",1,79,255,129,126
050,35,017,"New Mexico","Grant County",1,80,219,108,111
050,35,017,"New Mexico","Grant County",1,81,212,103,109
050,35,017,"New Mexico","Grant County",1,82,200,93,107
050,35,017,"New Mexico","Grant County",1,83,159,75,84
050,35,017,"New Mexico","Grant County",1,84,147,71,76
050,35,017,"New Mexico","Grant County",1,85,818,335,483
050,35,017,"New Mexico","Grant County",2,0,239,122,117
050,35,017,"New Mexico","Grant County",2,1,239,114,125
050,35,017,"New Mexico","Grant County",2,2,258,127,131
050,35,017,"New Mexico","Grant County",2,3,273,140,133
050,35,017,"New Mexico","Grant County",2,4,290,138,152
050,35,017,"New Mexico","Grant County",2,5,305,151,154
050,35,017,"New Mexico","Grant County",2,6,313,164,149
050,35,017,"New Mexico","Grant County",2,7,294,150,144
050,35,017,"New Mexico","Grant County",2,8,294,152,142
050,35,017,"New Mexico","Grant County",2,9,322,157,165
050,35,017,"New Mexico","Grant County",2,10,343,174,169
050,35,017,"New Mexico","Grant County",2,11,336,176,160
050,35,017,"New Mexico","Grant County",2,12,342,179,163
050,35,017,"New Mexico","Grant County",2,13,325,166,159
050,35,017,"New Mexico","Grant County",2,14,320,164,156
050,35,017,"New Mexico","Grant County",2,15,313,159,154
050,35,017,"New Mexico","Grant County",2,16,306,155,151
050,35,017,"New Mexico","Grant County",2,17,317,161,156
050,35,017,"New Mexico","Grant County",2,18,359,189,170
050,35,017,"New Mexico","Grant County",2,19,356,186,170
050,35,017,"New Mexico","Grant County",2,20,341,185,156
050,35,017,"New Mexico","Grant County",2,21,317,167,150
050,35,017,"New Mexico","Grant County",2,22,297,165,132
050,35,017,"New Mexico","Grant County",2,23,256,142,114
050,35,017,"New Mexico","Grant County",2,24,269,139,130
050,35,017,"New Mexico","Grant County",2,25,267,137,130
050,35,017,"New Mexico","Grant County",2,26,270,140,130
050,35,017,"New Mexico","Grant County",2,27,275,146,129
050,35,017,"New Mexico","Grant County",2,28,282,148,134
050,35,017,"New Mexico","Grant County",2,29,253,123,130
050,35,017,"New Mexico","Grant County",2,30,242,121,121
050,35,017,"New Mexico","Grant County",2,31,229,118,111
050,35,017,"New Mexico","Grant County",2,32,267,133,134
050,35,017,"New Mexico","Grant County",2,33,278,143,135
050,35,017,"New Mexico","Grant County",2,34,280,139,141
050,35,017,"New Mexico","Grant County",2,35,290,150,140
050,35,017,"New Mexico","Grant County",2,36,289,151,138
050,35,017,"New Mexico","Grant County",2,37,283,149,134
050,35,017,"New Mexico","Grant County",2,38,293,144,149
050,35,017,"New Mexico","Grant County",2,39,295,146,149
050,35,017,"New Mexico","Grant County",2,40,303,144,159
050,35,017,"New Mexico","Grant County",2,41,310,150,160
050,35,017,"New Mexico","Grant County",2,42,314,153,161
050,35,017,"New Mexico","Grant County",2,43,298,143,155
050,35,017,"New Mexico","Grant County",2,44,270,133,137
050,35,017,"New Mexico","Grant County",2,45,269,141,128
050,35,017,"New Mexico","Grant County",2,46,270,140,130
050,35,017,"New Mexico","Grant County",2,47,272,138,134
050,35,017,"New Mexico","Grant County",2,48,290,152,138
050,35,017,"New Mexico","Grant County",2,49,299,153,146
050,35,017,"New Mexico","Grant County",2,50,289,142,147
050,35,017,"New Mexico","Grant County",2,51,271,124,147
050,35,017,"New Mexico","Grant County",2,52,267,124,143
050,35,017,"New Mexico","Grant County",2,53,289,148,141
050,35,017,"New Mexico","Grant County",2,54,285,143,142
050,35,017,"New Mexico","Grant County",2,55,316,150,166
050,35,017,"New Mexico","Grant County",2,56,342,151,191
050,35,017,"New Mexico","Grant County",2,57,374,171,203
050,35,017,"New Mexico","Grant County",2,58,415,193,222
050,35,017,"New Mexico","Grant County",2,59,414,206,208
050,35,017,"New Mexico","Grant County",2,60,411,195,216
050,35,017,"New Mexico","Grant County",2,61,413,205,208
050,35,017,"New Mexico","Grant County",2,62,450,224,226
050,35,017,"New Mexico","Grant County",2,63,477,222,255
050,35,017,"New Mexico","Grant County",2,64,469,219,250
050,35,017,"New Mexico","Grant County",2,65,463,221,242
050,35,017,"New Mexico","Grant County",2,66,476,223,253
050,35,017,"New Mexico","Grant County",2,67,512,240,272
050,35,017,"New Mexico","Grant County",2,68,522,242,280
050,35,017,"New Mexico","Grant County",2,69,502,244,258
050,35,017,"New Mexico","Grant County",2,70,504,250,254
050,35,017,"New Mexico","Grant County",2,71,480,235,245
050,35,017,"New Mexico","Grant County",2,72,455,228,227
050,35,017,"New Mexico","Grant County",2,73,486,250,236
050,35,017,"New Mexico","Grant County",2,74,347,175,172
050,35,017,"New Mexico","Grant County",2,75,341,179,162
050,35,017,"New Mexico","Grant County",2,76,347,177,170
050,35,017,"New Mexico","Grant County",2,77,348,183,165
050,35,017,"New Mexico","Grant County",2,78,300,154,146
050,35,017,"New Mexico","Grant County",2,79,261,131,130
050,35,017,"New Mexico","Grant County",2,80,224,110,114
050,35,017,"New Mexico","Grant County",2,81,209,103,106
050,35,017,"New Mexico","Grant County",2,82,201,94,107
050,35,017,"New Mexico","Grant County",2,83,165,77,88
050,35,017,"New Mexico","Grant County",2,84,147,72,75
050,35,017,"New Mexico","Grant County",2,85,821,344,477
050,35,017,"New Mexico","Grant County",3,0,243,129,114
050,35,017,"New Mexico","Grant County",3,1,236,119,117
050,35,017,"New Mexico","Grant County",3,2,241,118,123
050,35,017,"New Mexico","Grant County",3,3,238,116,122
050,35,017,"New Mexico","Grant County",3,4,269,141,128
050,35,017,"New Mexico","Grant County",3,5,280,132,148
050,35,017,"New Mexico","Grant County",3,6,288,139,149
050,35,017,"New Mexico","Grant County",3,7,304,159,145
050,35,017,"New Mexico","Grant County",3,8,290,148,142
050,35,017,"New Mexico","Grant County",3,9,287,148,139
050,35,017,"New Mexico","Grant County",3,10,302,146,156
050,35,017,"New Mexico","Grant County",3,11,339,172,167
050,35,017,"New Mexico","Grant County",3,12,325,173,152
050,35,017,"New Mexico","Grant County",3,13,330,175,155
050,35,017,"New Mexico","Grant County",3,14,314,165,149
050,35,017,"New Mexico","Grant County",3,15,309,162,147
050,35,017,"New Mexico","Grant County",3,16,305,147,158
050,35,017,"New Mexico","Grant County",3,17,285,142,143
050,35,017,"New Mexico","Grant County",3,18,349,180,169
050,35,017,"New Mexico","Grant County",3,19,349,182,167
050,35,017,"New Mexico","Grant County",3,20,330,183,147
050,35,017,"New Mexico","Grant County",3,21,338,182,156
050,35,017,"New Mexico","Grant County",3,22,313,166,147
050,35,017,"New Mexico","Grant County",3,23,272,139,133
050,35,017,"New Mexico","Grant County",3,24,255,148,107
050,35,017,"New Mexico","Grant County",3,25,271,139,132
050,35,017,"New Mexico","Grant County",3,26,268,141,127
050,35,017,"New Mexico","Grant County",3,27,269,140,129
050,35,017,"New Mexico","Grant County",3,28,281,150,131
050,35,017,"New Mexico","Grant County",3,29,266,132,134
050,35,017,"New Mexico","Grant County",3,30,251,122,129
050,35,017,"New Mexico","Grant County",3,31,225,117,108
050,35,017,"New Mexico","Grant County",3,32,231,117,114
050,35,017,"New Mexico","Grant County",3,33,264,134,130
050,35,017,"New Mexico","Grant County",3,34,274,138,136
050,35,017,"New Mexico","Grant County",3,35,264,135,129
050,35,017,"New Mexico","Grant County",3,36,291,153,138
050,35,017,"New Mexico","Grant County",3,37,271,140,131
050,35,017,"New Mexico","Grant County",3,38,268,139,129
050,35,017,"New Mexico","Grant County",3,39,290,137,153
050,35,017,"New Mexico","Grant County",3,40,299,145,154
050,35,017,"New Mexico","Grant County",3,41,300,146,154
050,35,017,"New Mexico","Grant County",3,42,306,146,160
050,35,017,"New Mexico","Grant County",3,43,306,153,153
050,35,017,"New Mexico","Grant County",3,44,292,136,156
050,35,017,"New Mexico","Grant County",3,45,273,134,139
050,35,017,"New Mexico","Grant County",3,46,261,135,126
050,35,017,"New Mexico","Grant County",3,47,283,152,131
050,35,017,"New Mexico","Grant County",3,48,274,135,139
050,35,017,"New Mexico","Grant County",3,49,290,152,138
050,35,017,"New Mexico","Grant County",3,50,311,164,147
050,35,017,"New Mexico","Grant County",3,51,291,140,151
050,35,017,"New Mexico","Grant County",3,52,270,123,147
050,35,017,"New Mexico","Grant County",3,53,265,126,139
050,35,017,"New Mexico","Grant County",3,54,290,147,143
050,35,017,"New Mexico","Grant County",3,55,289,150,139
050,35,017,"New Mexico","Grant County",3,56,314,149,165
050,35,017,"New Mexico","Grant County",3,57,342,149,193
050,35,017,"New Mexico","Grant County",3,58,381,166,215
050,35,017,"New Mexico","Grant County",3,59,398,189,209
050,35,017,"New Mexico","Grant County",3,60,426,213,213
050,35,017,"New Mexico","Grant County",3,61,405,193,212
050,35,017,"New Mexico","Grant County",3,62,430,215,215
050,35,017,"New Mexico","Grant County",3,63,468,228,240
050,35,017,"New Mexico","Grant County",3,64,460,219,241
050,35,017,"New Mexico","Grant County",3,65,479,226,253
050,35,017,"New Mexico","Grant County",3,66,456,222,234
050,35,017,"New Mexico","Grant County",3,67,489,231,258
050,35,017,"New Mexico","Grant County",3,68,513,245,268
050,35,017,"New Mexico","Grant County",3,69,518,239,279
050,35,017,"New Mexico","Grant County",3,70,501,247,254
050,35,017,"New Mexico","Grant County",3,71,496,244,252
050,35,017,"New Mexico","Grant County",3,72,474,230,244
050,35,017,"New Mexico","Grant County",3,73,448,225,223
050,35,017,"New Mexico","Grant County",3,74,481,249,232
050,35,017,"New Mexico","Grant County",3,75,343,165,178
050,35,017,"New Mexico","Grant County",3,76,344,184,160
050,35,017,"New Mexico","Grant County",3,77,328,164,164
050,35,017,"New Mexico","Grant County",3,78,332,175,157
050,35,017,"New Mexico","Grant County",3,79,286,148,138
050,35,017,"New Mexico","Grant County",3,80,252,126,126
050,35,017,"New Mexico","Grant County",3,81,206,97,109
050,35,017,"New Mexico","Grant County",3,82,193,90,103
050,35,017,"New Mexico","Grant County",3,83,188,86,102
050,35,017,"New Mexico","Grant County",3,84,147,62,85
050,35,017,"New Mexico","Grant County",3,85,820,348,472
050,35,017,"New Mexico","Grant County",4,0,212,115,97
050,35,017,"New Mexico","Grant County",4,1,236,133,103
050,35,017,"New Mexico","Grant County",4,2,233,118,115
050,35,017,"New Mexico","Grant County",4,3,236,111,125
050,35,017,"New Mexico","Grant County",4,4,246,123,123
050,35,017,"New Mexico","Grant County",4,5,265,136,129
050,35,017,"New Mexico","Grant County",4,6,273,136,137
050,35,017,"New Mexico","Grant County",4,7,298,143,155
050,35,017,"New Mexico","Grant County",4,8,294,162,132
050,35,017,"New Mexico","Grant County",4,9,273,138,135
050,35,017,"New Mexico","Grant County",4,10,281,143,138
050,35,017,"New Mexico","Grant County",4,11,294,147,147
050,35,017,"New Mexico","Grant County",4,12,340,169,171
050,35,017,"New Mexico","Grant County",4,13,323,171,152
050,35,017,"New Mexico","Grant County",4,14,326,168,158
050,35,017,"New Mexico","Grant County",4,15,317,169,148
050,35,017,"New Mexico","Grant County",4,16,312,164,148
050,35,017,"New Mexico","Grant County",4,17,308,149,159
050,35,017,"New Mexico","Grant County",4,18,329,170,159
050,35,017,"New Mexico","Grant County",4,19,333,178,155
050,35,017,"New Mexico","Grant County",4,20,325,180,145
050,35,017,"New Mexico","Grant County",4,21,319,172,147
050,35,017,"New Mexico","Grant County",4,22,357,200,157
050,35,017,"New Mexico","Grant County",4,23,277,135,142
050,35,017,"New Mexico","Grant County",4,24,265,142,123
050,35,017,"New Mexico","Grant County",4,25,249,142,107
050,35,017,"New Mexico","Grant County",4,26,242,123,119
050,35,017,"New Mexico","Grant County",4,27,256,132,124
050,35,017,"New Mexico","Grant County",4,28,272,150,122
050,35,017,"New Mexico","Grant County",4,29,259,132,127
050,35,017,"New Mexico","Grant County",4,30,271,139,132
050,35,017,"New Mexico","Grant County",4,31,239,118,121
050,35,017,"New Mexico","Grant County",4,32,236,118,118
050,35,017,"New Mexico","Grant County",4,33,235,116,119
050,35,017,"New Mexico","Grant County",4,34,262,128,134
050,35,017,"New Mexico","Grant County",4,35,279,142,137
050,35,017,"New Mexico","Grant County",4,36,258,130,128
050,35,017,"New Mexico","Grant County",4,37,290,149,141
050,35,017,"New Mexico","Grant County",4,38,271,147,124
050,35,017,"New Mexico","Grant County",4,39,266,139,127
050,35,017,"New Mexico","Grant County",4,40,305,149,156
050,35,017,"New Mexico","Grant County",4,41,297,146,151
050,35,017,"New Mexico","Grant County",4,42,293,137,156
050,35,017,"New Mexico","Grant County",4,43,310,149,161
050,35,017,"New Mexico","Grant County",4,44,314,153,161
050,35,017,"New Mexico","Grant County",4,45,289,136,153
050,35,017,"New Mexico","Grant County",4,46,275,133,142
050,35,017,"New Mexico","Grant County",4,47,279,149,130
050,35,017,"New Mexico","Grant County",4,48,279,152,127
050,35,017,"New Mexico","Grant County",4,49,267,132,135
050,35,017,"New Mexico","Grant County",4,50,291,153,138
050,35,017,"New Mexico","Grant County",4,51,302,155,147
050,35,017,"New Mexico","Grant County",4,52,288,136,152
050,35,017,"New Mexico","Grant County",4,53,274,129,145
050,35,017,"New Mexico","Grant County",4,54,264,128,136
050,35,017,"New Mexico","Grant County",4,55,283,141,142
050,35,017,"New Mexico","Grant County",4,56,300,157,143
050,35,017,"New Mexico","Grant County",4,57,321,154,167
050,35,017,"New Mexico","Grant County",4,58,345,143,202
050,35,017,"New Mexico","Grant County",4,59,377,172,205
050,35,017,"New Mexico","Grant County",4,60,405,186,219
050,35,017,"New Mexico","Grant County",4,61,428,219,209
050,35,017,"New Mexico","Grant County",4,62,419,201,218
050,35,017,"New Mexico","Grant County",4,63,442,216,226
050,35,017,"New Mexico","Grant County",4,64,468,225,243
050,35,017,"New Mexico","Grant County",4,65,477,238,239
050,35,017,"New Mexico","Grant County",4,66,472,217,255
050,35,017,"New Mexico","Grant County",4,67,461,228,233
050,35,017,"New Mexico","Grant County",4,68,495,237,258
050,35,017,"New Mexico","Grant County",4,69,506,245,261
050,35,017,"New Mexico","Grant County",4,70,501,238,263
050,35,017,"New Mexico","Grant County",4,71,487,240,247
050,35,017,"New Mexico","Grant County",4,72,499,250,249
050,35,017,"New Mexico","Grant County",4,73,475,235,240
050,35,017,"New Mexico","Grant County",4,74,444,224,220
050,35,017,"New Mexico","Grant County",4,75,465,234,231
050,35,017,"New Mexico","Grant County",4,76,333,167,166
050,35,017,"New Mexico","Grant County",4,77,315,166,149
050,35,017,"New Mexico","Grant County",4,78,318,157,161
050,35,017,"New Mexico","Grant County",4,79,305,162,143
050,35,017,"New Mexico","Grant County",4,80,270,144,126
050,35,017,"New Mexico","Grant County",4,81,237,123,114
050,35,017,"New Mexico","Grant County",4,82,200,92,108
050,35,017,"New Mexico","Grant County",4,83,178,80,98
050,35,017,"New Mexico","Grant County",4,84,177,78,99
050,35,017,"New Mexico","Grant County",4,85,806,337,469
050,35,017,"New Mexico","Grant County",5,0,208,115,93
050,35,017,"New Mexico","Grant County",5,1,229,124,105
050,35,017,"New Mexico","Grant County",5,2,223,119,104
050,35,017,"New Mexico","Grant County",5,3,234,118,116
050,35,017,"New Mexico","Grant County",5,4,244,111,133
050,35,017,"New Mexico","Grant County",5,5,234,117,117
050,35,017,"New Mexico","Grant County",5,6,261,135,126
050,35,017,"New Mexico","Grant County",5,7,272,125,147
050,35,017,"New Mexico","Grant County",5,8,279,138,141
050,35,017,"New Mexico","Grant County",5,9,295,167,128
050,35,017,"New Mexico","Grant County",5,10,266,138,128
050,35,017,"New Mexico","Grant County",5,11,279,141,138
050,35,017,"New Mexico","Grant County",5,12,291,149,142
050,35,017,"New Mexico","Grant County",5,13,336,163,173
050,35,017,"New Mexico","Grant County",5,14,310,160,150
050,35,017,"New Mexico","Grant County",5,15,321,160,161
050,35,017,"New Mexico","Grant County",5,16,299,155,144
050,35,017,"New Mexico","Grant County",5,17,300,159,141
050,35,017,"New Mexico","Grant County",5,18,328,157,171
050,35,017,"New Mexico","Grant County",5,19,315,165,150
050,35,017,"New Mexico","Grant County",5,20,321,180,141
050,35,017,"New Mexico","Grant County",5,21,313,168,145
050,35,017,"New Mexico","Grant County",5,22,299,167,132
050,35,017,"New Mexico","Grant County",5,23,327,175,152
050,35,017,"New Mexico","Grant County",5,24,274,138,136
050,35,017,"New Mexico","Grant County",5,25,264,134,130
050,35,017,"New Mexico","Grant County",5,26,239,137,102
050,35,017,"New Mexico","Grant County",5,27,250,132,118
050,35,017,"New Mexico","Grant County",5,28,267,142,125
050,35,017,"New Mexico","Grant County",5,29,271,144,127
050,35,017,"New Mexico","Grant County",5,30,268,133,135
050,35,017,"New Mexico","Grant County",5,31,277,137,140
050,35,017,"New Mexico","Grant County",5,32,249,120,129
050,35,017,"New Mexico","Grant County",5,33,232,124,108
050,35,017,"New Mexico","Grant County",5,34,258,123,135
050,35,017,"New Mexico","Grant County",5,35,252,125,127
050,35,017,"New Mexico","Grant County",5,36,275,139,136
050,35,017,"New Mexico","Grant County",5,37,244,125,119
050,35,017,"New Mexico","Grant County",5,38,281,148,133
050,35,017,"New Mexico","Grant County",5,39,272,149,123
050,35,017,"New Mexico","Grant County",5,40,257,132,125
050,35,017,"New Mexico","Grant County",5,41,295,144,151
050,35,017,"New Mexico","Grant County",5,42,292,136,156
050,35,017,"New Mexico","Grant County",5,43,296,145,151
050,35,017,"New Mexico","Grant County",5,44,311,148,163
050,35,017,"New Mexico","Grant County",5,45,310,150,160
050,35,017,"New Mexico","Grant County",5,46,281,130,151
050,35,017,"New Mexico","Grant County",5,47,289,143,146
050,35,017,"New Mexico","Grant County",5,48,265,143,122
050,35,017,"New Mexico","Grant County",5,49,279,149,130
050,35,017,"New Mexico","Grant County",5,50,269,133,136
050,35,017,"New Mexico","Grant County",5,51,284,144,140
050,35,017,"New Mexico","Grant County",5,52,298,151,147
050,35,017,"New Mexico","Grant County",5,53,294,141,153
050,35,017,"New Mexico","Grant County",5,54,285,132,153
050,35,017,"New Mexico","Grant County",5,55,263,123,140
050,35,017,"New Mexico","Grant County",5,56,286,141,145
050,35,017,"New Mexico","Grant County",5,57,309,167,142
050,35,017,"New Mexico","Grant County",5,58,332,158,174
050,35,017,"New Mexico","Grant County",5,59,341,147,194
050,35,017,"New Mexico","Grant County",5,60,382,178,204
050,35,017,"New Mexico","Grant County",5,61,405,180,225
050,35,017,"New Mexico","Grant County",5,62,432,225,207
050,35,017,"New Mexico","Grant County",5,63,433,202,231
050,35,017,"New Mexico","Grant County",5,64,431,217,214
050,35,017,"New Mexico","Grant County",5,65,470,230,240
050,35,017,"New Mexico","Grant County",5,66,480,242,238
050,35,017,"New Mexico","Grant County",5,67,467,214,253
050,35,017,"New Mexico","Grant County",5,68,463,234,229
050,35,017,"New Mexico","Grant County",5,69,490,231,259
050,35,017,"New Mexico","Grant County",5,70,504,248,256
050,35,017,"New Mexico","Grant County",5,71,503,238,265
050,35,017,"New Mexico","Grant County",5,72,494,246,248
050,35,017,"New Mexico","Grant County",5,73,485,243,242
050,35,017,"New Mexico","Grant County",5,74,462,230,232
050,35,017,"New Mexico","Grant County",5,75,425,208,217
050,35,017,"New Mexico","Grant County",5,76,458,240,218
050,35,017,"New Mexico","Grant County",5,77,313,153,160
050,35,017,"New Mexico","Grant County",5,78,308,158,150
050,35,017,"New Mexico","Grant County",5,79,290,149,141
050,35,017,"New Mexico","Grant County",5,80,282,151,131
050,35,017,"New Mexico","Grant County",5,81,247,130,117
050,35,017,"New Mexico","Grant County",5,82,232,119,113
050,35,017,"New Mexico","Grant County",5,83,180,80,100
050,35,017,"New Mexico","Grant County",5,84,170,76,94
050,35,017,"New Mexico","Grant County",5,85,873,363,510
050,35,019,"New Mexico","Guadalupe County",1,0,38,19,19
050,35,019,"New Mexico","Guadalupe County",1,1,43,21,22
050,35,019,"New Mexico","Guadalupe County",1,2,41,22,19
050,35,019,"New Mexico","Guadalupe County",1,3,37,23,14
050,35,019,"New Mexico","Guadalupe County",1,4,55,31,24
050,35,019,"New Mexico","Guadalupe County",1,5,42,25,17
050,35,019,"New Mexico","Guadalupe County",1,6,44,22,22
050,35,019,"New Mexico","Guadalupe County",1,7,52,24,28
050,35,019,"New Mexico","Guadalupe County",1,8,45,22,23
050,35,019,"New Mexico","Guadalupe County",1,9,54,31,23
050,35,019,"New Mexico","Guadalupe County",1,10,57,30,27
050,35,019,"New Mexico","Guadalupe County",1,11,57,33,24
050,35,019,"New Mexico","Guadalupe County",1,12,54,30,24
050,35,019,"New Mexico","Guadalupe County",1,13,61,32,29
050,35,019,"New Mexico","Guadalupe County",1,14,60,29,31
050,35,019,"New Mexico","Guadalupe County",1,15,46,24,22
050,35,019,"New Mexico","Guadalupe County",1,16,51,27,24
050,35,019,"New Mexico","Guadalupe County",1,17,59,36,23
050,35,019,"New Mexico","Guadalupe County",1,18,62,30,32
050,35,019,"New Mexico","Guadalupe County",1,19,60,32,28
050,35,019,"New Mexico","Guadalupe County",1,20,47,25,22
050,35,019,"New Mexico","Guadalupe County",1,21,41,28,13
050,35,019,"New Mexico","Guadalupe County",1,22,50,36,14
050,35,019,"New Mexico","Guadalupe County",1,23,57,40,17
050,35,019,"New Mexico","Guadalupe County",1,24,54,36,18
050,35,019,"New Mexico","Guadalupe County",1,25,54,32,22
050,35,019,"New Mexico","Guadalupe County",1,26,67,43,24
050,35,019,"New Mexico","Guadalupe County",1,27,64,47,17
050,35,019,"New Mexico","Guadalupe County",1,28,70,55,15
050,35,019,"New Mexico","Guadalupe County",1,29,57,39,18
050,35,019,"New Mexico","Guadalupe County",1,30,64,46,18
050,35,019,"New Mexico","Guadalupe County",1,31,67,44,23
050,35,019,"New Mexico","Guadalupe County",1,32,60,41,19
050,35,019,"New Mexico","Guadalupe County",1,33,72,48,24
050,35,019,"New Mexico","Guadalupe County",1,34,72,45,27
050,35,019,"New Mexico","Guadalupe County",1,35,67,46,21
050,35,019,"New Mexico","Guadalupe County",1,36,71,48,23
050,35,019,"New Mexico","Guadalupe County",1,37,62,32,30
050,35,019,"New Mexico","Guadalupe County",1,38,76,43,33
050,35,019,"New Mexico","Guadalupe County",1,39,56,29,27
050,35,019,"New Mexico","Guadalupe County",1,40,64,41,23
050,35,019,"New Mexico","Guadalupe County",1,41,54,31,23
050,35,019,"New Mexico","Guadalupe County",1,42,57,36,21
050,35,019,"New Mexico","Guadalupe County",1,43,46,25,21
050,35,019,"New Mexico","Guadalupe County",1,44,55,32,23
050,35,019,"New Mexico","Guadalupe County",1,45,43,23,20
050,35,019,"New Mexico","Guadalupe County",1,46,36,22,14
050,35,019,"New Mexico","Guadalupe County",1,47,39,29,10
050,35,019,"New Mexico","Guadalupe County",1,48,46,30,16
050,35,019,"New Mexico","Guadalupe County",1,49,51,28,23
050,35,019,"New Mexico","Guadalupe County",1,50,44,24,20
050,35,019,"New Mexico","Guadalupe County",1,51,42,21,21
050,35,019,"New Mexico","Guadalupe County",1,52,40,24,16
050,35,019,"New Mexico","Guadalupe County",1,53,48,26,22
050,35,019,"New Mexico","Guadalupe County",1,54,47,26,21
050,35,019,"New Mexico","Guadalupe County",1,55,52,27,25
050,35,019,"New Mexico","Guadalupe County",1,56,60,33,27
050,35,019,"New Mexico","Guadalupe County",1,57,68,38,30
050,35,019,"New Mexico","Guadalupe County",1,58,58,28,30
050,35,019,"New Mexico","Guadalupe County",1,59,62,36,26
050,35,019,"New Mexico","Guadalupe County",1,60,57,30,27
050,35,019,"New Mexico","Guadalupe County",1,61,67,36,31
050,35,019,"New Mexico","Guadalupe County",1,62,70,37,33
050,35,019,"New Mexico","Guadalupe County",1,63,59,26,33
050,35,019,"New Mexico","Guadalupe County",1,64,57,26,31
050,35,019,"New Mexico","Guadalupe County",1,65,58,28,30
050,35,019,"New Mexico","Guadalupe County",1,66,49,28,21
050,35,019,"New Mexico","Guadalupe County",1,67,55,34,21
050,35,019,"New Mexico","Guadalupe County",1,68,46,33,13
050,35,019,"New Mexico","Guadalupe County",1,69,49,33,16
050,35,019,"New Mexico","Guadalupe County",1,70,52,29,23
050,35,019,"New Mexico","Guadalupe County",1,71,43,22,21
050,35,019,"New Mexico","Guadalupe County",1,72,42,27,15
050,35,019,"New Mexico","Guadalupe County",1,73,38,21,17
050,35,019,"New Mexico","Guadalupe County",1,74,40,14,26
050,35,019,"New Mexico","Guadalupe County",1,75,36,16,20
050,35,019,"New Mexico","Guadalupe County",1,76,26,14,12
050,35,019,"New Mexico","Guadalupe County",1,77,34,17,17
050,35,019,"New Mexico","Guadalupe County",1,78,34,13,21
050,35,019,"New Mexico","Guadalupe County",1,79,31,11,20
050,35,019,"New Mexico","Guadalupe County",1,80,29,12,17
050,35,019,"New Mexico","Guadalupe County",1,81,24,11,13
050,35,019,"New Mexico","Guadalupe County",1,82,34,17,17
050,35,019,"New Mexico","Guadalupe County",1,83,31,15,16
050,35,019,"New Mexico","Guadalupe County",1,84,22,11,11
050,35,019,"New Mexico","Guadalupe County",1,85,109,49,60
050,35,019,"New Mexico","Guadalupe County",2,0,39,19,20
050,35,019,"New Mexico","Guadalupe County",2,1,40,19,21
050,35,019,"New Mexico","Guadalupe County",2,2,41,22,19
050,35,019,"New Mexico","Guadalupe County",2,3,39,23,16
050,35,019,"New Mexico","Guadalupe County",2,4,52,30,22
050,35,019,"New Mexico","Guadalupe County",2,5,45,26,19
050,35,019,"New Mexico","Guadalupe County",2,6,44,23,21
050,35,019,"New Mexico","Guadalupe County",2,7,50,23,27
050,35,019,"New Mexico","Guadalupe County",2,8,47,23,24
050,35,019,"New Mexico","Guadalupe County",2,9,53,29,24
050,35,019,"New Mexico","Guadalupe County",2,10,57,30,27
050,35,019,"New Mexico","Guadalupe County",2,11,55,31,24
050,35,019,"New Mexico","Guadalupe County",2,12,53,30,23
050,35,019,"New Mexico","Guadalupe County",2,13,60,32,28
050,35,019,"New Mexico","Guadalupe County",2,14,58,29,29
050,35,019,"New Mexico","Guadalupe County",2,15,50,26,24
050,35,019,"New Mexico","Guadalupe County",2,16,49,26,23
050,35,019,"New Mexico","Guadalupe County",2,17,57,34,23
050,35,019,"New Mexico","Guadalupe County",2,18,58,30,28
050,35,019,"New Mexico","Guadalupe County",2,19,61,33,28
050,35,019,"New Mexico","Guadalupe County",2,20,50,27,23
050,35,019,"New Mexico","Guadalupe County",2,21,43,27,16
050,35,019,"New Mexico","Guadalupe County",2,22,50,37,13
050,35,019,"New Mexico","Guadalupe County",2,23,58,41,17
050,35,019,"New Mexico","Guadalupe County",2,24,55,36,19
050,35,019,"New Mexico","Guadalupe County",2,25,52,31,21
050,35,019,"New Mexico","Guadalupe County",2,26,67,43,24
050,35,019,"New Mexico","Guadalupe County",2,27,65,47,18
050,35,019,"New Mexico","Guadalupe County",2,28,72,56,16
050,35,019,"New Mexico","Guadalupe County",2,29,56,39,17
050,35,019,"New Mexico","Guadalupe County",2,30,66,47,19
050,35,019,"New Mexico","Guadalupe County",2,31,65,43,22
050,35,019,"New Mexico","Guadalupe County",2,32,62,42,20
050,35,019,"New Mexico","Guadalupe County",2,33,70,48,22
050,35,019,"New Mexico","Guadalupe County",2,34,75,48,27
050,35,019,"New Mexico","Guadalupe County",2,35,66,44,22
050,35,019,"New Mexico","Guadalupe County",2,36,71,48,23
050,35,019,"New Mexico","Guadalupe County",2,37,62,34,28
050,35,019,"New Mexico","Guadalupe County",2,38,74,43,31
050,35,019,"New Mexico","Guadalupe County",2,39,57,30,27
050,35,019,"New Mexico","Guadalupe County",2,40,64,40,24
050,35,019,"New Mexico","Guadalupe County",2,41,56,32,24
050,35,019,"New Mexico","Guadalupe County",2,42,56,35,21
050,35,019,"New Mexico","Guadalupe County",2,43,46,25,21
050,35,019,"New Mexico","Guadalupe County",2,44,54,32,22
050,35,019,"New Mexico","Guadalupe County",2,45,44,23,21
050,35,019,"New Mexico","Guadalupe County",2,46,38,22,16
050,35,019,"New Mexico","Guadalupe County",2,47,39,28,11
050,35,019,"New Mexico","Guadalupe County",2,48,46,30,16
050,35,019,"New Mexico","Guadalupe County",2,49,49,27,22
050,35,019,"New Mexico","Guadalupe County",2,50,45,25,20
050,35,019,"New Mexico","Guadalupe County",2,51,43,22,21
050,35,019,"New Mexico","Guadalupe County",2,52,39,23,16
050,35,019,"New Mexico","Guadalupe County",2,53,47,27,20
050,35,019,"New Mexico","Guadalupe County",2,54,46,25,21
050,35,019,"New Mexico","Guadalupe County",2,55,53,29,24
050,35,019,"New Mexico","Guadalupe County",2,56,57,30,27
050,35,019,"New Mexico","Guadalupe County",2,57,66,37,29
050,35,019,"New Mexico","Guadalupe County",2,58,59,29,30
050,35,019,"New Mexico","Guadalupe County",2,59,60,33,27
050,35,019,"New Mexico","Guadalupe County",2,60,57,31,26
050,35,019,"New Mexico","Guadalupe County",2,61,63,33,30
050,35,019,"New Mexico","Guadalupe County",2,62,69,37,32
050,35,019,"New Mexico","Guadalupe County",2,63,61,28,33
050,35,019,"New Mexico","Guadalupe County",2,64,57,26,31
050,35,019,"New Mexico","Guadalupe County",2,65,58,27,31
050,35,019,"New Mexico","Guadalupe County",2,66,51,28,23
050,35,019,"New Mexico","Guadalupe County",2,67,54,33,21
050,35,019,"New Mexico","Guadalupe County",2,68,49,34,15
050,35,019,"New Mexico","Guadalupe County",2,69,47,32,15
050,35,019,"New Mexico","Guadalupe County",2,70,51,30,21
050,35,019,"New Mexico","Guadalupe County",2,71,45,24,21
050,35,019,"New Mexico","Guadalupe County",2,72,41,25,16
050,35,019,"New Mexico","Guadalupe County",2,73,40,23,17
050,35,019,"New Mexico","Guadalupe County",2,74,37,16,21
050,35,019,"New Mexico","Guadalupe County",2,75,37,16,21
050,35,019,"New Mexico","Guadalupe County",2,76,27,14,13
050,35,019,"New Mexico","Guadalupe County",2,77,32,17,15
050,35,019,"New Mexico","Guadalupe County",2,78,32,13,19
050,35,019,"New Mexico","Guadalupe County",2,79,32,12,20
050,35,019,"New Mexico","Guadalupe County",2,80,31,12,19
050,35,019,"New Mexico","Guadalupe County",2,81,24,11,13
050,35,019,"New Mexico","Guadalupe County",2,82,32,16,16
050,35,019,"New Mexico","Guadalupe County",2,83,30,15,15
050,35,019,"New Mexico","Guadalupe County",2,84,23,11,12
050,35,019,"New Mexico","Guadalupe County",2,85,108,49,59
050,35,019,"New Mexico","Guadalupe County",3,0,29,17,12
050,35,019,"New Mexico","Guadalupe County",3,1,37,19,18
050,35,019,"New Mexico","Guadalupe County",3,2,38,16,22
050,35,019,"New Mexico","Guadalupe County",3,3,43,22,21
050,35,019,"New Mexico","Guadalupe County",3,4,42,28,14
050,35,019,"New Mexico","Guadalupe County",3,5,51,30,21
050,35,019,"New Mexico","Guadalupe County",3,6,44,24,20
050,35,019,"New Mexico","Guadalupe County",3,7,42,23,19
050,35,019,"New Mexico","Guadalupe County",3,8,49,23,26
050,35,019,"New Mexico","Guadalupe County",3,9,39,19,20
050,35,019,"New Mexico","Guadalupe County",3,10,54,27,27
050,35,019,"New Mexico","Guadalupe County",3,11,53,30,23
050,35,019,"New Mexico","Guadalupe County",3,12,56,33,23
050,35,019,"New Mexico","Guadalupe County",3,13,52,30,22
050,35,019,"New Mexico","Guadalupe County",3,14,57,30,27
050,35,019,"New Mexico","Guadalupe County",3,15,60,31,29
050,35,019,"New Mexico","Guadalupe County",3,16,48,24,24
050,35,019,"New Mexico","Guadalupe County",3,17,49,25,24
050,35,019,"New Mexico","Guadalupe County",3,18,50,32,18
050,35,019,"New Mexico","Guadalupe County",3,19,64,33,31
050,35,019,"New Mexico","Guadalupe County",3,20,62,34,28
050,35,019,"New Mexico","Guadalupe County",3,21,46,25,21
050,35,019,"New Mexico","Guadalupe County",3,22,51,35,16
050,35,019,"New Mexico","Guadalupe County",3,23,61,48,13
050,35,019,"New Mexico","Guadalupe County",3,24,54,41,13
050,35,019,"New Mexico","Guadalupe County",3,25,54,32,22
050,35,019,"New Mexico","Guadalupe County",3,26,60,39,21
050,35,019,"New Mexico","Guadalupe County",3,27,70,47,23
050,35,019,"New Mexico","Guadalupe County",3,28,80,61,19
050,35,019,"New Mexico","Guadalupe County",3,29,62,46,16
050,35,019,"New Mexico","Guadalupe County",3,30,67,49,18
050,35,019,"New Mexico","Guadalupe County",3,31,67,48,19
050,35,019,"New Mexico","Guadalupe County",3,32,62,40,22
050,35,019,"New Mexico","Guadalupe County",3,33,68,47,21
050,35,019,"New Mexico","Guadalupe County",3,34,74,55,19
050,35,019,"New Mexico","Guadalupe County",3,35,69,40,29
050,35,019,"New Mexico","Guadalupe County",3,36,70,46,24
050,35,019,"New Mexico","Guadalupe County",3,37,63,37,26
050,35,019,"New Mexico","Guadalupe County",3,38,69,42,27
050,35,019,"New Mexico","Guadalupe County",3,39,68,34,34
050,35,019,"New Mexico","Guadalupe County",3,40,66,39,27
050,35,019,"New Mexico","Guadalupe County",3,41,61,40,21
050,35,019,"New Mexico","Guadalupe County",3,42,53,33,20
050,35,019,"New Mexico","Guadalupe County",3,43,52,31,21
050,35,019,"New Mexico","Guadalupe County",3,44,55,34,21
050,35,019,"New Mexico","Guadalupe County",3,45,52,30,22
050,35,019,"New Mexico","Guadalupe County",3,46,43,22,21
050,35,019,"New Mexico","Guadalupe County",3,47,40,24,16
050,35,019,"New Mexico","Guadalupe County",3,48,43,30,13
050,35,019,"New Mexico","Guadalupe County",3,49,40,28,12
050,35,019,"New Mexico","Guadalupe County",3,50,50,29,21
050,35,019,"New Mexico","Guadalupe County",3,51,43,23,20
050,35,019,"New Mexico","Guadalupe County",3,52,41,21,20
050,35,019,"New Mexico","Guadalupe County",3,53,41,27,14
050,35,019,"New Mexico","Guadalupe County",3,54,42,23,19
050,35,019,"New Mexico","Guadalupe County",3,55,50,29,21
050,35,019,"New Mexico","Guadalupe County",3,56,44,21,23
050,35,019,"New Mexico","Guadalupe County",3,57,60,32,28
050,35,019,"New Mexico","Guadalupe County",3,58,57,29,28
050,35,019,"New Mexico","Guadalupe County",3,59,64,34,30
050,35,019,"New Mexico","Guadalupe County",3,60,56,31,25
050,35,019,"New Mexico","Guadalupe County",3,61,55,28,27
050,35,019,"New Mexico","Guadalupe County",3,62,66,35,31
050,35,019,"New Mexico","Guadalupe County",3,63,64,34,30
050,35,019,"New Mexico","Guadalupe County",3,64,63,30,33
050,35,019,"New Mexico","Guadalupe County",3,65,56,23,33
050,35,019,"New Mexico","Guadalupe County",3,66,60,32,28
050,35,019,"New Mexico","Guadalupe County",3,67,47,24,23
050,35,019,"New Mexico","Guadalupe County",3,68,57,36,21
050,35,019,"New Mexico","Guadalupe County",3,69,45,30,15
050,35,019,"New Mexico","Guadalupe County",3,70,48,33,15
050,35,019,"New Mexico","Guadalupe County",3,71,46,27,19
050,35,019,"New Mexico","Guadalupe County",3,72,40,19,21
050,35,019,"New Mexico","Guadalupe County",3,73,39,23,16
050,35,019,"New Mexico","Guadalupe County",3,74,40,23,17
050,35,019,"New Mexico","Guadalupe County",3,75,36,16,20
050,35,019,"New Mexico","Guadalupe County",3,76,35,15,20
050,35,019,"New Mexico","Guadalupe County",3,77,27,14,13
050,35,019,"New Mexico","Guadalupe County",3,78,30,15,15
050,35,019,"New Mexico","Guadalupe County",3,79,28,10,18
050,35,019,"New Mexico","Guadalupe County",3,80,31,12,19
050,35,019,"New Mexico","Guadalupe County",3,81,31,12,19
050,35,019,"New Mexico","Guadalupe County",3,82,23,10,13
050,35,019,"New Mexico","Guadalupe County",3,83,30,15,15
050,35,019,"New Mexico","Guadalupe County",3,84,28,13,15
050,35,019,"New Mexico","Guadalupe County",3,85,111,50,61
050,35,019,"New Mexico","Guadalupe County",4,0,22,13,9
050,35,019,"New Mexico","Guadalupe County",4,1,28,16,12
050,35,019,"New Mexico","Guadalupe County",4,2,37,20,17
050,35,019,"New Mexico","Guadalupe County",4,3,39,16,23
050,35,019,"New Mexico","Guadalupe County",4,4,42,22,20
050,35,019,"New Mexico","Guadalupe County",4,5,39,27,12
050,35,019,"New Mexico","Guadalupe County",4,6,50,27,23
050,35,019,"New Mexico","Guadalupe County",4,7,46,28,18
050,35,019,"New Mexico","Guadalupe County",4,8,43,25,18
050,35,019,"New Mexico","Guadalupe County",4,9,49,23,26
050,35,019,"New Mexico","Guadalupe County",4,10,43,24,19
050,35,019,"New Mexico","Guadalupe County",4,11,52,27,25
050,35,019,"New Mexico","Guadalupe County",4,12,52,30,22
050,35,019,"New Mexico","Guadalupe County",4,13,53,31,22
050,35,019,"New Mexico","Guadalupe County",4,14,57,33,24
050,35,019,"New Mexico","Guadalupe County",4,15,54,28,26
050,35,019,"New Mexico","Guadalupe County",4,16,57,28,29
050,35,019,"New Mexico","Guadalupe County",4,17,47,24,23
050,35,019,"New Mexico","Guadalupe County",4,18,44,23,21
050,35,019,"New Mexico","Guadalupe County",4,19,48,31,17
050,35,019,"New Mexico","Guadalupe County",4,20,59,32,27
050,35,019,"New Mexico","Guadalupe County",4,21,55,30,25
050,35,019,"New Mexico","Guadalupe County",4,22,57,35,22
050,35,019,"New Mexico","Guadalupe County",4,23,62,45,17
050,35,019,"New Mexico","Guadalupe County",4,24,54,42,12
050,35,019,"New Mexico","Guadalupe County",4,25,50,38,12
050,35,019,"New Mexico","Guadalupe County",4,26,53,36,17
050,35,019,"New Mexico","Guadalupe County",4,27,62,41,21
050,35,019,"New Mexico","Guadalupe County",4,28,77,56,21
050,35,019,"New Mexico","Guadalupe County",4,29,67,48,19
050,35,019,"New Mexico","Guadalupe County",4,30,73,56,17
050,35,019,"New Mexico","Guadalupe County",4,31,62,44,18
050,35,019,"New Mexico","Guadalupe County",4,32,59,41,18
050,35,019,"New Mexico","Guadalupe County",4,33,58,39,19
050,35,019,"New Mexico","Guadalupe County",4,34,70,50,20
050,35,019,"New Mexico","Guadalupe County",4,35,65,42,23
050,35,019,"New Mexico","Guadalupe County",4,36,68,43,25
050,35,019,"New Mexico","Guadalupe County",4,37,53,33,20
050,35,019,"New Mexico","Guadalupe County",4,38,67,44,23
050,35,019,"New Mexico","Guadalupe County",4,39,59,32,27
050,35,019,"New Mexico","Guadalupe County",4,40,76,43,33
050,35,019,"New Mexico","Guadalupe County",4,41,60,30,30
050,35,019,"New Mexico","Guadalupe County",4,42,62,41,21
050,35,019,"New Mexico","Guadalupe County",4,43,48,27,21
050,35,019,"New Mexico","Guadalupe County",4,44,57,38,19
050,35,019,"New Mexico","Guadalupe County",4,45,50,29,21
050,35,019,"New Mexico","Guadalupe County",4,46,52,29,23
050,35,019,"New Mexico","Guadalupe County",4,47,44,23,21
050,35,019,"New Mexico","Guadalupe County",4,48,39,23,16
050,35,019,"New Mexico","Guadalupe County",4,49,40,30,10
050,35,019,"New Mexico","Guadalupe County",4,50,39,27,12
050,35,019,"New Mexico","Guadalupe County",4,51,47,25,22
050,35,019,"New Mexico","Guadalupe County",4,52,40,20,20
050,35,019,"New Mexico","Guadalupe County",4,53,44,23,21
050,35,019,"New Mexico","Guadalupe County",4,54,38,23,15
050,35,019,"New Mexico","Guadalupe County",4,55,47,27,20
050,35,019,"New Mexico","Guadalupe County",4,56,41,19,22
050,35,019,"New Mexico","Guadalupe County",4,57,46,26,20
050,35,019,"New Mexico","Guadalupe County",4,58,55,30,25
050,35,019,"New Mexico","Guadalupe County",4,59,59,31,28
050,35,019,"New Mexico","Guadalupe County",4,60,59,31,28
050,35,019,"New Mexico","Guadalupe County",4,61,47,25,22
050,35,019,"New Mexico","Guadalupe County",4,62,56,27,29
050,35,019,"New Mexico","Guadalupe County",4,63,60,31,29
050,35,019,"New Mexico","Guadalupe County",4,64,66,36,30
050,35,019,"New Mexico","Guadalupe County",4,65,60,28,32
050,35,019,"New Mexico","Guadalupe County",4,66,56,25,31
050,35,019,"New Mexico","Guadalupe County",4,67,58,30,28
050,35,019,"New Mexico","Guadalupe County",4,68,48,25,23
050,35,019,"New Mexico","Guadalupe County",4,69,53,33,20
050,35,019,"New Mexico","Guadalupe County",4,70,44,31,13
050,35,019,"New Mexico","Guadalupe County",4,71,45,31,14
050,35,019,"New Mexico","Guadalupe County",4,72,44,25,19
050,35,019,"New Mexico","Guadalupe County",4,73,40,19,21
050,35,019,"New Mexico","Guadalupe County",4,74,40,23,17
050,35,019,"New Mexico","Guadalupe County",4,75,39,22,17
050,35,019,"New Mexico","Guadalupe County",4,76,35,15,20
050,35,019,"New Mexico","Guadalupe County",4,77,35,15,20
050,35,019,"New Mexico","Guadalupe County",4,78,23,10,13
050,35,019,"New Mexico","Guadalupe County",4,79,28,15,13
050,35,019,"New Mexico","Guadalupe County",4,80,25,8,17
050,35,019,"New Mexico","Guadalupe County",4,81,31,12,19
050,35,019,"New Mexico","Guadalupe County",4,82,30,11,19
050,35,019,"New Mexico","Guadalupe County",4,83,20,10,10
050,35,019,"New Mexico","Guadalupe County",4,84,28,13,15
050,35,019,"New Mexico","Guadalupe County",4,85,130,57,73
050,35,019,"New Mexico","Guadalupe County",5,0,23,13,10
050,35,019,"New Mexico","Guadalupe County",5,1,20,15,5
050,35,019,"New Mexico","Guadalupe County",5,2,30,17,13
050,35,019,"New Mexico","Guadalupe County",5,3,40,21,19
050,35,019,"New Mexico","Guadalupe County",5,4,35,17,18
050,35,019,"New Mexico","Guadalupe County",5,5,43,21,22
050,35,019,"New Mexico","Guadalupe County",5,6,41,29,12
050,35,019,"New Mexico","Guadalupe County",5,7,56,34,22
050,35,019,"New Mexico","Guadalupe County",5,8,51,29,22
050,35,019,"New Mexico","Guadalupe County",5,9,41,24,17
050,35,019,"New Mexico","Guadalupe County",5,10,54,25,29
050,35,019,"New Mexico","Guadalupe County",5,11,39,20,19
050,35,019,"New Mexico","Guadalupe County",5,12,48,25,23
050,35,019,"New Mexico","Guadalupe County",5,13,51,28,23
050,35,019,"New Mexico","Guadalupe County",5,14,50,29,21
050,35,019,"New Mexico","Guadalupe County",5,15,56,33,23
050,35,019,"New Mexico","Guadalupe County",5,16,55,27,28
050,35,019,"New Mexico","Guadalupe County",5,17,60,31,29
050,35,019,"New Mexico","Guadalupe County",5,18,48,24,24
050,35,019,"New Mexico","Guadalupe County",5,19,46,25,21
050,35,019,"New Mexico","Guadalupe County",5,20,40,27,13
050,35,019,"New Mexico","Guadalupe County",5,21,55,31,24
050,35,019,"New Mexico","Guadalupe County",5,22,66,42,24
050,35,019,"New Mexico","Guadalupe County",5,23,62,42,20
050,35,019,"New Mexico","Guadalupe County",5,24,60,42,18
050,35,019,"New Mexico","Guadalupe County",5,25,55,41,14
050,35,019,"New Mexico","Guadalupe County",5,26,55,43,12
050,35,019,"New Mexico","Guadalupe County",5,27,51,37,14
050,35,019,"New Mexico","Guadalupe County",5,28,73,55,18
050,35,019,"New Mexico","Guadalupe County",5,29,62,40,22
050,35,019,"New Mexico","Guadalupe County",5,30,77,59,18
050,35,019,"New Mexico","Guadalupe County",5,31,72,53,19
050,35,019,"New Mexico","Guadalupe County",5,32,58,38,20
050,35,019,"New Mexico","Guadalupe County",5,33,66,47,19
050,35,019,"New Mexico","Guadalupe County",5,34,68,49,19
050,35,019,"New Mexico","Guadalupe County",5,35,60,39,21
050,35,019,"New Mexico","Guadalupe County",5,36,67,47,20
050,35,019,"New Mexico","Guadalupe County",5,37,52,29,23
050,35,019,"New Mexico","Guadalupe County",5,38,60,42,18
050,35,019,"New Mexico","Guadalupe County",5,39,56,32,24
050,35,019,"New Mexico","Guadalupe County",5,40,67,42,25
050,35,019,"New Mexico","Guadalupe County",5,41,73,38,35
050,35,019,"New Mexico","Guadalupe County",5,42,62,31,31
050,35,019,"New Mexico","Guadalupe County",5,43,58,38,20
050,35,019,"New Mexico","Guadalupe County",5,44,56,34,22
050,35,019,"New Mexico","Guadalupe County",5,45,50,31,19
050,35,019,"New Mexico","Guadalupe County",5,46,50,28,22
050,35,019,"New Mexico","Guadalupe County",5,47,56,33,23
050,35,019,"New Mexico","Guadalupe County",5,48,41,22,19
050,35,019,"New Mexico","Guadalupe County",5,49,38,23,15
050,35,019,"New Mexico","Guadalupe County",5,50,41,30,11
050,35,019,"New Mexico","Guadalupe County",5,51,35,23,12
050,35,019,"New Mexico","Guadalupe County",5,52,44,23,21
050,35,019,"New Mexico","Guadalupe County",5,53,45,24,21
050,35,019,"New Mexico","Guadalupe County",5,54,39,19,20
050,35,019,"New Mexico","Guadalupe County",5,55,40,25,15
050,35,019,"New Mexico","Guadalupe County",5,56,40,19,21
050,35,019,"New Mexico","Guadalupe County",5,57,43,23,20
050,35,019,"New Mexico","Guadalupe County",5,58,40,21,19
050,35,019,"New Mexico","Guadalupe County",5,59,60,34,26
050,35,019,"New Mexico","Guadalupe County",5,60,50,27,23
050,35,019,"New Mexico","Guadalupe County",5,61,54,26,28
050,35,019,"New Mexico","Guadalupe County",5,62,49,26,23
050,35,019,"New Mexico","Guadalupe County",5,63,52,25,27
050,35,019,"New Mexico","Guadalupe County",5,64,62,34,28
050,35,019,"New Mexico","Guadalupe County",5,65,62,33,29
050,35,019,"New Mexico","Guadalupe County",5,66,64,34,30
050,35,019,"New Mexico","Guadalupe County",5,67,53,22,31
050,35,019,"New Mexico","Guadalupe County",5,68,59,31,28
050,35,019,"New Mexico","Guadalupe County",5,69,47,22,25
050,35,019,"New Mexico","Guadalupe County",5,70,56,36,20
050,35,019,"New Mexico","Guadalupe County",5,71,40,29,11
050,35,019,"New Mexico","Guadalupe County",5,72,45,30,15
050,35,019,"New Mexico","Guadalupe County",5,73,46,26,20
050,35,019,"New Mexico","Guadalupe County",5,74,41,20,21
050,35,019,"New Mexico","Guadalupe County",5,75,39,22,17
050,35,019,"New Mexico","Guadalupe County",5,76,38,21,17
050,35,019,"New Mexico","Guadalupe County",5,77,33,13,20
050,35,019,"New Mexico","Guadalupe County",5,78,34,14,20
050,35,019,"New Mexico","Guadalupe County",5,79,20,9,11
050,35,019,"New Mexico","Guadalupe County",5,80,28,14,14
050,35,019,"New Mexico","Guadalupe County",5,81,25,8,17
050,35,019,"New Mexico","Guadalupe County",5,82,29,11,18
050,35,019,"New Mexico","Guadalupe County",5,83,27,11,16
050,35,019,"New Mexico","Guadalupe County",5,84,17,8,9
050,35,019,"New Mexico","Guadalupe County",5,85,142,64,78
050,35,021,"New Mexico","Harding County",1,0,2,1,1
050,35,021,"New Mexico","Harding County",1,1,3,1,2
050,35,021,"New Mexico","Harding County",1,2,4,1,3
050,35,021,"New Mexico","Harding County",1,3,4,2,2
050,35,021,"New Mexico","Harding County",1,4,6,3,3
050,35,021,"New Mexico","Harding County",1,5,3,1,2
050,35,021,"New Mexico","Harding County",1,6,7,2,5
050,35,021,"New Mexico","Harding County",1,7,8,5,3
050,35,021,"New Mexico","Harding County",1,8,5,3,2
050,35,021,"New Mexico","Harding County",1,9,5,3,2
050,35,021,"New Mexico","Harding County",1,10,4,3,1
050,35,021,"New Mexico","Harding County",1,11,6,4,2
050,35,021,"New Mexico","Harding County",1,12,4,3,1
050,35,021,"New Mexico","Harding County",1,13,4,2,2
050,35,021,"New Mexico","Harding County",1,14,3,1,2
050,35,021,"New Mexico","Harding County",1,15,2,1,1
050,35,021,"New Mexico","Harding County",1,16,3,2,1
050,35,021,"New Mexico","Harding County",1,17,2,1,1
050,35,021,"New Mexico","Harding County",1,18,3,2,1
050,35,021,"New Mexico","Harding County",1,19,1,1,0
050,35,021,"New Mexico","Harding County",1,20,4,3,1
050,35,021,"New Mexico","Harding County",1,21,7,4,3
050,35,021,"New Mexico","Harding County",1,22,4,2,2
050,35,021,"New Mexico","Harding County",1,23,4,3,1
050,35,021,"New Mexico","Harding County",1,24,3,0,3
050,35,021,"New Mexico","Harding County",1,25,6,2,4
050,35,021,"New Mexico","Harding County",1,26,4,1,3
050,35,021,"New Mexico","Harding County",1,27,8,2,6
050,35,021,"New Mexico","Harding County",1,28,7,4,3
050,35,021,"New Mexico","Harding County",1,29,3,2,1
050,35,021,"New Mexico","Harding County",1,30,3,1,2
050,35,021,"New Mexico","Harding County",1,31,4,2,2
050,35,021,"New Mexico","Harding County",1,32,5,4,1
050,35,021,"New Mexico","Harding County",1,33,4,1,3
050,35,021,"New Mexico","Harding County",1,34,6,2,4
050,35,021,"New Mexico","Harding County",1,35,7,3,4
050,35,021,"New Mexico","Harding County",1,36,9,4,5
050,35,021,"New Mexico","Harding County",1,37,5,2,3
050,35,021,"New Mexico","Harding County",1,38,12,9,3
050,35,021,"New Mexico","Harding County",1,39,7,6,1
050,35,021,"New Mexico","Harding County",1,40,9,6,3
050,35,021,"New Mexico","Harding County",1,41,3,2,1
050,35,021,"New Mexico","Harding County",1,42,4,1,3
050,35,021,"New Mexico","Harding County",1,43,6,3,3
050,35,021,"New Mexico","Harding County",1,44,9,9,0
050,35,021,"New Mexico","Harding County",1,45,3,2,1
050,35,021,"New Mexico","Harding County",1,46,2,1,1
050,35,021,"New Mexico","Harding County",1,47,1,0,1
050,35,021,"New Mexico","Harding County",1,48,5,2,3
050,35,021,"New Mexico","Harding County",1,49,3,1,2
050,35,021,"New Mexico","Harding County",1,50,2,1,1
050,35,021,"New Mexico","Harding County",1,51,4,3,1
050,35,021,"New Mexico","Harding County",1,52,7,3,4
050,35,021,"New Mexico","Harding County",1,53,7,3,4
050,35,021,"New Mexico","Harding County",1,54,8,5,3
050,35,021,"New Mexico","Harding County",1,55,10,5,5
050,35,021,"New Mexico","Harding County",1,56,11,7,4
050,35,021,"New Mexico","Harding County",1,57,11,4,7
050,35,021,"New Mexico","Harding County",1,58,17,8,9
050,35,021,"New Mexico","Harding County",1,59,10,4,6
050,35,021,"New Mexico","Harding County",1,60,9,6,3
050,35,021,"New Mexico","Harding County",1,61,13,10,3
050,35,021,"New Mexico","Harding County",1,62,15,10,5
050,35,021,"New Mexico","Harding County",1,63,9,3,6
050,35,021,"New Mexico","Harding County",1,64,11,5,6
050,35,021,"New Mexico","Harding County",1,65,22,13,9
050,35,021,"New Mexico","Harding County",1,66,21,11,10
050,35,021,"New Mexico","Harding County",1,67,22,10,12
050,35,021,"New Mexico","Harding County",1,68,16,7,9
050,35,021,"New Mexico","Harding County",1,69,14,6,8
050,35,021,"New Mexico","Harding County",1,70,12,4,8
050,35,021,"New Mexico","Harding County",1,71,11,4,7
050,35,021,"New Mexico","Harding County",1,72,12,6,6
050,35,021,"New Mexico","Harding County",1,73,14,10,4
050,35,021,"New Mexico","Harding County",1,74,13,6,7
050,35,021,"New Mexico","Harding County",1,75,13,6,7
050,35,021,"New Mexico","Harding County",1,76,6,2,4
050,35,021,"New Mexico","Harding County",1,77,4,2,2
050,35,021,"New Mexico","Harding County",1,78,5,3,2
050,35,021,"New Mexico","Harding County",1,79,6,3,3
050,35,021,"New Mexico","Harding County",1,80,7,2,5
050,35,021,"New Mexico","Harding County",1,81,6,3,3
050,35,021,"New Mexico","Harding County",1,82,6,4,2
050,35,021,"New Mexico","Harding County",1,83,3,1,2
050,35,021,"New Mexico","Harding County",1,84,5,3,2
050,35,021,"New Mexico","Harding County",1,85,55,32,23
050,35,021,"New Mexico","Harding County",2,0,4,3,1
050,35,021,"New Mexico","Harding County",2,1,3,1,2
050,35,021,"New Mexico","Harding County",2,2,4,1,3
050,35,021,"New Mexico","Harding County",2,3,4,2,2
050,35,021,"New Mexico","Harding County",2,4,6,3,3
050,35,021,"New Mexico","Harding County",2,5,3,1,2
050,35,021,"New Mexico","Harding County",2,6,7,2,5
050,35,021,"New Mexico","Harding County",2,7,9,5,4
050,35,021,"New Mexico","Harding County",2,8,5,3,2
050,35,021,"New Mexico","Harding County",2,9,5,3,2
050,35,021,"New Mexico","Harding County",2,10,4,3,1
050,35,021,"New Mexico","Harding County",2,11,6,4,2
050,35,021,"New Mexico","Harding County",2,12,5,4,1
050,35,021,"New Mexico","Harding County",2,13,3,2,1
050,35,021,"New Mexico","Harding County",2,14,4,1,3
050,35,021,"New Mexico","Harding County",2,15,2,1,1
050,35,021,"New Mexico","Harding County",2,16,3,2,1
050,35,021,"New Mexico","Harding County",2,17,2,1,1
050,35,021,"New Mexico","Harding County",2,18,3,2,1
050,35,021,"New Mexico","Harding County",2,19,1,1,0
050,35,021,"New Mexico","Harding County",2,20,4,3,1
050,35,021,"New Mexico","Harding County",2,21,6,4,2
050,35,021,"New Mexico","Harding County",2,22,3,2,1
050,35,021,"New Mexico","Harding County",2,23,4,3,1
050,35,021,"New Mexico","Harding County",2,24,3,0,3
050,35,021,"New Mexico","Harding County",2,25,6,2,4
050,35,021,"New Mexico","Harding County",2,26,4,1,3
050,35,021,"New Mexico","Harding County",2,27,8,2,6
050,35,021,"New Mexico","Harding County",2,28,8,4,4
050,35,021,"New Mexico","Harding County",2,29,3,2,1
050,35,021,"New Mexico","Harding County",2,30,3,1,2
050,35,021,"New Mexico","Harding County",2,31,4,2,2
050,35,021,"New Mexico","Harding County",2,32,4,3,1
050,35,021,"New Mexico","Harding County",2,33,4,1,3
050,35,021,"New Mexico","Harding County",2,34,6,2,4
050,35,021,"New Mexico","Harding County",2,35,8,3,5
050,35,021,"New Mexico","Harding County",2,36,9,4,5
050,35,021,"New Mexico","Harding County",2,37,6,2,4
050,35,021,"New Mexico","Harding County",2,38,11,8,3
050,35,021,"New Mexico","Harding County",2,39,9,7,2
050,35,021,"New Mexico","Harding County",2,40,9,6,3
050,35,021,"New Mexico","Harding County",2,41,3,2,1
050,35,021,"New Mexico","Harding County",2,42,3,1,2
050,35,021,"New Mexico","Harding County",2,43,6,3,3
050,35,021,"New Mexico","Harding County",2,44,7,7,0
050,35,021,"New Mexico","Harding County",2,45,4,3,1
050,35,021,"New Mexico","Harding County",2,46,2,1,1
050,35,021,"New Mexico","Harding County",2,47,1,0,1
050,35,021,"New Mexico","Harding County",2,48,5,2,3
050,35,021,"New Mexico","Harding County",2,49,3,1,2
050,35,021,"New Mexico","Harding County",2,50,2,1,1
050,35,021,"New Mexico","Harding County",2,51,4,3,1
050,35,021,"New Mexico","Harding County",2,52,6,3,3
050,35,021,"New Mexico","Harding County",2,53,7,3,4
050,35,021,"New Mexico","Harding County",2,54,8,5,3
050,35,021,"New Mexico","Harding County",2,55,10,6,4
050,35,021,"New Mexico","Harding County",2,56,11,7,4
050,35,021,"New Mexico","Harding County",2,57,12,5,7
050,35,021,"New Mexico","Harding County",2,58,15,7,8
050,35,021,"New Mexico","Harding County",2,59,12,5,7
050,35,021,"New Mexico","Harding County",2,60,10,6,4
050,35,021,"New Mexico","Harding County",2,61,12,9,3
050,35,021,"New Mexico","Harding County",2,62,15,10,5
050,35,021,"New Mexico","Harding County",2,63,11,5,6
050,35,021,"New Mexico","Harding County",2,64,10,4,6
050,35,021,"New Mexico","Harding County",2,65,19,11,8
050,35,021,"New Mexico","Harding County",2,66,21,11,10
050,35,021,"New Mexico","Harding County",2,67,22,10,12
050,35,021,"New Mexico","Harding County",2,68,17,7,10
050,35,021,"New Mexico","Harding County",2,69,14,6,8
050,35,021,"New Mexico","Harding County",2,70,11,3,8
050,35,021,"New Mexico","Harding County",2,71,12,4,8
050,35,021,"New Mexico","Harding County",2,72,12,6,6
050,35,021,"New Mexico","Harding County",2,73,14,9,5
050,35,021,"New Mexico","Harding County",2,74,13,7,6
050,35,021,"New Mexico","Harding County",2,75,13,6,7
050,35,021,"New Mexico","Harding County",2,76,8,3,5
050,35,021,"New Mexico","Harding County",2,77,4,2,2
050,35,021,"New Mexico","Harding County",2,78,5,3,2
050,35,021,"New Mexico","Harding County",2,79,5,3,2
050,35,021,"New Mexico","Harding County",2,80,6,2,4
050,35,021,"New Mexico","Harding County",2,81,6,3,3
050,35,021,"New Mexico","Harding County",2,82,6,4,2
050,35,021,"New Mexico","Harding County",2,83,4,2,2
050,35,021,"New Mexico","Harding County",2,84,5,3,2
050,35,021,"New Mexico","Harding County",2,85,52,30,22
050,35,021,"New Mexico","Harding County",3,0,0,0,0
050,35,021,"New Mexico","Harding County",3,1,3,2,1
050,35,021,"New Mexico","Harding County",3,2,2,1,1
050,35,021,"New Mexico","Harding County",3,3,3,0,3
050,35,021,"New Mexico","Harding County",3,4,3,2,1
050,35,021,"New Mexico","Harding County",3,5,6,2,4
050,35,021,"New Mexico","Harding County",3,6,4,1,3
050,35,021,"New Mexico","Harding County",3,7,5,2,3
050,35,021,"New Mexico","Harding County",3,8,9,4,5
050,35,021,"New Mexico","Harding County",3,9,5,3,2
050,35,021,"New Mexico","Harding County",3,10,7,4,3
050,35,021,"New Mexico","Harding County",3,11,4,3,1
050,35,021,"New Mexico","Harding County",3,12,7,5,2
050,35,021,"New Mexico","Harding County",3,13,5,3,2
050,35,021,"New Mexico","Harding County",3,14,5,3,2
050,35,021,"New Mexico","Harding County",3,15,5,3,2
050,35,021,"New Mexico","Harding County",3,16,1,0,1
050,35,021,"New Mexico","Harding County",3,17,3,2,1
050,35,021,"New Mexico","Harding County",3,18,4,3,1
050,35,021,"New Mexico","Harding County",3,19,2,2,0
050,35,021,"New Mexico","Harding County",3,20,0,0,0
050,35,021,"New Mexico","Harding County",3,21,3,2,1
050,35,021,"New Mexico","Harding County",3,22,4,2,2
050,35,021,"New Mexico","Harding County",3,23,5,3,2
050,35,021,"New Mexico","Harding County",3,24,5,3,2
050,35,021,"New Mexico","Harding County",3,25,2,0,2
050,35,021,"New Mexico","Harding County",3,26,6,2,4
050,35,021,"New Mexico","Harding County",3,27,3,0,3
050,35,021,"New Mexico","Harding County",3,28,7,2,5
050,35,021,"New Mexico","Harding County",3,29,7,3,4
050,35,021,"New Mexico","Harding County",3,30,4,3,1
050,35,021,"New Mexico","Harding County",3,31,3,1,2
050,35,021,"New Mexico","Harding County",3,32,3,2,1
050,35,021,"New Mexico","Harding County",3,33,3,2,1
050,35,021,"New Mexico","Harding County",3,34,5,1,4
050,35,021,"New Mexico","Harding County",3,35,6,3,3
050,35,021,"New Mexico","Harding County",3,36,7,2,5
050,35,021,"New Mexico","Harding County",3,37,8,2,6
050,35,021,"New Mexico","Harding County",3,38,9,4,5
050,35,021,"New Mexico","Harding County",3,39,10,7,3
050,35,021,"New Mexico","Harding County",3,40,10,7,3
050,35,021,"New Mexico","Harding County",3,41,11,8,3
050,35,021,"New Mexico","Harding County",3,42,4,2,2
050,35,021,"New Mexico","Harding County",3,43,3,2,1
050,35,021,"New Mexico","Harding County",3,44,7,3,4
050,35,021,"New Mexico","Harding County",3,45,7,7,0
050,35,021,"New Mexico","Harding County",3,46,4,3,1
050,35,021,"New Mexico","Harding County",3,47,2,1,1
050,35,021,"New Mexico","Harding County",3,48,1,0,1
050,35,021,"New Mexico","Harding County",3,49,5,1,4
050,35,021,"New Mexico","Harding County",3,50,3,1,2
050,35,021,"New Mexico","Harding County",3,51,2,1,1
050,35,021,"New Mexico","Harding County",3,52,4,3,1
050,35,021,"New Mexico","Harding County",3,53,6,3,3
050,35,021,"New Mexico","Harding County",3,54,6,2,4
050,35,021,"New Mexico","Harding County",3,55,8,5,3
050,35,021,"New Mexico","Harding County",3,56,10,6,4
050,35,021,"New Mexico","Harding County",3,57,10,7,3
050,35,021,"New Mexico","Harding County",3,58,12,5,7
050,35,021,"New Mexico","Harding County",3,59,13,5,8
050,35,021,"New Mexico","Harding County",3,60,12,5,7
050,35,021,"New Mexico","Harding County",3,61,7,3,4
050,35,021,"New Mexico","Harding County",3,62,12,9,3
050,35,021,"New Mexico","Harding County",3,63,15,10,5
050,35,021,"New Mexico","Harding County",3,64,10,5,5
050,35,021,"New Mexico","Harding County",3,65,10,5,5
050,35,021,"New Mexico","Harding County",3,66,19,11,8
050,35,021,"New Mexico","Harding County",3,67,19,9,10
050,35,021,"New Mexico","Harding County",3,68,23,10,13
050,35,021,"New Mexico","Harding County",3,69,17,7,10
050,35,021,"New Mexico","Harding County",3,70,13,5,8
050,35,021,"New Mexico","Harding County",3,71,11,3,8
050,35,021,"New Mexico","Harding County",3,72,11,4,7
050,35,021,"New Mexico","Harding County",3,73,12,6,6
050,35,021,"New Mexico","Harding County",3,74,14,9,5
050,35,021,"New Mexico","Harding County",3,75,12,6,6
050,35,021,"New Mexico","Harding County",3,76,12,5,7
050,35,021,"New Mexico","Harding County",3,77,7,3,4
050,35,021,"New Mexico","Harding County",3,78,4,2,2
050,35,021,"New Mexico","Harding County",3,79,4,2,2
050,35,021,"New Mexico","Harding County",3,80,5,3,2
050,35,021,"New Mexico","Harding County",3,81,6,2,4
050,35,021,"New Mexico","Harding County",3,82,5,3,2
050,35,021,"New Mexico","Harding County",3,83,6,4,2
050,35,021,"New Mexico","Harding County",3,84,3,1,2
050,35,021,"New Mexico","Harding County",3,85,51,30,21
050,35,021,"New Mexico","Harding County",4,0,0,0,0
050,35,021,"New Mexico","Harding County",4,1,2,2,0
050,35,021,"New Mexico","Harding County",4,2,3,2,1
050,35,021,"New Mexico","Harding County",4,3,5,2,3
050,35,021,"New Mexico","Harding County",4,4,3,0,3
050,35,021,"New Mexico","Harding County",4,5,3,2,1
050,35,021,"New Mexico","Harding County",4,6,4,1,3
050,35,021,"New Mexico","Harding County",4,7,8,5,3
050,35,021,"New Mexico","Harding County",4,8,4,2,2
050,35,021,"New Mexico","Harding County",4,9,7,4,3
050,35,021,"New Mexico","Harding County",4,10,6,3,3
050,35,021,"New Mexico","Harding County",4,11,6,4,2
050,35,021,"New Mexico","Harding County",4,12,5,4,1
050,35,021,"New Mexico","Harding County",4,13,9,7,2
050,35,021,"New Mexico","Harding County",4,14,4,3,1
050,35,021,"New Mexico","Harding County",4,15,5,3,2
050,35,021,"New Mexico","Harding County",4,16,6,4,2
050,35,021,"New Mexico","Harding County",4,17,1,0,1
050,35,021,"New Mexico","Harding County",4,18,3,2,1
050,35,021,"New Mexico","Harding County",4,19,5,4,1
050,35,021,"New Mexico","Harding County",4,20,2,2,0
050,35,021,"New Mexico","Harding County",4,21,1,1,0
050,35,021,"New Mexico","Harding County",4,22,2,1,1
050,35,021,"New Mexico","Harding County",4,23,5,3,2
050,35,021,"New Mexico","Harding County",4,24,5,4,1
050,35,021,"New Mexico","Harding County",4,25,3,1,2
050,35,021,"New Mexico","Harding County",4,26,2,0,2
050,35,021,"New Mexico","Harding County",4,27,5,1,4
050,35,021,"New Mexico","Harding County",4,28,4,2,2
050,35,021,"New Mexico","Harding County",4,29,2,1,1
050,35,021,"New Mexico","Harding County",4,30,6,2,4
050,35,021,"New Mexico","Harding County",4,31,2,1,1
050,35,021,"New Mexico","Harding County",4,32,3,1,2
050,35,021,"New Mexico","Harding County",4,33,4,2,2
050,35,021,"New Mexico","Harding County",4,34,3,2,1
050,35,021,"New Mexico","Harding County",4,35,5,0,5
050,35,021,"New Mexico","Harding County",4,36,6,3,3
050,35,021,"New Mexico","Harding County",4,37,8,2,6
050,35,021,"New Mexico","Harding County",4,38,7,3,4
050,35,021,"New Mexico","Harding County",4,39,9,4,5
050,35,021,"New Mexico","Harding County",4,40,11,7,4
050,35,021,"New Mexico","Harding County",4,41,10,7,3
050,35,021,"New Mexico","Harding County",4,42,11,8,3
050,35,021,"New Mexico","Harding County",4,43,5,3,2
050,35,021,"New Mexico","Harding County",4,44,3,2,1
050,35,021,"New Mexico","Harding County",4,45,9,4,5
050,35,021,"New Mexico","Harding County",4,46,9,9,0
050,35,021,"New Mexico","Harding County",4,47,5,3,2
050,35,021,"New Mexico","Harding County",4,48,2,1,1
050,35,021,"New Mexico","Harding County",4,49,1,0,1
050,35,021,"New Mexico","Harding County",4,50,5,1,4
050,35,021,"New Mexico","Harding County",4,51,3,1,2
050,35,021,"New Mexico","Harding County",4,52,2,1,1
050,35,021,"New Mexico","Harding County",4,53,4,3,1
050,35,021,"New Mexico","Harding County",4,54,8,3,5
050,35,021,"New Mexico","Harding County",4,55,5,3,2
050,35,021,"New Mexico","Harding County",4,56,8,5,3
050,35,021,"New Mexico","Harding County",4,57,10,6,4
050,35,021,"New Mexico","Harding County",4,58,10,7,3
050,35,021,"New Mexico","Harding County",4,59,12,5,7
050,35,021,"New Mexico","Harding County",4,60,13,5,8
050,35,021,"New Mexico","Harding County",4,61,11,4,7
050,35,021,"New Mexico","Harding County",4,62,8,4,4
050,35,021,"New Mexico","Harding County",4,63,12,9,3
050,35,021,"New Mexico","Harding County",4,64,15,10,5
050,35,021,"New Mexico","Harding County",4,65,10,5,5
050,35,021,"New Mexico","Harding County",4,66,10,5,5
050,35,021,"New Mexico","Harding County",4,67,19,11,8
050,35,021,"New Mexico","Harding County",4,68,17,9,8
050,35,021,"New Mexico","Harding County",4,69,20,10,10
050,35,021,"New Mexico","Harding County",4,70,13,5,8
050,35,021,"New Mexico","Harding County",4,71,12,5,7
050,35,021,"New Mexico","Harding County",4,72,10,3,7
050,35,021,"New Mexico","Harding County",4,73,11,4,7
050,35,021,"New Mexico","Harding County",4,74,11,5,6
050,35,021,"New Mexico","Harding County",4,75,14,9,5
050,35,021,"New Mexico","Harding County",4,76,11,5,6
050,35,021,"New Mexico","Harding County",4,77,12,5,7
050,35,021,"New Mexico","Harding County",4,78,7,3,4
050,35,021,"New Mexico","Harding County",4,79,3,1,2
050,35,021,"New Mexico","Harding County",4,80,5,2,3
050,35,021,"New Mexico","Harding County",4,81,5,3,2
050,35,021,"New Mexico","Harding County",4,82,6,2,4
050,35,021,"New Mexico","Harding County",4,83,4,2,2
050,35,021,"New Mexico","Harding County",4,84,6,4,2
050,35,021,"New Mexico","Harding County",4,85,50,29,21
050,35,021,"New Mexico","Harding County",5,0,0,0,0
050,35,021,"New Mexico","Harding County",5,1,0,0,0
050,35,021,"New Mexico","Harding County",5,2,3,2,1
050,35,021,"New Mexico","Harding County",5,3,4,3,1
050,35,021,"New Mexico","Harding County",5,4,5,2,3
050,35,021,"New Mexico","Harding County",5,5,3,0,3
050,35,021,"New Mexico","Harding County",5,6,4,3,1
050,35,021,"New Mexico","Harding County",5,7,4,1,3
050,35,021,"New Mexico","Harding County",5,8,8,5,3
050,35,021,"New Mexico","Harding County",5,9,2,1,1
050,35,021,"New Mexico","Harding County",5,10,8,4,4
050,35,021,"New Mexico","Harding County",5,11,7,4,3
050,35,021,"New Mexico","Harding County",5,12,6,4,2
050,35,021,"New Mexico","Harding County",5,13,6,4,2
050,35,021,"New Mexico","Harding County",5,14,8,6,2
050,35,021,"New Mexico","Harding County",5,15,5,3,2
050,35,021,"New Mexico","Harding County",5,16,5,3,2
050,35,021,"New Mexico","Harding County",5,17,6,4,2
050,35,021,"New Mexico","Harding County",5,18,1,0,1
050,35,021,"New Mexico","Harding County",5,19,3,2,1
050,35,021,"New Mexico","Harding County",5,20,5,3,2
050,35,021,"New Mexico","Harding County",5,21,1,1,0
050,35,021,"New Mexico","Harding County",5,22,1,0,1
050,35,021,"New Mexico","Harding County",5,23,4,3,1
050,35,021,"New Mexico","Harding County",5,24,5,3,2
050,35,021,"New Mexico","Harding County",5,25,6,5,1
050,35,021,"New Mexico","Harding County",5,26,4,2,2
050,35,021,"New Mexico","Harding County",5,27,2,0,2
050,35,021,"New Mexico","Harding County",5,28,6,2,4
050,35,021,"New Mexico","Harding County",5,29,4,2,2
050,35,021,"New Mexico","Harding County",5,30,3,2,1
050,35,021,"New Mexico","Harding County",5,31,5,2,3
050,35,021,"New Mexico","Harding County",5,32,3,1,2
050,35,021,"New Mexico","Harding County",5,33,3,1,2
050,35,021,"New Mexico","Harding County",5,34,4,2,2
050,35,021,"New Mexico","Harding County",5,35,3,2,1
050,35,021,"New Mexico","Harding County",5,36,4,0,4
050,35,021,"New Mexico","Harding County",5,37,7,4,3
050,35,021,"New Mexico","Harding County",5,38,8,1,7
050,35,021,"New Mexico","Harding County",5,39,11,5,6
050,35,021,"New Mexico","Harding County",5,40,9,4,5
050,35,021,"New Mexico","Harding County",5,41,12,8,4
050,35,021,"New Mexico","Harding County",5,42,10,7,3
050,35,021,"New Mexico","Harding County",5,43,12,9,3
050,35,021,"New Mexico","Harding County",5,44,4,2,2
050,35,021,"New Mexico","Harding County",5,45,3,2,1
050,35,021,"New Mexico","Harding County",5,46,9,4,5
050,35,021,"New Mexico","Harding County",5,47,9,9,0
050,35,021,"New Mexico","Harding County",5,48,5,3,2
050,35,021,"New Mexico","Harding County",5,49,2,1,1
050,35,021,"New Mexico","Harding County",5,50,2,0,2
050,35,021,"New Mexico","Harding County",5,51,5,1,4
050,35,021,"New Mexico","Harding County",5,52,3,1,2
050,35,021,"New Mexico","Harding County",5,53,2,1,1
050,35,021,"New Mexico","Harding County",5,54,4,3,1
050,35,021,"New Mexico","Harding County",5,55,8,3,5
050,35,021,"New Mexico","Harding County",5,56,6,4,2
050,35,021,"New Mexico","Harding County",5,57,9,6,3
050,35,021,"New Mexico","Harding County",5,58,10,6,4
050,35,021,"New Mexico","Harding County",5,59,10,7,3
050,35,021,"New Mexico","Harding County",5,60,12,5,7
050,35,021,"New Mexico","Harding County",5,61,12,4,8
050,35,021,"New Mexico","Harding County",5,62,11,4,7
050,35,021,"New Mexico","Harding County",5,63,8,4,4
050,35,021,"New Mexico","Harding County",5,64,12,9,3
050,35,021,"New Mexico","Harding County",5,65,15,11,4
050,35,021,"New Mexico","Harding County",5,66,11,6,5
050,35,021,"New Mexico","Harding County",5,67,10,5,5
050,35,021,"New Mexico","Harding County",5,68,17,11,6
050,35,021,"New Mexico","Harding County",5,69,17,9,8
050,35,021,"New Mexico","Harding County",5,70,17,7,10
050,35,021,"New Mexico","Harding County",5,71,13,5,8
050,35,021,"New Mexico","Harding County",5,72,9,5,4
050,35,021,"New Mexico","Harding County",5,73,8,3,5
050,35,021,"New Mexico","Harding County",5,74,9,3,6
050,35,021,"New Mexico","Harding County",5,75,11,5,6
050,35,021,"New Mexico","Harding County",5,76,13,8,5
050,35,021,"New Mexico","Harding County",5,77,11,5,6
050,35,021,"New Mexico","Harding County",5,78,12,5,7
050,35,021,"New Mexico","Harding County",5,79,6,2,4
050,35,021,"New Mexico","Harding County",5,80,3,1,2
050,35,021,"New Mexico","Harding County",5,81,5,2,3
050,35,021,"New Mexico","Harding County",5,82,6,3,3
050,35,021,"New Mexico","Harding County",5,83,6,2,4
050,35,021,"New Mexico","Harding County",5,84,4,2,2
050,35,021,"New Mexico","Harding County",5,85,55,33,22
050,35,023,"New Mexico","Hidalgo County",1,0,37,19,18
050,35,023,"New Mexico","Hidalgo County",1,1,42,21,21
050,35,023,"New Mexico","Hidalgo County",1,2,54,28,26
050,35,023,"New Mexico","Hidalgo County",1,3,55,36,19
050,35,023,"New Mexico","Hidalgo County",1,4,48,25,23
050,35,023,"New Mexico","Hidalgo County",1,5,46,24,22
050,35,023,"New Mexico","Hidalgo County",1,6,39,17,22
050,35,023,"New Mexico","Hidalgo County",1,7,52,28,24
050,35,023,"New Mexico","Hidalgo County",1,8,56,23,33
050,35,023,"New Mexico","Hidalgo County",1,9,47,21,26
050,35,023,"New Mexico","Hidalgo County",1,10,56,28,28
050,35,023,"New Mexico","Hidalgo County",1,11,60,25,35
050,35,023,"New Mexico","Hidalgo County",1,12,64,33,31
050,35,023,"New Mexico","Hidalgo County",1,13,58,28,30
050,35,023,"New Mexico","Hidalgo County",1,14,50,25,25
050,35,023,"New Mexico","Hidalgo County",1,15,49,25,24
050,35,023,"New Mexico","Hidalgo County",1,16,55,29,26
050,35,023,"New Mexico","Hidalgo County",1,17,53,24,29
050,35,023,"New Mexico","Hidalgo County",1,18,45,21,24
050,35,023,"New Mexico","Hidalgo County",1,19,39,21,18
050,35,023,"New Mexico","Hidalgo County",1,20,45,21,24
050,35,023,"New Mexico","Hidalgo County",1,21,52,32,20
050,35,023,"New Mexico","Hidalgo County",1,22,46,27,19
050,35,023,"New Mexico","Hidalgo County",1,23,42,23,19
050,35,023,"New Mexico","Hidalgo County",1,24,45,27,18
050,35,023,"New Mexico","Hidalgo County",1,25,48,23,25
050,35,023,"New Mexico","Hidalgo County",1,26,56,32,24
050,35,023,"New Mexico","Hidalgo County",1,27,52,34,18
050,35,023,"New Mexico","Hidalgo County",1,28,44,29,15
050,35,023,"New Mexico","Hidalgo County",1,29,43,24,19
050,35,023,"New Mexico","Hidalgo County",1,30,54,28,26
050,35,023,"New Mexico","Hidalgo County",1,31,44,22,22
050,35,023,"New Mexico","Hidalgo County",1,32,44,24,20
050,35,023,"New Mexico","Hidalgo County",1,33,38,22,16
050,35,023,"New Mexico","Hidalgo County",1,34,56,30,26
050,35,023,"New Mexico","Hidalgo County",1,35,54,30,24
050,35,023,"New Mexico","Hidalgo County",1,36,52,33,19
050,35,023,"New Mexico","Hidalgo County",1,37,52,32,20
050,35,023,"New Mexico","Hidalgo County",1,38,49,27,22
050,35,023,"New Mexico","Hidalgo County",1,39,38,21,17
050,35,023,"New Mexico","Hidalgo County",1,40,35,18,17
050,35,023,"New Mexico","Hidalgo County",1,41,35,18,17
050,35,023,"New Mexico","Hidalgo County",1,42,44,22,22
050,35,023,"New Mexico","Hidalgo County",1,43,40,15,25
050,35,023,"New Mexico","Hidalgo County",1,44,39,21,18
050,35,023,"New Mexico","Hidalgo County",1,45,36,19,17
050,35,023,"New Mexico","Hidalgo County",1,46,39,22,17
050,35,023,"New Mexico","Hidalgo County",1,47,41,20,21
050,35,023,"New Mexico","Hidalgo County",1,48,48,23,25
050,35,023,"New Mexico","Hidalgo County",1,49,43,19,24
050,35,023,"New Mexico","Hidalgo County",1,50,48,22,26
050,35,023,"New Mexico","Hidalgo County",1,51,58,31,27
050,35,023,"New Mexico","Hidalgo County",1,52,56,28,28
050,35,023,"New Mexico","Hidalgo County",1,53,67,36,31
050,35,023,"New Mexico","Hidalgo County",1,54,60,30,30
050,35,023,"New Mexico","Hidalgo County",1,55,59,28,31
050,35,023,"New Mexico","Hidalgo County",1,56,57,34,23
050,35,023,"New Mexico","Hidalgo County",1,57,69,31,38
050,35,023,"New Mexico","Hidalgo County",1,58,68,35,33
050,35,023,"New Mexico","Hidalgo County",1,59,64,28,36
050,35,023,"New Mexico","Hidalgo County",1,60,65,29,36
050,35,023,"New Mexico","Hidalgo County",1,61,48,26,22
050,35,023,"New Mexico","Hidalgo County",1,62,54,30,24
050,35,023,"New Mexico","Hidalgo County",1,63,60,29,31
050,35,023,"New Mexico","Hidalgo County",1,64,53,19,34
050,35,023,"New Mexico","Hidalgo County",1,65,58,31,27
050,35,023,"New Mexico","Hidalgo County",1,66,53,25,28
050,35,023,"New Mexico","Hidalgo County",1,67,54,33,21
050,35,023,"New Mexico","Hidalgo County",1,68,56,27,29
050,35,023,"New Mexico","Hidalgo County",1,69,61,29,32
050,35,023,"New Mexico","Hidalgo County",1,70,65,27,38
050,35,023,"New Mexico","Hidalgo County",1,71,58,26,32
050,35,023,"New Mexico","Hidalgo County",1,72,59,31,28
050,35,023,"New Mexico","Hidalgo County",1,73,57,36,21
050,35,023,"New Mexico","Hidalgo County",1,74,31,17,14
050,35,023,"New Mexico","Hidalgo County",1,75,34,19,15
050,35,023,"New Mexico","Hidalgo County",1,76,38,17,21
050,35,023,"New Mexico","Hidalgo County",1,77,35,14,21
050,35,023,"New Mexico","Hidalgo County",1,78,39,19,20
050,35,023,"New Mexico","Hidalgo County",1,79,31,14,17
050,35,023,"New Mexico","Hidalgo County",1,80,25,15,10
050,35,023,"New Mexico","Hidalgo County",1,81,16,7,9
050,35,023,"New Mexico","Hidalgo County",1,82,24,13,11
050,35,023,"New Mexico","Hidalgo County",1,83,25,12,13
050,35,023,"New Mexico","Hidalgo County",1,84,17,7,10
050,35,023,"New Mexico","Hidalgo County",1,85,98,40,58
050,35,023,"New Mexico","Hidalgo County",2,0,47,23,24
050,35,023,"New Mexico","Hidalgo County",2,1,40,20,20
050,35,023,"New Mexico","Hidalgo County",2,2,50,26,24
050,35,023,"New Mexico","Hidalgo County",2,3,53,33,20
050,35,023,"New Mexico","Hidalgo County",2,4,49,28,21
050,35,023,"New Mexico","Hidalgo County",2,5,46,24,22
050,35,023,"New Mexico","Hidalgo County",2,6,41,18,23
050,35,023,"New Mexico","Hidalgo County",2,7,48,24,24
050,35,023,"New Mexico","Hidalgo County",2,8,55,25,30
050,35,023,"New Mexico","Hidalgo County",2,9,50,22,28
050,35,023,"New Mexico","Hidalgo County",2,10,53,25,28
050,35,023,"New Mexico","Hidalgo County",2,11,57,25,32
050,35,023,"New Mexico","Hidalgo County",2,12,64,31,33
050,35,023,"New Mexico","Hidalgo County",2,13,58,28,30
050,35,023,"New Mexico","Hidalgo County",2,14,50,25,25
050,35,023,"New Mexico","Hidalgo County",2,15,49,25,24
050,35,023,"New Mexico","Hidalgo County",2,16,54,29,25
050,35,023,"New Mexico","Hidalgo County",2,17,54,25,29
050,35,023,"New Mexico","Hidalgo County",2,18,44,21,23
050,35,023,"New Mexico","Hidalgo County",2,19,40,21,19
050,35,023,"New Mexico","Hidalgo County",2,20,45,22,23
050,35,023,"New Mexico","Hidalgo County",2,21,51,30,21
050,35,023,"New Mexico","Hidalgo County",2,22,48,29,19
050,35,023,"New Mexico","Hidalgo County",2,23,42,24,18
050,35,023,"New Mexico","Hidalgo County",2,24,43,26,17
050,35,023,"New Mexico","Hidalgo County",2,25,48,25,23
050,35,023,"New Mexico","Hidalgo County",2,26,55,30,25
050,35,023,"New Mexico","Hidalgo County",2,27,51,32,19
050,35,023,"New Mexico","Hidalgo County",2,28,47,30,17
050,35,023,"New Mexico","Hidalgo County",2,29,43,25,18
050,35,023,"New Mexico","Hidalgo County",2,30,52,28,24
050,35,023,"New Mexico","Hidalgo County",2,31,46,24,22
050,35,023,"New Mexico","Hidalgo County",2,32,45,24,21
050,35,023,"New Mexico","Hidalgo County",2,33,39,22,17
050,35,023,"New Mexico","Hidalgo County",2,34,51,27,24
050,35,023,"New Mexico","Hidalgo County",2,35,55,30,25
050,35,023,"New Mexico","Hidalgo County",2,36,52,32,20
050,35,023,"New Mexico","Hidalgo County",2,37,53,32,21
050,35,023,"New Mexico","Hidalgo County",2,38,49,27,22
050,35,023,"New Mexico","Hidalgo County",2,39,43,24,19
050,35,023,"New Mexico","Hidalgo County",2,40,34,18,16
050,35,023,"New Mexico","Hidalgo County",2,41,35,19,16
050,35,023,"New Mexico","Hidalgo County",2,42,41,20,21
050,35,023,"New Mexico","Hidalgo County",2,43,42,17,25
050,35,023,"New Mexico","Hidalgo County",2,44,40,20,20
050,35,023,"New Mexico","Hidalgo County",2,45,35,18,17
050,35,023,"New Mexico","Hidalgo County",2,46,38,21,17
050,35,023,"New Mexico","Hidalgo County",2,47,40,20,20
050,35,023,"New Mexico","Hidalgo County",2,48,45,22,23
050,35,023,"New Mexico","Hidalgo County",2,49,44,20,24
050,35,023,"New Mexico","Hidalgo County",2,50,46,21,25
050,35,023,"New Mexico","Hidalgo County",2,51,54,28,26
050,35,023,"New Mexico","Hidalgo County",2,52,57,29,28
050,35,023,"New Mexico","Hidalgo County",2,53,64,34,30
050,35,023,"New Mexico","Hidalgo County",2,54,59,30,29
050,35,023,"New Mexico","Hidalgo County",2,55,59,29,30
050,35,023,"New Mexico","Hidalgo County",2,56,57,32,25
050,35,023,"New Mexico","Hidalgo County",2,57,67,32,35
050,35,023,"New Mexico","Hidalgo County",2,58,68,34,34
050,35,023,"New Mexico","Hidalgo County",2,59,64,28,36
050,35,023,"New Mexico","Hidalgo County",2,60,64,29,35
050,35,023,"New Mexico","Hidalgo County",2,61,52,26,26
050,35,023,"New Mexico","Hidalgo County",2,62,52,29,23
050,35,023,"New Mexico","Hidalgo County",2,63,58,29,29
050,35,023,"New Mexico","Hidalgo County",2,64,54,22,32
050,35,023,"New Mexico","Hidalgo County",2,65,57,28,29
050,35,023,"New Mexico","Hidalgo County",2,66,53,27,26
050,35,023,"New Mexico","Hidalgo County",2,67,53,31,22
050,35,023,"New Mexico","Hidalgo County",2,68,56,28,28
050,35,023,"New Mexico","Hidalgo County",2,69,60,28,32
050,35,023,"New Mexico","Hidalgo County",2,70,63,27,36
050,35,023,"New Mexico","Hidalgo County",2,71,60,27,33
050,35,023,"New Mexico","Hidalgo County",2,72,56,28,28
050,35,023,"New Mexico","Hidalgo County",2,73,59,34,25
050,35,023,"New Mexico","Hidalgo County",2,74,34,19,15
050,35,023,"New Mexico","Hidalgo County",2,75,33,19,14
050,35,023,"New Mexico","Hidalgo County",2,76,38,18,20
050,35,023,"New Mexico","Hidalgo County",2,77,36,15,21
050,35,023,"New Mexico","Hidalgo County",2,78,36,17,19
050,35,023,"New Mexico","Hidalgo County",2,79,32,15,17
050,35,023,"New Mexico","Hidalgo County",2,80,28,16,12
050,35,023,"New Mexico","Hidalgo County",2,81,17,8,9
050,35,023,"New Mexico","Hidalgo County",2,82,22,12,10
050,35,023,"New Mexico","Hidalgo County",2,83,25,12,13
050,35,023,"New Mexico","Hidalgo County",2,84,18,8,10
050,35,023,"New Mexico","Hidalgo County",2,85,99,41,58
050,35,023,"New Mexico","Hidalgo County",3,0,26,13,13
050,35,023,"New Mexico","Hidalgo County",3,1,44,20,24
050,35,023,"New Mexico","Hidalgo County",3,2,36,20,16
050,35,023,"New Mexico","Hidalgo County",3,3,49,28,21
050,35,023,"New Mexico","Hidalgo County",3,4,52,32,20
050,35,023,"New Mexico","Hidalgo County",3,5,52,31,21
050,35,023,"New Mexico","Hidalgo County",3,6,46,24,22
050,35,023,"New Mexico","Hidalgo County",3,7,39,18,21
050,35,023,"New Mexico","Hidalgo County",3,8,50,26,24
050,35,023,"New Mexico","Hidalgo County",3,9,57,26,31
050,35,023,"New Mexico","Hidalgo County",3,10,45,21,24
050,35,023,"New Mexico","Hidalgo County",3,11,57,29,28
050,35,023,"New Mexico","Hidalgo County",3,12,55,26,29
050,35,023,"New Mexico","Hidalgo County",3,13,66,32,34
050,35,023,"New Mexico","Hidalgo County",3,14,58,31,27
050,35,023,"New Mexico","Hidalgo County",3,15,51,25,26
050,35,023,"New Mexico","Hidalgo County",3,16,53,25,28
050,35,023,"New Mexico","Hidalgo County",3,17,49,28,21
050,35,023,"New Mexico","Hidalgo County",3,18,53,25,28
050,35,023,"New Mexico","Hidalgo County",3,19,36,20,16
050,35,023,"New Mexico","Hidalgo County",3,20,34,19,15
050,35,023,"New Mexico","Hidalgo County",3,21,43,19,24
050,35,023,"New Mexico","Hidalgo County",3,22,51,29,22
050,35,023,"New Mexico","Hidalgo County",3,23,46,29,17
050,35,023,"New Mexico","Hidalgo County",3,24,45,24,21
050,35,023,"New Mexico","Hidalgo County",3,25,41,26,15
050,35,023,"New Mexico","Hidalgo County",3,26,42,21,21
050,35,023,"New Mexico","Hidalgo County",3,27,57,32,25
050,35,023,"New Mexico","Hidalgo County",3,28,51,33,18
050,35,023,"New Mexico","Hidalgo County",3,29,48,28,20
050,35,023,"New Mexico","Hidalgo County",3,30,44,25,19
050,35,023,"New Mexico","Hidalgo County",3,31,48,25,23
050,35,023,"New Mexico","Hidalgo County",3,32,39,22,17
050,35,023,"New Mexico","Hidalgo County",3,33,46,27,19
050,35,023,"New Mexico","Hidalgo County",3,34,38,20,18
050,35,023,"New Mexico","Hidalgo County",3,35,48,26,22
050,35,023,"New Mexico","Hidalgo County",3,36,56,32,24
050,35,023,"New Mexico","Hidalgo County",3,37,51,33,18
050,35,023,"New Mexico","Hidalgo County",3,38,60,35,25
050,35,023,"New Mexico","Hidalgo County",3,39,49,26,23
050,35,023,"New Mexico","Hidalgo County",3,40,45,24,21
050,35,023,"New Mexico","Hidalgo County",3,41,33,18,15
050,35,023,"New Mexico","Hidalgo County",3,42,38,19,19
050,35,023,"New Mexico","Hidalgo County",3,43,40,17,23
050,35,023,"New Mexico","Hidalgo County",3,44,41,17,24
050,35,023,"New Mexico","Hidalgo County",3,45,40,19,21
050,35,023,"New Mexico","Hidalgo County",3,46,35,18,17
050,35,023,"New Mexico","Hidalgo County",3,47,41,21,20
050,35,023,"New Mexico","Hidalgo County",3,48,39,20,19
050,35,023,"New Mexico","Hidalgo County",3,49,44,21,23
050,35,023,"New Mexico","Hidalgo County",3,50,41,19,22
050,35,023,"New Mexico","Hidalgo County",3,51,45,21,24
050,35,023,"New Mexico","Hidalgo County",3,52,56,28,28
050,35,023,"New Mexico","Hidalgo County",3,53,59,32,27
050,35,023,"New Mexico","Hidalgo County",3,54,58,30,28
050,35,023,"New Mexico","Hidalgo County",3,55,63,33,30
050,35,023,"New Mexico","Hidalgo County",3,56,60,29,31
050,35,023,"New Mexico","Hidalgo County",3,57,54,28,26
050,35,023,"New Mexico","Hidalgo County",3,58,68,33,35
050,35,023,"New Mexico","Hidalgo County",3,59,65,33,32
050,35,023,"New Mexico","Hidalgo County",3,60,58,26,32
050,35,023,"New Mexico","Hidalgo County",3,61,65,29,36
050,35,023,"New Mexico","Hidalgo County",3,62,51,26,25
050,35,023,"New Mexico","Hidalgo County",3,63,51,28,23
050,35,023,"New Mexico","Hidalgo County",3,64,57,29,28
050,35,023,"New Mexico","Hidalgo County",3,65,56,24,32
050,35,023,"New Mexico","Hidalgo County",3,66,58,29,29
050,35,023,"New Mexico","Hidalgo County",3,67,52,27,25
050,35,023,"New Mexico","Hidalgo County",3,68,48,27,21
050,35,023,"New Mexico","Hidalgo County",3,69,56,28,28
050,35,023,"New Mexico","Hidalgo County",3,70,58,28,30
050,35,023,"New Mexico","Hidalgo County",3,71,56,25,31
050,35,023,"New Mexico","Hidalgo County",3,72,57,26,31
050,35,023,"New Mexico","Hidalgo County",3,73,56,28,28
050,35,023,"New Mexico","Hidalgo County",3,74,53,31,22
050,35,023,"New Mexico","Hidalgo County",3,75,30,18,12
050,35,023,"New Mexico","Hidalgo County",3,76,32,19,13
050,35,023,"New Mexico","Hidalgo County",3,77,35,16,19
050,35,023,"New Mexico","Hidalgo County",3,78,34,14,20
050,35,023,"New Mexico","Hidalgo County",3,79,35,17,18
050,35,023,"New Mexico","Hidalgo County",3,80,34,16,18
050,35,023,"New Mexico","Hidalgo County",3,81,23,14,9
050,35,023,"New Mexico","Hidalgo County",3,82,17,8,9
050,35,023,"New Mexico","Hidalgo County",3,83,17,8,9
050,35,023,"New Mexico","Hidalgo County",3,84,24,11,13
050,35,023,"New Mexico","Hidalgo County",3,85,97,38,59
050,35,023,"New Mexico","Hidalgo County",4,0,41,22,19
050,35,023,"New Mexico","Hidalgo County",4,1,26,13,13
050,35,023,"New Mexico","Hidalgo County",4,2,41,19,22
050,35,023,"New Mexico","Hidalgo County",4,3,34,20,14
050,35,023,"New Mexico","Hidalgo County",4,4,49,27,22
050,35,023,"New Mexico","Hidalgo County",4,5,55,33,22
050,35,023,"New Mexico","Hidalgo County",4,6,46,25,21
050,35,023,"New Mexico","Hidalgo County",4,7,45,25,20
050,35,023,"New Mexico","Hidalgo County",4,8,44,18,26
050,35,023,"New Mexico","Hidalgo County",4,9,53,28,25
050,35,023,"New Mexico","Hidalgo County",4,10,58,27,31
050,35,023,"New Mexico","Hidalgo County",4,11,49,17,32
050,35,023,"New Mexico","Hidalgo County",4,12,61,29,32
050,35,023,"New Mexico","Hidalgo County",4,13,55,24,31
050,35,023,"New Mexico","Hidalgo County",4,14,66,32,34
050,35,023,"New Mexico","Hidalgo County",4,15,55,29,26
050,35,023,"New Mexico","Hidalgo County",4,16,50,26,24
050,35,023,"New Mexico","Hidalgo County",4,17,48,23,25
050,35,023,"New Mexico","Hidalgo County",4,18,46,25,21
050,35,023,"New Mexico","Hidalgo County",4,19,44,20,24
050,35,023,"New Mexico","Hidalgo County",4,20,35,20,15
050,35,023,"New Mexico","Hidalgo County",4,21,34,21,13
050,35,023,"New Mexico","Hidalgo County",4,22,46,21,25
050,35,023,"New Mexico","Hidalgo County",4,23,52,30,22
050,35,023,"New Mexico","Hidalgo County",4,24,53,36,17
050,35,023,"New Mexico","Hidalgo County",4,25,41,22,19
050,35,023,"New Mexico","Hidalgo County",4,26,39,28,11
050,35,023,"New Mexico","Hidalgo County",4,27,37,19,18
050,35,023,"New Mexico","Hidalgo County",4,28,53,29,24
050,35,023,"New Mexico","Hidalgo County",4,29,48,31,17
050,35,023,"New Mexico","Hidalgo County",4,30,44,25,19
050,35,023,"New Mexico","Hidalgo County",4,31,46,26,20
050,35,023,"New Mexico","Hidalgo County",4,32,52,25,27
050,35,023,"New Mexico","Hidalgo County",4,33,43,24,19
050,35,023,"New Mexico","Hidalgo County",4,34,44,25,19
050,35,023,"New Mexico","Hidalgo County",4,35,38,22,16
050,35,023,"New Mexico","Hidalgo County",4,36,40,21,19
050,35,023,"New Mexico","Hidalgo County",4,37,58,32,26
050,35,023,"New Mexico","Hidalgo County",4,38,45,28,17
050,35,023,"New Mexico","Hidalgo County",4,39,58,32,26
050,35,023,"New Mexico","Hidalgo County",4,40,47,25,22
050,35,023,"New Mexico","Hidalgo County",4,41,46,25,21
050,35,023,"New Mexico","Hidalgo County",4,42,32,16,16
050,35,023,"New Mexico","Hidalgo County",4,43,39,22,17
050,35,023,"New Mexico","Hidalgo County",4,44,40,18,22
050,35,023,"New Mexico","Hidalgo County",4,45,36,16,20
050,35,023,"New Mexico","Hidalgo County",4,46,38,17,21
050,35,023,"New Mexico","Hidalgo County",4,47,40,21,19
050,35,023,"New Mexico","Hidalgo County",4,48,37,20,17
050,35,023,"New Mexico","Hidalgo County",4,49,39,19,20
050,35,023,"New Mexico","Hidalgo County",4,50,43,20,23
050,35,023,"New Mexico","Hidalgo County",4,51,41,18,23
050,35,023,"New Mexico","Hidalgo County",4,52,39,16,23
050,35,023,"New Mexico","Hidalgo County",4,53,59,32,27
050,35,023,"New Mexico","Hidalgo County",4,54,54,27,27
050,35,023,"New Mexico","Hidalgo County",4,55,57,30,27
050,35,023,"New Mexico","Hidalgo County",4,56,61,33,28
050,35,023,"New Mexico","Hidalgo County",4,57,59,27,32
050,35,023,"New Mexico","Hidalgo County",4,58,56,30,26
050,35,023,"New Mexico","Hidalgo County",4,59,60,29,31
050,35,023,"New Mexico","Hidalgo County",4,60,64,33,31
050,35,023,"New Mexico","Hidalgo County",4,61,57,25,32
050,35,023,"New Mexico","Hidalgo County",4,62,66,32,34
050,35,023,"New Mexico","Hidalgo County",4,63,54,27,27
050,35,023,"New Mexico","Hidalgo County",4,64,50,28,22
050,35,023,"New Mexico","Hidalgo County",4,65,56,29,27
050,35,023,"New Mexico","Hidalgo County",4,66,60,25,35
050,35,023,"New Mexico","Hidalgo County",4,67,58,29,29
050,35,023,"New Mexico","Hidalgo County",4,68,51,26,25
050,35,023,"New Mexico","Hidalgo County",4,69,46,26,20
050,35,023,"New Mexico","Hidalgo County",4,70,46,20,26
050,35,023,"New Mexico","Hidalgo County",4,71,57,27,30
050,35,023,"New Mexico","Hidalgo County",4,72,50,23,27
050,35,023,"New Mexico","Hidalgo County",4,73,56,24,32
050,35,023,"New Mexico","Hidalgo County",4,74,52,26,26
050,35,023,"New Mexico","Hidalgo County",4,75,53,31,22
050,35,023,"New Mexico","Hidalgo County",4,76,30,17,13
050,35,023,"New Mexico","Hidalgo County",4,77,33,19,14
050,35,023,"New Mexico","Hidalgo County",4,78,32,15,17
050,35,023,"New Mexico","Hidalgo County",4,79,33,13,20
050,35,023,"New Mexico","Hidalgo County",4,80,35,17,18
050,35,023,"New Mexico","Hidalgo County",4,81,30,14,16
050,35,023,"New Mexico","Hidalgo County",4,82,20,12,8
050,35,023,"New Mexico","Hidalgo County",4,83,17,7,10
050,35,023,"New Mexico","Hidalgo County",4,84,14,8,6
050,35,023,"New Mexico","Hidalgo County",4,85,96,40,56
050,35,023,"New Mexico","Hidalgo County",5,0,43,22,21
050,35,023,"New Mexico","Hidalgo County",5,1,41,21,20
050,35,023,"New Mexico","Hidalgo County",5,2,31,16,15
050,35,023,"New Mexico","Hidalgo County",5,3,45,20,25
050,35,023,"New Mexico","Hidalgo County",5,4,34,20,14
050,35,023,"New Mexico","Hidalgo County",5,5,40,22,18
050,35,023,"New Mexico","Hidalgo County",5,6,51,32,19
050,35,023,"New Mexico","Hidalgo County",5,7,44,22,22
050,35,023,"New Mexico","Hidalgo County",5,8,42,24,18
050,35,023,"New Mexico","Hidalgo County",5,9,41,17,24
050,35,023,"New Mexico","Hidalgo County",5,10,49,25,24
050,35,023,"New Mexico","Hidalgo County",5,11,58,27,31
050,35,023,"New Mexico","Hidalgo County",5,12,46,16,30
050,35,023,"New Mexico","Hidalgo County",5,13,64,30,34
050,35,023,"New Mexico","Hidalgo County",5,14,54,25,29
050,35,023,"New Mexico","Hidalgo County",5,15,64,32,32
050,35,023,"New Mexico","Hidalgo County",5,16,58,31,27
050,35,023,"New Mexico","Hidalgo County",5,17,45,21,24
050,35,023,"New Mexico","Hidalgo County",5,18,45,22,23
050,35,023,"New Mexico","Hidalgo County",5,19,43,24,19
050,35,023,"New Mexico","Hidalgo County",5,20,40,17,23
050,35,023,"New Mexico","Hidalgo County",5,21,33,20,13
050,35,023,"New Mexico","Hidalgo County",5,22,40,20,20
050,35,023,"New Mexico","Hidalgo County",5,23,40,18,22
050,35,023,"New Mexico","Hidalgo County",5,24,47,30,17
050,35,023,"New Mexico","Hidalgo County",5,25,48,29,19
050,35,023,"New Mexico","Hidalgo County",5,26,40,21,19
050,35,023,"New Mexico","Hidalgo County",5,27,49,33,16
050,35,023,"New Mexico","Hidalgo County",5,28,41,23,18
050,35,023,"New Mexico","Hidalgo County",5,29,47,24,23
050,35,023,"New Mexico","Hidalgo County",5,30,43,27,16
050,35,023,"New Mexico","Hidalgo County",5,31,40,24,16
050,35,023,"New Mexico","Hidalgo County",5,32,45,24,21
050,35,023,"New Mexico","Hidalgo County",5,33,49,22,27
050,35,023,"New Mexico","Hidalgo County",5,34,46,24,22
050,35,023,"New Mexico","Hidalgo County",5,35,45,24,21
050,35,023,"New Mexico","Hidalgo County",5,36,40,25,15
050,35,023,"New Mexico","Hidalgo County",5,37,36,18,18
050,35,023,"New Mexico","Hidalgo County",5,38,60,34,26
050,35,023,"New Mexico","Hidalgo County",5,39,42,26,16
050,35,023,"New Mexico","Hidalgo County",5,40,58,35,23
050,35,023,"New Mexico","Hidalgo County",5,41,46,25,21
050,35,023,"New Mexico","Hidalgo County",5,42,47,25,22
050,35,023,"New Mexico","Hidalgo County",5,43,32,16,16
050,35,023,"New Mexico","Hidalgo County",5,44,37,24,13
050,35,023,"New Mexico","Hidalgo County",5,45,36,14,22
050,35,023,"New Mexico","Hidalgo County",5,46,33,14,19
050,35,023,"New Mexico","Hidalgo County",5,47,43,21,22
050,35,023,"New Mexico","Hidalgo County",5,48,39,20,19
050,35,023,"New Mexico","Hidalgo County",5,49,39,20,19
050,35,023,"New Mexico","Hidalgo County",5,50,38,17,21
050,35,023,"New Mexico","Hidalgo County",5,51,41,17,24
050,35,023,"New Mexico","Hidalgo County",5,52,41,17,24
050,35,023,"New Mexico","Hidalgo County",5,53,41,19,22
050,35,023,"New Mexico","Hidalgo County",5,54,57,29,28
050,35,023,"New Mexico","Hidalgo County",5,55,53,28,25
050,35,023,"New Mexico","Hidalgo County",5,56,59,30,29
050,35,023,"New Mexico","Hidalgo County",5,57,62,33,29
050,35,023,"New Mexico","Hidalgo County",5,58,62,27,35
050,35,023,"New Mexico","Hidalgo County",5,59,61,31,30
050,35,023,"New Mexico","Hidalgo County",5,60,56,28,28
050,35,023,"New Mexico","Hidalgo County",5,61,66,35,31
050,35,023,"New Mexico","Hidalgo County",5,62,56,26,30
050,35,023,"New Mexico","Hidalgo County",5,63,66,32,34
050,35,023,"New Mexico","Hidalgo County",5,64,51,27,24
050,35,023,"New Mexico","Hidalgo County",5,65,53,30,23
050,35,023,"New Mexico","Hidalgo County",5,66,58,31,27
050,35,023,"New Mexico","Hidalgo County",5,67,62,26,36
050,35,023,"New Mexico","Hidalgo County",5,68,58,29,29
050,35,023,"New Mexico","Hidalgo County",5,69,48,25,23
050,35,023,"New Mexico","Hidalgo County",5,70,43,24,19
050,35,023,"New Mexico","Hidalgo County",5,71,41,16,25
050,35,023,"New Mexico","Hidalgo County",5,72,54,27,27
050,35,023,"New Mexico","Hidalgo County",5,73,48,21,27
050,35,023,"New Mexico","Hidalgo County",5,74,50,20,30
050,35,023,"New Mexico","Hidalgo County",5,75,54,25,29
050,35,023,"New Mexico","Hidalgo County",5,76,55,32,23
050,35,023,"New Mexico","Hidalgo County",5,77,29,17,12
050,35,023,"New Mexico","Hidalgo County",5,78,30,17,13
050,35,023,"New Mexico","Hidalgo County",5,79,30,13,17
050,35,023,"New Mexico","Hidalgo County",5,80,32,13,19
050,35,023,"New Mexico","Hidalgo County",5,81,32,16,16
050,35,023,"New Mexico","Hidalgo County",5,82,28,13,15
050,35,023,"New Mexico","Hidalgo County",5,83,20,11,9
050,35,023,"New Mexico","Hidalgo County",5,84,17,9,8
050,35,023,"New Mexico","Hidalgo County",5,85,94,42,52
050,35,025,"New Mexico","Lea County",1,0,1161,593,568
050,35,025,"New Mexico","Lea County",1,1,1162,582,580
050,35,025,"New Mexico","Lea County",1,2,1145,565,580
050,35,025,"New Mexico","Lea County",1,3,1170,605,565
050,35,025,"New Mexico","Lea County",1,4,1225,638,587
050,35,025,"New Mexico","Lea County",1,5,1231,631,600
050,35,025,"New Mexico","Lea County",1,6,1205,639,566
050,35,025,"New Mexico","Lea County",1,7,1245,649,596
050,35,025,"New Mexico","Lea County",1,8,1231,630,601
050,35,025,"New Mexico","Lea County",1,9,1254,614,640
050,35,025,"New Mexico","Lea County",1,10,1330,671,659
050,35,025,"New Mexico","Lea County",1,11,1362,705,657
050,35,025,"New Mexico","Lea County",1,12,1437,747,690
050,35,025,"New Mexico","Lea County",1,13,1404,715,689
050,35,025,"New Mexico","Lea County",1,14,1279,632,647
050,35,025,"New Mexico","Lea County",1,15,1259,633,626
050,35,025,"New Mexico","Lea County",1,16,1248,658,590
050,35,025,"New Mexico","Lea County",1,17,1190,606,584
050,35,025,"New Mexico","Lea County",1,18,1124,587,537
050,35,025,"New Mexico","Lea County",1,19,1122,623,499
050,35,025,"New Mexico","Lea County",1,20,1101,607,494
050,35,025,"New Mexico","Lea County",1,21,1022,544,478
050,35,025,"New Mexico","Lea County",1,22,999,529,470
050,35,025,"New Mexico","Lea County",1,23,1028,532,496
050,35,025,"New Mexico","Lea County",1,24,1038,556,482
050,35,025,"New Mexico","Lea County",1,25,1008,553,455
050,35,025,"New Mexico","Lea County",1,26,1052,564,488
050,35,025,"New Mexico","Lea County",1,27,1088,583,505
050,35,025,"New Mexico","Lea County",1,28,1066,565,501
050,35,025,"New Mexico","Lea County",1,29,1097,586,511
050,35,025,"New Mexico","Lea County",1,30,1059,566,493
050,35,025,"New Mexico","Lea County",1,31,991,550,441
050,35,025,"New Mexico","Lea County",1,32,1030,542,488
050,35,025,"New Mexico","Lea County",1,33,1103,575,528
050,35,025,"New Mexico","Lea County",1,34,1085,571,514
050,35,025,"New Mexico","Lea County",1,35,1091,576,515
050,35,025,"New Mexico","Lea County",1,36,1089,576,513
050,35,025,"New Mexico","Lea County",1,37,1126,612,514
050,35,025,"New Mexico","Lea County",1,38,1032,554,478
050,35,025,"New Mexico","Lea County",1,39,1007,546,461
050,35,025,"New Mexico","Lea County",1,40,1012,539,473
050,35,025,"New Mexico","Lea County",1,41,898,461,437
050,35,025,"New Mexico","Lea County",1,42,883,458,425
050,35,025,"New Mexico","Lea County",1,43,894,467,427
050,35,025,"New Mexico","Lea County",1,44,924,507,417
050,35,025,"New Mexico","Lea County",1,45,822,425,397
050,35,025,"New Mexico","Lea County",1,46,798,402,396
050,35,025,"New Mexico","Lea County",1,47,851,427,424
050,35,025,"New Mexico","Lea County",1,48,799,391,408
050,35,025,"New Mexico","Lea County",1,49,800,412,388
050,35,025,"New Mexico","Lea County",1,50,786,385,401
050,35,025,"New Mexico","Lea County",1,51,789,416,373
050,35,025,"New Mexico","Lea County",1,52,784,429,355
050,35,025,"New Mexico","Lea County",1,53,771,417,354
050,35,025,"New Mexico","Lea County",1,54,794,426,368
050,35,025,"New Mexico","Lea County",1,55,794,393,401
050,35,025,"New Mexico","Lea County",1,56,802,433,369
050,35,025,"New Mexico","Lea County",1,57,831,457,374
050,35,025,"New Mexico","Lea County",1,58,824,456,368
050,35,025,"New Mexico","Lea County",1,59,805,415,390
050,35,025,"New Mexico","Lea County",1,60,832,413,419
050,35,025,"New Mexico","Lea County",1,61,776,403,373
050,35,025,"New Mexico","Lea County",1,62,750,378,372
050,35,025,"New Mexico","Lea County",1,63,741,375,366
050,35,025,"New Mexico","Lea County",1,64,670,351,319
050,35,025,"New Mexico","Lea County",1,65,638,336,302
050,35,025,"New Mexico","Lea County",1,66,620,310,310
050,35,025,"New Mexico","Lea County",1,67,585,287,298
050,35,025,"New Mexico","Lea County",1,68,530,266,264
050,35,025,"New Mexico","Lea County",1,69,484,226,258
050,35,025,"New Mexico","Lea County",1,70,484,228,256
050,35,025,"New Mexico","Lea County",1,71,453,217,236
050,35,025,"New Mexico","Lea County",1,72,438,221,217
050,35,025,"New Mexico","Lea County",1,73,402,196,206
050,35,025,"New Mexico","Lea County",1,74,328,144,184
050,35,025,"New Mexico","Lea County",1,75,325,150,175
050,35,025,"New Mexico","Lea County",1,76,300,125,175
050,35,025,"New Mexico","Lea County",1,77,263,125,138
050,35,025,"New Mexico","Lea County",1,78,242,108,134
050,35,025,"New Mexico","Lea County",1,79,223,85,138
050,35,025,"New Mexico","Lea County",1,80,214,84,130
050,35,025,"New Mexico","Lea County",1,81,183,81,102
050,35,025,"New Mexico","Lea County",1,82,211,107,104
050,35,025,"New Mexico","Lea County",1,83,187,94,93
050,35,025,"New Mexico","Lea County",1,84,157,66,91
050,35,025,"New Mexico","Lea County",1,85,864,340,524
050,35,025,"New Mexico","Lea County",2,0,1155,596,559
050,35,025,"New Mexico","Lea County",2,1,1175,589,586
050,35,025,"New Mexico","Lea County",2,2,1152,569,583
050,35,025,"New Mexico","Lea County",2,3,1161,592,569
050,35,025,"New Mexico","Lea County",2,4,1220,633,587
050,35,025,"New Mexico","Lea County",2,5,1235,638,597
050,35,025,"New Mexico","Lea County",2,6,1217,641,576
050,35,025,"New Mexico","Lea County",2,7,1240,649,591
050,35,025,"New Mexico","Lea County",2,8,1234,632,602
050,35,025,"New Mexico","Lea County",2,9,1246,617,629
050,35,025,"New Mexico","Lea County",2,10,1311,656,655
050,35,025,"New Mexico","Lea County",2,11,1356,695,661
050,35,025,"New Mexico","Lea County",2,12,1432,743,689
050,35,025,"New Mexico","Lea County",2,13,1413,724,689
050,35,025,"New Mexico","Lea County",2,14,1312,651,661
050,35,025,"New Mexico","Lea County",2,15,1269,636,633
050,35,025,"New Mexico","Lea County",2,16,1251,654,597
050,35,025,"New Mexico","Lea County",2,17,1205,620,585
050,35,025,"New Mexico","Lea County",2,18,1128,585,543
050,35,025,"New Mexico","Lea County",2,19,1118,613,505
050,35,025,"New Mexico","Lea County",2,20,1117,617,500
050,35,025,"New Mexico","Lea County",2,21,1032,555,477
050,35,025,"New Mexico","Lea County",2,22,1016,538,478
050,35,025,"New Mexico","Lea County",2,23,1029,537,492
050,35,025,"New Mexico","Lea County",2,24,1026,547,479
050,35,025,"New Mexico","Lea County",2,25,1024,557,467
050,35,025,"New Mexico","Lea County",2,26,1057,569,488
050,35,025,"New Mexico","Lea County",2,27,1075,578,497
050,35,025,"New Mexico","Lea County",2,28,1074,572,502
050,35,025,"New Mexico","Lea County",2,29,1087,579,508
050,35,025,"New Mexico","Lea County",2,30,1071,572,499
050,35,025,"New Mexico","Lea County",2,31,1005,552,453
050,35,025,"New Mexico","Lea County",2,32,1019,540,479
050,35,025,"New Mexico","Lea County",2,33,1090,574,516
050,35,025,"New Mexico","Lea County",2,34,1087,571,516
050,35,025,"New Mexico","Lea County",2,35,1091,577,514
050,35,025,"New Mexico","Lea County",2,36,1083,571,512
050,35,025,"New Mexico","Lea County",2,37,1119,604,515
050,35,025,"New Mexico","Lea County",2,38,1059,570,489
050,35,025,"New Mexico","Lea County",2,39,1007,547,460
050,35,025,"New Mexico","Lea County",2,40,1022,549,473
050,35,025,"New Mexico","Lea County",2,41,921,475,446
050,35,025,"New Mexico","Lea County",2,42,878,451,427
050,35,025,"New Mexico","Lea County",2,43,899,469,430
050,35,025,"New Mexico","Lea County",2,44,918,500,418
050,35,025,"New Mexico","Lea County",2,45,852,444,408
050,35,025,"New Mexico","Lea County",2,46,807,408,399
050,35,025,"New Mexico","Lea County",2,47,836,419,417
050,35,025,"New Mexico","Lea County",2,48,807,394,413
050,35,025,"New Mexico","Lea County",2,49,804,408,396
050,35,025,"New Mexico","Lea County",2,50,788,392,396
050,35,025,"New Mexico","Lea County",2,51,785,408,377
050,35,025,"New Mexico","Lea County",2,52,782,425,357
050,35,025,"New Mexico","Lea County",2,53,775,419,356
050,35,025,"New Mexico","Lea County",2,54,790,426,364
050,35,025,"New Mexico","Lea County",2,55,798,404,394
050,35,025,"New Mexico","Lea County",2,56,803,425,378
050,35,025,"New Mexico","Lea County",2,57,815,445,370
050,35,025,"New Mexico","Lea County",2,58,818,451,367
050,35,025,"New Mexico","Lea County",2,59,808,428,380
050,35,025,"New Mexico","Lea County",2,60,824,414,410
050,35,025,"New Mexico","Lea County",2,61,779,401,378
050,35,025,"New Mexico","Lea County",2,62,744,377,367
050,35,025,"New Mexico","Lea County",2,63,741,375,366
050,35,025,"New Mexico","Lea County",2,64,681,353,328
050,35,025,"New Mexico","Lea County",2,65,640,338,302
050,35,025,"New Mexico","Lea County",2,66,620,313,307
050,35,025,"New Mexico","Lea County",2,67,585,289,296
050,35,025,"New Mexico","Lea County",2,68,537,268,269
050,35,025,"New Mexico","Lea County",2,69,498,237,261
050,35,025,"New Mexico","Lea County",2,70,476,221,255
050,35,025,"New Mexico","Lea County",2,71,457,218,239
050,35,025,"New Mexico","Lea County",2,72,435,217,218
050,35,025,"New Mexico","Lea County",2,73,421,208,213
050,35,025,"New Mexico","Lea County",2,74,326,147,179
050,35,025,"New Mexico","Lea County",2,75,322,148,174
050,35,025,"New Mexico","Lea County",2,76,300,127,173
050,35,025,"New Mexico","Lea County",2,77,277,126,151
050,35,025,"New Mexico","Lea County",2,78,237,107,130
050,35,025,"New Mexico","Lea County",2,79,221,89,132
050,35,025,"New Mexico","Lea County",2,80,212,82,130
050,35,025,"New Mexico","Lea County",2,81,188,82,106
050,35,025,"New Mexico","Lea County",2,82,200,98,102
050,35,025,"New Mexico","Lea County",2,83,190,95,95
050,35,025,"New Mexico","Lea County",2,84,159,70,89
050,35,025,"New Mexico","Lea County",2,85,868,339,529
050,35,025,"New Mexico","Lea County",3,0,1071,571,500
050,35,025,"New Mexico","Lea County",3,1,1127,616,511
050,35,025,"New Mexico","Lea County",3,2,1116,563,553
050,35,025,"New Mexico","Lea County",3,3,1116,554,562
050,35,025,"New Mexico","Lea County",3,4,1135,584,551
050,35,025,"New Mexico","Lea County",3,5,1202,622,580
050,35,025,"New Mexico","Lea County",3,6,1187,608,579
050,35,025,"New Mexico","Lea County",3,7,1207,630,577
050,35,025,"New Mexico","Lea County",3,8,1201,614,587
050,35,025,"New Mexico","Lea County",3,9,1196,615,581
050,35,025,"New Mexico","Lea County",3,10,1201,609,592
050,35,025,"New Mexico","Lea County",3,11,1280,632,648
050,35,025,"New Mexico","Lea County",3,12,1294,668,626
050,35,025,"New Mexico","Lea County",3,13,1385,704,681
050,35,025,"New Mexico","Lea County",3,14,1345,672,673
050,35,025,"New Mexico","Lea County",3,15,1279,642,637
050,35,025,"New Mexico","Lea County",3,16,1249,631,618
050,35,025,"New Mexico","Lea County",3,17,1227,646,581
050,35,025,"New Mexico","Lea County",3,18,1170,599,571
050,35,025,"New Mexico","Lea County",3,19,1075,564,511
050,35,025,"New Mexico","Lea County",3,20,1115,619,496
050,35,025,"New Mexico","Lea County",3,21,1038,577,461
050,35,025,"New Mexico","Lea County",3,22,997,543,454
050,35,025,"New Mexico","Lea County",3,23,1000,525,475
050,35,025,"New Mexico","Lea County",3,24,976,507,469
050,35,025,"New Mexico","Lea County",3,25,983,517,466
050,35,025,"New Mexico","Lea County",3,26,1017,558,459
050,35,025,"New Mexico","Lea County",3,27,1051,561,490
050,35,025,"New Mexico","Lea County",3,28,1052,566,486
050,35,025,"New Mexico","Lea County",3,29,1034,553,481
050,35,025,"New Mexico","Lea County",3,30,1052,547,505
050,35,025,"New Mexico","Lea County",3,31,1048,577,471
050,35,025,"New Mexico","Lea County",3,32,952,516,436
050,35,025,"New Mexico","Lea County",3,33,1013,546,467
050,35,025,"New Mexico","Lea County",3,34,1025,529,496
050,35,025,"New Mexico","Lea County",3,35,1070,571,499
050,35,025,"New Mexico","Lea County",3,36,1035,545,490
050,35,025,"New Mexico","Lea County",3,37,1051,565,486
050,35,025,"New Mexico","Lea County",3,38,1081,575,506
050,35,025,"New Mexico","Lea County",3,39,1034,561,473
050,35,025,"New Mexico","Lea County",3,40,1009,557,452
050,35,025,"New Mexico","Lea County",3,41,985,526,459
050,35,025,"New Mexico","Lea County",3,42,892,460,432
050,35,025,"New Mexico","Lea County",3,43,854,438,416
050,35,025,"New Mexico","Lea County",3,44,887,473,414
050,35,025,"New Mexico","Lea County",3,45,871,469,402
050,35,025,"New Mexico","Lea County",3,46,831,439,392
050,35,025,"New Mexico","Lea County",3,47,796,402,394
050,35,025,"New Mexico","Lea County",3,48,797,389,408
050,35,025,"New Mexico","Lea County",3,49,789,385,404
050,35,025,"New Mexico","Lea County",3,50,772,395,377
050,35,025,"New Mexico","Lea County",3,51,771,383,388
050,35,025,"New Mexico","Lea County",3,52,730,374,356
050,35,025,"New Mexico","Lea County",3,53,765,418,347
050,35,025,"New Mexico","Lea County",3,54,759,414,345
050,35,025,"New Mexico","Lea County",3,55,778,414,364
050,35,025,"New Mexico","Lea County",3,56,764,378,386
050,35,025,"New Mexico","Lea County",3,57,771,401,370
050,35,025,"New Mexico","Lea County",3,58,772,418,354
050,35,025,"New Mexico","Lea County",3,59,790,436,354
050,35,025,"New Mexico","Lea County",3,60,770,418,352
050,35,025,"New Mexico","Lea County",3,61,810,406,404
050,35,025,"New Mexico","Lea County",3,62,732,371,361
050,35,025,"New Mexico","Lea County",3,63,714,359,355
050,35,025,"New Mexico","Lea County",3,64,705,347,358
050,35,025,"New Mexico","Lea County",3,65,642,330,312
050,35,025,"New Mexico","Lea County",3,66,610,323,287
050,35,025,"New Mexico","Lea County",3,67,610,304,306
050,35,025,"New Mexico","Lea County",3,68,554,274,280
050,35,025,"New Mexico","Lea County",3,69,519,259,260
050,35,025,"New Mexico","Lea County",3,70,480,230,250
050,35,025,"New Mexico","Lea County",3,71,457,214,243
050,35,025,"New Mexico","Lea County",3,72,439,209,230
050,35,025,"New Mexico","Lea County",3,73,427,210,217
050,35,025,"New Mexico","Lea County",3,74,397,194,203
050,35,025,"New Mexico","Lea County",3,75,309,140,169
050,35,025,"New Mexico","Lea County",3,76,298,131,167
050,35,025,"New Mexico","Lea County",3,77,286,120,166
050,35,025,"New Mexico","Lea County",3,78,263,120,143
050,35,025,"New Mexico","Lea County",3,79,215,92,123
050,35,025,"New Mexico","Lea County",3,80,195,81,114
050,35,025,"New Mexico","Lea County",3,81,192,70,122
050,35,025,"New Mexico","Lea County",3,82,168,74,94
050,35,025,"New Mexico","Lea County",3,83,182,89,93
050,35,025,"New Mexico","Lea County",3,84,174,83,91
050,35,025,"New Mexico","Lea County",3,85,844,335,509
050,35,025,"New Mexico","Lea County",4,0,925,473,452
050,35,025,"New Mexico","Lea County",4,1,1045,558,487
050,35,025,"New Mexico","Lea County",4,2,1112,596,516
050,35,025,"New Mexico","Lea County",4,3,1119,583,536
050,35,025,"New Mexico","Lea County",4,4,1125,566,559
050,35,025,"New Mexico","Lea County",4,5,1134,588,546
050,35,025,"New Mexico","Lea County",4,6,1169,600,569
050,35,025,"New Mexico","Lea County",4,7,1167,592,575
050,35,025,"New Mexico","Lea County",4,8,1167,608,559
050,35,025,"New Mexico","Lea County",4,9,1175,593,582
050,35,025,"New Mexico","Lea County",4,10,1177,607,570
050,35,025,"New Mexico","Lea County",4,11,1187,605,582
050,35,025,"New Mexico","Lea County",4,12,1265,633,632
050,35,025,"New Mexico","Lea County",4,13,1285,650,635
050,35,025,"New Mexico","Lea County",4,14,1361,700,661
050,35,025,"New Mexico","Lea County",4,15,1348,681,667
050,35,025,"New Mexico","Lea County",4,16,1262,642,620
050,35,025,"New Mexico","Lea County",4,17,1232,633,599
050,35,025,"New Mexico","Lea County",4,18,1218,637,581
050,35,025,"New Mexico","Lea County",4,19,1143,602,541
050,35,025,"New Mexico","Lea County",4,20,1081,584,497
050,35,025,"New Mexico","Lea County",4,21,1053,589,464
050,35,025,"New Mexico","Lea County",4,22,1011,567,444
050,35,025,"New Mexico","Lea County",4,23,1008,533,475
050,35,025,"New Mexico","Lea County",4,24,975,517,458
050,35,025,"New Mexico","Lea County",4,25,926,486,440
050,35,025,"New Mexico","Lea County",4,26,966,518,448
050,35,025,"New Mexico","Lea County",4,27,990,551,439
050,35,025,"New Mexico","Lea County",4,28,1042,562,480
050,35,025,"New Mexico","Lea County",4,29,1026,543,483
050,35,025,"New Mexico","Lea County",4,30,1020,540,480
050,35,025,"New Mexico","Lea County",4,31,1040,551,489
050,35,025,"New Mexico","Lea County",4,32,1046,561,485
050,35,025,"New Mexico","Lea County",4,33,965,550,415
050,35,025,"New Mexico","Lea County",4,34,980,523,457
050,35,025,"New Mexico","Lea County",4,35,1001,524,477
050,35,025,"New Mexico","Lea County",4,36,1044,548,496
050,35,025,"New Mexico","Lea County",4,37,1059,589,470
050,35,025,"New Mexico","Lea County",4,38,1008,534,474
050,35,025,"New Mexico","Lea County",4,39,1055,552,503
050,35,025,"New Mexico","Lea County",4,40,1029,564,465
050,35,025,"New Mexico","Lea County",4,41,983,532,451
050,35,025,"New Mexico","Lea County",4,42,992,540,452
050,35,025,"New Mexico","Lea County",4,43,885,453,432
050,35,025,"New Mexico","Lea County",4,44,838,429,409
050,35,025,"New Mexico","Lea County",4,45,887,471,416
050,35,025,"New Mexico","Lea County",4,46,866,471,395
050,35,025,"New Mexico","Lea County",4,47,819,427,392
050,35,025,"New Mexico","Lea County",4,48,777,380,397
050,35,025,"New Mexico","Lea County",4,49,772,380,392
050,35,025,"New Mexico","Lea County",4,50,786,384,402
050,35,025,"New Mexico","Lea County",4,51,763,391,372
050,35,025,"New Mexico","Lea County",4,52,763,392,371
050,35,025,"New Mexico","Lea County",4,53,716,368,348
050,35,025,"New Mexico","Lea County",4,54,737,401,336
050,35,025,"New Mexico","Lea County",4,55,728,391,337
050,35,025,"New Mexico","Lea County",4,56,746,395,351
050,35,025,"New Mexico","Lea County",4,57,728,355,373
050,35,025,"New Mexico","Lea County",4,58,732,378,354
050,35,025,"New Mexico","Lea County",4,59,772,421,351
050,35,025,"New Mexico","Lea County",4,60,759,421,338
050,35,025,"New Mexico","Lea County",4,61,738,397,341
050,35,025,"New Mexico","Lea County",4,62,763,373,390
050,35,025,"New Mexico","Lea County",4,63,711,364,347
050,35,025,"New Mexico","Lea County",4,64,695,335,360
050,35,025,"New Mexico","Lea County",4,65,677,332,345
050,35,025,"New Mexico","Lea County",4,66,622,318,304
050,35,025,"New Mexico","Lea County",4,67,585,312,273
050,35,025,"New Mexico","Lea County",4,68,590,292,298
050,35,025,"New Mexico","Lea County",4,69,538,267,271
050,35,025,"New Mexico","Lea County",4,70,500,247,253
050,35,025,"New Mexico","Lea County",4,71,466,221,245
050,35,025,"New Mexico","Lea County",4,72,443,209,234
050,35,025,"New Mexico","Lea County",4,73,428,203,225
050,35,025,"New Mexico","Lea County",4,74,410,201,209
050,35,025,"New Mexico","Lea County",4,75,376,184,192
050,35,025,"New Mexico","Lea County",4,76,289,128,161
050,35,025,"New Mexico","Lea County",4,77,292,126,166
050,35,025,"New Mexico","Lea County",4,78,268,114,154
050,35,025,"New Mexico","Lea County",4,79,237,106,131
050,35,025,"New Mexico","Lea County",4,80,194,85,109
050,35,025,"New Mexico","Lea County",4,81,177,72,105
050,35,025,"New Mexico","Lea County",4,82,178,68,110
050,35,025,"New Mexico","Lea County",4,83,157,65,92
050,35,025,"New Mexico","Lea County",4,84,167,78,89
050,35,025,"New Mexico","Lea County",4,85,852,353,499
050,35,025,"New Mexico","Lea County",5,0,805,420,385
050,35,025,"New Mexico","Lea County",5,1,942,489,453
050,35,025,"New Mexico","Lea County",5,2,1048,570,478
050,35,025,"New Mexico","Lea County",5,3,1113,595,518
050,35,025,"New Mexico","Lea County",5,4,1129,588,541
050,35,025,"New Mexico","Lea County",5,5,1099,554,545
050,35,025,"New Mexico","Lea County",5,6,1115,573,542
050,35,025,"New Mexico","Lea County",5,7,1168,600,568
050,35,025,"New Mexico","Lea County",5,8,1161,590,571
050,35,025,"New Mexico","Lea County",5,9,1157,601,556
050,35,025,"New Mexico","Lea County",5,10,1160,592,568
050,35,025,"New Mexico","Lea County",5,11,1173,604,569
050,35,025,"New Mexico","Lea County",5,12,1159,596,563
050,35,025,"New Mexico","Lea County",5,13,1240,616,624
050,35,025,"New Mexico","Lea County",5,14,1289,658,631
050,35,025,"New Mexico","Lea County",5,15,1355,700,655
050,35,025,"New Mexico","Lea County",5,16,1367,697,670
050,35,025,"New Mexico","Lea County",5,17,1258,633,625
050,35,025,"New Mexico","Lea County",5,18,1212,627,585
050,35,025,"New Mexico","Lea County",5,19,1176,626,550
050,35,025,"New Mexico","Lea County",5,20,1179,628,551
050,35,025,"New Mexico","Lea County",5,21,1002,543,459
050,35,025,"New Mexico","Lea County",5,22,1040,585,455
050,35,025,"New Mexico","Lea County",5,23,1036,577,459
050,35,025,"New Mexico","Lea County",5,24,1014,525,489
050,35,025,"New Mexico","Lea County",5,25,973,520,453
050,35,025,"New Mexico","Lea County",5,26,943,504,439
050,35,025,"New Mexico","Lea County",5,27,966,509,457
050,35,025,"New Mexico","Lea County",5,28,999,551,448
050,35,025,"New Mexico","Lea County",5,29,1031,568,463
050,35,025,"New Mexico","Lea County",5,30,1036,542,494
050,35,025,"New Mexico","Lea County",5,31,1024,553,471
050,35,025,"New Mexico","Lea County",5,32,1009,530,479
050,35,025,"New Mexico","Lea County",5,33,1049,581,468
050,35,025,"New Mexico","Lea County",5,34,938,528,410
050,35,025,"New Mexico","Lea County",5,35,960,504,456
050,35,025,"New Mexico","Lea County",5,36,995,520,475
050,35,025,"New Mexico","Lea County",5,37,1061,578,483
050,35,025,"New Mexico","Lea County",5,38,1044,574,470
050,35,025,"New Mexico","Lea County",5,39,1012,543,469
050,35,025,"New Mexico","Lea County",5,40,1069,554,515
050,35,025,"New Mexico","Lea County",5,41,1034,561,473
050,35,025,"New Mexico","Lea County",5,42,964,523,441
050,35,025,"New Mexico","Lea County",5,43,975,520,455
050,35,025,"New Mexico","Lea County",5,44,888,459,429
050,35,025,"New Mexico","Lea County",5,45,853,433,420
050,35,025,"New Mexico","Lea County",5,46,865,464,401
050,35,025,"New Mexico","Lea County",5,47,868,471,397
050,35,025,"New Mexico","Lea County",5,48,802,409,393
050,35,025,"New Mexico","Lea County",5,49,755,371,384
050,35,025,"New Mexico","Lea County",5,50,769,381,388
050,35,025,"New Mexico","Lea County",5,51,770,376,394
050,35,025,"New Mexico","Lea County",5,52,756,395,361
050,35,025,"New Mexico","Lea County",5,53,748,391,357
050,35,025,"New Mexico","Lea County",5,54,702,357,345
050,35,025,"New Mexico","Lea County",5,55,727,400,327
050,35,025,"New Mexico","Lea County",5,56,713,381,332
050,35,025,"New Mexico","Lea County",5,57,727,390,337
050,35,025,"New Mexico","Lea County",5,58,711,338,373
050,35,025,"New Mexico","Lea County",5,59,713,373,340
050,35,025,"New Mexico","Lea County",5,60,748,406,342
050,35,025,"New Mexico","Lea County",5,61,727,405,322
050,35,025,"New Mexico","Lea County",5,62,719,386,333
050,35,025,"New Mexico","Lea County",5,63,750,365,385
050,35,025,"New Mexico","Lea County",5,64,692,348,344
050,35,025,"New Mexico","Lea County",5,65,685,331,354
050,35,025,"New Mexico","Lea County",5,66,640,308,332
050,35,025,"New Mexico","Lea County",5,67,595,306,289
050,35,025,"New Mexico","Lea County",5,68,559,295,264
050,35,025,"New Mexico","Lea County",5,69,557,279,278
050,35,025,"New Mexico","Lea County",5,70,513,258,255
050,35,025,"New Mexico","Lea County",5,71,485,244,241
050,35,025,"New Mexico","Lea County",5,72,457,221,236
050,35,025,"New Mexico","Lea County",5,73,433,204,229
050,35,025,"New Mexico","Lea County",5,74,411,191,220
050,35,025,"New Mexico","Lea County",5,75,389,187,202
050,35,025,"New Mexico","Lea County",5,76,355,173,182
050,35,025,"New Mexico","Lea County",5,77,281,122,159
050,35,025,"New Mexico","Lea County",5,78,274,119,155
050,35,025,"New Mexico","Lea County",5,79,241,102,139
050,35,025,"New Mexico","Lea County",5,80,221,99,122
050,35,025,"New Mexico","Lea County",5,81,173,76,97
050,35,025,"New Mexico","Lea County",5,82,164,66,98
050,35,025,"New Mexico","Lea County",5,83,166,58,108
050,35,025,"New Mexico","Lea County",5,84,144,56,88
050,35,025,"New Mexico","Lea County",5,85,876,377,499
050,35,027,"New Mexico","Lincoln County",1,0,169,85,84
050,35,027,"New Mexico","Lincoln County",1,1,191,105,86
050,35,027,"New Mexico","Lincoln County",1,2,169,96,73
050,35,027,"New Mexico","Lincoln County",1,3,181,97,84
050,35,027,"New Mexico","Lincoln County",1,4,202,95,107
050,35,027,"New Mexico","Lincoln County",1,5,213,98,115
050,35,027,"New Mexico","Lincoln County",1,6,188,94,94
050,35,027,"New Mexico","Lincoln County",1,7,186,93,93
050,35,027,"New Mexico","Lincoln County",1,8,204,113,91
050,35,027,"New Mexico","Lincoln County",1,9,210,113,97
050,35,027,"New Mexico","Lincoln County",1,10,214,119,95
050,35,027,"New Mexico","Lincoln County",1,11,226,130,96
050,35,027,"New Mexico","Lincoln County",1,12,214,113,101
050,35,027,"New Mexico","Lincoln County",1,13,215,108,107
050,35,027,"New Mexico","Lincoln County",1,14,219,115,104
050,35,027,"New Mexico","Lincoln County",1,15,233,125,108
050,35,027,"New Mexico","Lincoln County",1,16,240,130,110
050,35,027,"New Mexico","Lincoln County",1,17,217,110,107
050,35,027,"New Mexico","Lincoln County",1,18,189,100,89
050,35,027,"New Mexico","Lincoln County",1,19,190,98,92
050,35,027,"New Mexico","Lincoln County",1,20,150,74,76
050,35,027,"New Mexico","Lincoln County",1,21,162,89,73
050,35,027,"New Mexico","Lincoln County",1,22,169,87,82
050,35,027,"New Mexico","Lincoln County",1,23,158,83,75
050,35,027,"New Mexico","Lincoln County",1,24,151,81,70
050,35,027,"New Mexico","Lincoln County",1,25,165,83,82
050,35,027,"New Mexico","Lincoln County",1,26,172,86,86
050,35,027,"New Mexico","Lincoln County",1,27,174,100,74
050,35,027,"New Mexico","Lincoln County",1,28,169,85,84
050,35,027,"New Mexico","Lincoln County",1,29,182,85,97
050,35,027,"New Mexico","Lincoln County",1,30,170,89,81
050,35,027,"New Mexico","Lincoln County",1,31,169,83,86
050,35,027,"New Mexico","Lincoln County",1,32,201,97,104
050,35,027,"New Mexico","Lincoln County",1,33,205,95,110
050,35,027,"New Mexico","Lincoln County",1,34,198,82,116
050,35,027,"New Mexico","Lincoln County",1,35,217,94,123
050,35,027,"New Mexico","Lincoln County",1,36,197,90,107
050,35,027,"New Mexico","Lincoln County",1,37,232,103,129
050,35,027,"New Mexico","Lincoln County",1,38,234,110,124
050,35,027,"New Mexico","Lincoln County",1,39,218,107,111
050,35,027,"New Mexico","Lincoln County",1,40,204,95,109
050,35,027,"New Mexico","Lincoln County",1,41,176,79,97
050,35,027,"New Mexico","Lincoln County",1,42,188,95,93
050,35,027,"New Mexico","Lincoln County",1,43,187,90,97
050,35,027,"New Mexico","Lincoln County",1,44,157,72,85
050,35,027,"New Mexico","Lincoln County",1,45,191,88,103
050,35,027,"New Mexico","Lincoln County",1,46,173,96,77
050,35,027,"New Mexico","Lincoln County",1,47,184,99,85
050,35,027,"New Mexico","Lincoln County",1,48,201,93,108
050,35,027,"New Mexico","Lincoln County",1,49,224,112,112
050,35,027,"New Mexico","Lincoln County",1,50,199,102,97
050,35,027,"New Mexico","Lincoln County",1,51,204,103,101
050,35,027,"New Mexico","Lincoln County",1,52,199,106,93
050,35,027,"New Mexico","Lincoln County",1,53,238,116,122
050,35,027,"New Mexico","Lincoln County",1,54,242,110,132
050,35,027,"New Mexico","Lincoln County",1,55,295,152,143
050,35,027,"New Mexico","Lincoln County",1,56,304,150,154
050,35,027,"New Mexico","Lincoln County",1,57,305,138,167
050,35,027,"New Mexico","Lincoln County",1,58,350,158,192
050,35,027,"New Mexico","Lincoln County",1,59,360,160,200
050,35,027,"New Mexico","Lincoln County",1,60,332,156,176
050,35,027,"New Mexico","Lincoln County",1,61,347,153,194
050,35,027,"New Mexico","Lincoln County",1,62,372,168,204
050,35,027,"New Mexico","Lincoln County",1,63,383,176,207
050,35,027,"New Mexico","Lincoln County",1,64,417,201,216
050,35,027,"New Mexico","Lincoln County",1,65,388,177,211
050,35,027,"New Mexico","Lincoln County",1,66,396,190,206
050,35,027,"New Mexico","Lincoln County",1,67,400,190,210
050,35,027,"New Mexico","Lincoln County",1,68,358,172,186
050,35,027,"New Mexico","Lincoln County",1,69,343,168,175
050,35,027,"New Mexico","Lincoln County",1,70,344,158,186
050,35,027,"New Mexico","Lincoln County",1,71,373,172,201
050,35,027,"New Mexico","Lincoln County",1,72,416,206,210
050,35,027,"New Mexico","Lincoln County",1,73,377,193,184
050,35,027,"New Mexico","Lincoln County",1,74,262,131,131
050,35,027,"New Mexico","Lincoln County",1,75,257,121,136
050,35,027,"New Mexico","Lincoln County",1,76,279,141,138
050,35,027,"New Mexico","Lincoln County",1,77,242,121,121
050,35,027,"New Mexico","Lincoln County",1,78,210,110,100
050,35,027,"New Mexico","Lincoln County",1,79,198,90,108
050,35,027,"New Mexico","Lincoln County",1,80,175,80,95
050,35,027,"New Mexico","Lincoln County",1,81,143,69,74
050,35,027,"New Mexico","Lincoln County",1,82,148,76,72
050,35,027,"New Mexico","Lincoln County",1,83,127,66,61
050,35,027,"New Mexico","Lincoln County",1,84,115,51,64
050,35,027,"New Mexico","Lincoln County",1,85,520,239,281
050,35,027,"New Mexico","Lincoln County",2,0,174,87,87
050,35,027,"New Mexico","Lincoln County",2,1,184,99,85
050,35,027,"New Mexico","Lincoln County",2,2,176,98,78
050,35,027,"New Mexico","Lincoln County",2,3,178,96,82
050,35,027,"New Mexico","Lincoln County",2,4,200,96,104
050,35,027,"New Mexico","Lincoln County",2,5,212,99,113
050,35,027,"New Mexico","Lincoln County",2,6,193,95,98
050,35,027,"New Mexico","Lincoln County",2,7,186,94,92
050,35,027,"New Mexico","Lincoln County",2,8,197,108,89
050,35,027,"New Mexico","Lincoln County",2,9,207,111,96
050,35,027,"New Mexico","Lincoln County",2,10,213,117,96
050,35,027,"New Mexico","Lincoln County",2,11,220,125,95
050,35,027,"New Mexico","Lincoln County",2,12,219,118,101
050,35,027,"New Mexico","Lincoln County",2,13,215,109,106
050,35,027,"New Mexico","Lincoln County",2,14,218,113,105
050,35,027,"New Mexico","Lincoln County",2,15,232,125,107
050,35,027,"New Mexico","Lincoln County",2,16,241,131,110
050,35,027,"New Mexico","Lincoln County",2,17,222,115,107
050,35,027,"New Mexico","Lincoln County",2,18,188,100,88
050,35,027,"New Mexico","Lincoln County",2,19,182,95,87
050,35,027,"New Mexico","Lincoln County",2,20,163,81,82
050,35,027,"New Mexico","Lincoln County",2,21,158,85,73
050,35,027,"New Mexico","Lincoln County",2,22,168,87,81
050,35,027,"New Mexico","Lincoln County",2,23,161,84,77
050,35,027,"New Mexico","Lincoln County",2,24,156,83,73
050,35,027,"New Mexico","Lincoln County",2,25,165,85,80
050,35,027,"New Mexico","Lincoln County",2,26,168,84,84
050,35,027,"New Mexico","Lincoln County",2,27,173,97,76
050,35,027,"New Mexico","Lincoln County",2,28,171,88,83
050,35,027,"New Mexico","Lincoln County",2,29,180,87,93
050,35,027,"New Mexico","Lincoln County",2,30,175,89,86
050,35,027,"New Mexico","Lincoln County",2,31,167,84,83
050,35,027,"New Mexico","Lincoln County",2,32,198,95,103
050,35,027,"New Mexico","Lincoln County",2,33,204,94,110
050,35,027,"New Mexico","Lincoln County",2,34,200,85,115
050,35,027,"New Mexico","Lincoln County",2,35,212,90,122
050,35,027,"New Mexico","Lincoln County",2,36,202,89,113
050,35,027,"New Mexico","Lincoln County",2,37,221,96,125
050,35,027,"New Mexico","Lincoln County",2,38,236,110,126
050,35,027,"New Mexico","Lincoln County",2,39,222,109,113
050,35,027,"New Mexico","Lincoln County",2,40,209,100,109
050,35,027,"New Mexico","Lincoln County",2,41,186,86,100
050,35,027,"New Mexico","Lincoln County",2,42,184,92,92
050,35,027,"New Mexico","Lincoln County",2,43,190,92,98
050,35,027,"New Mexico","Lincoln County",2,44,165,77,88
050,35,027,"New Mexico","Lincoln County",2,45,182,84,98
050,35,027,"New Mexico","Lincoln County",2,46,174,92,82
050,35,027,"New Mexico","Lincoln County",2,47,179,96,83
050,35,027,"New Mexico","Lincoln County",2,48,195,94,101
050,35,027,"New Mexico","Lincoln County",2,49,219,108,111
050,35,027,"New Mexico","Lincoln County",2,50,204,103,101
050,35,027,"New Mexico","Lincoln County",2,51,201,102,99
050,35,027,"New Mexico","Lincoln County",2,52,205,108,97
050,35,027,"New Mexico","Lincoln County",2,53,230,116,114
050,35,027,"New Mexico","Lincoln County",2,54,244,114,130
050,35,027,"New Mexico","Lincoln County",2,55,286,143,143
050,35,027,"New Mexico","Lincoln County",2,56,303,151,152
050,35,027,"New Mexico","Lincoln County",2,57,307,142,165
050,35,027,"New Mexico","Lincoln County",2,58,342,154,188
050,35,027,"New Mexico","Lincoln County",2,59,358,160,198
050,35,027,"New Mexico","Lincoln County",2,60,340,156,184
050,35,027,"New Mexico","Lincoln County",2,61,345,154,191
050,35,027,"New Mexico","Lincoln County",2,62,368,164,204
050,35,027,"New Mexico","Lincoln County",2,63,389,179,210
050,35,027,"New Mexico","Lincoln County",2,64,411,197,214
050,35,027,"New Mexico","Lincoln County",2,65,400,185,215
050,35,027,"New Mexico","Lincoln County",2,66,401,190,211
050,35,027,"New Mexico","Lincoln County",2,67,398,191,207
050,35,027,"New Mexico","Lincoln County",2,68,365,175,190
050,35,027,"New Mexico","Lincoln County",2,69,350,171,179
050,35,027,"New Mexico","Lincoln County",2,70,342,160,182
050,35,027,"New Mexico","Lincoln County",2,71,366,169,197
050,35,027,"New Mexico","Lincoln County",2,72,402,197,205
050,35,027,"New Mexico","Lincoln County",2,73,405,206,199
050,35,027,"New Mexico","Lincoln County",2,74,271,135,136
050,35,027,"New Mexico","Lincoln County",2,75,256,122,134
050,35,027,"New Mexico","Lincoln County",2,76,268,133,135
050,35,027,"New Mexico","Lincoln County",2,77,252,126,126
050,35,027,"New Mexico","Lincoln County",2,78,210,109,101
050,35,027,"New Mexico","Lincoln County",2,79,199,94,105
050,35,027,"New Mexico","Lincoln County",2,80,180,82,98
050,35,027,"New Mexico","Lincoln County",2,81,151,71,80
050,35,027,"New Mexico","Lincoln County",2,82,146,74,72
050,35,027,"New Mexico","Lincoln County",2,83,130,67,63
050,35,027,"New Mexico","Lincoln County",2,84,114,52,62
050,35,027,"New Mexico","Lincoln County",2,85,528,244,284
050,35,027,"New Mexico","Lincoln County",3,0,163,85,78
050,35,027,"New Mexico","Lincoln County",3,1,173,80,93
050,35,027,"New Mexico","Lincoln County",3,2,200,104,96
050,35,027,"New Mexico","Lincoln County",3,3,183,100,83
050,35,027,"New Mexico","Lincoln County",3,4,187,98,89
050,35,027,"New Mexico","Lincoln County",3,5,185,91,94
050,35,027,"New Mexico","Lincoln County",3,6,218,101,117
050,35,027,"New Mexico","Lincoln County",3,7,197,93,104
050,35,027,"New Mexico","Lincoln County",3,8,192,92,100
050,35,027,"New Mexico","Lincoln County",3,9,195,103,92
050,35,027,"New Mexico","Lincoln County",3,10,215,114,101
050,35,027,"New Mexico","Lincoln County",3,11,223,125,98
050,35,027,"New Mexico","Lincoln County",3,12,232,126,106
050,35,027,"New Mexico","Lincoln County",3,13,217,118,99
050,35,027,"New Mexico","Lincoln County",3,14,214,109,105
050,35,027,"New Mexico","Lincoln County",3,15,221,120,101
050,35,027,"New Mexico","Lincoln County",3,16,231,122,109
050,35,027,"New Mexico","Lincoln County",3,17,235,127,108
050,35,027,"New Mexico","Lincoln County",3,18,203,108,95
050,35,027,"New Mexico","Lincoln County",3,19,168,85,83
050,35,027,"New Mexico","Lincoln County",3,20,167,80,87
050,35,027,"New Mexico","Lincoln County",3,21,157,78,79
050,35,027,"New Mexico","Lincoln County",3,22,146,83,63
050,35,027,"New Mexico","Lincoln County",3,23,182,93,89
050,35,027,"New Mexico","Lincoln County",3,24,166,90,76
050,35,027,"New Mexico","Lincoln County",3,25,161,84,77
050,35,027,"New Mexico","Lincoln County",3,26,174,93,81
050,35,027,"New Mexico","Lincoln County",3,27,169,91,78
050,35,027,"New Mexico","Lincoln County",3,28,165,95,70
050,35,027,"New Mexico","Lincoln County",3,29,171,87,84
050,35,027,"New Mexico","Lincoln County",3,30,190,92,98
050,35,027,"New Mexico","Lincoln County",3,31,179,93,86
050,35,027,"New Mexico","Lincoln County",3,32,169,84,85
050,35,027,"New Mexico","Lincoln County",3,33,198,94,104
050,35,027,"New Mexico","Lincoln County",3,34,194,90,104
050,35,027,"New Mexico","Lincoln County",3,35,192,84,108
050,35,027,"New Mexico","Lincoln County",3,36,210,82,128
050,35,027,"New Mexico","Lincoln County",3,37,209,94,115
050,35,027,"New Mexico","Lincoln County",3,38,225,102,123
050,35,027,"New Mexico","Lincoln County",3,39,240,116,124
050,35,027,"New Mexico","Lincoln County",3,40,224,107,117
050,35,027,"New Mexico","Lincoln County",3,41,200,92,108
050,35,027,"New Mexico","Lincoln County",3,42,190,87,103
050,35,027,"New Mexico","Lincoln County",3,43,189,95,94
050,35,027,"New Mexico","Lincoln County",3,44,189,89,100
050,35,027,"New Mexico","Lincoln County",3,45,174,84,90
050,35,027,"New Mexico","Lincoln County",3,46,178,84,94
050,35,027,"New Mexico","Lincoln County",3,47,176,92,84
050,35,027,"New Mexico","Lincoln County",3,48,194,108,86
050,35,027,"New Mexico","Lincoln County",3,49,197,98,99
050,35,027,"New Mexico","Lincoln County",3,50,221,109,112
050,35,027,"New Mexico","Lincoln County",3,51,205,102,103
050,35,027,"New Mexico","Lincoln County",3,52,210,103,107
050,35,027,"New Mexico","Lincoln County",3,53,200,103,97
050,35,027,"New Mexico","Lincoln County",3,54,232,117,115
050,35,027,"New Mexico","Lincoln County",3,55,255,124,131
050,35,027,"New Mexico","Lincoln County",3,56,289,142,147
050,35,027,"New Mexico","Lincoln County",3,57,319,153,166
050,35,027,"New Mexico","Lincoln County",3,58,313,149,164
050,35,027,"New Mexico","Lincoln County",3,59,347,158,189
050,35,027,"New Mexico","Lincoln County",3,60,367,165,202
050,35,027,"New Mexico","Lincoln County",3,61,340,157,183
050,35,027,"New Mexico","Lincoln County",3,62,342,151,191
050,35,027,"New Mexico","Lincoln County",3,63,376,175,201
050,35,027,"New Mexico","Lincoln County",3,64,410,183,227
050,35,027,"New Mexico","Lincoln County",3,65,415,195,220
050,35,027,"New Mexico","Lincoln County",3,66,411,190,221
050,35,027,"New Mexico","Lincoln County",3,67,418,198,220
050,35,027,"New Mexico","Lincoln County",3,68,398,193,205
050,35,027,"New Mexico","Lincoln County",3,69,381,184,197
050,35,027,"New Mexico","Lincoln County",3,70,349,175,174
050,35,027,"New Mexico","Lincoln County",3,71,341,167,174
050,35,027,"New Mexico","Lincoln County",3,72,364,169,195
050,35,027,"New Mexico","Lincoln County",3,73,385,196,189
050,35,027,"New Mexico","Lincoln County",3,74,373,195,178
050,35,027,"New Mexico","Lincoln County",3,75,269,131,138
050,35,027,"New Mexico","Lincoln County",3,76,244,118,126
050,35,027,"New Mexico","Lincoln County",3,77,244,122,122
050,35,027,"New Mexico","Lincoln County",3,78,243,122,121
050,35,027,"New Mexico","Lincoln County",3,79,198,105,93
050,35,027,"New Mexico","Lincoln County",3,80,186,89,97
050,35,027,"New Mexico","Lincoln County",3,81,169,78,91
050,35,027,"New Mexico","Lincoln County",3,82,136,65,71
050,35,027,"New Mexico","Lincoln County",3,83,135,71,64
050,35,027,"New Mexico","Lincoln County",3,84,121,64,57
050,35,027,"New Mexico","Lincoln County",3,85,567,253,314
050,35,027,"New Mexico","Lincoln County",4,0,183,93,90
050,35,027,"New Mexico","Lincoln County",4,1,182,90,92
050,35,027,"New Mexico","Lincoln County",4,2,174,77,97
050,35,027,"New Mexico","Lincoln County",4,3,197,103,94
050,35,027,"New Mexico","Lincoln County",4,4,174,95,79
050,35,027,"New Mexico","Lincoln County",4,5,200,103,97
050,35,027,"New Mexico","Lincoln County",4,6,192,94,98
050,35,027,"New Mexico","Lincoln County",4,7,225,107,118
050,35,027,"New Mexico","Lincoln County",4,8,191,85,106
050,35,027,"New Mexico","Lincoln County",4,9,203,93,110
050,35,027,"New Mexico","Lincoln County",4,10,194,102,92
050,35,027,"New Mexico","Lincoln County",4,11,216,116,100
050,35,027,"New Mexico","Lincoln County",4,12,220,119,101
050,35,027,"New Mexico","Lincoln County",4,13,232,127,105
050,35,027,"New Mexico","Lincoln County",4,14,213,116,97
050,35,027,"New Mexico","Lincoln County",4,15,211,111,100
050,35,027,"New Mexico","Lincoln County",4,16,216,110,106
050,35,027,"New Mexico","Lincoln County",4,17,231,125,106
050,35,027,"New Mexico","Lincoln County",4,18,221,118,103
050,35,027,"New Mexico","Lincoln County",4,19,164,85,79
050,35,027,"New Mexico","Lincoln County",4,20,162,84,78
050,35,027,"New Mexico","Lincoln County",4,21,169,85,84
050,35,027,"New Mexico","Lincoln County",4,22,150,78,72
050,35,027,"New Mexico","Lincoln County",4,23,150,86,64
050,35,027,"New Mexico","Lincoln County",4,24,189,95,94
050,35,027,"New Mexico","Lincoln County",4,25,149,83,66
050,35,027,"New Mexico","Lincoln County",4,26,152,81,71
050,35,027,"New Mexico","Lincoln County",4,27,171,90,81
050,35,027,"New Mexico","Lincoln County",4,28,180,93,87
050,35,027,"New Mexico","Lincoln County",4,29,169,95,74
050,35,027,"New Mexico","Lincoln County",4,30,169,84,85
050,35,027,"New Mexico","Lincoln County",4,31,199,103,96
050,35,027,"New Mexico","Lincoln County",4,32,197,106,91
050,35,027,"New Mexico","Lincoln County",4,33,178,91,87
050,35,027,"New Mexico","Lincoln County",4,34,192,96,96
050,35,027,"New Mexico","Lincoln County",4,35,205,100,105
050,35,027,"New Mexico","Lincoln County",4,36,198,86,112
050,35,027,"New Mexico","Lincoln County",4,37,207,77,130
050,35,027,"New Mexico","Lincoln County",4,38,219,101,118
050,35,027,"New Mexico","Lincoln County",4,39,231,101,130
050,35,027,"New Mexico","Lincoln County",4,40,243,115,128
050,35,027,"New Mexico","Lincoln County",4,41,238,120,118
050,35,027,"New Mexico","Lincoln County",4,42,194,89,105
050,35,027,"New Mexico","Lincoln County",4,43,190,85,105
050,35,027,"New Mexico","Lincoln County",4,44,183,94,89
050,35,027,"New Mexico","Lincoln County",4,45,204,92,112
050,35,027,"New Mexico","Lincoln County",4,46,182,86,96
050,35,027,"New Mexico","Lincoln County",4,47,183,85,98
050,35,027,"New Mexico","Lincoln County",4,48,177,87,90
050,35,027,"New Mexico","Lincoln County",4,49,197,107,90
050,35,027,"New Mexico","Lincoln County",4,50,195,99,96
050,35,027,"New Mexico","Lincoln County",4,51,212,101,111
050,35,027,"New Mexico","Lincoln County",4,52,216,109,107
050,35,027,"New Mexico","Lincoln County",4,53,210,99,111
050,35,027,"New Mexico","Lincoln County",4,54,207,109,98
050,35,027,"New Mexico","Lincoln County",4,55,230,112,118
050,35,027,"New Mexico","Lincoln County",4,56,250,121,129
050,35,027,"New Mexico","Lincoln County",4,57,287,137,150
050,35,027,"New Mexico","Lincoln County",4,58,311,153,158
050,35,027,"New Mexico","Lincoln County",4,59,301,143,158
050,35,027,"New Mexico","Lincoln County",4,60,349,161,188
050,35,027,"New Mexico","Lincoln County",4,61,367,165,202
050,35,027,"New Mexico","Lincoln County",4,62,333,158,175
050,35,027,"New Mexico","Lincoln County",4,63,350,161,189
050,35,027,"New Mexico","Lincoln County",4,64,384,186,198
050,35,027,"New Mexico","Lincoln County",4,65,413,187,226
050,35,027,"New Mexico","Lincoln County",4,66,422,208,214
050,35,027,"New Mexico","Lincoln County",4,67,425,197,228
050,35,027,"New Mexico","Lincoln County",4,68,416,199,217
050,35,027,"New Mexico","Lincoln County",4,69,381,189,192
050,35,027,"New Mexico","Lincoln County",4,70,378,176,202
050,35,027,"New Mexico","Lincoln County",4,71,356,180,176
050,35,027,"New Mexico","Lincoln County",4,72,331,165,166
050,35,027,"New Mexico","Lincoln County",4,73,351,163,188
050,35,027,"New Mexico","Lincoln County",4,74,370,187,183
050,35,027,"New Mexico","Lincoln County",4,75,358,189,169
050,35,027,"New Mexico","Lincoln County",4,76,248,122,126
050,35,027,"New Mexico","Lincoln County",4,77,237,116,121
050,35,027,"New Mexico","Lincoln County",4,78,220,101,119
050,35,027,"New Mexico","Lincoln County",4,79,228,115,113
050,35,027,"New Mexico","Lincoln County",4,80,185,95,90
050,35,027,"New Mexico","Lincoln County",4,81,178,85,93
050,35,027,"New Mexico","Lincoln County",4,82,152,69,83
050,35,027,"New Mexico","Lincoln County",4,83,129,58,71
050,35,027,"New Mexico","Lincoln County",4,84,125,68,57
050,35,027,"New Mexico","Lincoln County",4,85,572,250,322
050,35,027,"New Mexico","Lincoln County",5,0,180,91,89
050,35,027,"New Mexico","Lincoln County",5,1,157,88,69
050,35,027,"New Mexico","Lincoln County",5,2,182,93,89
050,35,027,"New Mexico","Lincoln County",5,3,174,81,93
050,35,027,"New Mexico","Lincoln County",5,4,192,104,88
050,35,027,"New Mexico","Lincoln County",5,5,180,99,81
050,35,027,"New Mexico","Lincoln County",5,6,192,88,104
050,35,027,"New Mexico","Lincoln County",5,7,188,91,97
050,35,027,"New Mexico","Lincoln County",5,8,228,107,121
050,35,027,"New Mexico","Lincoln County",5,9,192,86,106
050,35,027,"New Mexico","Lincoln County",5,10,191,88,103
050,35,027,"New Mexico","Lincoln County",5,11,187,96,91
050,35,027,"New Mexico","Lincoln County",5,12,204,113,91
050,35,027,"New Mexico","Lincoln County",5,13,216,119,97
050,35,027,"New Mexico","Lincoln County",5,14,237,129,108
050,35,027,"New Mexico","Lincoln County",5,15,207,106,101
050,35,027,"New Mexico","Lincoln County",5,16,212,110,102
050,35,027,"New Mexico","Lincoln County",5,17,213,113,100
050,35,027,"New Mexico","Lincoln County",5,18,209,116,93
050,35,027,"New Mexico","Lincoln County",5,19,194,104,90
050,35,027,"New Mexico","Lincoln County",5,20,154,82,72
050,35,027,"New Mexico","Lincoln County",5,21,167,87,80
050,35,027,"New Mexico","Lincoln County",5,22,164,83,81
050,35,027,"New Mexico","Lincoln County",5,23,136,70,66
050,35,027,"New Mexico","Lincoln County",5,24,164,93,71
050,35,027,"New Mexico","Lincoln County",5,25,171,86,85
050,35,027,"New Mexico","Lincoln County",5,26,155,80,75
050,35,027,"New Mexico","Lincoln County",5,27,151,85,66
050,35,027,"New Mexico","Lincoln County",5,28,166,88,78
050,35,027,"New Mexico","Lincoln County",5,29,169,85,84
050,35,027,"New Mexico","Lincoln County",5,30,163,93,70
050,35,027,"New Mexico","Lincoln County",5,31,158,79,79
050,35,027,"New Mexico","Lincoln County",5,32,203,103,100
050,35,027,"New Mexico","Lincoln County",5,33,190,102,88
050,35,027,"New Mexico","Lincoln County",5,34,174,97,77
050,35,027,"New Mexico","Lincoln County",5,35,186,91,95
050,35,027,"New Mexico","Lincoln County",5,36,208,100,108
050,35,027,"New Mexico","Lincoln County",5,37,192,80,112
050,35,027,"New Mexico","Lincoln County",5,38,210,80,130
050,35,027,"New Mexico","Lincoln County",5,39,223,104,119
050,35,027,"New Mexico","Lincoln County",5,40,223,98,125
050,35,027,"New Mexico","Lincoln County",5,41,246,123,123
050,35,027,"New Mexico","Lincoln County",5,42,239,120,119
050,35,027,"New Mexico","Lincoln County",5,43,203,88,115
050,35,027,"New Mexico","Lincoln County",5,44,185,91,94
050,35,027,"New Mexico","Lincoln County",5,45,175,89,86
050,35,027,"New Mexico","Lincoln County",5,46,199,94,105
050,35,027,"New Mexico","Lincoln County",5,47,176,81,95
050,35,027,"New Mexico","Lincoln County",5,48,175,83,92
050,35,027,"New Mexico","Lincoln County",5,49,180,92,88
050,35,027,"New Mexico","Lincoln County",5,50,199,110,89
050,35,027,"New Mexico","Lincoln County",5,51,194,99,95
050,35,027,"New Mexico","Lincoln County",5,52,217,105,112
050,35,027,"New Mexico","Lincoln County",5,53,213,109,104
050,35,027,"New Mexico","Lincoln County",5,54,212,100,112
050,35,027,"New Mexico","Lincoln County",5,55,199,107,92
050,35,027,"New Mexico","Lincoln County",5,56,220,104,116
050,35,027,"New Mexico","Lincoln County",5,57,266,125,141
050,35,027,"New Mexico","Lincoln County",5,58,298,142,156
050,35,027,"New Mexico","Lincoln County",5,59,310,152,158
050,35,027,"New Mexico","Lincoln County",5,60,300,138,162
050,35,027,"New Mexico","Lincoln County",5,61,344,153,191
050,35,027,"New Mexico","Lincoln County",5,62,361,164,197
050,35,027,"New Mexico","Lincoln County",5,63,336,159,177
050,35,027,"New Mexico","Lincoln County",5,64,358,166,192
050,35,027,"New Mexico","Lincoln County",5,65,390,182,208
050,35,027,"New Mexico","Lincoln County",5,66,405,192,213
050,35,027,"New Mexico","Lincoln County",5,67,423,206,217
050,35,027,"New Mexico","Lincoln County",5,68,406,186,220
050,35,027,"New Mexico","Lincoln County",5,69,406,198,208
050,35,027,"New Mexico","Lincoln County",5,70,372,185,187
050,35,027,"New Mexico","Lincoln County",5,71,369,168,201
050,35,027,"New Mexico","Lincoln County",5,72,351,174,177
050,35,027,"New Mexico","Lincoln County",5,73,313,150,163
050,35,027,"New Mexico","Lincoln County",5,74,334,157,177
050,35,027,"New Mexico","Lincoln County",5,75,359,177,182
050,35,027,"New Mexico","Lincoln County",5,76,338,178,160
050,35,027,"New Mexico","Lincoln County",5,77,237,116,121
050,35,027,"New Mexico","Lincoln County",5,78,217,112,105
050,35,027,"New Mexico","Lincoln County",5,79,207,96,111
050,35,027,"New Mexico","Lincoln County",5,80,220,108,112
050,35,027,"New Mexico","Lincoln County",5,81,177,94,83
050,35,027,"New Mexico","Lincoln County",5,82,169,80,89
050,35,027,"New Mexico","Lincoln County",5,83,149,66,83
050,35,027,"New Mexico","Lincoln County",5,84,112,51,61
050,35,027,"New Mexico","Lincoln County",5,85,608,275,333
050,35,028,"New Mexico","Los Alamos County",1,0,170,86,84
050,35,028,"New Mexico","Los Alamos County",1,1,175,88,87
050,35,028,"New Mexico","Los Alamos County",1,2,197,103,94
050,35,028,"New Mexico","Los Alamos County",1,3,219,122,97
050,35,028,"New Mexico","Los Alamos County",1,4,219,115,104
050,35,028,"New Mexico","Los Alamos County",1,5,230,111,119
050,35,028,"New Mexico","Los Alamos County",1,6,225,119,106
050,35,028,"New Mexico","Los Alamos County",1,7,233,122,111
050,35,028,"New Mexico","Los Alamos County",1,8,227,115,112
050,35,028,"New Mexico","Los Alamos County",1,9,246,115,131
050,35,028,"New Mexico","Los Alamos County",1,10,260,135,125
050,35,028,"New Mexico","Los Alamos County",1,11,284,157,127
050,35,028,"New Mexico","Los Alamos County",1,12,278,141,137
050,35,028,"New Mexico","Los Alamos County",1,13,260,130,130
050,35,028,"New Mexico","Los Alamos County",1,14,246,121,125
050,35,028,"New Mexico","Los Alamos County",1,15,279,135,144
050,35,028,"New Mexico","Los Alamos County",1,16,269,147,122
050,35,028,"New Mexico","Los Alamos County",1,17,277,140,137
050,35,028,"New Mexico","Los Alamos County",1,18,230,122,108
050,35,028,"New Mexico","Los Alamos County",1,19,175,98,77
050,35,028,"New Mexico","Los Alamos County",1,20,158,83,75
050,35,028,"New Mexico","Los Alamos County",1,21,174,87,87
050,35,028,"New Mexico","Los Alamos County",1,22,177,91,86
050,35,028,"New Mexico","Los Alamos County",1,23,187,94,93
050,35,028,"New Mexico","Los Alamos County",1,24,196,101,95
050,35,028,"New Mexico","Los Alamos County",1,25,202,106,96
050,35,028,"New Mexico","Los Alamos County",1,26,215,112,103
050,35,028,"New Mexico","Los Alamos County",1,27,223,116,107
050,35,028,"New Mexico","Los Alamos County",1,28,259,145,114
050,35,028,"New Mexico","Los Alamos County",1,29,253,141,112
050,35,028,"New Mexico","Los Alamos County",1,30,283,161,122
050,35,028,"New Mexico","Los Alamos County",1,31,294,161,133
050,35,028,"New Mexico","Los Alamos County",1,32,301,171,130
050,35,028,"New Mexico","Los Alamos County",1,33,266,150,116
050,35,028,"New Mexico","Los Alamos County",1,34,286,165,121
050,35,028,"New Mexico","Los Alamos County",1,35,291,169,122
050,35,028,"New Mexico","Los Alamos County",1,36,293,172,121
050,35,028,"New Mexico","Los Alamos County",1,37,274,158,116
050,35,028,"New Mexico","Los Alamos County",1,38,264,143,121
050,35,028,"New Mexico","Los Alamos County",1,39,260,129,131
050,35,028,"New Mexico","Los Alamos County",1,40,251,128,123
050,35,028,"New Mexico","Los Alamos County",1,41,260,134,126
050,35,028,"New Mexico","Los Alamos County",1,42,248,121,127
050,35,028,"New Mexico","Los Alamos County",1,43,215,111,104
050,35,028,"New Mexico","Los Alamos County",1,44,206,102,104
050,35,028,"New Mexico","Los Alamos County",1,45,226,112,114
050,35,028,"New Mexico","Los Alamos County",1,46,216,103,113
050,35,028,"New Mexico","Los Alamos County",1,47,236,115,121
050,35,028,"New Mexico","Los Alamos County",1,48,241,125,116
050,35,028,"New Mexico","Los Alamos County",1,49,266,130,136
050,35,028,"New Mexico","Los Alamos County",1,50,254,126,128
050,35,028,"New Mexico","Los Alamos County",1,51,232,116,116
050,35,028,"New Mexico","Los Alamos County",1,52,234,119,115
050,35,028,"New Mexico","Los Alamos County",1,53,272,139,133
050,35,028,"New Mexico","Los Alamos County",1,54,269,137,132
050,35,028,"New Mexico","Los Alamos County",1,55,286,149,137
050,35,028,"New Mexico","Los Alamos County",1,56,285,159,126
050,35,028,"New Mexico","Los Alamos County",1,57,306,165,141
050,35,028,"New Mexico","Los Alamos County",1,58,294,156,138
050,35,028,"New Mexico","Los Alamos County",1,59,312,147,165
050,35,028,"New Mexico","Los Alamos County",1,60,296,161,135
050,35,028,"New Mexico","Los Alamos County",1,61,259,139,120
050,35,028,"New Mexico","Los Alamos County",1,62,246,131,115
050,35,028,"New Mexico","Los Alamos County",1,63,253,131,122
050,35,028,"New Mexico","Los Alamos County",1,64,243,128,115
050,35,028,"New Mexico","Los Alamos County",1,65,241,132,109
050,35,028,"New Mexico","Los Alamos County",1,66,235,116,119
050,35,028,"New Mexico","Los Alamos County",1,67,244,117,127
050,35,028,"New Mexico","Los Alamos County",1,68,227,110,117
050,35,028,"New Mexico","Los Alamos County",1,69,183,97,86
050,35,028,"New Mexico","Los Alamos County",1,70,186,94,92
050,35,028,"New Mexico","Los Alamos County",1,71,166,77,89
050,35,028,"New Mexico","Los Alamos County",1,72,182,91,91
050,35,028,"New Mexico","Los Alamos County",1,73,203,111,92
050,35,028,"New Mexico","Los Alamos County",1,74,135,64,71
050,35,028,"New Mexico","Los Alamos County",1,75,128,53,75
050,35,028,"New Mexico","Los Alamos County",1,76,150,68,82
050,35,028,"New Mexico","Los Alamos County",1,77,149,70,79
050,35,028,"New Mexico","Los Alamos County",1,78,118,53,65
050,35,028,"New Mexico","Los Alamos County",1,79,107,55,52
050,35,028,"New Mexico","Los Alamos County",1,80,94,48,46
050,35,028,"New Mexico","Los Alamos County",1,81,85,41,44
050,35,028,"New Mexico","Los Alamos County",1,82,80,38,42
050,35,028,"New Mexico","Los Alamos County",1,83,69,32,37
050,35,028,"New Mexico","Los Alamos County",1,84,76,30,46
050,35,028,"New Mexico","Los Alamos County",1,85,401,167,234
050,35,028,"New Mexico","Los Alamos County",2,0,168,88,80
050,35,028,"New Mexico","Los Alamos County",2,1,178,89,89
050,35,028,"New Mexico","Los Alamos County",2,2,195,100,95
050,35,028,"New Mexico","Los Alamos County",2,3,214,118,96
050,35,028,"New Mexico","Los Alamos County",2,4,220,116,104
050,35,028,"New Mexico","Los Alamos County",2,5,227,112,115
050,35,028,"New Mexico","Los Alamos County",2,6,226,118,108
050,35,028,"New Mexico","Los Alamos County",2,7,230,121,109
050,35,028,"New Mexico","Los Alamos County",2,8,229,117,112
050,35,028,"New Mexico","Los Alamos County",2,9,245,117,128
050,35,028,"New Mexico","Los Alamos County",2,10,257,130,127
050,35,028,"New Mexico","Los Alamos County",2,11,277,151,126
050,35,028,"New Mexico","Los Alamos County",2,12,282,144,138
050,35,028,"New Mexico","Los Alamos County",2,13,261,130,131
050,35,028,"New Mexico","Los Alamos County",2,14,248,122,126
050,35,028,"New Mexico","Los Alamos County",2,15,271,132,139
050,35,028,"New Mexico","Los Alamos County",2,16,271,144,127
050,35,028,"New Mexico","Los Alamos County",2,17,275,142,133
050,35,028,"New Mexico","Los Alamos County",2,18,228,121,107
050,35,028,"New Mexico","Los Alamos County",2,19,175,96,79
050,35,028,"New Mexico","Los Alamos County",2,20,162,86,76
050,35,028,"New Mexico","Los Alamos County",2,21,170,85,85
050,35,028,"New Mexico","Los Alamos County",2,22,177,89,88
050,35,028,"New Mexico","Los Alamos County",2,23,186,94,92
050,35,028,"New Mexico","Los Alamos County",2,24,198,103,95
050,35,028,"New Mexico","Los Alamos County",2,25,203,107,96
050,35,028,"New Mexico","Los Alamos County",2,26,216,113,103
050,35,028,"New Mexico","Los Alamos County",2,27,225,118,107
050,35,028,"New Mexico","Los Alamos County",2,28,257,141,116
050,35,028,"New Mexico","Los Alamos County",2,29,259,144,115
050,35,028,"New Mexico","Los Alamos County",2,30,280,157,123
050,35,028,"New Mexico","Los Alamos County",2,31,295,163,132
050,35,028,"New Mexico","Los Alamos County",2,32,298,167,131
050,35,028,"New Mexico","Los Alamos County",2,33,272,153,119
050,35,028,"New Mexico","Los Alamos County",2,34,284,163,121
050,35,028,"New Mexico","Los Alamos County",2,35,294,169,125
050,35,028,"New Mexico","Los Alamos County",2,36,293,172,121
050,35,028,"New Mexico","Los Alamos County",2,37,280,163,117
050,35,028,"New Mexico","Los Alamos County",2,38,266,145,121
050,35,028,"New Mexico","Los Alamos County",2,39,259,131,128
050,35,028,"New Mexico","Los Alamos County",2,40,258,133,125
050,35,028,"New Mexico","Los Alamos County",2,41,257,131,126
050,35,028,"New Mexico","Los Alamos County",2,42,250,125,125
050,35,028,"New Mexico","Los Alamos County",2,43,225,116,109
050,35,028,"New Mexico","Los Alamos County",2,44,207,103,104
050,35,028,"New Mexico","Los Alamos County",2,45,221,108,113
050,35,028,"New Mexico","Los Alamos County",2,46,221,106,115
050,35,028,"New Mexico","Los Alamos County",2,47,232,112,120
050,35,028,"New Mexico","Los Alamos County",2,48,240,123,117
050,35,028,"New Mexico","Los Alamos County",2,49,262,131,131
050,35,028,"New Mexico","Los Alamos County",2,50,258,128,130
050,35,028,"New Mexico","Los Alamos County",2,51,235,117,118
050,35,028,"New Mexico","Los Alamos County",2,52,234,119,115
050,35,028,"New Mexico","Los Alamos County",2,53,263,134,129
050,35,028,"New Mexico","Los Alamos County",2,54,271,139,132
050,35,028,"New Mexico","Los Alamos County",2,55,277,143,134
050,35,028,"New Mexico","Los Alamos County",2,56,285,157,128
050,35,028,"New Mexico","Los Alamos County",2,57,296,162,134
050,35,028,"New Mexico","Los Alamos County",2,58,295,157,138
050,35,028,"New Mexico","Los Alamos County",2,59,309,149,160
050,35,028,"New Mexico","Los Alamos County",2,60,298,156,142
050,35,028,"New Mexico","Los Alamos County",2,61,265,142,123
050,35,028,"New Mexico","Los Alamos County",2,62,243,131,112
050,35,028,"New Mexico","Los Alamos County",2,63,251,130,121
050,35,028,"New Mexico","Los Alamos County",2,64,242,127,115
050,35,028,"New Mexico","Los Alamos County",2,65,239,129,110
050,35,028,"New Mexico","Los Alamos County",2,66,237,119,118
050,35,028,"New Mexico","Los Alamos County",2,67,240,116,124
050,35,028,"New Mexico","Los Alamos County",2,68,230,112,118
050,35,028,"New Mexico","Los Alamos County",2,69,194,100,94
050,35,028,"New Mexico","Los Alamos County",2,70,184,94,90
050,35,028,"New Mexico","Los Alamos County",2,71,168,80,88
050,35,028,"New Mexico","Los Alamos County",2,72,177,87,90
050,35,028,"New Mexico","Los Alamos County",2,73,205,110,95
050,35,028,"New Mexico","Los Alamos County",2,74,141,71,70
050,35,028,"New Mexico","Los Alamos County",2,75,129,56,73
050,35,028,"New Mexico","Los Alamos County",2,76,144,64,80
050,35,028,"New Mexico","Los Alamos County",2,77,151,70,81
050,35,028,"New Mexico","Los Alamos County",2,78,123,57,66
050,35,028,"New Mexico","Los Alamos County",2,79,106,53,53
050,35,028,"New Mexico","Los Alamos County",2,80,97,49,48
050,35,028,"New Mexico","Los Alamos County",2,81,85,42,43
050,35,028,"New Mexico","Los Alamos County",2,82,77,37,40
050,35,028,"New Mexico","Los Alamos County",2,83,70,32,38
050,35,028,"New Mexico","Los Alamos County",2,84,72,28,44
050,35,028,"New Mexico","Los Alamos County",2,85,403,166,237
050,35,028,"New Mexico","Los Alamos County",3,0,186,106,80
050,35,028,"New Mexico","Los Alamos County",3,1,162,87,75
050,35,028,"New Mexico","Los Alamos County",3,2,190,95,95
050,35,028,"New Mexico","Los Alamos County",3,3,195,100,95
050,35,028,"New Mexico","Los Alamos County",3,4,225,119,106
050,35,028,"New Mexico","Los Alamos County",3,5,217,114,103
050,35,028,"New Mexico","Los Alamos County",3,6,238,119,119
050,35,028,"New Mexico","Los Alamos County",3,7,219,110,109
050,35,028,"New Mexico","Los Alamos County",3,8,229,122,107
050,35,028,"New Mexico","Los Alamos County",3,9,231,119,112
050,35,028,"New Mexico","Los Alamos County",3,10,245,120,125
050,35,028,"New Mexico","Los Alamos County",3,11,247,130,117
050,35,028,"New Mexico","Los Alamos County",3,12,276,148,128
050,35,028,"New Mexico","Los Alamos County",3,13,281,138,143
050,35,028,"New Mexico","Los Alamos County",3,14,254,123,131
050,35,028,"New Mexico","Los Alamos County",3,15,252,123,129
050,35,028,"New Mexico","Los Alamos County",3,16,264,127,137
050,35,028,"New Mexico","Los Alamos County",3,17,266,132,134
050,35,028,"New Mexico","Los Alamos County",3,18,230,125,105
050,35,028,"New Mexico","Los Alamos County",3,19,182,98,84
050,35,028,"New Mexico","Los Alamos County",3,20,168,93,75
050,35,028,"New Mexico","Los Alamos County",3,21,157,92,65
050,35,028,"New Mexico","Los Alamos County",3,22,169,78,91
050,35,028,"New Mexico","Los Alamos County",3,23,187,92,95
050,35,028,"New Mexico","Los Alamos County",3,24,205,110,95
050,35,028,"New Mexico","Los Alamos County",3,25,208,111,97
050,35,028,"New Mexico","Los Alamos County",3,26,219,115,104
050,35,028,"New Mexico","Los Alamos County",3,27,231,127,104
050,35,028,"New Mexico","Los Alamos County",3,28,240,137,103
050,35,028,"New Mexico","Los Alamos County",3,29,289,161,128
050,35,028,"New Mexico","Los Alamos County",3,30,270,150,120
050,35,028,"New Mexico","Los Alamos County",3,31,293,170,123
050,35,028,"New Mexico","Los Alamos County",3,32,303,170,133
050,35,028,"New Mexico","Los Alamos County",3,33,310,167,143
050,35,028,"New Mexico","Los Alamos County",3,34,284,156,128
050,35,028,"New Mexico","Los Alamos County",3,35,287,173,114
050,35,028,"New Mexico","Los Alamos County",3,36,287,167,120
050,35,028,"New Mexico","Los Alamos County",3,37,282,160,122
050,35,028,"New Mexico","Los Alamos County",3,38,273,154,119
050,35,028,"New Mexico","Los Alamos County",3,39,259,137,122
050,35,028,"New Mexico","Los Alamos County",3,40,254,133,121
050,35,028,"New Mexico","Los Alamos County",3,41,273,142,131
050,35,028,"New Mexico","Los Alamos County",3,42,254,135,119
050,35,028,"New Mexico","Los Alamos County",3,43,248,123,125
050,35,028,"New Mexico","Los Alamos County",3,44,225,118,107
050,35,028,"New Mexico","Los Alamos County",3,45,207,104,103
050,35,028,"New Mexico","Los Alamos County",3,46,217,105,112
050,35,028,"New Mexico","Los Alamos County",3,47,221,106,115
050,35,028,"New Mexico","Los Alamos County",3,48,235,115,120
050,35,028,"New Mexico","Los Alamos County",3,49,233,120,113
050,35,028,"New Mexico","Los Alamos County",3,50,256,129,127
050,35,028,"New Mexico","Los Alamos County",3,51,255,124,131
050,35,028,"New Mexico","Los Alamos County",3,52,240,114,126
050,35,028,"New Mexico","Los Alamos County",3,53,229,112,117
050,35,028,"New Mexico","Los Alamos County",3,54,268,133,135
050,35,028,"New Mexico","Los Alamos County",3,55,271,140,131
050,35,028,"New Mexico","Los Alamos County",3,56,259,133,126
050,35,028,"New Mexico","Los Alamos County",3,57,281,153,128
050,35,028,"New Mexico","Los Alamos County",3,58,286,154,132
050,35,028,"New Mexico","Los Alamos County",3,59,291,153,138
050,35,028,"New Mexico","Los Alamos County",3,60,307,156,151
050,35,028,"New Mexico","Los Alamos County",3,61,285,154,131
050,35,028,"New Mexico","Los Alamos County",3,62,257,138,119
050,35,028,"New Mexico","Los Alamos County",3,63,237,129,108
050,35,028,"New Mexico","Los Alamos County",3,64,230,123,107
050,35,028,"New Mexico","Los Alamos County",3,65,233,124,109
050,35,028,"New Mexico","Los Alamos County",3,66,232,126,106
050,35,028,"New Mexico","Los Alamos County",3,67,230,113,117
050,35,028,"New Mexico","Los Alamos County",3,68,240,117,123
050,35,028,"New Mexico","Los Alamos County",3,69,222,106,116
050,35,028,"New Mexico","Los Alamos County",3,70,194,101,93
050,35,028,"New Mexico","Los Alamos County",3,71,177,91,86
050,35,028,"New Mexico","Los Alamos County",3,72,166,79,87
050,35,028,"New Mexico","Los Alamos County",3,73,173,84,89
050,35,028,"New Mexico","Los Alamos County",3,74,195,107,88
050,35,028,"New Mexico","Los Alamos County",3,75,141,69,72
050,35,028,"New Mexico","Los Alamos County",3,76,128,56,72
050,35,028,"New Mexico","Los Alamos County",3,77,141,64,77
050,35,028,"New Mexico","Los Alamos County",3,78,146,66,80
050,35,028,"New Mexico","Los Alamos County",3,79,119,59,60
050,35,028,"New Mexico","Los Alamos County",3,80,103,51,52
050,35,028,"New Mexico","Los Alamos County",3,81,89,46,43
050,35,028,"New Mexico","Los Alamos County",3,82,84,43,41
050,35,028,"New Mexico","Los Alamos County",3,83,72,36,36
050,35,028,"New Mexico","Los Alamos County",3,84,65,29,36
050,35,028,"New Mexico","Los Alamos County",3,85,411,163,248
050,35,028,"New Mexico","Los Alamos County",4,0,173,96,77
050,35,028,"New Mexico","Los Alamos County",4,1,183,100,83
050,35,028,"New Mexico","Los Alamos County",4,2,168,93,75
050,35,028,"New Mexico","Los Alamos County",4,3,188,96,92
050,35,028,"New Mexico","Los Alamos County",4,4,196,97,99
050,35,028,"New Mexico","Los Alamos County",4,5,224,120,104
050,35,028,"New Mexico","Los Alamos County",4,6,205,110,95
050,35,028,"New Mexico","Los Alamos County",4,7,234,117,117
050,35,028,"New Mexico","Los Alamos County",4,8,234,115,119
050,35,028,"New Mexico","Los Alamos County",4,9,236,121,115
050,35,028,"New Mexico","Los Alamos County",4,10,217,116,101
050,35,028,"New Mexico","Los Alamos County",4,11,260,132,128
050,35,028,"New Mexico","Los Alamos County",4,12,244,130,114
050,35,028,"New Mexico","Los Alamos County",4,13,272,151,121
050,35,028,"New Mexico","Los Alamos County",4,14,275,138,137
050,35,028,"New Mexico","Los Alamos County",4,15,247,122,125
050,35,028,"New Mexico","Los Alamos County",4,16,245,113,132
050,35,028,"New Mexico","Los Alamos County",4,17,262,126,136
050,35,028,"New Mexico","Los Alamos County",4,18,225,115,110
050,35,028,"New Mexico","Los Alamos County",4,19,169,94,75
050,35,028,"New Mexico","Los Alamos County",4,20,178,93,85
050,35,028,"New Mexico","Los Alamos County",4,21,166,90,76
050,35,028,"New Mexico","Los Alamos County",4,22,149,83,66
050,35,028,"New Mexico","Los Alamos County",4,23,184,99,85
050,35,028,"New Mexico","Los Alamos County",4,24,166,88,78
050,35,028,"New Mexico","Los Alamos County",4,25,199,104,95
050,35,028,"New Mexico","Los Alamos County",4,26,229,124,105
050,35,028,"New Mexico","Los Alamos County",4,27,224,125,99
050,35,028,"New Mexico","Los Alamos County",4,28,261,147,114
050,35,028,"New Mexico","Los Alamos County",4,29,276,152,124
050,35,028,"New Mexico","Los Alamos County",4,30,303,174,129
050,35,028,"New Mexico","Los Alamos County",4,31,296,164,132
050,35,028,"New Mexico","Los Alamos County",4,32,305,172,133
050,35,028,"New Mexico","Los Alamos County",4,33,298,170,128
050,35,028,"New Mexico","Los Alamos County",4,34,293,155,138
050,35,028,"New Mexico","Los Alamos County",4,35,288,162,126
050,35,028,"New Mexico","Los Alamos County",4,36,289,177,112
050,35,028,"New Mexico","Los Alamos County",4,37,292,175,117
050,35,028,"New Mexico","Los Alamos County",4,38,287,157,130
050,35,028,"New Mexico","Los Alamos County",4,39,271,153,118
050,35,028,"New Mexico","Los Alamos County",4,40,254,141,113
050,35,028,"New Mexico","Los Alamos County",4,41,256,130,126
050,35,028,"New Mexico","Los Alamos County",4,42,271,141,130
050,35,028,"New Mexico","Los Alamos County",4,43,236,125,111
050,35,028,"New Mexico","Los Alamos County",4,44,251,133,118
050,35,028,"New Mexico","Los Alamos County",4,45,230,121,109
050,35,028,"New Mexico","Los Alamos County",4,46,214,106,108
050,35,028,"New Mexico","Los Alamos County",4,47,225,112,113
050,35,028,"New Mexico","Los Alamos County",4,48,230,113,117
050,35,028,"New Mexico","Los Alamos County",4,49,229,113,116
050,35,028,"New Mexico","Los Alamos County",4,50,241,126,115
050,35,028,"New Mexico","Los Alamos County",4,51,255,130,125
050,35,028,"New Mexico","Los Alamos County",4,52,259,126,133
050,35,028,"New Mexico","Los Alamos County",4,53,243,114,129
050,35,028,"New Mexico","Los Alamos County",4,54,230,114,116
050,35,028,"New Mexico","Los Alamos County",4,55,255,125,130
050,35,028,"New Mexico","Los Alamos County",4,56,260,131,129
050,35,028,"New Mexico","Los Alamos County",4,57,246,122,124
050,35,028,"New Mexico","Los Alamos County",4,58,282,153,129
050,35,028,"New Mexico","Los Alamos County",4,59,279,154,125
050,35,028,"New Mexico","Los Alamos County",4,60,284,147,137
050,35,028,"New Mexico","Los Alamos County",4,61,289,144,145
050,35,028,"New Mexico","Los Alamos County",4,62,268,138,130
050,35,028,"New Mexico","Los Alamos County",4,63,259,138,121
050,35,028,"New Mexico","Los Alamos County",4,64,227,130,97
050,35,028,"New Mexico","Los Alamos County",4,65,222,121,101
050,35,028,"New Mexico","Los Alamos County",4,66,224,114,110
050,35,028,"New Mexico","Los Alamos County",4,67,224,120,104
050,35,028,"New Mexico","Los Alamos County",4,68,222,111,111
050,35,028,"New Mexico","Los Alamos County",4,69,232,112,120
050,35,028,"New Mexico","Los Alamos County",4,70,209,101,108
050,35,028,"New Mexico","Los Alamos County",4,71,194,101,93
050,35,028,"New Mexico","Los Alamos County",4,72,168,84,84
050,35,028,"New Mexico","Los Alamos County",4,73,160,77,83
050,35,028,"New Mexico","Los Alamos County",4,74,171,82,89
050,35,028,"New Mexico","Los Alamos County",4,75,196,104,92
050,35,028,"New Mexico","Los Alamos County",4,76,136,68,68
050,35,028,"New Mexico","Los Alamos County",4,77,122,57,65
050,35,028,"New Mexico","Los Alamos County",4,78,133,62,71
050,35,028,"New Mexico","Los Alamos County",4,79,135,64,71
050,35,028,"New Mexico","Los Alamos County",4,80,109,52,57
050,35,028,"New Mexico","Los Alamos County",4,81,97,48,49
050,35,028,"New Mexico","Los Alamos County",4,82,85,43,42
050,35,028,"New Mexico","Los Alamos County",4,83,75,38,37
050,35,028,"New Mexico","Los Alamos County",4,84,72,33,39
050,35,028,"New Mexico","Los Alamos County",4,85,403,159,244
050,35,028,"New Mexico","Los Alamos County",5,0,170,94,76
050,35,028,"New Mexico","Los Alamos County",5,1,182,101,81
050,35,028,"New Mexico","Los Alamos County",5,2,185,106,79
050,35,028,"New Mexico","Los Alamos County",5,3,169,95,74
050,35,028,"New Mexico","Los Alamos County",5,4,192,98,94
050,35,028,"New Mexico","Los Alamos County",5,5,188,92,96
050,35,028,"New Mexico","Los Alamos County",5,6,227,119,108
050,35,028,"New Mexico","Los Alamos County",5,7,216,110,106
050,35,028,"New Mexico","Los Alamos County",5,8,241,112,129
050,35,028,"New Mexico","Los Alamos County",5,9,239,123,116
050,35,028,"New Mexico","Los Alamos County",5,10,251,134,117
050,35,028,"New Mexico","Los Alamos County",5,11,238,130,108
050,35,028,"New Mexico","Los Alamos County",5,12,254,122,132
050,35,028,"New Mexico","Los Alamos County",5,13,247,133,114
050,35,028,"New Mexico","Los Alamos County",5,14,269,149,120
050,35,028,"New Mexico","Los Alamos County",5,15,274,134,140
050,35,028,"New Mexico","Los Alamos County",5,16,250,122,128
050,35,028,"New Mexico","Los Alamos County",5,17,241,114,127
050,35,028,"New Mexico","Los Alamos County",5,18,219,110,109
050,35,028,"New Mexico","Los Alamos County",5,19,168,84,84
050,35,028,"New Mexico","Los Alamos County",5,20,164,87,77
050,35,028,"New Mexico","Los Alamos County",5,21,165,86,79
050,35,028,"New Mexico","Los Alamos County",5,22,163,83,80
050,35,028,"New Mexico","Los Alamos County",5,23,166,103,63
050,35,028,"New Mexico","Los Alamos County",5,24,194,115,79
050,35,028,"New Mexico","Los Alamos County",5,25,206,109,97
050,35,028,"New Mexico","Los Alamos County",5,26,222,115,107
050,35,028,"New Mexico","Los Alamos County",5,27,255,141,114
050,35,028,"New Mexico","Los Alamos County",5,28,237,124,113
050,35,028,"New Mexico","Los Alamos County",5,29,280,169,111
050,35,028,"New Mexico","Los Alamos County",5,30,307,167,140
050,35,028,"New Mexico","Los Alamos County",5,31,341,207,134
050,35,028,"New Mexico","Los Alamos County",5,32,301,168,133
050,35,028,"New Mexico","Los Alamos County",5,33,323,186,137
050,35,028,"New Mexico","Los Alamos County",5,34,314,184,130
050,35,028,"New Mexico","Los Alamos County",5,35,300,154,146
050,35,028,"New Mexico","Los Alamos County",5,36,304,173,131
050,35,028,"New Mexico","Los Alamos County",5,37,293,174,119
050,35,028,"New Mexico","Los Alamos County",5,38,292,170,122
050,35,028,"New Mexico","Los Alamos County",5,39,281,155,126
050,35,028,"New Mexico","Los Alamos County",5,40,289,163,126
050,35,028,"New Mexico","Los Alamos County",5,41,260,146,114
050,35,028,"New Mexico","Los Alamos County",5,42,265,136,129
050,35,028,"New Mexico","Los Alamos County",5,43,280,151,129
050,35,028,"New Mexico","Los Alamos County",5,44,242,134,108
050,35,028,"New Mexico","Los Alamos County",5,45,255,141,114
050,35,028,"New Mexico","Los Alamos County",5,46,231,121,110
050,35,028,"New Mexico","Los Alamos County",5,47,207,104,103
050,35,028,"New Mexico","Los Alamos County",5,48,230,113,117
050,35,028,"New Mexico","Los Alamos County",5,49,236,114,122
050,35,028,"New Mexico","Los Alamos County",5,50,228,115,113
050,35,028,"New Mexico","Los Alamos County",5,51,246,134,112
050,35,028,"New Mexico","Los Alamos County",5,52,253,129,124
050,35,028,"New Mexico","Los Alamos County",5,53,260,124,136
050,35,028,"New Mexico","Los Alamos County",5,54,243,117,126
050,35,028,"New Mexico","Los Alamos County",5,55,223,119,104
050,35,028,"New Mexico","Los Alamos County",5,56,247,124,123
050,35,028,"New Mexico","Los Alamos County",5,57,248,126,122
050,35,028,"New Mexico","Los Alamos County",5,58,248,127,121
050,35,028,"New Mexico","Los Alamos County",5,59,275,141,134
050,35,028,"New Mexico","Los Alamos County",5,60,272,148,124
050,35,028,"New Mexico","Los Alamos County",5,61,272,143,129
050,35,028,"New Mexico","Los Alamos County",5,62,288,143,145
050,35,028,"New Mexico","Los Alamos County",5,63,259,136,123
050,35,028,"New Mexico","Los Alamos County",5,64,249,134,115
050,35,028,"New Mexico","Los Alamos County",5,65,215,118,97
050,35,028,"New Mexico","Los Alamos County",5,66,215,117,98
050,35,028,"New Mexico","Los Alamos County",5,67,210,105,105
050,35,028,"New Mexico","Los Alamos County",5,68,216,115,101
050,35,028,"New Mexico","Los Alamos County",5,69,209,101,108
050,35,028,"New Mexico","Los Alamos County",5,70,228,108,120
050,35,028,"New Mexico","Los Alamos County",5,71,203,99,104
050,35,028,"New Mexico","Los Alamos County",5,72,188,96,92
050,35,028,"New Mexico","Los Alamos County",5,73,157,81,76
050,35,028,"New Mexico","Los Alamos County",5,74,160,77,83
050,35,028,"New Mexico","Los Alamos County",5,75,175,82,93
050,35,028,"New Mexico","Los Alamos County",5,76,189,100,89
050,35,028,"New Mexico","Los Alamos County",5,77,130,67,63
050,35,028,"New Mexico","Los Alamos County",5,78,118,58,60
050,35,028,"New Mexico","Los Alamos County",5,79,128,61,67
050,35,028,"New Mexico","Los Alamos County",5,80,128,59,69
050,35,028,"New Mexico","Los Alamos County",5,81,101,50,51
050,35,028,"New Mexico","Los Alamos County",5,82,90,44,46
050,35,028,"New Mexico","Los Alamos County",5,83,76,40,36
050,35,028,"New Mexico","Los Alamos County",5,84,71,34,37
050,35,028,"New Mexico","Los Alamos County",5,85,403,161,242
050,35,029,"New Mexico","Luna County",1,0,363,179,184
050,35,029,"New Mexico","Luna County",1,1,367,174,193
050,35,029,"New Mexico","Luna County",1,2,371,189,182
050,35,029,"New Mexico","Luna County",1,3,395,198,197
050,35,029,"New Mexico","Luna County",1,4,365,190,175
050,35,029,"New Mexico","Luna County",1,5,367,175,192
050,35,029,"New Mexico","Luna County",1,6,365,177,188
050,35,029,"New Mexico","Luna County",1,7,371,188,183
050,35,029,"New Mexico","Luna County",1,8,355,176,179
050,35,029,"New Mexico","Luna County",1,9,339,175,164
050,35,029,"New Mexico","Luna County",1,10,358,187,171
050,35,029,"New Mexico","Luna County",1,11,377,194,183
050,35,029,"New Mexico","Luna County",1,12,390,198,192
050,35,029,"New Mexico","Luna County",1,13,352,177,175
050,35,029,"New Mexico","Luna County",1,14,348,177,171
050,35,029,"New Mexico","Luna County",1,15,365,190,175
050,35,029,"New Mexico","Luna County",1,16,376,195,181
050,35,029,"New Mexico","Luna County",1,17,338,171,167
050,35,029,"New Mexico","Luna County",1,18,407,216,191
050,35,029,"New Mexico","Luna County",1,19,459,245,214
050,35,029,"New Mexico","Luna County",1,20,365,187,178
050,35,029,"New Mexico","Luna County",1,21,338,180,158
050,35,029,"New Mexico","Luna County",1,22,306,168,138
050,35,029,"New Mexico","Luna County",1,23,319,172,147
050,35,029,"New Mexico","Luna County",1,24,330,176,154
050,35,029,"New Mexico","Luna County",1,25,327,174,153
050,35,029,"New Mexico","Luna County",1,26,309,165,144
050,35,029,"New Mexico","Luna County",1,27,314,170,144
050,35,029,"New Mexico","Luna County",1,28,332,168,164
050,35,029,"New Mexico","Luna County",1,29,310,154,156
050,35,029,"New Mexico","Luna County",1,30,269,145,124
050,35,029,"New Mexico","Luna County",1,31,277,150,127
050,35,029,"New Mexico","Luna County",1,32,283,140,143
050,35,029,"New Mexico","Luna County",1,33,279,137,142
050,35,029,"New Mexico","Luna County",1,34,294,157,137
050,35,029,"New Mexico","Luna County",1,35,315,186,129
050,35,029,"New Mexico","Luna County",1,36,286,159,127
050,35,029,"New Mexico","Luna County",1,37,265,135,130
050,35,029,"New Mexico","Luna County",1,38,273,137,136
050,35,029,"New Mexico","Luna County",1,39,238,113,125
050,35,029,"New Mexico","Luna County",1,40,255,121,134
050,35,029,"New Mexico","Luna County",1,41,245,123,122
050,35,029,"New Mexico","Luna County",1,42,236,113,123
050,35,029,"New Mexico","Luna County",1,43,246,116,130
050,35,029,"New Mexico","Luna County",1,44,234,121,113
050,35,029,"New Mexico","Luna County",1,45,222,105,117
050,35,029,"New Mexico","Luna County",1,46,229,115,114
050,35,029,"New Mexico","Luna County",1,47,260,133,127
050,35,029,"New Mexico","Luna County",1,48,252,134,118
050,35,029,"New Mexico","Luna County",1,49,251,128,123
050,35,029,"New Mexico","Luna County",1,50,260,123,137
050,35,029,"New Mexico","Luna County",1,51,262,122,140
050,35,029,"New Mexico","Luna County",1,52,251,128,123
050,35,029,"New Mexico","Luna County",1,53,266,135,131
050,35,029,"New Mexico","Luna County",1,54,264,131,133
050,35,029,"New Mexico","Luna County",1,55,258,120,138
050,35,029,"New Mexico","Luna County",1,56,278,138,140
050,35,029,"New Mexico","Luna County",1,57,304,169,135
050,35,029,"New Mexico","Luna County",1,58,320,171,149
050,35,029,"New Mexico","Luna County",1,59,319,160,159
050,35,029,"New Mexico","Luna County",1,60,307,148,159
050,35,029,"New Mexico","Luna County",1,61,278,125,153
050,35,029,"New Mexico","Luna County",1,62,283,117,166
050,35,029,"New Mexico","Luna County",1,63,306,133,173
050,35,029,"New Mexico","Luna County",1,64,307,145,162
050,35,029,"New Mexico","Luna County",1,65,293,164,129
050,35,029,"New Mexico","Luna County",1,66,270,144,126
050,35,029,"New Mexico","Luna County",1,67,280,150,130
050,35,029,"New Mexico","Luna County",1,68,289,143,146
050,35,029,"New Mexico","Luna County",1,69,287,129,158
050,35,029,"New Mexico","Luna County",1,70,279,126,153
050,35,029,"New Mexico","Luna County",1,71,283,133,150
050,35,029,"New Mexico","Luna County",1,72,322,159,163
050,35,029,"New Mexico","Luna County",1,73,332,161,171
050,35,029,"New Mexico","Luna County",1,74,256,116,140
050,35,029,"New Mexico","Luna County",1,75,256,123,133
050,35,029,"New Mexico","Luna County",1,76,245,121,124
050,35,029,"New Mexico","Luna County",1,77,207,113,94
050,35,029,"New Mexico","Luna County",1,78,218,105,113
050,35,029,"New Mexico","Luna County",1,79,194,94,100
050,35,029,"New Mexico","Luna County",1,80,162,79,83
050,35,029,"New Mexico","Luna County",1,81,170,94,76
050,35,029,"New Mexico","Luna County",1,82,146,70,76
050,35,029,"New Mexico","Luna County",1,83,138,71,67
050,35,029,"New Mexico","Luna County",1,84,107,58,49
050,35,029,"New Mexico","Luna County",1,85,542,234,308
050,35,029,"New Mexico","Luna County",2,0,371,180,191
050,35,029,"New Mexico","Luna County",2,1,366,174,192
050,35,029,"New Mexico","Luna County",2,2,369,184,185
050,35,029,"New Mexico","Luna County",2,3,387,196,191
050,35,029,"New Mexico","Luna County",2,4,371,191,180
050,35,029,"New Mexico","Luna County",2,5,369,181,188
050,35,029,"New Mexico","Luna County",2,6,367,179,188
050,35,029,"New Mexico","Luna County",2,7,369,184,185
050,35,029,"New Mexico","Luna County",2,8,356,178,178
050,35,029,"New Mexico","Luna County",2,9,342,175,167
050,35,029,"New Mexico","Luna County",2,10,358,185,173
050,35,029,"New Mexico","Luna County",2,11,372,192,180
050,35,029,"New Mexico","Luna County",2,12,391,199,192
050,35,029,"New Mexico","Luna County",2,13,361,182,179
050,35,029,"New Mexico","Luna County",2,14,349,177,172
050,35,029,"New Mexico","Luna County",2,15,362,188,174
050,35,029,"New Mexico","Luna County",2,16,373,194,179
050,35,029,"New Mexico","Luna County",2,17,344,177,167
050,35,029,"New Mexico","Luna County",2,18,403,211,192
050,35,029,"New Mexico","Luna County",2,19,457,244,213
050,35,029,"New Mexico","Luna County",2,20,374,193,181
050,35,029,"New Mexico","Luna County",2,21,335,176,159
050,35,029,"New Mexico","Luna County",2,22,310,170,140
050,35,029,"New Mexico","Luna County",2,23,313,171,142
050,35,029,"New Mexico","Luna County",2,24,327,176,151
050,35,029,"New Mexico","Luna County",2,25,328,174,154
050,35,029,"New Mexico","Luna County",2,26,310,166,144
050,35,029,"New Mexico","Luna County",2,27,311,166,145
050,35,029,"New Mexico","Luna County",2,28,328,167,161
050,35,029,"New Mexico","Luna County",2,29,318,160,158
050,35,029,"New Mexico","Luna County",2,30,278,147,131
050,35,029,"New Mexico","Luna County",2,31,274,149,125
050,35,029,"New Mexico","Luna County",2,32,285,145,140
050,35,029,"New Mexico","Luna County",2,33,278,137,141
050,35,029,"New Mexico","Luna County",2,34,296,156,140
050,35,029,"New Mexico","Luna County",2,35,314,182,132
050,35,029,"New Mexico","Luna County",2,36,290,163,127
050,35,029,"New Mexico","Luna County",2,37,273,144,129
050,35,029,"New Mexico","Luna County",2,38,269,135,134
050,35,029,"New Mexico","Luna County",2,39,239,113,126
050,35,029,"New Mexico","Luna County",2,40,255,120,135
050,35,029,"New Mexico","Luna County",2,41,244,120,124
050,35,029,"New Mexico","Luna County",2,42,240,115,125
050,35,029,"New Mexico","Luna County",2,43,246,117,129
050,35,029,"New Mexico","Luna County",2,44,234,118,116
050,35,029,"New Mexico","Luna County",2,45,225,109,116
050,35,029,"New Mexico","Luna County",2,46,226,112,114
050,35,029,"New Mexico","Luna County",2,47,249,126,123
050,35,029,"New Mexico","Luna County",2,48,256,134,122
050,35,029,"New Mexico","Luna County",2,49,253,129,124
050,35,029,"New Mexico","Luna County",2,50,257,124,133
050,35,029,"New Mexico","Luna County",2,51,262,122,140
050,35,029,"New Mexico","Luna County",2,52,253,127,126
050,35,029,"New Mexico","Luna County",2,53,263,132,131
050,35,029,"New Mexico","Luna County",2,54,267,134,133
050,35,029,"New Mexico","Luna County",2,55,258,121,137
050,35,029,"New Mexico","Luna County",2,56,275,136,139
050,35,029,"New Mexico","Luna County",2,57,298,162,136
050,35,029,"New Mexico","Luna County",2,58,319,172,147
050,35,029,"New Mexico","Luna County",2,59,319,161,158
050,35,029,"New Mexico","Luna County",2,60,316,154,162
050,35,029,"New Mexico","Luna County",2,61,283,129,154
050,35,029,"New Mexico","Luna County",2,62,279,117,162
050,35,029,"New Mexico","Luna County",2,63,305,131,174
050,35,029,"New Mexico","Luna County",2,64,303,141,162
050,35,029,"New Mexico","Luna County",2,65,296,159,137
050,35,029,"New Mexico","Luna County",2,66,276,149,127
050,35,029,"New Mexico","Luna County",2,67,277,147,130
050,35,029,"New Mexico","Luna County",2,68,285,141,144
050,35,029,"New Mexico","Luna County",2,69,288,133,155
050,35,029,"New Mexico","Luna County",2,70,282,128,154
050,35,029,"New Mexico","Luna County",2,71,284,132,152
050,35,029,"New Mexico","Luna County",2,72,313,155,158
050,35,029,"New Mexico","Luna County",2,73,338,165,173
050,35,029,"New Mexico","Luna County",2,74,261,120,141
050,35,029,"New Mexico","Luna County",2,75,253,120,133
050,35,029,"New Mexico","Luna County",2,76,242,120,122
050,35,029,"New Mexico","Luna County",2,77,220,117,103
050,35,029,"New Mexico","Luna County",2,78,208,103,105
050,35,029,"New Mexico","Luna County",2,79,198,95,103
050,35,029,"New Mexico","Luna County",2,80,163,79,84
050,35,029,"New Mexico","Luna County",2,81,167,90,77
050,35,029,"New Mexico","Luna County",2,82,147,74,73
050,35,029,"New Mexico","Luna County",2,83,135,69,66
050,35,029,"New Mexico","Luna County",2,84,112,60,52
050,35,029,"New Mexico","Luna County",2,85,541,234,307
050,35,029,"New Mexico","Luna County",3,0,344,168,176
050,35,029,"New Mexico","Luna County",3,1,368,176,192
050,35,029,"New Mexico","Luna County",3,2,371,186,185
050,35,029,"New Mexico","Luna County",3,3,365,187,178
050,35,029,"New Mexico","Luna County",3,4,385,185,200
050,35,029,"New Mexico","Luna County",3,5,364,187,177
050,35,029,"New Mexico","Luna County",3,6,371,183,188
050,35,029,"New Mexico","Luna County",3,7,371,185,186
050,35,029,"New Mexico","Luna County",3,8,362,177,185
050,35,029,"New Mexico","Luna County",3,9,363,189,174
050,35,029,"New Mexico","Luna County",3,10,345,178,167
050,35,029,"New Mexico","Luna County",3,11,352,183,169
050,35,029,"New Mexico","Luna County",3,12,376,195,181
050,35,029,"New Mexico","Luna County",3,13,391,197,194
050,35,029,"New Mexico","Luna County",3,14,362,189,173
050,35,029,"New Mexico","Luna County",3,15,354,180,174
050,35,029,"New Mexico","Luna County",3,16,369,195,174
050,35,029,"New Mexico","Luna County",3,17,376,194,182
050,35,029,"New Mexico","Luna County",3,18,424,218,206
050,35,029,"New Mexico","Luna County",3,19,453,244,209
050,35,029,"New Mexico","Luna County",3,20,392,201,191
050,35,029,"New Mexico","Luna County",3,21,342,178,164
050,35,029,"New Mexico","Luna County",3,22,326,172,154
050,35,029,"New Mexico","Luna County",3,23,308,167,141
050,35,029,"New Mexico","Luna County",3,24,306,165,141
050,35,029,"New Mexico","Luna County",3,25,326,168,158
050,35,029,"New Mexico","Luna County",3,26,319,173,146
050,35,029,"New Mexico","Luna County",3,27,305,160,145
050,35,029,"New Mexico","Luna County",3,28,314,159,155
050,35,029,"New Mexico","Luna County",3,29,334,177,157
050,35,029,"New Mexico","Luna County",3,30,302,154,148
050,35,029,"New Mexico","Luna County",3,31,278,148,130
050,35,029,"New Mexico","Luna County",3,32,272,146,126
050,35,029,"New Mexico","Luna County",3,33,271,132,139
050,35,029,"New Mexico","Luna County",3,34,268,128,140
050,35,029,"New Mexico","Luna County",3,35,293,156,137
050,35,029,"New Mexico","Luna County",3,36,309,182,127
050,35,029,"New Mexico","Luna County",3,37,279,152,127
050,35,029,"New Mexico","Luna County",3,38,269,149,120
050,35,029,"New Mexico","Luna County",3,39,288,147,141
050,35,029,"New Mexico","Luna County",3,40,235,109,126
050,35,029,"New Mexico","Luna County",3,41,250,114,136
050,35,029,"New Mexico","Luna County",3,42,239,115,124
050,35,029,"New Mexico","Luna County",3,43,240,120,120
050,35,029,"New Mexico","Luna County",3,44,246,122,124
050,35,029,"New Mexico","Luna County",3,45,240,119,121
050,35,029,"New Mexico","Luna County",3,46,235,115,120
050,35,029,"New Mexico","Luna County",3,47,220,107,113
050,35,029,"New Mexico","Luna County",3,48,250,122,128
050,35,029,"New Mexico","Luna County",3,49,251,133,118
050,35,029,"New Mexico","Luna County",3,50,251,127,124
050,35,029,"New Mexico","Luna County",3,51,268,129,139
050,35,029,"New Mexico","Luna County",3,52,262,128,134
050,35,029,"New Mexico","Luna County",3,53,259,130,129
050,35,029,"New Mexico","Luna County",3,54,262,129,133
050,35,029,"New Mexico","Luna County",3,55,265,131,134
050,35,029,"New Mexico","Luna County",3,56,265,116,149
050,35,029,"New Mexico","Luna County",3,57,287,145,142
050,35,029,"New Mexico","Luna County",3,58,310,168,142
050,35,029,"New Mexico","Luna County",3,59,311,164,147
050,35,029,"New Mexico","Luna County",3,60,323,164,159
050,35,029,"New Mexico","Luna County",3,61,304,148,156
050,35,029,"New Mexico","Luna County",3,62,275,132,143
050,35,029,"New Mexico","Luna County",3,63,283,122,161
050,35,029,"New Mexico","Luna County",3,64,298,133,165
050,35,029,"New Mexico","Luna County",3,65,308,148,160
050,35,029,"New Mexico","Luna County",3,66,296,160,136
050,35,029,"New Mexico","Luna County",3,67,270,149,121
050,35,029,"New Mexico","Luna County",3,68,271,146,125
050,35,029,"New Mexico","Luna County",3,69,278,137,141
050,35,029,"New Mexico","Luna County",3,70,287,129,158
050,35,029,"New Mexico","Luna County",3,71,268,121,147
050,35,029,"New Mexico","Luna County",3,72,283,134,149
050,35,029,"New Mexico","Luna County",3,73,300,148,152
050,35,029,"New Mexico","Luna County",3,74,324,152,172
050,35,029,"New Mexico","Luna County",3,75,249,112,137
050,35,029,"New Mexico","Luna County",3,76,242,114,128
050,35,029,"New Mexico","Luna County",3,77,228,110,118
050,35,029,"New Mexico","Luna County",3,78,209,113,96
050,35,029,"New Mexico","Luna County",3,79,192,95,97
050,35,029,"New Mexico","Luna County",3,80,184,90,94
050,35,029,"New Mexico","Luna County",3,81,151,69,82
050,35,029,"New Mexico","Luna County",3,82,154,83,71
050,35,029,"New Mexico","Luna County",3,83,121,59,62
050,35,029,"New Mexico","Luna County",3,84,124,66,58
050,35,029,"New Mexico","Luna County",3,85,536,238,298
050,35,029,"New Mexico","Luna County",4,0,327,156,171
050,35,029,"New Mexico","Luna County",4,1,348,165,183
050,35,029,"New Mexico","Luna County",4,2,379,177,202
050,35,029,"New Mexico","Luna County",4,3,372,182,190
050,35,029,"New Mexico","Luna County",4,4,361,181,180
050,35,029,"New Mexico","Luna County",4,5,391,189,202
050,35,029,"New Mexico","Luna County",4,6,368,189,179
050,35,029,"New Mexico","Luna County",4,7,391,203,188
050,35,029,"New Mexico","Luna County",4,8,372,182,190
050,35,029,"New Mexico","Luna County",4,9,363,175,188
050,35,029,"New Mexico","Luna County",4,10,364,187,177
050,35,029,"New Mexico","Luna County",4,11,349,173,176
050,35,029,"New Mexico","Luna County",4,12,347,175,172
050,35,029,"New Mexico","Luna County",4,13,380,194,186
050,35,029,"New Mexico","Luna County",4,14,387,190,197
050,35,029,"New Mexico","Luna County",4,15,372,192,180
050,35,029,"New Mexico","Luna County",4,16,365,179,186
050,35,029,"New Mexico","Luna County",4,17,366,195,171
050,35,029,"New Mexico","Luna County",4,18,425,224,201
050,35,029,"New Mexico","Luna County",4,19,440,234,206
050,35,029,"New Mexico","Luna County",4,20,381,210,171
050,35,029,"New Mexico","Luna County",4,21,362,186,176
050,35,029,"New Mexico","Luna County",4,22,324,161,163
050,35,029,"New Mexico","Luna County",4,23,314,166,148
050,35,029,"New Mexico","Luna County",4,24,315,170,145
050,35,029,"New Mexico","Luna County",4,25,308,163,145
050,35,029,"New Mexico","Luna County",4,26,336,174,162
050,35,029,"New Mexico","Luna County",4,27,324,168,156
050,35,029,"New Mexico","Luna County",4,28,320,162,158
050,35,029,"New Mexico","Luna County",4,29,323,168,155
050,35,029,"New Mexico","Luna County",4,30,318,169,149
050,35,029,"New Mexico","Luna County",4,31,304,157,147
050,35,029,"New Mexico","Luna County",4,32,289,150,139
050,35,029,"New Mexico","Luna County",4,33,272,146,126
050,35,029,"New Mexico","Luna County",4,34,279,136,143
050,35,029,"New Mexico","Luna County",4,35,290,140,150
050,35,029,"New Mexico","Luna County",4,36,299,167,132
050,35,029,"New Mexico","Luna County",4,37,310,174,136
050,35,029,"New Mexico","Luna County",4,38,283,155,128
050,35,029,"New Mexico","Luna County",4,39,282,153,129
050,35,029,"New Mexico","Luna County",4,40,286,141,145
050,35,029,"New Mexico","Luna County",4,41,224,106,118
050,35,029,"New Mexico","Luna County",4,42,261,125,136
050,35,029,"New Mexico","Luna County",4,43,246,127,119
050,35,029,"New Mexico","Luna County",4,44,250,130,120
050,35,029,"New Mexico","Luna County",4,45,246,126,120
050,35,029,"New Mexico","Luna County",4,46,236,118,118
050,35,029,"New Mexico","Luna County",4,47,234,108,126
050,35,029,"New Mexico","Luna County",4,48,219,107,112
050,35,029,"New Mexico","Luna County",4,49,254,121,133
050,35,029,"New Mexico","Luna County",4,50,257,136,121
050,35,029,"New Mexico","Luna County",4,51,262,137,125
050,35,029,"New Mexico","Luna County",4,52,269,133,136
050,35,029,"New Mexico","Luna County",4,53,270,134,136
050,35,029,"New Mexico","Luna County",4,54,263,137,126
050,35,029,"New Mexico","Luna County",4,55,267,125,142
050,35,029,"New Mexico","Luna County",4,56,262,126,136
050,35,029,"New Mexico","Luna County",4,57,263,115,148
050,35,029,"New Mexico","Luna County",4,58,307,155,152
050,35,029,"New Mexico","Luna County",4,59,317,166,151
050,35,029,"New Mexico","Luna County",4,60,326,171,155
050,35,029,"New Mexico","Luna County",4,61,322,160,162
050,35,029,"New Mexico","Luna County",4,62,313,150,163
050,35,029,"New Mexico","Luna County",4,63,281,130,151
050,35,029,"New Mexico","Luna County",4,64,280,125,155
050,35,029,"New Mexico","Luna County",4,65,300,139,161
050,35,029,"New Mexico","Luna County",4,66,297,146,151
050,35,029,"New Mexico","Luna County",4,67,303,163,140
050,35,029,"New Mexico","Luna County",4,68,274,152,122
050,35,029,"New Mexico","Luna County",4,69,270,144,126
050,35,029,"New Mexico","Luna County",4,70,278,139,139
050,35,029,"New Mexico","Luna County",4,71,285,131,154
050,35,029,"New Mexico","Luna County",4,72,274,127,147
050,35,029,"New Mexico","Luna County",4,73,274,128,146
050,35,029,"New Mexico","Luna County",4,74,290,143,147
050,35,029,"New Mexico","Luna County",4,75,306,144,162
050,35,029,"New Mexico","Luna County",4,76,230,101,129
050,35,029,"New Mexico","Luna County",4,77,230,107,123
050,35,029,"New Mexico","Luna County",4,78,209,99,110
050,35,029,"New Mexico","Luna County",4,79,195,108,87
050,35,029,"New Mexico","Luna County",4,80,176,88,88
050,35,029,"New Mexico","Luna County",4,81,161,77,84
050,35,029,"New Mexico","Luna County",4,82,143,68,75
050,35,029,"New Mexico","Luna County",4,83,132,70,62
050,35,029,"New Mexico","Luna County",4,84,102,49,53
050,35,029,"New Mexico","Luna County",4,85,549,254,295
050,35,029,"New Mexico","Luna County",5,0,324,156,168
050,35,029,"New Mexico","Luna County",5,1,314,150,164
050,35,029,"New Mexico","Luna County",5,2,328,162,166
050,35,029,"New Mexico","Luna County",5,3,373,172,201
050,35,029,"New Mexico","Luna County",5,4,366,177,189
050,35,029,"New Mexico","Luna County",5,5,352,179,173
050,35,029,"New Mexico","Luna County",5,6,388,196,192
050,35,029,"New Mexico","Luna County",5,7,368,187,181
050,35,029,"New Mexico","Luna County",5,8,375,193,182
050,35,029,"New Mexico","Luna County",5,9,358,176,182
050,35,029,"New Mexico","Luna County",5,10,360,182,178
050,35,029,"New Mexico","Luna County",5,11,357,185,172
050,35,029,"New Mexico","Luna County",5,12,348,175,173
050,35,029,"New Mexico","Luna County",5,13,356,188,168
050,35,029,"New Mexico","Luna County",5,14,375,202,173
050,35,029,"New Mexico","Luna County",5,15,378,189,189
050,35,029,"New Mexico","Luna County",5,16,374,193,181
050,35,029,"New Mexico","Luna County",5,17,360,180,180
050,35,029,"New Mexico","Luna County",5,18,417,223,194
050,35,029,"New Mexico","Luna County",5,19,453,249,204
050,35,029,"New Mexico","Luna County",5,20,366,193,173
050,35,029,"New Mexico","Luna County",5,21,355,194,161
050,35,029,"New Mexico","Luna County",5,22,340,169,171
050,35,029,"New Mexico","Luna County",5,23,307,160,147
050,35,029,"New Mexico","Luna County",5,24,310,162,148
050,35,029,"New Mexico","Luna County",5,25,301,165,136
050,35,029,"New Mexico","Luna County",5,26,301,168,133
050,35,029,"New Mexico","Luna County",5,27,325,162,163
050,35,029,"New Mexico","Luna County",5,28,315,158,157
050,35,029,"New Mexico","Luna County",5,29,328,172,156
050,35,029,"New Mexico","Luna County",5,30,300,150,150
050,35,029,"New Mexico","Luna County",5,31,313,168,145
050,35,029,"New Mexico","Luna County",5,32,287,146,141
050,35,029,"New Mexico","Luna County",5,33,273,138,135
050,35,029,"New Mexico","Luna County",5,34,269,145,124
050,35,029,"New Mexico","Luna County",5,35,267,131,136
050,35,029,"New Mexico","Luna County",5,36,278,142,136
050,35,029,"New Mexico","Luna County",5,37,293,161,132
050,35,029,"New Mexico","Luna County",5,38,306,181,125
050,35,029,"New Mexico","Luna County",5,39,273,151,122
050,35,029,"New Mexico","Luna County",5,40,290,156,134
050,35,029,"New Mexico","Luna County",5,41,274,133,141
050,35,029,"New Mexico","Luna County",5,42,217,101,116
050,35,029,"New Mexico","Luna County",5,43,261,121,140
050,35,029,"New Mexico","Luna County",5,44,245,126,119
050,35,029,"New Mexico","Luna County",5,45,248,122,126
050,35,029,"New Mexico","Luna County",5,46,236,121,115
050,35,029,"New Mexico","Luna County",5,47,229,116,113
050,35,029,"New Mexico","Luna County",5,48,218,102,116
050,35,029,"New Mexico","Luna County",5,49,216,100,116
050,35,029,"New Mexico","Luna County",5,50,241,118,123
050,35,029,"New Mexico","Luna County",5,51,261,138,123
050,35,029,"New Mexico","Luna County",5,52,255,136,119
050,35,029,"New Mexico","Luna County",5,53,264,127,137
050,35,029,"New Mexico","Luna County",5,54,282,144,138
050,35,029,"New Mexico","Luna County",5,55,254,128,126
050,35,029,"New Mexico","Luna County",5,56,273,126,147
050,35,029,"New Mexico","Luna County",5,57,256,124,132
050,35,029,"New Mexico","Luna County",5,58,271,124,147
050,35,029,"New Mexico","Luna County",5,59,301,154,147
050,35,029,"New Mexico","Luna County",5,60,321,163,158
050,35,029,"New Mexico","Luna County",5,61,318,169,149
050,35,029,"New Mexico","Luna County",5,62,329,166,163
050,35,029,"New Mexico","Luna County",5,63,302,145,157
050,35,029,"New Mexico","Luna County",5,64,280,128,152
050,35,029,"New Mexico","Luna County",5,65,274,124,150
050,35,029,"New Mexico","Luna County",5,66,300,138,162
050,35,029,"New Mexico","Luna County",5,67,301,147,154
050,35,029,"New Mexico","Luna County",5,68,299,158,141
050,35,029,"New Mexico","Luna County",5,69,271,147,124
050,35,029,"New Mexico","Luna County",5,70,260,139,121
050,35,029,"New Mexico","Luna County",5,71,272,136,136
050,35,029,"New Mexico","Luna County",5,72,273,131,142
050,35,029,"New Mexico","Luna County",5,73,266,120,146
050,35,029,"New Mexico","Luna County",5,74,269,126,143
050,35,029,"New Mexico","Luna County",5,75,268,134,134
050,35,029,"New Mexico","Luna County",5,76,287,135,152
050,35,029,"New Mexico","Luna County",5,77,223,96,127
050,35,029,"New Mexico","Luna County",5,78,223,102,121
050,35,029,"New Mexico","Luna County",5,79,196,99,97
050,35,029,"New Mexico","Luna County",5,80,171,92,79
050,35,029,"New Mexico","Luna County",5,81,159,76,83
050,35,029,"New Mexico","Luna County",5,82,148,73,75
050,35,029,"New Mexico","Luna County",5,83,122,58,64
050,35,029,"New Mexico","Luna County",5,84,123,64,59
050,35,029,"New Mexico","Luna County",5,85,538,249,289
050,35,031,"New Mexico","McKinley County",1,0,857,433,424
050,35,031,"New Mexico","McKinley County",1,1,860,413,447
050,35,031,"New Mexico","McKinley County",1,2,805,398,407
050,35,031,"New Mexico","McKinley County",1,3,908,443,465
050,35,031,"New Mexico","McKinley County",1,4,1000,502,498
050,35,031,"New Mexico","McKinley County",1,5,1136,566,570
050,35,031,"New Mexico","McKinley County",1,6,1189,608,581
050,35,031,"New Mexico","McKinley County",1,7,1224,619,605
050,35,031,"New Mexico","McKinley County",1,8,1262,652,610
050,35,031,"New Mexico","McKinley County",1,9,1226,639,587
050,35,031,"New Mexico","McKinley County",1,10,1218,616,602
050,35,031,"New Mexico","McKinley County",1,11,1261,632,629
050,35,031,"New Mexico","McKinley County",1,12,1297,669,628
050,35,031,"New Mexico","McKinley County",1,13,1314,679,635
050,35,031,"New Mexico","McKinley County",1,14,1246,642,604
050,35,031,"New Mexico","McKinley County",1,15,1236,631,605
050,35,031,"New Mexico","McKinley County",1,16,1168,588,580
050,35,031,"New Mexico","McKinley County",1,17,1149,583,566
050,35,031,"New Mexico","McKinley County",1,18,1055,530,525
050,35,031,"New Mexico","McKinley County",1,19,1006,498,508
050,35,031,"New Mexico","McKinley County",1,20,955,477,478
050,35,031,"New Mexico","McKinley County",1,21,898,426,472
050,35,031,"New Mexico","McKinley County",1,22,897,427,470
050,35,031,"New Mexico","McKinley County",1,23,890,420,470
050,35,031,"New Mexico","McKinley County",1,24,918,461,457
050,35,031,"New Mexico","McKinley County",1,25,980,492,488
050,35,031,"New Mexico","McKinley County",1,26,1071,545,526
050,35,031,"New Mexico","McKinley County",1,27,1151,556,595
050,35,031,"New Mexico","McKinley County",1,28,1168,566,602
050,35,031,"New Mexico","McKinley County",1,29,1125,551,574
050,35,031,"New Mexico","McKinley County",1,30,1166,573,593
050,35,031,"New Mexico","McKinley County",1,31,1126,550,576
050,35,031,"New Mexico","McKinley County",1,32,1081,555,526
050,35,031,"New Mexico","McKinley County",1,33,1029,548,481
050,35,031,"New Mexico","McKinley County",1,34,1032,527,505
050,35,031,"New Mexico","McKinley County",1,35,1032,525,507
050,35,031,"New Mexico","McKinley County",1,36,926,452,474
050,35,031,"New Mexico","McKinley County",1,37,933,462,471
050,35,031,"New Mexico","McKinley County",1,38,913,479,434
050,35,031,"New Mexico","McKinley County",1,39,863,433,430
050,35,031,"New Mexico","McKinley County",1,40,831,406,425
050,35,031,"New Mexico","McKinley County",1,41,893,459,434
050,35,031,"New Mexico","McKinley County",1,42,894,444,450
050,35,031,"New Mexico","McKinley County",1,43,888,440,448
050,35,031,"New Mexico","McKinley County",1,44,812,405,407
050,35,031,"New Mexico","McKinley County",1,45,786,362,424
050,35,031,"New Mexico","McKinley County",1,46,784,353,431
050,35,031,"New Mexico","McKinley County",1,47,833,400,433
050,35,031,"New Mexico","McKinley County",1,48,817,403,414
050,35,031,"New Mexico","McKinley County",1,49,798,383,415
050,35,031,"New Mexico","McKinley County",1,50,796,389,407
050,35,031,"New Mexico","McKinley County",1,51,832,394,438
050,35,031,"New Mexico","McKinley County",1,52,829,397,432
050,35,031,"New Mexico","McKinley County",1,53,767,359,408
050,35,031,"New Mexico","McKinley County",1,54,807,386,421
050,35,031,"New Mexico","McKinley County",1,55,894,411,483
050,35,031,"New Mexico","McKinley County",1,56,926,423,503
050,35,031,"New Mexico","McKinley County",1,57,906,425,481
050,35,031,"New Mexico","McKinley County",1,58,894,410,484
050,35,031,"New Mexico","McKinley County",1,59,877,406,471
050,35,031,"New Mexico","McKinley County",1,60,835,396,439
050,35,031,"New Mexico","McKinley County",1,61,841,392,449
050,35,031,"New Mexico","McKinley County",1,62,848,398,450
050,35,031,"New Mexico","McKinley County",1,63,795,377,418
050,35,031,"New Mexico","McKinley County",1,64,767,337,430
050,35,031,"New Mexico","McKinley County",1,65,789,371,418
050,35,031,"New Mexico","McKinley County",1,66,692,312,380
050,35,031,"New Mexico","McKinley County",1,67,662,281,381
050,35,031,"New Mexico","McKinley County",1,68,656,289,367
050,35,031,"New Mexico","McKinley County",1,69,599,259,340
050,35,031,"New Mexico","McKinley County",1,70,560,235,325
050,35,031,"New Mexico","McKinley County",1,71,511,219,292
050,35,031,"New Mexico","McKinley County",1,72,481,201,280
050,35,031,"New Mexico","McKinley County",1,73,502,213,289
050,35,031,"New Mexico","McKinley County",1,74,370,160,210
050,35,031,"New Mexico","McKinley County",1,75,364,160,204
050,35,031,"New Mexico","McKinley County",1,76,323,134,189
050,35,031,"New Mexico","McKinley County",1,77,334,139,195
050,35,031,"New Mexico","McKinley County",1,78,298,129,169
050,35,031,"New Mexico","McKinley County",1,79,265,115,150
050,35,031,"New Mexico","McKinley County",1,80,247,101,146
050,35,031,"New Mexico","McKinley County",1,81,242,93,149
050,35,031,"New Mexico","McKinley County",1,82,210,71,139
050,35,031,"New Mexico","McKinley County",1,83,186,70,116
050,35,031,"New Mexico","McKinley County",1,84,159,59,100
050,35,031,"New Mexico","McKinley County",1,85,933,307,626
050,35,031,"New Mexico","McKinley County",2,0,873,445,428
050,35,031,"New Mexico","McKinley County",2,1,865,423,442
050,35,031,"New Mexico","McKinley County",2,2,813,401,412
050,35,031,"New Mexico","McKinley County",2,3,885,434,451
050,35,031,"New Mexico","McKinley County",2,4,987,490,497
050,35,031,"New Mexico","McKinley County",2,5,1100,549,551
050,35,031,"New Mexico","McKinley County",2,6,1174,595,579
050,35,031,"New Mexico","McKinley County",2,7,1214,614,600
050,35,031,"New Mexico","McKinley County",2,8,1249,641,608
050,35,031,"New Mexico","McKinley County",2,9,1226,643,583
050,35,031,"New Mexico","McKinley County",2,10,1216,617,599
050,35,031,"New Mexico","McKinley County",2,11,1239,623,616
050,35,031,"New Mexico","McKinley County",2,12,1296,665,631
050,35,031,"New Mexico","McKinley County",2,13,1300,669,631
050,35,031,"New Mexico","McKinley County",2,14,1258,649,609
050,35,031,"New Mexico","McKinley County",2,15,1237,629,608
050,35,031,"New Mexico","McKinley County",2,16,1185,599,586
050,35,031,"New Mexico","McKinley County",2,17,1139,577,562
050,35,031,"New Mexico","McKinley County",2,18,1047,529,518
050,35,031,"New Mexico","McKinley County",2,19,993,489,504
050,35,031,"New Mexico","McKinley County",2,20,964,484,480
050,35,031,"New Mexico","McKinley County",2,21,896,429,467
050,35,031,"New Mexico","McKinley County",2,22,899,427,472
050,35,031,"New Mexico","McKinley County",2,23,887,421,466
050,35,031,"New Mexico","McKinley County",2,24,908,450,458
050,35,031,"New Mexico","McKinley County",2,25,960,479,481
050,35,031,"New Mexico","McKinley County",2,26,1057,540,517
050,35,031,"New Mexico","McKinley County",2,27,1126,547,579
050,35,031,"New Mexico","McKinley County",2,28,1162,562,600
050,35,031,"New Mexico","McKinley County",2,29,1129,546,583
050,35,031,"New Mexico","McKinley County",2,30,1160,569,591
050,35,031,"New Mexico","McKinley County",2,31,1126,552,574
050,35,031,"New Mexico","McKinley County",2,32,1094,557,537
050,35,031,"New Mexico","McKinley County",2,33,1037,551,486
050,35,031,"New Mexico","McKinley County",2,34,1036,537,499
050,35,031,"New Mexico","McKinley County",2,35,1031,523,508
050,35,031,"New Mexico","McKinley County",2,36,946,467,479
050,35,031,"New Mexico","McKinley County",2,37,929,456,473
050,35,031,"New Mexico","McKinley County",2,38,920,482,438
050,35,031,"New Mexico","McKinley County",2,39,861,433,428
050,35,031,"New Mexico","McKinley County",2,40,847,417,430
050,35,031,"New Mexico","McKinley County",2,41,877,452,425
050,35,031,"New Mexico","McKinley County",2,42,880,439,441
050,35,031,"New Mexico","McKinley County",2,43,898,445,453
050,35,031,"New Mexico","McKinley County",2,44,819,408,411
050,35,031,"New Mexico","McKinley County",2,45,794,374,420
050,35,031,"New Mexico","McKinley County",2,46,781,353,428
050,35,031,"New Mexico","McKinley County",2,47,819,385,434
050,35,031,"New Mexico","McKinley County",2,48,816,399,417
050,35,031,"New Mexico","McKinley County",2,49,797,387,410
050,35,031,"New Mexico","McKinley County",2,50,791,378,413
050,35,031,"New Mexico","McKinley County",2,51,817,393,424
050,35,031,"New Mexico","McKinley County",2,52,821,397,424
050,35,031,"New Mexico","McKinley County",2,53,770,363,407
050,35,031,"New Mexico","McKinley County",2,54,788,377,411
050,35,031,"New Mexico","McKinley County",2,55,865,400,465
050,35,031,"New Mexico","McKinley County",2,56,918,419,499
050,35,031,"New Mexico","McKinley County",2,57,906,424,482
050,35,031,"New Mexico","McKinley County",2,58,886,406,480
050,35,031,"New Mexico","McKinley County",2,59,875,402,473
050,35,031,"New Mexico","McKinley County",2,60,841,399,442
050,35,031,"New Mexico","McKinley County",2,61,828,385,443
050,35,031,"New Mexico","McKinley County",2,62,832,387,445
050,35,031,"New Mexico","McKinley County",2,63,800,377,423
050,35,031,"New Mexico","McKinley County",2,64,757,336,421
050,35,031,"New Mexico","McKinley County",2,65,775,360,415
050,35,031,"New Mexico","McKinley County",2,66,703,316,387
050,35,031,"New Mexico","McKinley County",2,67,664,288,376
050,35,031,"New Mexico","McKinley County",2,68,640,277,363
050,35,031,"New Mexico","McKinley County",2,69,608,262,346
050,35,031,"New Mexico","McKinley County",2,70,567,238,329
050,35,031,"New Mexico","McKinley County",2,71,512,215,297
050,35,031,"New Mexico","McKinley County",2,72,480,200,280
050,35,031,"New Mexico","McKinley County",2,73,506,215,291
050,35,031,"New Mexico","McKinley County",2,74,380,161,219
050,35,031,"New Mexico","McKinley County",2,75,364,162,202
050,35,031,"New Mexico","McKinley County",2,76,325,135,190
050,35,031,"New Mexico","McKinley County",2,77,325,134,191
050,35,031,"New Mexico","McKinley County",2,78,296,123,173
050,35,031,"New Mexico","McKinley County",2,79,270,115,155
050,35,031,"New Mexico","McKinley County",2,80,244,104,140
050,35,031,"New Mexico","McKinley County",2,81,232,93,139
050,35,031,"New Mexico","McKinley County",2,82,212,71,141
050,35,031,"New Mexico","McKinley County",2,83,185,67,118
050,35,031,"New Mexico","McKinley County",2,84,161,58,103
050,35,031,"New Mexico","McKinley County",2,85,894,295,599
050,35,031,"New Mexico","McKinley County",3,0,754,361,393
050,35,031,"New Mexico","McKinley County",3,1,901,461,440
050,35,031,"New Mexico","McKinley County",3,2,854,418,436
050,35,031,"New Mexico","McKinley County",3,3,796,384,412
050,35,031,"New Mexico","McKinley County",3,4,863,425,438
050,35,031,"New Mexico","McKinley County",3,5,999,510,489
050,35,031,"New Mexico","McKinley County",3,6,1091,542,549
050,35,031,"New Mexico","McKinley County",3,7,1169,587,582
050,35,031,"New Mexico","McKinley County",3,8,1200,619,581
050,35,031,"New Mexico","McKinley County",3,9,1244,624,620
050,35,031,"New Mexico","McKinley County",3,10,1197,626,571
050,35,031,"New Mexico","McKinley County",3,11,1200,606,594
050,35,031,"New Mexico","McKinley County",3,12,1220,627,593
050,35,031,"New Mexico","McKinley County",3,13,1297,663,634
050,35,031,"New Mexico","McKinley County",3,14,1278,657,621
050,35,031,"New Mexico","McKinley County",3,15,1261,655,606
050,35,031,"New Mexico","McKinley County",3,16,1208,608,600
050,35,031,"New Mexico","McKinley County",3,17,1169,598,571
050,35,031,"New Mexico","McKinley County",3,18,1036,521,515
050,35,031,"New Mexico","McKinley County",3,19,969,475,494
050,35,031,"New Mexico","McKinley County",3,20,966,482,484
050,35,031,"New Mexico","McKinley County",3,21,930,459,471
050,35,031,"New Mexico","McKinley County",3,22,884,415,469
050,35,031,"New Mexico","McKinley County",3,23,878,425,453
050,35,031,"New Mexico","McKinley County",3,24,876,423,453
050,35,031,"New Mexico","McKinley County",3,25,893,445,448
050,35,031,"New Mexico","McKinley County",3,26,979,503,476
050,35,031,"New Mexico","McKinley County",3,27,1025,521,504
050,35,031,"New Mexico","McKinley County",3,28,1076,533,543
050,35,031,"New Mexico","McKinley County",3,29,1137,539,598
050,35,031,"New Mexico","McKinley County",3,30,1131,555,576
050,35,031,"New Mexico","McKinley County",3,31,1131,572,559
050,35,031,"New Mexico","McKinley County",3,32,1149,560,589
050,35,031,"New Mexico","McKinley County",3,33,1068,537,531
050,35,031,"New Mexico","McKinley County",3,34,1034,548,486
050,35,031,"New Mexico","McKinley County",3,35,1010,512,498
050,35,031,"New Mexico","McKinley County",3,36,997,501,496
050,35,031,"New Mexico","McKinley County",3,37,938,449,489
050,35,031,"New Mexico","McKinley County",3,38,917,461,456
050,35,031,"New Mexico","McKinley County",3,39,864,444,420
050,35,031,"New Mexico","McKinley County",3,40,835,417,418
050,35,031,"New Mexico","McKinley County",3,41,859,432,427
050,35,031,"New Mexico","McKinley County",3,42,854,426,428
050,35,031,"New Mexico","McKinley County",3,43,867,435,432
050,35,031,"New Mexico","McKinley County",3,44,898,443,455
050,35,031,"New Mexico","McKinley County",3,45,820,408,412
050,35,031,"New Mexico","McKinley County",3,46,783,367,416
050,35,031,"New Mexico","McKinley County",3,47,768,347,421
050,35,031,"New Mexico","McKinley County",3,48,803,377,426
050,35,031,"New Mexico","McKinley County",3,49,790,380,410
050,35,031,"New Mexico","McKinley County",3,50,798,374,424
050,35,031,"New Mexico","McKinley County",3,51,785,380,405
050,35,031,"New Mexico","McKinley County",3,52,802,396,406
050,35,031,"New Mexico","McKinley County",3,53,772,368,404
050,35,031,"New Mexico","McKinley County",3,54,744,341,403
050,35,031,"New Mexico","McKinley County",3,55,757,356,401
050,35,031,"New Mexico","McKinley County",3,56,861,402,459
050,35,031,"New Mexico","McKinley County",3,57,880,394,486
050,35,031,"New Mexico","McKinley County",3,58,883,411,472
050,35,031,"New Mexico","McKinley County",3,59,863,393,470
050,35,031,"New Mexico","McKinley County",3,60,847,393,454
050,35,031,"New Mexico","McKinley County",3,61,821,383,438
050,35,031,"New Mexico","McKinley County",3,62,789,358,431
050,35,031,"New Mexico","McKinley County",3,63,790,363,427
050,35,031,"New Mexico","McKinley County",3,64,762,348,414
050,35,031,"New Mexico","McKinley County",3,65,727,316,411
050,35,031,"New Mexico","McKinley County",3,66,747,336,411
050,35,031,"New Mexico","McKinley County",3,67,671,306,365
050,35,031,"New Mexico","McKinley County",3,68,641,283,358
050,35,031,"New Mexico","McKinley County",3,69,618,264,354
050,35,031,"New Mexico","McKinley County",3,70,579,245,334
050,35,031,"New Mexico","McKinley County",3,71,555,232,323
050,35,031,"New Mexico","McKinley County",3,72,485,201,284
050,35,031,"New Mexico","McKinley County",3,73,463,195,268
050,35,031,"New Mexico","McKinley County",3,74,475,199,276
050,35,031,"New Mexico","McKinley County",3,75,359,152,207
050,35,031,"New Mexico","McKinley County",3,76,342,145,197
050,35,031,"New Mexico","McKinley County",3,77,304,127,177
050,35,031,"New Mexico","McKinley County",3,78,300,114,186
050,35,031,"New Mexico","McKinley County",3,79,275,111,164
050,35,031,"New Mexico","McKinley County",3,80,243,103,140
050,35,031,"New Mexico","McKinley County",3,81,223,100,123
050,35,031,"New Mexico","McKinley County",3,82,209,80,129
050,35,031,"New Mexico","McKinley County",3,83,184,57,127
050,35,031,"New Mexico","McKinley County",3,84,179,64,115
050,35,031,"New Mexico","McKinley County",3,85,865,281,584
050,35,031,"New Mexico","McKinley County",4,0,758,367,391
050,35,031,"New Mexico","McKinley County",4,1,779,382,397
050,35,031,"New Mexico","McKinley County",4,2,863,431,432
050,35,031,"New Mexico","McKinley County",4,3,843,411,432
050,35,031,"New Mexico","McKinley County",4,4,799,394,405
050,35,031,"New Mexico","McKinley County",4,5,854,423,431
050,35,031,"New Mexico","McKinley County",4,6,965,490,475
050,35,031,"New Mexico","McKinley County",4,7,1076,533,543
050,35,031,"New Mexico","McKinley County",4,8,1160,587,573
050,35,031,"New Mexico","McKinley County",4,9,1167,608,559
050,35,031,"New Mexico","McKinley County",4,10,1213,616,597
050,35,031,"New Mexico","McKinley County",4,11,1161,608,553
050,35,031,"New Mexico","McKinley County",4,12,1179,597,582
050,35,031,"New Mexico","McKinley County",4,13,1184,610,574
050,35,031,"New Mexico","McKinley County",4,14,1293,659,634
050,35,031,"New Mexico","McKinley County",4,15,1268,658,610
050,35,031,"New Mexico","McKinley County",4,16,1214,634,580
050,35,031,"New Mexico","McKinley County",4,17,1170,604,566
050,35,031,"New Mexico","McKinley County",4,18,1054,537,517
050,35,031,"New Mexico","McKinley County",4,19,927,458,469
050,35,031,"New Mexico","McKinley County",4,20,912,455,457
050,35,031,"New Mexico","McKinley County",4,21,947,470,477
050,35,031,"New Mexico","McKinley County",4,22,906,447,459
050,35,031,"New Mexico","McKinley County",4,23,873,424,449
050,35,031,"New Mexico","McKinley County",4,24,850,412,438
050,35,031,"New Mexico","McKinley County",4,25,859,421,438
050,35,031,"New Mexico","McKinley County",4,26,907,472,435
050,35,031,"New Mexico","McKinley County",4,27,954,459,495
050,35,031,"New Mexico","McKinley County",4,28,977,497,480
050,35,031,"New Mexico","McKinley County",4,29,1003,492,511
050,35,031,"New Mexico","McKinley County",4,30,1090,518,572
050,35,031,"New Mexico","McKinley County",4,31,1090,531,559
050,35,031,"New Mexico","McKinley County",4,32,1093,547,546
050,35,031,"New Mexico","McKinley County",4,33,1104,539,565
050,35,031,"New Mexico","McKinley County",4,34,1038,517,521
050,35,031,"New Mexico","McKinley County",4,35,1017,543,474
050,35,031,"New Mexico","McKinley County",4,36,986,493,493
050,35,031,"New Mexico","McKinley County",4,37,977,482,495
050,35,031,"New Mexico","McKinley County",4,38,937,463,474
050,35,031,"New Mexico","McKinley County",4,39,897,444,453
050,35,031,"New Mexico","McKinley County",4,40,827,421,406
050,35,031,"New Mexico","McKinley County",4,41,837,429,408
050,35,031,"New Mexico","McKinley County",4,42,830,408,422
050,35,031,"New Mexico","McKinley County",4,43,808,403,405
050,35,031,"New Mexico","McKinley County",4,44,859,428,431
050,35,031,"New Mexico","McKinley County",4,45,886,438,448
050,35,031,"New Mexico","McKinley County",4,46,791,387,404
050,35,031,"New Mexico","McKinley County",4,47,740,356,384
050,35,031,"New Mexico","McKinley County",4,48,761,347,414
050,35,031,"New Mexico","McKinley County",4,49,774,356,418
050,35,031,"New Mexico","McKinley County",4,50,782,367,415
050,35,031,"New Mexico","McKinley County",4,51,774,360,414
050,35,031,"New Mexico","McKinley County",4,52,768,381,387
050,35,031,"New Mexico","McKinley County",4,53,778,382,396
050,35,031,"New Mexico","McKinley County",4,54,772,375,397
050,35,031,"New Mexico","McKinley County",4,55,720,318,402
050,35,031,"New Mexico","McKinley County",4,56,735,338,397
050,35,031,"New Mexico","McKinley County",4,57,838,386,452
050,35,031,"New Mexico","McKinley County",4,58,859,386,473
050,35,031,"New Mexico","McKinley County",4,59,879,402,477
050,35,031,"New Mexico","McKinley County",4,60,834,371,463
050,35,031,"New Mexico","McKinley County",4,61,807,365,442
050,35,031,"New Mexico","McKinley County",4,62,791,360,431
050,35,031,"New Mexico","McKinley County",4,63,756,343,413
050,35,031,"New Mexico","McKinley County",4,64,781,353,428
050,35,031,"New Mexico","McKinley County",4,65,727,330,397
050,35,031,"New Mexico","McKinley County",4,66,694,296,398
050,35,031,"New Mexico","McKinley County",4,67,714,322,392
050,35,031,"New Mexico","McKinley County",4,68,655,306,349
050,35,031,"New Mexico","McKinley County",4,69,638,275,363
050,35,031,"New Mexico","McKinley County",4,70,596,253,343
050,35,031,"New Mexico","McKinley County",4,71,563,236,327
050,35,031,"New Mexico","McKinley County",4,72,529,221,308
050,35,031,"New Mexico","McKinley County",4,73,477,198,279
050,35,031,"New Mexico","McKinley County",4,74,426,174,252
050,35,031,"New Mexico","McKinley County",4,75,461,192,269
050,35,031,"New Mexico","McKinley County",4,76,330,134,196
050,35,031,"New Mexico","McKinley County",4,77,320,132,188
050,35,031,"New Mexico","McKinley County",4,78,280,109,171
050,35,031,"New Mexico","McKinley County",4,79,283,110,173
050,35,031,"New Mexico","McKinley County",4,80,252,102,150
050,35,031,"New Mexico","McKinley County",4,81,228,96,132
050,35,031,"New Mexico","McKinley County",4,82,202,91,111
050,35,031,"New Mexico","McKinley County",4,83,189,75,114
050,35,031,"New Mexico","McKinley County",4,84,172,54,118
050,35,031,"New Mexico","McKinley County",4,85,864,269,595
050,35,031,"New Mexico","McKinley County",5,0,754,364,390
050,35,031,"New Mexico","McKinley County",5,1,734,359,375
050,35,031,"New Mexico","McKinley County",5,2,775,384,391
050,35,031,"New Mexico","McKinley County",5,3,845,424,421
050,35,031,"New Mexico","McKinley County",5,4,825,398,427
050,35,031,"New Mexico","McKinley County",5,5,797,380,417
050,35,031,"New Mexico","McKinley County",5,6,870,428,442
050,35,031,"New Mexico","McKinley County",5,7,940,472,468
050,35,031,"New Mexico","McKinley County",5,8,1075,537,538
050,35,031,"New Mexico","McKinley County",5,9,1131,577,554
050,35,031,"New Mexico","McKinley County",5,10,1144,593,551
050,35,031,"New Mexico","McKinley County",5,11,1205,610,595
050,35,031,"New Mexico","McKinley County",5,12,1143,594,549
050,35,031,"New Mexico","McKinley County",5,13,1161,591,570
050,35,031,"New Mexico","McKinley County",5,14,1197,620,577
050,35,031,"New Mexico","McKinley County",5,15,1252,642,610
050,35,031,"New Mexico","McKinley County",5,16,1273,670,603
050,35,031,"New Mexico","McKinley County",5,17,1210,640,570
050,35,031,"New Mexico","McKinley County",5,18,1058,550,508
050,35,031,"New Mexico","McKinley County",5,19,949,486,463
050,35,031,"New Mexico","McKinley County",5,20,893,447,446
050,35,031,"New Mexico","McKinley County",5,21,892,450,442
050,35,031,"New Mexico","McKinley County",5,22,924,461,463
050,35,031,"New Mexico","McKinley County",5,23,896,455,441
050,35,031,"New Mexico","McKinley County",5,24,837,413,424
050,35,031,"New Mexico","McKinley County",5,25,819,394,425
050,35,031,"New Mexico","McKinley County",5,26,863,434,429
050,35,031,"New Mexico","McKinley County",5,27,846,420,426
050,35,031,"New Mexico","McKinley County",5,28,930,455,475
050,35,031,"New Mexico","McKinley County",5,29,948,477,471
050,35,031,"New Mexico","McKinley County",5,30,1013,492,521
050,35,031,"New Mexico","McKinley County",5,31,1053,492,561
050,35,031,"New Mexico","McKinley County",5,32,1070,518,552
050,35,031,"New Mexico","McKinley County",5,33,1052,541,511
050,35,031,"New Mexico","McKinley County",5,34,1066,526,540
050,35,031,"New Mexico","McKinley County",5,35,1033,515,518
050,35,031,"New Mexico","McKinley County",5,36,984,530,454
050,35,031,"New Mexico","McKinley County",5,37,973,482,491
050,35,031,"New Mexico","McKinley County",5,38,972,495,477
050,35,031,"New Mexico","McKinley County",5,39,897,432,465
050,35,031,"New Mexico","McKinley County",5,40,857,416,441
050,35,031,"New Mexico","McKinley County",5,41,819,419,400
050,35,031,"New Mexico","McKinley County",5,42,830,419,411
050,35,031,"New Mexico","McKinley County",5,43,820,400,420
050,35,031,"New Mexico","McKinley County",5,44,798,393,405
050,35,031,"New Mexico","McKinley County",5,45,853,425,428
050,35,031,"New Mexico","McKinley County",5,46,864,425,439
050,35,031,"New Mexico","McKinley County",5,47,765,380,385
050,35,031,"New Mexico","McKinley County",5,48,721,342,379
050,35,031,"New Mexico","McKinley County",5,49,730,327,403
050,35,031,"New Mexico","McKinley County",5,50,763,344,419
050,35,031,"New Mexico","McKinley County",5,51,763,359,404
050,35,031,"New Mexico","McKinley County",5,52,758,349,409
050,35,031,"New Mexico","McKinley County",5,53,750,357,393
050,35,031,"New Mexico","McKinley County",5,54,766,378,388
050,35,031,"New Mexico","McKinley County",5,55,743,350,393
050,35,031,"New Mexico","McKinley County",5,56,718,314,404
050,35,031,"New Mexico","McKinley County",5,57,700,318,382
050,35,031,"New Mexico","McKinley County",5,58,819,376,443
050,35,031,"New Mexico","McKinley County",5,59,840,367,473
050,35,031,"New Mexico","McKinley County",5,60,854,389,465
050,35,031,"New Mexico","McKinley County",5,61,807,360,447
050,35,031,"New Mexico","McKinley County",5,62,785,349,436
050,35,031,"New Mexico","McKinley County",5,63,767,346,421
050,35,031,"New Mexico","McKinley County",5,64,750,340,410
050,35,031,"New Mexico","McKinley County",5,65,748,338,410
050,35,031,"New Mexico","McKinley County",5,66,690,311,379
050,35,031,"New Mexico","McKinley County",5,67,681,292,389
050,35,031,"New Mexico","McKinley County",5,68,705,321,384
050,35,031,"New Mexico","McKinley County",5,69,654,306,348
050,35,031,"New Mexico","McKinley County",5,70,601,258,343
050,35,031,"New Mexico","McKinley County",5,71,582,248,334
050,35,031,"New Mexico","McKinley County",5,72,555,237,318
050,35,031,"New Mexico","McKinley County",5,73,516,215,301
050,35,031,"New Mexico","McKinley County",5,74,446,175,271
050,35,031,"New Mexico","McKinley County",5,75,416,171,245
050,35,031,"New Mexico","McKinley County",5,76,431,174,257
050,35,031,"New Mexico","McKinley County",5,77,310,119,191
050,35,031,"New Mexico","McKinley County",5,78,305,117,188
050,35,031,"New Mexico","McKinley County",5,79,264,102,162
050,35,031,"New Mexico","McKinley County",5,80,267,104,163
050,35,031,"New Mexico","McKinley County",5,81,244,99,145
050,35,031,"New Mexico","McKinley County",5,82,206,85,121
050,35,031,"New Mexico","McKinley County",5,83,178,80,98
050,35,031,"New Mexico","McKinley County",5,84,180,70,110
050,35,031,"New Mexico","McKinley County",5,85,879,254,625
050,35,033,"New Mexico","Mora County",1,0,30,15,15
050,35,033,"New Mexico","Mora County",1,1,29,15,14
050,35,033,"New Mexico","Mora County",1,2,38,20,18
050,35,033,"New Mexico","Mora County",1,3,39,25,14
050,35,033,"New Mexico","Mora County",1,4,42,19,23
050,35,033,"New Mexico","Mora County",1,5,39,16,23
050,35,033,"New Mexico","Mora County",1,6,36,16,20
050,35,033,"New Mexico","Mora County",1,7,39,21,18
050,35,033,"New Mexico","Mora County",1,8,47,21,26
050,35,033,"New Mexico","Mora County",1,9,36,17,19
050,35,033,"New Mexico","Mora County",1,10,35,18,17
050,35,033,"New Mexico","Mora County",1,11,41,20,21
050,35,033,"New Mexico","Mora County",1,12,34,19,15
050,35,033,"New Mexico","Mora County",1,13,37,22,15
050,35,033,"New Mexico","Mora County",1,14,40,20,20
050,35,033,"New Mexico","Mora County",1,15,43,22,21
050,35,033,"New Mexico","Mora County",1,16,49,23,26
050,35,033,"New Mexico","Mora County",1,17,41,20,21
050,35,033,"New Mexico","Mora County",1,18,49,30,19
050,35,033,"New Mexico","Mora County",1,19,49,30,19
050,35,033,"New Mexico","Mora County",1,20,48,26,22
050,35,033,"New Mexico","Mora County",1,21,37,17,20
050,35,033,"New Mexico","Mora County",1,22,36,19,17
050,35,033,"New Mexico","Mora County",1,23,33,20,13
050,35,033,"New Mexico","Mora County",1,24,35,23,12
050,35,033,"New Mexico","Mora County",1,25,38,22,16
050,35,033,"New Mexico","Mora County",1,26,41,22,19
050,35,033,"New Mexico","Mora County",1,27,40,19,21
050,35,033,"New Mexico","Mora County",1,28,41,22,19
050,35,033,"New Mexico","Mora County",1,29,33,12,21
050,35,033,"New Mexico","Mora County",1,30,31,12,19
050,35,033,"New Mexico","Mora County",1,31,38,21,17
050,35,033,"New Mexico","Mora County",1,32,36,23,13
050,35,033,"New Mexico","Mora County",1,33,34,16,18
050,35,033,"New Mexico","Mora County",1,34,31,16,15
050,35,033,"New Mexico","Mora County",1,35,37,20,17
050,35,033,"New Mexico","Mora County",1,36,46,27,19
050,35,033,"New Mexico","Mora County",1,37,42,21,21
050,35,033,"New Mexico","Mora County",1,38,48,24,24
050,35,033,"New Mexico","Mora County",1,39,46,22,24
050,35,033,"New Mexico","Mora County",1,40,58,27,31
050,35,033,"New Mexico","Mora County",1,41,41,20,21
050,35,033,"New Mexico","Mora County",1,42,33,16,17
050,35,033,"New Mexico","Mora County",1,43,39,23,16
050,35,033,"New Mexico","Mora County",1,44,39,21,18
050,35,033,"New Mexico","Mora County",1,45,31,16,15
050,35,033,"New Mexico","Mora County",1,46,33,14,19
050,35,033,"New Mexico","Mora County",1,47,39,22,17
050,35,033,"New Mexico","Mora County",1,48,47,25,22
050,35,033,"New Mexico","Mora County",1,49,45,23,22
050,35,033,"New Mexico","Mora County",1,50,51,25,26
050,35,033,"New Mexico","Mora County",1,51,48,22,26
050,35,033,"New Mexico","Mora County",1,52,44,20,24
050,35,033,"New Mexico","Mora County",1,53,58,33,25
050,35,033,"New Mexico","Mora County",1,54,61,28,33
050,35,033,"New Mexico","Mora County",1,55,64,28,36
050,35,033,"New Mexico","Mora County",1,56,56,26,30
050,35,033,"New Mexico","Mora County",1,57,57,30,27
050,35,033,"New Mexico","Mora County",1,58,69,41,28
050,35,033,"New Mexico","Mora County",1,59,76,43,33
050,35,033,"New Mexico","Mora County",1,60,79,39,40
050,35,033,"New Mexico","Mora County",1,61,81,36,45
050,35,033,"New Mexico","Mora County",1,62,85,47,38
050,35,033,"New Mexico","Mora County",1,63,64,33,31
050,35,033,"New Mexico","Mora County",1,64,76,39,37
050,35,033,"New Mexico","Mora County",1,65,77,35,42
050,35,033,"New Mexico","Mora County",1,66,67,35,32
050,35,033,"New Mexico","Mora County",1,67,83,34,49
050,35,033,"New Mexico","Mora County",1,68,97,56,41
050,35,033,"New Mexico","Mora County",1,69,84,53,31
050,35,033,"New Mexico","Mora County",1,70,69,42,27
050,35,033,"New Mexico","Mora County",1,71,81,46,35
050,35,033,"New Mexico","Mora County",1,72,74,37,37
050,35,033,"New Mexico","Mora County",1,73,63,30,33
050,35,033,"New Mexico","Mora County",1,74,49,26,23
050,35,033,"New Mexico","Mora County",1,75,59,34,25
050,35,033,"New Mexico","Mora County",1,76,48,29,19
050,35,033,"New Mexico","Mora County",1,77,41,27,14
050,35,033,"New Mexico","Mora County",1,78,31,18,13
050,35,033,"New Mexico","Mora County",1,79,30,13,17
050,35,033,"New Mexico","Mora County",1,80,40,18,22
050,35,033,"New Mexico","Mora County",1,81,38,21,17
050,35,033,"New Mexico","Mora County",1,82,27,12,15
050,35,033,"New Mexico","Mora County",1,83,29,12,17
050,35,033,"New Mexico","Mora County",1,84,21,11,10
050,35,033,"New Mexico","Mora County",1,85,138,62,76
050,35,033,"New Mexico","Mora County",2,0,38,21,17
050,35,033,"New Mexico","Mora County",2,1,29,15,14
050,35,033,"New Mexico","Mora County",2,2,35,19,16
050,35,033,"New Mexico","Mora County",2,3,38,23,15
050,35,033,"New Mexico","Mora County",2,4,40,20,20
050,35,033,"New Mexico","Mora County",2,5,40,17,23
050,35,033,"New Mexico","Mora County",2,6,35,16,19
050,35,033,"New Mexico","Mora County",2,7,38,20,18
050,35,033,"New Mexico","Mora County",2,8,45,21,24
050,35,033,"New Mexico","Mora County",2,9,37,17,20
050,35,033,"New Mexico","Mora County",2,10,34,17,17
050,35,033,"New Mexico","Mora County",2,11,40,20,20
050,35,033,"New Mexico","Mora County",2,12,37,20,17
050,35,033,"New Mexico","Mora County",2,13,37,21,16
050,35,033,"New Mexico","Mora County",2,14,38,19,19
050,35,033,"New Mexico","Mora County",2,15,43,22,21
050,35,033,"New Mexico","Mora County",2,16,46,22,24
050,35,033,"New Mexico","Mora County",2,17,42,21,21
050,35,033,"New Mexico","Mora County",2,18,46,27,19
050,35,033,"New Mexico","Mora County",2,19,48,30,18
050,35,033,"New Mexico","Mora County",2,20,49,27,22
050,35,033,"New Mexico","Mora County",2,21,39,19,20
050,35,033,"New Mexico","Mora County",2,22,34,18,16
050,35,033,"New Mexico","Mora County",2,23,34,20,14
050,35,033,"New Mexico","Mora County",2,24,35,22,13
050,35,033,"New Mexico","Mora County",2,25,39,23,16
050,35,033,"New Mexico","Mora County",2,26,41,23,18
050,35,033,"New Mexico","Mora County",2,27,39,19,20
050,35,033,"New Mexico","Mora County",2,28,40,20,20
050,35,033,"New Mexico","Mora County",2,29,33,13,20
050,35,033,"New Mexico","Mora County",2,30,32,12,20
050,35,033,"New Mexico","Mora County",2,31,36,18,18
050,35,033,"New Mexico","Mora County",2,32,37,23,14
050,35,033,"New Mexico","Mora County",2,33,35,18,17
050,35,033,"New Mexico","Mora County",2,34,32,16,16
050,35,033,"New Mexico","Mora County",2,35,36,19,17
050,35,033,"New Mexico","Mora County",2,36,43,25,18
050,35,033,"New Mexico","Mora County",2,37,43,23,20
050,35,033,"New Mexico","Mora County",2,38,47,24,23
050,35,033,"New Mexico","Mora County",2,39,47,23,24
050,35,033,"New Mexico","Mora County",2,40,58,27,31
050,35,033,"New Mexico","Mora County",2,41,44,21,23
050,35,033,"New Mexico","Mora County",2,42,35,17,18
050,35,033,"New Mexico","Mora County",2,43,39,22,17
050,35,033,"New Mexico","Mora County",2,44,39,22,17
050,35,033,"New Mexico","Mora County",2,45,32,17,15
050,35,033,"New Mexico","Mora County",2,46,32,15,17
050,35,033,"New Mexico","Mora County",2,47,36,19,17
050,35,033,"New Mexico","Mora County",2,48,47,26,21
050,35,033,"New Mexico","Mora County",2,49,45,23,22
050,35,033,"New Mexico","Mora County",2,50,48,24,24
050,35,033,"New Mexico","Mora County",2,51,49,21,28
050,35,033,"New Mexico","Mora County",2,52,44,20,24
050,35,033,"New Mexico","Mora County",2,53,54,29,25
050,35,033,"New Mexico","Mora County",2,54,61,29,32
050,35,033,"New Mexico","Mora County",2,55,64,29,35
050,35,033,"New Mexico","Mora County",2,56,60,27,33
050,35,033,"New Mexico","Mora County",2,57,58,30,28
050,35,033,"New Mexico","Mora County",2,58,67,40,27
050,35,033,"New Mexico","Mora County",2,59,76,43,33
050,35,033,"New Mexico","Mora County",2,60,79,41,38
050,35,033,"New Mexico","Mora County",2,61,82,38,44
050,35,033,"New Mexico","Mora County",2,62,81,43,38
050,35,033,"New Mexico","Mora County",2,63,68,36,32
050,35,033,"New Mexico","Mora County",2,64,73,37,36
050,35,033,"New Mexico","Mora County",2,65,79,37,42
050,35,033,"New Mexico","Mora County",2,66,70,36,34
050,35,033,"New Mexico","Mora County",2,67,79,34,45
050,35,033,"New Mexico","Mora County",2,68,92,50,42
050,35,033,"New Mexico","Mora County",2,69,89,55,34
050,35,033,"New Mexico","Mora County",2,70,74,45,29
050,35,033,"New Mexico","Mora County",2,71,78,45,33
050,35,033,"New Mexico","Mora County",2,72,73,37,36
050,35,033,"New Mexico","Mora County",2,73,68,33,35
050,35,033,"New Mexico","Mora County",2,74,50,26,24
050,35,033,"New Mexico","Mora County",2,75,57,32,25
050,35,033,"New Mexico","Mora County",2,76,50,30,20
050,35,033,"New Mexico","Mora County",2,77,43,28,15
050,35,033,"New Mexico","Mora County",2,78,34,20,14
050,35,033,"New Mexico","Mora County",2,79,30,14,16
050,35,033,"New Mexico","Mora County",2,80,38,17,21
050,35,033,"New Mexico","Mora County",2,81,38,20,18
050,35,033,"New Mexico","Mora County",2,82,30,14,16
050,35,033,"New Mexico","Mora County",2,83,29,12,17
050,35,033,"New Mexico","Mora County",2,84,22,11,11
050,35,033,"New Mexico","Mora County",2,85,140,63,77
050,35,033,"New Mexico","Mora County",3,0,29,13,16
050,35,033,"New Mexico","Mora County",3,1,40,21,19
050,35,033,"New Mexico","Mora County",3,2,33,17,16
050,35,033,"New Mexico","Mora County",3,3,33,20,13
050,35,033,"New Mexico","Mora County",3,4,41,23,18
050,35,033,"New Mexico","Mora County",3,5,41,22,19
050,35,033,"New Mexico","Mora County",3,6,33,15,18
050,35,033,"New Mexico","Mora County",3,7,38,17,21
050,35,033,"New Mexico","Mora County",3,8,41,19,22
050,35,033,"New Mexico","Mora County",3,9,48,23,25
050,35,033,"New Mexico","Mora County",3,10,36,16,20
050,35,033,"New Mexico","Mora County",3,11,37,19,18
050,35,033,"New Mexico","Mora County",3,12,36,19,17
050,35,033,"New Mexico","Mora County",3,13,36,18,18
050,35,033,"New Mexico","Mora County",3,14,38,21,17
050,35,033,"New Mexico","Mora County",3,15,37,18,19
050,35,033,"New Mexico","Mora County",3,16,41,22,19
050,35,033,"New Mexico","Mora County",3,17,47,21,26
050,35,033,"New Mexico","Mora County",3,18,38,17,21
050,35,033,"New Mexico","Mora County",3,19,44,26,18
050,35,033,"New Mexico","Mora County",3,20,48,30,18
050,35,033,"New Mexico","Mora County",3,21,45,26,19
050,35,033,"New Mexico","Mora County",3,22,36,19,17
050,35,033,"New Mexico","Mora County",3,23,32,17,15
050,35,033,"New Mexico","Mora County",3,24,36,21,15
050,35,033,"New Mexico","Mora County",3,25,34,19,15
050,35,033,"New Mexico","Mora County",3,26,35,21,14
050,35,033,"New Mexico","Mora County",3,27,41,20,21
050,35,033,"New Mexico","Mora County",3,28,40,18,22
050,35,033,"New Mexico","Mora County",3,29,39,19,20
050,35,033,"New Mexico","Mora County",3,30,38,18,20
050,35,033,"New Mexico","Mora County",3,31,26,10,16
050,35,033,"New Mexico","Mora County",3,32,38,16,22
050,35,033,"New Mexico","Mora County",3,33,36,21,15
050,35,033,"New Mexico","Mora County",3,34,42,22,20
050,35,033,"New Mexico","Mora County",3,35,35,19,16
050,35,033,"New Mexico","Mora County",3,36,35,20,15
050,35,033,"New Mexico","Mora County",3,37,39,23,16
050,35,033,"New Mexico","Mora County",3,38,40,22,18
050,35,033,"New Mexico","Mora County",3,39,46,23,23
050,35,033,"New Mexico","Mora County",3,40,46,22,24
050,35,033,"New Mexico","Mora County",3,41,57,28,29
050,35,033,"New Mexico","Mora County",3,42,40,19,21
050,35,033,"New Mexico","Mora County",3,43,39,17,22
050,35,033,"New Mexico","Mora County",3,44,44,22,22
050,35,033,"New Mexico","Mora County",3,45,38,20,18
050,35,033,"New Mexico","Mora County",3,46,32,17,15
050,35,033,"New Mexico","Mora County",3,47,32,13,19
050,35,033,"New Mexico","Mora County",3,48,38,23,15
050,35,033,"New Mexico","Mora County",3,49,47,25,22
050,35,033,"New Mexico","Mora County",3,50,45,22,23
050,35,033,"New Mexico","Mora County",3,51,51,25,26
050,35,033,"New Mexico","Mora County",3,52,50,21,29
050,35,033,"New Mexico","Mora County",3,53,43,19,24
050,35,033,"New Mexico","Mora County",3,54,52,27,25
050,35,033,"New Mexico","Mora County",3,55,62,29,33
050,35,033,"New Mexico","Mora County",3,56,68,32,36
050,35,033,"New Mexico","Mora County",3,57,66,29,37
050,35,033,"New Mexico","Mora County",3,58,59,33,26
050,35,033,"New Mexico","Mora County",3,59,71,42,29
050,35,033,"New Mexico","Mora County",3,60,76,41,35
050,35,033,"New Mexico","Mora County",3,61,81,42,39
050,35,033,"New Mexico","Mora County",3,62,79,36,43
050,35,033,"New Mexico","Mora County",3,63,84,44,40
050,35,033,"New Mexico","Mora County",3,64,67,37,30
050,35,033,"New Mexico","Mora County",3,65,74,37,37
050,35,033,"New Mexico","Mora County",3,66,81,40,41
050,35,033,"New Mexico","Mora County",3,67,69,34,35
050,35,033,"New Mexico","Mora County",3,68,76,34,42
050,35,033,"New Mexico","Mora County",3,69,90,48,42
050,35,033,"New Mexico","Mora County",3,70,88,55,33
050,35,033,"New Mexico","Mora County",3,71,69,44,25
050,35,033,"New Mexico","Mora County",3,72,77,45,32
050,35,033,"New Mexico","Mora County",3,73,74,39,35
050,35,033,"New Mexico","Mora County",3,74,65,31,34
050,35,033,"New Mexico","Mora County",3,75,50,26,24
050,35,033,"New Mexico","Mora County",3,76,56,32,24
050,35,033,"New Mexico","Mora County",3,77,47,28,19
050,35,033,"New Mexico","Mora County",3,78,42,27,15
050,35,033,"New Mexico","Mora County",3,79,33,19,14
050,35,033,"New Mexico","Mora County",3,80,30,14,16
050,35,033,"New Mexico","Mora County",3,81,38,18,20
050,35,033,"New Mexico","Mora County",3,82,37,19,18
050,35,033,"New Mexico","Mora County",3,83,30,14,16
050,35,033,"New Mexico","Mora County",3,84,28,11,17
050,35,033,"New Mexico","Mora County",3,85,140,64,76
050,35,033,"New Mexico","Mora County",4,0,28,11,17
050,35,033,"New Mexico","Mora County",4,1,24,8,16
050,35,033,"New Mexico","Mora County",4,2,42,25,17
050,35,033,"New Mexico","Mora County",4,3,29,16,13
050,35,033,"New Mexico","Mora County",4,4,31,16,15
050,35,033,"New Mexico","Mora County",4,5,40,21,19
050,35,033,"New Mexico","Mora County",4,6,42,23,19
050,35,033,"New Mexico","Mora County",4,7,38,16,22
050,35,033,"New Mexico","Mora County",4,8,39,16,23
050,35,033,"New Mexico","Mora County",4,9,37,18,19
050,35,033,"New Mexico","Mora County",4,10,44,22,22
050,35,033,"New Mexico","Mora County",4,11,35,16,19
050,35,033,"New Mexico","Mora County",4,12,37,17,20
050,35,033,"New Mexico","Mora County",4,13,35,18,17
050,35,033,"New Mexico","Mora County",4,14,37,18,19
050,35,033,"New Mexico","Mora County",4,15,41,23,18
050,35,033,"New Mexico","Mora County",4,16,39,20,19
050,35,033,"New Mexico","Mora County",4,17,41,22,19
050,35,033,"New Mexico","Mora County",4,18,47,23,24
050,35,033,"New Mexico","Mora County",4,19,38,16,22
050,35,033,"New Mexico","Mora County",4,20,42,25,17
050,35,033,"New Mexico","Mora County",4,21,51,32,19
050,35,033,"New Mexico","Mora County",4,22,46,28,18
050,35,033,"New Mexico","Mora County",4,23,36,19,17
050,35,033,"New Mexico","Mora County",4,24,30,15,15
050,35,033,"New Mexico","Mora County",4,25,29,15,14
050,35,033,"New Mexico","Mora County",4,26,29,16,13
050,35,033,"New Mexico","Mora County",4,27,35,20,15
050,35,033,"New Mexico","Mora County",4,28,43,23,20
050,35,033,"New Mexico","Mora County",4,29,37,17,20
050,35,033,"New Mexico","Mora County",4,30,38,16,22
050,35,033,"New Mexico","Mora County",4,31,26,11,15
050,35,033,"New Mexico","Mora County",4,32,27,11,16
050,35,033,"New Mexico","Mora County",4,33,38,16,22
050,35,033,"New Mexico","Mora County",4,34,40,23,17
050,35,033,"New Mexico","Mora County",4,35,37,20,17
050,35,033,"New Mexico","Mora County",4,36,30,15,15
050,35,033,"New Mexico","Mora County",4,37,35,20,15
050,35,033,"New Mexico","Mora County",4,38,45,30,15
050,35,033,"New Mexico","Mora County",4,39,42,24,18
050,35,033,"New Mexico","Mora County",4,40,43,22,21
050,35,033,"New Mexico","Mora County",4,41,45,21,24
050,35,033,"New Mexico","Mora County",4,42,51,25,26
050,35,033,"New Mexico","Mora County",4,43,43,20,23
050,35,033,"New Mexico","Mora County",4,44,40,18,22
050,35,033,"New Mexico","Mora County",4,45,47,24,23
050,35,033,"New Mexico","Mora County",4,46,37,18,19
050,35,033,"New Mexico","Mora County",4,47,33,18,15
050,35,033,"New Mexico","Mora County",4,48,34,13,21
050,35,033,"New Mexico","Mora County",4,49,38,23,15
050,35,033,"New Mexico","Mora County",4,50,46,25,21
050,35,033,"New Mexico","Mora County",4,51,44,21,23
050,35,033,"New Mexico","Mora County",4,52,49,23,26
050,35,033,"New Mexico","Mora County",4,53,50,21,29
050,35,033,"New Mexico","Mora County",4,54,43,19,24
050,35,033,"New Mexico","Mora County",4,55,50,25,25
050,35,033,"New Mexico","Mora County",4,56,61,29,32
050,35,033,"New Mexico","Mora County",4,57,69,32,37
050,35,033,"New Mexico","Mora County",4,58,66,31,35
050,35,033,"New Mexico","Mora County",4,59,63,33,30
050,35,033,"New Mexico","Mora County",4,60,73,43,30
050,35,033,"New Mexico","Mora County",4,61,76,42,34
050,35,033,"New Mexico","Mora County",4,62,79,41,38
050,35,033,"New Mexico","Mora County",4,63,72,33,39
050,35,033,"New Mexico","Mora County",4,64,86,41,45
050,35,033,"New Mexico","Mora County",4,65,70,39,31
050,35,033,"New Mexico","Mora County",4,66,73,36,37
050,35,033,"New Mexico","Mora County",4,67,87,42,45
050,35,033,"New Mexico","Mora County",4,68,76,37,39
050,35,033,"New Mexico","Mora County",4,69,77,37,40
050,35,033,"New Mexico","Mora County",4,70,89,47,42
050,35,033,"New Mexico","Mora County",4,71,87,56,31
050,35,033,"New Mexico","Mora County",4,72,67,41,26
050,35,033,"New Mexico","Mora County",4,73,77,44,33
050,35,033,"New Mexico","Mora County",4,74,74,39,35
050,35,033,"New Mexico","Mora County",4,75,65,31,34
050,35,033,"New Mexico","Mora County",4,76,49,25,24
050,35,033,"New Mexico","Mora County",4,77,54,33,21
050,35,033,"New Mexico","Mora County",4,78,47,28,19
050,35,033,"New Mexico","Mora County",4,79,34,24,10
050,35,033,"New Mexico","Mora County",4,80,31,17,14
050,35,033,"New Mexico","Mora County",4,81,27,14,13
050,35,033,"New Mexico","Mora County",4,82,32,15,17
050,35,033,"New Mexico","Mora County",4,83,35,18,17
050,35,033,"New Mexico","Mora County",4,84,29,14,15
050,35,033,"New Mexico","Mora County",4,85,149,70,79
050,35,033,"New Mexico","Mora County",5,0,28,11,17
050,35,033,"New Mexico","Mora County",5,1,34,15,19
050,35,033,"New Mexico","Mora County",5,2,28,11,17
050,35,033,"New Mexico","Mora County",5,3,39,23,16
050,35,033,"New Mexico","Mora County",5,4,36,21,15
050,35,033,"New Mexico","Mora County",5,5,35,19,16
050,35,033,"New Mexico","Mora County",5,6,40,20,20
050,35,033,"New Mexico","Mora County",5,7,44,24,20
050,35,033,"New Mexico","Mora County",5,8,38,16,22
050,35,033,"New Mexico","Mora County",5,9,41,18,23
050,35,033,"New Mexico","Mora County",5,10,39,19,20
050,35,033,"New Mexico","Mora County",5,11,44,25,19
050,35,033,"New Mexico","Mora County",5,12,38,18,20
050,35,033,"New Mexico","Mora County",5,13,37,17,20
050,35,033,"New Mexico","Mora County",5,14,34,15,19
050,35,033,"New Mexico","Mora County",5,15,34,18,16
050,35,033,"New Mexico","Mora County",5,16,42,23,19
050,35,033,"New Mexico","Mora County",5,17,38,21,17
050,35,033,"New Mexico","Mora County",5,18,41,23,18
050,35,033,"New Mexico","Mora County",5,19,40,19,21
050,35,033,"New Mexico","Mora County",5,20,33,16,17
050,35,033,"New Mexico","Mora County",5,21,39,23,16
050,35,033,"New Mexico","Mora County",5,22,45,28,17
050,35,033,"New Mexico","Mora County",5,23,46,29,17
050,35,033,"New Mexico","Mora County",5,24,40,22,18
050,35,033,"New Mexico","Mora County",5,25,34,18,16
050,35,033,"New Mexico","Mora County",5,26,28,16,12
050,35,033,"New Mexico","Mora County",5,27,28,15,13
050,35,033,"New Mexico","Mora County",5,28,32,19,13
050,35,033,"New Mexico","Mora County",5,29,42,21,21
050,35,033,"New Mexico","Mora County",5,30,37,18,19
050,35,033,"New Mexico","Mora County",5,31,39,16,23
050,35,033,"New Mexico","Mora County",5,32,27,13,14
050,35,033,"New Mexico","Mora County",5,33,33,15,18
050,35,033,"New Mexico","Mora County",5,34,36,14,22
050,35,033,"New Mexico","Mora County",5,35,40,23,17
050,35,033,"New Mexico","Mora County",5,36,34,16,18
050,35,033,"New Mexico","Mora County",5,37,29,14,15
050,35,033,"New Mexico","Mora County",5,38,38,21,17
050,35,033,"New Mexico","Mora County",5,39,47,32,15
050,35,033,"New Mexico","Mora County",5,40,38,20,18
050,35,033,"New Mexico","Mora County",5,41,47,25,22
050,35,033,"New Mexico","Mora County",5,42,46,21,25
050,35,033,"New Mexico","Mora County",5,43,52,27,25
050,35,033,"New Mexico","Mora County",5,44,44,20,24
050,35,033,"New Mexico","Mora County",5,45,38,18,20
050,35,033,"New Mexico","Mora County",5,46,46,23,23
050,35,033,"New Mexico","Mora County",5,47,39,17,22
050,35,033,"New Mexico","Mora County",5,48,33,18,15
050,35,033,"New Mexico","Mora County",5,49,32,11,21
050,35,033,"New Mexico","Mora County",5,50,42,23,19
050,35,033,"New Mexico","Mora County",5,51,45,24,21
050,35,033,"New Mexico","Mora County",5,52,43,22,21
050,35,033,"New Mexico","Mora County",5,53,51,25,26
050,35,033,"New Mexico","Mora County",5,54,53,23,30
050,35,033,"New Mexico","Mora County",5,55,46,22,24
050,35,033,"New Mexico","Mora County",5,56,49,23,26
050,35,033,"New Mexico","Mora County",5,57,62,29,33
050,35,033,"New Mexico","Mora County",5,58,73,35,38
050,35,033,"New Mexico","Mora County",5,59,64,30,34
050,35,033,"New Mexico","Mora County",5,60,65,34,31
050,35,033,"New Mexico","Mora County",5,61,73,43,30
050,35,033,"New Mexico","Mora County",5,62,72,40,32
050,35,033,"New Mexico","Mora County",5,63,82,41,41
050,35,033,"New Mexico","Mora County",5,64,68,30,38
050,35,033,"New Mexico","Mora County",5,65,87,40,47
050,35,033,"New Mexico","Mora County",5,66,72,38,34
050,35,033,"New Mexico","Mora County",5,67,75,38,37
050,35,033,"New Mexico","Mora County",5,68,86,43,43
050,35,033,"New Mexico","Mora County",5,69,71,35,36
050,35,033,"New Mexico","Mora County",5,70,72,34,38
050,35,033,"New Mexico","Mora County",5,71,84,47,37
050,35,033,"New Mexico","Mora County",5,72,84,53,31
050,35,033,"New Mexico","Mora County",5,73,65,40,25
050,35,033,"New Mexico","Mora County",5,74,73,39,34
050,35,033,"New Mexico","Mora County",5,75,71,36,35
050,35,033,"New Mexico","Mora County",5,76,60,29,31
050,35,033,"New Mexico","Mora County",5,77,46,25,21
050,35,033,"New Mexico","Mora County",5,78,54,32,22
050,35,033,"New Mexico","Mora County",5,79,41,23,18
050,35,033,"New Mexico","Mora County",5,80,31,22,9
050,35,033,"New Mexico","Mora County",5,81,27,15,12
050,35,033,"New Mexico","Mora County",5,82,24,13,11
050,35,033,"New Mexico","Mora County",5,83,32,15,17
050,35,033,"New Mexico","Mora County",5,84,31,18,13
050,35,033,"New Mexico","Mora County",5,85,157,74,83
050,35,035,"New Mexico","Otero County",1,0,841,430,411
050,35,035,"New Mexico","Otero County",1,1,862,436,426
050,35,035,"New Mexico","Otero County",1,2,899,451,448
050,35,035,"New Mexico","Otero County",1,3,870,469,401
050,35,035,"New Mexico","Otero County",1,4,845,438,407
050,35,035,"New Mexico","Otero County",1,5,870,473,397
050,35,035,"New Mexico","Otero County",1,6,830,429,401
050,35,035,"New Mexico","Otero County",1,7,783,383,400
050,35,035,"New Mexico","Otero County",1,8,828,404,424
050,35,035,"New Mexico","Otero County",1,9,851,438,413
050,35,035,"New Mexico","Otero County",1,10,878,456,422
050,35,035,"New Mexico","Otero County",1,11,871,450,421
050,35,035,"New Mexico","Otero County",1,12,870,462,408
050,35,035,"New Mexico","Otero County",1,13,864,451,413
050,35,035,"New Mexico","Otero County",1,14,849,413,436
050,35,035,"New Mexico","Otero County",1,15,814,405,409
050,35,035,"New Mexico","Otero County",1,16,793,401,392
050,35,035,"New Mexico","Otero County",1,17,823,428,395
050,35,035,"New Mexico","Otero County",1,18,818,432,386
050,35,035,"New Mexico","Otero County",1,19,1072,673,399
050,35,035,"New Mexico","Otero County",1,20,1225,792,433
050,35,035,"New Mexico","Otero County",1,21,1305,836,469
050,35,035,"New Mexico","Otero County",1,22,1273,829,444
050,35,035,"New Mexico","Otero County",1,23,1125,712,413
050,35,035,"New Mexico","Otero County",1,24,1059,660,399
050,35,035,"New Mexico","Otero County",1,25,1168,696,472
050,35,035,"New Mexico","Otero County",1,26,1103,676,427
050,35,035,"New Mexico","Otero County",1,27,1028,615,413
050,35,035,"New Mexico","Otero County",1,28,1058,617,441
050,35,035,"New Mexico","Otero County",1,29,1041,605,436
050,35,035,"New Mexico","Otero County",1,30,1048,574,474
050,35,035,"New Mexico","Otero County",1,31,959,515,444
050,35,035,"New Mexico","Otero County",1,32,936,494,442
050,35,035,"New Mexico","Otero County",1,33,1015,576,439
050,35,035,"New Mexico","Otero County",1,34,976,540,436
050,35,035,"New Mexico","Otero County",1,35,910,475,435
050,35,035,"New Mexico","Otero County",1,36,944,496,448
050,35,035,"New Mexico","Otero County",1,37,867,475,392
050,35,035,"New Mexico","Otero County",1,38,824,446,378
050,35,035,"New Mexico","Otero County",1,39,827,450,377
050,35,035,"New Mexico","Otero County",1,40,809,442,367
050,35,035,"New Mexico","Otero County",1,41,718,343,375
050,35,035,"New Mexico","Otero County",1,42,799,433,366
050,35,035,"New Mexico","Otero County",1,43,682,347,335
050,35,035,"New Mexico","Otero County",1,44,675,340,335
050,35,035,"New Mexico","Otero County",1,45,684,341,343
050,35,035,"New Mexico","Otero County",1,46,642,326,316
050,35,035,"New Mexico","Otero County",1,47,586,298,288
050,35,035,"New Mexico","Otero County",1,48,719,356,363
050,35,035,"New Mexico","Otero County",1,49,699,353,346
050,35,035,"New Mexico","Otero County",1,50,692,342,350
050,35,035,"New Mexico","Otero County",1,51,657,316,341
050,35,035,"New Mexico","Otero County",1,52,627,304,323
050,35,035,"New Mexico","Otero County",1,53,675,322,353
050,35,035,"New Mexico","Otero County",1,54,663,311,352
050,35,035,"New Mexico","Otero County",1,55,710,360,350
050,35,035,"New Mexico","Otero County",1,56,788,383,405
050,35,035,"New Mexico","Otero County",1,57,877,428,449
050,35,035,"New Mexico","Otero County",1,58,869,442,427
050,35,035,"New Mexico","Otero County",1,59,872,411,461
050,35,035,"New Mexico","Otero County",1,60,895,444,451
050,35,035,"New Mexico","Otero County",1,61,858,444,414
050,35,035,"New Mexico","Otero County",1,62,853,421,432
050,35,035,"New Mexico","Otero County",1,63,838,397,441
050,35,035,"New Mexico","Otero County",1,64,831,370,461
050,35,035,"New Mexico","Otero County",1,65,756,361,395
050,35,035,"New Mexico","Otero County",1,66,703,342,361
050,35,035,"New Mexico","Otero County",1,67,720,354,366
050,35,035,"New Mexico","Otero County",1,68,700,341,359
050,35,035,"New Mexico","Otero County",1,69,670,322,348
050,35,035,"New Mexico","Otero County",1,70,649,334,315
050,35,035,"New Mexico","Otero County",1,71,646,331,315
050,35,035,"New Mexico","Otero County",1,72,656,336,320
050,35,035,"New Mexico","Otero County",1,73,627,315,312
050,35,035,"New Mexico","Otero County",1,74,453,226,227
050,35,035,"New Mexico","Otero County",1,75,442,224,218
050,35,035,"New Mexico","Otero County",1,76,437,211,226
050,35,035,"New Mexico","Otero County",1,77,433,209,224
050,35,035,"New Mexico","Otero County",1,78,360,184,176
050,35,035,"New Mexico","Otero County",1,79,330,165,165
050,35,035,"New Mexico","Otero County",1,80,319,144,175
050,35,035,"New Mexico","Otero County",1,81,322,151,171
050,35,035,"New Mexico","Otero County",1,82,311,151,160
050,35,035,"New Mexico","Otero County",1,83,269,121,148
050,35,035,"New Mexico","Otero County",1,84,268,116,152
050,35,035,"New Mexico","Otero County",1,85,1224,511,713
050,35,035,"New Mexico","Otero County",2,0,839,435,404
050,35,035,"New Mexico","Otero County",2,1,862,435,427
050,35,035,"New Mexico","Otero County",2,2,885,448,437
050,35,035,"New Mexico","Otero County",2,3,870,459,411
050,35,035,"New Mexico","Otero County",2,4,854,446,408
050,35,035,"New Mexico","Otero County",2,5,861,462,399
050,35,035,"New Mexico","Otero County",2,6,834,436,398
050,35,035,"New Mexico","Otero County",2,7,786,387,399
050,35,035,"New Mexico","Otero County",2,8,809,396,413
050,35,035,"New Mexico","Otero County",2,9,843,430,413
050,35,035,"New Mexico","Otero County",2,10,867,448,419
050,35,035,"New Mexico","Otero County",2,11,864,448,416
050,35,035,"New Mexico","Otero County",2,12,875,465,410
050,35,035,"New Mexico","Otero County",2,13,861,452,409
050,35,035,"New Mexico","Otero County",2,14,848,418,430
050,35,035,"New Mexico","Otero County",2,15,820,404,416
050,35,035,"New Mexico","Otero County",2,16,800,402,398
050,35,035,"New Mexico","Otero County",2,17,814,423,391
050,35,035,"New Mexico","Otero County",2,18,826,438,388
050,35,035,"New Mexico","Otero County",2,19,1080,681,399
050,35,035,"New Mexico","Otero County",2,20,1231,790,441
050,35,035,"New Mexico","Otero County",2,21,1302,834,468
050,35,035,"New Mexico","Otero County",2,22,1271,824,447
050,35,035,"New Mexico","Otero County",2,23,1148,724,424
050,35,035,"New Mexico","Otero County",2,24,1049,649,400
050,35,035,"New Mexico","Otero County",2,25,1140,677,463
050,35,035,"New Mexico","Otero County",2,26,1109,675,434
050,35,035,"New Mexico","Otero County",2,27,1035,617,418
050,35,035,"New Mexico","Otero County",2,28,1052,622,430
050,35,035,"New Mexico","Otero County",2,29,1036,599,437
050,35,035,"New Mexico","Otero County",2,30,1053,591,462
050,35,035,"New Mexico","Otero County",2,31,954,507,447
050,35,035,"New Mexico","Otero County",2,32,941,497,444
050,35,035,"New Mexico","Otero County",2,33,1003,569,434
050,35,035,"New Mexico","Otero County",2,34,968,534,434
050,35,035,"New Mexico","Otero County",2,35,919,483,436
050,35,035,"New Mexico","Otero County",2,36,947,494,453
050,35,035,"New Mexico","Otero County",2,37,860,467,393
050,35,035,"New Mexico","Otero County",2,38,844,463,381
050,35,035,"New Mexico","Otero County",2,39,815,439,376
050,35,035,"New Mexico","Otero County",2,40,815,443,372
050,35,035,"New Mexico","Otero County",2,41,732,353,379
050,35,035,"New Mexico","Otero County",2,42,799,438,361
050,35,035,"New Mexico","Otero County",2,43,694,343,351
050,35,035,"New Mexico","Otero County",2,44,678,342,336
050,35,035,"New Mexico","Otero County",2,45,679,335,344
050,35,035,"New Mexico","Otero County",2,46,652,327,325
050,35,035,"New Mexico","Otero County",2,47,601,309,292
050,35,035,"New Mexico","Otero County",2,48,700,351,349
050,35,035,"New Mexico","Otero County",2,49,699,353,346
050,35,035,"New Mexico","Otero County",2,50,701,350,351
050,35,035,"New Mexico","Otero County",2,51,658,315,343
050,35,035,"New Mexico","Otero County",2,52,632,304,328
050,35,035,"New Mexico","Otero County",2,53,669,325,344
050,35,035,"New Mexico","Otero County",2,54,656,307,349
050,35,035,"New Mexico","Otero County",2,55,695,345,350
050,35,035,"New Mexico","Otero County",2,56,773,380,393
050,35,035,"New Mexico","Otero County",2,57,856,416,440
050,35,035,"New Mexico","Otero County",2,58,872,440,432
050,35,035,"New Mexico","Otero County",2,59,873,420,453
050,35,035,"New Mexico","Otero County",2,60,896,442,454
050,35,035,"New Mexico","Otero County",2,61,871,446,425
050,35,035,"New Mexico","Otero County",2,62,843,415,428
050,35,035,"New Mexico","Otero County",2,63,846,401,445
050,35,035,"New Mexico","Otero County",2,64,825,371,454
050,35,035,"New Mexico","Otero County",2,65,772,363,409
050,35,035,"New Mexico","Otero County",2,66,725,351,374
050,35,035,"New Mexico","Otero County",2,67,720,354,366
050,35,035,"New Mexico","Otero County",2,68,704,347,357
050,35,035,"New Mexico","Otero County",2,69,678,325,353
050,35,035,"New Mexico","Otero County",2,70,652,330,322
050,35,035,"New Mexico","Otero County",2,71,645,334,311
050,35,035,"New Mexico","Otero County",2,72,639,331,308
050,35,035,"New Mexico","Otero County",2,73,655,333,322
050,35,035,"New Mexico","Otero County",2,74,463,231,232
050,35,035,"New Mexico","Otero County",2,75,447,225,222
050,35,035,"New Mexico","Otero County",2,76,427,207,220
050,35,035,"New Mexico","Otero County",2,77,438,214,224
050,35,035,"New Mexico","Otero County",2,78,366,185,181
050,35,035,"New Mexico","Otero County",2,79,332,167,165
050,35,035,"New Mexico","Otero County",2,80,322,150,172
050,35,035,"New Mexico","Otero County",2,81,311,143,168
050,35,035,"New Mexico","Otero County",2,82,313,149,164
050,35,035,"New Mexico","Otero County",2,83,275,127,148
050,35,035,"New Mexico","Otero County",2,84,254,108,146
050,35,035,"New Mexico","Otero County",2,85,1234,511,723
050,35,035,"New Mexico","Otero County",3,0,756,373,383
050,35,035,"New Mexico","Otero County",3,1,863,456,407
050,35,035,"New Mexico","Otero County",3,2,864,459,405
050,35,035,"New Mexico","Otero County",3,3,873,450,423
050,35,035,"New Mexico","Otero County",3,4,863,454,409
050,35,035,"New Mexico","Otero County",3,5,841,448,393
050,35,035,"New Mexico","Otero County",3,6,862,468,394
050,35,035,"New Mexico","Otero County",3,7,821,432,389
050,35,035,"New Mexico","Otero County",3,8,804,399,405
050,35,035,"New Mexico","Otero County",3,9,822,405,417
050,35,035,"New Mexico","Otero County",3,10,845,432,413
050,35,035,"New Mexico","Otero County",3,11,855,447,408
050,35,035,"New Mexico","Otero County",3,12,874,449,425
050,35,035,"New Mexico","Otero County",3,13,891,463,428
050,35,035,"New Mexico","Otero County",3,14,857,439,418
050,35,035,"New Mexico","Otero County",3,15,836,420,416
050,35,035,"New Mexico","Otero County",3,16,825,407,418
050,35,035,"New Mexico","Otero County",3,17,802,402,400
050,35,035,"New Mexico","Otero County",3,18,793,406,387
050,35,035,"New Mexico","Otero County",3,19,1072,687,385
050,35,035,"New Mexico","Otero County",3,20,1246,789,457
050,35,035,"New Mexico","Otero County",3,21,1324,858,466
050,35,035,"New Mexico","Otero County",3,22,1277,820,457
050,35,035,"New Mexico","Otero County",3,23,1198,764,434
050,35,035,"New Mexico","Otero County",3,24,1078,646,432
050,35,035,"New Mexico","Otero County",3,25,1068,634,434
050,35,035,"New Mexico","Otero County",3,26,1084,637,447
050,35,035,"New Mexico","Otero County",3,27,1031,606,425
050,35,035,"New Mexico","Otero County",3,28,1018,595,423
050,35,035,"New Mexico","Otero County",3,29,1068,617,451
050,35,035,"New Mexico","Otero County",3,30,1074,630,444
050,35,035,"New Mexico","Otero County",3,31,1008,546,462
050,35,035,"New Mexico","Otero County",3,32,984,538,446
050,35,035,"New Mexico","Otero County",3,33,1013,593,420
050,35,035,"New Mexico","Otero County",3,34,973,525,448
050,35,035,"New Mexico","Otero County",3,35,952,523,429
050,35,035,"New Mexico","Otero County",3,36,991,505,486
050,35,035,"New Mexico","Otero County",3,37,923,489,434
050,35,035,"New Mexico","Otero County",3,38,904,496,408
050,35,035,"New Mexico","Otero County",3,39,844,457,387
050,35,035,"New Mexico","Otero County",3,40,819,447,372
050,35,035,"New Mexico","Otero County",3,41,806,420,386
050,35,035,"New Mexico","Otero County",3,42,789,444,345
050,35,035,"New Mexico","Otero County",3,43,697,331,366
050,35,035,"New Mexico","Otero County",3,44,709,358,351
050,35,035,"New Mexico","Otero County",3,45,669,339,330
050,35,035,"New Mexico","Otero County",3,46,688,333,355
050,35,035,"New Mexico","Otero County",3,47,633,334,299
050,35,035,"New Mexico","Otero County",3,48,663,351,312
050,35,035,"New Mexico","Otero County",3,49,663,331,332
050,35,035,"New Mexico","Otero County",3,50,729,382,347
050,35,035,"New Mexico","Otero County",3,51,684,337,347
050,35,035,"New Mexico","Otero County",3,52,660,319,341
050,35,035,"New Mexico","Otero County",3,53,674,344,330
050,35,035,"New Mexico","Otero County",3,54,652,295,357
050,35,035,"New Mexico","Otero County",3,55,644,296,348
050,35,035,"New Mexico","Otero County",3,56,715,351,364
050,35,035,"New Mexico","Otero County",3,57,769,370,399
050,35,035,"New Mexico","Otero County",3,58,853,420,433
050,35,035,"New Mexico","Otero County",3,59,874,434,440
050,35,035,"New Mexico","Otero County",3,60,884,443,441
050,35,035,"New Mexico","Otero County",3,61,886,449,437
050,35,035,"New Mexico","Otero County",3,62,841,420,421
050,35,035,"New Mexico","Otero County",3,63,844,415,429
050,35,035,"New Mexico","Otero County",3,64,850,407,443
050,35,035,"New Mexico","Otero County",3,65,825,374,451
050,35,035,"New Mexico","Otero County",3,66,763,354,409
050,35,035,"New Mexico","Otero County",3,67,732,360,372
050,35,035,"New Mexico","Otero County",3,68,737,360,377
050,35,035,"New Mexico","Otero County",3,69,691,325,366
050,35,035,"New Mexico","Otero County",3,70,671,323,348
050,35,035,"New Mexico","Otero County",3,71,645,327,318
050,35,035,"New Mexico","Otero County",3,72,644,334,310
050,35,035,"New Mexico","Otero County",3,73,619,322,297
050,35,035,"New Mexico","Otero County",3,74,639,322,317
050,35,035,"New Mexico","Otero County",3,75,451,222,229
050,35,035,"New Mexico","Otero County",3,76,418,205,213
050,35,035,"New Mexico","Otero County",3,77,413,199,214
050,35,035,"New Mexico","Otero County",3,78,415,202,213
050,35,035,"New Mexico","Otero County",3,79,354,179,175
050,35,035,"New Mexico","Otero County",3,80,314,160,154
050,35,035,"New Mexico","Otero County",3,81,305,133,172
050,35,035,"New Mexico","Otero County",3,82,290,131,159
050,35,035,"New Mexico","Otero County",3,83,275,127,148
050,35,035,"New Mexico","Otero County",3,84,242,113,129
050,35,035,"New Mexico","Otero County",3,85,1271,519,752
050,35,035,"New Mexico","Otero County",4,0,701,368,333
050,35,035,"New Mexico","Otero County",4,1,749,362,387
050,35,035,"New Mexico","Otero County",4,2,827,438,389
050,35,035,"New Mexico","Otero County",4,3,859,455,404
050,35,035,"New Mexico","Otero County",4,4,851,448,403
050,35,035,"New Mexico","Otero County",4,5,864,453,411
050,35,035,"New Mexico","Otero County",4,6,847,437,410
050,35,035,"New Mexico","Otero County",4,7,864,472,392
050,35,035,"New Mexico","Otero County",4,8,835,432,403
050,35,035,"New Mexico","Otero County",4,9,814,415,399
050,35,035,"New Mexico","Otero County",4,10,821,398,423
050,35,035,"New Mexico","Otero County",4,11,841,424,417
050,35,035,"New Mexico","Otero County",4,12,875,452,423
050,35,035,"New Mexico","Otero County",4,13,884,454,430
050,35,035,"New Mexico","Otero County",4,14,868,441,427
050,35,035,"New Mexico","Otero County",4,15,840,442,398
050,35,035,"New Mexico","Otero County",4,16,824,415,409
050,35,035,"New Mexico","Otero County",4,17,814,415,399
050,35,035,"New Mexico","Otero County",4,18,799,416,383
050,35,035,"New Mexico","Otero County",4,19,1049,670,379
050,35,035,"New Mexico","Otero County",4,20,1209,787,422
050,35,035,"New Mexico","Otero County",4,21,1291,809,482
050,35,035,"New Mexico","Otero County",4,22,1261,837,424
050,35,035,"New Mexico","Otero County",4,23,1227,750,477
050,35,035,"New Mexico","Otero County",4,24,1097,680,417
050,35,035,"New Mexico","Otero County",4,25,1084,650,434
050,35,035,"New Mexico","Otero County",4,26,994,578,416
050,35,035,"New Mexico","Otero County",4,27,981,541,440
050,35,035,"New Mexico","Otero County",4,28,1006,564,442
050,35,035,"New Mexico","Otero County",4,29,994,574,420
050,35,035,"New Mexico","Otero County",4,30,1105,664,441
050,35,035,"New Mexico","Otero County",4,31,992,549,443
050,35,035,"New Mexico","Otero County",4,32,1033,560,473
050,35,035,"New Mexico","Otero County",4,33,1054,621,433
050,35,035,"New Mexico","Otero County",4,34,953,537,416
050,35,035,"New Mexico","Otero County",4,35,945,486,459
050,35,035,"New Mexico","Otero County",4,36,981,516,465
050,35,035,"New Mexico","Otero County",4,37,938,479,459
050,35,035,"New Mexico","Otero County",4,38,965,531,434
050,35,035,"New Mexico","Otero County",4,39,871,475,396
050,35,035,"New Mexico","Otero County",4,40,868,467,401
050,35,035,"New Mexico","Otero County",4,41,785,388,397
050,35,035,"New Mexico","Otero County",4,42,898,540,358
050,35,035,"New Mexico","Otero County",4,43,700,346,354
050,35,035,"New Mexico","Otero County",4,44,723,356,367
050,35,035,"New Mexico","Otero County",4,45,685,346,339
050,35,035,"New Mexico","Otero County",4,46,679,341,338
050,35,035,"New Mexico","Otero County",4,47,659,335,324
050,35,035,"New Mexico","Otero County",4,48,687,356,331
050,35,035,"New Mexico","Otero County",4,49,618,336,282
050,35,035,"New Mexico","Otero County",4,50,679,345,334
050,35,035,"New Mexico","Otero County",4,51,737,368,369
050,35,035,"New Mexico","Otero County",4,52,660,323,337
050,35,035,"New Mexico","Otero County",4,53,691,359,332
050,35,035,"New Mexico","Otero County",4,54,657,321,336
050,35,035,"New Mexico","Otero County",4,55,650,300,350
050,35,035,"New Mexico","Otero County",4,56,647,300,347
050,35,035,"New Mexico","Otero County",4,57,731,355,376
050,35,035,"New Mexico","Otero County",4,58,770,362,408
050,35,035,"New Mexico","Otero County",4,59,830,409,421
050,35,035,"New Mexico","Otero County",4,60,905,460,445
050,35,035,"New Mexico","Otero County",4,61,897,449,448
050,35,035,"New Mexico","Otero County",4,62,868,424,444
050,35,035,"New Mexico","Otero County",4,63,844,424,420
050,35,035,"New Mexico","Otero County",4,64,829,413,416
050,35,035,"New Mexico","Otero County",4,65,820,393,427
050,35,035,"New Mexico","Otero County",4,66,839,379,460
050,35,035,"New Mexico","Otero County",4,67,790,370,420
050,35,035,"New Mexico","Otero County",4,68,732,366,366
050,35,035,"New Mexico","Otero County",4,69,729,348,381
050,35,035,"New Mexico","Otero County",4,70,686,326,360
050,35,035,"New Mexico","Otero County",4,71,657,312,345
050,35,035,"New Mexico","Otero County",4,72,646,326,320
050,35,035,"New Mexico","Otero County",4,73,623,332,291
050,35,035,"New Mexico","Otero County",4,74,611,316,295
050,35,035,"New Mexico","Otero County",4,75,624,312,312
050,35,035,"New Mexico","Otero County",4,76,424,206,218
050,35,035,"New Mexico","Otero County",4,77,409,199,210
050,35,035,"New Mexico","Otero County",4,78,381,174,207
050,35,035,"New Mexico","Otero County",4,79,399,194,205
050,35,035,"New Mexico","Otero County",4,80,332,170,162
050,35,035,"New Mexico","Otero County",4,81,289,147,142
050,35,035,"New Mexico","Otero County",4,82,280,121,159
050,35,035,"New Mexico","Otero County",4,83,256,119,137
050,35,035,"New Mexico","Otero County",4,84,222,102,120
050,35,035,"New Mexico","Otero County",4,85,1264,523,741
050,35,035,"New Mexico","Otero County",5,0,675,352,323
050,35,035,"New Mexico","Otero County",5,1,671,346,325
050,35,035,"New Mexico","Otero County",5,2,745,365,380
050,35,035,"New Mexico","Otero County",5,3,809,422,387
050,35,035,"New Mexico","Otero County",5,4,862,430,432
050,35,035,"New Mexico","Otero County",5,5,856,456,400
050,35,035,"New Mexico","Otero County",5,6,884,468,416
050,35,035,"New Mexico","Otero County",5,7,870,461,409
050,35,035,"New Mexico","Otero County",5,8,888,476,412
050,35,035,"New Mexico","Otero County",5,9,822,426,396
050,35,035,"New Mexico","Otero County",5,10,816,417,399
050,35,035,"New Mexico","Otero County",5,11,810,394,416
050,35,035,"New Mexico","Otero County",5,12,847,417,430
050,35,035,"New Mexico","Otero County",5,13,874,455,419
050,35,035,"New Mexico","Otero County",5,14,875,454,421
050,35,035,"New Mexico","Otero County",5,15,865,443,422
050,35,035,"New Mexico","Otero County",5,16,833,422,411
050,35,035,"New Mexico","Otero County",5,17,822,426,396
050,35,035,"New Mexico","Otero County",5,18,807,412,395
050,35,035,"New Mexico","Otero County",5,19,1033,660,373
050,35,035,"New Mexico","Otero County",5,20,1249,812,437
050,35,035,"New Mexico","Otero County",5,21,1268,811,457
050,35,035,"New Mexico","Otero County",5,22,1262,790,472
050,35,035,"New Mexico","Otero County",5,23,1222,782,440
050,35,035,"New Mexico","Otero County",5,24,1137,681,456
050,35,035,"New Mexico","Otero County",5,25,1085,629,456
050,35,035,"New Mexico","Otero County",5,26,1026,630,396
050,35,035,"New Mexico","Otero County",5,27,939,526,413
050,35,035,"New Mexico","Otero County",5,28,972,530,442
050,35,035,"New Mexico","Otero County",5,29,1000,550,450
050,35,035,"New Mexico","Otero County",5,30,1036,608,428
050,35,035,"New Mexico","Otero County",5,31,1025,585,440
050,35,035,"New Mexico","Otero County",5,32,982,521,461
050,35,035,"New Mexico","Otero County",5,33,1127,651,476
050,35,035,"New Mexico","Otero County",5,34,1023,584,439
050,35,035,"New Mexico","Otero County",5,35,975,534,441
050,35,035,"New Mexico","Otero County",5,36,1002,504,498
050,35,035,"New Mexico","Otero County",5,37,905,481,424
050,35,035,"New Mexico","Otero County",5,38,967,517,450
050,35,035,"New Mexico","Otero County",5,39,985,537,448
050,35,035,"New Mexico","Otero County",5,40,881,493,388
050,35,035,"New Mexico","Otero County",5,41,809,390,419
050,35,035,"New Mexico","Otero County",5,42,862,497,365
050,35,035,"New Mexico","Otero County",5,43,795,426,369
050,35,035,"New Mexico","Otero County",5,44,739,378,361
050,35,035,"New Mexico","Otero County",5,45,679,329,350
050,35,035,"New Mexico","Otero County",5,46,689,341,348
050,35,035,"New Mexico","Otero County",5,47,664,349,315
050,35,035,"New Mexico","Otero County",5,48,689,344,345
050,35,035,"New Mexico","Otero County",5,49,638,339,299
050,35,035,"New Mexico","Otero County",5,50,645,353,292
050,35,035,"New Mexico","Otero County",5,51,669,314,355
050,35,035,"New Mexico","Otero County",5,52,717,363,354
050,35,035,"New Mexico","Otero County",5,53,706,362,344
050,35,035,"New Mexico","Otero County",5,54,681,344,337
050,35,035,"New Mexico","Otero County",5,55,649,319,330
050,35,035,"New Mexico","Otero County",5,56,666,308,358
050,35,035,"New Mexico","Otero County",5,57,641,297,344
050,35,035,"New Mexico","Otero County",5,58,731,362,369
050,35,035,"New Mexico","Otero County",5,59,757,346,411
050,35,035,"New Mexico","Otero County",5,60,873,442,431
050,35,035,"New Mexico","Otero County",5,61,924,469,455
050,35,035,"New Mexico","Otero County",5,62,888,431,457
050,35,035,"New Mexico","Otero County",5,63,864,418,446
050,35,035,"New Mexico","Otero County",5,64,856,425,431
050,35,035,"New Mexico","Otero County",5,65,830,405,425
050,35,035,"New Mexico","Otero County",5,66,824,397,427
050,35,035,"New Mexico","Otero County",5,67,842,385,457
050,35,035,"New Mexico","Otero County",5,68,788,376,412
050,35,035,"New Mexico","Otero County",5,69,705,341,364
050,35,035,"New Mexico","Otero County",5,70,712,346,366
050,35,035,"New Mexico","Otero County",5,71,678,318,360
050,35,035,"New Mexico","Otero County",5,72,637,306,331
050,35,035,"New Mexico","Otero County",5,73,621,320,301
050,35,035,"New Mexico","Otero County",5,74,605,324,281
050,35,035,"New Mexico","Otero County",5,75,599,303,296
050,35,035,"New Mexico","Otero County",5,76,598,294,304
050,35,035,"New Mexico","Otero County",5,77,407,201,206
050,35,035,"New Mexico","Otero County",5,78,376,182,194
050,35,035,"New Mexico","Otero County",5,79,358,163,195
050,35,035,"New Mexico","Otero County",5,80,381,181,200
050,35,035,"New Mexico","Otero County",5,81,303,152,151
050,35,035,"New Mexico","Otero County",5,82,275,138,137
050,35,035,"New Mexico","Otero County",5,83,253,108,145
050,35,035,"New Mexico","Otero County",5,84,211,96,115
050,35,035,"New Mexico","Otero County",5,85,1269,528,741
050,35,037,"New Mexico","Quay County",1,0,102,52,50
050,35,037,"New Mexico","Quay County",1,1,93,45,48
050,35,037,"New Mexico","Quay County",1,2,103,48,55
050,35,037,"New Mexico","Quay County",1,3,87,38,49
050,35,037,"New Mexico","Quay County",1,4,94,55,39
050,35,037,"New Mexico","Quay County",1,5,95,43,52
050,35,037,"New Mexico","Quay County",1,6,100,38,62
050,35,037,"New Mexico","Quay County",1,7,96,40,56
050,35,037,"New Mexico","Quay County",1,8,105,44,61
050,35,037,"New Mexico","Quay County",1,9,105,47,58
050,35,037,"New Mexico","Quay County",1,10,103,53,50
050,35,037,"New Mexico","Quay County",1,11,108,55,53
050,35,037,"New Mexico","Quay County",1,12,113,60,53
050,35,037,"New Mexico","Quay County",1,13,107,55,52
050,35,037,"New Mexico","Quay County",1,14,101,56,45
050,35,037,"New Mexico","Quay County",1,15,105,57,48
050,35,037,"New Mexico","Quay County",1,16,116,58,58
050,35,037,"New Mexico","Quay County",1,17,106,57,49
050,35,037,"New Mexico","Quay County",1,18,108,53,55
050,35,037,"New Mexico","Quay County",1,19,93,43,50
050,35,037,"New Mexico","Quay County",1,20,85,43,42
050,35,037,"New Mexico","Quay County",1,21,83,44,39
050,35,037,"New Mexico","Quay County",1,22,77,48,29
050,35,037,"New Mexico","Quay County",1,23,67,36,31
050,35,037,"New Mexico","Quay County",1,24,81,45,36
050,35,037,"New Mexico","Quay County",1,25,66,40,26
050,35,037,"New Mexico","Quay County",1,26,83,46,37
050,35,037,"New Mexico","Quay County",1,27,98,52,46
050,35,037,"New Mexico","Quay County",1,28,99,52,47
050,35,037,"New Mexico","Quay County",1,29,99,55,44
050,35,037,"New Mexico","Quay County",1,30,93,51,42
050,35,037,"New Mexico","Quay County",1,31,90,46,44
050,35,037,"New Mexico","Quay County",1,32,83,43,40
050,35,037,"New Mexico","Quay County",1,33,80,46,34
050,35,037,"New Mexico","Quay County",1,34,85,47,38
050,35,037,"New Mexico","Quay County",1,35,79,41,38
050,35,037,"New Mexico","Quay County",1,36,88,40,48
050,35,037,"New Mexico","Quay County",1,37,104,45,59
050,35,037,"New Mexico","Quay County",1,38,102,56,46
050,35,037,"New Mexico","Quay County",1,39,98,54,44
050,35,037,"New Mexico","Quay County",1,40,95,49,46
050,35,037,"New Mexico","Quay County",1,41,89,41,48
050,35,037,"New Mexico","Quay County",1,42,89,40,49
050,35,037,"New Mexico","Quay County",1,43,80,44,36
050,35,037,"New Mexico","Quay County",1,44,72,41,31
050,35,037,"New Mexico","Quay County",1,45,73,35,38
050,35,037,"New Mexico","Quay County",1,46,87,37,50
050,35,037,"New Mexico","Quay County",1,47,83,38,45
050,35,037,"New Mexico","Quay County",1,48,80,42,38
050,35,037,"New Mexico","Quay County",1,49,100,43,57
050,35,037,"New Mexico","Quay County",1,50,96,40,56
050,35,037,"New Mexico","Quay County",1,51,110,59,51
050,35,037,"New Mexico","Quay County",1,52,91,54,37
050,35,037,"New Mexico","Quay County",1,53,118,65,53
050,35,037,"New Mexico","Quay County",1,54,112,55,57
050,35,037,"New Mexico","Quay County",1,55,119,50,69
050,35,037,"New Mexico","Quay County",1,56,109,48,61
050,35,037,"New Mexico","Quay County",1,57,125,60,65
050,35,037,"New Mexico","Quay County",1,58,141,74,67
050,35,037,"New Mexico","Quay County",1,59,134,65,69
050,35,037,"New Mexico","Quay County",1,60,121,66,55
050,35,037,"New Mexico","Quay County",1,61,121,65,56
050,35,037,"New Mexico","Quay County",1,62,136,63,73
050,35,037,"New Mexico","Quay County",1,63,159,68,91
050,35,037,"New Mexico","Quay County",1,64,133,54,79
050,35,037,"New Mexico","Quay County",1,65,123,53,70
050,35,037,"New Mexico","Quay County",1,66,151,72,79
050,35,037,"New Mexico","Quay County",1,67,141,68,73
050,35,037,"New Mexico","Quay County",1,68,146,65,81
050,35,037,"New Mexico","Quay County",1,69,137,63,74
050,35,037,"New Mexico","Quay County",1,70,113,60,53
050,35,037,"New Mexico","Quay County",1,71,130,64,66
050,35,037,"New Mexico","Quay County",1,72,148,75,73
050,35,037,"New Mexico","Quay County",1,73,133,69,64
050,35,037,"New Mexico","Quay County",1,74,101,48,53
050,35,037,"New Mexico","Quay County",1,75,95,49,46
050,35,037,"New Mexico","Quay County",1,76,87,40,47
050,35,037,"New Mexico","Quay County",1,77,105,50,55
050,35,037,"New Mexico","Quay County",1,78,92,47,45
050,35,037,"New Mexico","Quay County",1,79,70,39,31
050,35,037,"New Mexico","Quay County",1,80,65,32,33
050,35,037,"New Mexico","Quay County",1,81,71,39,32
050,35,037,"New Mexico","Quay County",1,82,54,25,29
050,35,037,"New Mexico","Quay County",1,83,42,20,22
050,35,037,"New Mexico","Quay County",1,84,47,20,27
050,35,037,"New Mexico","Quay County",1,85,239,95,144
050,35,037,"New Mexico","Quay County",2,0,97,48,49
050,35,037,"New Mexico","Quay County",2,1,94,45,49
050,35,037,"New Mexico","Quay County",2,2,98,45,53
050,35,037,"New Mexico","Quay County",2,3,91,42,49
050,35,037,"New Mexico","Quay County",2,4,93,51,42
050,35,037,"New Mexico","Quay County",2,5,96,46,50
050,35,037,"New Mexico","Quay County",2,6,98,40,58
050,35,037,"New Mexico","Quay County",2,7,94,39,55
050,35,037,"New Mexico","Quay County",2,8,101,44,57
050,35,037,"New Mexico","Quay County",2,9,104,45,59
050,35,037,"New Mexico","Quay County",2,10,103,52,51
050,35,037,"New Mexico","Quay County",2,11,106,55,51
050,35,037,"New Mexico","Quay County",2,12,113,59,54
050,35,037,"New Mexico","Quay County",2,13,106,56,50
050,35,037,"New Mexico","Quay County",2,14,101,54,47
050,35,037,"New Mexico","Quay County",2,15,104,56,48
050,35,037,"New Mexico","Quay County",2,16,111,57,54
050,35,037,"New Mexico","Quay County",2,17,108,57,51
050,35,037,"New Mexico","Quay County",2,18,105,53,52
050,35,037,"New Mexico","Quay County",2,19,92,45,47
050,35,037,"New Mexico","Quay County",2,20,90,46,44
050,35,037,"New Mexico","Quay County",2,21,82,44,38
050,35,037,"New Mexico","Quay County",2,22,79,48,31
050,35,037,"New Mexico","Quay County",2,23,68,39,29
050,35,037,"New Mexico","Quay County",2,24,77,41,36
050,35,037,"New Mexico","Quay County",2,25,72,42,30
050,35,037,"New Mexico","Quay County",2,26,81,45,36
050,35,037,"New Mexico","Quay County",2,27,93,50,43
050,35,037,"New Mexico","Quay County",2,28,98,51,47
050,35,037,"New Mexico","Quay County",2,29,100,54,46
050,35,037,"New Mexico","Quay County",2,30,95,52,43
050,35,037,"New Mexico","Quay County",2,31,89,46,43
050,35,037,"New Mexico","Quay County",2,32,84,44,40
050,35,037,"New Mexico","Quay County",2,33,82,47,35
050,35,037,"New Mexico","Quay County",2,34,84,46,38
050,35,037,"New Mexico","Quay County",2,35,78,41,37
050,35,037,"New Mexico","Quay County",2,36,87,41,46
050,35,037,"New Mexico","Quay County",2,37,100,43,57
050,35,037,"New Mexico","Quay County",2,38,101,53,48
050,35,037,"New Mexico","Quay County",2,39,98,54,44
050,35,037,"New Mexico","Quay County",2,40,98,51,47
050,35,037,"New Mexico","Quay County",2,41,89,42,47
050,35,037,"New Mexico","Quay County",2,42,87,40,47
050,35,037,"New Mexico","Quay County",2,43,83,44,39
050,35,037,"New Mexico","Quay County",2,44,73,41,32
050,35,037,"New Mexico","Quay County",2,45,73,36,37
050,35,037,"New Mexico","Quay County",2,46,83,36,47
050,35,037,"New Mexico","Quay County",2,47,84,38,46
050,35,037,"New Mexico","Quay County",2,48,81,41,40
050,35,037,"New Mexico","Quay County",2,49,96,43,53
050,35,037,"New Mexico","Quay County",2,50,98,42,56
050,35,037,"New Mexico","Quay County",2,51,104,52,52
050,35,037,"New Mexico","Quay County",2,52,99,57,42
050,35,037,"New Mexico","Quay County",2,53,112,62,50
050,35,037,"New Mexico","Quay County",2,54,114,58,56
050,35,037,"New Mexico","Quay County",2,55,119,51,68
050,35,037,"New Mexico","Quay County",2,56,114,51,63
050,35,037,"New Mexico","Quay County",2,57,121,58,63
050,35,037,"New Mexico","Quay County",2,58,137,70,67
050,35,037,"New Mexico","Quay County",2,59,135,67,68
050,35,037,"New Mexico","Quay County",2,60,123,65,58
050,35,037,"New Mexico","Quay County",2,61,120,64,56
050,35,037,"New Mexico","Quay County",2,62,131,62,69
050,35,037,"New Mexico","Quay County",2,63,156,68,88
050,35,037,"New Mexico","Quay County",2,64,136,56,80
050,35,037,"New Mexico","Quay County",2,65,126,53,73
050,35,037,"New Mexico","Quay County",2,66,143,69,74
050,35,037,"New Mexico","Quay County",2,67,146,71,75
050,35,037,"New Mexico","Quay County",2,68,145,66,79
050,35,037,"New Mexico","Quay County",2,69,139,64,75
050,35,037,"New Mexico","Quay County",2,70,118,60,58
050,35,037,"New Mexico","Quay County",2,71,125,62,63
050,35,037,"New Mexico","Quay County",2,72,141,71,70
050,35,037,"New Mexico","Quay County",2,73,142,73,69
050,35,037,"New Mexico","Quay County",2,74,102,50,52
050,35,037,"New Mexico","Quay County",2,75,97,49,48
050,35,037,"New Mexico","Quay County",2,76,87,41,46
050,35,037,"New Mexico","Quay County",2,77,100,46,54
050,35,037,"New Mexico","Quay County",2,78,91,46,45
050,35,037,"New Mexico","Quay County",2,79,75,41,34
050,35,037,"New Mexico","Quay County",2,80,67,34,33
050,35,037,"New Mexico","Quay County",2,81,66,35,31
050,35,037,"New Mexico","Quay County",2,82,56,29,27
050,35,037,"New Mexico","Quay County",2,83,44,20,24
050,35,037,"New Mexico","Quay County",2,84,44,20,24
050,35,037,"New Mexico","Quay County",2,85,239,99,140
050,35,037,"New Mexico","Quay County",3,0,65,32,33
050,35,037,"New Mexico","Quay County",3,1,92,41,51
050,35,037,"New Mexico","Quay County",3,2,100,46,54
050,35,037,"New Mexico","Quay County",3,3,99,45,54
050,35,037,"New Mexico","Quay County",3,4,94,46,48
050,35,037,"New Mexico","Quay County",3,5,94,52,42
050,35,037,"New Mexico","Quay County",3,6,95,46,49
050,35,037,"New Mexico","Quay County",3,7,89,36,53
050,35,037,"New Mexico","Quay County",3,8,100,45,55
050,35,037,"New Mexico","Quay County",3,9,108,50,58
050,35,037,"New Mexico","Quay County",3,10,108,50,58
050,35,037,"New Mexico","Quay County",3,11,103,57,46
050,35,037,"New Mexico","Quay County",3,12,112,54,58
050,35,037,"New Mexico","Quay County",3,13,116,59,57
050,35,037,"New Mexico","Quay County",3,14,104,55,49
050,35,037,"New Mexico","Quay County",3,15,102,54,48
050,35,037,"New Mexico","Quay County",3,16,102,57,45
050,35,037,"New Mexico","Quay County",3,17,114,60,54
050,35,037,"New Mexico","Quay County",3,18,103,56,47
050,35,037,"New Mexico","Quay County",3,19,90,46,44
050,35,037,"New Mexico","Quay County",3,20,86,41,45
050,35,037,"New Mexico","Quay County",3,21,94,44,50
050,35,037,"New Mexico","Quay County",3,22,70,36,34
050,35,037,"New Mexico","Quay County",3,23,84,51,33
050,35,037,"New Mexico","Quay County",3,24,61,38,23
050,35,037,"New Mexico","Quay County",3,25,72,37,35
050,35,037,"New Mexico","Quay County",3,26,71,42,29
050,35,037,"New Mexico","Quay County",3,27,86,48,38
050,35,037,"New Mexico","Quay County",3,28,88,52,36
050,35,037,"New Mexico","Quay County",3,29,93,46,47
050,35,037,"New Mexico","Quay County",3,30,93,52,41
050,35,037,"New Mexico","Quay County",3,31,92,52,40
050,35,037,"New Mexico","Quay County",3,32,85,43,42
050,35,037,"New Mexico","Quay County",3,33,83,44,39
050,35,037,"New Mexico","Quay County",3,34,84,49,35
050,35,037,"New Mexico","Quay County",3,35,81,45,36
050,35,037,"New Mexico","Quay County",3,36,75,40,35
050,35,037,"New Mexico","Quay County",3,37,85,40,45
050,35,037,"New Mexico","Quay County",3,38,103,46,57
050,35,037,"New Mexico","Quay County",3,39,102,55,47
050,35,037,"New Mexico","Quay County",3,40,96,52,44
050,35,037,"New Mexico","Quay County",3,41,96,49,47
050,35,037,"New Mexico","Quay County",3,42,87,40,47
050,35,037,"New Mexico","Quay County",3,43,86,40,46
050,35,037,"New Mexico","Quay County",3,44,77,44,33
050,35,037,"New Mexico","Quay County",3,45,70,39,31
050,35,037,"New Mexico","Quay County",3,46,70,34,36
050,35,037,"New Mexico","Quay County",3,47,86,37,49
050,35,037,"New Mexico","Quay County",3,48,91,41,50
050,35,037,"New Mexico","Quay County",3,49,81,43,38
050,35,037,"New Mexico","Quay County",3,50,97,43,54
050,35,037,"New Mexico","Quay County",3,51,97,40,57
050,35,037,"New Mexico","Quay County",3,52,107,53,54
050,35,037,"New Mexico","Quay County",3,53,103,61,42
050,35,037,"New Mexico","Quay County",3,54,109,60,49
050,35,037,"New Mexico","Quay County",3,55,119,60,59
050,35,037,"New Mexico","Quay County",3,56,121,53,68
050,35,037,"New Mexico","Quay County",3,57,112,52,60
050,35,037,"New Mexico","Quay County",3,58,120,58,62
050,35,037,"New Mexico","Quay County",3,59,139,71,68
050,35,037,"New Mexico","Quay County",3,60,135,69,66
050,35,037,"New Mexico","Quay County",3,61,117,60,57
050,35,037,"New Mexico","Quay County",3,62,120,65,55
050,35,037,"New Mexico","Quay County",3,63,137,64,73
050,35,037,"New Mexico","Quay County",3,64,157,72,85
050,35,037,"New Mexico","Quay County",3,65,124,50,74
050,35,037,"New Mexico","Quay County",3,66,126,53,73
050,35,037,"New Mexico","Quay County",3,67,146,71,75
050,35,037,"New Mexico","Quay County",3,68,143,70,73
050,35,037,"New Mexico","Quay County",3,69,140,63,77
050,35,037,"New Mexico","Quay County",3,70,132,62,70
050,35,037,"New Mexico","Quay County",3,71,117,60,57
050,35,037,"New Mexico","Quay County",3,72,123,60,63
050,35,037,"New Mexico","Quay County",3,73,139,68,71
050,35,037,"New Mexico","Quay County",3,74,132,66,66
050,35,037,"New Mexico","Quay County",3,75,102,53,49
050,35,037,"New Mexico","Quay County",3,76,89,45,44
050,35,037,"New Mexico","Quay County",3,77,85,38,47
050,35,037,"New Mexico","Quay County",3,78,97,45,52
050,35,037,"New Mexico","Quay County",3,79,87,44,43
050,35,037,"New Mexico","Quay County",3,80,72,38,34
050,35,037,"New Mexico","Quay County",3,81,61,30,31
050,35,037,"New Mexico","Quay County",3,82,63,32,31
050,35,037,"New Mexico","Quay County",3,83,53,29,24
050,35,037,"New Mexico","Quay County",3,84,43,19,24
050,35,037,"New Mexico","Quay County",3,85,238,97,141
050,35,037,"New Mexico","Quay County",4,0,67,28,39
050,35,037,"New Mexico","Quay County",4,1,68,29,39
050,35,037,"New Mexico","Quay County",4,2,95,44,51
050,35,037,"New Mexico","Quay County",4,3,96,45,51
050,35,037,"New Mexico","Quay County",4,4,104,49,55
050,35,037,"New Mexico","Quay County",4,5,92,46,46
050,35,037,"New Mexico","Quay County",4,6,93,50,43
050,35,037,"New Mexico","Quay County",4,7,92,47,45
050,35,037,"New Mexico","Quay County",4,8,86,34,52
050,35,037,"New Mexico","Quay County",4,9,102,46,56
050,35,037,"New Mexico","Quay County",4,10,102,45,57
050,35,037,"New Mexico","Quay County",4,11,109,47,62
050,35,037,"New Mexico","Quay County",4,12,98,53,45
050,35,037,"New Mexico","Quay County",4,13,107,52,55
050,35,037,"New Mexico","Quay County",4,14,121,60,61
050,35,037,"New Mexico","Quay County",4,15,106,54,52
050,35,037,"New Mexico","Quay County",4,16,106,53,53
050,35,037,"New Mexico","Quay County",4,17,101,55,46
050,35,037,"New Mexico","Quay County",4,18,101,50,51
050,35,037,"New Mexico","Quay County",4,19,86,49,37
050,35,037,"New Mexico","Quay County",4,20,88,45,43
050,35,037,"New Mexico","Quay County",4,21,75,36,39
050,35,037,"New Mexico","Quay County",4,22,90,39,51
050,35,037,"New Mexico","Quay County",4,23,70,35,35
050,35,037,"New Mexico","Quay County",4,24,83,51,32
050,35,037,"New Mexico","Quay County",4,25,62,33,29
050,35,037,"New Mexico","Quay County",4,26,76,38,38
050,35,037,"New Mexico","Quay County",4,27,78,48,30
050,35,037,"New Mexico","Quay County",4,28,85,47,38
050,35,037,"New Mexico","Quay County",4,29,85,50,35
050,35,037,"New Mexico","Quay County",4,30,93,47,46
050,35,037,"New Mexico","Quay County",4,31,89,46,43
050,35,037,"New Mexico","Quay County",4,32,92,50,42
050,35,037,"New Mexico","Quay County",4,33,94,50,44
050,35,037,"New Mexico","Quay County",4,34,80,43,37
050,35,037,"New Mexico","Quay County",4,35,94,54,40
050,35,037,"New Mexico","Quay County",4,36,85,48,37
050,35,037,"New Mexico","Quay County",4,37,81,41,40
050,35,037,"New Mexico","Quay County",4,38,91,45,46
050,35,037,"New Mexico","Quay County",4,39,102,48,54
050,35,037,"New Mexico","Quay County",4,40,101,55,46
050,35,037,"New Mexico","Quay County",4,41,91,50,41
050,35,037,"New Mexico","Quay County",4,42,101,56,45
050,35,037,"New Mexico","Quay County",4,43,85,38,47
050,35,037,"New Mexico","Quay County",4,44,77,36,41
050,35,037,"New Mexico","Quay County",4,45,82,44,38
050,35,037,"New Mexico","Quay County",4,46,73,41,32
050,35,037,"New Mexico","Quay County",4,47,77,34,43
050,35,037,"New Mexico","Quay County",4,48,83,37,46
050,35,037,"New Mexico","Quay County",4,49,88,39,49
050,35,037,"New Mexico","Quay County",4,50,77,44,33
050,35,037,"New Mexico","Quay County",4,51,96,42,54
050,35,037,"New Mexico","Quay County",4,52,98,42,56
050,35,037,"New Mexico","Quay County",4,53,112,56,56
050,35,037,"New Mexico","Quay County",4,54,100,57,43
050,35,037,"New Mexico","Quay County",4,55,113,63,50
050,35,037,"New Mexico","Quay County",4,56,119,56,63
050,35,037,"New Mexico","Quay County",4,57,124,54,70
050,35,037,"New Mexico","Quay County",4,58,119,56,63
050,35,037,"New Mexico","Quay County",4,59,122,60,62
050,35,037,"New Mexico","Quay County",4,60,141,73,68
050,35,037,"New Mexico","Quay County",4,61,136,70,66
050,35,037,"New Mexico","Quay County",4,62,117,59,58
050,35,037,"New Mexico","Quay County",4,63,111,60,51
050,35,037,"New Mexico","Quay County",4,64,140,66,74
050,35,037,"New Mexico","Quay County",4,65,158,71,87
050,35,037,"New Mexico","Quay County",4,66,120,50,70
050,35,037,"New Mexico","Quay County",4,67,119,50,69
050,35,037,"New Mexico","Quay County",4,68,145,68,77
050,35,037,"New Mexico","Quay County",4,69,145,71,74
050,35,037,"New Mexico","Quay County",4,70,134,63,71
050,35,037,"New Mexico","Quay County",4,71,132,61,71
050,35,037,"New Mexico","Quay County",4,72,109,59,50
050,35,037,"New Mexico","Quay County",4,73,120,59,61
050,35,037,"New Mexico","Quay County",4,74,132,64,68
050,35,037,"New Mexico","Quay County",4,75,123,64,59
050,35,037,"New Mexico","Quay County",4,76,96,49,47
050,35,037,"New Mexico","Quay County",4,77,84,41,43
050,35,037,"New Mexico","Quay County",4,78,80,34,46
050,35,037,"New Mexico","Quay County",4,79,91,43,48
050,35,037,"New Mexico","Quay County",4,80,78,40,38
050,35,037,"New Mexico","Quay County",4,81,68,34,34
050,35,037,"New Mexico","Quay County",4,82,53,27,26
050,35,037,"New Mexico","Quay County",4,83,60,32,28
050,35,037,"New Mexico","Quay County",4,84,53,29,24
050,35,037,"New Mexico","Quay County",4,85,221,92,129
050,35,037,"New Mexico","Quay County",5,0,62,26,36
050,35,037,"New Mexico","Quay County",5,1,71,35,36
050,35,037,"New Mexico","Quay County",5,2,76,32,44
050,35,037,"New Mexico","Quay County",5,3,93,41,52
050,35,037,"New Mexico","Quay County",5,4,103,47,56
050,35,037,"New Mexico","Quay County",5,5,103,44,59
050,35,037,"New Mexico","Quay County",5,6,97,51,46
050,35,037,"New Mexico","Quay County",5,7,96,55,41
050,35,037,"New Mexico","Quay County",5,8,96,47,49
050,35,037,"New Mexico","Quay County",5,9,92,36,56
050,35,037,"New Mexico","Quay County",5,10,103,46,57
050,35,037,"New Mexico","Quay County",5,11,108,47,61
050,35,037,"New Mexico","Quay County",5,12,109,48,61
050,35,037,"New Mexico","Quay County",5,13,106,58,48
050,35,037,"New Mexico","Quay County",5,14,105,51,54
050,35,037,"New Mexico","Quay County",5,15,117,59,58
050,35,037,"New Mexico","Quay County",5,16,105,52,53
050,35,037,"New Mexico","Quay County",5,17,109,53,56
050,35,037,"New Mexico","Quay County",5,18,101,55,46
050,35,037,"New Mexico","Quay County",5,19,85,44,41
050,35,037,"New Mexico","Quay County",5,20,78,41,37
050,35,037,"New Mexico","Quay County",5,21,94,52,42
050,35,037,"New Mexico","Quay County",5,22,83,37,46
050,35,037,"New Mexico","Quay County",5,23,102,38,64
050,35,037,"New Mexico","Quay County",5,24,66,37,29
050,35,037,"New Mexico","Quay County",5,25,83,51,32
050,35,037,"New Mexico","Quay County",5,26,64,36,28
050,35,037,"New Mexico","Quay County",5,27,76,34,42
050,35,037,"New Mexico","Quay County",5,28,79,47,32
050,35,037,"New Mexico","Quay County",5,29,82,47,35
050,35,037,"New Mexico","Quay County",5,30,89,51,38
050,35,037,"New Mexico","Quay County",5,31,97,49,48
050,35,037,"New Mexico","Quay County",5,32,88,45,43
050,35,037,"New Mexico","Quay County",5,33,103,58,45
050,35,037,"New Mexico","Quay County",5,34,105,56,49
050,35,037,"New Mexico","Quay County",5,35,82,44,38
050,35,037,"New Mexico","Quay County",5,36,91,46,45
050,35,037,"New Mexico","Quay County",5,37,83,46,37
050,35,037,"New Mexico","Quay County",5,38,78,38,40
050,35,037,"New Mexico","Quay County",5,39,97,48,49
050,35,037,"New Mexico","Quay County",5,40,105,52,53
050,35,037,"New Mexico","Quay County",5,41,101,52,49
050,35,037,"New Mexico","Quay County",5,42,93,49,44
050,35,037,"New Mexico","Quay County",5,43,102,55,47
050,35,037,"New Mexico","Quay County",5,44,80,33,47
050,35,037,"New Mexico","Quay County",5,45,76,35,41
050,35,037,"New Mexico","Quay County",5,46,86,45,41
050,35,037,"New Mexico","Quay County",5,47,73,40,33
050,35,037,"New Mexico","Quay County",5,48,80,32,48
050,35,037,"New Mexico","Quay County",5,49,85,37,48
050,35,037,"New Mexico","Quay County",5,50,92,44,48
050,35,037,"New Mexico","Quay County",5,51,79,43,36
050,35,037,"New Mexico","Quay County",5,52,97,43,54
050,35,037,"New Mexico","Quay County",5,53,94,46,48
050,35,037,"New Mexico","Quay County",5,54,111,54,57
050,35,037,"New Mexico","Quay County",5,55,102,53,49
050,35,037,"New Mexico","Quay County",5,56,115,61,54
050,35,037,"New Mexico","Quay County",5,57,122,57,65
050,35,037,"New Mexico","Quay County",5,58,117,52,65
050,35,037,"New Mexico","Quay County",5,59,113,58,55
050,35,037,"New Mexico","Quay County",5,60,115,58,57
050,35,037,"New Mexico","Quay County",5,61,128,66,62
050,35,037,"New Mexico","Quay County",5,62,140,72,68
050,35,037,"New Mexico","Quay County",5,63,114,57,57
050,35,037,"New Mexico","Quay County",5,64,110,62,48
050,35,037,"New Mexico","Quay County",5,65,142,67,75
050,35,037,"New Mexico","Quay County",5,66,155,69,86
050,35,037,"New Mexico","Quay County",5,67,115,47,68
050,35,037,"New Mexico","Quay County",5,68,118,50,68
050,35,037,"New Mexico","Quay County",5,69,147,67,80
050,35,037,"New Mexico","Quay County",5,70,148,71,77
050,35,037,"New Mexico","Quay County",5,71,133,62,71
050,35,037,"New Mexico","Quay County",5,72,129,61,68
050,35,037,"New Mexico","Quay County",5,73,105,57,48
050,35,037,"New Mexico","Quay County",5,74,117,59,58
050,35,037,"New Mexico","Quay County",5,75,124,61,63
050,35,037,"New Mexico","Quay County",5,76,117,61,56
050,35,037,"New Mexico","Quay County",5,77,91,45,46
050,35,037,"New Mexico","Quay County",5,78,77,35,42
050,35,037,"New Mexico","Quay County",5,79,69,27,42
050,35,037,"New Mexico","Quay County",5,80,81,37,44
050,35,037,"New Mexico","Quay County",5,81,69,34,35
050,35,037,"New Mexico","Quay County",5,82,60,32,28
050,35,037,"New Mexico","Quay County",5,83,49,26,23
050,35,037,"New Mexico","Quay County",5,84,59,32,27
050,35,037,"New Mexico","Quay County",5,85,218,96,122
050,35,039,"New Mexico","Rio Arriba County",1,0,403,198,205
050,35,039,"New Mexico","Rio Arriba County",1,1,399,193,206
050,35,039,"New Mexico","Rio Arriba County",1,2,440,242,198
050,35,039,"New Mexico","Rio Arriba County",1,3,497,271,226
050,35,039,"New Mexico","Rio Arriba County",1,4,509,268,241
050,35,039,"New Mexico","Rio Arriba County",1,5,524,255,269
050,35,039,"New Mexico","Rio Arriba County",1,6,552,295,257
050,35,039,"New Mexico","Rio Arriba County",1,7,547,263,284
050,35,039,"New Mexico","Rio Arriba County",1,8,549,249,300
050,35,039,"New Mexico","Rio Arriba County",1,9,551,275,276
050,35,039,"New Mexico","Rio Arriba County",1,10,502,245,257
050,35,039,"New Mexico","Rio Arriba County",1,11,503,244,259
050,35,039,"New Mexico","Rio Arriba County",1,12,571,292,279
050,35,039,"New Mexico","Rio Arriba County",1,13,568,275,293
050,35,039,"New Mexico","Rio Arriba County",1,14,549,272,277
050,35,039,"New Mexico","Rio Arriba County",1,15,538,268,270
050,35,039,"New Mexico","Rio Arriba County",1,16,546,285,261
050,35,039,"New Mexico","Rio Arriba County",1,17,541,277,264
050,35,039,"New Mexico","Rio Arriba County",1,18,488,256,232
050,35,039,"New Mexico","Rio Arriba County",1,19,473,239,234
050,35,039,"New Mexico","Rio Arriba County",1,20,454,230,224
050,35,039,"New Mexico","Rio Arriba County",1,21,450,231,219
050,35,039,"New Mexico","Rio Arriba County",1,22,432,213,219
050,35,039,"New Mexico","Rio Arriba County",1,23,397,197,200
050,35,039,"New Mexico","Rio Arriba County",1,24,415,213,202
050,35,039,"New Mexico","Rio Arriba County",1,25,455,233,222
050,35,039,"New Mexico","Rio Arriba County",1,26,443,219,224
050,35,039,"New Mexico","Rio Arriba County",1,27,441,235,206
050,35,039,"New Mexico","Rio Arriba County",1,28,470,227,243
050,35,039,"New Mexico","Rio Arriba County",1,29,440,228,212
050,35,039,"New Mexico","Rio Arriba County",1,30,480,250,230
050,35,039,"New Mexico","Rio Arriba County",1,31,472,232,240
050,35,039,"New Mexico","Rio Arriba County",1,32,461,226,235
050,35,039,"New Mexico","Rio Arriba County",1,33,481,241,240
050,35,039,"New Mexico","Rio Arriba County",1,34,487,252,235
050,35,039,"New Mexico","Rio Arriba County",1,35,443,225,218
050,35,039,"New Mexico","Rio Arriba County",1,36,449,215,234
050,35,039,"New Mexico","Rio Arriba County",1,37,452,211,241
050,35,039,"New Mexico","Rio Arriba County",1,38,423,217,206
050,35,039,"New Mexico","Rio Arriba County",1,39,464,239,225
050,35,039,"New Mexico","Rio Arriba County",1,40,487,238,249
050,35,039,"New Mexico","Rio Arriba County",1,41,444,219,225
050,35,039,"New Mexico","Rio Arriba County",1,42,427,203,224
050,35,039,"New Mexico","Rio Arriba County",1,43,433,228,205
050,35,039,"New Mexico","Rio Arriba County",1,44,445,245,200
050,35,039,"New Mexico","Rio Arriba County",1,45,400,198,202
050,35,039,"New Mexico","Rio Arriba County",1,46,431,210,221
050,35,039,"New Mexico","Rio Arriba County",1,47,469,222,247
050,35,039,"New Mexico","Rio Arriba County",1,48,478,233,245
050,35,039,"New Mexico","Rio Arriba County",1,49,508,256,252
050,35,039,"New Mexico","Rio Arriba County",1,50,510,256,254
050,35,039,"New Mexico","Rio Arriba County",1,51,457,225,232
050,35,039,"New Mexico","Rio Arriba County",1,52,479,231,248
050,35,039,"New Mexico","Rio Arriba County",1,53,489,244,245
050,35,039,"New Mexico","Rio Arriba County",1,54,477,247,230
050,35,039,"New Mexico","Rio Arriba County",1,55,526,259,267
050,35,039,"New Mexico","Rio Arriba County",1,56,590,275,315
050,35,039,"New Mexico","Rio Arriba County",1,57,595,302,293
050,35,039,"New Mexico","Rio Arriba County",1,58,581,296,285
050,35,039,"New Mexico","Rio Arriba County",1,59,602,300,302
050,35,039,"New Mexico","Rio Arriba County",1,60,598,294,304
050,35,039,"New Mexico","Rio Arriba County",1,61,597,295,302
050,35,039,"New Mexico","Rio Arriba County",1,62,661,328,333
050,35,039,"New Mexico","Rio Arriba County",1,63,619,304,315
050,35,039,"New Mexico","Rio Arriba County",1,64,575,274,301
050,35,039,"New Mexico","Rio Arriba County",1,65,552,258,294
050,35,039,"New Mexico","Rio Arriba County",1,66,574,270,304
050,35,039,"New Mexico","Rio Arriba County",1,67,547,251,296
050,35,039,"New Mexico","Rio Arriba County",1,68,539,247,292
050,35,039,"New Mexico","Rio Arriba County",1,69,514,258,256
050,35,039,"New Mexico","Rio Arriba County",1,70,474,234,240
050,35,039,"New Mexico","Rio Arriba County",1,71,460,226,234
050,35,039,"New Mexico","Rio Arriba County",1,72,468,214,254
050,35,039,"New Mexico","Rio Arriba County",1,73,464,220,244
050,35,039,"New Mexico","Rio Arriba County",1,74,345,163,182
050,35,039,"New Mexico","Rio Arriba County",1,75,341,159,182
050,35,039,"New Mexico","Rio Arriba County",1,76,310,144,166
050,35,039,"New Mexico","Rio Arriba County",1,77,285,155,130
050,35,039,"New Mexico","Rio Arriba County",1,78,275,137,138
050,35,039,"New Mexico","Rio Arriba County",1,79,264,127,137
050,35,039,"New Mexico","Rio Arriba County",1,80,234,118,116
050,35,039,"New Mexico","Rio Arriba County",1,81,220,99,121
050,35,039,"New Mexico","Rio Arriba County",1,82,196,88,108
050,35,039,"New Mexico","Rio Arriba County",1,83,175,72,103
050,35,039,"New Mexico","Rio Arriba County",1,84,154,63,91
050,35,039,"New Mexico","Rio Arriba County",1,85,832,307,525
050,35,039,"New Mexico","Rio Arriba County",2,0,386,183,203
050,35,039,"New Mexico","Rio Arriba County",2,1,399,192,207
050,35,039,"New Mexico","Rio Arriba County",2,2,430,230,200
050,35,039,"New Mexico","Rio Arriba County",2,3,482,262,220
050,35,039,"New Mexico","Rio Arriba County",2,4,506,268,238
050,35,039,"New Mexico","Rio Arriba County",2,5,522,259,263
050,35,039,"New Mexico","Rio Arriba County",2,6,540,283,257
050,35,039,"New Mexico","Rio Arriba County",2,7,538,266,272
050,35,039,"New Mexico","Rio Arriba County",2,8,545,250,295
050,35,039,"New Mexico","Rio Arriba County",2,9,552,270,282
050,35,039,"New Mexico","Rio Arriba County",2,10,512,251,261
050,35,039,"New Mexico","Rio Arriba County",2,11,499,242,257
050,35,039,"New Mexico","Rio Arriba County",2,12,556,280,276
050,35,039,"New Mexico","Rio Arriba County",2,13,568,281,287
050,35,039,"New Mexico","Rio Arriba County",2,14,551,273,278
050,35,039,"New Mexico","Rio Arriba County",2,15,545,270,275
050,35,039,"New Mexico","Rio Arriba County",2,16,544,281,263
050,35,039,"New Mexico","Rio Arriba County",2,17,539,277,262
050,35,039,"New Mexico","Rio Arriba County",2,18,487,252,235
050,35,039,"New Mexico","Rio Arriba County",2,19,466,237,229
050,35,039,"New Mexico","Rio Arriba County",2,20,462,233,229
050,35,039,"New Mexico","Rio Arriba County",2,21,449,231,218
050,35,039,"New Mexico","Rio Arriba County",2,22,432,215,217
050,35,039,"New Mexico","Rio Arriba County",2,23,405,203,202
050,35,039,"New Mexico","Rio Arriba County",2,24,407,206,201
050,35,039,"New Mexico","Rio Arriba County",2,25,444,226,218
050,35,039,"New Mexico","Rio Arriba County",2,26,446,223,223
050,35,039,"New Mexico","Rio Arriba County",2,27,438,228,210
050,35,039,"New Mexico","Rio Arriba County",2,28,463,229,234
050,35,039,"New Mexico","Rio Arriba County",2,29,449,231,218
050,35,039,"New Mexico","Rio Arriba County",2,30,475,247,228
050,35,039,"New Mexico","Rio Arriba County",2,31,472,236,236
050,35,039,"New Mexico","Rio Arriba County",2,32,463,228,235
050,35,039,"New Mexico","Rio Arriba County",2,33,476,238,238
050,35,039,"New Mexico","Rio Arriba County",2,34,482,246,236
050,35,039,"New Mexico","Rio Arriba County",2,35,454,231,223
050,35,039,"New Mexico","Rio Arriba County",2,36,445,214,231
050,35,039,"New Mexico","Rio Arriba County",2,37,450,211,239
050,35,039,"New Mexico","Rio Arriba County",2,38,432,218,214
050,35,039,"New Mexico","Rio Arriba County",2,39,450,233,217
050,35,039,"New Mexico","Rio Arriba County",2,40,489,243,246
050,35,039,"New Mexico","Rio Arriba County",2,41,451,223,228
050,35,039,"New Mexico","Rio Arriba County",2,42,422,204,218
050,35,039,"New Mexico","Rio Arriba County",2,43,436,226,210
050,35,039,"New Mexico","Rio Arriba County",2,44,434,235,199
050,35,039,"New Mexico","Rio Arriba County",2,45,412,210,202
050,35,039,"New Mexico","Rio Arriba County",2,46,425,209,216
050,35,039,"New Mexico","Rio Arriba County",2,47,460,217,243
050,35,039,"New Mexico","Rio Arriba County",2,48,477,232,245
050,35,039,"New Mexico","Rio Arriba County",2,49,501,251,250
050,35,039,"New Mexico","Rio Arriba County",2,50,505,253,252
050,35,039,"New Mexico","Rio Arriba County",2,51,467,231,236
050,35,039,"New Mexico","Rio Arriba County",2,52,473,231,242
050,35,039,"New Mexico","Rio Arriba County",2,53,486,240,246
050,35,039,"New Mexico","Rio Arriba County",2,54,480,246,234
050,35,039,"New Mexico","Rio Arriba County",2,55,516,257,259
050,35,039,"New Mexico","Rio Arriba County",2,56,578,275,303
050,35,039,"New Mexico","Rio Arriba County",2,57,593,296,297
050,35,039,"New Mexico","Rio Arriba County",2,58,585,297,288
050,35,039,"New Mexico","Rio Arriba County",2,59,587,293,294
050,35,039,"New Mexico","Rio Arriba County",2,60,602,297,305
050,35,039,"New Mexico","Rio Arriba County",2,61,595,293,302
050,35,039,"New Mexico","Rio Arriba County",2,62,640,318,322
050,35,039,"New Mexico","Rio Arriba County",2,63,632,312,320
050,35,039,"New Mexico","Rio Arriba County",2,64,579,279,300
050,35,039,"New Mexico","Rio Arriba County",2,65,556,261,295
050,35,039,"New Mexico","Rio Arriba County",2,66,564,262,302
050,35,039,"New Mexico","Rio Arriba County",2,67,551,252,299
050,35,039,"New Mexico","Rio Arriba County",2,68,537,245,292
050,35,039,"New Mexico","Rio Arriba County",2,69,519,256,263
050,35,039,"New Mexico","Rio Arriba County",2,70,484,240,244
050,35,039,"New Mexico","Rio Arriba County",2,71,460,226,234
050,35,039,"New Mexico","Rio Arriba County",2,72,460,213,247
050,35,039,"New Mexico","Rio Arriba County",2,73,473,221,252
050,35,039,"New Mexico","Rio Arriba County",2,74,360,170,190
050,35,039,"New Mexico","Rio Arriba County",2,75,338,155,183
050,35,039,"New Mexico","Rio Arriba County",2,76,311,145,166
050,35,039,"New Mexico","Rio Arriba County",2,77,293,153,140
050,35,039,"New Mexico","Rio Arriba County",2,78,274,140,134
050,35,039,"New Mexico","Rio Arriba County",2,79,262,125,137
050,35,039,"New Mexico","Rio Arriba County",2,80,240,120,120
050,35,039,"New Mexico","Rio Arriba County",2,81,221,104,117
050,35,039,"New Mexico","Rio Arriba County",2,82,201,91,110
050,35,039,"New Mexico","Rio Arriba County",2,83,178,75,103
050,35,039,"New Mexico","Rio Arriba County",2,84,157,64,93
050,35,039,"New Mexico","Rio Arriba County",2,85,846,314,532
050,35,039,"New Mexico","Rio Arriba County",3,0,425,234,191
050,35,039,"New Mexico","Rio Arriba County",3,1,400,183,217
050,35,039,"New Mexico","Rio Arriba County",3,2,377,181,196
050,35,039,"New Mexico","Rio Arriba County",3,3,444,241,203
050,35,039,"New Mexico","Rio Arriba County",3,4,491,274,217
050,35,039,"New Mexico","Rio Arriba County",3,5,505,276,229
050,35,039,"New Mexico","Rio Arriba County",3,6,530,254,276
050,35,039,"New Mexico","Rio Arriba County",3,7,528,267,261
050,35,039,"New Mexico","Rio Arriba County",3,8,551,279,272
050,35,039,"New Mexico","Rio Arriba County",3,9,552,253,299
050,35,039,"New Mexico","Rio Arriba County",3,10,557,273,284
050,35,039,"New Mexico","Rio Arriba County",3,11,508,239,269
050,35,039,"New Mexico","Rio Arriba County",3,12,517,254,263
050,35,039,"New Mexico","Rio Arriba County",3,13,566,284,282
050,35,039,"New Mexico","Rio Arriba County",3,14,572,284,288
050,35,039,"New Mexico","Rio Arriba County",3,15,565,278,287
050,35,039,"New Mexico","Rio Arriba County",3,16,523,259,264
050,35,039,"New Mexico","Rio Arriba County",3,17,532,275,257
050,35,039,"New Mexico","Rio Arriba County",3,18,499,264,235
050,35,039,"New Mexico","Rio Arriba County",3,19,447,226,221
050,35,039,"New Mexico","Rio Arriba County",3,20,455,234,221
050,35,039,"New Mexico","Rio Arriba County",3,21,478,241,237
050,35,039,"New Mexico","Rio Arriba County",3,22,435,216,219
050,35,039,"New Mexico","Rio Arriba County",3,23,436,213,223
050,35,039,"New Mexico","Rio Arriba County",3,24,401,203,198
050,35,039,"New Mexico","Rio Arriba County",3,25,399,208,191
050,35,039,"New Mexico","Rio Arriba County",3,26,443,223,220
050,35,039,"New Mexico","Rio Arriba County",3,27,434,218,216
050,35,039,"New Mexico","Rio Arriba County",3,28,445,225,220
050,35,039,"New Mexico","Rio Arriba County",3,29,462,220,242
050,35,039,"New Mexico","Rio Arriba County",3,30,456,230,226
050,35,039,"New Mexico","Rio Arriba County",3,31,477,253,224
050,35,039,"New Mexico","Rio Arriba County",3,32,461,229,232
050,35,039,"New Mexico","Rio Arriba County",3,33,467,233,234
050,35,039,"New Mexico","Rio Arriba County",3,34,481,239,242
050,35,039,"New Mexico","Rio Arriba County",3,35,494,257,237
050,35,039,"New Mexico","Rio Arriba County",3,36,469,235,234
050,35,039,"New Mexico","Rio Arriba County",3,37,470,226,244
050,35,039,"New Mexico","Rio Arriba County",3,38,434,202,232
050,35,039,"New Mexico","Rio Arriba County",3,39,435,229,206
050,35,039,"New Mexico","Rio Arriba County",3,40,460,238,222
050,35,039,"New Mexico","Rio Arriba County",3,41,502,250,252
050,35,039,"New Mexico","Rio Arriba County",3,42,438,213,225
050,35,039,"New Mexico","Rio Arriba County",3,43,415,203,212
050,35,039,"New Mexico","Rio Arriba County",3,44,432,224,208
050,35,039,"New Mexico","Rio Arriba County",3,45,442,233,209
050,35,039,"New Mexico","Rio Arriba County",3,46,422,214,208
050,35,039,"New Mexico","Rio Arriba County",3,47,410,194,216
050,35,039,"New Mexico","Rio Arriba County",3,48,464,216,248
050,35,039,"New Mexico","Rio Arriba County",3,49,474,226,248
050,35,039,"New Mexico","Rio Arriba County",3,50,500,249,251
050,35,039,"New Mexico","Rio Arriba County",3,51,499,250,249
050,35,039,"New Mexico","Rio Arriba County",3,52,458,225,233
050,35,039,"New Mexico","Rio Arriba County",3,53,444,214,230
050,35,039,"New Mexico","Rio Arriba County",3,54,481,237,244
050,35,039,"New Mexico","Rio Arriba County",3,55,493,254,239
050,35,039,"New Mexico","Rio Arriba County",3,56,525,261,264
050,35,039,"New Mexico","Rio Arriba County",3,57,553,261,292
050,35,039,"New Mexico","Rio Arriba County",3,58,583,300,283
050,35,039,"New Mexico","Rio Arriba County",3,59,567,278,289
050,35,039,"New Mexico","Rio Arriba County",3,60,586,293,293
050,35,039,"New Mexico","Rio Arriba County",3,61,577,284,293
050,35,039,"New Mexico","Rio Arriba County",3,62,590,290,300
050,35,039,"New Mexico","Rio Arriba County",3,63,623,313,310
050,35,039,"New Mexico","Rio Arriba County",3,64,629,306,323
050,35,039,"New Mexico","Rio Arriba County",3,65,563,277,286
050,35,039,"New Mexico","Rio Arriba County",3,66,547,260,287
050,35,039,"New Mexico","Rio Arriba County",3,67,557,257,300
050,35,039,"New Mexico","Rio Arriba County",3,68,544,243,301
050,35,039,"New Mexico","Rio Arriba County",3,69,538,251,287
050,35,039,"New Mexico","Rio Arriba County",3,70,511,252,259
050,35,039,"New Mexico","Rio Arriba County",3,71,477,234,243
050,35,039,"New Mexico","Rio Arriba County",3,72,431,214,217
050,35,039,"New Mexico","Rio Arriba County",3,73,450,205,245
050,35,039,"New Mexico","Rio Arriba County",3,74,463,214,249
050,35,039,"New Mexico","Rio Arriba County",3,75,352,163,189
050,35,039,"New Mexico","Rio Arriba County",3,76,333,151,182
050,35,039,"New Mexico","Rio Arriba County",3,77,307,144,163
050,35,039,"New Mexico","Rio Arriba County",3,78,288,151,137
050,35,039,"New Mexico","Rio Arriba County",3,79,259,132,127
050,35,039,"New Mexico","Rio Arriba County",3,80,257,122,135
050,35,039,"New Mexico","Rio Arriba County",3,81,234,117,117
050,35,039,"New Mexico","Rio Arriba County",3,82,213,99,114
050,35,039,"New Mexico","Rio Arriba County",3,83,190,82,108
050,35,039,"New Mexico","Rio Arriba County",3,84,164,70,94
050,35,039,"New Mexico","Rio Arriba County",3,85,850,297,553
050,35,039,"New Mexico","Rio Arriba County",4,0,398,214,184
050,35,039,"New Mexico","Rio Arriba County",4,1,433,238,195
050,35,039,"New Mexico","Rio Arriba County",4,2,397,179,218
050,35,039,"New Mexico","Rio Arriba County",4,3,381,187,194
050,35,039,"New Mexico","Rio Arriba County",4,4,440,229,211
050,35,039,"New Mexico","Rio Arriba County",4,5,491,270,221
050,35,039,"New Mexico","Rio Arriba County",4,6,500,272,228
050,35,039,"New Mexico","Rio Arriba County",4,7,528,262,266
050,35,039,"New Mexico","Rio Arriba County",4,8,536,272,264
050,35,039,"New Mexico","Rio Arriba County",4,9,552,281,271
050,35,039,"New Mexico","Rio Arriba County",4,10,555,259,296
050,35,039,"New Mexico","Rio Arriba County",4,11,553,273,280
050,35,039,"New Mexico","Rio Arriba County",4,12,508,242,266
050,35,039,"New Mexico","Rio Arriba County",4,13,497,242,255
050,35,039,"New Mexico","Rio Arriba County",4,14,573,281,292
050,35,039,"New Mexico","Rio Arriba County",4,15,569,284,285
050,35,039,"New Mexico","Rio Arriba County",4,16,568,282,286
050,35,039,"New Mexico","Rio Arriba County",4,17,546,279,267
050,35,039,"New Mexico","Rio Arriba County",4,18,497,263,234
050,35,039,"New Mexico","Rio Arriba County",4,19,458,238,220
050,35,039,"New Mexico","Rio Arriba County",4,20,431,219,212
050,35,039,"New Mexico","Rio Arriba County",4,21,462,240,222
050,35,039,"New Mexico","Rio Arriba County",4,22,467,237,230
050,35,039,"New Mexico","Rio Arriba County",4,23,406,209,197
050,35,039,"New Mexico","Rio Arriba County",4,24,449,219,230
050,35,039,"New Mexico","Rio Arriba County",4,25,392,207,185
050,35,039,"New Mexico","Rio Arriba County",4,26,412,226,186
050,35,039,"New Mexico","Rio Arriba County",4,27,433,219,214
050,35,039,"New Mexico","Rio Arriba County",4,28,422,208,214
050,35,039,"New Mexico","Rio Arriba County",4,29,432,214,218
050,35,039,"New Mexico","Rio Arriba County",4,30,459,216,243
050,35,039,"New Mexico","Rio Arriba County",4,31,442,222,220
050,35,039,"New Mexico","Rio Arriba County",4,32,459,240,219
050,35,039,"New Mexico","Rio Arriba County",4,33,466,228,238
050,35,039,"New Mexico","Rio Arriba County",4,34,448,223,225
050,35,039,"New Mexico","Rio Arriba County",4,35,487,247,240
050,35,039,"New Mexico","Rio Arriba County",4,36,501,258,243
050,35,039,"New Mexico","Rio Arriba County",4,37,463,234,229
050,35,039,"New Mexico","Rio Arriba County",4,38,473,233,240
050,35,039,"New Mexico","Rio Arriba County",4,39,447,211,236
050,35,039,"New Mexico","Rio Arriba County",4,40,423,216,207
050,35,039,"New Mexico","Rio Arriba County",4,41,453,237,216
050,35,039,"New Mexico","Rio Arriba County",4,42,493,245,248
050,35,039,"New Mexico","Rio Arriba County",4,43,456,229,227
050,35,039,"New Mexico","Rio Arriba County",4,44,408,197,211
050,35,039,"New Mexico","Rio Arriba County",4,45,441,222,219
050,35,039,"New Mexico","Rio Arriba County",4,46,435,230,205
050,35,039,"New Mexico","Rio Arriba County",4,47,412,210,202
050,35,039,"New Mexico","Rio Arriba County",4,48,412,198,214
050,35,039,"New Mexico","Rio Arriba County",4,49,458,215,243
050,35,039,"New Mexico","Rio Arriba County",4,50,470,234,236
050,35,039,"New Mexico","Rio Arriba County",4,51,504,251,253
050,35,039,"New Mexico","Rio Arriba County",4,52,491,242,249
050,35,039,"New Mexico","Rio Arriba County",4,53,455,219,236
050,35,039,"New Mexico","Rio Arriba County",4,54,443,214,229
050,35,039,"New Mexico","Rio Arriba County",4,55,471,233,238
050,35,039,"New Mexico","Rio Arriba County",4,56,499,254,245
050,35,039,"New Mexico","Rio Arriba County",4,57,520,258,262
050,35,039,"New Mexico","Rio Arriba County",4,58,541,252,289
050,35,039,"New Mexico","Rio Arriba County",4,59,561,281,280
050,35,039,"New Mexico","Rio Arriba County",4,60,559,268,291
050,35,039,"New Mexico","Rio Arriba County",4,61,588,292,296
050,35,039,"New Mexico","Rio Arriba County",4,62,566,280,286
050,35,039,"New Mexico","Rio Arriba County",4,63,592,292,300
050,35,039,"New Mexico","Rio Arriba County",4,64,614,306,308
050,35,039,"New Mexico","Rio Arriba County",4,65,620,305,315
050,35,039,"New Mexico","Rio Arriba County",4,66,561,275,286
050,35,039,"New Mexico","Rio Arriba County",4,67,550,260,290
050,35,039,"New Mexico","Rio Arriba County",4,68,561,250,311
050,35,039,"New Mexico","Rio Arriba County",4,69,535,234,301
050,35,039,"New Mexico","Rio Arriba County",4,70,524,244,280
050,35,039,"New Mexico","Rio Arriba County",4,71,493,245,248
050,35,039,"New Mexico","Rio Arriba County",4,72,474,231,243
050,35,039,"New Mexico","Rio Arriba County",4,73,428,212,216
050,35,039,"New Mexico","Rio Arriba County",4,74,437,201,236
050,35,039,"New Mexico","Rio Arriba County",4,75,442,205,237
050,35,039,"New Mexico","Rio Arriba County",4,76,339,159,180
050,35,039,"New Mexico","Rio Arriba County",4,77,320,142,178
050,35,039,"New Mexico","Rio Arriba County",4,78,303,146,157
050,35,039,"New Mexico","Rio Arriba County",4,79,277,141,136
050,35,039,"New Mexico","Rio Arriba County",4,80,247,127,120
050,35,039,"New Mexico","Rio Arriba County",4,81,243,116,127
050,35,039,"New Mexico","Rio Arriba County",4,82,221,111,110
050,35,039,"New Mexico","Rio Arriba County",4,83,197,90,107
050,35,039,"New Mexico","Rio Arriba County",4,84,171,70,101
050,35,039,"New Mexico","Rio Arriba County",4,85,852,300,552
050,35,039,"New Mexico","Rio Arriba County",5,0,405,216,189
050,35,039,"New Mexico","Rio Arriba County",5,1,373,204,169
050,35,039,"New Mexico","Rio Arriba County",5,2,434,237,197
050,35,039,"New Mexico","Rio Arriba County",5,3,404,178,226
050,35,039,"New Mexico","Rio Arriba County",5,4,384,190,194
050,35,039,"New Mexico","Rio Arriba County",5,5,452,239,213
050,35,039,"New Mexico","Rio Arriba County",5,6,509,288,221
050,35,039,"New Mexico","Rio Arriba County",5,7,510,281,229
050,35,039,"New Mexico","Rio Arriba County",5,8,510,262,248
050,35,039,"New Mexico","Rio Arriba County",5,9,539,275,264
050,35,039,"New Mexico","Rio Arriba County",5,10,544,280,264
050,35,039,"New Mexico","Rio Arriba County",5,11,547,255,292
050,35,039,"New Mexico","Rio Arriba County",5,12,566,277,289
050,35,039,"New Mexico","Rio Arriba County",5,13,502,239,263
050,35,039,"New Mexico","Rio Arriba County",5,14,497,239,258
050,35,039,"New Mexico","Rio Arriba County",5,15,562,281,281
050,35,039,"New Mexico","Rio Arriba County",5,16,577,290,287
050,35,039,"New Mexico","Rio Arriba County",5,17,573,293,280
050,35,039,"New Mexico","Rio Arriba County",5,18,510,272,238
050,35,039,"New Mexico","Rio Arriba County",5,19,459,247,212
050,35,039,"New Mexico","Rio Arriba County",5,20,442,224,218
050,35,039,"New Mexico","Rio Arriba County",5,21,449,235,214
050,35,039,"New Mexico","Rio Arriba County",5,22,461,240,221
050,35,039,"New Mexico","Rio Arriba County",5,23,462,225,237
050,35,039,"New Mexico","Rio Arriba County",5,24,417,224,193
050,35,039,"New Mexico","Rio Arriba County",5,25,439,214,225
050,35,039,"New Mexico","Rio Arriba County",5,26,406,213,193
050,35,039,"New Mexico","Rio Arriba County",5,27,403,225,178
050,35,039,"New Mexico","Rio Arriba County",5,28,440,220,220
050,35,039,"New Mexico","Rio Arriba County",5,29,419,205,214
050,35,039,"New Mexico","Rio Arriba County",5,30,434,211,223
050,35,039,"New Mexico","Rio Arriba County",5,31,466,227,239
050,35,039,"New Mexico","Rio Arriba County",5,32,446,226,220
050,35,039,"New Mexico","Rio Arriba County",5,33,466,245,221
050,35,039,"New Mexico","Rio Arriba County",5,34,470,235,235
050,35,039,"New Mexico","Rio Arriba County",5,35,451,223,228
050,35,039,"New Mexico","Rio Arriba County",5,36,495,252,243
050,35,039,"New Mexico","Rio Arriba County",5,37,501,260,241
050,35,039,"New Mexico","Rio Arriba County",5,38,456,233,223
050,35,039,"New Mexico","Rio Arriba County",5,39,456,223,233
050,35,039,"New Mexico","Rio Arriba County",5,40,452,204,248
050,35,039,"New Mexico","Rio Arriba County",5,41,421,215,206
050,35,039,"New Mexico","Rio Arriba County",5,42,454,236,218
050,35,039,"New Mexico","Rio Arriba County",5,43,493,244,249
050,35,039,"New Mexico","Rio Arriba County",5,44,453,228,225
050,35,039,"New Mexico","Rio Arriba County",5,45,400,194,206
050,35,039,"New Mexico","Rio Arriba County",5,46,436,215,221
050,35,039,"New Mexico","Rio Arriba County",5,47,432,229,203
050,35,039,"New Mexico","Rio Arriba County",5,48,400,206,194
050,35,039,"New Mexico","Rio Arriba County",5,49,406,198,208
050,35,039,"New Mexico","Rio Arriba County",5,50,453,226,227
050,35,039,"New Mexico","Rio Arriba County",5,51,471,231,240
050,35,039,"New Mexico","Rio Arriba County",5,52,505,249,256
050,35,039,"New Mexico","Rio Arriba County",5,53,480,234,246
050,35,039,"New Mexico","Rio Arriba County",5,54,459,222,237
050,35,039,"New Mexico","Rio Arriba County",5,55,443,212,231
050,35,039,"New Mexico","Rio Arriba County",5,56,469,230,239
050,35,039,"New Mexico","Rio Arriba County",5,57,483,241,242
050,35,039,"New Mexico","Rio Arriba County",5,58,513,252,261
050,35,039,"New Mexico","Rio Arriba County",5,59,525,245,280
050,35,039,"New Mexico","Rio Arriba County",5,60,568,282,286
050,35,039,"New Mexico","Rio Arriba County",5,61,542,260,282
050,35,039,"New Mexico","Rio Arriba County",5,62,580,288,292
050,35,039,"New Mexico","Rio Arriba County",5,63,563,280,283
050,35,039,"New Mexico","Rio Arriba County",5,64,587,284,303
050,35,039,"New Mexico","Rio Arriba County",5,65,605,302,303
050,35,039,"New Mexico","Rio Arriba County",5,66,606,298,308
050,35,039,"New Mexico","Rio Arriba County",5,67,562,276,286
050,35,039,"New Mexico","Rio Arriba County",5,68,550,254,296
050,35,039,"New Mexico","Rio Arriba County",5,69,554,247,307
050,35,039,"New Mexico","Rio Arriba County",5,70,526,227,299
050,35,039,"New Mexico","Rio Arriba County",5,71,513,239,274
050,35,039,"New Mexico","Rio Arriba County",5,72,488,238,250
050,35,039,"New Mexico","Rio Arriba County",5,73,458,224,234
050,35,039,"New Mexico","Rio Arriba County",5,74,426,212,214
050,35,039,"New Mexico","Rio Arriba County",5,75,428,194,234
050,35,039,"New Mexico","Rio Arriba County",5,76,429,197,232
050,35,039,"New Mexico","Rio Arriba County",5,77,324,150,174
050,35,039,"New Mexico","Rio Arriba County",5,78,311,136,175
050,35,039,"New Mexico","Rio Arriba County",5,79,285,135,150
050,35,039,"New Mexico","Rio Arriba County",5,80,263,133,130
050,35,039,"New Mexico","Rio Arriba County",5,81,236,121,115
050,35,039,"New Mexico","Rio Arriba County",5,82,228,110,118
050,35,039,"New Mexico","Rio Arriba County",5,83,209,103,106
050,35,039,"New Mexico","Rio Arriba County",5,84,177,78,99
050,35,039,"New Mexico","Rio Arriba County",5,85,874,307,567
050,35,041,"New Mexico","Roosevelt County",1,0,262,133,129
050,35,041,"New Mexico","Roosevelt County",1,1,258,132,126
050,35,041,"New Mexico","Roosevelt County",1,2,264,133,131
050,35,041,"New Mexico","Roosevelt County",1,3,253,122,131
050,35,041,"New Mexico","Roosevelt County",1,4,254,126,128
050,35,041,"New Mexico","Roosevelt County",1,5,253,137,116
050,35,041,"New Mexico","Roosevelt County",1,6,283,145,138
050,35,041,"New Mexico","Roosevelt County",1,7,256,125,131
050,35,041,"New Mexico","Roosevelt County",1,8,231,118,113
050,35,041,"New Mexico","Roosevelt County",1,9,251,128,123
050,35,041,"New Mexico","Roosevelt County",1,10,280,156,124
050,35,041,"New Mexico","Roosevelt County",1,11,278,142,136
050,35,041,"New Mexico","Roosevelt County",1,12,264,142,122
050,35,041,"New Mexico","Roosevelt County",1,13,287,159,128
050,35,041,"New Mexico","Roosevelt County",1,14,258,146,112
050,35,041,"New Mexico","Roosevelt County",1,15,261,127,134
050,35,041,"New Mexico","Roosevelt County",1,16,249,123,126
050,35,041,"New Mexico","Roosevelt County",1,17,260,134,126
050,35,041,"New Mexico","Roosevelt County",1,18,388,198,190
050,35,041,"New Mexico","Roosevelt County",1,19,515,257,258
050,35,041,"New Mexico","Roosevelt County",1,20,486,217,269
050,35,041,"New Mexico","Roosevelt County",1,21,580,300,280
050,35,041,"New Mexico","Roosevelt County",1,22,483,215,268
050,35,041,"New Mexico","Roosevelt County",1,23,440,237,203
050,35,041,"New Mexico","Roosevelt County",1,24,338,181,157
050,35,041,"New Mexico","Roosevelt County",1,25,319,161,158
050,35,041,"New Mexico","Roosevelt County",1,26,315,152,163
050,35,041,"New Mexico","Roosevelt County",1,27,271,148,123
050,35,041,"New Mexico","Roosevelt County",1,28,271,148,123
050,35,041,"New Mexico","Roosevelt County",1,29,218,110,108
050,35,041,"New Mexico","Roosevelt County",1,30,235,120,115
050,35,041,"New Mexico","Roosevelt County",1,31,222,121,101
050,35,041,"New Mexico","Roosevelt County",1,32,210,116,94
050,35,041,"New Mexico","Roosevelt County",1,33,225,115,110
050,35,041,"New Mexico","Roosevelt County",1,34,224,129,95
050,35,041,"New Mexico","Roosevelt County",1,35,225,115,110
050,35,041,"New Mexico","Roosevelt County",1,36,211,112,99
050,35,041,"New Mexico","Roosevelt County",1,37,205,121,84
050,35,041,"New Mexico","Roosevelt County",1,38,208,103,105
050,35,041,"New Mexico","Roosevelt County",1,39,232,126,106
050,35,041,"New Mexico","Roosevelt County",1,40,196,100,96
050,35,041,"New Mexico","Roosevelt County",1,41,192,97,95
050,35,041,"New Mexico","Roosevelt County",1,42,196,95,101
050,35,041,"New Mexico","Roosevelt County",1,43,197,98,99
050,35,041,"New Mexico","Roosevelt County",1,44,199,97,102
050,35,041,"New Mexico","Roosevelt County",1,45,188,105,83
050,35,041,"New Mexico","Roosevelt County",1,46,189,89,100
050,35,041,"New Mexico","Roosevelt County",1,47,193,86,107
050,35,041,"New Mexico","Roosevelt County",1,48,205,98,107
050,35,041,"New Mexico","Roosevelt County",1,49,188,90,98
050,35,041,"New Mexico","Roosevelt County",1,50,186,100,86
050,35,041,"New Mexico","Roosevelt County",1,51,193,97,96
050,35,041,"New Mexico","Roosevelt County",1,52,196,94,102
050,35,041,"New Mexico","Roosevelt County",1,53,192,105,87
050,35,041,"New Mexico","Roosevelt County",1,54,181,97,84
050,35,041,"New Mexico","Roosevelt County",1,55,180,97,83
050,35,041,"New Mexico","Roosevelt County",1,56,188,104,84
050,35,041,"New Mexico","Roosevelt County",1,57,189,90,99
050,35,041,"New Mexico","Roosevelt County",1,58,202,102,100
050,35,041,"New Mexico","Roosevelt County",1,59,193,95,98
050,35,041,"New Mexico","Roosevelt County",1,60,190,87,103
050,35,041,"New Mexico","Roosevelt County",1,61,214,96,118
050,35,041,"New Mexico","Roosevelt County",1,62,214,85,129
050,35,041,"New Mexico","Roosevelt County",1,63,204,92,112
050,35,041,"New Mexico","Roosevelt County",1,64,205,99,106
050,35,041,"New Mexico","Roosevelt County",1,65,182,92,90
050,35,041,"New Mexico","Roosevelt County",1,66,164,88,76
050,35,041,"New Mexico","Roosevelt County",1,67,163,82,81
050,35,041,"New Mexico","Roosevelt County",1,68,178,94,84
050,35,041,"New Mexico","Roosevelt County",1,69,176,81,95
050,35,041,"New Mexico","Roosevelt County",1,70,176,82,94
050,35,041,"New Mexico","Roosevelt County",1,71,165,77,88
050,35,041,"New Mexico","Roosevelt County",1,72,150,71,79
050,35,041,"New Mexico","Roosevelt County",1,73,129,65,64
050,35,041,"New Mexico","Roosevelt County",1,74,110,49,61
050,35,041,"New Mexico","Roosevelt County",1,75,111,54,57
050,35,041,"New Mexico","Roosevelt County",1,76,118,60,58
050,35,041,"New Mexico","Roosevelt County",1,77,109,55,54
050,35,041,"New Mexico","Roosevelt County",1,78,93,40,53
050,35,041,"New Mexico","Roosevelt County",1,79,88,36,52
050,35,041,"New Mexico","Roosevelt County",1,80,76,30,46
050,35,041,"New Mexico","Roosevelt County",1,81,78,33,45
050,35,041,"New Mexico","Roosevelt County",1,82,71,33,38
050,35,041,"New Mexico","Roosevelt County",1,83,56,31,25
050,35,041,"New Mexico","Roosevelt County",1,84,66,33,33
050,35,041,"New Mexico","Roosevelt County",1,85,336,133,203
050,35,041,"New Mexico","Roosevelt County",2,0,248,134,114
050,35,041,"New Mexico","Roosevelt County",2,1,256,132,124
050,35,041,"New Mexico","Roosevelt County",2,2,260,134,126
050,35,041,"New Mexico","Roosevelt County",2,3,253,124,129
050,35,041,"New Mexico","Roosevelt County",2,4,253,126,127
050,35,041,"New Mexico","Roosevelt County",2,5,253,135,118
050,35,041,"New Mexico","Roosevelt County",2,6,278,144,134
050,35,041,"New Mexico","Roosevelt County",2,7,260,129,131
050,35,041,"New Mexico","Roosevelt County",2,8,232,117,115
050,35,041,"New Mexico","Roosevelt County",2,9,245,125,120
050,35,041,"New Mexico","Roosevelt County",2,10,271,148,123
050,35,041,"New Mexico","Roosevelt County",2,11,278,145,133
050,35,041,"New Mexico","Roosevelt County",2,12,270,144,126
050,35,041,"New Mexico","Roosevelt County",2,13,279,155,124
050,35,041,"New Mexico","Roosevelt County",2,14,265,150,115
050,35,041,"New Mexico","Roosevelt County",2,15,257,129,128
050,35,041,"New Mexico","Roosevelt County",2,16,254,125,129
050,35,041,"New Mexico","Roosevelt County",2,17,258,132,126
050,35,041,"New Mexico","Roosevelt County",2,18,383,195,188
050,35,041,"New Mexico","Roosevelt County",2,19,517,258,259
050,35,041,"New Mexico","Roosevelt County",2,20,486,219,267
050,35,041,"New Mexico","Roosevelt County",2,21,569,297,272
050,35,041,"New Mexico","Roosevelt County",2,22,485,213,272
050,35,041,"New Mexico","Roosevelt County",2,23,442,238,204
050,35,041,"New Mexico","Roosevelt County",2,24,339,183,156
050,35,041,"New Mexico","Roosevelt County",2,25,311,159,152
050,35,041,"New Mexico","Roosevelt County",2,26,315,154,161
050,35,041,"New Mexico","Roosevelt County",2,27,277,149,128
050,35,041,"New Mexico","Roosevelt County",2,28,269,145,124
050,35,041,"New Mexico","Roosevelt County",2,29,227,116,111
050,35,041,"New Mexico","Roosevelt County",2,30,233,117,116
050,35,041,"New Mexico","Roosevelt County",2,31,223,122,101
050,35,041,"New Mexico","Roosevelt County",2,32,213,116,97
050,35,041,"New Mexico","Roosevelt County",2,33,219,115,104
050,35,041,"New Mexico","Roosevelt County",2,34,225,125,100
050,35,041,"New Mexico","Roosevelt County",2,35,225,120,105
050,35,041,"New Mexico","Roosevelt County",2,36,209,109,100
050,35,041,"New Mexico","Roosevelt County",2,37,207,119,88
050,35,041,"New Mexico","Roosevelt County",2,38,207,107,100
050,35,041,"New Mexico","Roosevelt County",2,39,224,121,103
050,35,041,"New Mexico","Roosevelt County",2,40,202,105,97
050,35,041,"New Mexico","Roosevelt County",2,41,190,97,93
050,35,041,"New Mexico","Roosevelt County",2,42,194,95,99
050,35,041,"New Mexico","Roosevelt County",2,43,199,98,101
050,35,041,"New Mexico","Roosevelt County",2,44,193,94,99
050,35,041,"New Mexico","Roosevelt County",2,45,193,104,89
050,35,041,"New Mexico","Roosevelt County",2,46,188,91,97
050,35,041,"New Mexico","Roosevelt County",2,47,191,87,104
050,35,041,"New Mexico","Roosevelt County",2,48,203,96,107
050,35,041,"New Mexico","Roosevelt County",2,49,194,92,102
050,35,041,"New Mexico","Roosevelt County",2,50,186,99,87
050,35,041,"New Mexico","Roosevelt County",2,51,191,96,95
050,35,041,"New Mexico","Roosevelt County",2,52,195,95,100
050,35,041,"New Mexico","Roosevelt County",2,53,192,102,90
050,35,041,"New Mexico","Roosevelt County",2,54,183,98,85
050,35,041,"New Mexico","Roosevelt County",2,55,180,97,83
050,35,041,"New Mexico","Roosevelt County",2,56,188,103,85
050,35,041,"New Mexico","Roosevelt County",2,57,188,93,95
050,35,041,"New Mexico","Roosevelt County",2,58,196,98,98
050,35,041,"New Mexico","Roosevelt County",2,59,193,95,98
050,35,041,"New Mexico","Roosevelt County",2,60,190,89,101
050,35,041,"New Mexico","Roosevelt County",2,61,209,95,114
050,35,041,"New Mexico","Roosevelt County",2,62,211,87,124
050,35,041,"New Mexico","Roosevelt County",2,63,207,90,117
050,35,041,"New Mexico","Roosevelt County",2,64,204,98,106
050,35,041,"New Mexico","Roosevelt County",2,65,186,93,93
050,35,041,"New Mexico","Roosevelt County",2,66,168,87,81
050,35,041,"New Mexico","Roosevelt County",2,67,164,83,81
050,35,041,"New Mexico","Roosevelt County",2,68,171,89,82
050,35,041,"New Mexico","Roosevelt County",2,69,176,85,91
050,35,041,"New Mexico","Roosevelt County",2,70,176,82,94
050,35,041,"New Mexico","Roosevelt County",2,71,169,79,90
050,35,041,"New Mexico","Roosevelt County",2,72,152,71,81
050,35,041,"New Mexico","Roosevelt County",2,73,138,68,70
050,35,041,"New Mexico","Roosevelt County",2,74,107,51,56
050,35,041,"New Mexico","Roosevelt County",2,75,107,50,57
050,35,041,"New Mexico","Roosevelt County",2,76,113,57,56
050,35,041,"New Mexico","Roosevelt County",2,77,115,58,57
050,35,041,"New Mexico","Roosevelt County",2,78,97,44,53
050,35,041,"New Mexico","Roosevelt County",2,79,86,35,51
050,35,041,"New Mexico","Roosevelt County",2,80,78,32,46
050,35,041,"New Mexico","Roosevelt County",2,81,77,32,45
050,35,041,"New Mexico","Roosevelt County",2,82,72,32,40
050,35,041,"New Mexico","Roosevelt County",2,83,59,31,28
050,35,041,"New Mexico","Roosevelt County",2,84,63,32,31
050,35,041,"New Mexico","Roosevelt County",2,85,339,134,205
050,35,041,"New Mexico","Roosevelt County",3,0,194,99,95
050,35,041,"New Mexico","Roosevelt County",3,1,243,146,97
050,35,041,"New Mexico","Roosevelt County",3,2,249,133,116
050,35,041,"New Mexico","Roosevelt County",3,3,268,138,130
050,35,041,"New Mexico","Roosevelt County",3,4,250,120,130
050,35,041,"New Mexico","Roosevelt County",3,5,257,129,128
050,35,041,"New Mexico","Roosevelt County",3,6,259,136,123
050,35,041,"New Mexico","Roosevelt County",3,7,281,139,142
050,35,041,"New Mexico","Roosevelt County",3,8,247,115,132
050,35,041,"New Mexico","Roosevelt County",3,9,237,118,119
050,35,041,"New Mexico","Roosevelt County",3,10,242,120,122
050,35,041,"New Mexico","Roosevelt County",3,11,275,149,126
050,35,041,"New Mexico","Roosevelt County",3,12,281,141,140
050,35,041,"New Mexico","Roosevelt County",3,13,270,141,129
050,35,041,"New Mexico","Roosevelt County",3,14,273,151,122
050,35,041,"New Mexico","Roosevelt County",3,15,256,138,118
050,35,041,"New Mexico","Roosevelt County",3,16,265,131,134
050,35,041,"New Mexico","Roosevelt County",3,17,261,134,127
050,35,041,"New Mexico","Roosevelt County",3,18,377,193,184
050,35,041,"New Mexico","Roosevelt County",3,19,532,268,264
050,35,041,"New Mexico","Roosevelt County",3,20,509,229,280
050,35,041,"New Mexico","Roosevelt County",3,21,566,298,268
050,35,041,"New Mexico","Roosevelt County",3,22,476,196,280
050,35,041,"New Mexico","Roosevelt County",3,23,437,229,208
050,35,041,"New Mexico","Roosevelt County",3,24,329,168,161
050,35,041,"New Mexico","Roosevelt County",3,25,302,160,142
050,35,041,"New Mexico","Roosevelt County",3,26,293,146,147
050,35,041,"New Mexico","Roosevelt County",3,27,319,159,160
050,35,041,"New Mexico","Roosevelt County",3,28,283,139,144
050,35,041,"New Mexico","Roosevelt County",3,29,250,137,113
050,35,041,"New Mexico","Roosevelt County",3,30,219,117,102
050,35,041,"New Mexico","Roosevelt County",3,31,218,105,113
050,35,041,"New Mexico","Roosevelt County",3,32,206,108,98
050,35,041,"New Mexico","Roosevelt County",3,33,212,117,95
050,35,041,"New Mexico","Roosevelt County",3,34,204,106,98
050,35,041,"New Mexico","Roosevelt County",3,35,230,128,102
050,35,041,"New Mexico","Roosevelt County",3,36,222,120,102
050,35,041,"New Mexico","Roosevelt County",3,37,200,103,97
050,35,041,"New Mexico","Roosevelt County",3,38,195,106,89
050,35,041,"New Mexico","Roosevelt County",3,39,215,113,102
050,35,041,"New Mexico","Roosevelt County",3,40,211,114,97
050,35,041,"New Mexico","Roosevelt County",3,41,189,93,96
050,35,041,"New Mexico","Roosevelt County",3,42,187,97,90
050,35,041,"New Mexico","Roosevelt County",3,43,192,91,101
050,35,041,"New Mexico","Roosevelt County",3,44,191,95,96
050,35,041,"New Mexico","Roosevelt County",3,45,185,90,95
050,35,041,"New Mexico","Roosevelt County",3,46,191,105,86
050,35,041,"New Mexico","Roosevelt County",3,47,180,88,92
050,35,041,"New Mexico","Roosevelt County",3,48,190,86,104
050,35,041,"New Mexico","Roosevelt County",3,49,203,98,105
050,35,041,"New Mexico","Roosevelt County",3,50,194,92,102
050,35,041,"New Mexico","Roosevelt County",3,51,190,97,93
050,35,041,"New Mexico","Roosevelt County",3,52,191,93,98
050,35,041,"New Mexico","Roosevelt County",3,53,195,97,98
050,35,041,"New Mexico","Roosevelt County",3,54,183,93,90
050,35,041,"New Mexico","Roosevelt County",3,55,176,101,75
050,35,041,"New Mexico","Roosevelt County",3,56,179,95,84
050,35,041,"New Mexico","Roosevelt County",3,57,182,94,88
050,35,041,"New Mexico","Roosevelt County",3,58,194,99,95
050,35,041,"New Mexico","Roosevelt County",3,59,187,92,95
050,35,041,"New Mexico","Roosevelt County",3,60,193,92,101
050,35,041,"New Mexico","Roosevelt County",3,61,185,84,101
050,35,041,"New Mexico","Roosevelt County",3,62,202,92,110
050,35,041,"New Mexico","Roosevelt County",3,63,202,80,122
050,35,041,"New Mexico","Roosevelt County",3,64,196,86,110
050,35,041,"New Mexico","Roosevelt County",3,65,200,98,102
050,35,041,"New Mexico","Roosevelt County",3,66,184,92,92
050,35,041,"New Mexico","Roosevelt County",3,67,163,85,78
050,35,041,"New Mexico","Roosevelt County",3,68,154,77,77
050,35,041,"New Mexico","Roosevelt County",3,69,168,88,80
050,35,041,"New Mexico","Roosevelt County",3,70,171,82,89
050,35,041,"New Mexico","Roosevelt County",3,71,169,80,89
050,35,041,"New Mexico","Roosevelt County",3,72,159,73,86
050,35,041,"New Mexico","Roosevelt County",3,73,146,69,77
050,35,041,"New Mexico","Roosevelt County",3,74,132,68,64
050,35,041,"New Mexico","Roosevelt County",3,75,104,50,54
050,35,041,"New Mexico","Roosevelt County",3,76,107,49,58
050,35,041,"New Mexico","Roosevelt County",3,77,104,50,54
050,35,041,"New Mexico","Roosevelt County",3,78,115,57,58
050,35,041,"New Mexico","Roosevelt County",3,79,86,39,47
050,35,041,"New Mexico","Roosevelt County",3,80,80,30,50
050,35,041,"New Mexico","Roosevelt County",3,81,69,29,40
050,35,041,"New Mexico","Roosevelt County",3,82,74,32,42
050,35,041,"New Mexico","Roosevelt County",3,83,61,28,33
050,35,041,"New Mexico","Roosevelt County",3,84,48,24,24
050,35,041,"New Mexico","Roosevelt County",3,85,328,139,189
050,35,041,"New Mexico","Roosevelt County",4,0,231,121,110
050,35,041,"New Mexico","Roosevelt County",4,1,190,101,89
050,35,041,"New Mexico","Roosevelt County",4,2,253,144,109
050,35,041,"New Mexico","Roosevelt County",4,3,251,124,127
050,35,041,"New Mexico","Roosevelt County",4,4,263,131,132
050,35,041,"New Mexico","Roosevelt County",4,5,252,122,130
050,35,041,"New Mexico","Roosevelt County",4,6,265,128,137
050,35,041,"New Mexico","Roosevelt County",4,7,257,121,136
050,35,041,"New Mexico","Roosevelt County",4,8,267,137,130
050,35,041,"New Mexico","Roosevelt County",4,9,238,116,122
050,35,041,"New Mexico","Roosevelt County",4,10,235,118,117
050,35,041,"New Mexico","Roosevelt County",4,11,241,127,114
050,35,041,"New Mexico","Roosevelt County",4,12,283,150,133
050,35,041,"New Mexico","Roosevelt County",4,13,282,144,138
050,35,041,"New Mexico","Roosevelt County",4,14,265,141,124
050,35,041,"New Mexico","Roosevelt County",4,15,260,136,124
050,35,041,"New Mexico","Roosevelt County",4,16,254,132,122
050,35,041,"New Mexico","Roosevelt County",4,17,265,139,126
050,35,041,"New Mexico","Roosevelt County",4,18,370,187,183
050,35,041,"New Mexico","Roosevelt County",4,19,515,258,257
050,35,041,"New Mexico","Roosevelt County",4,20,485,228,257
050,35,041,"New Mexico","Roosevelt County",4,21,563,284,279
050,35,041,"New Mexico","Roosevelt County",4,22,469,189,280
050,35,041,"New Mexico","Roosevelt County",4,23,435,222,213
050,35,041,"New Mexico","Roosevelt County",4,24,353,185,168
050,35,041,"New Mexico","Roosevelt County",4,25,292,145,147
050,35,041,"New Mexico","Roosevelt County",4,26,279,138,141
050,35,041,"New Mexico","Roosevelt County",4,27,279,142,137
050,35,041,"New Mexico","Roosevelt County",4,28,319,162,157
050,35,041,"New Mexico","Roosevelt County",4,29,272,132,140
050,35,041,"New Mexico","Roosevelt County",4,30,245,131,114
050,35,041,"New Mexico","Roosevelt County",4,31,228,119,109
050,35,041,"New Mexico","Roosevelt County",4,32,213,101,112
050,35,041,"New Mexico","Roosevelt County",4,33,210,108,102
050,35,041,"New Mexico","Roosevelt County",4,34,209,109,100
050,35,041,"New Mexico","Roosevelt County",4,35,205,113,92
050,35,041,"New Mexico","Roosevelt County",4,36,233,126,107
050,35,041,"New Mexico","Roosevelt County",4,37,218,117,101
050,35,041,"New Mexico","Roosevelt County",4,38,204,100,104
050,35,041,"New Mexico","Roosevelt County",4,39,201,111,90
050,35,041,"New Mexico","Roosevelt County",4,40,210,106,104
050,35,041,"New Mexico","Roosevelt County",4,41,211,113,98
050,35,041,"New Mexico","Roosevelt County",4,42,184,85,99
050,35,041,"New Mexico","Roosevelt County",4,43,184,91,93
050,35,041,"New Mexico","Roosevelt County",4,44,172,77,95
050,35,041,"New Mexico","Roosevelt County",4,45,191,95,96
050,35,041,"New Mexico","Roosevelt County",4,46,181,89,92
050,35,041,"New Mexico","Roosevelt County",4,47,186,110,76
050,35,041,"New Mexico","Roosevelt County",4,48,171,89,82
050,35,041,"New Mexico","Roosevelt County",4,49,192,89,103
050,35,041,"New Mexico","Roosevelt County",4,50,196,96,100
050,35,041,"New Mexico","Roosevelt County",4,51,193,87,106
050,35,041,"New Mexico","Roosevelt County",4,52,174,88,86
050,35,041,"New Mexico","Roosevelt County",4,53,179,90,89
050,35,041,"New Mexico","Roosevelt County",4,54,193,90,103
050,35,041,"New Mexico","Roosevelt County",4,55,175,96,79
050,35,041,"New Mexico","Roosevelt County",4,56,171,97,74
050,35,041,"New Mexico","Roosevelt County",4,57,172,91,81
050,35,041,"New Mexico","Roosevelt County",4,58,181,97,84
050,35,041,"New Mexico","Roosevelt County",4,59,189,94,95
050,35,041,"New Mexico","Roosevelt County",4,60,191,95,96
050,35,041,"New Mexico","Roosevelt County",4,61,194,89,105
050,35,041,"New Mexico","Roosevelt County",4,62,178,86,92
050,35,041,"New Mexico","Roosevelt County",4,63,192,84,108
050,35,041,"New Mexico","Roosevelt County",4,64,191,77,114
050,35,041,"New Mexico","Roosevelt County",4,65,188,83,105
050,35,041,"New Mexico","Roosevelt County",4,66,199,96,103
050,35,041,"New Mexico","Roosevelt County",4,67,178,87,91
050,35,041,"New Mexico","Roosevelt County",4,68,157,85,72
050,35,041,"New Mexico","Roosevelt County",4,69,153,73,80
050,35,041,"New Mexico","Roosevelt County",4,70,165,85,80
050,35,041,"New Mexico","Roosevelt County",4,71,163,76,87
050,35,041,"New Mexico","Roosevelt County",4,72,165,73,92
050,35,041,"New Mexico","Roosevelt County",4,73,163,74,89
050,35,041,"New Mexico","Roosevelt County",4,74,135,64,71
050,35,041,"New Mexico","Roosevelt County",4,75,130,63,67
050,35,041,"New Mexico","Roosevelt County",4,76,106,50,56
050,35,041,"New Mexico","Roosevelt County",4,77,96,43,53
050,35,041,"New Mexico","Roosevelt County",4,78,99,45,54
050,35,041,"New Mexico","Roosevelt County",4,79,104,51,53
050,35,041,"New Mexico","Roosevelt County",4,80,81,36,45
050,35,041,"New Mexico","Roosevelt County",4,81,76,28,48
050,35,041,"New Mexico","Roosevelt County",4,82,67,32,35
050,35,041,"New Mexico","Roosevelt County",4,83,69,29,40
050,35,041,"New Mexico","Roosevelt County",4,84,57,22,35
050,35,041,"New Mexico","Roosevelt County",4,85,307,143,164
050,35,041,"New Mexico","Roosevelt County",5,0,226,117,109
050,35,041,"New Mexico","Roosevelt County",5,1,219,122,97
050,35,041,"New Mexico","Roosevelt County",5,2,182,98,84
050,35,041,"New Mexico","Roosevelt County",5,3,250,139,111
050,35,041,"New Mexico","Roosevelt County",5,4,250,126,124
050,35,041,"New Mexico","Roosevelt County",5,5,263,134,129
050,35,041,"New Mexico","Roosevelt County",5,6,249,125,124
050,35,041,"New Mexico","Roosevelt County",5,7,245,122,123
050,35,041,"New Mexico","Roosevelt County",5,8,258,131,127
050,35,041,"New Mexico","Roosevelt County",5,9,262,133,129
050,35,041,"New Mexico","Roosevelt County",5,10,240,112,128
050,35,041,"New Mexico","Roosevelt County",5,11,239,122,117
050,35,041,"New Mexico","Roosevelt County",5,12,238,126,112
050,35,041,"New Mexico","Roosevelt County",5,13,294,161,133
050,35,041,"New Mexico","Roosevelt County",5,14,274,141,133
050,35,041,"New Mexico","Roosevelt County",5,15,253,129,124
050,35,041,"New Mexico","Roosevelt County",5,16,264,140,124
050,35,041,"New Mexico","Roosevelt County",5,17,264,145,119
050,35,041,"New Mexico","Roosevelt County",5,18,373,194,179
050,35,041,"New Mexico","Roosevelt County",5,19,507,253,254
050,35,041,"New Mexico","Roosevelt County",5,20,470,216,254
050,35,041,"New Mexico","Roosevelt County",5,21,545,292,253
050,35,041,"New Mexico","Roosevelt County",5,22,493,207,286
050,35,041,"New Mexico","Roosevelt County",5,23,439,229,210
050,35,041,"New Mexico","Roosevelt County",5,24,346,179,167
050,35,041,"New Mexico","Roosevelt County",5,25,295,159,136
050,35,041,"New Mexico","Roosevelt County",5,26,275,136,139
050,35,041,"New Mexico","Roosevelt County",5,27,262,130,132
050,35,041,"New Mexico","Roosevelt County",5,28,282,144,138
050,35,041,"New Mexico","Roosevelt County",5,29,302,157,145
050,35,041,"New Mexico","Roosevelt County",5,30,268,131,137
050,35,041,"New Mexico","Roosevelt County",5,31,242,134,108
050,35,041,"New Mexico","Roosevelt County",5,32,223,109,114
050,35,041,"New Mexico","Roosevelt County",5,33,225,113,112
050,35,041,"New Mexico","Roosevelt County",5,34,217,109,108
050,35,041,"New Mexico","Roosevelt County",5,35,210,114,96
050,35,041,"New Mexico","Roosevelt County",5,36,204,112,92
050,35,041,"New Mexico","Roosevelt County",5,37,219,118,101
050,35,041,"New Mexico","Roosevelt County",5,38,216,116,100
050,35,041,"New Mexico","Roosevelt County",5,39,201,102,99
050,35,041,"New Mexico","Roosevelt County",5,40,189,102,87
050,35,041,"New Mexico","Roosevelt County",5,41,199,102,97
050,35,041,"New Mexico","Roosevelt County",5,42,208,113,95
050,35,041,"New Mexico","Roosevelt County",5,43,184,83,101
050,35,041,"New Mexico","Roosevelt County",5,44,194,96,98
050,35,041,"New Mexico","Roosevelt County",5,45,169,75,94
050,35,041,"New Mexico","Roosevelt County",5,46,179,90,89
050,35,041,"New Mexico","Roosevelt County",5,47,186,93,93
050,35,041,"New Mexico","Roosevelt County",5,48,189,110,79
050,35,041,"New Mexico","Roosevelt County",5,49,176,93,83
050,35,041,"New Mexico","Roosevelt County",5,50,188,85,103
050,35,041,"New Mexico","Roosevelt County",5,51,196,94,102
050,35,041,"New Mexico","Roosevelt County",5,52,184,85,99
050,35,041,"New Mexico","Roosevelt County",5,53,177,91,86
050,35,041,"New Mexico","Roosevelt County",5,54,180,84,96
050,35,041,"New Mexico","Roosevelt County",5,55,195,94,101
050,35,041,"New Mexico","Roosevelt County",5,56,176,98,78
050,35,041,"New Mexico","Roosevelt County",5,57,165,91,74
050,35,041,"New Mexico","Roosevelt County",5,58,175,94,81
050,35,041,"New Mexico","Roosevelt County",5,59,171,87,84
050,35,041,"New Mexico","Roosevelt County",5,60,194,96,98
050,35,041,"New Mexico","Roosevelt County",5,61,189,91,98
050,35,041,"New Mexico","Roosevelt County",5,62,186,83,103
050,35,041,"New Mexico","Roosevelt County",5,63,172,78,94
050,35,041,"New Mexico","Roosevelt County",5,64,195,88,107
050,35,041,"New Mexico","Roosevelt County",5,65,187,77,110
050,35,041,"New Mexico","Roosevelt County",5,66,185,80,105
050,35,041,"New Mexico","Roosevelt County",5,67,195,96,99
050,35,041,"New Mexico","Roosevelt County",5,68,172,82,90
050,35,041,"New Mexico","Roosevelt County",5,69,162,88,74
050,35,041,"New Mexico","Roosevelt County",5,70,147,69,78
050,35,041,"New Mexico","Roosevelt County",5,71,161,82,79
050,35,041,"New Mexico","Roosevelt County",5,72,162,74,88
050,35,041,"New Mexico","Roosevelt County",5,73,158,69,89
050,35,041,"New Mexico","Roosevelt County",5,74,153,72,81
050,35,041,"New Mexico","Roosevelt County",5,75,130,59,71
050,35,041,"New Mexico","Roosevelt County",5,76,132,62,70
050,35,041,"New Mexico","Roosevelt County",5,77,92,40,52
050,35,041,"New Mexico","Roosevelt County",5,78,93,43,50
050,35,041,"New Mexico","Roosevelt County",5,79,89,37,52
050,35,041,"New Mexico","Roosevelt County",5,80,94,43,51
050,35,041,"New Mexico","Roosevelt County",5,81,78,34,44
050,35,041,"New Mexico","Roosevelt County",5,82,68,25,43
050,35,041,"New Mexico","Roosevelt County",5,83,63,31,32
050,35,041,"New Mexico","Roosevelt County",5,84,63,24,39
050,35,041,"New Mexico","Roosevelt County",5,85,303,145,158
050,35,043,"New Mexico","Sandoval County",1,0,1321,673,648
050,35,043,"New Mexico","Sandoval County",1,1,1404,710,694
050,35,043,"New Mexico","Sandoval County",1,2,1528,807,721
050,35,043,"New Mexico","Sandoval County",1,3,1625,822,803
050,35,043,"New Mexico","Sandoval County",1,4,1791,921,870
050,35,043,"New Mexico","Sandoval County",1,5,1800,949,851
050,35,043,"New Mexico","Sandoval County",1,6,1796,970,826
050,35,043,"New Mexico","Sandoval County",1,7,1814,925,889
050,35,043,"New Mexico","Sandoval County",1,8,1860,938,922
050,35,043,"New Mexico","Sandoval County",1,9,1962,999,963
050,35,043,"New Mexico","Sandoval County",1,10,2078,1065,1013
050,35,043,"New Mexico","Sandoval County",1,11,2096,1077,1019
050,35,043,"New Mexico","Sandoval County",1,12,2190,1123,1067
050,35,043,"New Mexico","Sandoval County",1,13,2141,1103,1038
050,35,043,"New Mexico","Sandoval County",1,14,2152,1106,1046
050,35,043,"New Mexico","Sandoval County",1,15,2136,1093,1043
050,35,043,"New Mexico","Sandoval County",1,16,2143,1078,1065
050,35,043,"New Mexico","Sandoval County",1,17,2115,1088,1027
050,35,043,"New Mexico","Sandoval County",1,18,1857,965,892
050,35,043,"New Mexico","Sandoval County",1,19,1617,840,777
050,35,043,"New Mexico","Sandoval County",1,20,1584,826,758
050,35,043,"New Mexico","Sandoval County",1,21,1572,803,769
050,35,043,"New Mexico","Sandoval County",1,22,1548,778,770
050,35,043,"New Mexico","Sandoval County",1,23,1516,778,738
050,35,043,"New Mexico","Sandoval County",1,24,1504,736,768
050,35,043,"New Mexico","Sandoval County",1,25,1551,786,765
050,35,043,"New Mexico","Sandoval County",1,26,1606,821,785
050,35,043,"New Mexico","Sandoval County",1,27,1692,866,826
050,35,043,"New Mexico","Sandoval County",1,28,1776,895,881
050,35,043,"New Mexico","Sandoval County",1,29,1780,857,923
050,35,043,"New Mexico","Sandoval County",1,30,1815,898,917
050,35,043,"New Mexico","Sandoval County",1,31,1804,917,887
050,35,043,"New Mexico","Sandoval County",1,32,1844,950,894
050,35,043,"New Mexico","Sandoval County",1,33,1984,1007,977
050,35,043,"New Mexico","Sandoval County",1,34,1983,997,986
050,35,043,"New Mexico","Sandoval County",1,35,1928,957,971
050,35,043,"New Mexico","Sandoval County",1,36,2020,1008,1012
050,35,043,"New Mexico","Sandoval County",1,37,2029,1037,992
050,35,043,"New Mexico","Sandoval County",1,38,2049,1055,994
050,35,043,"New Mexico","Sandoval County",1,39,2033,1017,1016
050,35,043,"New Mexico","Sandoval County",1,40,1876,905,971
050,35,043,"New Mexico","Sandoval County",1,41,1847,903,944
050,35,043,"New Mexico","Sandoval County",1,42,1847,937,910
050,35,043,"New Mexico","Sandoval County",1,43,1822,932,890
050,35,043,"New Mexico","Sandoval County",1,44,1795,887,908
050,35,043,"New Mexico","Sandoval County",1,45,1808,892,916
050,35,043,"New Mexico","Sandoval County",1,46,1713,831,882
050,35,043,"New Mexico","Sandoval County",1,47,1776,876,900
050,35,043,"New Mexico","Sandoval County",1,48,1911,956,955
050,35,043,"New Mexico","Sandoval County",1,49,2014,995,1019
050,35,043,"New Mexico","Sandoval County",1,50,1920,942,978
050,35,043,"New Mexico","Sandoval County",1,51,1778,871,907
050,35,043,"New Mexico","Sandoval County",1,52,1709,851,858
050,35,043,"New Mexico","Sandoval County",1,53,1705,848,857
050,35,043,"New Mexico","Sandoval County",1,54,1715,862,853
050,35,043,"New Mexico","Sandoval County",1,55,1885,922,963
050,35,043,"New Mexico","Sandoval County",1,56,2040,995,1045
050,35,043,"New Mexico","Sandoval County",1,57,2083,1008,1075
050,35,043,"New Mexico","Sandoval County",1,58,2147,1058,1089
050,35,043,"New Mexico","Sandoval County",1,59,2120,1036,1084
050,35,043,"New Mexico","Sandoval County",1,60,2118,1029,1089
050,35,043,"New Mexico","Sandoval County",1,61,2003,942,1061
050,35,043,"New Mexico","Sandoval County",1,62,2027,977,1050
050,35,043,"New Mexico","Sandoval County",1,63,2041,977,1064
050,35,043,"New Mexico","Sandoval County",1,64,2009,935,1074
050,35,043,"New Mexico","Sandoval County",1,65,2067,961,1106
050,35,043,"New Mexico","Sandoval County",1,66,1978,898,1080
050,35,043,"New Mexico","Sandoval County",1,67,1943,852,1091
050,35,043,"New Mexico","Sandoval County",1,68,1930,911,1019
050,35,043,"New Mexico","Sandoval County",1,69,1761,823,938
050,35,043,"New Mexico","Sandoval County",1,70,1781,845,936
050,35,043,"New Mexico","Sandoval County",1,71,1694,817,877
050,35,043,"New Mexico","Sandoval County",1,72,1665,801,864
050,35,043,"New Mexico","Sandoval County",1,73,1680,826,854
050,35,043,"New Mexico","Sandoval County",1,74,1216,580,636
050,35,043,"New Mexico","Sandoval County",1,75,1192,571,621
050,35,043,"New Mexico","Sandoval County",1,76,1140,538,602
050,35,043,"New Mexico","Sandoval County",1,77,1095,518,577
050,35,043,"New Mexico","Sandoval County",1,78,916,432,484
050,35,043,"New Mexico","Sandoval County",1,79,803,365,438
050,35,043,"New Mexico","Sandoval County",1,80,696,308,388
050,35,043,"New Mexico","Sandoval County",1,81,652,301,351
050,35,043,"New Mexico","Sandoval County",1,82,546,239,307
050,35,043,"New Mexico","Sandoval County",1,83,490,209,281
050,35,043,"New Mexico","Sandoval County",1,84,427,178,249
050,35,043,"New Mexico","Sandoval County",1,85,2409,921,1488
050,35,043,"New Mexico","Sandoval County",2,0,1309,657,652
050,35,043,"New Mexico","Sandoval County",2,1,1408,714,694
050,35,043,"New Mexico","Sandoval County",2,2,1516,795,721
050,35,043,"New Mexico","Sandoval County",2,3,1611,824,787
050,35,043,"New Mexico","Sandoval County",2,4,1768,903,865
050,35,043,"New Mexico","Sandoval County",2,5,1807,947,860
050,35,043,"New Mexico","Sandoval County",2,6,1810,973,837
050,35,043,"New Mexico","Sandoval County",2,7,1828,942,886
050,35,043,"New Mexico","Sandoval County",2,8,1851,933,918
050,35,043,"New Mexico","Sandoval County",2,9,1942,988,954
050,35,043,"New Mexico","Sandoval County",2,10,2054,1053,1001
050,35,043,"New Mexico","Sandoval County",2,11,2087,1071,1016
050,35,043,"New Mexico","Sandoval County",2,12,2174,1118,1056
050,35,043,"New Mexico","Sandoval County",2,13,2153,1107,1046
050,35,043,"New Mexico","Sandoval County",2,14,2155,1108,1047
050,35,043,"New Mexico","Sandoval County",2,15,2147,1099,1048
050,35,043,"New Mexico","Sandoval County",2,16,2149,1082,1067
050,35,043,"New Mexico","Sandoval County",2,17,2123,1083,1040
050,35,043,"New Mexico","Sandoval County",2,18,1854,965,889
050,35,043,"New Mexico","Sandoval County",2,19,1619,840,779
050,35,043,"New Mexico","Sandoval County",2,20,1614,838,776
050,35,043,"New Mexico","Sandoval County",2,21,1581,813,768
050,35,043,"New Mexico","Sandoval County",2,22,1560,787,773
050,35,043,"New Mexico","Sandoval County",2,23,1536,784,752
050,35,043,"New Mexico","Sandoval County",2,24,1507,746,761
050,35,043,"New Mexico","Sandoval County",2,25,1553,782,771
050,35,043,"New Mexico","Sandoval County",2,26,1601,817,784
050,35,043,"New Mexico","Sandoval County",2,27,1686,862,824
050,35,043,"New Mexico","Sandoval County",2,28,1770,896,874
050,35,043,"New Mexico","Sandoval County",2,29,1787,869,918
050,35,043,"New Mexico","Sandoval County",2,30,1827,897,930
050,35,043,"New Mexico","Sandoval County",2,31,1819,922,897
050,35,043,"New Mexico","Sandoval County",2,32,1852,953,899
050,35,043,"New Mexico","Sandoval County",2,33,1967,1003,964
050,35,043,"New Mexico","Sandoval County",2,34,1999,1010,989
050,35,043,"New Mexico","Sandoval County",2,35,1962,980,982
050,35,043,"New Mexico","Sandoval County",2,36,1998,999,999
050,35,043,"New Mexico","Sandoval County",2,37,2038,1036,1002
050,35,043,"New Mexico","Sandoval County",2,38,2066,1060,1006
050,35,043,"New Mexico","Sandoval County",2,39,2029,1021,1008
050,35,043,"New Mexico","Sandoval County",2,40,1938,944,994
050,35,043,"New Mexico","Sandoval County",2,41,1849,903,946
050,35,043,"New Mexico","Sandoval County",2,42,1839,927,912
050,35,043,"New Mexico","Sandoval County",2,43,1838,935,903
050,35,043,"New Mexico","Sandoval County",2,44,1798,898,900
050,35,043,"New Mexico","Sandoval County",2,45,1818,897,921
050,35,043,"New Mexico","Sandoval County",2,46,1739,845,894
050,35,043,"New Mexico","Sandoval County",2,47,1763,867,896
050,35,043,"New Mexico","Sandoval County",2,48,1879,935,944
050,35,043,"New Mexico","Sandoval County",2,49,2009,990,1019
050,35,043,"New Mexico","Sandoval County",2,50,1942,956,986
050,35,043,"New Mexico","Sandoval County",2,51,1806,880,926
050,35,043,"New Mexico","Sandoval County",2,52,1713,851,862
050,35,043,"New Mexico","Sandoval County",2,53,1712,856,856
050,35,043,"New Mexico","Sandoval County",2,54,1712,857,855
050,35,043,"New Mexico","Sandoval County",2,55,1845,906,939
050,35,043,"New Mexico","Sandoval County",2,56,2015,988,1027
050,35,043,"New Mexico","Sandoval County",2,57,2077,1006,1071
050,35,043,"New Mexico","Sandoval County",2,58,2130,1048,1082
050,35,043,"New Mexico","Sandoval County",2,59,2131,1045,1086
050,35,043,"New Mexico","Sandoval County",2,60,2120,1029,1091
050,35,043,"New Mexico","Sandoval County",2,61,2041,965,1076
050,35,043,"New Mexico","Sandoval County",2,62,2020,966,1054
050,35,043,"New Mexico","Sandoval County",2,63,2058,991,1067
050,35,043,"New Mexico","Sandoval County",2,64,2009,937,1072
050,35,043,"New Mexico","Sandoval County",2,65,2059,959,1100
050,35,043,"New Mexico","Sandoval County",2,66,2006,914,1092
050,35,043,"New Mexico","Sandoval County",2,67,1949,861,1088
050,35,043,"New Mexico","Sandoval County",2,68,1915,888,1027
050,35,043,"New Mexico","Sandoval County",2,69,1807,843,964
050,35,043,"New Mexico","Sandoval County",2,70,1766,836,930
050,35,043,"New Mexico","Sandoval County",2,71,1714,823,891
050,35,043,"New Mexico","Sandoval County",2,72,1649,793,856
050,35,043,"New Mexico","Sandoval County",2,73,1747,857,890
050,35,043,"New Mexico","Sandoval County",2,74,1253,604,649
050,35,043,"New Mexico","Sandoval County",2,75,1200,574,626
050,35,043,"New Mexico","Sandoval County",2,76,1140,537,603
050,35,043,"New Mexico","Sandoval County",2,77,1122,530,592
050,35,043,"New Mexico","Sandoval County",2,78,942,447,495
050,35,043,"New Mexico","Sandoval County",2,79,816,373,443
050,35,043,"New Mexico","Sandoval County",2,80,722,322,400
050,35,043,"New Mexico","Sandoval County",2,81,653,296,357
050,35,043,"New Mexico","Sandoval County",2,82,569,250,319
050,35,043,"New Mexico","Sandoval County",2,83,496,214,282
050,35,043,"New Mexico","Sandoval County",2,84,423,174,249
050,35,043,"New Mexico","Sandoval County",2,85,2424,924,1500
050,35,043,"New Mexico","Sandoval County",3,0,1304,692,612
050,35,043,"New Mexico","Sandoval County",3,1,1369,702,667
050,35,043,"New Mexico","Sandoval County",3,2,1489,751,738
050,35,043,"New Mexico","Sandoval County",3,3,1537,804,733
050,35,043,"New Mexico","Sandoval County",3,4,1670,846,824
050,35,043,"New Mexico","Sandoval County",3,5,1829,936,893
050,35,043,"New Mexico","Sandoval County",3,6,1848,964,884
050,35,043,"New Mexico","Sandoval County",3,7,1858,988,870
050,35,043,"New Mexico","Sandoval County",3,8,1898,979,919
050,35,043,"New Mexico","Sandoval County",3,9,1910,979,931
050,35,043,"New Mexico","Sandoval County",3,10,1959,995,964
050,35,043,"New Mexico","Sandoval County",3,11,2046,1033,1013
050,35,043,"New Mexico","Sandoval County",3,12,2108,1084,1024
050,35,043,"New Mexico","Sandoval County",3,13,2206,1137,1069
050,35,043,"New Mexico","Sandoval County",3,14,2138,1083,1055
050,35,043,"New Mexico","Sandoval County",3,15,2144,1114,1030
050,35,043,"New Mexico","Sandoval County",3,16,2145,1118,1027
050,35,043,"New Mexico","Sandoval County",3,17,2157,1108,1049
050,35,043,"New Mexico","Sandoval County",3,18,1933,1007,926
050,35,043,"New Mexico","Sandoval County",3,19,1609,838,771
050,35,043,"New Mexico","Sandoval County",3,20,1628,834,794
050,35,043,"New Mexico","Sandoval County",3,21,1628,831,797
050,35,043,"New Mexico","Sandoval County",3,22,1602,812,790
050,35,043,"New Mexico","Sandoval County",3,23,1635,819,816
050,35,043,"New Mexico","Sandoval County",3,24,1547,791,756
050,35,043,"New Mexico","Sandoval County",3,25,1546,785,761
050,35,043,"New Mexico","Sandoval County",3,26,1618,824,794
050,35,043,"New Mexico","Sandoval County",3,27,1709,874,835
050,35,043,"New Mexico","Sandoval County",3,28,1748,889,859
050,35,043,"New Mexico","Sandoval County",3,29,1873,923,950
050,35,043,"New Mexico","Sandoval County",3,30,1911,929,982
050,35,043,"New Mexico","Sandoval County",3,31,1886,954,932
050,35,043,"New Mexico","Sandoval County",3,32,1888,980,908
050,35,043,"New Mexico","Sandoval County",3,33,1908,978,930
050,35,043,"New Mexico","Sandoval County",3,34,2009,1021,988
050,35,043,"New Mexico","Sandoval County",3,35,2093,1059,1034
050,35,043,"New Mexico","Sandoval County",3,36,2051,1020,1031
050,35,043,"New Mexico","Sandoval County",3,37,2038,1008,1030
050,35,043,"New Mexico","Sandoval County",3,38,2096,1054,1042
050,35,043,"New Mexico","Sandoval County",3,39,2096,1098,998
050,35,043,"New Mexico","Sandoval County",3,40,2064,1042,1022
050,35,043,"New Mexico","Sandoval County",3,41,2013,1004,1009
050,35,043,"New Mexico","Sandoval County",3,42,1882,925,957
050,35,043,"New Mexico","Sandoval County",3,43,1870,962,908
050,35,043,"New Mexico","Sandoval County",3,44,1921,977,944
050,35,043,"New Mexico","Sandoval County",3,45,1814,911,903
050,35,043,"New Mexico","Sandoval County",3,46,1814,888,926
050,35,043,"New Mexico","Sandoval County",3,47,1783,858,925
050,35,043,"New Mexico","Sandoval County",3,48,1778,880,898
050,35,043,"New Mexico","Sandoval County",3,49,1901,940,961
050,35,043,"New Mexico","Sandoval County",3,50,2040,1015,1025
050,35,043,"New Mexico","Sandoval County",3,51,1958,940,1018
050,35,043,"New Mexico","Sandoval County",3,52,1781,872,909
050,35,043,"New Mexico","Sandoval County",3,53,1729,865,864
050,35,043,"New Mexico","Sandoval County",3,54,1695,842,853
050,35,043,"New Mexico","Sandoval County",3,55,1723,867,856
050,35,043,"New Mexico","Sandoval County",3,56,1870,935,935
050,35,043,"New Mexico","Sandoval County",3,57,2026,993,1033
050,35,043,"New Mexico","Sandoval County",3,58,2115,1033,1082
050,35,043,"New Mexico","Sandoval County",3,59,2104,1023,1081
050,35,043,"New Mexico","Sandoval County",3,60,2135,1045,1090
050,35,043,"New Mexico","Sandoval County",3,61,2157,1047,1110
050,35,043,"New Mexico","Sandoval County",3,62,2045,968,1077
050,35,043,"New Mexico","Sandoval County",3,63,2004,957,1047
050,35,043,"New Mexico","Sandoval County",3,64,2052,999,1053
050,35,043,"New Mexico","Sandoval County",3,65,2038,950,1088
050,35,043,"New Mexico","Sandoval County",3,66,2051,946,1105
050,35,043,"New Mexico","Sandoval County",3,67,2019,921,1098
050,35,043,"New Mexico","Sandoval County",3,68,1951,868,1083
050,35,043,"New Mexico","Sandoval County",3,69,1907,882,1025
050,35,043,"New Mexico","Sandoval County",3,70,1777,833,944
050,35,043,"New Mexico","Sandoval County",3,71,1781,837,944
050,35,043,"New Mexico","Sandoval County",3,72,1684,802,882
050,35,043,"New Mexico","Sandoval County",3,73,1661,794,867
050,35,043,"New Mexico","Sandoval County",3,74,1722,836,886
050,35,043,"New Mexico","Sandoval County",3,75,1221,586,635
050,35,043,"New Mexico","Sandoval County",3,76,1178,551,627
050,35,043,"New Mexico","Sandoval County",3,77,1120,515,605
050,35,043,"New Mexico","Sandoval County",3,78,1064,491,573
050,35,043,"New Mexico","Sandoval County",3,79,899,422,477
050,35,043,"New Mexico","Sandoval County",3,80,780,361,419
050,35,043,"New Mexico","Sandoval County",3,81,698,306,392
050,35,043,"New Mexico","Sandoval County",3,82,620,279,341
050,35,043,"New Mexico","Sandoval County",3,83,524,226,298
050,35,043,"New Mexico","Sandoval County",3,84,445,188,257
050,35,043,"New Mexico","Sandoval County",3,85,2397,928,1469
050,35,043,"New Mexico","Sandoval County",4,0,1289,655,634
050,35,043,"New Mexico","Sandoval County",4,1,1423,720,703
050,35,043,"New Mexico","Sandoval County",4,2,1441,749,692
050,35,043,"New Mexico","Sandoval County",4,3,1580,778,802
050,35,043,"New Mexico","Sandoval County",4,4,1559,802,757
050,35,043,"New Mexico","Sandoval County",4,5,1713,861,852
050,35,043,"New Mexico","Sandoval County",4,6,1900,975,925
050,35,043,"New Mexico","Sandoval County",4,7,1888,975,913
050,35,043,"New Mexico","Sandoval County",4,8,1918,1041,877
050,35,043,"New Mexico","Sandoval County",4,9,1944,989,955
050,35,043,"New Mexico","Sandoval County",4,10,1924,996,928
050,35,043,"New Mexico","Sandoval County",4,11,1965,999,966
050,35,043,"New Mexico","Sandoval County",4,12,2088,1051,1037
050,35,043,"New Mexico","Sandoval County",4,13,2120,1089,1031
050,35,043,"New Mexico","Sandoval County",4,14,2207,1134,1073
050,35,043,"New Mexico","Sandoval County",4,15,2171,1109,1062
050,35,043,"New Mexico","Sandoval County",4,16,2152,1108,1044
050,35,043,"New Mexico","Sandoval County",4,17,2141,1113,1028
050,35,043,"New Mexico","Sandoval County",4,18,1923,987,936
050,35,043,"New Mexico","Sandoval County",4,19,1655,864,791
050,35,043,"New Mexico","Sandoval County",4,20,1595,834,761
050,35,043,"New Mexico","Sandoval County",4,21,1646,835,811
050,35,043,"New Mexico","Sandoval County",4,22,1640,840,800
050,35,043,"New Mexico","Sandoval County",4,23,1650,822,828
050,35,043,"New Mexico","Sandoval County",4,24,1629,831,798
050,35,043,"New Mexico","Sandoval County",4,25,1593,808,785
050,35,043,"New Mexico","Sandoval County",4,26,1647,815,832
050,35,043,"New Mexico","Sandoval County",4,27,1717,893,824
050,35,043,"New Mexico","Sandoval County",4,28,1759,886,873
050,35,043,"New Mexico","Sandoval County",4,29,1813,934,879
050,35,043,"New Mexico","Sandoval County",4,30,1895,913,982
050,35,043,"New Mexico","Sandoval County",4,31,2027,1013,1014
050,35,043,"New Mexico","Sandoval County",4,32,1966,990,976
050,35,043,"New Mexico","Sandoval County",4,33,1948,988,960
050,35,043,"New Mexico","Sandoval County",4,34,1977,999,978
050,35,043,"New Mexico","Sandoval County",4,35,2045,1046,999
050,35,043,"New Mexico","Sandoval County",4,36,2165,1095,1070
050,35,043,"New Mexico","Sandoval County",4,37,2124,1034,1090
050,35,043,"New Mexico","Sandoval County",4,38,2122,1038,1084
050,35,043,"New Mexico","Sandoval County",4,39,2192,1118,1074
050,35,043,"New Mexico","Sandoval County",4,40,2133,1103,1030
050,35,043,"New Mexico","Sandoval County",4,41,2105,1071,1034
050,35,043,"New Mexico","Sandoval County",4,42,2040,1023,1017
050,35,043,"New Mexico","Sandoval County",4,43,1908,924,984
050,35,043,"New Mexico","Sandoval County",4,44,1899,974,925
050,35,043,"New Mexico","Sandoval County",4,45,1945,1002,943
050,35,043,"New Mexico","Sandoval County",4,46,1839,912,927
050,35,043,"New Mexico","Sandoval County",4,47,1810,862,948
050,35,043,"New Mexico","Sandoval County",4,48,1794,880,914
050,35,043,"New Mexico","Sandoval County",4,49,1806,878,928
050,35,043,"New Mexico","Sandoval County",4,50,1919,948,971
050,35,043,"New Mexico","Sandoval County",4,51,2047,1001,1046
050,35,043,"New Mexico","Sandoval County",4,52,1938,938,1000
050,35,043,"New Mexico","Sandoval County",4,53,1796,894,902
050,35,043,"New Mexico","Sandoval County",4,54,1735,864,871
050,35,043,"New Mexico","Sandoval County",4,55,1717,853,864
050,35,043,"New Mexico","Sandoval County",4,56,1740,877,863
050,35,043,"New Mexico","Sandoval County",4,57,1848,923,925
050,35,043,"New Mexico","Sandoval County",4,58,2093,1019,1074
050,35,043,"New Mexico","Sandoval County",4,59,2077,1012,1065
050,35,043,"New Mexico","Sandoval County",4,60,2133,1034,1099
050,35,043,"New Mexico","Sandoval County",4,61,2191,1048,1143
050,35,043,"New Mexico","Sandoval County",4,62,2139,1028,1111
050,35,043,"New Mexico","Sandoval County",4,63,2033,968,1065
050,35,043,"New Mexico","Sandoval County",4,64,2053,988,1065
050,35,043,"New Mexico","Sandoval County",4,65,2071,995,1076
050,35,043,"New Mexico","Sandoval County",4,66,2009,941,1068
050,35,043,"New Mexico","Sandoval County",4,67,2034,920,1114
050,35,043,"New Mexico","Sandoval County",4,68,1996,912,1084
050,35,043,"New Mexico","Sandoval County",4,69,1944,875,1069
050,35,043,"New Mexico","Sandoval County",4,70,1915,889,1026
050,35,043,"New Mexico","Sandoval County",4,71,1777,821,956
050,35,043,"New Mexico","Sandoval County",4,72,1763,819,944
050,35,043,"New Mexico","Sandoval County",4,73,1658,794,864
050,35,043,"New Mexico","Sandoval County",4,74,1635,784,851
050,35,043,"New Mexico","Sandoval County",4,75,1704,818,886
050,35,043,"New Mexico","Sandoval County",4,76,1202,560,642
050,35,043,"New Mexico","Sandoval County",4,77,1141,518,623
050,35,043,"New Mexico","Sandoval County",4,78,1095,506,589
050,35,043,"New Mexico","Sandoval County",4,79,1038,476,562
050,35,043,"New Mexico","Sandoval County",4,80,856,410,446
050,35,043,"New Mexico","Sandoval County",4,81,735,331,404
050,35,043,"New Mexico","Sandoval County",4,82,657,294,363
050,35,043,"New Mexico","Sandoval County",4,83,594,268,326
050,35,043,"New Mexico","Sandoval County",4,84,461,186,275
050,35,043,"New Mexico","Sandoval County",4,85,2423,936,1487
050,35,043,"New Mexico","Sandoval County",5,0,1290,658,632
050,35,043,"New Mexico","Sandoval County",5,1,1311,693,618
050,35,043,"New Mexico","Sandoval County",5,2,1505,785,720
050,35,043,"New Mexico","Sandoval County",5,3,1473,770,703
050,35,043,"New Mexico","Sandoval County",5,4,1647,837,810
050,35,043,"New Mexico","Sandoval County",5,5,1652,869,783
050,35,043,"New Mexico","Sandoval County",5,6,1756,863,893
050,35,043,"New Mexico","Sandoval County",5,7,1932,1000,932
050,35,043,"New Mexico","Sandoval County",5,8,1916,980,936
050,35,043,"New Mexico","Sandoval County",5,9,1964,1062,902
050,35,043,"New Mexico","Sandoval County",5,10,1965,997,968
050,35,043,"New Mexico","Sandoval County",5,11,1953,992,961
050,35,043,"New Mexico","Sandoval County",5,12,2001,1026,975
050,35,043,"New Mexico","Sandoval County",5,13,2104,1070,1034
050,35,043,"New Mexico","Sandoval County",5,14,2182,1118,1064
050,35,043,"New Mexico","Sandoval County",5,15,2259,1178,1081
050,35,043,"New Mexico","Sandoval County",5,16,2197,1130,1067
050,35,043,"New Mexico","Sandoval County",5,17,2180,1103,1077
050,35,043,"New Mexico","Sandoval County",5,18,1919,1005,914
050,35,043,"New Mexico","Sandoval County",5,19,1723,872,851
050,35,043,"New Mexico","Sandoval County",5,20,1683,872,811
050,35,043,"New Mexico","Sandoval County",5,21,1643,847,796
050,35,043,"New Mexico","Sandoval County",5,22,1704,862,842
050,35,043,"New Mexico","Sandoval County",5,23,1708,869,839
050,35,043,"New Mexico","Sandoval County",5,24,1687,850,837
050,35,043,"New Mexico","Sandoval County",5,25,1725,886,839
050,35,043,"New Mexico","Sandoval County",5,26,1674,841,833
050,35,043,"New Mexico","Sandoval County",5,27,1675,830,845
050,35,043,"New Mexico","Sandoval County",5,28,1749,905,844
050,35,043,"New Mexico","Sandoval County",5,29,1816,907,909
050,35,043,"New Mexico","Sandoval County",5,30,1861,958,903
050,35,043,"New Mexico","Sandoval County",5,31,1948,949,999
050,35,043,"New Mexico","Sandoval County",5,32,2102,1050,1052
050,35,043,"New Mexico","Sandoval County",5,33,2039,1016,1023
050,35,043,"New Mexico","Sandoval County",5,34,2030,1034,996
050,35,043,"New Mexico","Sandoval County",5,35,2067,1045,1022
050,35,043,"New Mexico","Sandoval County",5,36,2123,1102,1021
050,35,043,"New Mexico","Sandoval County",5,37,2166,1098,1068
050,35,043,"New Mexico","Sandoval County",5,38,2168,1063,1105
050,35,043,"New Mexico","Sandoval County",5,39,2244,1113,1131
050,35,043,"New Mexico","Sandoval County",5,40,2205,1151,1054
050,35,043,"New Mexico","Sandoval County",5,41,2207,1162,1045
050,35,043,"New Mexico","Sandoval County",5,42,2126,1075,1051
050,35,043,"New Mexico","Sandoval County",5,43,2060,1041,1019
050,35,043,"New Mexico","Sandoval County",5,44,1957,950,1007
050,35,043,"New Mexico","Sandoval County",5,45,1925,985,940
050,35,043,"New Mexico","Sandoval County",5,46,1946,993,953
050,35,043,"New Mexico","Sandoval County",5,47,1853,935,918
050,35,043,"New Mexico","Sandoval County",5,48,1843,888,955
050,35,043,"New Mexico","Sandoval County",5,49,1821,891,930
050,35,043,"New Mexico","Sandoval County",5,50,1834,894,940
050,35,043,"New Mexico","Sandoval County",5,51,1919,951,968
050,35,043,"New Mexico","Sandoval County",5,52,2061,1025,1036
050,35,043,"New Mexico","Sandoval County",5,53,1939,934,1005
050,35,043,"New Mexico","Sandoval County",5,54,1793,871,922
050,35,043,"New Mexico","Sandoval County",5,55,1736,876,860
050,35,043,"New Mexico","Sandoval County",5,56,1733,866,867
050,35,043,"New Mexico","Sandoval County",5,57,1768,889,879
050,35,043,"New Mexico","Sandoval County",5,58,1872,925,947
050,35,043,"New Mexico","Sandoval County",5,59,2084,1013,1071
050,35,043,"New Mexico","Sandoval County",5,60,2070,1008,1062
050,35,043,"New Mexico","Sandoval County",5,61,2162,1033,1129
050,35,043,"New Mexico","Sandoval County",5,62,2182,1042,1140
050,35,043,"New Mexico","Sandoval County",5,63,2163,1038,1125
050,35,043,"New Mexico","Sandoval County",5,64,2058,980,1078
050,35,043,"New Mexico","Sandoval County",5,65,2092,996,1096
050,35,043,"New Mexico","Sandoval County",5,66,2070,989,1081
050,35,043,"New Mexico","Sandoval County",5,67,2009,929,1080
050,35,043,"New Mexico","Sandoval County",5,68,2009,923,1086
050,35,043,"New Mexico","Sandoval County",5,69,1989,907,1082
050,35,043,"New Mexico","Sandoval County",5,70,1917,864,1053
050,35,043,"New Mexico","Sandoval County",5,71,1909,871,1038
050,35,043,"New Mexico","Sandoval County",5,72,1746,798,948
050,35,043,"New Mexico","Sandoval County",5,73,1761,826,935
050,35,043,"New Mexico","Sandoval County",5,74,1623,771,852
050,35,043,"New Mexico","Sandoval County",5,75,1609,764,845
050,35,043,"New Mexico","Sandoval County",5,76,1662,795,867
050,35,043,"New Mexico","Sandoval County",5,77,1169,527,642
050,35,043,"New Mexico","Sandoval County",5,78,1107,505,602
050,35,043,"New Mexico","Sandoval County",5,79,1045,484,561
050,35,043,"New Mexico","Sandoval County",5,80,977,456,521
050,35,043,"New Mexico","Sandoval County",5,81,828,383,445
050,35,043,"New Mexico","Sandoval County",5,82,688,316,372
050,35,043,"New Mexico","Sandoval County",5,83,623,280,343
050,35,043,"New Mexico","Sandoval County",5,84,535,239,296
050,35,043,"New Mexico","Sandoval County",5,85,2510,975,1535
050,35,045,"New Mexico","San Juan County",1,0,1341,680,661
050,35,045,"New Mexico","San Juan County",1,1,1371,684,687
050,35,045,"New Mexico","San Juan County",1,2,1393,678,715
050,35,045,"New Mexico","San Juan County",1,3,1536,805,731
050,35,045,"New Mexico","San Juan County",1,4,1596,809,787
050,35,045,"New Mexico","San Juan County",1,5,1663,806,857
050,35,045,"New Mexico","San Juan County",1,6,1692,876,816
050,35,045,"New Mexico","San Juan County",1,7,1725,880,845
050,35,045,"New Mexico","San Juan County",1,8,1778,940,838
050,35,045,"New Mexico","San Juan County",1,9,1781,906,875
050,35,045,"New Mexico","San Juan County",1,10,1848,958,890
050,35,045,"New Mexico","San Juan County",1,11,1925,973,952
050,35,045,"New Mexico","San Juan County",1,12,2053,1044,1009
050,35,045,"New Mexico","San Juan County",1,13,2010,1018,992
050,35,045,"New Mexico","San Juan County",1,14,1970,983,987
050,35,045,"New Mexico","San Juan County",1,15,1878,965,913
050,35,045,"New Mexico","San Juan County",1,16,1910,962,948
050,35,045,"New Mexico","San Juan County",1,17,1921,961,960
050,35,045,"New Mexico","San Juan County",1,18,1699,863,836
050,35,045,"New Mexico","San Juan County",1,19,1437,730,707
050,35,045,"New Mexico","San Juan County",1,20,1394,721,673
050,35,045,"New Mexico","San Juan County",1,21,1396,708,688
050,35,045,"New Mexico","San Juan County",1,22,1376,683,693
050,35,045,"New Mexico","San Juan County",1,23,1415,713,702
050,35,045,"New Mexico","San Juan County",1,24,1388,710,678
050,35,045,"New Mexico","San Juan County",1,25,1390,707,683
050,35,045,"New Mexico","San Juan County",1,26,1469,704,765
050,35,045,"New Mexico","San Juan County",1,27,1622,805,817
050,35,045,"New Mexico","San Juan County",1,28,1718,864,854
050,35,045,"New Mexico","San Juan County",1,29,1765,884,881
050,35,045,"New Mexico","San Juan County",1,30,1704,857,847
050,35,045,"New Mexico","San Juan County",1,31,1558,769,789
050,35,045,"New Mexico","San Juan County",1,32,1591,819,772
050,35,045,"New Mexico","San Juan County",1,33,1608,841,767
050,35,045,"New Mexico","San Juan County",1,34,1660,846,814
050,35,045,"New Mexico","San Juan County",1,35,1662,834,828
050,35,045,"New Mexico","San Juan County",1,36,1594,794,800
050,35,045,"New Mexico","San Juan County",1,37,1705,877,828
050,35,045,"New Mexico","San Juan County",1,38,1682,846,836
050,35,045,"New Mexico","San Juan County",1,39,1627,817,810
050,35,045,"New Mexico","San Juan County",1,40,1618,836,782
050,35,045,"New Mexico","San Juan County",1,41,1547,789,758
050,35,045,"New Mexico","San Juan County",1,42,1485,736,749
050,35,045,"New Mexico","San Juan County",1,43,1449,718,731
050,35,045,"New Mexico","San Juan County",1,44,1381,700,681
050,35,045,"New Mexico","San Juan County",1,45,1321,661,660
050,35,045,"New Mexico","San Juan County",1,46,1291,638,653
050,35,045,"New Mexico","San Juan County",1,47,1280,619,661
050,35,045,"New Mexico","San Juan County",1,48,1300,645,655
050,35,045,"New Mexico","San Juan County",1,49,1441,722,719
050,35,045,"New Mexico","San Juan County",1,50,1362,666,696
050,35,045,"New Mexico","San Juan County",1,51,1240,611,629
050,35,045,"New Mexico","San Juan County",1,52,1255,603,652
050,35,045,"New Mexico","San Juan County",1,53,1349,643,706
050,35,045,"New Mexico","San Juan County",1,54,1333,661,672
050,35,045,"New Mexico","San Juan County",1,55,1447,700,747
050,35,045,"New Mexico","San Juan County",1,56,1544,750,794
050,35,045,"New Mexico","San Juan County",1,57,1580,801,779
050,35,045,"New Mexico","San Juan County",1,58,1688,857,831
050,35,045,"New Mexico","San Juan County",1,59,1677,841,836
050,35,045,"New Mexico","San Juan County",1,60,1651,827,824
050,35,045,"New Mexico","San Juan County",1,61,1595,805,790
050,35,045,"New Mexico","San Juan County",1,62,1637,829,808
050,35,045,"New Mexico","San Juan County",1,63,1610,827,783
050,35,045,"New Mexico","San Juan County",1,64,1531,755,776
050,35,045,"New Mexico","San Juan County",1,65,1443,724,719
050,35,045,"New Mexico","San Juan County",1,66,1439,692,747
050,35,045,"New Mexico","San Juan County",1,67,1292,624,668
050,35,045,"New Mexico","San Juan County",1,68,1258,612,646
050,35,045,"New Mexico","San Juan County",1,69,1201,566,635
050,35,045,"New Mexico","San Juan County",1,70,1175,569,606
050,35,045,"New Mexico","San Juan County",1,71,1098,527,571
050,35,045,"New Mexico","San Juan County",1,72,1039,492,547
050,35,045,"New Mexico","San Juan County",1,73,985,442,543
050,35,045,"New Mexico","San Juan County",1,74,707,304,403
050,35,045,"New Mexico","San Juan County",1,75,733,322,411
050,35,045,"New Mexico","San Juan County",1,76,719,321,398
050,35,045,"New Mexico","San Juan County",1,77,656,315,341
050,35,045,"New Mexico","San Juan County",1,78,600,267,333
050,35,045,"New Mexico","San Juan County",1,79,577,244,333
050,35,045,"New Mexico","San Juan County",1,80,515,218,297
050,35,045,"New Mexico","San Juan County",1,81,485,205,280
050,35,045,"New Mexico","San Juan County",1,82,434,185,249
050,35,045,"New Mexico","San Juan County",1,83,408,185,223
050,35,045,"New Mexico","San Juan County",1,84,367,138,229
050,35,045,"New Mexico","San Juan County",1,85,2072,776,1296
050,35,045,"New Mexico","San Juan County",2,0,1347,677,670
050,35,045,"New Mexico","San Juan County",2,1,1363,680,683
050,35,045,"New Mexico","San Juan County",2,2,1389,682,707
050,35,045,"New Mexico","San Juan County",2,3,1499,772,727
050,35,045,"New Mexico","San Juan County",2,4,1581,804,777
050,35,045,"New Mexico","San Juan County",2,5,1638,805,833
050,35,045,"New Mexico","San Juan County",2,6,1686,862,824
050,35,045,"New Mexico","San Juan County",2,7,1716,882,834
050,35,045,"New Mexico","San Juan County",2,8,1755,914,841
050,35,045,"New Mexico","San Juan County",2,9,1769,909,860
050,35,045,"New Mexico","San Juan County",2,10,1823,940,883
050,35,045,"New Mexico","San Juan County",2,11,1894,963,931
050,35,045,"New Mexico","San Juan County",2,12,2026,1029,997
050,35,045,"New Mexico","San Juan County",2,13,2015,1019,996
050,35,045,"New Mexico","San Juan County",2,14,1974,990,984
050,35,045,"New Mexico","San Juan County",2,15,1896,967,929
050,35,045,"New Mexico","San Juan County",2,16,1913,962,951
050,35,045,"New Mexico","San Juan County",2,17,1909,961,948
050,35,045,"New Mexico","San Juan County",2,18,1691,861,830
050,35,045,"New Mexico","San Juan County",2,19,1445,733,712
050,35,045,"New Mexico","San Juan County",2,20,1423,733,690
050,35,045,"New Mexico","San Juan County",2,21,1389,707,682
050,35,045,"New Mexico","San Juan County",2,22,1396,698,698
050,35,045,"New Mexico","San Juan County",2,23,1412,711,701
050,35,045,"New Mexico","San Juan County",2,24,1393,712,681
050,35,045,"New Mexico","San Juan County",2,25,1389,707,682
050,35,045,"New Mexico","San Juan County",2,26,1454,709,745
050,35,045,"New Mexico","San Juan County",2,27,1592,785,807
050,35,045,"New Mexico","San Juan County",2,28,1688,845,843
050,35,045,"New Mexico","San Juan County",2,29,1752,879,873
050,35,045,"New Mexico","San Juan County",2,30,1718,860,858
050,35,045,"New Mexico","San Juan County",2,31,1591,789,802
050,35,045,"New Mexico","San Juan County",2,32,1582,807,775
050,35,045,"New Mexico","San Juan County",2,33,1602,831,771
050,35,045,"New Mexico","San Juan County",2,34,1642,841,801
050,35,045,"New Mexico","San Juan County",2,35,1653,828,825
050,35,045,"New Mexico","San Juan County",2,36,1608,806,802
050,35,045,"New Mexico","San Juan County",2,37,1673,853,820
050,35,045,"New Mexico","San Juan County",2,38,1697,864,833
050,35,045,"New Mexico","San Juan County",2,39,1626,810,816
050,35,045,"New Mexico","San Juan County",2,40,1633,838,795
050,35,045,"New Mexico","San Juan County",2,41,1555,797,758
050,35,045,"New Mexico","San Juan County",2,42,1485,740,745
050,35,045,"New Mexico","San Juan County",2,43,1463,725,738
050,35,045,"New Mexico","San Juan County",2,44,1384,699,685
050,35,045,"New Mexico","San Juan County",2,45,1335,669,666
050,35,045,"New Mexico","San Juan County",2,46,1288,640,648
050,35,045,"New Mexico","San Juan County",2,47,1276,619,657
050,35,045,"New Mexico","San Juan County",2,48,1291,638,653
050,35,045,"New Mexico","San Juan County",2,49,1409,706,703
050,35,045,"New Mexico","San Juan County",2,50,1368,672,696
050,35,045,"New Mexico","San Juan County",2,51,1270,626,644
050,35,045,"New Mexico","San Juan County",2,52,1248,600,648
050,35,045,"New Mexico","San Juan County",2,53,1323,631,692
050,35,045,"New Mexico","San Juan County",2,54,1331,655,676
050,35,045,"New Mexico","San Juan County",2,55,1422,688,734
050,35,045,"New Mexico","San Juan County",2,56,1512,737,775
050,35,045,"New Mexico","San Juan County",2,57,1570,787,783
050,35,045,"New Mexico","San Juan County",2,58,1653,839,814
050,35,045,"New Mexico","San Juan County",2,59,1676,838,838
050,35,045,"New Mexico","San Juan County",2,60,1651,827,824
050,35,045,"New Mexico","San Juan County",2,61,1594,802,792
050,35,045,"New Mexico","San Juan County",2,62,1621,821,800
050,35,045,"New Mexico","San Juan County",2,63,1620,829,791
050,35,045,"New Mexico","San Juan County",2,64,1534,762,772
050,35,045,"New Mexico","San Juan County",2,65,1462,733,729
050,35,045,"New Mexico","San Juan County",2,66,1438,695,743
050,35,045,"New Mexico","San Juan County",2,67,1319,640,679
050,35,045,"New Mexico","San Juan County",2,68,1250,606,644
050,35,045,"New Mexico","San Juan County",2,69,1207,575,632
050,35,045,"New Mexico","San Juan County",2,70,1176,564,612
050,35,045,"New Mexico","San Juan County",2,71,1108,530,578
050,35,045,"New Mexico","San Juan County",2,72,1034,492,542
050,35,045,"New Mexico","San Juan County",2,73,1032,471,561
050,35,045,"New Mexico","San Juan County",2,74,726,314,412
050,35,045,"New Mexico","San Juan County",2,75,724,316,408
050,35,045,"New Mexico","San Juan County",2,76,707,313,394
050,35,045,"New Mexico","San Juan County",2,77,672,319,353
050,35,045,"New Mexico","San Juan County",2,78,591,264,327
050,35,045,"New Mexico","San Juan County",2,79,568,240,328
050,35,045,"New Mexico","San Juan County",2,80,523,224,299
050,35,045,"New Mexico","San Juan County",2,81,479,206,273
050,35,045,"New Mexico","San Juan County",2,82,435,182,253
050,35,045,"New Mexico","San Juan County",2,83,404,180,224
050,35,045,"New Mexico","San Juan County",2,84,370,147,223
050,35,045,"New Mexico","San Juan County",2,85,2030,750,1280
050,35,045,"New Mexico","San Juan County",3,0,1317,670,647
050,35,045,"New Mexico","San Juan County",3,1,1338,646,692
050,35,045,"New Mexico","San Juan County",3,2,1364,667,697
050,35,045,"New Mexico","San Juan County",3,3,1416,678,738
050,35,045,"New Mexico","San Juan County",3,4,1495,778,717
050,35,045,"New Mexico","San Juan County",3,5,1587,804,783
050,35,045,"New Mexico","San Juan County",3,6,1619,802,817
050,35,045,"New Mexico","San Juan County",3,7,1682,862,820
050,35,045,"New Mexico","San Juan County",3,8,1710,879,831
050,35,045,"New Mexico","San Juan County",3,9,1746,915,831
050,35,045,"New Mexico","San Juan County",3,10,1789,919,870
050,35,045,"New Mexico","San Juan County",3,11,1817,921,896
050,35,045,"New Mexico","San Juan County",3,12,1882,950,932
050,35,045,"New Mexico","San Juan County",3,13,2006,1008,998
050,35,045,"New Mexico","San Juan County",3,14,2004,1009,995
050,35,045,"New Mexico","San Juan County",3,15,1966,974,992
050,35,045,"New Mexico","San Juan County",3,16,1954,962,992
050,35,045,"New Mexico","San Juan County",3,17,1913,979,934
050,35,045,"New Mexico","San Juan County",3,18,1702,863,839
050,35,045,"New Mexico","San Juan County",3,19,1456,740,716
050,35,045,"New Mexico","San Juan County",3,20,1488,752,736
050,35,045,"New Mexico","San Juan County",3,21,1432,727,705
050,35,045,"New Mexico","San Juan County",3,22,1402,728,674
050,35,045,"New Mexico","San Juan County",3,23,1425,724,701
050,35,045,"New Mexico","San Juan County",3,24,1393,706,687
050,35,045,"New Mexico","San Juan County",3,25,1396,714,682
050,35,045,"New Mexico","San Juan County",3,26,1387,710,677
050,35,045,"New Mexico","San Juan County",3,27,1504,742,762
050,35,045,"New Mexico","San Juan County",3,28,1547,772,775
050,35,045,"New Mexico","San Juan County",3,29,1671,843,828
050,35,045,"New Mexico","San Juan County",3,30,1688,835,853
050,35,045,"New Mexico","San Juan County",3,31,1734,869,865
050,35,045,"New Mexico","San Juan County",3,32,1572,783,789
050,35,045,"New Mexico","San Juan County",3,33,1588,815,773
050,35,045,"New Mexico","San Juan County",3,34,1589,817,772
050,35,045,"New Mexico","San Juan County",3,35,1620,832,788
050,35,045,"New Mexico","San Juan County",3,36,1681,840,841
050,35,045,"New Mexico","San Juan County",3,37,1606,808,798
050,35,045,"New Mexico","San Juan County",3,38,1648,838,810
050,35,045,"New Mexico","San Juan County",3,39,1667,849,818
050,35,045,"New Mexico","San Juan County",3,40,1621,804,817
050,35,045,"New Mexico","San Juan County",3,41,1622,835,787
050,35,045,"New Mexico","San Juan County",3,42,1574,808,766
050,35,045,"New Mexico","San Juan County",3,43,1469,717,752
050,35,045,"New Mexico","San Juan County",3,44,1454,714,740
050,35,045,"New Mexico","San Juan County",3,45,1373,681,692
050,35,045,"New Mexico","San Juan County",3,46,1321,665,656
050,35,045,"New Mexico","San Juan County",3,47,1288,628,660
050,35,045,"New Mexico","San Juan County",3,48,1265,615,650
050,35,045,"New Mexico","San Juan County",3,49,1305,644,661
050,35,045,"New Mexico","San Juan County",3,50,1380,691,689
050,35,045,"New Mexico","San Juan County",3,51,1371,670,701
050,35,045,"New Mexico","San Juan County",3,52,1261,611,650
050,35,045,"New Mexico","San Juan County",3,53,1246,597,649
050,35,045,"New Mexico","San Juan County",3,54,1304,618,686
050,35,045,"New Mexico","San Juan County",3,55,1330,651,679
050,35,045,"New Mexico","San Juan County",3,56,1419,692,727
050,35,045,"New Mexico","San Juan County",3,57,1496,719,777
050,35,045,"New Mexico","San Juan County",3,58,1556,776,780
050,35,045,"New Mexico","San Juan County",3,59,1643,835,808
050,35,045,"New Mexico","San Juan County",3,60,1660,829,831
050,35,045,"New Mexico","San Juan County",3,61,1625,804,821
050,35,045,"New Mexico","San Juan County",3,62,1584,801,783
050,35,045,"New Mexico","San Juan County",3,63,1606,815,791
050,35,045,"New Mexico","San Juan County",3,64,1609,809,800
050,35,045,"New Mexico","San Juan County",3,65,1517,754,763
050,35,045,"New Mexico","San Juan County",3,66,1440,719,721
050,35,045,"New Mexico","San Juan County",3,67,1411,675,736
050,35,045,"New Mexico","San Juan County",3,68,1286,618,668
050,35,045,"New Mexico","San Juan County",3,69,1212,585,627
050,35,045,"New Mexico","San Juan County",3,70,1190,561,629
050,35,045,"New Mexico","San Juan County",3,71,1144,545,599
050,35,045,"New Mexico","San Juan County",3,72,1090,532,558
050,35,045,"New Mexico","San Juan County",3,73,985,459,526
050,35,045,"New Mexico","San Juan County",3,74,1004,446,558
050,35,045,"New Mexico","San Juan County",3,75,698,304,394
050,35,045,"New Mexico","San Juan County",3,76,689,292,397
050,35,045,"New Mexico","San Juan County",3,77,679,309,370
050,35,045,"New Mexico","San Juan County",3,78,619,284,335
050,35,045,"New Mexico","San Juan County",3,79,564,248,316
050,35,045,"New Mexico","San Juan County",3,80,540,233,307
050,35,045,"New Mexico","San Juan County",3,81,486,202,284
050,35,045,"New Mexico","San Juan County",3,82,443,189,254
050,35,045,"New Mexico","San Juan County",3,83,397,161,236
050,35,045,"New Mexico","San Juan County",3,84,365,153,212
050,35,045,"New Mexico","San Juan County",3,85,2054,748,1306
050,35,045,"New Mexico","San Juan County",4,0,1309,666,643
050,35,045,"New Mexico","San Juan County",4,1,1329,680,649
050,35,045,"New Mexico","San Juan County",4,2,1356,662,694
050,35,045,"New Mexico","San Juan County",4,3,1371,677,694
050,35,045,"New Mexico","San Juan County",4,4,1429,689,740
050,35,045,"New Mexico","San Juan County",4,5,1480,776,704
050,35,045,"New Mexico","San Juan County",4,6,1600,813,787
050,35,045,"New Mexico","San Juan County",4,7,1666,819,847
050,35,045,"New Mexico","San Juan County",4,8,1679,861,818
050,35,045,"New Mexico","San Juan County",4,9,1727,894,833
050,35,045,"New Mexico","San Juan County",4,10,1728,888,840
050,35,045,"New Mexico","San Juan County",4,11,1787,913,874
050,35,045,"New Mexico","San Juan County",4,12,1850,952,898
050,35,045,"New Mexico","San Juan County",4,13,1903,960,943
050,35,045,"New Mexico","San Juan County",4,14,2043,1027,1016
050,35,045,"New Mexico","San Juan County",4,15,2005,1022,983
050,35,045,"New Mexico","San Juan County",4,16,2022,989,1033
050,35,045,"New Mexico","San Juan County",4,17,1960,984,976
050,35,045,"New Mexico","San Juan County",4,18,1675,878,797
050,35,045,"New Mexico","San Juan County",4,19,1445,731,714
050,35,045,"New Mexico","San Juan County",4,20,1443,723,720
050,35,045,"New Mexico","San Juan County",4,21,1466,741,725
050,35,045,"New Mexico","San Juan County",4,22,1409,719,690
050,35,045,"New Mexico","San Juan County",4,23,1395,724,671
050,35,045,"New Mexico","San Juan County",4,24,1421,726,695
050,35,045,"New Mexico","San Juan County",4,25,1389,709,680
050,35,045,"New Mexico","San Juan County",4,26,1383,716,667
050,35,045,"New Mexico","San Juan County",4,27,1407,714,693
050,35,045,"New Mexico","San Juan County",4,28,1481,733,748
050,35,045,"New Mexico","San Juan County",4,29,1524,765,759
050,35,045,"New Mexico","San Juan County",4,30,1672,836,836
050,35,045,"New Mexico","San Juan County",4,31,1686,841,845
050,35,045,"New Mexico","San Juan County",4,32,1726,863,863
050,35,045,"New Mexico","San Juan County",4,33,1587,788,799
050,35,045,"New Mexico","San Juan County",4,34,1595,815,780
050,35,045,"New Mexico","San Juan County",4,35,1575,794,781
050,35,045,"New Mexico","San Juan County",4,36,1621,839,782
050,35,045,"New Mexico","San Juan County",4,37,1686,851,835
050,35,045,"New Mexico","San Juan County",4,38,1639,829,810
050,35,045,"New Mexico","San Juan County",4,39,1654,836,818
050,35,045,"New Mexico","San Juan County",4,40,1677,846,831
050,35,045,"New Mexico","San Juan County",4,41,1609,798,811
050,35,045,"New Mexico","San Juan County",4,42,1607,831,776
050,35,045,"New Mexico","San Juan County",4,43,1559,784,775
050,35,045,"New Mexico","San Juan County",4,44,1453,704,749
050,35,045,"New Mexico","San Juan County",4,45,1436,707,729
050,35,045,"New Mexico","San Juan County",4,46,1397,692,705
050,35,045,"New Mexico","San Juan County",4,47,1307,647,660
050,35,045,"New Mexico","San Juan County",4,48,1278,629,649
050,35,045,"New Mexico","San Juan County",4,49,1277,611,666
050,35,045,"New Mexico","San Juan County",4,50,1280,630,650
050,35,045,"New Mexico","San Juan County",4,51,1391,695,696
050,35,045,"New Mexico","San Juan County",4,52,1337,658,679
050,35,045,"New Mexico","San Juan County",4,53,1233,599,634
050,35,045,"New Mexico","San Juan County",4,54,1221,581,640
050,35,045,"New Mexico","San Juan County",4,55,1296,606,690
050,35,045,"New Mexico","San Juan County",4,56,1312,648,664
050,35,045,"New Mexico","San Juan County",4,57,1420,680,740
050,35,045,"New Mexico","San Juan County",4,58,1479,709,770
050,35,045,"New Mexico","San Juan County",4,59,1511,741,770
050,35,045,"New Mexico","San Juan County",4,60,1605,813,792
050,35,045,"New Mexico","San Juan County",4,61,1632,806,826
050,35,045,"New Mexico","San Juan County",4,62,1600,787,813
050,35,045,"New Mexico","San Juan County",4,63,1562,790,772
050,35,045,"New Mexico","San Juan County",4,64,1589,798,791
050,35,045,"New Mexico","San Juan County",4,65,1578,798,780
050,35,045,"New Mexico","San Juan County",4,66,1472,728,744
050,35,045,"New Mexico","San Juan County",4,67,1401,695,706
050,35,045,"New Mexico","San Juan County",4,68,1401,669,732
050,35,045,"New Mexico","San Juan County",4,69,1242,587,655
050,35,045,"New Mexico","San Juan County",4,70,1200,577,623
050,35,045,"New Mexico","San Juan County",4,71,1149,535,614
050,35,045,"New Mexico","San Juan County",4,72,1130,546,584
050,35,045,"New Mexico","San Juan County",4,73,1037,496,541
050,35,045,"New Mexico","San Juan County",4,74,950,431,519
050,35,045,"New Mexico","San Juan County",4,75,973,434,539
050,35,045,"New Mexico","San Juan County",4,76,672,286,386
050,35,045,"New Mexico","San Juan County",4,77,654,283,371
050,35,045,"New Mexico","San Juan County",4,78,647,293,354
050,35,045,"New Mexico","San Juan County",4,79,593,261,332
050,35,045,"New Mexico","San Juan County",4,80,525,229,296
050,35,045,"New Mexico","San Juan County",4,81,494,210,284
050,35,045,"New Mexico","San Juan County",4,82,452,188,264
050,35,045,"New Mexico","San Juan County",4,83,413,172,241
050,35,045,"New Mexico","San Juan County",4,84,362,137,225
050,35,045,"New Mexico","San Juan County",4,85,2033,739,1294
050,35,045,"New Mexico","San Juan County",5,0,1315,665,650
050,35,045,"New Mexico","San Juan County",5,1,1343,691,652
050,35,045,"New Mexico","San Juan County",5,2,1339,688,651
050,35,045,"New Mexico","San Juan County",5,3,1356,663,693
050,35,045,"New Mexico","San Juan County",5,4,1391,687,704
050,35,045,"New Mexico","San Juan County",5,5,1421,688,733
050,35,045,"New Mexico","San Juan County",5,6,1460,766,694
050,35,045,"New Mexico","San Juan County",5,7,1628,817,811
050,35,045,"New Mexico","San Juan County",5,8,1662,815,847
050,35,045,"New Mexico","San Juan County",5,9,1681,850,831
050,35,045,"New Mexico","San Juan County",5,10,1733,897,836
050,35,045,"New Mexico","San Juan County",5,11,1757,888,869
050,35,045,"New Mexico","San Juan County",5,12,1799,916,883
050,35,045,"New Mexico","San Juan County",5,13,1825,933,892
050,35,045,"New Mexico","San Juan County",5,14,1883,947,936
050,35,045,"New Mexico","San Juan County",5,15,2067,1039,1028
050,35,045,"New Mexico","San Juan County",5,16,2025,1017,1008
050,35,045,"New Mexico","San Juan County",5,17,2018,1004,1014
050,35,045,"New Mexico","San Juan County",5,18,1756,905,851
050,35,045,"New Mexico","San Juan County",5,19,1446,758,688
050,35,045,"New Mexico","San Juan County",5,20,1491,755,736
050,35,045,"New Mexico","San Juan County",5,21,1456,728,728
050,35,045,"New Mexico","San Juan County",5,22,1519,764,755
050,35,045,"New Mexico","San Juan County",5,23,1449,751,698
050,35,045,"New Mexico","San Juan County",5,24,1412,732,680
050,35,045,"New Mexico","San Juan County",5,25,1451,732,719
050,35,045,"New Mexico","San Juan County",5,26,1417,717,700
050,35,045,"New Mexico","San Juan County",5,27,1440,744,696
050,35,045,"New Mexico","San Juan County",5,28,1382,705,677
050,35,045,"New Mexico","San Juan County",5,29,1486,751,735
050,35,045,"New Mexico","San Juan County",5,30,1535,775,760
050,35,045,"New Mexico","San Juan County",5,31,1703,860,843
050,35,045,"New Mexico","San Juan County",5,32,1644,802,842
050,35,045,"New Mexico","San Juan County",5,33,1731,872,859
050,35,045,"New Mexico","San Juan County",5,34,1588,786,802
050,35,045,"New Mexico","San Juan County",5,35,1602,799,803
050,35,045,"New Mexico","San Juan County",5,36,1568,793,775
050,35,045,"New Mexico","San Juan County",5,37,1614,838,776
050,35,045,"New Mexico","San Juan County",5,38,1714,860,854
050,35,045,"New Mexico","San Juan County",5,39,1616,817,799
050,35,045,"New Mexico","San Juan County",5,40,1654,825,829
050,35,045,"New Mexico","San Juan County",5,41,1695,848,847
050,35,045,"New Mexico","San Juan County",5,42,1608,805,803
050,35,045,"New Mexico","San Juan County",5,43,1620,826,794
050,35,045,"New Mexico","San Juan County",5,44,1568,802,766
050,35,045,"New Mexico","San Juan County",5,45,1442,697,745
050,35,045,"New Mexico","San Juan County",5,46,1436,712,724
050,35,045,"New Mexico","San Juan County",5,47,1342,659,683
050,35,045,"New Mexico","San Juan County",5,48,1310,637,673
050,35,045,"New Mexico","San Juan County",5,49,1280,636,644
050,35,045,"New Mexico","San Juan County",5,50,1267,589,678
050,35,045,"New Mexico","San Juan County",5,51,1293,635,658
050,35,045,"New Mexico","San Juan County",5,52,1361,680,681
050,35,045,"New Mexico","San Juan County",5,53,1309,646,663
050,35,045,"New Mexico","San Juan County",5,54,1232,586,646
050,35,045,"New Mexico","San Juan County",5,55,1218,576,642
050,35,045,"New Mexico","San Juan County",5,56,1291,605,686
050,35,045,"New Mexico","San Juan County",5,57,1295,635,660
050,35,045,"New Mexico","San Juan County",5,58,1396,668,728
050,35,045,"New Mexico","San Juan County",5,59,1457,692,765
050,35,045,"New Mexico","San Juan County",5,60,1500,748,752
050,35,045,"New Mexico","San Juan County",5,61,1595,798,797
050,35,045,"New Mexico","San Juan County",5,62,1640,801,839
050,35,045,"New Mexico","San Juan County",5,63,1582,769,813
050,35,045,"New Mexico","San Juan County",5,64,1556,786,770
050,35,045,"New Mexico","San Juan County",5,65,1579,785,794
050,35,045,"New Mexico","San Juan County",5,66,1552,778,774
050,35,045,"New Mexico","San Juan County",5,67,1437,701,736
050,35,045,"New Mexico","San Juan County",5,68,1373,681,692
050,35,045,"New Mexico","San Juan County",5,69,1342,633,709
050,35,045,"New Mexico","San Juan County",5,70,1236,583,653
050,35,045,"New Mexico","San Juan County",5,71,1162,556,606
050,35,045,"New Mexico","San Juan County",5,72,1120,532,588
050,35,045,"New Mexico","San Juan County",5,73,1097,525,572
050,35,045,"New Mexico","San Juan County",5,74,1013,475,538
050,35,045,"New Mexico","San Juan County",5,75,930,425,505
050,35,045,"New Mexico","San Juan County",5,76,935,415,520
050,35,045,"New Mexico","San Juan County",5,77,652,276,376
050,35,045,"New Mexico","San Juan County",5,78,625,265,360
050,35,045,"New Mexico","San Juan County",5,79,621,280,341
050,35,045,"New Mexico","San Juan County",5,80,555,244,311
050,35,045,"New Mexico","San Juan County",5,81,488,211,277
050,35,045,"New Mexico","San Juan County",5,82,451,190,261
050,35,045,"New Mexico","San Juan County",5,83,416,168,248
050,35,045,"New Mexico","San Juan County",5,84,375,144,231
050,35,045,"New Mexico","San Juan County",5,85,2046,730,1316
050,35,047,"New Mexico","San Miguel County",1,0,233,119,114
050,35,047,"New Mexico","San Miguel County",1,1,237,133,104
050,35,047,"New Mexico","San Miguel County",1,2,232,126,106
050,35,047,"New Mexico","San Miguel County",1,3,242,119,123
050,35,047,"New Mexico","San Miguel County",1,4,245,116,129
050,35,047,"New Mexico","San Miguel County",1,5,256,128,128
050,35,047,"New Mexico","San Miguel County",1,6,272,138,134
050,35,047,"New Mexico","San Miguel County",1,7,282,150,132
050,35,047,"New Mexico","San Miguel County",1,8,250,128,122
050,35,047,"New Mexico","San Miguel County",1,9,234,125,109
050,35,047,"New Mexico","San Miguel County",1,10,239,119,120
050,35,047,"New Mexico","San Miguel County",1,11,245,120,125
050,35,047,"New Mexico","San Miguel County",1,12,258,130,128
050,35,047,"New Mexico","San Miguel County",1,13,296,156,140
050,35,047,"New Mexico","San Miguel County",1,14,262,133,129
050,35,047,"New Mexico","San Miguel County",1,15,278,151,127
050,35,047,"New Mexico","San Miguel County",1,16,298,155,143
050,35,047,"New Mexico","San Miguel County",1,17,332,169,163
050,35,047,"New Mexico","San Miguel County",1,18,413,195,218
050,35,047,"New Mexico","San Miguel County",1,19,462,254,208
050,35,047,"New Mexico","San Miguel County",1,20,392,199,193
050,35,047,"New Mexico","San Miguel County",1,21,363,193,170
050,35,047,"New Mexico","San Miguel County",1,22,355,180,175
050,35,047,"New Mexico","San Miguel County",1,23,336,179,157
050,35,047,"New Mexico","San Miguel County",1,24,320,156,164
050,35,047,"New Mexico","San Miguel County",1,25,325,162,163
050,35,047,"New Mexico","San Miguel County",1,26,317,168,149
050,35,047,"New Mexico","San Miguel County",1,27,359,184,175
050,35,047,"New Mexico","San Miguel County",1,28,331,164,167
050,35,047,"New Mexico","San Miguel County",1,29,327,169,158
050,35,047,"New Mexico","San Miguel County",1,30,303,165,138
050,35,047,"New Mexico","San Miguel County",1,31,301,155,146
050,35,047,"New Mexico","San Miguel County",1,32,268,136,132
050,35,047,"New Mexico","San Miguel County",1,33,296,156,140
050,35,047,"New Mexico","San Miguel County",1,34,313,172,141
050,35,047,"New Mexico","San Miguel County",1,35,304,149,155
050,35,047,"New Mexico","San Miguel County",1,36,290,149,141
050,35,047,"New Mexico","San Miguel County",1,37,279,150,129
050,35,047,"New Mexico","San Miguel County",1,38,289,141,148
050,35,047,"New Mexico","San Miguel County",1,39,311,158,153
050,35,047,"New Mexico","San Miguel County",1,40,319,165,154
050,35,047,"New Mexico","San Miguel County",1,41,277,134,143
050,35,047,"New Mexico","San Miguel County",1,42,285,147,138
050,35,047,"New Mexico","San Miguel County",1,43,263,116,147
050,35,047,"New Mexico","San Miguel County",1,44,267,123,144
050,35,047,"New Mexico","San Miguel County",1,45,287,127,160
050,35,047,"New Mexico","San Miguel County",1,46,277,130,147
050,35,047,"New Mexico","San Miguel County",1,47,306,148,158
050,35,047,"New Mexico","San Miguel County",1,48,331,165,166
050,35,047,"New Mexico","San Miguel County",1,49,362,175,187
050,35,047,"New Mexico","San Miguel County",1,50,353,176,177
050,35,047,"New Mexico","San Miguel County",1,51,313,168,145
050,35,047,"New Mexico","San Miguel County",1,52,286,159,127
050,35,047,"New Mexico","San Miguel County",1,53,282,147,135
050,35,047,"New Mexico","San Miguel County",1,54,315,160,155
050,35,047,"New Mexico","San Miguel County",1,55,393,197,196
050,35,047,"New Mexico","San Miguel County",1,56,420,201,219
050,35,047,"New Mexico","San Miguel County",1,57,432,225,207
050,35,047,"New Mexico","San Miguel County",1,58,469,250,219
050,35,047,"New Mexico","San Miguel County",1,59,461,244,217
050,35,047,"New Mexico","San Miguel County",1,60,419,209,210
050,35,047,"New Mexico","San Miguel County",1,61,413,206,207
050,35,047,"New Mexico","San Miguel County",1,62,458,241,217
050,35,047,"New Mexico","San Miguel County",1,63,438,212,226
050,35,047,"New Mexico","San Miguel County",1,64,434,201,233
050,35,047,"New Mexico","San Miguel County",1,65,421,194,227
050,35,047,"New Mexico","San Miguel County",1,66,411,182,229
050,35,047,"New Mexico","San Miguel County",1,67,416,201,215
050,35,047,"New Mexico","San Miguel County",1,68,399,193,206
050,35,047,"New Mexico","San Miguel County",1,69,395,192,203
050,35,047,"New Mexico","San Miguel County",1,70,401,194,207
050,35,047,"New Mexico","San Miguel County",1,71,390,183,207
050,35,047,"New Mexico","San Miguel County",1,72,378,180,198
050,35,047,"New Mexico","San Miguel County",1,73,382,186,196
050,35,047,"New Mexico","San Miguel County",1,74,255,125,130
050,35,047,"New Mexico","San Miguel County",1,75,256,125,131
050,35,047,"New Mexico","San Miguel County",1,76,252,120,132
050,35,047,"New Mexico","San Miguel County",1,77,267,132,135
050,35,047,"New Mexico","San Miguel County",1,78,233,110,123
050,35,047,"New Mexico","San Miguel County",1,79,203,97,106
050,35,047,"New Mexico","San Miguel County",1,80,180,81,99
050,35,047,"New Mexico","San Miguel County",1,81,179,76,103
050,35,047,"New Mexico","San Miguel County",1,82,152,80,72
050,35,047,"New Mexico","San Miguel County",1,83,124,63,61
050,35,047,"New Mexico","San Miguel County",1,84,129,58,71
050,35,047,"New Mexico","San Miguel County",1,85,574,212,362
050,35,047,"New Mexico","San Miguel County",2,0,229,121,108
050,35,047,"New Mexico","San Miguel County",2,1,237,131,106
050,35,047,"New Mexico","San Miguel County",2,2,232,127,105
050,35,047,"New Mexico","San Miguel County",2,3,238,121,117
050,35,047,"New Mexico","San Miguel County",2,4,243,117,126
050,35,047,"New Mexico","San Miguel County",2,5,254,126,128
050,35,047,"New Mexico","San Miguel County",2,6,268,135,133
050,35,047,"New Mexico","San Miguel County",2,7,275,146,129
050,35,047,"New Mexico","San Miguel County",2,8,253,130,123
050,35,047,"New Mexico","San Miguel County",2,9,239,126,113
050,35,047,"New Mexico","San Miguel County",2,10,235,120,115
050,35,047,"New Mexico","San Miguel County",2,11,238,116,122
050,35,047,"New Mexico","San Miguel County",2,12,256,130,126
050,35,047,"New Mexico","San Miguel County",2,13,281,147,134
050,35,047,"New Mexico","San Miguel County",2,14,271,139,132
050,35,047,"New Mexico","San Miguel County",2,15,274,146,128
050,35,047,"New Mexico","San Miguel County",2,16,295,154,141
050,35,047,"New Mexico","San Miguel County",2,17,327,166,161
050,35,047,"New Mexico","San Miguel County",2,18,413,196,217
050,35,047,"New Mexico","San Miguel County",2,19,457,249,208
050,35,047,"New Mexico","San Miguel County",2,20,390,195,195
050,35,047,"New Mexico","San Miguel County",2,21,358,188,170
050,35,047,"New Mexico","San Miguel County",2,22,353,183,170
050,35,047,"New Mexico","San Miguel County",2,23,331,174,157
050,35,047,"New Mexico","San Miguel County",2,24,319,157,162
050,35,047,"New Mexico","San Miguel County",2,25,322,163,159
050,35,047,"New Mexico","San Miguel County",2,26,318,165,153
050,35,047,"New Mexico","San Miguel County",2,27,347,181,166
050,35,047,"New Mexico","San Miguel County",2,28,335,167,168
050,35,047,"New Mexico","San Miguel County",2,29,326,167,159
050,35,047,"New Mexico","San Miguel County",2,30,305,162,143
050,35,047,"New Mexico","San Miguel County",2,31,299,158,141
050,35,047,"New Mexico","San Miguel County",2,32,276,141,135
050,35,047,"New Mexico","San Miguel County",2,33,288,152,136
050,35,047,"New Mexico","San Miguel County",2,34,310,169,141
050,35,047,"New Mexico","San Miguel County",2,35,305,155,150
050,35,047,"New Mexico","San Miguel County",2,36,292,149,143
050,35,047,"New Mexico","San Miguel County",2,37,284,152,132
050,35,047,"New Mexico","San Miguel County",2,38,288,145,143
050,35,047,"New Mexico","San Miguel County",2,39,302,152,150
050,35,047,"New Mexico","San Miguel County",2,40,319,164,155
050,35,047,"New Mexico","San Miguel County",2,41,285,140,145
050,35,047,"New Mexico","San Miguel County",2,42,282,143,139
050,35,047,"New Mexico","San Miguel County",2,43,270,125,145
050,35,047,"New Mexico","San Miguel County",2,44,266,122,144
050,35,047,"New Mexico","San Miguel County",2,45,284,127,157
050,35,047,"New Mexico","San Miguel County",2,46,278,129,149
050,35,047,"New Mexico","San Miguel County",2,47,300,144,156
050,35,047,"New Mexico","San Miguel County",2,48,327,162,165
050,35,047,"New Mexico","San Miguel County",2,49,351,171,180
050,35,047,"New Mexico","San Miguel County",2,50,354,175,179
050,35,047,"New Mexico","San Miguel County",2,51,324,172,152
050,35,047,"New Mexico","San Miguel County",2,52,293,162,131
050,35,047,"New Mexico","San Miguel County",2,53,277,147,130
050,35,047,"New Mexico","San Miguel County",2,54,307,158,149
050,35,047,"New Mexico","San Miguel County",2,55,375,189,186
050,35,047,"New Mexico","San Miguel County",2,56,414,201,213
050,35,047,"New Mexico","San Miguel County",2,57,428,217,211
050,35,047,"New Mexico","San Miguel County",2,58,461,245,216
050,35,047,"New Mexico","San Miguel County",2,59,460,244,216
050,35,047,"New Mexico","San Miguel County",2,60,433,220,213
050,35,047,"New Mexico","San Miguel County",2,61,418,208,210
050,35,047,"New Mexico","San Miguel County",2,62,440,228,212
050,35,047,"New Mexico","San Miguel County",2,63,446,219,227
050,35,047,"New Mexico","San Miguel County",2,64,434,204,230
050,35,047,"New Mexico","San Miguel County",2,65,423,194,229
050,35,047,"New Mexico","San Miguel County",2,66,417,187,230
050,35,047,"New Mexico","San Miguel County",2,67,414,197,217
050,35,047,"New Mexico","San Miguel County",2,68,400,191,209
050,35,047,"New Mexico","San Miguel County",2,69,395,193,202
050,35,047,"New Mexico","San Miguel County",2,70,398,192,206
050,35,047,"New Mexico","San Miguel County",2,71,391,184,207
050,35,047,"New Mexico","San Miguel County",2,72,374,175,199
050,35,047,"New Mexico","San Miguel County",2,73,391,188,203
050,35,047,"New Mexico","San Miguel County",2,74,273,133,140
050,35,047,"New Mexico","San Miguel County",2,75,255,124,131
050,35,047,"New Mexico","San Miguel County",2,76,253,121,132
050,35,047,"New Mexico","San Miguel County",2,77,263,130,133
050,35,047,"New Mexico","San Miguel County",2,78,241,116,125
050,35,047,"New Mexico","San Miguel County",2,79,209,98,111
050,35,047,"New Mexico","San Miguel County",2,80,185,85,100
050,35,047,"New Mexico","San Miguel County",2,81,175,75,100
050,35,047,"New Mexico","San Miguel County",2,82,159,79,80
050,35,047,"New Mexico","San Miguel County",2,83,125,64,61
050,35,047,"New Mexico","San Miguel County",2,84,126,59,67
050,35,047,"New Mexico","San Miguel County",2,85,575,215,360
050,35,047,"New Mexico","San Miguel County",3,0,224,114,110
050,35,047,"New Mexico","San Miguel County",3,1,228,117,111
050,35,047,"New Mexico","San Miguel County",3,2,229,131,98
050,35,047,"New Mexico","San Miguel County",3,3,233,124,109
050,35,047,"New Mexico","San Miguel County",3,4,230,117,113
050,35,047,"New Mexico","San Miguel County",3,5,236,116,120
050,35,047,"New Mexico","San Miguel County",3,6,251,127,124
050,35,047,"New Mexico","San Miguel County",3,7,268,141,127
050,35,047,"New Mexico","San Miguel County",3,8,266,139,127
050,35,047,"New Mexico","San Miguel County",3,9,258,132,126
050,35,047,"New Mexico","San Miguel County",3,10,252,138,114
050,35,047,"New Mexico","San Miguel County",3,11,238,122,116
050,35,047,"New Mexico","San Miguel County",3,12,244,117,127
050,35,047,"New Mexico","San Miguel County",3,13,253,131,122
050,35,047,"New Mexico","San Miguel County",3,14,279,143,136
050,35,047,"New Mexico","San Miguel County",3,15,262,128,134
050,35,047,"New Mexico","San Miguel County",3,16,287,152,135
050,35,047,"New Mexico","San Miguel County",3,17,312,162,150
050,35,047,"New Mexico","San Miguel County",3,18,411,193,218
050,35,047,"New Mexico","San Miguel County",3,19,445,245,200
050,35,047,"New Mexico","San Miguel County",3,20,387,180,207
050,35,047,"New Mexico","San Miguel County",3,21,366,189,177
050,35,047,"New Mexico","San Miguel County",3,22,335,181,154
050,35,047,"New Mexico","San Miguel County",3,23,302,160,142
050,35,047,"New Mexico","San Miguel County",3,24,319,164,155
050,35,047,"New Mexico","San Miguel County",3,25,322,155,167
050,35,047,"New Mexico","San Miguel County",3,26,309,151,158
050,35,047,"New Mexico","San Miguel County",3,27,305,162,143
050,35,047,"New Mexico","San Miguel County",3,28,347,180,167
050,35,047,"New Mexico","San Miguel County",3,29,338,176,162
050,35,047,"New Mexico","San Miguel County",3,30,330,168,162
050,35,047,"New Mexico","San Miguel County",3,31,318,167,151
050,35,047,"New Mexico","San Miguel County",3,32,311,169,142
050,35,047,"New Mexico","San Miguel County",3,33,279,144,135
050,35,047,"New Mexico","San Miguel County",3,34,293,152,141
050,35,047,"New Mexico","San Miguel County",3,35,308,173,135
050,35,047,"New Mexico","San Miguel County",3,36,303,154,149
050,35,047,"New Mexico","San Miguel County",3,37,294,150,144
050,35,047,"New Mexico","San Miguel County",3,38,281,145,136
050,35,047,"New Mexico","San Miguel County",3,39,299,150,149
050,35,047,"New Mexico","San Miguel County",3,40,313,160,153
050,35,047,"New Mexico","San Miguel County",3,41,325,165,160
050,35,047,"New Mexico","San Miguel County",3,42,288,144,144
050,35,047,"New Mexico","San Miguel County",3,43,283,151,132
050,35,047,"New Mexico","San Miguel County",3,44,272,129,143
050,35,047,"New Mexico","San Miguel County",3,45,272,128,144
050,35,047,"New Mexico","San Miguel County",3,46,287,130,157
050,35,047,"New Mexico","San Miguel County",3,47,283,128,155
050,35,047,"New Mexico","San Miguel County",3,48,283,136,147
050,35,047,"New Mexico","San Miguel County",3,49,328,170,158
050,35,047,"New Mexico","San Miguel County",3,50,347,164,183
050,35,047,"New Mexico","San Miguel County",3,51,366,182,184
050,35,047,"New Mexico","San Miguel County",3,52,329,174,155
050,35,047,"New Mexico","San Miguel County",3,53,282,152,130
050,35,047,"New Mexico","San Miguel County",3,54,288,154,134
050,35,047,"New Mexico","San Miguel County",3,55,313,157,156
050,35,047,"New Mexico","San Miguel County",3,56,368,189,179
050,35,047,"New Mexico","San Miguel County",3,57,424,204,220
050,35,047,"New Mexico","San Miguel County",3,58,427,216,211
050,35,047,"New Mexico","San Miguel County",3,59,453,239,214
050,35,047,"New Mexico","San Miguel County",3,60,460,245,215
050,35,047,"New Mexico","San Miguel County",3,61,446,224,222
050,35,047,"New Mexico","San Miguel County",3,62,424,215,209
050,35,047,"New Mexico","San Miguel County",3,63,448,231,217
050,35,047,"New Mexico","San Miguel County",3,64,435,217,218
050,35,047,"New Mexico","San Miguel County",3,65,411,194,217
050,35,047,"New Mexico","San Miguel County",3,66,428,195,233
050,35,047,"New Mexico","San Miguel County",3,67,415,191,224
050,35,047,"New Mexico","San Miguel County",3,68,413,195,218
050,35,047,"New Mexico","San Miguel County",3,69,398,187,211
050,35,047,"New Mexico","San Miguel County",3,70,394,191,203
050,35,047,"New Mexico","San Miguel County",3,71,392,187,205
050,35,047,"New Mexico","San Miguel County",3,72,388,181,207
050,35,047,"New Mexico","San Miguel County",3,73,368,170,198
050,35,047,"New Mexico","San Miguel County",3,74,385,181,204
050,35,047,"New Mexico","San Miguel County",3,75,268,130,138
050,35,047,"New Mexico","San Miguel County",3,76,247,116,131
050,35,047,"New Mexico","San Miguel County",3,77,240,114,126
050,35,047,"New Mexico","San Miguel County",3,78,259,131,128
050,35,047,"New Mexico","San Miguel County",3,79,236,110,126
050,35,047,"New Mexico","San Miguel County",3,80,203,92,111
050,35,047,"New Mexico","San Miguel County",3,81,179,82,97
050,35,047,"New Mexico","San Miguel County",3,82,164,65,99
050,35,047,"New Mexico","San Miguel County",3,83,155,76,79
050,35,047,"New Mexico","San Miguel County",3,84,113,57,56
050,35,047,"New Mexico","San Miguel County",3,85,603,240,363
050,35,047,"New Mexico","San Miguel County",4,0,219,118,101
050,35,047,"New Mexico","San Miguel County",4,1,216,107,109
050,35,047,"New Mexico","San Miguel County",4,2,224,115,109
050,35,047,"New Mexico","San Miguel County",4,3,222,128,94
050,35,047,"New Mexico","San Miguel County",4,4,231,124,107
050,35,047,"New Mexico","San Miguel County",4,5,232,116,116
050,35,047,"New Mexico","San Miguel County",4,6,229,117,112
050,35,047,"New Mexico","San Miguel County",4,7,251,128,123
050,35,047,"New Mexico","San Miguel County",4,8,273,148,125
050,35,047,"New Mexico","San Miguel County",4,9,264,137,127
050,35,047,"New Mexico","San Miguel County",4,10,260,132,128
050,35,047,"New Mexico","San Miguel County",4,11,253,140,113
050,35,047,"New Mexico","San Miguel County",4,12,226,115,111
050,35,047,"New Mexico","San Miguel County",4,13,251,122,129
050,35,047,"New Mexico","San Miguel County",4,14,244,127,117
050,35,047,"New Mexico","San Miguel County",4,15,279,143,136
050,35,047,"New Mexico","San Miguel County",4,16,268,130,138
050,35,047,"New Mexico","San Miguel County",4,17,309,162,147
050,35,047,"New Mexico","San Miguel County",4,18,417,201,216
050,35,047,"New Mexico","San Miguel County",4,19,429,229,200
050,35,047,"New Mexico","San Miguel County",4,20,376,185,191
050,35,047,"New Mexico","San Miguel County",4,21,367,175,192
050,35,047,"New Mexico","San Miguel County",4,22,341,186,155
050,35,047,"New Mexico","San Miguel County",4,23,299,154,145
050,35,047,"New Mexico","San Miguel County",4,24,291,146,145
050,35,047,"New Mexico","San Miguel County",4,25,304,151,153
050,35,047,"New Mexico","San Miguel County",4,26,320,157,163
050,35,047,"New Mexico","San Miguel County",4,27,298,150,148
050,35,047,"New Mexico","San Miguel County",4,28,292,148,144
050,35,047,"New Mexico","San Miguel County",4,29,333,178,155
050,35,047,"New Mexico","San Miguel County",4,30,315,164,151
050,35,047,"New Mexico","San Miguel County",4,31,336,177,159
050,35,047,"New Mexico","San Miguel County",4,32,314,164,150
050,35,047,"New Mexico","San Miguel County",4,33,305,160,145
050,35,047,"New Mexico","San Miguel County",4,34,265,134,131
050,35,047,"New Mexico","San Miguel County",4,35,301,161,140
050,35,047,"New Mexico","San Miguel County",4,36,310,175,135
050,35,047,"New Mexico","San Miguel County",4,37,305,153,152
050,35,047,"New Mexico","San Miguel County",4,38,308,152,156
050,35,047,"New Mexico","San Miguel County",4,39,272,139,133
050,35,047,"New Mexico","San Miguel County",4,40,299,150,149
050,35,047,"New Mexico","San Miguel County",4,41,305,153,152
050,35,047,"New Mexico","San Miguel County",4,42,319,159,160
050,35,047,"New Mexico","San Miguel County",4,43,303,150,153
050,35,047,"New Mexico","San Miguel County",4,44,282,145,137
050,35,047,"New Mexico","San Miguel County",4,45,275,136,139
050,35,047,"New Mexico","San Miguel County",4,46,266,124,142
050,35,047,"New Mexico","San Miguel County",4,47,296,131,165
050,35,047,"New Mexico","San Miguel County",4,48,277,132,145
050,35,047,"New Mexico","San Miguel County",4,49,273,130,143
050,35,047,"New Mexico","San Miguel County",4,50,322,161,161
050,35,047,"New Mexico","San Miguel County",4,51,345,165,180
050,35,047,"New Mexico","San Miguel County",4,52,372,185,187
050,35,047,"New Mexico","San Miguel County",4,53,328,173,155
050,35,047,"New Mexico","San Miguel County",4,54,281,156,125
050,35,047,"New Mexico","San Miguel County",4,55,289,153,136
050,35,047,"New Mexico","San Miguel County",4,56,301,149,152
050,35,047,"New Mexico","San Miguel County",4,57,376,186,190
050,35,047,"New Mexico","San Miguel County",4,58,408,185,223
050,35,047,"New Mexico","San Miguel County",4,59,408,202,206
050,35,047,"New Mexico","San Miguel County",4,60,447,229,218
050,35,047,"New Mexico","San Miguel County",4,61,465,251,214
050,35,047,"New Mexico","San Miguel County",4,62,447,226,221
050,35,047,"New Mexico","San Miguel County",4,63,435,220,215
050,35,047,"New Mexico","San Miguel County",4,64,428,227,201
050,35,047,"New Mexico","San Miguel County",4,65,420,212,208
050,35,047,"New Mexico","San Miguel County",4,66,419,197,222
050,35,047,"New Mexico","San Miguel County",4,67,419,193,226
050,35,047,"New Mexico","San Miguel County",4,68,406,182,224
050,35,047,"New Mexico","San Miguel County",4,69,413,190,223
050,35,047,"New Mexico","San Miguel County",4,70,399,191,208
050,35,047,"New Mexico","San Miguel County",4,71,378,181,197
050,35,047,"New Mexico","San Miguel County",4,72,381,183,198
050,35,047,"New Mexico","San Miguel County",4,73,378,181,197
050,35,047,"New Mexico","San Miguel County",4,74,357,166,191
050,35,047,"New Mexico","San Miguel County",4,75,379,179,200
050,35,047,"New Mexico","San Miguel County",4,76,262,122,140
050,35,047,"New Mexico","San Miguel County",4,77,235,108,127
050,35,047,"New Mexico","San Miguel County",4,78,230,109,121
050,35,047,"New Mexico","San Miguel County",4,79,254,127,127
050,35,047,"New Mexico","San Miguel County",4,80,224,107,117
050,35,047,"New Mexico","San Miguel County",4,81,192,85,107
050,35,047,"New Mexico","San Miguel County",4,82,163,73,90
050,35,047,"New Mexico","San Miguel County",4,83,154,58,96
050,35,047,"New Mexico","San Miguel County",4,84,141,69,72
050,35,047,"New Mexico","San Miguel County",4,85,602,250,352
050,35,047,"New Mexico","San Miguel County",5,0,220,118,102
050,35,047,"New Mexico","San Miguel County",5,1,213,116,97
050,35,047,"New Mexico","San Miguel County",5,2,223,108,115
050,35,047,"New Mexico","San Miguel County",5,3,221,122,99
050,35,047,"New Mexico","San Miguel County",5,4,221,122,99
050,35,047,"New Mexico","San Miguel County",5,5,227,123,104
050,35,047,"New Mexico","San Miguel County",5,6,232,118,114
050,35,047,"New Mexico","San Miguel County",5,7,228,116,112
050,35,047,"New Mexico","San Miguel County",5,8,247,127,120
050,35,047,"New Mexico","San Miguel County",5,9,257,130,127
050,35,047,"New Mexico","San Miguel County",5,10,262,140,122
050,35,047,"New Mexico","San Miguel County",5,11,265,136,129
050,35,047,"New Mexico","San Miguel County",5,12,243,128,115
050,35,047,"New Mexico","San Miguel County",5,13,235,121,114
050,35,047,"New Mexico","San Miguel County",5,14,238,112,126
050,35,047,"New Mexico","San Miguel County",5,15,249,125,124
050,35,047,"New Mexico","San Miguel County",5,16,287,151,136
050,35,047,"New Mexico","San Miguel County",5,17,292,143,149
050,35,047,"New Mexico","San Miguel County",5,18,390,187,203
050,35,047,"New Mexico","San Miguel County",5,19,447,245,202
050,35,047,"New Mexico","San Miguel County",5,20,359,171,188
050,35,047,"New Mexico","San Miguel County",5,21,364,183,181
050,35,047,"New Mexico","San Miguel County",5,22,338,172,166
050,35,047,"New Mexico","San Miguel County",5,23,299,155,144
050,35,047,"New Mexico","San Miguel County",5,24,280,135,145
050,35,047,"New Mexico","San Miguel County",5,25,290,154,136
050,35,047,"New Mexico","San Miguel County",5,26,292,140,152
050,35,047,"New Mexico","San Miguel County",5,27,323,166,157
050,35,047,"New Mexico","San Miguel County",5,28,291,143,148
050,35,047,"New Mexico","San Miguel County",5,29,284,150,134
050,35,047,"New Mexico","San Miguel County",5,30,322,172,150
050,35,047,"New Mexico","San Miguel County",5,31,313,164,149
050,35,047,"New Mexico","San Miguel County",5,32,338,176,162
050,35,047,"New Mexico","San Miguel County",5,33,317,164,153
050,35,047,"New Mexico","San Miguel County",5,34,307,165,142
050,35,047,"New Mexico","San Miguel County",5,35,261,136,125
050,35,047,"New Mexico","San Miguel County",5,36,300,157,143
050,35,047,"New Mexico","San Miguel County",5,37,314,172,142
050,35,047,"New Mexico","San Miguel County",5,38,304,152,152
050,35,047,"New Mexico","San Miguel County",5,39,291,145,146
050,35,047,"New Mexico","San Miguel County",5,40,275,139,136
050,35,047,"New Mexico","San Miguel County",5,41,302,148,154
050,35,047,"New Mexico","San Miguel County",5,42,308,156,152
050,35,047,"New Mexico","San Miguel County",5,43,322,165,157
050,35,047,"New Mexico","San Miguel County",5,44,294,145,149
050,35,047,"New Mexico","San Miguel County",5,45,278,142,136
050,35,047,"New Mexico","San Miguel County",5,46,272,133,139
050,35,047,"New Mexico","San Miguel County",5,47,264,123,141
050,35,047,"New Mexico","San Miguel County",5,48,302,138,164
050,35,047,"New Mexico","San Miguel County",5,49,286,135,151
050,35,047,"New Mexico","San Miguel County",5,50,265,128,137
050,35,047,"New Mexico","San Miguel County",5,51,324,161,163
050,35,047,"New Mexico","San Miguel County",5,52,348,163,185
050,35,047,"New Mexico","San Miguel County",5,53,353,166,187
050,35,047,"New Mexico","San Miguel County",5,54,331,181,150
050,35,047,"New Mexico","San Miguel County",5,55,276,150,126
050,35,047,"New Mexico","San Miguel County",5,56,284,151,133
050,35,047,"New Mexico","San Miguel County",5,57,300,144,156
050,35,047,"New Mexico","San Miguel County",5,58,358,175,183
050,35,047,"New Mexico","San Miguel County",5,59,400,182,218
050,35,047,"New Mexico","San Miguel County",5,60,406,202,204
050,35,047,"New Mexico","San Miguel County",5,61,450,231,219
050,35,047,"New Mexico","San Miguel County",5,62,464,246,218
050,35,047,"New Mexico","San Miguel County",5,63,443,226,217
050,35,047,"New Mexico","San Miguel County",5,64,433,218,215
050,35,047,"New Mexico","San Miguel County",5,65,414,219,195
050,35,047,"New Mexico","San Miguel County",5,66,426,217,209
050,35,047,"New Mexico","San Miguel County",5,67,409,194,215
050,35,047,"New Mexico","San Miguel County",5,68,410,190,220
050,35,047,"New Mexico","San Miguel County",5,69,403,177,226
050,35,047,"New Mexico","San Miguel County",5,70,402,182,220
050,35,047,"New Mexico","San Miguel County",5,71,385,181,204
050,35,047,"New Mexico","San Miguel County",5,72,378,177,201
050,35,047,"New Mexico","San Miguel County",5,73,376,180,196
050,35,047,"New Mexico","San Miguel County",5,74,367,182,185
050,35,047,"New Mexico","San Miguel County",5,75,350,163,187
050,35,047,"New Mexico","San Miguel County",5,76,366,163,203
050,35,047,"New Mexico","San Miguel County",5,77,245,110,135
050,35,047,"New Mexico","San Miguel County",5,78,216,100,116
050,35,047,"New Mexico","San Miguel County",5,79,219,100,119
050,35,047,"New Mexico","San Miguel County",5,80,246,126,120
050,35,047,"New Mexico","San Miguel County",5,81,207,95,112
050,35,047,"New Mexico","San Miguel County",5,82,177,77,100
050,35,047,"New Mexico","San Miguel County",5,83,153,66,87
050,35,047,"New Mexico","San Miguel County",5,84,144,51,93
050,35,047,"New Mexico","San Miguel County",5,85,653,283,370
050,35,049,"New Mexico","Santa Fe County",1,0,1155,581,574
050,35,049,"New Mexico","Santa Fe County",1,1,1150,569,581
050,35,049,"New Mexico","Santa Fe County",1,2,1205,624,581
050,35,049,"New Mexico","Santa Fe County",1,3,1246,631,615
050,35,049,"New Mexico","Santa Fe County",1,4,1286,648,638
050,35,049,"New Mexico","Santa Fe County",1,5,1326,684,642
050,35,049,"New Mexico","Santa Fe County",1,6,1352,693,659
050,35,049,"New Mexico","Santa Fe County",1,7,1345,689,656
050,35,049,"New Mexico","Santa Fe County",1,8,1409,721,688
050,35,049,"New Mexico","Santa Fe County",1,9,1522,755,767
050,35,049,"New Mexico","Santa Fe County",1,10,1582,786,796
050,35,049,"New Mexico","Santa Fe County",1,11,1683,829,854
050,35,049,"New Mexico","Santa Fe County",1,12,1697,862,835
050,35,049,"New Mexico","Santa Fe County",1,13,1717,868,849
050,35,049,"New Mexico","Santa Fe County",1,14,1768,855,913
050,35,049,"New Mexico","Santa Fe County",1,15,1738,842,896
050,35,049,"New Mexico","Santa Fe County",1,16,1699,824,875
050,35,049,"New Mexico","Santa Fe County",1,17,1674,831,843
050,35,049,"New Mexico","Santa Fe County",1,18,1583,812,771
050,35,049,"New Mexico","Santa Fe County",1,19,1469,740,729
050,35,049,"New Mexico","Santa Fe County",1,20,1536,794,742
050,35,049,"New Mexico","Santa Fe County",1,21,1489,760,729
050,35,049,"New Mexico","Santa Fe County",1,22,1497,745,752
050,35,049,"New Mexico","Santa Fe County",1,23,1442,723,719
050,35,049,"New Mexico","Santa Fe County",1,24,1507,768,739
050,35,049,"New Mexico","Santa Fe County",1,25,1582,793,789
050,35,049,"New Mexico","Santa Fe County",1,26,1562,798,764
050,35,049,"New Mexico","Santa Fe County",1,27,1658,837,821
050,35,049,"New Mexico","Santa Fe County",1,28,1671,810,861
050,35,049,"New Mexico","Santa Fe County",1,29,1704,839,865
050,35,049,"New Mexico","Santa Fe County",1,30,1754,929,825
050,35,049,"New Mexico","Santa Fe County",1,31,1710,873,837
050,35,049,"New Mexico","Santa Fe County",1,32,1697,853,844
050,35,049,"New Mexico","Santa Fe County",1,33,1744,883,861
050,35,049,"New Mexico","Santa Fe County",1,34,1790,939,851
050,35,049,"New Mexico","Santa Fe County",1,35,1819,956,863
050,35,049,"New Mexico","Santa Fe County",1,36,1810,924,886
050,35,049,"New Mexico","Santa Fe County",1,37,1872,965,907
050,35,049,"New Mexico","Santa Fe County",1,38,1814,917,897
050,35,049,"New Mexico","Santa Fe County",1,39,1827,914,913
050,35,049,"New Mexico","Santa Fe County",1,40,1804,923,881
050,35,049,"New Mexico","Santa Fe County",1,41,1811,900,911
050,35,049,"New Mexico","Santa Fe County",1,42,1731,885,846
050,35,049,"New Mexico","Santa Fe County",1,43,1686,874,812
050,35,049,"New Mexico","Santa Fe County",1,44,1640,830,810
050,35,049,"New Mexico","Santa Fe County",1,45,1701,829,872
050,35,049,"New Mexico","Santa Fe County",1,46,1673,840,833
050,35,049,"New Mexico","Santa Fe County",1,47,1759,852,907
050,35,049,"New Mexico","Santa Fe County",1,48,1881,956,925
050,35,049,"New Mexico","Santa Fe County",1,49,1901,969,932
050,35,049,"New Mexico","Santa Fe County",1,50,1878,921,957
050,35,049,"New Mexico","Santa Fe County",1,51,1950,952,998
050,35,049,"New Mexico","Santa Fe County",1,52,1889,939,950
050,35,049,"New Mexico","Santa Fe County",1,53,1980,976,1004
050,35,049,"New Mexico","Santa Fe County",1,54,1985,961,1024
050,35,049,"New Mexico","Santa Fe County",1,55,2105,1030,1075
050,35,049,"New Mexico","Santa Fe County",1,56,2140,994,1146
050,35,049,"New Mexico","Santa Fe County",1,57,2269,1059,1210
050,35,049,"New Mexico","Santa Fe County",1,58,2456,1166,1290
050,35,049,"New Mexico","Santa Fe County",1,59,2433,1182,1251
050,35,049,"New Mexico","Santa Fe County",1,60,2512,1158,1354
050,35,049,"New Mexico","Santa Fe County",1,61,2406,1108,1298
050,35,049,"New Mexico","Santa Fe County",1,62,2517,1189,1328
050,35,049,"New Mexico","Santa Fe County",1,63,2550,1174,1376
050,35,049,"New Mexico","Santa Fe County",1,64,2577,1190,1387
050,35,049,"New Mexico","Santa Fe County",1,65,2625,1205,1420
050,35,049,"New Mexico","Santa Fe County",1,66,2630,1191,1439
050,35,049,"New Mexico","Santa Fe County",1,67,2734,1201,1533
050,35,049,"New Mexico","Santa Fe County",1,68,2856,1304,1552
050,35,049,"New Mexico","Santa Fe County",1,69,2724,1282,1442
050,35,049,"New Mexico","Santa Fe County",1,70,2742,1283,1459
050,35,049,"New Mexico","Santa Fe County",1,71,2671,1253,1418
050,35,049,"New Mexico","Santa Fe County",1,72,2585,1249,1336
050,35,049,"New Mexico","Santa Fe County",1,73,2472,1209,1263
050,35,049,"New Mexico","Santa Fe County",1,74,1849,878,971
050,35,049,"New Mexico","Santa Fe County",1,75,1759,844,915
050,35,049,"New Mexico","Santa Fe County",1,76,1666,786,880
050,35,049,"New Mexico","Santa Fe County",1,77,1610,734,876
050,35,049,"New Mexico","Santa Fe County",1,78,1282,584,698
050,35,049,"New Mexico","Santa Fe County",1,79,1102,509,593
050,35,049,"New Mexico","Santa Fe County",1,80,961,451,510
050,35,049,"New Mexico","Santa Fe County",1,81,897,412,485
050,35,049,"New Mexico","Santa Fe County",1,82,770,339,431
050,35,049,"New Mexico","Santa Fe County",1,83,686,330,356
050,35,049,"New Mexico","Santa Fe County",1,84,614,286,328
050,35,049,"New Mexico","Santa Fe County",1,85,3261,1231,2030
050,35,049,"New Mexico","Santa Fe County",2,0,1138,568,570
050,35,049,"New Mexico","Santa Fe County",2,1,1156,576,580
050,35,049,"New Mexico","Santa Fe County",2,2,1193,611,582
050,35,049,"New Mexico","Santa Fe County",2,3,1240,631,609
050,35,049,"New Mexico","Santa Fe County",2,4,1285,648,637
050,35,049,"New Mexico","Santa Fe County",2,5,1316,673,643
050,35,049,"New Mexico","Santa Fe County",2,6,1348,692,656
050,35,049,"New Mexico","Santa Fe County",2,7,1341,689,652
050,35,049,"New Mexico","Santa Fe County",2,8,1390,711,679
050,35,049,"New Mexico","Santa Fe County",2,9,1495,747,748
050,35,049,"New Mexico","Santa Fe County",2,10,1567,776,791
050,35,049,"New Mexico","Santa Fe County",2,11,1655,813,842
050,35,049,"New Mexico","Santa Fe County",2,12,1702,857,845
050,35,049,"New Mexico","Santa Fe County",2,13,1711,866,845
050,35,049,"New Mexico","Santa Fe County",2,14,1751,855,896
050,35,049,"New Mexico","Santa Fe County",2,15,1740,844,896
050,35,049,"New Mexico","Santa Fe County",2,16,1705,825,880
050,35,049,"New Mexico","Santa Fe County",2,17,1672,829,843
050,35,049,"New Mexico","Santa Fe County",2,18,1575,803,772
050,35,049,"New Mexico","Santa Fe County",2,19,1478,749,729
050,35,049,"New Mexico","Santa Fe County",2,20,1545,794,751
050,35,049,"New Mexico","Santa Fe County",2,21,1492,764,728
050,35,049,"New Mexico","Santa Fe County",2,22,1504,756,748
050,35,049,"New Mexico","Santa Fe County",2,23,1455,726,729
050,35,049,"New Mexico","Santa Fe County",2,24,1493,760,733
050,35,049,"New Mexico","Santa Fe County",2,25,1566,789,777
050,35,049,"New Mexico","Santa Fe County",2,26,1573,802,771
050,35,049,"New Mexico","Santa Fe County",2,27,1640,829,811
050,35,049,"New Mexico","Santa Fe County",2,28,1685,823,862
050,35,049,"New Mexico","Santa Fe County",2,29,1711,845,866
050,35,049,"New Mexico","Santa Fe County",2,30,1777,931,846
050,35,049,"New Mexico","Santa Fe County",2,31,1711,881,830
050,35,049,"New Mexico","Santa Fe County",2,32,1708,863,845
050,35,049,"New Mexico","Santa Fe County",2,33,1736,878,858
050,35,049,"New Mexico","Santa Fe County",2,34,1780,922,858
050,35,049,"New Mexico","Santa Fe County",2,35,1829,961,868
050,35,049,"New Mexico","Santa Fe County",2,36,1815,934,881
050,35,049,"New Mexico","Santa Fe County",2,37,1862,957,905
050,35,049,"New Mexico","Santa Fe County",2,38,1853,942,911
050,35,049,"New Mexico","Santa Fe County",2,39,1819,912,907
050,35,049,"New Mexico","Santa Fe County",2,40,1829,930,899
050,35,049,"New Mexico","Santa Fe County",2,41,1808,908,900
050,35,049,"New Mexico","Santa Fe County",2,42,1739,884,855
050,35,049,"New Mexico","Santa Fe County",2,43,1700,879,821
050,35,049,"New Mexico","Santa Fe County",2,44,1649,838,811
050,35,049,"New Mexico","Santa Fe County",2,45,1688,827,861
050,35,049,"New Mexico","Santa Fe County",2,46,1675,830,845
050,35,049,"New Mexico","Santa Fe County",2,47,1741,852,889
050,35,049,"New Mexico","Santa Fe County",2,48,1854,930,924
050,35,049,"New Mexico","Santa Fe County",2,49,1904,969,935
050,35,049,"New Mexico","Santa Fe County",2,50,1879,930,949
050,35,049,"New Mexico","Santa Fe County",2,51,1926,942,984
050,35,049,"New Mexico","Santa Fe County",2,52,1912,948,964
050,35,049,"New Mexico","Santa Fe County",2,53,1950,963,987
050,35,049,"New Mexico","Santa Fe County",2,54,1986,970,1016
050,35,049,"New Mexico","Santa Fe County",2,55,2083,1013,1070
050,35,049,"New Mexico","Santa Fe County",2,56,2139,1004,1135
050,35,049,"New Mexico","Santa Fe County",2,57,2243,1043,1200
050,35,049,"New Mexico","Santa Fe County",2,58,2417,1143,1274
050,35,049,"New Mexico","Santa Fe County",2,59,2446,1181,1265
050,35,049,"New Mexico","Santa Fe County",2,60,2499,1169,1330
050,35,049,"New Mexico","Santa Fe County",2,61,2435,1122,1313
050,35,049,"New Mexico","Santa Fe County",2,62,2492,1170,1322
050,35,049,"New Mexico","Santa Fe County",2,63,2569,1189,1380
050,35,049,"New Mexico","Santa Fe County",2,64,2569,1181,1388
050,35,049,"New Mexico","Santa Fe County",2,65,2619,1204,1415
050,35,049,"New Mexico","Santa Fe County",2,66,2642,1197,1445
050,35,049,"New Mexico","Santa Fe County",2,67,2705,1198,1507
050,35,049,"New Mexico","Santa Fe County",2,68,2818,1277,1541
050,35,049,"New Mexico","Santa Fe County",2,69,2772,1293,1479
050,35,049,"New Mexico","Santa Fe County",2,70,2727,1276,1451
050,35,049,"New Mexico","Santa Fe County",2,71,2689,1265,1424
050,35,049,"New Mexico","Santa Fe County",2,72,2568,1230,1338
050,35,049,"New Mexico","Santa Fe County",2,73,2605,1268,1337
050,35,049,"New Mexico","Santa Fe County",2,74,1892,906,986
050,35,049,"New Mexico","Santa Fe County",2,75,1786,854,932
050,35,049,"New Mexico","Santa Fe County",2,76,1658,790,868
050,35,049,"New Mexico","Santa Fe County",2,77,1654,760,894
050,35,049,"New Mexico","Santa Fe County",2,78,1326,601,725
050,35,049,"New Mexico","Santa Fe County",2,79,1132,517,615
050,35,049,"New Mexico","Santa Fe County",2,80,989,463,526
050,35,049,"New Mexico","Santa Fe County",2,81,900,414,486
050,35,049,"New Mexico","Santa Fe County",2,82,798,355,443
050,35,049,"New Mexico","Santa Fe County",2,83,696,329,367
050,35,049,"New Mexico","Santa Fe County",2,84,619,298,321
050,35,049,"New Mexico","Santa Fe County",2,85,3304,1256,2048
050,35,049,"New Mexico","Santa Fe County",3,0,1133,582,551
050,35,049,"New Mexico","Santa Fe County",3,1,1131,585,546
050,35,049,"New Mexico","Santa Fe County",3,2,1140,563,577
050,35,049,"New Mexico","Santa Fe County",3,3,1210,625,585
050,35,049,"New Mexico","Santa Fe County",3,4,1202,614,588
050,35,049,"New Mexico","Santa Fe County",3,5,1276,658,618
050,35,049,"New Mexico","Santa Fe County",3,6,1309,666,643
050,35,049,"New Mexico","Santa Fe County",3,7,1326,690,636
050,35,049,"New Mexico","Santa Fe County",3,8,1354,701,653
050,35,049,"New Mexico","Santa Fe County",3,9,1382,704,678
050,35,049,"New Mexico","Santa Fe County",3,10,1465,735,730
050,35,049,"New Mexico","Santa Fe County",3,11,1529,771,758
050,35,049,"New Mexico","Santa Fe County",3,12,1612,802,810
050,35,049,"New Mexico","Santa Fe County",3,13,1653,832,821
050,35,049,"New Mexico","Santa Fe County",3,14,1691,858,833
050,35,049,"New Mexico","Santa Fe County",3,15,1734,844,890
050,35,049,"New Mexico","Santa Fe County",3,16,1755,854,901
050,35,049,"New Mexico","Santa Fe County",3,17,1688,825,863
050,35,049,"New Mexico","Santa Fe County",3,18,1585,793,792
050,35,049,"New Mexico","Santa Fe County",3,19,1468,766,702
050,35,049,"New Mexico","Santa Fe County",3,20,1550,785,765
050,35,049,"New Mexico","Santa Fe County",3,21,1547,804,743
050,35,049,"New Mexico","Santa Fe County",3,22,1524,807,717
050,35,049,"New Mexico","Santa Fe County",3,23,1479,750,729
050,35,049,"New Mexico","Santa Fe County",3,24,1469,743,726
050,35,049,"New Mexico","Santa Fe County",3,25,1549,789,760
050,35,049,"New Mexico","Santa Fe County",3,26,1566,802,764
050,35,049,"New Mexico","Santa Fe County",3,27,1620,824,796
050,35,049,"New Mexico","Santa Fe County",3,28,1676,843,833
050,35,049,"New Mexico","Santa Fe County",3,29,1692,840,852
050,35,049,"New Mexico","Santa Fe County",3,30,1804,904,900
050,35,049,"New Mexico","Santa Fe County",3,31,1774,913,861
050,35,049,"New Mexico","Santa Fe County",3,32,1781,915,866
050,35,049,"New Mexico","Santa Fe County",3,33,1716,854,862
050,35,049,"New Mexico","Santa Fe County",3,34,1765,907,858
050,35,049,"New Mexico","Santa Fe County",3,35,1849,961,888
050,35,049,"New Mexico","Santa Fe County",3,36,1873,979,894
050,35,049,"New Mexico","Santa Fe County",3,37,1848,932,916
050,35,049,"New Mexico","Santa Fe County",3,38,1875,972,903
050,35,049,"New Mexico","Santa Fe County",3,39,1872,959,913
050,35,049,"New Mexico","Santa Fe County",3,40,1788,899,889
050,35,049,"New Mexico","Santa Fe County",3,41,1780,899,881
050,35,049,"New Mexico","Santa Fe County",3,42,1806,901,905
050,35,049,"New Mexico","Santa Fe County",3,43,1759,896,863
050,35,049,"New Mexico","Santa Fe County",3,44,1727,904,823
050,35,049,"New Mexico","Santa Fe County",3,45,1653,839,814
050,35,049,"New Mexico","Santa Fe County",3,46,1697,829,868
050,35,049,"New Mexico","Santa Fe County",3,47,1677,847,830
050,35,049,"New Mexico","Santa Fe County",3,48,1724,843,881
050,35,049,"New Mexico","Santa Fe County",3,49,1813,902,911
050,35,049,"New Mexico","Santa Fe County",3,50,1899,971,928
050,35,049,"New Mexico","Santa Fe County",3,51,1913,953,960
050,35,049,"New Mexico","Santa Fe County",3,52,1900,927,973
050,35,049,"New Mexico","Santa Fe County",3,53,1938,964,974
050,35,049,"New Mexico","Santa Fe County",3,54,1987,990,997
050,35,049,"New Mexico","Santa Fe County",3,55,2016,981,1035
050,35,049,"New Mexico","Santa Fe County",3,56,2095,1012,1083
050,35,049,"New Mexico","Santa Fe County",3,57,2161,1012,1149
050,35,049,"New Mexico","Santa Fe County",3,58,2220,1022,1198
050,35,049,"New Mexico","Santa Fe County",3,59,2422,1149,1273
050,35,049,"New Mexico","Santa Fe County",3,60,2458,1196,1262
050,35,049,"New Mexico","Santa Fe County",3,61,2514,1171,1343
050,35,049,"New Mexico","Santa Fe County",3,62,2440,1125,1315
050,35,049,"New Mexico","Santa Fe County",3,63,2533,1167,1366
050,35,049,"New Mexico","Santa Fe County",3,64,2612,1194,1418
050,35,049,"New Mexico","Santa Fe County",3,65,2584,1203,1381
050,35,049,"New Mexico","Santa Fe County",3,66,2597,1183,1414
050,35,049,"New Mexico","Santa Fe County",3,67,2648,1207,1441
050,35,049,"New Mexico","Santa Fe County",3,68,2714,1206,1508
050,35,049,"New Mexico","Santa Fe County",3,69,2793,1265,1528
050,35,049,"New Mexico","Santa Fe County",3,70,2742,1265,1477
050,35,049,"New Mexico","Santa Fe County",3,71,2715,1279,1436
050,35,049,"New Mexico","Santa Fe County",3,72,2649,1249,1400
050,35,049,"New Mexico","Santa Fe County",3,73,2535,1219,1316
050,35,049,"New Mexico","Santa Fe County",3,74,2576,1261,1315
050,35,049,"New Mexico","Santa Fe County",3,75,1890,895,995
050,35,049,"New Mexico","Santa Fe County",3,76,1740,835,905
050,35,049,"New Mexico","Santa Fe County",3,77,1636,776,860
050,35,049,"New Mexico","Santa Fe County",3,78,1609,739,870
050,35,049,"New Mexico","Santa Fe County",3,79,1289,579,710
050,35,049,"New Mexico","Santa Fe County",3,80,1092,495,597
050,35,049,"New Mexico","Santa Fe County",3,81,944,439,505
050,35,049,"New Mexico","Santa Fe County",3,82,843,388,455
050,35,049,"New Mexico","Santa Fe County",3,83,757,331,426
050,35,049,"New Mexico","Santa Fe County",3,84,640,307,333
050,35,049,"New Mexico","Santa Fe County",3,85,3403,1325,2078
050,35,049,"New Mexico","Santa Fe County",4,0,1160,641,519
050,35,049,"New Mexico","Santa Fe County",4,1,1141,578,563
050,35,049,"New Mexico","Santa Fe County",4,2,1121,574,547
050,35,049,"New Mexico","Santa Fe County",4,3,1168,588,580
050,35,049,"New Mexico","Santa Fe County",4,4,1230,646,584
050,35,049,"New Mexico","Santa Fe County",4,5,1202,606,596
050,35,049,"New Mexico","Santa Fe County",4,6,1277,644,633
050,35,049,"New Mexico","Santa Fe County",4,7,1312,676,636
050,35,049,"New Mexico","Santa Fe County",4,8,1332,698,634
050,35,049,"New Mexico","Santa Fe County",4,9,1349,695,654
050,35,049,"New Mexico","Santa Fe County",4,10,1367,704,663
050,35,049,"New Mexico","Santa Fe County",4,11,1447,729,718
050,35,049,"New Mexico","Santa Fe County",4,12,1506,748,758
050,35,049,"New Mexico","Santa Fe County",4,13,1603,805,798
050,35,049,"New Mexico","Santa Fe County",4,14,1641,814,827
050,35,049,"New Mexico","Santa Fe County",4,15,1687,861,826
050,35,049,"New Mexico","Santa Fe County",4,16,1733,848,885
050,35,049,"New Mexico","Santa Fe County",4,17,1742,859,883
050,35,049,"New Mexico","Santa Fe County",4,18,1636,810,826
050,35,049,"New Mexico","Santa Fe County",4,19,1514,764,750
050,35,049,"New Mexico","Santa Fe County",4,20,1563,810,753
050,35,049,"New Mexico","Santa Fe County",4,21,1541,797,744
050,35,049,"New Mexico","Santa Fe County",4,22,1567,820,747
050,35,049,"New Mexico","Santa Fe County",4,23,1555,805,750
050,35,049,"New Mexico","Santa Fe County",4,24,1503,779,724
050,35,049,"New Mexico","Santa Fe County",4,25,1539,804,735
050,35,049,"New Mexico","Santa Fe County",4,26,1549,772,777
050,35,049,"New Mexico","Santa Fe County",4,27,1586,798,788
050,35,049,"New Mexico","Santa Fe County",4,28,1586,807,779
050,35,049,"New Mexico","Santa Fe County",4,29,1689,855,834
050,35,049,"New Mexico","Santa Fe County",4,30,1717,862,855
050,35,049,"New Mexico","Santa Fe County",4,31,1814,925,889
050,35,049,"New Mexico","Santa Fe County",4,32,1829,953,876
050,35,049,"New Mexico","Santa Fe County",4,33,1756,893,863
050,35,049,"New Mexico","Santa Fe County",4,34,1732,860,872
050,35,049,"New Mexico","Santa Fe County",4,35,1820,941,879
050,35,049,"New Mexico","Santa Fe County",4,36,1870,950,920
050,35,049,"New Mexico","Santa Fe County",4,37,1875,974,901
050,35,049,"New Mexico","Santa Fe County",4,38,1862,952,910
050,35,049,"New Mexico","Santa Fe County",4,39,1873,965,908
050,35,049,"New Mexico","Santa Fe County",4,40,1854,937,917
050,35,049,"New Mexico","Santa Fe County",4,41,1826,919,907
050,35,049,"New Mexico","Santa Fe County",4,42,1797,920,877
050,35,049,"New Mexico","Santa Fe County",4,43,1816,905,911
050,35,049,"New Mexico","Santa Fe County",4,44,1784,885,899
050,35,049,"New Mexico","Santa Fe County",4,45,1722,888,834
050,35,049,"New Mexico","Santa Fe County",4,46,1683,841,842
050,35,049,"New Mexico","Santa Fe County",4,47,1707,846,861
050,35,049,"New Mexico","Santa Fe County",4,48,1693,855,838
050,35,049,"New Mexico","Santa Fe County",4,49,1716,834,882
050,35,049,"New Mexico","Santa Fe County",4,50,1813,895,918
050,35,049,"New Mexico","Santa Fe County",4,51,1931,982,949
050,35,049,"New Mexico","Santa Fe County",4,52,1952,968,984
050,35,049,"New Mexico","Santa Fe County",4,53,1881,919,962
050,35,049,"New Mexico","Santa Fe County",4,54,1953,982,971
050,35,049,"New Mexico","Santa Fe County",4,55,1989,988,1001
050,35,049,"New Mexico","Santa Fe County",4,56,1996,961,1035
050,35,049,"New Mexico","Santa Fe County",4,57,2101,1010,1091
050,35,049,"New Mexico","Santa Fe County",4,58,2179,1019,1160
050,35,049,"New Mexico","Santa Fe County",4,59,2252,1038,1214
050,35,049,"New Mexico","Santa Fe County",4,60,2438,1158,1280
050,35,049,"New Mexico","Santa Fe County",4,61,2431,1179,1252
050,35,049,"New Mexico","Santa Fe County",4,62,2507,1153,1354
050,35,049,"New Mexico","Santa Fe County",4,63,2428,1112,1316
050,35,049,"New Mexico","Santa Fe County",4,64,2560,1186,1374
050,35,049,"New Mexico","Santa Fe County",4,65,2615,1201,1414
050,35,049,"New Mexico","Santa Fe County",4,66,2545,1171,1374
050,35,049,"New Mexico","Santa Fe County",4,67,2597,1186,1411
050,35,049,"New Mexico","Santa Fe County",4,68,2618,1193,1425
050,35,049,"New Mexico","Santa Fe County",4,69,2668,1198,1470
050,35,049,"New Mexico","Santa Fe County",4,70,2792,1271,1521
050,35,049,"New Mexico","Santa Fe County",4,71,2729,1272,1457
050,35,049,"New Mexico","Santa Fe County",4,72,2649,1240,1409
050,35,049,"New Mexico","Santa Fe County",4,73,2626,1226,1400
050,35,049,"New Mexico","Santa Fe County",4,74,2501,1196,1305
050,35,049,"New Mexico","Santa Fe County",4,75,2500,1216,1284
050,35,049,"New Mexico","Santa Fe County",4,76,1823,861,962
050,35,049,"New Mexico","Santa Fe County",4,77,1719,826,893
050,35,049,"New Mexico","Santa Fe County",4,78,1581,749,832
050,35,049,"New Mexico","Santa Fe County",4,79,1549,707,842
050,35,049,"New Mexico","Santa Fe County",4,80,1229,546,683
050,35,049,"New Mexico","Santa Fe County",4,81,1048,473,575
050,35,049,"New Mexico","Santa Fe County",4,82,888,405,483
050,35,049,"New Mexico","Santa Fe County",4,83,820,378,442
050,35,049,"New Mexico","Santa Fe County",4,84,683,306,377
050,35,049,"New Mexico","Santa Fe County",4,85,3578,1415,2163
050,35,049,"New Mexico","Santa Fe County",5,0,1140,629,511
050,35,049,"New Mexico","Santa Fe County",5,1,1155,640,515
050,35,049,"New Mexico","Santa Fe County",5,2,1116,564,552
050,35,049,"New Mexico","Santa Fe County",5,3,1106,575,531
050,35,049,"New Mexico","Santa Fe County",5,4,1176,598,578
050,35,049,"New Mexico","Santa Fe County",5,5,1213,640,573
050,35,049,"New Mexico","Santa Fe County",5,6,1207,609,598
050,35,049,"New Mexico","Santa Fe County",5,7,1278,639,639
050,35,049,"New Mexico","Santa Fe County",5,8,1303,684,619
050,35,049,"New Mexico","Santa Fe County",5,9,1326,685,641
050,35,049,"New Mexico","Santa Fe County",5,10,1317,680,637
050,35,049,"New Mexico","Santa Fe County",5,11,1347,699,648
050,35,049,"New Mexico","Santa Fe County",5,12,1437,715,722
050,35,049,"New Mexico","Santa Fe County",5,13,1496,740,756
050,35,049,"New Mexico","Santa Fe County",5,14,1586,796,790
050,35,049,"New Mexico","Santa Fe County",5,15,1622,812,810
050,35,049,"New Mexico","Santa Fe County",5,16,1672,855,817
050,35,049,"New Mexico","Santa Fe County",5,17,1697,832,865
050,35,049,"New Mexico","Santa Fe County",5,18,1653,824,829
050,35,049,"New Mexico","Santa Fe County",5,19,1525,760,765
050,35,049,"New Mexico","Santa Fe County",5,20,1617,817,800
050,35,049,"New Mexico","Santa Fe County",5,21,1545,808,737
050,35,049,"New Mexico","Santa Fe County",5,22,1567,825,742
050,35,049,"New Mexico","Santa Fe County",5,23,1583,838,745
050,35,049,"New Mexico","Santa Fe County",5,24,1579,838,741
050,35,049,"New Mexico","Santa Fe County",5,25,1572,813,759
050,35,049,"New Mexico","Santa Fe County",5,26,1590,834,756
050,35,049,"New Mexico","Santa Fe County",5,27,1601,798,803
050,35,049,"New Mexico","Santa Fe County",5,28,1664,850,814
050,35,049,"New Mexico","Santa Fe County",5,29,1625,837,788
050,35,049,"New Mexico","Santa Fe County",5,30,1744,899,845
050,35,049,"New Mexico","Santa Fe County",5,31,1736,903,833
050,35,049,"New Mexico","Santa Fe County",5,32,1773,915,858
050,35,049,"New Mexico","Santa Fe County",5,33,1800,933,867
050,35,049,"New Mexico","Santa Fe County",5,34,1747,892,855
050,35,049,"New Mexico","Santa Fe County",5,35,1754,888,866
050,35,049,"New Mexico","Santa Fe County",5,36,1886,949,937
050,35,049,"New Mexico","Santa Fe County",5,37,1846,947,899
050,35,049,"New Mexico","Santa Fe County",5,38,1878,984,894
050,35,049,"New Mexico","Santa Fe County",5,39,1858,937,921
050,35,049,"New Mexico","Santa Fe County",5,40,1849,952,897
050,35,049,"New Mexico","Santa Fe County",5,41,1854,941,913
050,35,049,"New Mexico","Santa Fe County",5,42,1782,880,902
050,35,049,"New Mexico","Santa Fe County",5,43,1811,930,881
050,35,049,"New Mexico","Santa Fe County",5,44,1813,892,921
050,35,049,"New Mexico","Santa Fe County",5,45,1786,884,902
050,35,049,"New Mexico","Santa Fe County",5,46,1711,873,838
050,35,049,"New Mexico","Santa Fe County",5,47,1680,844,836
050,35,049,"New Mexico","Santa Fe County",5,48,1746,860,886
050,35,049,"New Mexico","Santa Fe County",5,49,1710,859,851
050,35,049,"New Mexico","Santa Fe County",5,50,1708,831,877
050,35,049,"New Mexico","Santa Fe County",5,51,1844,917,927
050,35,049,"New Mexico","Santa Fe County",5,52,1954,986,968
050,35,049,"New Mexico","Santa Fe County",5,53,1944,950,994
050,35,049,"New Mexico","Santa Fe County",5,54,1912,938,974
050,35,049,"New Mexico","Santa Fe County",5,55,1941,981,960
050,35,049,"New Mexico","Santa Fe County",5,56,1988,981,1007
050,35,049,"New Mexico","Santa Fe County",5,57,2003,961,1042
050,35,049,"New Mexico","Santa Fe County",5,58,2093,1006,1087
050,35,049,"New Mexico","Santa Fe County",5,59,2172,1001,1171
050,35,049,"New Mexico","Santa Fe County",5,60,2241,1041,1200
050,35,049,"New Mexico","Santa Fe County",5,61,2465,1159,1306
050,35,049,"New Mexico","Santa Fe County",5,62,2465,1202,1263
050,35,049,"New Mexico","Santa Fe County",5,63,2520,1168,1352
050,35,049,"New Mexico","Santa Fe County",5,64,2422,1104,1318
050,35,049,"New Mexico","Santa Fe County",5,65,2562,1208,1354
050,35,049,"New Mexico","Santa Fe County",5,66,2602,1182,1420
050,35,049,"New Mexico","Santa Fe County",5,67,2560,1160,1400
050,35,049,"New Mexico","Santa Fe County",5,68,2590,1180,1410
050,35,049,"New Mexico","Santa Fe County",5,69,2585,1179,1406
050,35,049,"New Mexico","Santa Fe County",5,70,2637,1178,1459
050,35,049,"New Mexico","Santa Fe County",5,71,2765,1284,1481
050,35,049,"New Mexico","Santa Fe County",5,72,2680,1241,1439
050,35,049,"New Mexico","Santa Fe County",5,73,2599,1215,1384
050,35,049,"New Mexico","Santa Fe County",5,74,2600,1229,1371
050,35,049,"New Mexico","Santa Fe County",5,75,2439,1156,1283
050,35,049,"New Mexico","Santa Fe County",5,76,2453,1196,1257
050,35,049,"New Mexico","Santa Fe County",5,77,1807,855,952
050,35,049,"New Mexico","Santa Fe County",5,78,1684,816,868
050,35,049,"New Mexico","Santa Fe County",5,79,1539,734,805
050,35,049,"New Mexico","Santa Fe County",5,80,1496,680,816
050,35,049,"New Mexico","Santa Fe County",5,81,1197,525,672
050,35,049,"New Mexico","Santa Fe County",5,82,981,446,535
050,35,049,"New Mexico","Santa Fe County",5,83,849,383,466
050,35,049,"New Mexico","Santa Fe County",5,84,765,354,411
050,35,049,"New Mexico","Santa Fe County",5,85,3815,1543,2272
050,35,051,"New Mexico","Sierra County",1,0,92,46,46
050,35,051,"New Mexico","Sierra County",1,1,106,50,56
050,35,051,"New Mexico","Sierra County",1,2,101,48,53
050,35,051,"New Mexico","Sierra County",1,3,100,51,49
050,35,051,"New Mexico","Sierra County",1,4,108,56,52
050,35,051,"New Mexico","Sierra County",1,5,115,61,54
050,35,051,"New Mexico","Sierra County",1,6,114,68,46
050,35,051,"New Mexico","Sierra County",1,7,95,50,45
050,35,051,"New Mexico","Sierra County",1,8,88,49,39
050,35,051,"New Mexico","Sierra County",1,9,94,48,46
050,35,051,"New Mexico","Sierra County",1,10,98,48,50
050,35,051,"New Mexico","Sierra County",1,11,109,54,55
050,35,051,"New Mexico","Sierra County",1,12,109,54,55
050,35,051,"New Mexico","Sierra County",1,13,107,45,62
050,35,051,"New Mexico","Sierra County",1,14,92,51,41
050,35,051,"New Mexico","Sierra County",1,15,106,56,50
050,35,051,"New Mexico","Sierra County",1,16,88,44,44
050,35,051,"New Mexico","Sierra County",1,17,91,58,33
050,35,051,"New Mexico","Sierra County",1,18,87,47,40
050,35,051,"New Mexico","Sierra County",1,19,76,39,37
050,35,051,"New Mexico","Sierra County",1,20,71,40,31
050,35,051,"New Mexico","Sierra County",1,21,86,48,38
050,35,051,"New Mexico","Sierra County",1,22,77,39,38
050,35,051,"New Mexico","Sierra County",1,23,91,54,37
050,35,051,"New Mexico","Sierra County",1,24,85,45,40
050,35,051,"New Mexico","Sierra County",1,25,77,43,34
050,35,051,"New Mexico","Sierra County",1,26,104,54,50
050,35,051,"New Mexico","Sierra County",1,27,103,53,50
050,35,051,"New Mexico","Sierra County",1,28,108,54,54
050,35,051,"New Mexico","Sierra County",1,29,87,44,43
050,35,051,"New Mexico","Sierra County",1,30,99,50,49
050,35,051,"New Mexico","Sierra County",1,31,93,48,45
050,35,051,"New Mexico","Sierra County",1,32,90,52,38
050,35,051,"New Mexico","Sierra County",1,33,97,51,46
050,35,051,"New Mexico","Sierra County",1,34,100,47,53
050,35,051,"New Mexico","Sierra County",1,35,91,48,43
050,35,051,"New Mexico","Sierra County",1,36,90,45,45
050,35,051,"New Mexico","Sierra County",1,37,101,46,55
050,35,051,"New Mexico","Sierra County",1,38,84,45,39
050,35,051,"New Mexico","Sierra County",1,39,100,54,46
050,35,051,"New Mexico","Sierra County",1,40,97,51,46
050,35,051,"New Mexico","Sierra County",1,41,88,40,48
050,35,051,"New Mexico","Sierra County",1,42,82,35,47
050,35,051,"New Mexico","Sierra County",1,43,85,42,43
050,35,051,"New Mexico","Sierra County",1,44,81,44,37
050,35,051,"New Mexico","Sierra County",1,45,95,45,50
050,35,051,"New Mexico","Sierra County",1,46,101,51,50
050,35,051,"New Mexico","Sierra County",1,47,110,58,52
050,35,051,"New Mexico","Sierra County",1,48,109,55,54
050,35,051,"New Mexico","Sierra County",1,49,98,44,54
050,35,051,"New Mexico","Sierra County",1,50,112,56,56
050,35,051,"New Mexico","Sierra County",1,51,118,56,62
050,35,051,"New Mexico","Sierra County",1,52,133,66,67
050,35,051,"New Mexico","Sierra County",1,53,152,74,78
050,35,051,"New Mexico","Sierra County",1,54,126,54,72
050,35,051,"New Mexico","Sierra County",1,55,144,64,80
050,35,051,"New Mexico","Sierra County",1,56,164,76,88
050,35,051,"New Mexico","Sierra County",1,57,166,82,84
050,35,051,"New Mexico","Sierra County",1,58,163,78,85
050,35,051,"New Mexico","Sierra County",1,59,170,86,84
050,35,051,"New Mexico","Sierra County",1,60,187,88,99
050,35,051,"New Mexico","Sierra County",1,61,190,81,109
050,35,051,"New Mexico","Sierra County",1,62,212,98,114
050,35,051,"New Mexico","Sierra County",1,63,195,89,106
050,35,051,"New Mexico","Sierra County",1,64,208,107,101
050,35,051,"New Mexico","Sierra County",1,65,212,104,108
050,35,051,"New Mexico","Sierra County",1,66,260,129,131
050,35,051,"New Mexico","Sierra County",1,67,249,127,122
050,35,051,"New Mexico","Sierra County",1,68,235,119,116
050,35,051,"New Mexico","Sierra County",1,69,259,136,123
050,35,051,"New Mexico","Sierra County",1,70,255,127,128
050,35,051,"New Mexico","Sierra County",1,71,252,124,128
050,35,051,"New Mexico","Sierra County",1,72,271,133,138
050,35,051,"New Mexico","Sierra County",1,73,273,125,148
050,35,051,"New Mexico","Sierra County",1,74,170,77,93
050,35,051,"New Mexico","Sierra County",1,75,185,106,79
050,35,051,"New Mexico","Sierra County",1,76,193,112,81
050,35,051,"New Mexico","Sierra County",1,77,187,98,89
050,35,051,"New Mexico","Sierra County",1,78,159,81,78
050,35,051,"New Mexico","Sierra County",1,79,159,84,75
050,35,051,"New Mexico","Sierra County",1,80,139,77,62
050,35,051,"New Mexico","Sierra County",1,81,131,66,65
050,35,051,"New Mexico","Sierra County",1,82,121,59,62
050,35,051,"New Mexico","Sierra County",1,83,99,48,51
050,35,051,"New Mexico","Sierra County",1,84,102,59,43
050,35,051,"New Mexico","Sierra County",1,85,466,229,237
050,35,051,"New Mexico","Sierra County",2,0,98,46,52
050,35,051,"New Mexico","Sierra County",2,1,102,49,53
050,35,051,"New Mexico","Sierra County",2,2,100,48,52
050,35,051,"New Mexico","Sierra County",2,3,99,51,48
050,35,051,"New Mexico","Sierra County",2,4,103,54,49
050,35,051,"New Mexico","Sierra County",2,5,114,60,54
050,35,051,"New Mexico","Sierra County",2,6,114,65,49
050,35,051,"New Mexico","Sierra County",2,7,98,54,44
050,35,051,"New Mexico","Sierra County",2,8,91,51,40
050,35,051,"New Mexico","Sierra County",2,9,92,48,44
050,35,051,"New Mexico","Sierra County",2,10,100,49,51
050,35,051,"New Mexico","Sierra County",2,11,104,52,52
050,35,051,"New Mexico","Sierra County",2,12,110,54,56
050,35,051,"New Mexico","Sierra County",2,13,106,46,60
050,35,051,"New Mexico","Sierra County",2,14,97,51,46
050,35,051,"New Mexico","Sierra County",2,15,100,54,46
050,35,051,"New Mexico","Sierra County",2,16,91,46,45
050,35,051,"New Mexico","Sierra County",2,17,92,57,35
050,35,051,"New Mexico","Sierra County",2,18,86,48,38
050,35,051,"New Mexico","Sierra County",2,19,75,39,36
050,35,051,"New Mexico","Sierra County",2,20,75,42,33
050,35,051,"New Mexico","Sierra County",2,21,82,44,38
050,35,051,"New Mexico","Sierra County",2,22,79,42,37
050,35,051,"New Mexico","Sierra County",2,23,87,50,37
050,35,051,"New Mexico","Sierra County",2,24,84,47,37
050,35,051,"New Mexico","Sierra County",2,25,80,45,35
050,35,051,"New Mexico","Sierra County",2,26,97,49,48
050,35,051,"New Mexico","Sierra County",2,27,105,54,51
050,35,051,"New Mexico","Sierra County",2,28,106,54,52
050,35,051,"New Mexico","Sierra County",2,29,94,47,47
050,35,051,"New Mexico","Sierra County",2,30,95,48,47
050,35,051,"New Mexico","Sierra County",2,31,92,47,45
050,35,051,"New Mexico","Sierra County",2,32,91,51,40
050,35,051,"New Mexico","Sierra County",2,33,96,51,45
050,35,051,"New Mexico","Sierra County",2,34,101,49,52
050,35,051,"New Mexico","Sierra County",2,35,93,48,45
050,35,051,"New Mexico","Sierra County",2,36,90,47,43
050,35,051,"New Mexico","Sierra County",2,37,99,47,52
050,35,051,"New Mexico","Sierra County",2,38,90,46,44
050,35,051,"New Mexico","Sierra County",2,39,95,52,43
050,35,051,"New Mexico","Sierra County",2,40,100,53,47
050,35,051,"New Mexico","Sierra County",2,41,90,42,48
050,35,051,"New Mexico","Sierra County",2,42,85,37,48
050,35,051,"New Mexico","Sierra County",2,43,85,42,43
050,35,051,"New Mexico","Sierra County",2,44,83,44,39
050,35,051,"New Mexico","Sierra County",2,45,92,44,48
050,35,051,"New Mexico","Sierra County",2,46,99,49,50
050,35,051,"New Mexico","Sierra County",2,47,107,55,52
050,35,051,"New Mexico","Sierra County",2,48,109,56,53
050,35,051,"New Mexico","Sierra County",2,49,103,48,55
050,35,051,"New Mexico","Sierra County",2,50,109,53,56
050,35,051,"New Mexico","Sierra County",2,51,117,56,61
050,35,051,"New Mexico","Sierra County",2,52,130,64,66
050,35,051,"New Mexico","Sierra County",2,53,149,73,76
050,35,051,"New Mexico","Sierra County",2,54,133,59,74
050,35,051,"New Mexico","Sierra County",2,55,142,63,79
050,35,051,"New Mexico","Sierra County",2,56,162,75,87
050,35,051,"New Mexico","Sierra County",2,57,163,79,84
050,35,051,"New Mexico","Sierra County",2,58,163,79,84
050,35,051,"New Mexico","Sierra County",2,59,167,83,84
050,35,051,"New Mexico","Sierra County",2,60,183,88,95
050,35,051,"New Mexico","Sierra County",2,61,190,84,106
050,35,051,"New Mexico","Sierra County",2,62,208,95,113
050,35,051,"New Mexico","Sierra County",2,63,201,93,108
050,35,051,"New Mexico","Sierra County",2,64,203,103,100
050,35,051,"New Mexico","Sierra County",2,65,217,110,107
050,35,051,"New Mexico","Sierra County",2,66,244,123,121
050,35,051,"New Mexico","Sierra County",2,67,254,129,125
050,35,051,"New Mexico","Sierra County",2,68,237,120,117
050,35,051,"New Mexico","Sierra County",2,69,254,132,122
050,35,051,"New Mexico","Sierra County",2,70,254,129,125
050,35,051,"New Mexico","Sierra County",2,71,253,124,129
050,35,051,"New Mexico","Sierra County",2,72,261,127,134
050,35,051,"New Mexico","Sierra County",2,73,283,132,151
050,35,051,"New Mexico","Sierra County",2,74,183,82,101
050,35,051,"New Mexico","Sierra County",2,75,182,101,81
050,35,051,"New Mexico","Sierra County",2,76,188,107,81
050,35,051,"New Mexico","Sierra County",2,77,188,100,88
050,35,051,"New Mexico","Sierra County",2,78,164,84,80
050,35,051,"New Mexico","Sierra County",2,79,156,83,73
050,35,051,"New Mexico","Sierra County",2,80,142,78,64
050,35,051,"New Mexico","Sierra County",2,81,130,66,64
050,35,051,"New Mexico","Sierra County",2,82,125,62,63
050,35,051,"New Mexico","Sierra County",2,83,100,48,52
050,35,051,"New Mexico","Sierra County",2,84,100,56,44
050,35,051,"New Mexico","Sierra County",2,85,471,235,236
050,35,051,"New Mexico","Sierra County",3,0,74,37,37
050,35,051,"New Mexico","Sierra County",3,1,94,42,52
050,35,051,"New Mexico","Sierra County",3,2,103,52,51
050,35,051,"New Mexico","Sierra County",3,3,98,46,52
050,35,051,"New Mexico","Sierra County",3,4,103,51,52
050,35,051,"New Mexico","Sierra County",3,5,98,59,39
050,35,051,"New Mexico","Sierra County",3,6,117,64,53
050,35,051,"New Mexico","Sierra County",3,7,116,68,48
050,35,051,"New Mexico","Sierra County",3,8,97,54,43
050,35,051,"New Mexico","Sierra County",3,9,85,49,36
050,35,051,"New Mexico","Sierra County",3,10,99,52,47
050,35,051,"New Mexico","Sierra County",3,11,102,50,52
050,35,051,"New Mexico","Sierra County",3,12,100,53,47
050,35,051,"New Mexico","Sierra County",3,13,115,56,59
050,35,051,"New Mexico","Sierra County",3,14,115,52,63
050,35,051,"New Mexico","Sierra County",3,15,100,49,51
050,35,051,"New Mexico","Sierra County",3,16,100,52,48
050,35,051,"New Mexico","Sierra County",3,17,94,45,49
050,35,051,"New Mexico","Sierra County",3,18,87,52,35
050,35,051,"New Mexico","Sierra County",3,19,81,44,37
050,35,051,"New Mexico","Sierra County",3,20,81,44,37
050,35,051,"New Mexico","Sierra County",3,21,78,42,36
050,35,051,"New Mexico","Sierra County",3,22,91,48,43
050,35,051,"New Mexico","Sierra County",3,23,69,37,32
050,35,051,"New Mexico","Sierra County",3,24,88,51,37
050,35,051,"New Mexico","Sierra County",3,25,93,49,44
050,35,051,"New Mexico","Sierra County",3,26,84,46,38
050,35,051,"New Mexico","Sierra County",3,27,104,50,54
050,35,051,"New Mexico","Sierra County",3,28,102,53,49
050,35,051,"New Mexico","Sierra County",3,29,107,52,55
050,35,051,"New Mexico","Sierra County",3,30,95,49,46
050,35,051,"New Mexico","Sierra County",3,31,100,50,50
050,35,051,"New Mexico","Sierra County",3,32,85,44,41
050,35,051,"New Mexico","Sierra County",3,33,88,47,41
050,35,051,"New Mexico","Sierra County",3,34,93,51,42
050,35,051,"New Mexico","Sierra County",3,35,107,49,58
050,35,051,"New Mexico","Sierra County",3,36,88,48,40
050,35,051,"New Mexico","Sierra County",3,37,101,48,53
050,35,051,"New Mexico","Sierra County",3,38,99,48,51
050,35,051,"New Mexico","Sierra County",3,39,81,40,41
050,35,051,"New Mexico","Sierra County",3,40,101,56,45
050,35,051,"New Mexico","Sierra County",3,41,104,55,49
050,35,051,"New Mexico","Sierra County",3,42,88,42,46
050,35,051,"New Mexico","Sierra County",3,43,94,40,54
050,35,051,"New Mexico","Sierra County",3,44,89,47,42
050,35,051,"New Mexico","Sierra County",3,45,86,41,45
050,35,051,"New Mexico","Sierra County",3,46,96,43,53
050,35,051,"New Mexico","Sierra County",3,47,97,47,50
050,35,051,"New Mexico","Sierra County",3,48,101,49,52
050,35,051,"New Mexico","Sierra County",3,49,112,58,54
050,35,051,"New Mexico","Sierra County",3,50,102,51,51
050,35,051,"New Mexico","Sierra County",3,51,104,50,54
050,35,051,"New Mexico","Sierra County",3,52,124,60,64
050,35,051,"New Mexico","Sierra County",3,53,141,65,76
050,35,051,"New Mexico","Sierra County",3,54,149,73,76
050,35,051,"New Mexico","Sierra County",3,55,132,58,74
050,35,051,"New Mexico","Sierra County",3,56,141,65,76
050,35,051,"New Mexico","Sierra County",3,57,162,75,87
050,35,051,"New Mexico","Sierra County",3,58,164,81,83
050,35,051,"New Mexico","Sierra County",3,59,164,72,92
050,35,051,"New Mexico","Sierra County",3,60,166,78,88
050,35,051,"New Mexico","Sierra County",3,61,185,89,96
050,35,051,"New Mexico","Sierra County",3,62,210,91,119
050,35,051,"New Mexico","Sierra County",3,63,212,98,114
050,35,051,"New Mexico","Sierra County",3,64,202,95,107
050,35,051,"New Mexico","Sierra County",3,65,207,108,99
050,35,051,"New Mexico","Sierra County",3,66,216,109,107
050,35,051,"New Mexico","Sierra County",3,67,246,122,124
050,35,051,"New Mexico","Sierra County",3,68,246,120,126
050,35,051,"New Mexico","Sierra County",3,69,241,126,115
050,35,051,"New Mexico","Sierra County",3,70,254,128,126
050,35,051,"New Mexico","Sierra County",3,71,242,127,115
050,35,051,"New Mexico","Sierra County",3,72,249,120,129
050,35,051,"New Mexico","Sierra County",3,73,254,123,131
050,35,051,"New Mexico","Sierra County",3,74,277,128,149
050,35,051,"New Mexico","Sierra County",3,75,168,76,92
050,35,051,"New Mexico","Sierra County",3,76,186,101,85
050,35,051,"New Mexico","Sierra County",3,77,170,95,75
050,35,051,"New Mexico","Sierra County",3,78,179,98,81
050,35,051,"New Mexico","Sierra County",3,79,153,76,77
050,35,051,"New Mexico","Sierra County",3,80,140,72,68
050,35,051,"New Mexico","Sierra County",3,81,130,71,59
050,35,051,"New Mexico","Sierra County",3,82,119,65,54
050,35,051,"New Mexico","Sierra County",3,83,123,61,62
050,35,051,"New Mexico","Sierra County",3,84,93,43,50
050,35,051,"New Mexico","Sierra County",3,85,488,248,240
050,35,051,"New Mexico","Sierra County",4,0,68,35,33
050,35,051,"New Mexico","Sierra County",4,1,74,37,37
050,35,051,"New Mexico","Sierra County",4,2,91,42,49
050,35,051,"New Mexico","Sierra County",4,3,101,44,57
050,35,051,"New Mexico","Sierra County",4,4,98,48,50
050,35,051,"New Mexico","Sierra County",4,5,110,55,55
050,35,051,"New Mexico","Sierra County",4,6,101,54,47
050,35,051,"New Mexico","Sierra County",4,7,115,61,54
050,35,051,"New Mexico","Sierra County",4,8,124,72,52
050,35,051,"New Mexico","Sierra County",4,9,96,53,43
050,35,051,"New Mexico","Sierra County",4,10,97,58,39
050,35,051,"New Mexico","Sierra County",4,11,91,46,45
050,35,051,"New Mexico","Sierra County",4,12,114,55,59
050,35,051,"New Mexico","Sierra County",4,13,98,54,44
050,35,051,"New Mexico","Sierra County",4,14,118,61,57
050,35,051,"New Mexico","Sierra County",4,15,117,49,68
050,35,051,"New Mexico","Sierra County",4,16,108,52,56
050,35,051,"New Mexico","Sierra County",4,17,104,51,53
050,35,051,"New Mexico","Sierra County",4,18,88,45,43
050,35,051,"New Mexico","Sierra County",4,19,65,38,27
050,35,051,"New Mexico","Sierra County",4,20,86,48,38
050,35,051,"New Mexico","Sierra County",4,21,73,36,37
050,35,051,"New Mexico","Sierra County",4,22,80,42,38
050,35,051,"New Mexico","Sierra County",4,23,92,50,42
050,35,051,"New Mexico","Sierra County",4,24,66,37,29
050,35,051,"New Mexico","Sierra County",4,25,87,50,37
050,35,051,"New Mexico","Sierra County",4,26,88,50,38
050,35,051,"New Mexico","Sierra County",4,27,89,49,40
050,35,051,"New Mexico","Sierra County",4,28,93,44,49
050,35,051,"New Mexico","Sierra County",4,29,99,50,49
050,35,051,"New Mexico","Sierra County",4,30,105,46,59
050,35,051,"New Mexico","Sierra County",4,31,96,45,51
050,35,051,"New Mexico","Sierra County",4,32,103,48,55
050,35,051,"New Mexico","Sierra County",4,33,99,53,46
050,35,051,"New Mexico","Sierra County",4,34,98,52,46
050,35,051,"New Mexico","Sierra County",4,35,100,57,43
050,35,051,"New Mexico","Sierra County",4,36,104,47,57
050,35,051,"New Mexico","Sierra County",4,37,93,51,42
050,35,051,"New Mexico","Sierra County",4,38,103,54,49
050,35,051,"New Mexico","Sierra County",4,39,104,52,52
050,35,051,"New Mexico","Sierra County",4,40,82,38,44
050,35,051,"New Mexico","Sierra County",4,41,103,59,44
050,35,051,"New Mexico","Sierra County",4,42,108,57,51
050,35,051,"New Mexico","Sierra County",4,43,97,47,50
050,35,051,"New Mexico","Sierra County",4,44,96,41,55
050,35,051,"New Mexico","Sierra County",4,45,91,44,47
050,35,051,"New Mexico","Sierra County",4,46,82,35,47
050,35,051,"New Mexico","Sierra County",4,47,101,44,57
050,35,051,"New Mexico","Sierra County",4,48,107,54,53
050,35,051,"New Mexico","Sierra County",4,49,108,49,59
050,35,051,"New Mexico","Sierra County",4,50,117,57,60
050,35,051,"New Mexico","Sierra County",4,51,100,51,49
050,35,051,"New Mexico","Sierra County",4,52,120,58,62
050,35,051,"New Mexico","Sierra County",4,53,124,60,64
050,35,051,"New Mexico","Sierra County",4,54,137,59,78
050,35,051,"New Mexico","Sierra County",4,55,133,67,66
050,35,051,"New Mexico","Sierra County",4,56,136,64,72
050,35,051,"New Mexico","Sierra County",4,57,140,64,76
050,35,051,"New Mexico","Sierra County",4,58,163,81,82
050,35,051,"New Mexico","Sierra County",4,59,163,77,86
050,35,051,"New Mexico","Sierra County",4,60,157,63,94
050,35,051,"New Mexico","Sierra County",4,61,180,86,94
050,35,051,"New Mexico","Sierra County",4,62,184,87,97
050,35,051,"New Mexico","Sierra County",4,63,217,95,122
050,35,051,"New Mexico","Sierra County",4,64,217,98,119
050,35,051,"New Mexico","Sierra County",4,65,202,97,105
050,35,051,"New Mexico","Sierra County",4,66,224,117,107
050,35,051,"New Mexico","Sierra County",4,67,217,111,106
050,35,051,"New Mexico","Sierra County",4,68,237,116,121
050,35,051,"New Mexico","Sierra County",4,69,241,121,120
050,35,051,"New Mexico","Sierra County",4,70,234,122,112
050,35,051,"New Mexico","Sierra County",4,71,257,136,121
050,35,051,"New Mexico","Sierra County",4,72,240,131,109
050,35,051,"New Mexico","Sierra County",4,73,242,111,131
050,35,051,"New Mexico","Sierra County",4,74,251,115,136
050,35,051,"New Mexico","Sierra County",4,75,251,115,136
050,35,051,"New Mexico","Sierra County",4,76,161,68,93
050,35,051,"New Mexico","Sierra County",4,77,175,94,81
050,35,051,"New Mexico","Sierra County",4,78,157,96,61
050,35,051,"New Mexico","Sierra County",4,79,173,92,81
050,35,051,"New Mexico","Sierra County",4,80,144,74,70
050,35,051,"New Mexico","Sierra County",4,81,128,65,63
050,35,051,"New Mexico","Sierra County",4,82,125,70,55
050,35,051,"New Mexico","Sierra County",4,83,108,56,52
050,35,051,"New Mexico","Sierra County",4,84,118,59,59
050,35,051,"New Mexico","Sierra County",4,85,490,245,245
050,35,051,"New Mexico","Sierra County",5,0,66,34,32
050,35,051,"New Mexico","Sierra County",5,1,67,32,35
050,35,051,"New Mexico","Sierra County",5,2,75,39,36
050,35,051,"New Mexico","Sierra County",5,3,92,42,50
050,35,051,"New Mexico","Sierra County",5,4,108,50,58
050,35,051,"New Mexico","Sierra County",5,5,103,53,50
050,35,051,"New Mexico","Sierra County",5,6,103,51,52
050,35,051,"New Mexico","Sierra County",5,7,112,59,53
050,35,051,"New Mexico","Sierra County",5,8,127,65,62
050,35,051,"New Mexico","Sierra County",5,9,133,77,56
050,35,051,"New Mexico","Sierra County",5,10,94,55,39
050,35,051,"New Mexico","Sierra County",5,11,102,60,42
050,35,051,"New Mexico","Sierra County",5,12,93,48,45
050,35,051,"New Mexico","Sierra County",5,13,114,54,60
050,35,051,"New Mexico","Sierra County",5,14,110,62,48
050,35,051,"New Mexico","Sierra County",5,15,114,60,54
050,35,051,"New Mexico","Sierra County",5,16,120,53,67
050,35,051,"New Mexico","Sierra County",5,17,112,54,58
050,35,051,"New Mexico","Sierra County",5,18,93,47,46
050,35,051,"New Mexico","Sierra County",5,19,71,36,35
050,35,051,"New Mexico","Sierra County",5,20,74,44,30
050,35,051,"New Mexico","Sierra County",5,21,87,47,40
050,35,051,"New Mexico","Sierra County",5,22,72,36,36
050,35,051,"New Mexico","Sierra County",5,23,81,45,36
050,35,051,"New Mexico","Sierra County",5,24,88,52,36
050,35,051,"New Mexico","Sierra County",5,25,71,41,30
050,35,051,"New Mexico","Sierra County",5,26,88,50,38
050,35,051,"New Mexico","Sierra County",5,27,97,53,44
050,35,051,"New Mexico","Sierra County",5,28,81,42,39
050,35,051,"New Mexico","Sierra County",5,29,88,42,46
050,35,051,"New Mexico","Sierra County",5,30,101,52,49
050,35,051,"New Mexico","Sierra County",5,31,108,50,58
050,35,051,"New Mexico","Sierra County",5,32,110,55,55
050,35,051,"New Mexico","Sierra County",5,33,106,48,58
050,35,051,"New Mexico","Sierra County",5,34,102,54,48
050,35,051,"New Mexico","Sierra County",5,35,93,49,44
050,35,051,"New Mexico","Sierra County",5,36,105,57,48
050,35,051,"New Mexico","Sierra County",5,37,104,47,57
050,35,051,"New Mexico","Sierra County",5,38,90,52,38
050,35,051,"New Mexico","Sierra County",5,39,109,61,48
050,35,051,"New Mexico","Sierra County",5,40,111,52,59
050,35,051,"New Mexico","Sierra County",5,41,80,35,45
050,35,051,"New Mexico","Sierra County",5,42,104,60,44
050,35,051,"New Mexico","Sierra County",5,43,104,49,55
050,35,051,"New Mexico","Sierra County",5,44,97,49,48
050,35,051,"New Mexico","Sierra County",5,45,100,43,57
050,35,051,"New Mexico","Sierra County",5,46,97,49,48
050,35,051,"New Mexico","Sierra County",5,47,86,40,46
050,35,051,"New Mexico","Sierra County",5,48,104,45,59
050,35,051,"New Mexico","Sierra County",5,49,115,61,54
050,35,051,"New Mexico","Sierra County",5,50,110,51,59
050,35,051,"New Mexico","Sierra County",5,51,117,54,63
050,35,051,"New Mexico","Sierra County",5,52,107,54,53
050,35,051,"New Mexico","Sierra County",5,53,124,57,67
050,35,051,"New Mexico","Sierra County",5,54,126,59,67
050,35,051,"New Mexico","Sierra County",5,55,136,58,78
050,35,051,"New Mexico","Sierra County",5,56,139,73,66
050,35,051,"New Mexico","Sierra County",5,57,137,68,69
050,35,051,"New Mexico","Sierra County",5,58,145,62,83
050,35,051,"New Mexico","Sierra County",5,59,158,79,79
050,35,051,"New Mexico","Sierra County",5,60,161,72,89
050,35,051,"New Mexico","Sierra County",5,61,167,69,98
050,35,051,"New Mexico","Sierra County",5,62,166,78,88
050,35,051,"New Mexico","Sierra County",5,63,197,96,101
050,35,051,"New Mexico","Sierra County",5,64,211,90,121
050,35,051,"New Mexico","Sierra County",5,65,213,101,112
050,35,051,"New Mexico","Sierra County",5,66,212,103,109
050,35,051,"New Mexico","Sierra County",5,67,229,119,110
050,35,051,"New Mexico","Sierra County",5,68,210,105,105
050,35,051,"New Mexico","Sierra County",5,69,241,117,124
050,35,051,"New Mexico","Sierra County",5,70,239,116,123
050,35,051,"New Mexico","Sierra County",5,71,242,133,109
050,35,051,"New Mexico","Sierra County",5,72,251,132,119
050,35,051,"New Mexico","Sierra County",5,73,239,127,112
050,35,051,"New Mexico","Sierra County",5,74,235,104,131
050,35,051,"New Mexico","Sierra County",5,75,234,111,123
050,35,051,"New Mexico","Sierra County",5,76,239,110,129
050,35,051,"New Mexico","Sierra County",5,77,154,66,88
050,35,051,"New Mexico","Sierra County",5,78,163,87,76
050,35,051,"New Mexico","Sierra County",5,79,146,86,60
050,35,051,"New Mexico","Sierra County",5,80,164,86,78
050,35,051,"New Mexico","Sierra County",5,81,134,71,63
050,35,051,"New Mexico","Sierra County",5,82,124,64,60
050,35,051,"New Mexico","Sierra County",5,83,114,63,51
050,35,051,"New Mexico","Sierra County",5,84,108,56,52
050,35,051,"New Mexico","Sierra County",5,85,534,272,262
050,35,053,"New Mexico","Socorro County",1,0,183,93,90
050,35,053,"New Mexico","Socorro County",1,1,184,96,88
050,35,053,"New Mexico","Socorro County",1,2,184,100,84
050,35,053,"New Mexico","Socorro County",1,3,195,90,105
050,35,053,"New Mexico","Socorro County",1,4,208,98,110
050,35,053,"New Mexico","Socorro County",1,5,190,86,104
050,35,053,"New Mexico","Socorro County",1,6,189,94,95
050,35,053,"New Mexico","Socorro County",1,7,196,102,94
050,35,053,"New Mexico","Socorro County",1,8,208,108,100
050,35,053,"New Mexico","Socorro County",1,9,229,112,117
050,35,053,"New Mexico","Socorro County",1,10,211,96,115
050,35,053,"New Mexico","Socorro County",1,11,202,94,108
050,35,053,"New Mexico","Socorro County",1,12,211,101,110
050,35,053,"New Mexico","Socorro County",1,13,216,97,119
050,35,053,"New Mexico","Socorro County",1,14,224,115,109
050,35,053,"New Mexico","Socorro County",1,15,225,116,109
050,35,053,"New Mexico","Socorro County",1,16,204,106,98
050,35,053,"New Mexico","Socorro County",1,17,201,120,81
050,35,053,"New Mexico","Socorro County",1,18,313,174,139
050,35,053,"New Mexico","Socorro County",1,19,442,289,153
050,35,053,"New Mexico","Socorro County",1,20,337,213,124
050,35,053,"New Mexico","Socorro County",1,21,270,166,104
050,35,053,"New Mexico","Socorro County",1,22,240,133,107
050,35,053,"New Mexico","Socorro County",1,23,220,125,95
050,35,053,"New Mexico","Socorro County",1,24,186,100,86
050,35,053,"New Mexico","Socorro County",1,25,199,107,92
050,35,053,"New Mexico","Socorro County",1,26,177,98,79
050,35,053,"New Mexico","Socorro County",1,27,194,110,84
050,35,053,"New Mexico","Socorro County",1,28,193,104,89
050,35,053,"New Mexico","Socorro County",1,29,182,95,87
050,35,053,"New Mexico","Socorro County",1,30,185,84,101
050,35,053,"New Mexico","Socorro County",1,31,180,97,83
050,35,053,"New Mexico","Socorro County",1,32,180,99,81
050,35,053,"New Mexico","Socorro County",1,33,205,105,100
050,35,053,"New Mexico","Socorro County",1,34,188,95,93
050,35,053,"New Mexico","Socorro County",1,35,182,97,85
050,35,053,"New Mexico","Socorro County",1,36,188,95,93
050,35,053,"New Mexico","Socorro County",1,37,174,88,86
050,35,053,"New Mexico","Socorro County",1,38,156,89,67
050,35,053,"New Mexico","Socorro County",1,39,180,104,76
050,35,053,"New Mexico","Socorro County",1,40,185,97,88
050,35,053,"New Mexico","Socorro County",1,41,182,87,95
050,35,053,"New Mexico","Socorro County",1,42,161,88,73
050,35,053,"New Mexico","Socorro County",1,43,160,83,77
050,35,053,"New Mexico","Socorro County",1,44,173,81,92
050,35,053,"New Mexico","Socorro County",1,45,194,94,100
050,35,053,"New Mexico","Socorro County",1,46,169,86,83
050,35,053,"New Mexico","Socorro County",1,47,151,85,66
050,35,053,"New Mexico","Socorro County",1,48,163,93,70
050,35,053,"New Mexico","Socorro County",1,49,176,88,88
050,35,053,"New Mexico","Socorro County",1,50,188,94,94
050,35,053,"New Mexico","Socorro County",1,51,177,86,91
050,35,053,"New Mexico","Socorro County",1,52,189,93,96
050,35,053,"New Mexico","Socorro County",1,53,188,87,101
050,35,053,"New Mexico","Socorro County",1,54,176,81,95
050,35,053,"New Mexico","Socorro County",1,55,197,99,98
050,35,053,"New Mexico","Socorro County",1,56,209,103,106
050,35,053,"New Mexico","Socorro County",1,57,223,109,114
050,35,053,"New Mexico","Socorro County",1,58,244,126,118
050,35,053,"New Mexico","Socorro County",1,59,251,117,134
050,35,053,"New Mexico","Socorro County",1,60,230,111,119
050,35,053,"New Mexico","Socorro County",1,61,219,104,115
050,35,053,"New Mexico","Socorro County",1,62,237,108,129
050,35,053,"New Mexico","Socorro County",1,63,230,108,122
050,35,053,"New Mexico","Socorro County",1,64,227,106,121
050,35,053,"New Mexico","Socorro County",1,65,226,109,117
050,35,053,"New Mexico","Socorro County",1,66,218,116,102
050,35,053,"New Mexico","Socorro County",1,67,202,109,93
050,35,053,"New Mexico","Socorro County",1,68,212,105,107
050,35,053,"New Mexico","Socorro County",1,69,212,104,108
050,35,053,"New Mexico","Socorro County",1,70,186,86,100
050,35,053,"New Mexico","Socorro County",1,71,190,92,98
050,35,053,"New Mexico","Socorro County",1,72,203,95,108
050,35,053,"New Mexico","Socorro County",1,73,181,93,88
050,35,053,"New Mexico","Socorro County",1,74,130,67,63
050,35,053,"New Mexico","Socorro County",1,75,133,58,75
050,35,053,"New Mexico","Socorro County",1,76,136,62,74
050,35,053,"New Mexico","Socorro County",1,77,129,61,68
050,35,053,"New Mexico","Socorro County",1,78,106,50,56
050,35,053,"New Mexico","Socorro County",1,79,104,52,52
050,35,053,"New Mexico","Socorro County",1,80,93,44,49
050,35,053,"New Mexico","Socorro County",1,81,101,55,46
050,35,053,"New Mexico","Socorro County",1,82,77,47,30
050,35,053,"New Mexico","Socorro County",1,83,59,28,31
050,35,053,"New Mexico","Socorro County",1,84,62,31,31
050,35,053,"New Mexico","Socorro County",1,85,304,116,188
050,35,053,"New Mexico","Socorro County",2,0,172,87,85
050,35,053,"New Mexico","Socorro County",2,1,183,96,87
050,35,053,"New Mexico","Socorro County",2,2,187,99,88
050,35,053,"New Mexico","Socorro County",2,3,195,95,100
050,35,053,"New Mexico","Socorro County",2,4,205,97,108
050,35,053,"New Mexico","Socorro County",2,5,198,92,106
050,35,053,"New Mexico","Socorro County",2,6,189,92,97
050,35,053,"New Mexico","Socorro County",2,7,191,98,93
050,35,053,"New Mexico","Socorro County",2,8,205,106,99
050,35,053,"New Mexico","Socorro County",2,9,226,113,113
050,35,053,"New Mexico","Socorro County",2,10,215,100,115
050,35,053,"New Mexico","Socorro County",2,11,203,94,109
050,35,053,"New Mexico","Socorro County",2,12,210,99,111
050,35,053,"New Mexico","Socorro County",2,13,214,97,117
050,35,053,"New Mexico","Socorro County",2,14,221,112,109
050,35,053,"New Mexico","Socorro County",2,15,224,116,108
050,35,053,"New Mexico","Socorro County",2,16,208,109,99
050,35,053,"New Mexico","Socorro County",2,17,201,116,85
050,35,053,"New Mexico","Socorro County",2,18,312,177,135
050,35,053,"New Mexico","Socorro County",2,19,437,283,154
050,35,053,"New Mexico","Socorro County",2,20,334,212,122
050,35,053,"New Mexico","Socorro County",2,21,273,167,106
050,35,053,"New Mexico","Socorro County",2,22,240,134,106
050,35,053,"New Mexico","Socorro County",2,23,219,123,96
050,35,053,"New Mexico","Socorro County",2,24,192,105,87
050,35,053,"New Mexico","Socorro County",2,25,193,103,90
050,35,053,"New Mexico","Socorro County",2,26,183,101,82
050,35,053,"New Mexico","Socorro County",2,27,186,104,82
050,35,053,"New Mexico","Socorro County",2,28,195,105,90
050,35,053,"New Mexico","Socorro County",2,29,185,96,89
050,35,053,"New Mexico","Socorro County",2,30,184,87,97
050,35,053,"New Mexico","Socorro County",2,31,177,92,85
050,35,053,"New Mexico","Socorro County",2,32,180,98,82
050,35,053,"New Mexico","Socorro County",2,33,195,102,93
050,35,053,"New Mexico","Socorro County",2,34,190,97,93
050,35,053,"New Mexico","Socorro County",2,35,185,97,88
050,35,053,"New Mexico","Socorro County",2,36,184,94,90
050,35,053,"New Mexico","Socorro County",2,37,179,90,89
050,35,053,"New Mexico","Socorro County",2,38,162,90,72
050,35,053,"New Mexico","Socorro County",2,39,176,102,74
050,35,053,"New Mexico","Socorro County",2,40,186,99,87
050,35,053,"New Mexico","Socorro County",2,41,182,90,92
050,35,053,"New Mexico","Socorro County",2,42,164,87,77
050,35,053,"New Mexico","Socorro County",2,43,160,83,77
050,35,053,"New Mexico","Socorro County",2,44,169,81,88
050,35,053,"New Mexico","Socorro County",2,45,189,92,97
050,35,053,"New Mexico","Socorro County",2,46,173,87,86
050,35,053,"New Mexico","Socorro County",2,47,154,84,70
050,35,053,"New Mexico","Socorro County",2,48,159,92,67
050,35,053,"New Mexico","Socorro County",2,49,174,90,84
050,35,053,"New Mexico","Socorro County",2,50,186,93,93
050,35,053,"New Mexico","Socorro County",2,51,178,87,91
050,35,053,"New Mexico","Socorro County",2,52,186,92,94
050,35,053,"New Mexico","Socorro County",2,53,187,87,100
050,35,053,"New Mexico","Socorro County",2,54,179,83,96
050,35,053,"New Mexico","Socorro County",2,55,192,95,97
050,35,053,"New Mexico","Socorro County",2,56,209,103,106
050,35,053,"New Mexico","Socorro County",2,57,220,110,110
050,35,053,"New Mexico","Socorro County",2,58,237,120,117
050,35,053,"New Mexico","Socorro County",2,59,249,119,130
050,35,053,"New Mexico","Socorro County",2,60,234,112,122
050,35,053,"New Mexico","Socorro County",2,61,221,106,115
050,35,053,"New Mexico","Socorro County",2,62,230,106,124
050,35,053,"New Mexico","Socorro County",2,63,231,108,123
050,35,053,"New Mexico","Socorro County",2,64,220,103,117
050,35,053,"New Mexico","Socorro County",2,65,225,109,116
050,35,053,"New Mexico","Socorro County",2,66,218,113,105
050,35,053,"New Mexico","Socorro County",2,67,205,110,95
050,35,053,"New Mexico","Socorro County",2,68,205,103,102
050,35,053,"New Mexico","Socorro County",2,69,212,104,108
050,35,053,"New Mexico","Socorro County",2,70,191,89,102
050,35,053,"New Mexico","Socorro County",2,71,188,90,98
050,35,053,"New Mexico","Socorro County",2,72,198,94,104
050,35,053,"New Mexico","Socorro County",2,73,191,97,94
050,35,053,"New Mexico","Socorro County",2,74,135,69,66
050,35,053,"New Mexico","Socorro County",2,75,131,59,72
050,35,053,"New Mexico","Socorro County",2,76,134,60,74
050,35,053,"New Mexico","Socorro County",2,77,132,62,70
050,35,053,"New Mexico","Socorro County",2,78,109,50,59
050,35,053,"New Mexico","Socorro County",2,79,103,50,53
050,35,053,"New Mexico","Socorro County",2,80,94,45,49
050,35,053,"New Mexico","Socorro County",2,81,99,53,46
050,35,053,"New Mexico","Socorro County",2,82,81,48,33
050,35,053,"New Mexico","Socorro County",2,83,60,31,29
050,35,053,"New Mexico","Socorro County",2,84,60,30,30
050,35,053,"New Mexico","Socorro County",2,85,303,119,184
050,35,053,"New Mexico","Socorro County",3,0,159,100,59
050,35,053,"New Mexico","Socorro County",3,1,175,96,79
050,35,053,"New Mexico","Socorro County",3,2,188,101,87
050,35,053,"New Mexico","Socorro County",3,3,196,102,94
050,35,053,"New Mexico","Socorro County",3,4,189,94,95
050,35,053,"New Mexico","Socorro County",3,5,195,96,99
050,35,053,"New Mexico","Socorro County",3,6,196,100,96
050,35,053,"New Mexico","Socorro County",3,7,193,92,101
050,35,053,"New Mexico","Socorro County",3,8,181,92,89
050,35,053,"New Mexico","Socorro County",3,9,198,105,93
050,35,053,"New Mexico","Socorro County",3,10,223,111,112
050,35,053,"New Mexico","Socorro County",3,11,198,98,100
050,35,053,"New Mexico","Socorro County",3,12,199,93,106
050,35,053,"New Mexico","Socorro County",3,13,211,98,113
050,35,053,"New Mexico","Socorro County",3,14,211,99,112
050,35,053,"New Mexico","Socorro County",3,15,215,111,104
050,35,053,"New Mexico","Socorro County",3,16,203,107,96
050,35,053,"New Mexico","Socorro County",3,17,206,111,95
050,35,053,"New Mexico","Socorro County",3,18,309,185,124
050,35,053,"New Mexico","Socorro County",3,19,410,273,137
050,35,053,"New Mexico","Socorro County",3,20,324,197,127
050,35,053,"New Mexico","Socorro County",3,21,268,162,106
050,35,053,"New Mexico","Socorro County",3,22,240,133,107
050,35,053,"New Mexico","Socorro County",3,23,220,120,100
050,35,053,"New Mexico","Socorro County",3,24,192,107,85
050,35,053,"New Mexico","Socorro County",3,25,184,98,86
050,35,053,"New Mexico","Socorro County",3,26,182,102,80
050,35,053,"New Mexico","Socorro County",3,27,175,91,84
050,35,053,"New Mexico","Socorro County",3,28,185,96,89
050,35,053,"New Mexico","Socorro County",3,29,186,105,81
050,35,053,"New Mexico","Socorro County",3,30,180,94,86
050,35,053,"New Mexico","Socorro County",3,31,176,80,96
050,35,053,"New Mexico","Socorro County",3,32,175,95,80
050,35,053,"New Mexico","Socorro County",3,33,181,98,83
050,35,053,"New Mexico","Socorro County",3,34,195,100,95
050,35,053,"New Mexico","Socorro County",3,35,198,101,97
050,35,053,"New Mexico","Socorro County",3,36,185,100,85
050,35,053,"New Mexico","Socorro County",3,37,174,90,84
050,35,053,"New Mexico","Socorro County",3,38,174,87,87
050,35,053,"New Mexico","Socorro County",3,39,175,104,71
050,35,053,"New Mexico","Socorro County",3,40,168,95,73
050,35,053,"New Mexico","Socorro County",3,41,194,100,94
050,35,053,"New Mexico","Socorro County",3,42,177,92,85
050,35,053,"New Mexico","Socorro County",3,43,160,85,75
050,35,053,"New Mexico","Socorro County",3,44,159,82,77
050,35,053,"New Mexico","Socorro County",3,45,169,80,89
050,35,053,"New Mexico","Socorro County",3,46,187,94,93
050,35,053,"New Mexico","Socorro County",3,47,178,93,85
050,35,053,"New Mexico","Socorro County",3,48,149,82,67
050,35,053,"New Mexico","Socorro County",3,49,153,88,65
050,35,053,"New Mexico","Socorro County",3,50,168,86,82
050,35,053,"New Mexico","Socorro County",3,51,184,96,88
050,35,053,"New Mexico","Socorro County",3,52,172,78,94
050,35,053,"New Mexico","Socorro County",3,53,184,86,98
050,35,053,"New Mexico","Socorro County",3,54,178,87,91
050,35,053,"New Mexico","Socorro County",3,55,177,84,93
050,35,053,"New Mexico","Socorro County",3,56,199,101,98
050,35,053,"New Mexico","Socorro County",3,57,212,107,105
050,35,053,"New Mexico","Socorro County",3,58,219,111,108
050,35,053,"New Mexico","Socorro County",3,59,227,116,111
050,35,053,"New Mexico","Socorro County",3,60,239,114,125
050,35,053,"New Mexico","Socorro County",3,61,228,109,119
050,35,053,"New Mexico","Socorro County",3,62,222,109,113
050,35,053,"New Mexico","Socorro County",3,63,223,102,121
050,35,053,"New Mexico","Socorro County",3,64,221,104,117
050,35,053,"New Mexico","Socorro County",3,65,225,103,122
050,35,053,"New Mexico","Socorro County",3,66,212,102,110
050,35,053,"New Mexico","Socorro County",3,67,214,107,107
050,35,053,"New Mexico","Socorro County",3,68,196,103,93
050,35,053,"New Mexico","Socorro County",3,69,203,98,105
050,35,053,"New Mexico","Socorro County",3,70,207,101,106
050,35,053,"New Mexico","Socorro County",3,71,184,84,100
050,35,053,"New Mexico","Socorro County",3,72,185,87,98
050,35,053,"New Mexico","Socorro County",3,73,185,90,95
050,35,053,"New Mexico","Socorro County",3,74,185,91,94
050,35,053,"New Mexico","Socorro County",3,75,132,67,65
050,35,053,"New Mexico","Socorro County",3,76,117,51,66
050,35,053,"New Mexico","Socorro County",3,77,133,60,73
050,35,053,"New Mexico","Socorro County",3,78,125,57,68
050,35,053,"New Mexico","Socorro County",3,79,104,46,58
050,35,053,"New Mexico","Socorro County",3,80,96,44,52
050,35,053,"New Mexico","Socorro County",3,81,90,43,47
050,35,053,"New Mexico","Socorro County",3,82,93,51,42
050,35,053,"New Mexico","Socorro County",3,83,79,45,34
050,35,053,"New Mexico","Socorro County",3,84,52,28,24
050,35,053,"New Mexico","Socorro County",3,85,303,119,184
050,35,053,"New Mexico","Socorro County",4,0,150,80,70
050,35,053,"New Mexico","Socorro County",4,1,149,93,56
050,35,053,"New Mexico","Socorro County",4,2,177,95,82
050,35,053,"New Mexico","Socorro County",4,3,182,98,84
050,35,053,"New Mexico","Socorro County",4,4,194,97,97
050,35,053,"New Mexico","Socorro County",4,5,192,101,91
050,35,053,"New Mexico","Socorro County",4,6,195,96,99
050,35,053,"New Mexico","Socorro County",4,7,197,98,99
050,35,053,"New Mexico","Socorro County",4,8,182,92,90
050,35,053,"New Mexico","Socorro County",4,9,189,97,92
050,35,053,"New Mexico","Socorro County",4,10,188,108,80
050,35,053,"New Mexico","Socorro County",4,11,215,110,105
050,35,053,"New Mexico","Socorro County",4,12,194,99,95
050,35,053,"New Mexico","Socorro County",4,13,193,90,103
050,35,053,"New Mexico","Socorro County",4,14,205,96,109
050,35,053,"New Mexico","Socorro County",4,15,214,103,111
050,35,053,"New Mexico","Socorro County",4,16,211,106,105
050,35,053,"New Mexico","Socorro County",4,17,209,112,97
050,35,053,"New Mexico","Socorro County",4,18,320,183,137
050,35,053,"New Mexico","Socorro County",4,19,416,282,134
050,35,053,"New Mexico","Socorro County",4,20,299,191,108
050,35,053,"New Mexico","Socorro County",4,21,288,166,122
050,35,053,"New Mexico","Socorro County",4,22,246,136,110
050,35,053,"New Mexico","Socorro County",4,23,212,120,92
050,35,053,"New Mexico","Socorro County",4,24,204,110,94
050,35,053,"New Mexico","Socorro County",4,25,171,91,80
050,35,053,"New Mexico","Socorro County",4,26,176,92,84
050,35,053,"New Mexico","Socorro County",4,27,169,94,75
050,35,053,"New Mexico","Socorro County",4,28,172,92,80
050,35,053,"New Mexico","Socorro County",4,29,186,92,94
050,35,053,"New Mexico","Socorro County",4,30,183,96,87
050,35,053,"New Mexico","Socorro County",4,31,194,99,95
050,35,053,"New Mexico","Socorro County",4,32,170,77,93
050,35,053,"New Mexico","Socorro County",4,33,175,97,78
050,35,053,"New Mexico","Socorro County",4,34,170,91,79
050,35,053,"New Mexico","Socorro County",4,35,194,100,94
050,35,053,"New Mexico","Socorro County",4,36,204,99,105
050,35,053,"New Mexico","Socorro County",4,37,189,99,90
050,35,053,"New Mexico","Socorro County",4,38,163,83,80
050,35,053,"New Mexico","Socorro County",4,39,176,90,86
050,35,053,"New Mexico","Socorro County",4,40,172,102,70
050,35,053,"New Mexico","Socorro County",4,41,162,89,73
050,35,053,"New Mexico","Socorro County",4,42,183,96,87
050,35,053,"New Mexico","Socorro County",4,43,171,86,85
050,35,053,"New Mexico","Socorro County",4,44,157,86,71
050,35,053,"New Mexico","Socorro County",4,45,163,80,83
050,35,053,"New Mexico","Socorro County",4,46,159,76,83
050,35,053,"New Mexico","Socorro County",4,47,182,94,88
050,35,053,"New Mexico","Socorro County",4,48,168,85,83
050,35,053,"New Mexico","Socorro County",4,49,153,84,69
050,35,053,"New Mexico","Socorro County",4,50,149,85,64
050,35,053,"New Mexico","Socorro County",4,51,174,91,83
050,35,053,"New Mexico","Socorro County",4,52,187,99,88
050,35,053,"New Mexico","Socorro County",4,53,175,79,96
050,35,053,"New Mexico","Socorro County",4,54,184,86,98
050,35,053,"New Mexico","Socorro County",4,55,174,87,87
050,35,053,"New Mexico","Socorro County",4,56,176,86,90
050,35,053,"New Mexico","Socorro County",4,57,196,99,97
050,35,053,"New Mexico","Socorro County",4,58,209,106,103
050,35,053,"New Mexico","Socorro County",4,59,212,105,107
050,35,053,"New Mexico","Socorro County",4,60,224,115,109
050,35,053,"New Mexico","Socorro County",4,61,239,113,126
050,35,053,"New Mexico","Socorro County",4,62,221,105,116
050,35,053,"New Mexico","Socorro County",4,63,209,104,105
050,35,053,"New Mexico","Socorro County",4,64,214,95,119
050,35,053,"New Mexico","Socorro County",4,65,216,99,117
050,35,053,"New Mexico","Socorro County",4,66,223,103,120
050,35,053,"New Mexico","Socorro County",4,67,211,100,111
050,35,053,"New Mexico","Socorro County",4,68,217,109,108
050,35,053,"New Mexico","Socorro County",4,69,200,105,95
050,35,053,"New Mexico","Socorro County",4,70,193,94,99
050,35,053,"New Mexico","Socorro County",4,71,204,99,105
050,35,053,"New Mexico","Socorro County",4,72,180,80,100
050,35,053,"New Mexico","Socorro County",4,73,161,78,83
050,35,053,"New Mexico","Socorro County",4,74,182,88,94
050,35,053,"New Mexico","Socorro County",4,75,185,90,95
050,35,053,"New Mexico","Socorro County",4,76,115,60,55
050,35,053,"New Mexico","Socorro County",4,77,113,48,65
050,35,053,"New Mexico","Socorro County",4,78,124,56,68
050,35,053,"New Mexico","Socorro County",4,79,122,52,70
050,35,053,"New Mexico","Socorro County",4,80,95,43,52
050,35,053,"New Mexico","Socorro County",4,81,92,41,51
050,35,053,"New Mexico","Socorro County",4,82,84,42,42
050,35,053,"New Mexico","Socorro County",4,83,86,47,39
050,35,053,"New Mexico","Socorro County",4,84,73,45,28
050,35,053,"New Mexico","Socorro County",4,85,309,128,181
050,35,053,"New Mexico","Socorro County",5,0,152,81,71
050,35,053,"New Mexico","Socorro County",5,1,149,67,82
050,35,053,"New Mexico","Socorro County",5,2,154,94,60
050,35,053,"New Mexico","Socorro County",5,3,174,93,81
050,35,053,"New Mexico","Socorro County",5,4,189,105,84
050,35,053,"New Mexico","Socorro County",5,5,183,99,84
050,35,053,"New Mexico","Socorro County",5,6,188,96,92
050,35,053,"New Mexico","Socorro County",5,7,202,93,109
050,35,053,"New Mexico","Socorro County",5,8,185,84,101
050,35,053,"New Mexico","Socorro County",5,9,186,95,91
050,35,053,"New Mexico","Socorro County",5,10,194,104,90
050,35,053,"New Mexico","Socorro County",5,11,186,106,80
050,35,053,"New Mexico","Socorro County",5,12,213,113,100
050,35,053,"New Mexico","Socorro County",5,13,195,95,100
050,35,053,"New Mexico","Socorro County",5,14,197,92,105
050,35,053,"New Mexico","Socorro County",5,15,205,99,106
050,35,053,"New Mexico","Socorro County",5,16,203,98,105
050,35,053,"New Mexico","Socorro County",5,17,214,111,103
050,35,053,"New Mexico","Socorro County",5,18,318,180,138
050,35,053,"New Mexico","Socorro County",5,19,429,281,148
050,35,053,"New Mexico","Socorro County",5,20,318,207,111
050,35,053,"New Mexico","Socorro County",5,21,241,148,93
050,35,053,"New Mexico","Socorro County",5,22,256,140,116
050,35,053,"New Mexico","Socorro County",5,23,222,124,98
050,35,053,"New Mexico","Socorro County",5,24,189,111,78
050,35,053,"New Mexico","Socorro County",5,25,194,99,95
050,35,053,"New Mexico","Socorro County",5,26,159,81,78
050,35,053,"New Mexico","Socorro County",5,27,164,83,81
050,35,053,"New Mexico","Socorro County",5,28,167,93,74
050,35,053,"New Mexico","Socorro County",5,29,167,87,80
050,35,053,"New Mexico","Socorro County",5,30,177,93,84
050,35,053,"New Mexico","Socorro County",5,31,186,97,89
050,35,053,"New Mexico","Socorro County",5,32,185,88,97
050,35,053,"New Mexico","Socorro County",5,33,160,76,84
050,35,053,"New Mexico","Socorro County",5,34,166,87,79
050,35,053,"New Mexico","Socorro County",5,35,168,91,77
050,35,053,"New Mexico","Socorro County",5,36,183,96,87
050,35,053,"New Mexico","Socorro County",5,37,196,96,100
050,35,053,"New Mexico","Socorro County",5,38,192,102,90
050,35,053,"New Mexico","Socorro County",5,39,170,85,85
050,35,053,"New Mexico","Socorro County",5,40,177,88,89
050,35,053,"New Mexico","Socorro County",5,41,179,108,71
050,35,053,"New Mexico","Socorro County",5,42,148,78,70
050,35,053,"New Mexico","Socorro County",5,43,181,96,85
050,35,053,"New Mexico","Socorro County",5,44,165,86,79
050,35,053,"New Mexico","Socorro County",5,45,155,83,72
050,35,053,"New Mexico","Socorro County",5,46,160,79,81
050,35,053,"New Mexico","Socorro County",5,47,155,75,80
050,35,053,"New Mexico","Socorro County",5,48,184,95,89
050,35,053,"New Mexico","Socorro County",5,49,169,87,82
050,35,053,"New Mexico","Socorro County",5,50,158,86,72
050,35,053,"New Mexico","Socorro County",5,51,148,84,64
050,35,053,"New Mexico","Socorro County",5,52,173,89,84
050,35,053,"New Mexico","Socorro County",5,53,182,94,88
050,35,053,"New Mexico","Socorro County",5,54,174,83,91
050,35,053,"New Mexico","Socorro County",5,55,175,82,93
050,35,053,"New Mexico","Socorro County",5,56,169,84,85
050,35,053,"New Mexico","Socorro County",5,57,168,79,89
050,35,053,"New Mexico","Socorro County",5,58,199,100,99
050,35,053,"New Mexico","Socorro County",5,59,201,99,102
050,35,053,"New Mexico","Socorro County",5,60,213,103,110
050,35,053,"New Mexico","Socorro County",5,61,227,114,113
050,35,053,"New Mexico","Socorro County",5,62,236,113,123
050,35,053,"New Mexico","Socorro County",5,63,225,109,116
050,35,053,"New Mexico","Socorro County",5,64,200,100,100
050,35,053,"New Mexico","Socorro County",5,65,210,96,114
050,35,053,"New Mexico","Socorro County",5,66,211,94,117
050,35,053,"New Mexico","Socorro County",5,67,230,109,121
050,35,053,"New Mexico","Socorro County",5,68,204,97,107
050,35,053,"New Mexico","Socorro County",5,69,222,108,114
050,35,053,"New Mexico","Socorro County",5,70,195,102,93
050,35,053,"New Mexico","Socorro County",5,71,194,96,98
050,35,053,"New Mexico","Socorro County",5,72,205,99,106
050,35,053,"New Mexico","Socorro County",5,73,168,73,95
050,35,053,"New Mexico","Socorro County",5,74,157,75,82
050,35,053,"New Mexico","Socorro County",5,75,179,87,92
050,35,053,"New Mexico","Socorro County",5,76,169,82,87
050,35,053,"New Mexico","Socorro County",5,77,111,54,57
050,35,053,"New Mexico","Socorro County",5,78,108,44,64
050,35,053,"New Mexico","Socorro County",5,79,123,56,67
050,35,053,"New Mexico","Socorro County",5,80,113,47,66
050,35,053,"New Mexico","Socorro County",5,81,88,41,47
050,35,053,"New Mexico","Socorro County",5,82,89,42,47
050,35,053,"New Mexico","Socorro County",5,83,80,39,41
050,35,053,"New Mexico","Socorro County",5,84,83,46,37
050,35,053,"New Mexico","Socorro County",5,85,327,150,177
050,35,055,"New Mexico","Taos County",1,0,244,123,121
050,35,055,"New Mexico","Taos County",1,1,269,133,136
050,35,055,"New Mexico","Taos County",1,2,297,153,144
050,35,055,"New Mexico","Taos County",1,3,288,138,150
050,35,055,"New Mexico","Taos County",1,4,283,129,154
050,35,055,"New Mexico","Taos County",1,5,291,142,149
050,35,055,"New Mexico","Taos County",1,6,309,146,163
050,35,055,"New Mexico","Taos County",1,7,297,151,146
050,35,055,"New Mexico","Taos County",1,8,324,185,139
050,35,055,"New Mexico","Taos County",1,9,298,163,135
050,35,055,"New Mexico","Taos County",1,10,310,163,147
050,35,055,"New Mexico","Taos County",1,11,335,166,169
050,35,055,"New Mexico","Taos County",1,12,371,191,180
050,35,055,"New Mexico","Taos County",1,13,379,191,188
050,35,055,"New Mexico","Taos County",1,14,370,194,176
050,35,055,"New Mexico","Taos County",1,15,363,196,167
050,35,055,"New Mexico","Taos County",1,16,352,180,172
050,35,055,"New Mexico","Taos County",1,17,371,203,168
050,35,055,"New Mexico","Taos County",1,18,347,194,153
050,35,055,"New Mexico","Taos County",1,19,301,168,133
050,35,055,"New Mexico","Taos County",1,20,306,158,148
050,35,055,"New Mexico","Taos County",1,21,286,146,140
050,35,055,"New Mexico","Taos County",1,22,273,149,124
050,35,055,"New Mexico","Taos County",1,23,288,136,152
050,35,055,"New Mexico","Taos County",1,24,296,157,139
050,35,055,"New Mexico","Taos County",1,25,294,159,135
050,35,055,"New Mexico","Taos County",1,26,293,145,148
050,35,055,"New Mexico","Taos County",1,27,336,168,168
050,35,055,"New Mexico","Taos County",1,28,338,169,169
050,35,055,"New Mexico","Taos County",1,29,355,191,164
050,35,055,"New Mexico","Taos County",1,30,337,178,159
050,35,055,"New Mexico","Taos County",1,31,336,155,181
050,35,055,"New Mexico","Taos County",1,32,370,188,182
050,35,055,"New Mexico","Taos County",1,33,360,183,177
050,35,055,"New Mexico","Taos County",1,34,359,178,181
050,35,055,"New Mexico","Taos County",1,35,369,177,192
050,35,055,"New Mexico","Taos County",1,36,362,178,184
050,35,055,"New Mexico","Taos County",1,37,342,167,175
050,35,055,"New Mexico","Taos County",1,38,395,191,204
050,35,055,"New Mexico","Taos County",1,39,428,217,211
050,35,055,"New Mexico","Taos County",1,40,382,196,186
050,35,055,"New Mexico","Taos County",1,41,325,161,164
050,35,055,"New Mexico","Taos County",1,42,374,191,183
050,35,055,"New Mexico","Taos County",1,43,422,233,189
050,35,055,"New Mexico","Taos County",1,44,395,222,173
050,35,055,"New Mexico","Taos County",1,45,334,189,145
050,35,055,"New Mexico","Taos County",1,46,342,167,175
050,35,055,"New Mexico","Taos County",1,47,344,158,186
050,35,055,"New Mexico","Taos County",1,48,396,201,195
050,35,055,"New Mexico","Taos County",1,49,453,236,217
050,35,055,"New Mexico","Taos County",1,50,421,216,205
050,35,055,"New Mexico","Taos County",1,51,428,211,217
050,35,055,"New Mexico","Taos County",1,52,418,208,210
050,35,055,"New Mexico","Taos County",1,53,437,237,200
050,35,055,"New Mexico","Taos County",1,54,455,214,241
050,35,055,"New Mexico","Taos County",1,55,472,217,255
050,35,055,"New Mexico","Taos County",1,56,514,231,283
050,35,055,"New Mexico","Taos County",1,57,528,247,281
050,35,055,"New Mexico","Taos County",1,58,542,256,286
050,35,055,"New Mexico","Taos County",1,59,577,260,317
050,35,055,"New Mexico","Taos County",1,60,550,251,299
050,35,055,"New Mexico","Taos County",1,61,555,262,293
050,35,055,"New Mexico","Taos County",1,62,564,289,275
050,35,055,"New Mexico","Taos County",1,63,612,297,315
050,35,055,"New Mexico","Taos County",1,64,621,277,344
050,35,055,"New Mexico","Taos County",1,65,614,295,319
050,35,055,"New Mexico","Taos County",1,66,650,318,332
050,35,055,"New Mexico","Taos County",1,67,690,324,366
050,35,055,"New Mexico","Taos County",1,68,683,330,353
050,35,055,"New Mexico","Taos County",1,69,656,319,337
050,35,055,"New Mexico","Taos County",1,70,644,316,328
050,35,055,"New Mexico","Taos County",1,71,615,293,322
050,35,055,"New Mexico","Taos County",1,72,597,275,322
050,35,055,"New Mexico","Taos County",1,73,600,281,319
050,35,055,"New Mexico","Taos County",1,74,425,191,234
050,35,055,"New Mexico","Taos County",1,75,448,208,240
050,35,055,"New Mexico","Taos County",1,76,412,200,212
050,35,055,"New Mexico","Taos County",1,77,357,161,196
050,35,055,"New Mexico","Taos County",1,78,297,138,159
050,35,055,"New Mexico","Taos County",1,79,294,152,142
050,35,055,"New Mexico","Taos County",1,80,277,140,137
050,35,055,"New Mexico","Taos County",1,81,238,98,140
050,35,055,"New Mexico","Taos County",1,82,214,94,120
050,35,055,"New Mexico","Taos County",1,83,171,86,85
050,35,055,"New Mexico","Taos County",1,84,174,87,87
050,35,055,"New Mexico","Taos County",1,85,851,338,513
050,35,055,"New Mexico","Taos County",2,0,244,119,125
050,35,055,"New Mexico","Taos County",2,1,264,131,133
050,35,055,"New Mexico","Taos County",2,2,289,146,143
050,35,055,"New Mexico","Taos County",2,3,287,139,148
050,35,055,"New Mexico","Taos County",2,4,287,133,154
050,35,055,"New Mexico","Taos County",2,5,290,139,151
050,35,055,"New Mexico","Taos County",2,6,307,147,160
050,35,055,"New Mexico","Taos County",2,7,301,151,150
050,35,055,"New Mexico","Taos County",2,8,317,175,142
050,35,055,"New Mexico","Taos County",2,9,303,167,136
050,35,055,"New Mexico","Taos County",2,10,307,165,142
050,35,055,"New Mexico","Taos County",2,11,326,165,161
050,35,055,"New Mexico","Taos County",2,12,362,185,177
050,35,055,"New Mexico","Taos County",2,13,376,190,186
050,35,055,"New Mexico","Taos County",2,14,369,192,177
050,35,055,"New Mexico","Taos County",2,15,366,195,171
050,35,055,"New Mexico","Taos County",2,16,354,184,170
050,35,055,"New Mexico","Taos County",2,17,366,197,169
050,35,055,"New Mexico","Taos County",2,18,343,192,151
050,35,055,"New Mexico","Taos County",2,19,304,170,134
050,35,055,"New Mexico","Taos County",2,20,303,160,143
050,35,055,"New Mexico","Taos County",2,21,283,146,137
050,35,055,"New Mexico","Taos County",2,22,275,145,130
050,35,055,"New Mexico","Taos County",2,23,286,140,146
050,35,055,"New Mexico","Taos County",2,24,293,152,141
050,35,055,"New Mexico","Taos County",2,25,290,155,135
050,35,055,"New Mexico","Taos County",2,26,295,150,145
050,35,055,"New Mexico","Taos County",2,27,325,164,161
050,35,055,"New Mexico","Taos County",2,28,341,171,170
050,35,055,"New Mexico","Taos County",2,29,350,185,165
050,35,055,"New Mexico","Taos County",2,30,345,183,162
050,35,055,"New Mexico","Taos County",2,31,336,162,174
050,35,055,"New Mexico","Taos County",2,32,363,180,183
050,35,055,"New Mexico","Taos County",2,33,362,183,179
050,35,055,"New Mexico","Taos County",2,34,357,178,179
050,35,055,"New Mexico","Taos County",2,35,366,177,189
050,35,055,"New Mexico","Taos County",2,36,361,176,185
050,35,055,"New Mexico","Taos County",2,37,345,168,177
050,35,055,"New Mexico","Taos County",2,38,388,188,200
050,35,055,"New Mexico","Taos County",2,39,421,211,210
050,35,055,"New Mexico","Taos County",2,40,394,202,192
050,35,055,"New Mexico","Taos County",2,41,337,169,168
050,35,055,"New Mexico","Taos County",2,42,363,183,180
050,35,055,"New Mexico","Taos County",2,43,415,225,190
050,35,055,"New Mexico","Taos County",2,44,396,223,173
050,35,055,"New Mexico","Taos County",2,45,352,198,154
050,35,055,"New Mexico","Taos County",2,46,336,170,166
050,35,055,"New Mexico","Taos County",2,47,344,159,185
050,35,055,"New Mexico","Taos County",2,48,384,192,192
050,35,055,"New Mexico","Taos County",2,49,438,227,211
050,35,055,"New Mexico","Taos County",2,50,431,222,209
050,35,055,"New Mexico","Taos County",2,51,427,214,213
050,35,055,"New Mexico","Taos County",2,52,421,209,212
050,35,055,"New Mexico","Taos County",2,53,432,230,202
050,35,055,"New Mexico","Taos County",2,54,445,217,228
050,35,055,"New Mexico","Taos County",2,55,467,216,251
050,35,055,"New Mexico","Taos County",2,56,505,228,277
050,35,055,"New Mexico","Taos County",2,57,527,243,284
050,35,055,"New Mexico","Taos County",2,58,542,255,287
050,35,055,"New Mexico","Taos County",2,59,569,258,311
050,35,055,"New Mexico","Taos County",2,60,563,257,306
050,35,055,"New Mexico","Taos County",2,61,554,259,295
050,35,055,"New Mexico","Taos County",2,62,562,282,280
050,35,055,"New Mexico","Taos County",2,63,606,296,310
050,35,055,"New Mexico","Taos County",2,64,615,280,335
050,35,055,"New Mexico","Taos County",2,65,618,292,326
050,35,055,"New Mexico","Taos County",2,66,645,316,329
050,35,055,"New Mexico","Taos County",2,67,679,322,357
050,35,055,"New Mexico","Taos County",2,68,673,322,351
050,35,055,"New Mexico","Taos County",2,69,662,322,340
050,35,055,"New Mexico","Taos County",2,70,645,316,329
050,35,055,"New Mexico","Taos County",2,71,620,296,324
050,35,055,"New Mexico","Taos County",2,72,596,276,320
050,35,055,"New Mexico","Taos County",2,73,622,289,333
050,35,055,"New Mexico","Taos County",2,74,443,202,241
050,35,055,"New Mexico","Taos County",2,75,440,205,235
050,35,055,"New Mexico","Taos County",2,76,415,199,216
050,35,055,"New Mexico","Taos County",2,77,376,174,202
050,35,055,"New Mexico","Taos County",2,78,305,140,165
050,35,055,"New Mexico","Taos County",2,79,292,147,145
050,35,055,"New Mexico","Taos County",2,80,280,142,138
050,35,055,"New Mexico","Taos County",2,81,243,106,137
050,35,055,"New Mexico","Taos County",2,82,220,94,126
050,35,055,"New Mexico","Taos County",2,83,179,86,93
050,35,055,"New Mexico","Taos County",2,84,168,87,81
050,35,055,"New Mexico","Taos County",2,85,870,347,523
050,35,055,"New Mexico","Taos County",3,0,228,121,107
050,35,055,"New Mexico","Taos County",3,1,234,108,126
050,35,055,"New Mexico","Taos County",3,2,267,127,140
050,35,055,"New Mexico","Taos County",3,3,283,147,136
050,35,055,"New Mexico","Taos County",3,4,288,139,149
050,35,055,"New Mexico","Taos County",3,5,297,140,157
050,35,055,"New Mexico","Taos County",3,6,293,136,157
050,35,055,"New Mexico","Taos County",3,7,302,146,156
050,35,055,"New Mexico","Taos County",3,8,298,149,149
050,35,055,"New Mexico","Taos County",3,9,329,180,149
050,35,055,"New Mexico","Taos County",3,10,320,175,145
050,35,055,"New Mexico","Taos County",3,11,313,160,153
050,35,055,"New Mexico","Taos County",3,12,332,170,162
050,35,055,"New Mexico","Taos County",3,13,369,188,181
050,35,055,"New Mexico","Taos County",3,14,379,197,182
050,35,055,"New Mexico","Taos County",3,15,369,193,176
050,35,055,"New Mexico","Taos County",3,16,364,191,173
050,35,055,"New Mexico","Taos County",3,17,355,187,168
050,35,055,"New Mexico","Taos County",3,18,335,186,149
050,35,055,"New Mexico","Taos County",3,19,303,168,135
050,35,055,"New Mexico","Taos County",3,20,302,170,132
050,35,055,"New Mexico","Taos County",3,21,291,155,136
050,35,055,"New Mexico","Taos County",3,22,289,151,138
050,35,055,"New Mexico","Taos County",3,23,270,137,133
050,35,055,"New Mexico","Taos County",3,24,281,135,146
050,35,055,"New Mexico","Taos County",3,25,296,155,141
050,35,055,"New Mexico","Taos County",3,26,294,160,134
050,35,055,"New Mexico","Taos County",3,27,300,155,145
050,35,055,"New Mexico","Taos County",3,28,332,178,154
050,35,055,"New Mexico","Taos County",3,29,347,173,174
050,35,055,"New Mexico","Taos County",3,30,370,203,167
050,35,055,"New Mexico","Taos County",3,31,360,191,169
050,35,055,"New Mexico","Taos County",3,32,347,161,186
050,35,055,"New Mexico","Taos County",3,33,380,183,197
050,35,055,"New Mexico","Taos County",3,34,378,195,183
050,35,055,"New Mexico","Taos County",3,35,374,188,186
050,35,055,"New Mexico","Taos County",3,36,373,189,184
050,35,055,"New Mexico","Taos County",3,37,368,181,187
050,35,055,"New Mexico","Taos County",3,38,368,180,188
050,35,055,"New Mexico","Taos County",3,39,386,184,202
050,35,055,"New Mexico","Taos County",3,40,425,214,211
050,35,055,"New Mexico","Taos County",3,41,397,203,194
050,35,055,"New Mexico","Taos County",3,42,344,165,179
050,35,055,"New Mexico","Taos County",3,43,363,180,183
050,35,055,"New Mexico","Taos County",3,44,424,229,195
050,35,055,"New Mexico","Taos County",3,45,406,229,177
050,35,055,"New Mexico","Taos County",3,46,362,197,165
050,35,055,"New Mexico","Taos County",3,47,344,175,169
050,35,055,"New Mexico","Taos County",3,48,344,161,183
050,35,055,"New Mexico","Taos County",3,49,384,194,190
050,35,055,"New Mexico","Taos County",3,50,450,231,219
050,35,055,"New Mexico","Taos County",3,51,447,232,215
050,35,055,"New Mexico","Taos County",3,52,431,218,213
050,35,055,"New Mexico","Taos County",3,53,435,219,216
050,35,055,"New Mexico","Taos County",3,54,447,241,206
050,35,055,"New Mexico","Taos County",3,55,444,218,226
050,35,055,"New Mexico","Taos County",3,56,453,218,235
050,35,055,"New Mexico","Taos County",3,57,506,225,281
050,35,055,"New Mexico","Taos County",3,58,535,251,284
050,35,055,"New Mexico","Taos County",3,59,563,261,302
050,35,055,"New Mexico","Taos County",3,60,579,262,317
050,35,055,"New Mexico","Taos County",3,61,572,255,317
050,35,055,"New Mexico","Taos County",3,62,572,267,305
050,35,055,"New Mexico","Taos County",3,63,573,284,289
050,35,055,"New Mexico","Taos County",3,64,615,292,323
050,35,055,"New Mexico","Taos County",3,65,619,281,338
050,35,055,"New Mexico","Taos County",3,66,623,298,325
050,35,055,"New Mexico","Taos County",3,67,651,321,330
050,35,055,"New Mexico","Taos County",3,68,681,314,367
050,35,055,"New Mexico","Taos County",3,69,667,319,348
050,35,055,"New Mexico","Taos County",3,70,651,314,337
050,35,055,"New Mexico","Taos County",3,71,625,299,326
050,35,055,"New Mexico","Taos County",3,72,616,289,327
050,35,055,"New Mexico","Taos County",3,73,579,263,316
050,35,055,"New Mexico","Taos County",3,74,604,285,319
050,35,055,"New Mexico","Taos County",3,75,436,201,235
050,35,055,"New Mexico","Taos County",3,76,437,204,233
050,35,055,"New Mexico","Taos County",3,77,403,191,212
050,35,055,"New Mexico","Taos County",3,78,365,166,199
050,35,055,"New Mexico","Taos County",3,79,287,131,156
050,35,055,"New Mexico","Taos County",3,80,280,143,137
050,35,055,"New Mexico","Taos County",3,81,262,135,127
050,35,055,"New Mexico","Taos County",3,82,234,101,133
050,35,055,"New Mexico","Taos County",3,83,207,90,117
050,35,055,"New Mexico","Taos County",3,84,166,79,87
050,35,055,"New Mexico","Taos County",3,85,913,385,528
050,35,055,"New Mexico","Taos County",4,0,235,133,102
050,35,055,"New Mexico","Taos County",4,1,230,118,112
050,35,055,"New Mexico","Taos County",4,2,239,109,130
050,35,055,"New Mexico","Taos County",4,3,270,130,140
050,35,055,"New Mexico","Taos County",4,4,285,147,138
050,35,055,"New Mexico","Taos County",4,5,293,144,149
050,35,055,"New Mexico","Taos County",4,6,303,145,158
050,35,055,"New Mexico","Taos County",4,7,292,134,158
050,35,055,"New Mexico","Taos County",4,8,283,145,138
050,35,055,"New Mexico","Taos County",4,9,291,144,147
050,35,055,"New Mexico","Taos County",4,10,323,174,149
050,35,055,"New Mexico","Taos County",4,11,314,168,146
050,35,055,"New Mexico","Taos County",4,12,308,162,146
050,35,055,"New Mexico","Taos County",4,13,326,172,154
050,35,055,"New Mexico","Taos County",4,14,355,178,177
050,35,055,"New Mexico","Taos County",4,15,378,191,187
050,35,055,"New Mexico","Taos County",4,16,360,189,171
050,35,055,"New Mexico","Taos County",4,17,351,186,165
050,35,055,"New Mexico","Taos County",4,18,335,173,162
050,35,055,"New Mexico","Taos County",4,19,311,168,143
050,35,055,"New Mexico","Taos County",4,20,332,162,170
050,35,055,"New Mexico","Taos County",4,21,297,162,135
050,35,055,"New Mexico","Taos County",4,22,294,160,134
050,35,055,"New Mexico","Taos County",4,23,268,140,128
050,35,055,"New Mexico","Taos County",4,24,275,146,129
050,35,055,"New Mexico","Taos County",4,25,287,148,139
050,35,055,"New Mexico","Taos County",4,26,298,151,147
050,35,055,"New Mexico","Taos County",4,27,290,158,132
050,35,055,"New Mexico","Taos County",4,28,296,157,139
050,35,055,"New Mexico","Taos County",4,29,331,174,157
050,35,055,"New Mexico","Taos County",4,30,353,174,179
050,35,055,"New Mexico","Taos County",4,31,381,216,165
050,35,055,"New Mexico","Taos County",4,32,371,192,179
050,35,055,"New Mexico","Taos County",4,33,353,166,187
050,35,055,"New Mexico","Taos County",4,34,381,186,195
050,35,055,"New Mexico","Taos County",4,35,377,193,184
050,35,055,"New Mexico","Taos County",4,36,385,199,186
050,35,055,"New Mexico","Taos County",4,37,373,188,185
050,35,055,"New Mexico","Taos County",4,38,386,191,195
050,35,055,"New Mexico","Taos County",4,39,375,183,192
050,35,055,"New Mexico","Taos County",4,40,378,187,191
050,35,055,"New Mexico","Taos County",4,41,429,208,221
050,35,055,"New Mexico","Taos County",4,42,403,206,197
050,35,055,"New Mexico","Taos County",4,43,350,161,189
050,35,055,"New Mexico","Taos County",4,44,372,189,183
050,35,055,"New Mexico","Taos County",4,45,411,222,189
050,35,055,"New Mexico","Taos County",4,46,412,226,186
050,35,055,"New Mexico","Taos County",4,47,352,190,162
050,35,055,"New Mexico","Taos County",4,48,348,178,170
050,35,055,"New Mexico","Taos County",4,49,342,167,175
050,35,055,"New Mexico","Taos County",4,50,397,196,201
050,35,055,"New Mexico","Taos County",4,51,447,231,216
050,35,055,"New Mexico","Taos County",4,52,447,229,218
050,35,055,"New Mexico","Taos County",4,53,440,220,220
050,35,055,"New Mexico","Taos County",4,54,438,221,217
050,35,055,"New Mexico","Taos County",4,55,454,245,209
050,35,055,"New Mexico","Taos County",4,56,440,220,220
050,35,055,"New Mexico","Taos County",4,57,466,221,245
050,35,055,"New Mexico","Taos County",4,58,510,229,281
050,35,055,"New Mexico","Taos County",4,59,548,247,301
050,35,055,"New Mexico","Taos County",4,60,563,256,307
050,35,055,"New Mexico","Taos County",4,61,579,258,321
050,35,055,"New Mexico","Taos County",4,62,573,247,326
050,35,055,"New Mexico","Taos County",4,63,576,274,302
050,35,055,"New Mexico","Taos County",4,64,575,277,298
050,35,055,"New Mexico","Taos County",4,65,612,298,314
050,35,055,"New Mexico","Taos County",4,66,604,278,326
050,35,055,"New Mexico","Taos County",4,67,623,293,330
050,35,055,"New Mexico","Taos County",4,68,640,313,327
050,35,055,"New Mexico","Taos County",4,69,674,311,363
050,35,055,"New Mexico","Taos County",4,70,656,306,350
050,35,055,"New Mexico","Taos County",4,71,636,311,325
050,35,055,"New Mexico","Taos County",4,72,610,287,323
050,35,055,"New Mexico","Taos County",4,73,604,283,321
050,35,055,"New Mexico","Taos County",4,74,558,256,302
050,35,055,"New Mexico","Taos County",4,75,588,275,313
050,35,055,"New Mexico","Taos County",4,76,426,196,230
050,35,055,"New Mexico","Taos County",4,77,413,201,212
050,35,055,"New Mexico","Taos County",4,78,402,187,215
050,35,055,"New Mexico","Taos County",4,79,347,157,190
050,35,055,"New Mexico","Taos County",4,80,278,127,151
050,35,055,"New Mexico","Taos County",4,81,264,133,131
050,35,055,"New Mexico","Taos County",4,82,252,128,124
050,35,055,"New Mexico","Taos County",4,83,218,94,124
050,35,055,"New Mexico","Taos County",4,84,190,80,110
050,35,055,"New Mexico","Taos County",4,85,960,410,550
050,35,055,"New Mexico","Taos County",5,0,235,133,102
050,35,055,"New Mexico","Taos County",5,1,224,124,100
050,35,055,"New Mexico","Taos County",5,2,239,130,109
050,35,055,"New Mexico","Taos County",5,3,230,106,124
050,35,055,"New Mexico","Taos County",5,4,276,137,139
050,35,055,"New Mexico","Taos County",5,5,260,124,136
050,35,055,"New Mexico","Taos County",5,6,287,138,149
050,35,055,"New Mexico","Taos County",5,7,300,139,161
050,35,055,"New Mexico","Taos County",5,8,300,138,162
050,35,055,"New Mexico","Taos County",5,9,277,142,135
050,35,055,"New Mexico","Taos County",5,10,297,138,159
050,35,055,"New Mexico","Taos County",5,11,314,165,149
050,35,055,"New Mexico","Taos County",5,12,310,166,144
050,35,055,"New Mexico","Taos County",5,13,310,165,145
050,35,055,"New Mexico","Taos County",5,14,327,170,157
050,35,055,"New Mexico","Taos County",5,15,355,182,173
050,35,055,"New Mexico","Taos County",5,16,383,193,190
050,35,055,"New Mexico","Taos County",5,17,353,183,170
050,35,055,"New Mexico","Taos County",5,18,330,171,159
050,35,055,"New Mexico","Taos County",5,19,301,155,146
050,35,055,"New Mexico","Taos County",5,20,338,164,174
050,35,055,"New Mexico","Taos County",5,21,310,154,156
050,35,055,"New Mexico","Taos County",5,22,302,163,139
050,35,055,"New Mexico","Taos County",5,23,285,155,130
050,35,055,"New Mexico","Taos County",5,24,276,147,129
050,35,055,"New Mexico","Taos County",5,25,270,139,131
050,35,055,"New Mexico","Taos County",5,26,275,137,138
050,35,055,"New Mexico","Taos County",5,27,291,147,144
050,35,055,"New Mexico","Taos County",5,28,290,160,130
050,35,055,"New Mexico","Taos County",5,29,310,156,154
050,35,055,"New Mexico","Taos County",5,30,343,179,164
050,35,055,"New Mexico","Taos County",5,31,337,159,178
050,35,055,"New Mexico","Taos County",5,32,376,205,171
050,35,055,"New Mexico","Taos County",5,33,385,198,187
050,35,055,"New Mexico","Taos County",5,34,339,161,178
050,35,055,"New Mexico","Taos County",5,35,393,191,202
050,35,055,"New Mexico","Taos County",5,36,372,192,180
050,35,055,"New Mexico","Taos County",5,37,383,195,188
050,35,055,"New Mexico","Taos County",5,38,376,193,183
050,35,055,"New Mexico","Taos County",5,39,390,192,198
050,35,055,"New Mexico","Taos County",5,40,366,173,193
050,35,055,"New Mexico","Taos County",5,41,400,195,205
050,35,055,"New Mexico","Taos County",5,42,429,215,214
050,35,055,"New Mexico","Taos County",5,43,405,207,198
050,35,055,"New Mexico","Taos County",5,44,353,166,187
050,35,055,"New Mexico","Taos County",5,45,386,190,196
050,35,055,"New Mexico","Taos County",5,46,416,228,188
050,35,055,"New Mexico","Taos County",5,47,410,225,185
050,35,055,"New Mexico","Taos County",5,48,344,182,162
050,35,055,"New Mexico","Taos County",5,49,337,169,168
050,35,055,"New Mexico","Taos County",5,50,350,168,182
050,35,055,"New Mexico","Taos County",5,51,415,212,203
050,35,055,"New Mexico","Taos County",5,52,453,237,216
050,35,055,"New Mexico","Taos County",5,53,447,224,223
050,35,055,"New Mexico","Taos County",5,54,442,213,229
050,35,055,"New Mexico","Taos County",5,55,435,211,224
050,35,055,"New Mexico","Taos County",5,56,453,248,205
050,35,055,"New Mexico","Taos County",5,57,438,218,220
050,35,055,"New Mexico","Taos County",5,58,455,214,241
050,35,055,"New Mexico","Taos County",5,59,519,227,292
050,35,055,"New Mexico","Taos County",5,60,546,243,303
050,35,055,"New Mexico","Taos County",5,61,570,255,315
050,35,055,"New Mexico","Taos County",5,62,576,253,323
050,35,055,"New Mexico","Taos County",5,63,576,248,328
050,35,055,"New Mexico","Taos County",5,64,571,278,293
050,35,055,"New Mexico","Taos County",5,65,557,273,284
050,35,055,"New Mexico","Taos County",5,66,604,298,306
050,35,055,"New Mexico","Taos County",5,67,601,277,324
050,35,055,"New Mexico","Taos County",5,68,632,299,333
050,35,055,"New Mexico","Taos County",5,69,637,310,327
050,35,055,"New Mexico","Taos County",5,70,659,301,358
050,35,055,"New Mexico","Taos County",5,71,631,295,336
050,35,055,"New Mexico","Taos County",5,72,605,297,308
050,35,055,"New Mexico","Taos County",5,73,591,282,309
050,35,055,"New Mexico","Taos County",5,74,592,278,314
050,35,055,"New Mexico","Taos County",5,75,553,251,302
050,35,055,"New Mexico","Taos County",5,76,580,267,313
050,35,055,"New Mexico","Taos County",5,77,408,193,215
050,35,055,"New Mexico","Taos County",5,78,399,186,213
050,35,055,"New Mexico","Taos County",5,79,394,183,211
050,35,055,"New Mexico","Taos County",5,80,336,153,183
050,35,055,"New Mexico","Taos County",5,81,255,113,142
050,35,055,"New Mexico","Taos County",5,82,251,128,123
050,35,055,"New Mexico","Taos County",5,83,232,121,111
050,35,055,"New Mexico","Taos County",5,84,197,79,118
050,35,055,"New Mexico","Taos County",5,85,1050,434,616
050,35,057,"New Mexico","Torrance County",1,0,152,76,76
050,35,057,"New Mexico","Torrance County",1,1,151,71,80
050,35,057,"New Mexico","Torrance County",1,2,165,76,89
050,35,057,"New Mexico","Torrance County",1,3,156,75,81
050,35,057,"New Mexico","Torrance County",1,4,161,80,81
050,35,057,"New Mexico","Torrance County",1,5,172,89,83
050,35,057,"New Mexico","Torrance County",1,6,147,74,73
050,35,057,"New Mexico","Torrance County",1,7,165,92,73
050,35,057,"New Mexico","Torrance County",1,8,175,92,83
050,35,057,"New Mexico","Torrance County",1,9,158,86,72
050,35,057,"New Mexico","Torrance County",1,10,178,99,79
050,35,057,"New Mexico","Torrance County",1,11,178,86,92
050,35,057,"New Mexico","Torrance County",1,12,196,92,104
050,35,057,"New Mexico","Torrance County",1,13,195,95,100
050,35,057,"New Mexico","Torrance County",1,14,214,96,118
050,35,057,"New Mexico","Torrance County",1,15,214,104,110
050,35,057,"New Mexico","Torrance County",1,16,194,96,98
050,35,057,"New Mexico","Torrance County",1,17,190,107,83
050,35,057,"New Mexico","Torrance County",1,18,202,113,89
050,35,057,"New Mexico","Torrance County",1,19,162,83,79
050,35,057,"New Mexico","Torrance County",1,20,166,90,76
050,35,057,"New Mexico","Torrance County",1,21,151,83,68
050,35,057,"New Mexico","Torrance County",1,22,156,94,62
050,35,057,"New Mexico","Torrance County",1,23,147,85,62
050,35,057,"New Mexico","Torrance County",1,24,167,97,70
050,35,057,"New Mexico","Torrance County",1,25,156,94,62
050,35,057,"New Mexico","Torrance County",1,26,184,115,69
050,35,057,"New Mexico","Torrance County",1,27,147,90,57
050,35,057,"New Mexico","Torrance County",1,28,181,105,76
050,35,057,"New Mexico","Torrance County",1,29,155,87,68
050,35,057,"New Mexico","Torrance County",1,30,170,86,84
050,35,057,"New Mexico","Torrance County",1,31,169,87,82
050,35,057,"New Mexico","Torrance County",1,32,143,75,68
050,35,057,"New Mexico","Torrance County",1,33,156,91,65
050,35,057,"New Mexico","Torrance County",1,34,181,109,72
050,35,057,"New Mexico","Torrance County",1,35,166,100,66
050,35,057,"New Mexico","Torrance County",1,36,163,95,68
050,35,057,"New Mexico","Torrance County",1,37,161,81,80
050,35,057,"New Mexico","Torrance County",1,38,156,77,79
050,35,057,"New Mexico","Torrance County",1,39,187,100,87
050,35,057,"New Mexico","Torrance County",1,40,170,87,83
050,35,057,"New Mexico","Torrance County",1,41,153,76,77
050,35,057,"New Mexico","Torrance County",1,42,179,90,89
050,35,057,"New Mexico","Torrance County",1,43,162,88,74
050,35,057,"New Mexico","Torrance County",1,44,176,98,78
050,35,057,"New Mexico","Torrance County",1,45,169,97,72
050,35,057,"New Mexico","Torrance County",1,46,165,92,73
050,35,057,"New Mexico","Torrance County",1,47,163,89,74
050,35,057,"New Mexico","Torrance County",1,48,181,95,86
050,35,057,"New Mexico","Torrance County",1,49,178,87,91
050,35,057,"New Mexico","Torrance County",1,50,189,98,91
050,35,057,"New Mexico","Torrance County",1,51,184,99,85
050,35,057,"New Mexico","Torrance County",1,52,175,90,85
050,35,057,"New Mexico","Torrance County",1,53,173,88,85
050,35,057,"New Mexico","Torrance County",1,54,178,98,80
050,35,057,"New Mexico","Torrance County",1,55,198,97,101
050,35,057,"New Mexico","Torrance County",1,56,228,99,129
050,35,057,"New Mexico","Torrance County",1,57,226,120,106
050,35,057,"New Mexico","Torrance County",1,58,227,109,118
050,35,057,"New Mexico","Torrance County",1,59,252,114,138
050,35,057,"New Mexico","Torrance County",1,60,231,115,116
050,35,057,"New Mexico","Torrance County",1,61,241,118,123
050,35,057,"New Mexico","Torrance County",1,62,230,115,115
050,35,057,"New Mexico","Torrance County",1,63,248,131,117
050,35,057,"New Mexico","Torrance County",1,64,248,126,122
050,35,057,"New Mexico","Torrance County",1,65,231,119,112
050,35,057,"New Mexico","Torrance County",1,66,243,119,124
050,35,057,"New Mexico","Torrance County",1,67,247,122,125
050,35,057,"New Mexico","Torrance County",1,68,228,124,104
050,35,057,"New Mexico","Torrance County",1,69,227,131,96
050,35,057,"New Mexico","Torrance County",1,70,200,107,93
050,35,057,"New Mexico","Torrance County",1,71,203,99,104
050,35,057,"New Mexico","Torrance County",1,72,197,98,99
050,35,057,"New Mexico","Torrance County",1,73,214,109,105
050,35,057,"New Mexico","Torrance County",1,74,152,73,79
050,35,057,"New Mexico","Torrance County",1,75,132,73,59
050,35,057,"New Mexico","Torrance County",1,76,126,67,59
050,35,057,"New Mexico","Torrance County",1,77,115,54,61
050,35,057,"New Mexico","Torrance County",1,78,103,49,54
050,35,057,"New Mexico","Torrance County",1,79,95,52,43
050,35,057,"New Mexico","Torrance County",1,80,94,48,46
050,35,057,"New Mexico","Torrance County",1,81,79,41,38
050,35,057,"New Mexico","Torrance County",1,82,73,44,29
050,35,057,"New Mexico","Torrance County",1,83,61,32,29
050,35,057,"New Mexico","Torrance County",1,84,55,27,28
050,35,057,"New Mexico","Torrance County",1,85,266,116,150
050,35,057,"New Mexico","Torrance County",2,0,148,72,76
050,35,057,"New Mexico","Torrance County",2,1,154,73,81
050,35,057,"New Mexico","Torrance County",2,2,165,77,88
050,35,057,"New Mexico","Torrance County",2,3,160,77,83
050,35,057,"New Mexico","Torrance County",2,4,161,82,79
050,35,057,"New Mexico","Torrance County",2,5,172,87,85
050,35,057,"New Mexico","Torrance County",2,6,156,79,77
050,35,057,"New Mexico","Torrance County",2,7,160,89,71
050,35,057,"New Mexico","Torrance County",2,8,172,92,80
050,35,057,"New Mexico","Torrance County",2,9,160,86,74
050,35,057,"New Mexico","Torrance County",2,10,171,96,75
050,35,057,"New Mexico","Torrance County",2,11,177,89,88
050,35,057,"New Mexico","Torrance County",2,12,192,92,100
050,35,057,"New Mexico","Torrance County",2,13,197,95,102
050,35,057,"New Mexico","Torrance County",2,14,209,96,113
050,35,057,"New Mexico","Torrance County",2,15,216,103,113
050,35,057,"New Mexico","Torrance County",2,16,197,97,100
050,35,057,"New Mexico","Torrance County",2,17,192,106,86
050,35,057,"New Mexico","Torrance County",2,18,191,108,83
050,35,057,"New Mexico","Torrance County",2,19,166,88,78
050,35,057,"New Mexico","Torrance County",2,20,162,86,76
050,35,057,"New Mexico","Torrance County",2,21,154,85,69
050,35,057,"New Mexico","Torrance County",2,22,155,92,63
050,35,057,"New Mexico","Torrance County",2,23,145,85,60
050,35,057,"New Mexico","Torrance County",2,24,164,96,68
050,35,057,"New Mexico","Torrance County",2,25,160,97,63
050,35,057,"New Mexico","Torrance County",2,26,176,107,69
050,35,057,"New Mexico","Torrance County",2,27,156,96,60
050,35,057,"New Mexico","Torrance County",2,28,183,109,74
050,35,057,"New Mexico","Torrance County",2,29,157,86,71
050,35,057,"New Mexico","Torrance County",2,30,171,89,82
050,35,057,"New Mexico","Torrance County",2,31,165,84,81
050,35,057,"New Mexico","Torrance County",2,32,149,78,71
050,35,057,"New Mexico","Torrance County",2,33,151,84,67
050,35,057,"New Mexico","Torrance County",2,34,175,106,69
050,35,057,"New Mexico","Torrance County",2,35,174,106,68
050,35,057,"New Mexico","Torrance County",2,36,164,96,68
050,35,057,"New Mexico","Torrance County",2,37,162,83,79
050,35,057,"New Mexico","Torrance County",2,38,158,77,81
050,35,057,"New Mexico","Torrance County",2,39,184,99,85
050,35,057,"New Mexico","Torrance County",2,40,173,90,83
050,35,057,"New Mexico","Torrance County",2,41,156,78,78
050,35,057,"New Mexico","Torrance County",2,42,177,90,87
050,35,057,"New Mexico","Torrance County",2,43,167,89,78
050,35,057,"New Mexico","Torrance County",2,44,174,96,78
050,35,057,"New Mexico","Torrance County",2,45,167,94,73
050,35,057,"New Mexico","Torrance County",2,46,165,93,72
050,35,057,"New Mexico","Torrance County",2,47,163,90,73
050,35,057,"New Mexico","Torrance County",2,48,178,95,83
050,35,057,"New Mexico","Torrance County",2,49,177,87,90
050,35,057,"New Mexico","Torrance County",2,50,186,95,91
050,35,057,"New Mexico","Torrance County",2,51,185,100,85
050,35,057,"New Mexico","Torrance County",2,52,178,92,86
050,35,057,"New Mexico","Torrance County",2,53,174,90,84
050,35,057,"New Mexico","Torrance County",2,54,177,95,82
050,35,057,"New Mexico","Torrance County",2,55,197,100,97
050,35,057,"New Mexico","Torrance County",2,56,221,97,124
050,35,057,"New Mexico","Torrance County",2,57,230,118,112
050,35,057,"New Mexico","Torrance County",2,58,225,109,116
050,35,057,"New Mexico","Torrance County",2,59,248,113,135
050,35,057,"New Mexico","Torrance County",2,60,240,117,123
050,35,057,"New Mexico","Torrance County",2,61,237,117,120
050,35,057,"New Mexico","Torrance County",2,62,229,114,115
050,35,057,"New Mexico","Torrance County",2,63,245,128,117
050,35,057,"New Mexico","Torrance County",2,64,246,126,120
050,35,057,"New Mexico","Torrance County",2,65,238,121,117
050,35,057,"New Mexico","Torrance County",2,66,241,120,121
050,35,057,"New Mexico","Torrance County",2,67,246,122,124
050,35,057,"New Mexico","Torrance County",2,68,230,123,107
050,35,057,"New Mexico","Torrance County",2,69,226,128,98
050,35,057,"New Mexico","Torrance County",2,70,205,113,92
050,35,057,"New Mexico","Torrance County",2,71,200,100,100
050,35,057,"New Mexico","Torrance County",2,72,196,97,99
050,35,057,"New Mexico","Torrance County",2,73,215,108,107
050,35,057,"New Mexico","Torrance County",2,74,158,77,81
050,35,057,"New Mexico","Torrance County",2,75,137,72,65
050,35,057,"New Mexico","Torrance County",2,76,125,67,58
050,35,057,"New Mexico","Torrance County",2,77,118,58,60
050,35,057,"New Mexico","Torrance County",2,78,104,49,55
050,35,057,"New Mexico","Torrance County",2,79,95,50,45
050,35,057,"New Mexico","Torrance County",2,80,92,49,43
050,35,057,"New Mexico","Torrance County",2,81,80,42,38
050,35,057,"New Mexico","Torrance County",2,82,75,44,31
050,35,057,"New Mexico","Torrance County",2,83,62,33,29
050,35,057,"New Mexico","Torrance County",2,84,54,28,26
050,35,057,"New Mexico","Torrance County",2,85,269,118,151
050,35,057,"New Mexico","Torrance County",3,0,157,65,92
050,35,057,"New Mexico","Torrance County",3,1,155,67,88
050,35,057,"New Mexico","Torrance County",3,2,158,76,82
050,35,057,"New Mexico","Torrance County",3,3,156,71,85
050,35,057,"New Mexico","Torrance County",3,4,174,90,84
050,35,057,"New Mexico","Torrance County",3,5,162,77,85
050,35,057,"New Mexico","Torrance County",3,6,173,83,90
050,35,057,"New Mexico","Torrance County",3,7,151,79,72
050,35,057,"New Mexico","Torrance County",3,8,170,95,75
050,35,057,"New Mexico","Torrance County",3,9,175,89,86
050,35,057,"New Mexico","Torrance County",3,10,159,88,71
050,35,057,"New Mexico","Torrance County",3,11,169,89,80
050,35,057,"New Mexico","Torrance County",3,12,189,102,87
050,35,057,"New Mexico","Torrance County",3,13,193,88,105
050,35,057,"New Mexico","Torrance County",3,14,200,102,98
050,35,057,"New Mexico","Torrance County",3,15,213,96,117
050,35,057,"New Mexico","Torrance County",3,16,216,106,110
050,35,057,"New Mexico","Torrance County",3,17,203,105,98
050,35,057,"New Mexico","Torrance County",3,18,166,84,82
050,35,057,"New Mexico","Torrance County",3,19,173,93,80
050,35,057,"New Mexico","Torrance County",3,20,167,95,72
050,35,057,"New Mexico","Torrance County",3,21,161,79,82
050,35,057,"New Mexico","Torrance County",3,22,179,99,80
050,35,057,"New Mexico","Torrance County",3,23,166,103,63
050,35,057,"New Mexico","Torrance County",3,24,170,106,64
050,35,057,"New Mexico","Torrance County",3,25,169,102,67
050,35,057,"New Mexico","Torrance County",3,26,168,90,78
050,35,057,"New Mexico","Torrance County",3,27,182,103,79
050,35,057,"New Mexico","Torrance County",3,28,194,124,70
050,35,057,"New Mexico","Torrance County",3,29,165,90,75
050,35,057,"New Mexico","Torrance County",3,30,167,94,73
050,35,057,"New Mexico","Torrance County",3,31,172,88,84
050,35,057,"New Mexico","Torrance County",3,32,161,79,82
050,35,057,"New Mexico","Torrance County",3,33,153,79,74
050,35,057,"New Mexico","Torrance County",3,34,170,99,71
050,35,057,"New Mexico","Torrance County",3,35,181,113,68
050,35,057,"New Mexico","Torrance County",3,36,177,102,75
050,35,057,"New Mexico","Torrance County",3,37,157,89,68
050,35,057,"New Mexico","Torrance County",3,38,159,86,73
050,35,057,"New Mexico","Torrance County",3,39,178,101,77
050,35,057,"New Mexico","Torrance County",3,40,174,82,92
050,35,057,"New Mexico","Torrance County",3,41,166,86,80
050,35,057,"New Mexico","Torrance County",3,42,178,94,84
050,35,057,"New Mexico","Torrance County",3,43,172,81,91
050,35,057,"New Mexico","Torrance County",3,44,184,100,84
050,35,057,"New Mexico","Torrance County",3,45,163,87,76
050,35,057,"New Mexico","Torrance County",3,46,171,94,77
050,35,057,"New Mexico","Torrance County",3,47,167,93,74
050,35,057,"New Mexico","Torrance County",3,48,169,93,76
050,35,057,"New Mexico","Torrance County",3,49,178,92,86
050,35,057,"New Mexico","Torrance County",3,50,190,95,95
050,35,057,"New Mexico","Torrance County",3,51,198,100,98
050,35,057,"New Mexico","Torrance County",3,52,186,99,87
050,35,057,"New Mexico","Torrance County",3,53,176,93,83
050,35,057,"New Mexico","Torrance County",3,54,183,93,90
050,35,057,"New Mexico","Torrance County",3,55,192,111,81
050,35,057,"New Mexico","Torrance County",3,56,203,100,103
050,35,057,"New Mexico","Torrance County",3,57,225,103,122
050,35,057,"New Mexico","Torrance County",3,58,222,106,116
050,35,057,"New Mexico","Torrance County",3,59,224,101,123
050,35,057,"New Mexico","Torrance County",3,60,252,107,145
050,35,057,"New Mexico","Torrance County",3,61,235,113,122
050,35,057,"New Mexico","Torrance County",3,62,232,115,117
050,35,057,"New Mexico","Torrance County",3,63,237,119,118
050,35,057,"New Mexico","Torrance County",3,64,248,130,118
050,35,057,"New Mexico","Torrance County",3,65,236,121,115
050,35,057,"New Mexico","Torrance County",3,66,241,120,121
050,35,057,"New Mexico","Torrance County",3,67,239,125,114
050,35,057,"New Mexico","Torrance County",3,68,238,114,124
050,35,057,"New Mexico","Torrance County",3,69,230,124,106
050,35,057,"New Mexico","Torrance County",3,70,228,131,97
050,35,057,"New Mexico","Torrance County",3,71,204,111,93
050,35,057,"New Mexico","Torrance County",3,72,199,101,98
050,35,057,"New Mexico","Torrance County",3,73,195,96,99
050,35,057,"New Mexico","Torrance County",3,74,212,101,111
050,35,057,"New Mexico","Torrance County",3,75,145,67,78
050,35,057,"New Mexico","Torrance County",3,76,131,71,60
050,35,057,"New Mexico","Torrance County",3,77,120,65,55
050,35,057,"New Mexico","Torrance County",3,78,115,57,58
050,35,057,"New Mexico","Torrance County",3,79,101,48,53
050,35,057,"New Mexico","Torrance County",3,80,89,43,46
050,35,057,"New Mexico","Torrance County",3,81,91,48,43
050,35,057,"New Mexico","Torrance County",3,82,72,37,35
050,35,057,"New Mexico","Torrance County",3,83,65,39,26
050,35,057,"New Mexico","Torrance County",3,84,59,31,28
050,35,057,"New Mexico","Torrance County",3,85,270,125,145
050,35,057,"New Mexico","Torrance County",4,0,153,71,82
050,35,057,"New Mexico","Torrance County",4,1,170,67,103
050,35,057,"New Mexico","Torrance County",4,2,142,64,78
050,35,057,"New Mexico","Torrance County",4,3,164,79,85
050,35,057,"New Mexico","Torrance County",4,4,169,84,85
050,35,057,"New Mexico","Torrance County",4,5,176,88,88
050,35,057,"New Mexico","Torrance County",4,6,181,86,95
050,35,057,"New Mexico","Torrance County",4,7,182,86,96
050,35,057,"New Mexico","Torrance County",4,8,163,83,80
050,35,057,"New Mexico","Torrance County",4,9,177,100,77
050,35,057,"New Mexico","Torrance County",4,10,180,95,85
050,35,057,"New Mexico","Torrance County",4,11,156,85,71
050,35,057,"New Mexico","Torrance County",4,12,171,98,73
050,35,057,"New Mexico","Torrance County",4,13,195,104,91
050,35,057,"New Mexico","Torrance County",4,14,195,93,102
050,35,057,"New Mexico","Torrance County",4,15,201,103,98
050,35,057,"New Mexico","Torrance County",4,16,215,96,119
050,35,057,"New Mexico","Torrance County",4,17,231,112,119
050,35,057,"New Mexico","Torrance County",4,18,191,100,91
050,35,057,"New Mexico","Torrance County",4,19,136,73,63
050,35,057,"New Mexico","Torrance County",4,20,166,90,76
050,35,057,"New Mexico","Torrance County",4,21,158,86,72
050,35,057,"New Mexico","Torrance County",4,22,173,94,79
050,35,057,"New Mexico","Torrance County",4,23,191,105,86
050,35,057,"New Mexico","Torrance County",4,24,187,110,77
050,35,057,"New Mexico","Torrance County",4,25,161,103,58
050,35,057,"New Mexico","Torrance County",4,26,158,88,70
050,35,057,"New Mexico","Torrance County",4,27,171,94,77
050,35,057,"New Mexico","Torrance County",4,28,197,123,74
050,35,057,"New Mexico","Torrance County",4,29,179,104,75
050,35,057,"New Mexico","Torrance County",4,30,194,105,89
050,35,057,"New Mexico","Torrance County",4,31,164,94,70
050,35,057,"New Mexico","Torrance County",4,32,164,76,88
050,35,057,"New Mexico","Torrance County",4,33,171,76,95
050,35,057,"New Mexico","Torrance County",4,34,163,93,70
050,35,057,"New Mexico","Torrance County",4,35,182,105,77
050,35,057,"New Mexico","Torrance County",4,36,181,106,75
050,35,057,"New Mexico","Torrance County",4,37,171,98,73
050,35,057,"New Mexico","Torrance County",4,38,157,88,69
050,35,057,"New Mexico","Torrance County",4,39,170,94,76
050,35,057,"New Mexico","Torrance County",4,40,159,79,80
050,35,057,"New Mexico","Torrance County",4,41,172,80,92
050,35,057,"New Mexico","Torrance County",4,42,180,98,82
050,35,057,"New Mexico","Torrance County",4,43,180,97,83
050,35,057,"New Mexico","Torrance County",4,44,170,80,90
050,35,057,"New Mexico","Torrance County",4,45,172,93,79
050,35,057,"New Mexico","Torrance County",4,46,164,87,77
050,35,057,"New Mexico","Torrance County",4,47,176,96,80
050,35,057,"New Mexico","Torrance County",4,48,169,97,72
050,35,057,"New Mexico","Torrance County",4,49,159,85,74
050,35,057,"New Mexico","Torrance County",4,50,186,100,86
050,35,057,"New Mexico","Torrance County",4,51,186,91,95
050,35,057,"New Mexico","Torrance County",4,52,194,100,94
050,35,057,"New Mexico","Torrance County",4,53,184,96,88
050,35,057,"New Mexico","Torrance County",4,54,180,97,83
050,35,057,"New Mexico","Torrance County",4,55,191,99,92
050,35,057,"New Mexico","Torrance County",4,56,181,106,75
050,35,057,"New Mexico","Torrance County",4,57,213,107,106
050,35,057,"New Mexico","Torrance County",4,58,219,98,121
050,35,057,"New Mexico","Torrance County",4,59,208,100,108
050,35,057,"New Mexico","Torrance County",4,60,223,102,121
050,35,057,"New Mexico","Torrance County",4,61,247,105,142
050,35,057,"New Mexico","Torrance County",4,62,242,113,129
050,35,057,"New Mexico","Torrance County",4,63,238,123,115
050,35,057,"New Mexico","Torrance County",4,64,238,120,118
050,35,057,"New Mexico","Torrance County",4,65,245,128,117
050,35,057,"New Mexico","Torrance County",4,66,231,116,115
050,35,057,"New Mexico","Torrance County",4,67,242,121,121
050,35,057,"New Mexico","Torrance County",4,68,234,122,112
050,35,057,"New Mexico","Torrance County",4,69,224,109,115
050,35,057,"New Mexico","Torrance County",4,70,225,124,101
050,35,057,"New Mexico","Torrance County",4,71,222,127,95
050,35,057,"New Mexico","Torrance County",4,72,198,107,91
050,35,057,"New Mexico","Torrance County",4,73,197,99,98
050,35,057,"New Mexico","Torrance County",4,74,198,97,101
050,35,057,"New Mexico","Torrance County",4,75,199,95,104
050,35,057,"New Mexico","Torrance County",4,76,139,62,77
050,35,057,"New Mexico","Torrance County",4,77,117,63,54
050,35,057,"New Mexico","Torrance County",4,78,108,58,50
050,35,057,"New Mexico","Torrance County",4,79,109,53,56
050,35,057,"New Mexico","Torrance County",4,80,91,42,49
050,35,057,"New Mexico","Torrance County",4,81,85,40,45
050,35,057,"New Mexico","Torrance County",4,82,83,44,39
050,35,057,"New Mexico","Torrance County",4,83,62,28,34
050,35,057,"New Mexico","Torrance County",4,84,59,37,22
050,35,057,"New Mexico","Torrance County",4,85,278,139,139
050,35,057,"New Mexico","Torrance County",5,0,152,70,82
050,35,057,"New Mexico","Torrance County",5,1,162,66,96
050,35,057,"New Mexico","Torrance County",5,2,174,75,99
050,35,057,"New Mexico","Torrance County",5,3,148,70,78
050,35,057,"New Mexico","Torrance County",5,4,157,81,76
050,35,057,"New Mexico","Torrance County",5,5,166,83,83
050,35,057,"New Mexico","Torrance County",5,6,197,104,93
050,35,057,"New Mexico","Torrance County",5,7,177,80,97
050,35,057,"New Mexico","Torrance County",5,8,190,92,98
050,35,057,"New Mexico","Torrance County",5,9,173,83,90
050,35,057,"New Mexico","Torrance County",5,10,186,101,85
050,35,057,"New Mexico","Torrance County",5,11,188,101,87
050,35,057,"New Mexico","Torrance County",5,12,157,86,71
050,35,057,"New Mexico","Torrance County",5,13,183,99,84
050,35,057,"New Mexico","Torrance County",5,14,199,108,91
050,35,057,"New Mexico","Torrance County",5,15,192,88,104
050,35,057,"New Mexico","Torrance County",5,16,207,105,102
050,35,057,"New Mexico","Torrance County",5,17,219,100,119
050,35,057,"New Mexico","Torrance County",5,18,210,101,109
050,35,057,"New Mexico","Torrance County",5,19,170,93,77
050,35,057,"New Mexico","Torrance County",5,20,130,63,67
050,35,057,"New Mexico","Torrance County",5,21,174,96,78
050,35,057,"New Mexico","Torrance County",5,22,183,102,81
050,35,057,"New Mexico","Torrance County",5,23,175,95,80
050,35,057,"New Mexico","Torrance County",5,24,217,118,99
050,35,057,"New Mexico","Torrance County",5,25,184,108,76
050,35,057,"New Mexico","Torrance County",5,26,157,95,62
050,35,057,"New Mexico","Torrance County",5,27,154,87,67
050,35,057,"New Mexico","Torrance County",5,28,192,116,76
050,35,057,"New Mexico","Torrance County",5,29,178,102,76
050,35,057,"New Mexico","Torrance County",5,30,203,118,85
050,35,057,"New Mexico","Torrance County",5,31,196,107,89
050,35,057,"New Mexico","Torrance County",5,32,158,90,68
050,35,057,"New Mexico","Torrance County",5,33,162,81,81
050,35,057,"New Mexico","Torrance County",5,34,187,88,99
050,35,057,"New Mexico","Torrance County",5,35,172,97,75
050,35,057,"New Mexico","Torrance County",5,36,182,103,79
050,35,057,"New Mexico","Torrance County",5,37,183,107,76
050,35,057,"New Mexico","Torrance County",5,38,167,95,72
050,35,057,"New Mexico","Torrance County",5,39,175,102,73
050,35,057,"New Mexico","Torrance County",5,40,159,79,80
050,35,057,"New Mexico","Torrance County",5,41,159,81,78
050,35,057,"New Mexico","Torrance County",5,42,195,100,95
050,35,057,"New Mexico","Torrance County",5,43,185,103,82
050,35,057,"New Mexico","Torrance County",5,44,186,106,80
050,35,057,"New Mexico","Torrance County",5,45,170,81,89
050,35,057,"New Mexico","Torrance County",5,46,176,96,80
050,35,057,"New Mexico","Torrance County",5,47,182,99,83
050,35,057,"New Mexico","Torrance County",5,48,174,97,77
050,35,057,"New Mexico","Torrance County",5,49,165,90,75
050,35,057,"New Mexico","Torrance County",5,50,166,85,81
050,35,057,"New Mexico","Torrance County",5,51,184,98,86
050,35,057,"New Mexico","Torrance County",5,52,188,92,96
050,35,057,"New Mexico","Torrance County",5,53,193,100,93
050,35,057,"New Mexico","Torrance County",5,54,190,97,93
050,35,057,"New Mexico","Torrance County",5,55,183,100,83
050,35,057,"New Mexico","Torrance County",5,56,200,103,97
050,35,057,"New Mexico","Torrance County",5,57,191,112,79
050,35,057,"New Mexico","Torrance County",5,58,207,99,108
050,35,057,"New Mexico","Torrance County",5,59,236,101,135
050,35,057,"New Mexico","Torrance County",5,60,221,103,118
050,35,057,"New Mexico","Torrance County",5,61,224,104,120
050,35,057,"New Mexico","Torrance County",5,62,244,105,139
050,35,057,"New Mexico","Torrance County",5,63,237,111,126
050,35,057,"New Mexico","Torrance County",5,64,229,123,106
050,35,057,"New Mexico","Torrance County",5,65,231,124,107
050,35,057,"New Mexico","Torrance County",5,66,257,133,124
050,35,057,"New Mexico","Torrance County",5,67,233,117,116
050,35,057,"New Mexico","Torrance County",5,68,233,110,123
050,35,057,"New Mexico","Torrance County",5,69,227,122,105
050,35,057,"New Mexico","Torrance County",5,70,228,108,120
050,35,057,"New Mexico","Torrance County",5,71,220,118,102
050,35,057,"New Mexico","Torrance County",5,72,225,130,95
050,35,057,"New Mexico","Torrance County",5,73,197,104,93
050,35,057,"New Mexico","Torrance County",5,74,196,101,95
050,35,057,"New Mexico","Torrance County",5,75,183,84,99
050,35,057,"New Mexico","Torrance County",5,76,193,91,102
050,35,057,"New Mexico","Torrance County",5,77,128,54,74
050,35,057,"New Mexico","Torrance County",5,78,110,56,54
050,35,057,"New Mexico","Torrance County",5,79,103,54,49
050,35,057,"New Mexico","Torrance County",5,80,103,51,52
050,35,057,"New Mexico","Torrance County",5,81,89,38,51
050,35,057,"New Mexico","Torrance County",5,82,79,39,40
050,35,057,"New Mexico","Torrance County",5,83,73,36,37
050,35,057,"New Mexico","Torrance County",5,84,51,24,27
050,35,057,"New Mexico","Torrance County",5,85,294,157,137
050,35,059,"New Mexico","Union County",1,0,42,21,21
050,35,059,"New Mexico","Union County",1,1,47,20,27
050,35,059,"New Mexico","Union County",1,2,44,25,19
050,35,059,"New Mexico","Union County",1,3,47,27,20
050,35,059,"New Mexico","Union County",1,4,44,17,27
050,35,059,"New Mexico","Union County",1,5,47,26,21
050,35,059,"New Mexico","Union County",1,6,44,24,20
050,35,059,"New Mexico","Union County",1,7,46,25,21
050,35,059,"New Mexico","Union County",1,8,46,24,22
050,35,059,"New Mexico","Union County",1,9,53,29,24
050,35,059,"New Mexico","Union County",1,10,52,29,23
050,35,059,"New Mexico","Union County",1,11,38,16,22
050,35,059,"New Mexico","Union County",1,12,54,34,20
050,35,059,"New Mexico","Union County",1,13,53,24,29
050,35,059,"New Mexico","Union County",1,14,49,17,32
050,35,059,"New Mexico","Union County",1,15,46,24,22
050,35,059,"New Mexico","Union County",1,16,43,19,24
050,35,059,"New Mexico","Union County",1,17,48,22,26
050,35,059,"New Mexico","Union County",1,18,44,21,23
050,35,059,"New Mexico","Union County",1,19,40,20,20
050,35,059,"New Mexico","Union County",1,20,32,17,15
050,35,059,"New Mexico","Union County",1,21,37,28,9
050,35,059,"New Mexico","Union County",1,22,45,33,12
050,35,059,"New Mexico","Union County",1,23,38,25,13
050,35,059,"New Mexico","Union County",1,24,45,35,10
050,35,059,"New Mexico","Union County",1,25,55,40,15
050,35,059,"New Mexico","Union County",1,26,47,28,19
050,35,059,"New Mexico","Union County",1,27,54,36,18
050,35,059,"New Mexico","Union County",1,28,47,31,16
050,35,059,"New Mexico","Union County",1,29,58,36,22
050,35,059,"New Mexico","Union County",1,30,50,31,19
050,35,059,"New Mexico","Union County",1,31,51,33,18
050,35,059,"New Mexico","Union County",1,32,56,28,28
050,35,059,"New Mexico","Union County",1,33,44,30,14
050,35,059,"New Mexico","Union County",1,34,51,36,15
050,35,059,"New Mexico","Union County",1,35,46,30,16
050,35,059,"New Mexico","Union County",1,36,60,37,23
050,35,059,"New Mexico","Union County",1,37,48,25,23
050,35,059,"New Mexico","Union County",1,38,52,33,19
050,35,059,"New Mexico","Union County",1,39,51,33,18
050,35,059,"New Mexico","Union County",1,40,55,36,19
050,35,059,"New Mexico","Union County",1,41,65,42,23
050,35,059,"New Mexico","Union County",1,42,42,28,14
050,35,059,"New Mexico","Union County",1,43,49,30,19
050,35,059,"New Mexico","Union County",1,44,45,23,22
050,35,059,"New Mexico","Union County",1,45,40,21,19
050,35,059,"New Mexico","Union County",1,46,39,25,14
050,35,059,"New Mexico","Union County",1,47,53,30,23
050,35,059,"New Mexico","Union County",1,48,40,21,19
050,35,059,"New Mexico","Union County",1,49,55,28,27
050,35,059,"New Mexico","Union County",1,50,48,23,25
050,35,059,"New Mexico","Union County",1,51,39,23,16
050,35,059,"New Mexico","Union County",1,52,40,24,16
050,35,059,"New Mexico","Union County",1,53,41,24,17
050,35,059,"New Mexico","Union County",1,54,47,31,16
050,35,059,"New Mexico","Union County",1,55,46,27,19
050,35,059,"New Mexico","Union County",1,56,49,29,20
050,35,059,"New Mexico","Union County",1,57,53,25,28
050,35,059,"New Mexico","Union County",1,58,52,27,25
050,35,059,"New Mexico","Union County",1,59,53,26,27
050,35,059,"New Mexico","Union County",1,60,60,28,32
050,35,059,"New Mexico","Union County",1,61,67,32,35
050,35,059,"New Mexico","Union County",1,62,60,34,26
050,35,059,"New Mexico","Union County",1,63,54,31,23
050,35,059,"New Mexico","Union County",1,64,65,34,31
050,35,059,"New Mexico","Union County",1,65,67,32,35
050,35,059,"New Mexico","Union County",1,66,60,32,28
050,35,059,"New Mexico","Union County",1,67,55,32,23
050,35,059,"New Mexico","Union County",1,68,51,29,22
050,35,059,"New Mexico","Union County",1,69,42,13,29
050,35,059,"New Mexico","Union County",1,70,53,22,31
050,35,059,"New Mexico","Union County",1,71,48,23,25
050,35,059,"New Mexico","Union County",1,72,47,19,28
050,35,059,"New Mexico","Union County",1,73,48,21,27
050,35,059,"New Mexico","Union County",1,74,38,18,20
050,35,059,"New Mexico","Union County",1,75,43,21,22
050,35,059,"New Mexico","Union County",1,76,42,18,24
050,35,059,"New Mexico","Union County",1,77,40,19,21
050,35,059,"New Mexico","Union County",1,78,32,15,17
050,35,059,"New Mexico","Union County",1,79,20,8,12
050,35,059,"New Mexico","Union County",1,80,24,13,11
050,35,059,"New Mexico","Union County",1,81,20,10,10
050,35,059,"New Mexico","Union County",1,82,20,5,15
050,35,059,"New Mexico","Union County",1,83,28,14,14
050,35,059,"New Mexico","Union County",1,84,24,7,17
050,35,059,"New Mexico","Union County",1,85,129,37,92
050,35,059,"New Mexico","Union County",2,0,39,17,22
050,35,059,"New Mexico","Union County",2,1,46,21,25
050,35,059,"New Mexico","Union County",2,2,46,25,21
050,35,059,"New Mexico","Union County",2,3,45,25,20
050,35,059,"New Mexico","Union County",2,4,46,20,26
050,35,059,"New Mexico","Union County",2,5,46,24,22
050,35,059,"New Mexico","Union County",2,6,46,25,21
050,35,059,"New Mexico","Union County",2,7,44,24,20
050,35,059,"New Mexico","Union County",2,8,46,24,22
050,35,059,"New Mexico","Union County",2,9,53,29,24
050,35,059,"New Mexico","Union County",2,10,51,28,23
050,35,059,"New Mexico","Union County",2,11,39,18,21
050,35,059,"New Mexico","Union County",2,12,51,30,21
050,35,059,"New Mexico","Union County",2,13,54,26,28
050,35,059,"New Mexico","Union County",2,14,50,19,31
050,35,059,"New Mexico","Union County",2,15,47,22,25
050,35,059,"New Mexico","Union County",2,16,45,21,24
050,35,059,"New Mexico","Union County",2,17,45,20,25
050,35,059,"New Mexico","Union County",2,18,43,20,23
050,35,059,"New Mexico","Union County",2,19,41,21,20
050,35,059,"New Mexico","Union County",2,20,34,18,16
050,35,059,"New Mexico","Union County",2,21,36,27,9
050,35,059,"New Mexico","Union County",2,22,43,32,11
050,35,059,"New Mexico","Union County",2,23,37,25,12
050,35,059,"New Mexico","Union County",2,24,44,35,9
050,35,059,"New Mexico","Union County",2,25,54,39,15
050,35,059,"New Mexico","Union County",2,26,47,29,18
050,35,059,"New Mexico","Union County",2,27,54,37,17
050,35,059,"New Mexico","Union County",2,28,46,30,16
050,35,059,"New Mexico","Union County",2,29,56,35,21
050,35,059,"New Mexico","Union County",2,30,53,32,21
050,35,059,"New Mexico","Union County",2,31,49,31,18
050,35,059,"New Mexico","Union County",2,32,52,28,24
050,35,059,"New Mexico","Union County",2,33,48,31,17
050,35,059,"New Mexico","Union County",2,34,52,36,16
050,35,059,"New Mexico","Union County",2,35,46,30,16
050,35,059,"New Mexico","Union County",2,36,55,34,21
050,35,059,"New Mexico","Union County",2,37,50,27,23
050,35,059,"New Mexico","Union County",2,38,53,33,20
050,35,059,"New Mexico","Union County",2,39,51,32,19
050,35,059,"New Mexico","Union County",2,40,55,36,19
050,35,059,"New Mexico","Union County",2,41,61,39,22
050,35,059,"New Mexico","Union County",2,42,49,32,17
050,35,059,"New Mexico","Union County",2,43,48,31,17
050,35,059,"New Mexico","Union County",2,44,44,23,21
050,35,059,"New Mexico","Union County",2,45,41,21,20
050,35,059,"New Mexico","Union County",2,46,38,24,14
050,35,059,"New Mexico","Union County",2,47,51,31,20
050,35,059,"New Mexico","Union County",2,48,42,22,20
050,35,059,"New Mexico","Union County",2,49,52,26,26
050,35,059,"New Mexico","Union County",2,50,47,22,25
050,35,059,"New Mexico","Union County",2,51,40,23,17
050,35,059,"New Mexico","Union County",2,52,42,25,17
050,35,059,"New Mexico","Union County",2,53,42,25,17
050,35,059,"New Mexico","Union County",2,54,45,29,16
050,35,059,"New Mexico","Union County",2,55,46,28,18
050,35,059,"New Mexico","Union County",2,56,48,27,21
050,35,059,"New Mexico","Union County",2,57,51,25,26
050,35,059,"New Mexico","Union County",2,58,52,26,26
050,35,059,"New Mexico","Union County",2,59,52,26,26
050,35,059,"New Mexico","Union County",2,60,59,28,31
050,35,059,"New Mexico","Union County",2,61,65,30,35
050,35,059,"New Mexico","Union County",2,62,62,34,28
050,35,059,"New Mexico","Union County",2,63,56,31,25
050,35,059,"New Mexico","Union County",2,64,62,33,29
050,35,059,"New Mexico","Union County",2,65,67,32,35
050,35,059,"New Mexico","Union County",2,66,63,33,30
050,35,059,"New Mexico","Union County",2,67,56,32,24
050,35,059,"New Mexico","Union County",2,68,52,30,22
050,35,059,"New Mexico","Union County",2,69,46,18,28
050,35,059,"New Mexico","Union County",2,70,49,19,30
050,35,059,"New Mexico","Union County",2,71,50,23,27
050,35,059,"New Mexico","Union County",2,72,46,19,27
050,35,059,"New Mexico","Union County",2,73,50,22,28
050,35,059,"New Mexico","Union County",2,74,38,18,20
050,35,059,"New Mexico","Union County",2,75,40,20,20
050,35,059,"New Mexico","Union County",2,76,43,19,24
050,35,059,"New Mexico","Union County",2,77,39,17,22
050,35,059,"New Mexico","Union County",2,78,32,16,16
050,35,059,"New Mexico","Union County",2,79,22,9,13
050,35,059,"New Mexico","Union County",2,80,23,12,11
050,35,059,"New Mexico","Union County",2,81,21,11,10
050,35,059,"New Mexico","Union County",2,82,22,7,15
050,35,059,"New Mexico","Union County",2,83,25,12,13
050,35,059,"New Mexico","Union County",2,84,24,8,16
050,35,059,"New Mexico","Union County",2,85,130,37,93
050,35,059,"New Mexico","Union County",3,0,36,20,16
050,35,059,"New Mexico","Union County",3,1,42,20,22
050,35,059,"New Mexico","Union County",3,2,47,23,24
050,35,059,"New Mexico","Union County",3,3,46,26,20
050,35,059,"New Mexico","Union County",3,4,45,26,19
050,35,059,"New Mexico","Union County",3,5,54,23,31
050,35,059,"New Mexico","Union County",3,6,48,24,24
050,35,059,"New Mexico","Union County",3,7,46,25,21
050,35,059,"New Mexico","Union County",3,8,50,27,23
050,35,059,"New Mexico","Union County",3,9,48,26,22
050,35,059,"New Mexico","Union County",3,10,54,29,25
050,35,059,"New Mexico","Union County",3,11,53,30,23
050,35,059,"New Mexico","Union County",3,12,38,18,20
050,35,059,"New Mexico","Union County",3,13,54,32,22
050,35,059,"New Mexico","Union County",3,14,57,28,29
050,35,059,"New Mexico","Union County",3,15,48,18,30
050,35,059,"New Mexico","Union County",3,16,48,21,27
050,35,059,"New Mexico","Union County",3,17,49,25,24
050,35,059,"New Mexico","Union County",3,18,42,21,21
050,35,059,"New Mexico","Union County",3,19,36,14,22
050,35,059,"New Mexico","Union County",3,20,49,25,24
050,35,059,"New Mexico","Union County",3,21,36,24,12
050,35,059,"New Mexico","Union County",3,22,37,29,8
050,35,059,"New Mexico","Union County",3,23,41,29,12
050,35,059,"New Mexico","Union County",3,24,43,30,13
050,35,059,"New Mexico","Union County",3,25,47,38,9
050,35,059,"New Mexico","Union County",3,26,49,31,18
050,35,059,"New Mexico","Union County",3,27,52,36,16
050,35,059,"New Mexico","Union County",3,28,46,29,17
050,35,059,"New Mexico","Union County",3,29,49,33,16
050,35,059,"New Mexico","Union County",3,30,55,34,21
050,35,059,"New Mexico","Union County",3,31,55,33,22
050,35,059,"New Mexico","Union County",3,32,50,29,21
050,35,059,"New Mexico","Union County",3,33,59,31,28
050,35,059,"New Mexico","Union County",3,34,50,33,17
050,35,059,"New Mexico","Union County",3,35,55,35,20
050,35,059,"New Mexico","Union County",3,36,42,28,14
050,35,059,"New Mexico","Union County",3,37,52,32,20
050,35,059,"New Mexico","Union County",3,38,57,33,24
050,35,059,"New Mexico","Union County",3,39,49,30,19
050,35,059,"New Mexico","Union County",3,40,52,36,16
050,35,059,"New Mexico","Union County",3,41,53,33,20
050,35,059,"New Mexico","Union County",3,42,59,36,23
050,35,059,"New Mexico","Union County",3,43,55,38,17
050,35,059,"New Mexico","Union County",3,44,42,26,16
050,35,059,"New Mexico","Union County",3,45,41,19,22
050,35,059,"New Mexico","Union County",3,46,39,22,17
050,35,059,"New Mexico","Union County",3,47,48,34,14
050,35,059,"New Mexico","Union County",3,48,45,25,20
050,35,059,"New Mexico","Union County",3,49,42,22,20
050,35,059,"New Mexico","Union County",3,50,48,21,27
050,35,059,"New Mexico","Union County",3,51,47,22,25
050,35,059,"New Mexico","Union County",3,52,44,27,17
050,35,059,"New Mexico","Union County",3,53,44,26,18
050,35,059,"New Mexico","Union County",3,54,44,25,19
050,35,059,"New Mexico","Union County",3,55,39,24,15
050,35,059,"New Mexico","Union County",3,56,47,31,16
050,35,059,"New Mexico","Union County",3,57,43,21,22
050,35,059,"New Mexico","Union County",3,58,54,27,27
050,35,059,"New Mexico","Union County",3,59,53,26,27
050,35,059,"New Mexico","Union County",3,60,52,27,25
050,35,059,"New Mexico","Union County",3,61,61,28,33
050,35,059,"New Mexico","Union County",3,62,67,33,34
050,35,059,"New Mexico","Union County",3,63,59,33,26
050,35,059,"New Mexico","Union County",3,64,58,31,27
050,35,059,"New Mexico","Union County",3,65,63,33,30
050,35,059,"New Mexico","Union County",3,66,69,33,36
050,35,059,"New Mexico","Union County",3,67,59,30,29
050,35,059,"New Mexico","Union County",3,68,54,32,22
050,35,059,"New Mexico","Union County",3,69,51,28,23
050,35,059,"New Mexico","Union County",3,70,44,17,27
050,35,059,"New Mexico","Union County",3,71,49,19,30
050,35,059,"New Mexico","Union County",3,72,49,22,27
050,35,059,"New Mexico","Union County",3,73,46,19,27
050,35,059,"New Mexico","Union County",3,74,47,19,28
050,35,059,"New Mexico","Union County",3,75,37,19,18
050,35,059,"New Mexico","Union County",3,76,37,16,21
050,35,059,"New Mexico","Union County",3,77,41,18,23
050,35,059,"New Mexico","Union County",3,78,37,15,22
050,35,059,"New Mexico","Union County",3,79,32,16,16
050,35,059,"New Mexico","Union County",3,80,19,7,12
050,35,059,"New Mexico","Union County",3,81,20,11,9
050,35,059,"New Mexico","Union County",3,82,21,11,10
050,35,059,"New Mexico","Union County",3,83,17,5,12
050,35,059,"New Mexico","Union County",3,84,24,12,12
050,35,059,"New Mexico","Union County",3,85,130,34,96
050,35,059,"New Mexico","Union County",4,0,38,25,13
050,35,059,"New Mexico","Union County",4,1,29,20,9
050,35,059,"New Mexico","Union County",4,2,40,21,19
050,35,059,"New Mexico","Union County",4,3,49,25,24
050,35,059,"New Mexico","Union County",4,4,49,28,21
050,35,059,"New Mexico","Union County",4,5,39,23,16
050,35,059,"New Mexico","Union County",4,6,53,24,29
050,35,059,"New Mexico","Union County",4,7,46,24,22
050,35,059,"New Mexico","Union County",4,8,43,24,19
050,35,059,"New Mexico","Union County",4,9,50,28,22
050,35,059,"New Mexico","Union County",4,10,41,20,21
050,35,059,"New Mexico","Union County",4,11,51,26,25
050,35,059,"New Mexico","Union County",4,12,47,28,19
050,35,059,"New Mexico","Union County",4,13,38,18,20
050,35,059,"New Mexico","Union County",4,14,50,31,19
050,35,059,"New Mexico","Union County",4,15,51,26,25
050,35,059,"New Mexico","Union County",4,16,46,17,29
050,35,059,"New Mexico","Union County",4,17,46,19,27
050,35,059,"New Mexico","Union County",4,18,42,22,20
050,35,059,"New Mexico","Union County",4,19,42,22,20
050,35,059,"New Mexico","Union County",4,20,37,13,24
050,35,059,"New Mexico","Union County",4,21,50,28,22
050,35,059,"New Mexico","Union County",4,22,42,27,15
050,35,059,"New Mexico","Union County",4,23,35,30,5
050,35,059,"New Mexico","Union County",4,24,45,34,11
050,35,059,"New Mexico","Union County",4,25,44,35,9
050,35,059,"New Mexico","Union County",4,26,41,32,9
050,35,059,"New Mexico","Union County",4,27,61,42,19
050,35,059,"New Mexico","Union County",4,28,44,28,16
050,35,059,"New Mexico","Union County",4,29,47,31,16
050,35,059,"New Mexico","Union County",4,30,46,32,14
050,35,059,"New Mexico","Union County",4,31,54,35,19
050,35,059,"New Mexico","Union County",4,32,47,27,20
050,35,059,"New Mexico","Union County",4,33,48,31,17
050,35,059,"New Mexico","Union County",4,34,62,35,27
050,35,059,"New Mexico","Union County",4,35,43,28,15
050,35,059,"New Mexico","Union County",4,36,49,30,19
050,35,059,"New Mexico","Union County",4,37,39,26,13
050,35,059,"New Mexico","Union County",4,38,56,37,19
050,35,059,"New Mexico","Union County",4,39,52,30,22
050,35,059,"New Mexico","Union County",4,40,51,34,17
050,35,059,"New Mexico","Union County",4,41,50,31,19
050,35,059,"New Mexico","Union County",4,42,53,32,21
050,35,059,"New Mexico","Union County",4,43,62,40,22
050,35,059,"New Mexico","Union County",4,44,49,32,17
050,35,059,"New Mexico","Union County",4,45,41,24,17
050,35,059,"New Mexico","Union County",4,46,40,19,21
050,35,059,"New Mexico","Union County",4,47,45,28,17
050,35,059,"New Mexico","Union County",4,48,43,28,15
050,35,059,"New Mexico","Union County",4,49,44,25,19
050,35,059,"New Mexico","Union County",4,50,39,18,21
050,35,059,"New Mexico","Union County",4,51,46,20,26
050,35,059,"New Mexico","Union County",4,52,49,24,25
050,35,059,"New Mexico","Union County",4,53,45,28,17
050,35,059,"New Mexico","Union County",4,54,45,24,21
050,35,059,"New Mexico","Union County",4,55,41,22,19
050,35,059,"New Mexico","Union County",4,56,38,23,15
050,35,059,"New Mexico","Union County",4,57,46,29,17
050,35,059,"New Mexico","Union County",4,58,47,24,23
050,35,059,"New Mexico","Union County",4,59,53,27,26
050,35,059,"New Mexico","Union County",4,60,54,28,26
050,35,059,"New Mexico","Union County",4,61,49,26,23
050,35,059,"New Mexico","Union County",4,62,63,29,34
050,35,059,"New Mexico","Union County",4,63,65,33,32
050,35,059,"New Mexico","Union County",4,64,58,33,25
050,35,059,"New Mexico","Union County",4,65,60,31,29
050,35,059,"New Mexico","Union County",4,66,59,31,28
050,35,059,"New Mexico","Union County",4,67,69,33,36
050,35,059,"New Mexico","Union County",4,68,56,27,29
050,35,059,"New Mexico","Union County",4,69,54,32,22
050,35,059,"New Mexico","Union County",4,70,43,25,18
050,35,059,"New Mexico","Union County",4,71,42,17,25
050,35,059,"New Mexico","Union County",4,72,47,17,30
050,35,059,"New Mexico","Union County",4,73,51,24,27
050,35,059,"New Mexico","Union County",4,74,42,16,26
050,35,059,"New Mexico","Union County",4,75,48,21,27
050,35,059,"New Mexico","Union County",4,76,36,18,18
050,35,059,"New Mexico","Union County",4,77,33,13,20
050,35,059,"New Mexico","Union County",4,78,41,18,23
050,35,059,"New Mexico","Union County",4,79,34,14,20
050,35,059,"New Mexico","Union County",4,80,25,12,13
050,35,059,"New Mexico","Union County",4,81,16,6,10
050,35,059,"New Mexico","Union County",4,82,20,11,9
050,35,059,"New Mexico","Union County",4,83,17,10,7
050,35,059,"New Mexico","Union County",4,84,17,5,12
050,35,059,"New Mexico","Union County",4,85,124,37,87
050,35,059,"New Mexico","Union County",5,0,35,23,12
050,35,059,"New Mexico","Union County",5,1,37,22,15
050,35,059,"New Mexico","Union County",5,2,27,17,10
050,35,059,"New Mexico","Union County",5,3,43,21,22
050,35,059,"New Mexico","Union County",5,4,48,24,24
050,35,059,"New Mexico","Union County",5,5,47,24,23
050,35,059,"New Mexico","Union County",5,6,40,24,16
050,35,059,"New Mexico","Union County",5,7,53,24,29
050,35,059,"New Mexico","Union County",5,8,44,22,22
050,35,059,"New Mexico","Union County",5,9,44,25,19
050,35,059,"New Mexico","Union County",5,10,51,27,24
050,35,059,"New Mexico","Union County",5,11,44,22,22
050,35,059,"New Mexico","Union County",5,12,52,23,29
050,35,059,"New Mexico","Union County",5,13,48,29,19
050,35,059,"New Mexico","Union County",5,14,33,14,19
050,35,059,"New Mexico","Union County",5,15,48,29,19
050,35,059,"New Mexico","Union County",5,16,52,26,26
050,35,059,"New Mexico","Union County",5,17,49,20,29
050,35,059,"New Mexico","Union County",5,18,39,19,20
050,35,059,"New Mexico","Union County",5,19,38,22,16
050,35,059,"New Mexico","Union County",5,20,48,23,25
050,35,059,"New Mexico","Union County",5,21,37,18,19
050,35,059,"New Mexico","Union County",5,22,55,33,22
050,35,059,"New Mexico","Union County",5,23,43,26,17
050,35,059,"New Mexico","Union County",5,24,41,32,9
050,35,059,"New Mexico","Union County",5,25,48,36,12
050,35,059,"New Mexico","Union County",5,26,38,30,8
050,35,059,"New Mexico","Union County",5,27,50,43,7
050,35,059,"New Mexico","Union County",5,28,54,37,17
050,35,059,"New Mexico","Union County",5,29,46,30,16
050,35,059,"New Mexico","Union County",5,30,48,30,18
050,35,059,"New Mexico","Union County",5,31,47,32,15
050,35,059,"New Mexico","Union County",5,32,52,32,20
050,35,059,"New Mexico","Union County",5,33,51,31,20
050,35,059,"New Mexico","Union County",5,34,57,38,19
050,35,059,"New Mexico","Union County",5,35,53,28,25
050,35,059,"New Mexico","Union County",5,36,43,28,15
050,35,059,"New Mexico","Union County",5,37,47,28,19
050,35,059,"New Mexico","Union County",5,38,47,33,14
050,35,059,"New Mexico","Union County",5,39,50,32,18
050,35,059,"New Mexico","Union County",5,40,59,38,21
050,35,059,"New Mexico","Union County",5,41,52,34,18
050,35,059,"New Mexico","Union County",5,42,43,30,13
050,35,059,"New Mexico","Union County",5,43,59,36,23
050,35,059,"New Mexico","Union County",5,44,55,33,22
050,35,059,"New Mexico","Union County",5,45,49,32,17
050,35,059,"New Mexico","Union County",5,46,42,27,15
050,35,059,"New Mexico","Union County",5,47,47,28,19
050,35,059,"New Mexico","Union County",5,48,38,21,17
050,35,059,"New Mexico","Union County",5,49,42,28,14
050,35,059,"New Mexico","Union County",5,50,39,20,19
050,35,059,"New Mexico","Union County",5,51,38,17,21
050,35,059,"New Mexico","Union County",5,52,46,22,24
050,35,059,"New Mexico","Union County",5,53,51,28,23
050,35,059,"New Mexico","Union County",5,54,47,27,20
050,35,059,"New Mexico","Union County",5,55,43,21,22
050,35,059,"New Mexico","Union County",5,56,39,21,18
050,35,059,"New Mexico","Union County",5,57,33,18,15
050,35,059,"New Mexico","Union County",5,58,46,29,17
050,35,059,"New Mexico","Union County",5,59,47,26,21
050,35,059,"New Mexico","Union County",5,60,58,30,28
050,35,059,"New Mexico","Union County",5,61,54,28,26
050,35,059,"New Mexico","Union County",5,62,49,26,23
050,35,059,"New Mexico","Union County",5,63,56,26,30
050,35,059,"New Mexico","Union County",5,64,62,31,31
050,35,059,"New Mexico","Union County",5,65,58,32,26
050,35,059,"New Mexico","Union County",5,66,56,30,26
050,35,059,"New Mexico","Union County",5,67,58,31,27
050,35,059,"New Mexico","Union County",5,68,68,32,36
050,35,059,"New Mexico","Union County",5,69,56,26,30
050,35,059,"New Mexico","Union County",5,70,52,32,20
050,35,059,"New Mexico","Union County",5,71,43,26,17
050,35,059,"New Mexico","Union County",5,72,39,14,25
050,35,059,"New Mexico","Union County",5,73,47,18,29
050,35,059,"New Mexico","Union County",5,74,50,22,28
050,35,059,"New Mexico","Union County",5,75,43,17,26
050,35,059,"New Mexico","Union County",5,76,46,17,29
050,35,059,"New Mexico","Union County",5,77,33,16,17
050,35,059,"New Mexico","Union County",5,78,32,14,18
050,35,059,"New Mexico","Union County",5,79,41,18,23
050,35,059,"New Mexico","Union County",5,80,32,12,20
050,35,059,"New Mexico","Union County",5,81,23,11,12
050,35,059,"New Mexico","Union County",5,82,17,6,11
050,35,059,"New Mexico","Union County",5,83,17,10,7
050,35,059,"New Mexico","Union County",5,84,15,9,6
050,35,059,"New Mexico","Union County",5,85,117,33,84
050,35,061,"New Mexico","Valencia County",1,0,750,384,366
050,35,061,"New Mexico","Valencia County",1,1,766,403,363
050,35,061,"New Mexico","Valencia County",1,2,849,412,437
050,35,061,"New Mexico","Valencia County",1,3,908,437,471
050,35,061,"New Mexico","Valencia County",1,4,919,450,469
050,35,061,"New Mexico","Valencia County",1,5,895,446,449
050,35,061,"New Mexico","Valencia County",1,6,922,467,455
050,35,061,"New Mexico","Valencia County",1,7,926,487,439
050,35,061,"New Mexico","Valencia County",1,8,994,500,494
050,35,061,"New Mexico","Valencia County",1,9,1049,546,503
050,35,061,"New Mexico","Valencia County",1,10,1103,543,560
050,35,061,"New Mexico","Valencia County",1,11,1109,577,532
050,35,061,"New Mexico","Valencia County",1,12,1147,609,538
050,35,061,"New Mexico","Valencia County",1,13,1171,640,531
050,35,061,"New Mexico","Valencia County",1,14,1113,590,523
050,35,061,"New Mexico","Valencia County",1,15,1128,608,520
050,35,061,"New Mexico","Valencia County",1,16,1056,560,496
050,35,061,"New Mexico","Valencia County",1,17,1014,503,511
050,35,061,"New Mexico","Valencia County",1,18,935,487,448
050,35,061,"New Mexico","Valencia County",1,19,914,477,437
050,35,061,"New Mexico","Valencia County",1,20,906,447,459
050,35,061,"New Mexico","Valencia County",1,21,1011,530,481
050,35,061,"New Mexico","Valencia County",1,22,881,462,419
050,35,061,"New Mexico","Valencia County",1,23,918,476,442
050,35,061,"New Mexico","Valencia County",1,24,947,484,463
050,35,061,"New Mexico","Valencia County",1,25,972,467,505
050,35,061,"New Mexico","Valencia County",1,26,902,466,436
050,35,061,"New Mexico","Valencia County",1,27,949,466,483
050,35,061,"New Mexico","Valencia County",1,28,981,496,485
050,35,061,"New Mexico","Valencia County",1,29,967,523,444
050,35,061,"New Mexico","Valencia County",1,30,976,519,457
050,35,061,"New Mexico","Valencia County",1,31,943,490,453
050,35,061,"New Mexico","Valencia County",1,32,870,456,414
050,35,061,"New Mexico","Valencia County",1,33,932,463,469
050,35,061,"New Mexico","Valencia County",1,34,942,457,485
050,35,061,"New Mexico","Valencia County",1,35,944,447,497
050,35,061,"New Mexico","Valencia County",1,36,930,460,470
050,35,061,"New Mexico","Valencia County",1,37,926,462,464
050,35,061,"New Mexico","Valencia County",1,38,1008,533,475
050,35,061,"New Mexico","Valencia County",1,39,953,503,450
050,35,061,"New Mexico","Valencia County",1,40,882,437,445
050,35,061,"New Mexico","Valencia County",1,41,833,441,392
050,35,061,"New Mexico","Valencia County",1,42,867,435,432
050,35,061,"New Mexico","Valencia County",1,43,859,420,439
050,35,061,"New Mexico","Valencia County",1,44,799,394,405
050,35,061,"New Mexico","Valencia County",1,45,849,438,411
050,35,061,"New Mexico","Valencia County",1,46,829,443,386
050,35,061,"New Mexico","Valencia County",1,47,843,437,406
050,35,061,"New Mexico","Valencia County",1,48,909,470,439
050,35,061,"New Mexico","Valencia County",1,49,931,479,452
050,35,061,"New Mexico","Valencia County",1,50,930,488,442
050,35,061,"New Mexico","Valencia County",1,51,951,472,479
050,35,061,"New Mexico","Valencia County",1,52,894,475,419
050,35,061,"New Mexico","Valencia County",1,53,948,458,490
050,35,061,"New Mexico","Valencia County",1,54,1005,445,560
050,35,061,"New Mexico","Valencia County",1,55,982,494,488
050,35,061,"New Mexico","Valencia County",1,56,1031,506,525
050,35,061,"New Mexico","Valencia County",1,57,1065,526,539
050,35,061,"New Mexico","Valencia County",1,58,1092,555,537
050,35,061,"New Mexico","Valencia County",1,59,1092,525,567
050,35,061,"New Mexico","Valencia County",1,60,1163,580,583
050,35,061,"New Mexico","Valencia County",1,61,1165,614,551
050,35,061,"New Mexico","Valencia County",1,62,1011,482,529
050,35,061,"New Mexico","Valencia County",1,63,966,464,502
050,35,061,"New Mexico","Valencia County",1,64,952,455,497
050,35,061,"New Mexico","Valencia County",1,65,985,478,507
050,35,061,"New Mexico","Valencia County",1,66,947,464,483
050,35,061,"New Mexico","Valencia County",1,67,924,452,472
050,35,061,"New Mexico","Valencia County",1,68,929,428,501
050,35,061,"New Mexico","Valencia County",1,69,855,407,448
050,35,061,"New Mexico","Valencia County",1,70,855,431,424
050,35,061,"New Mexico","Valencia County",1,71,833,420,413
050,35,061,"New Mexico","Valencia County",1,72,799,396,403
050,35,061,"New Mexico","Valencia County",1,73,814,414,400
050,35,061,"New Mexico","Valencia County",1,74,592,294,298
050,35,061,"New Mexico","Valencia County",1,75,608,271,337
050,35,061,"New Mexico","Valencia County",1,76,546,246,300
050,35,061,"New Mexico","Valencia County",1,77,528,243,285
050,35,061,"New Mexico","Valencia County",1,78,461,215,246
050,35,061,"New Mexico","Valencia County",1,79,413,197,216
050,35,061,"New Mexico","Valencia County",1,80,366,174,192
050,35,061,"New Mexico","Valencia County",1,81,321,141,180
050,35,061,"New Mexico","Valencia County",1,82,286,129,157
050,35,061,"New Mexico","Valencia County",1,83,269,125,144
050,35,061,"New Mexico","Valencia County",1,84,276,136,140
050,35,061,"New Mexico","Valencia County",1,85,1226,515,711
050,35,061,"New Mexico","Valencia County",2,0,757,394,363
050,35,061,"New Mexico","Valencia County",2,1,772,404,368
050,35,061,"New Mexico","Valencia County",2,2,837,415,422
050,35,061,"New Mexico","Valencia County",2,3,897,433,464
050,35,061,"New Mexico","Valencia County",2,4,920,452,468
050,35,061,"New Mexico","Valencia County",2,5,903,450,453
050,35,061,"New Mexico","Valencia County",2,6,915,464,451
050,35,061,"New Mexico","Valencia County",2,7,926,483,443
050,35,061,"New Mexico","Valencia County",2,8,979,496,483
050,35,061,"New Mexico","Valencia County",2,9,1042,540,502
050,35,061,"New Mexico","Valencia County",2,10,1098,546,552
050,35,061,"New Mexico","Valencia County",2,11,1096,567,529
050,35,061,"New Mexico","Valencia County",2,12,1148,607,541
050,35,061,"New Mexico","Valencia County",2,13,1172,639,533
050,35,061,"New Mexico","Valencia County",2,14,1119,596,523
050,35,061,"New Mexico","Valencia County",2,15,1135,613,522
050,35,061,"New Mexico","Valencia County",2,16,1067,564,503
050,35,061,"New Mexico","Valencia County",2,17,1022,516,506
050,35,061,"New Mexico","Valencia County",2,18,931,481,450
050,35,061,"New Mexico","Valencia County",2,19,901,470,431
050,35,061,"New Mexico","Valencia County",2,20,916,458,458
050,35,061,"New Mexico","Valencia County",2,21,1011,531,480
050,35,061,"New Mexico","Valencia County",2,22,902,467,435
050,35,061,"New Mexico","Valencia County",2,23,917,475,442
050,35,061,"New Mexico","Valencia County",2,24,953,488,465
050,35,061,"New Mexico","Valencia County",2,25,978,468,510
050,35,061,"New Mexico","Valencia County",2,26,910,467,443
050,35,061,"New Mexico","Valencia County",2,27,935,468,467
050,35,061,"New Mexico","Valencia County",2,28,985,493,492
050,35,061,"New Mexico","Valencia County",2,29,963,515,448
050,35,061,"New Mexico","Valencia County",2,30,984,518,466
050,35,061,"New Mexico","Valencia County",2,31,945,497,448
050,35,061,"New Mexico","Valencia County",2,32,890,467,423
050,35,061,"New Mexico","Valencia County",2,33,927,470,457
050,35,061,"New Mexico","Valencia County",2,34,939,456,483
050,35,061,"New Mexico","Valencia County",2,35,958,456,502
050,35,061,"New Mexico","Valencia County",2,36,929,457,472
050,35,061,"New Mexico","Valencia County",2,37,927,460,467
050,35,061,"New Mexico","Valencia County",2,38,1007,526,481
050,35,061,"New Mexico","Valencia County",2,39,959,504,455
050,35,061,"New Mexico","Valencia County",2,40,915,460,455
050,35,061,"New Mexico","Valencia County",2,41,844,443,401
050,35,061,"New Mexico","Valencia County",2,42,859,435,424
050,35,061,"New Mexico","Valencia County",2,43,872,429,443
050,35,061,"New Mexico","Valencia County",2,44,812,398,414
050,35,061,"New Mexico","Valencia County",2,45,846,433,413
050,35,061,"New Mexico","Valencia County",2,46,831,440,391
050,35,061,"New Mexico","Valencia County",2,47,839,438,401
050,35,061,"New Mexico","Valencia County",2,48,903,471,432
050,35,061,"New Mexico","Valencia County",2,49,923,474,449
050,35,061,"New Mexico","Valencia County",2,50,924,477,447
050,35,061,"New Mexico","Valencia County",2,51,954,473,481
050,35,061,"New Mexico","Valencia County",2,52,905,478,427
050,35,061,"New Mexico","Valencia County",2,53,933,457,476
050,35,061,"New Mexico","Valencia County",2,54,1003,450,553
050,35,061,"New Mexico","Valencia County",2,55,975,485,490
050,35,061,"New Mexico","Valencia County",2,56,1020,501,519
050,35,061,"New Mexico","Valencia County",2,57,1052,522,530
050,35,061,"New Mexico","Valencia County",2,58,1086,548,538
050,35,061,"New Mexico","Valencia County",2,59,1088,527,561
050,35,061,"New Mexico","Valencia County",2,60,1152,578,574
050,35,061,"New Mexico","Valencia County",2,61,1171,614,557
050,35,061,"New Mexico","Valencia County",2,62,1026,494,532
050,35,061,"New Mexico","Valencia County",2,63,992,473,519
050,35,061,"New Mexico","Valencia County",2,64,938,451,487
050,35,061,"New Mexico","Valencia County",2,65,976,472,504
050,35,061,"New Mexico","Valencia County",2,66,953,467,486
050,35,061,"New Mexico","Valencia County",2,67,929,453,476
050,35,061,"New Mexico","Valencia County",2,68,921,432,489
050,35,061,"New Mexico","Valencia County",2,69,875,412,463
050,35,061,"New Mexico","Valencia County",2,70,848,420,428
050,35,061,"New Mexico","Valencia County",2,71,832,420,412
050,35,061,"New Mexico","Valencia County",2,72,802,400,402
050,35,061,"New Mexico","Valencia County",2,73,839,427,412
050,35,061,"New Mexico","Valencia County",2,74,614,307,307
050,35,061,"New Mexico","Valencia County",2,75,607,275,332
050,35,061,"New Mexico","Valencia County",2,76,552,249,303
050,35,061,"New Mexico","Valencia County",2,77,536,246,290
050,35,061,"New Mexico","Valencia County",2,78,468,218,250
050,35,061,"New Mexico","Valencia County",2,79,412,194,218
050,35,061,"New Mexico","Valencia County",2,80,369,177,192
050,35,061,"New Mexico","Valencia County",2,81,327,147,180
050,35,061,"New Mexico","Valencia County",2,82,296,133,163
050,35,061,"New Mexico","Valencia County",2,83,272,124,148
050,35,061,"New Mexico","Valencia County",2,84,264,127,137
050,35,061,"New Mexico","Valencia County",2,85,1247,527,720
050,35,061,"New Mexico","Valencia County",3,0,821,436,385
050,35,061,"New Mexico","Valencia County",3,1,792,414,378
050,35,061,"New Mexico","Valencia County",3,2,814,417,397
050,35,061,"New Mexico","Valencia County",3,3,899,442,457
050,35,061,"New Mexico","Valencia County",3,4,914,451,463
050,35,061,"New Mexico","Valencia County",3,5,938,463,475
050,35,061,"New Mexico","Valencia County",3,6,937,469,468
050,35,061,"New Mexico","Valencia County",3,7,917,479,438
050,35,061,"New Mexico","Valencia County",3,8,951,496,455
050,35,061,"New Mexico","Valencia County",3,9,985,502,483
050,35,061,"New Mexico","Valencia County",3,10,1092,544,548
050,35,061,"New Mexico","Valencia County",3,11,1078,557,521
050,35,061,"New Mexico","Valencia County",3,12,1124,581,543
050,35,061,"New Mexico","Valencia County",3,13,1182,640,542
050,35,061,"New Mexico","Valencia County",3,14,1140,611,529
050,35,061,"New Mexico","Valencia County",3,15,1158,627,531
050,35,061,"New Mexico","Valencia County",3,16,1119,575,544
050,35,061,"New Mexico","Valencia County",3,17,1081,560,521
050,35,061,"New Mexico","Valencia County",3,18,951,491,460
050,35,061,"New Mexico","Valencia County",3,19,886,465,421
050,35,061,"New Mexico","Valencia County",3,20,915,481,434
050,35,061,"New Mexico","Valencia County",3,21,1018,528,490
050,35,061,"New Mexico","Valencia County",3,22,947,480,467
050,35,061,"New Mexico","Valencia County",3,23,929,476,453
050,35,061,"New Mexico","Valencia County",3,24,954,494,460
050,35,061,"New Mexico","Valencia County",3,25,1014,489,525
050,35,061,"New Mexico","Valencia County",3,26,955,485,470
050,35,061,"New Mexico","Valencia County",3,27,927,474,453
050,35,061,"New Mexico","Valencia County",3,28,975,483,492
050,35,061,"New Mexico","Valencia County",3,29,975,502,473
050,35,061,"New Mexico","Valencia County",3,30,977,508,469
050,35,061,"New Mexico","Valencia County",3,31,982,518,464
050,35,061,"New Mexico","Valencia County",3,32,961,502,459
050,35,061,"New Mexico","Valencia County",3,33,916,479,437
050,35,061,"New Mexico","Valencia County",3,34,950,460,490
050,35,061,"New Mexico","Valencia County",3,35,974,453,521
050,35,061,"New Mexico","Valencia County",3,36,946,459,487
050,35,061,"New Mexico","Valencia County",3,37,950,468,482
050,35,061,"New Mexico","Valencia County",3,38,980,504,476
050,35,061,"New Mexico","Valencia County",3,39,991,518,473
050,35,061,"New Mexico","Valencia County",3,40,982,519,463
050,35,061,"New Mexico","Valencia County",3,41,910,468,442
050,35,061,"New Mexico","Valencia County",3,42,885,467,418
050,35,061,"New Mexico","Valencia County",3,43,880,443,437
050,35,061,"New Mexico","Valencia County",3,44,881,428,453
050,35,061,"New Mexico","Valencia County",3,45,855,426,429
050,35,061,"New Mexico","Valencia County",3,46,842,435,407
050,35,061,"New Mexico","Valencia County",3,47,844,446,398
050,35,061,"New Mexico","Valencia County",3,48,882,491,391
050,35,061,"New Mexico","Valencia County",3,49,900,456,444
050,35,061,"New Mexico","Valencia County",3,50,922,471,451
050,35,061,"New Mexico","Valencia County",3,51,957,472,485
050,35,061,"New Mexico","Valencia County",3,52,946,495,451
050,35,061,"New Mexico","Valencia County",3,53,915,473,442
050,35,061,"New Mexico","Valencia County",3,54,979,451,528
050,35,061,"New Mexico","Valencia County",3,55,923,450,473
050,35,061,"New Mexico","Valencia County",3,56,991,480,511
050,35,061,"New Mexico","Valencia County",3,57,992,489,503
050,35,061,"New Mexico","Valencia County",3,58,1042,514,528
050,35,061,"New Mexico","Valencia County",3,59,1107,543,564
050,35,061,"New Mexico","Valencia County",3,60,1112,572,540
050,35,061,"New Mexico","Valencia County",3,61,1167,602,565
050,35,061,"New Mexico","Valencia County",3,62,1085,520,565
050,35,061,"New Mexico","Valencia County",3,63,1066,498,568
050,35,061,"New Mexico","Valencia County",3,64,941,465,476
050,35,061,"New Mexico","Valencia County",3,65,932,448,484
050,35,061,"New Mexico","Valencia County",3,66,961,459,502
050,35,061,"New Mexico","Valencia County",3,67,949,467,482
050,35,061,"New Mexico","Valencia County",3,68,923,442,481
050,35,061,"New Mexico","Valencia County",3,69,907,423,484
050,35,061,"New Mexico","Valencia County",3,70,854,404,450
050,35,061,"New Mexico","Valencia County",3,71,828,402,426
050,35,061,"New Mexico","Valencia County",3,72,817,411,406
050,35,061,"New Mexico","Valencia County",3,73,784,387,397
050,35,061,"New Mexico","Valencia County",3,74,823,413,410
050,35,061,"New Mexico","Valencia County",3,75,621,306,315
050,35,061,"New Mexico","Valencia County",3,76,568,259,309
050,35,061,"New Mexico","Valencia County",3,77,528,240,288
050,35,061,"New Mexico","Valencia County",3,78,513,231,282
050,35,061,"New Mexico","Valencia County",3,79,438,201,237
050,35,061,"New Mexico","Valencia County",3,80,387,179,208
050,35,061,"New Mexico","Valencia County",3,81,348,167,181
050,35,061,"New Mexico","Valencia County",3,82,312,146,166
050,35,061,"New Mexico","Valencia County",3,83,277,122,155
050,35,061,"New Mexico","Valencia County",3,84,241,112,129
050,35,061,"New Mexico","Valencia County",3,85,1283,551,732
050,35,061,"New Mexico","Valencia County",4,0,826,423,403
050,35,061,"New Mexico","Valencia County",4,1,849,455,394
050,35,061,"New Mexico","Valencia County",4,2,849,442,407
050,35,061,"New Mexico","Valencia County",4,3,871,443,428
050,35,061,"New Mexico","Valencia County",4,4,918,446,472
050,35,061,"New Mexico","Valencia County",4,5,958,472,486
050,35,061,"New Mexico","Valencia County",4,6,955,469,486
050,35,061,"New Mexico","Valencia County",4,7,947,479,468
050,35,061,"New Mexico","Valencia County",4,8,966,497,469
050,35,061,"New Mexico","Valencia County",4,9,1011,516,495
050,35,061,"New Mexico","Valencia County",4,10,1028,501,527
050,35,061,"New Mexico","Valencia County",4,11,1089,556,533
050,35,061,"New Mexico","Valencia County",4,12,1085,566,519
050,35,061,"New Mexico","Valencia County",4,13,1157,607,550
050,35,061,"New Mexico","Valencia County",4,14,1164,632,532
050,35,061,"New Mexico","Valencia County",4,15,1183,637,546
050,35,061,"New Mexico","Valencia County",4,16,1114,586,528
050,35,061,"New Mexico","Valencia County",4,17,1112,580,532
050,35,061,"New Mexico","Valencia County",4,18,987,527,460
050,35,061,"New Mexico","Valencia County",4,19,860,444,416
050,35,061,"New Mexico","Valencia County",4,20,864,453,411
050,35,061,"New Mexico","Valencia County",4,21,1018,566,452
050,35,061,"New Mexico","Valencia County",4,22,946,462,484
050,35,061,"New Mexico","Valencia County",4,23,961,492,469
050,35,061,"New Mexico","Valencia County",4,24,978,502,476
050,35,061,"New Mexico","Valencia County",4,25,1017,469,548
050,35,061,"New Mexico","Valencia County",4,26,983,517,466
050,35,061,"New Mexico","Valencia County",4,27,971,503,468
050,35,061,"New Mexico","Valencia County",4,28,988,500,488
050,35,061,"New Mexico","Valencia County",4,29,970,505,465
050,35,061,"New Mexico","Valencia County",4,30,1005,501,504
050,35,061,"New Mexico","Valencia County",4,31,990,530,460
050,35,061,"New Mexico","Valencia County",4,32,1018,548,470
050,35,061,"New Mexico","Valencia County",4,33,1021,535,486
050,35,061,"New Mexico","Valencia County",4,34,925,470,455
050,35,061,"New Mexico","Valencia County",4,35,1017,490,527
050,35,061,"New Mexico","Valencia County",4,36,975,481,494
050,35,061,"New Mexico","Valencia County",4,37,966,461,505
050,35,061,"New Mexico","Valencia County",4,38,996,498,498
050,35,061,"New Mexico","Valencia County",4,39,982,494,488
050,35,061,"New Mexico","Valencia County",4,40,1015,514,501
050,35,061,"New Mexico","Valencia County",4,41,1004,541,463
050,35,061,"New Mexico","Valencia County",4,42,925,479,446
050,35,061,"New Mexico","Valencia County",4,43,916,477,439
050,35,061,"New Mexico","Valencia County",4,44,871,438,433
050,35,061,"New Mexico","Valencia County",4,45,891,438,453
050,35,061,"New Mexico","Valencia County",4,46,871,438,433
050,35,061,"New Mexico","Valencia County",4,47,866,453,413
050,35,061,"New Mexico","Valencia County",4,48,885,482,403
050,35,061,"New Mexico","Valencia County",4,49,868,476,392
050,35,061,"New Mexico","Valencia County",4,50,890,442,448
050,35,061,"New Mexico","Valencia County",4,51,954,467,487
050,35,061,"New Mexico","Valencia County",4,52,933,491,442
050,35,061,"New Mexico","Valencia County",4,53,938,465,473
050,35,061,"New Mexico","Valencia County",4,54,955,475,480
050,35,061,"New Mexico","Valencia County",4,55,879,432,447
050,35,061,"New Mexico","Valencia County",4,56,931,442,489
050,35,061,"New Mexico","Valencia County",4,57,980,484,496
050,35,061,"New Mexico","Valencia County",4,58,978,486,492
050,35,061,"New Mexico","Valencia County",4,59,1045,503,542
050,35,061,"New Mexico","Valencia County",4,60,1128,575,553
050,35,061,"New Mexico","Valencia County",4,61,1132,603,529
050,35,061,"New Mexico","Valencia County",4,62,1079,513,566
050,35,061,"New Mexico","Valencia County",4,63,1107,515,592
050,35,061,"New Mexico","Valencia County",4,64,1012,485,527
050,35,061,"New Mexico","Valencia County",4,65,932,458,474
050,35,061,"New Mexico","Valencia County",4,66,923,435,488
050,35,061,"New Mexico","Valencia County",4,67,963,465,498
050,35,061,"New Mexico","Valencia County",4,68,939,456,483
050,35,061,"New Mexico","Valencia County",4,69,917,443,474
050,35,061,"New Mexico","Valencia County",4,70,890,417,473
050,35,061,"New Mexico","Valencia County",4,71,841,394,447
050,35,061,"New Mexico","Valencia County",4,72,807,390,417
050,35,061,"New Mexico","Valencia County",4,73,793,390,403
050,35,061,"New Mexico","Valencia County",4,74,769,382,387
050,35,061,"New Mexico","Valencia County",4,75,816,407,409
050,35,061,"New Mexico","Valencia County",4,76,583,293,290
050,35,061,"New Mexico","Valencia County",4,77,536,246,290
050,35,061,"New Mexico","Valencia County",4,78,507,230,277
050,35,061,"New Mexico","Valencia County",4,79,472,206,266
050,35,061,"New Mexico","Valencia County",4,80,420,195,225
050,35,061,"New Mexico","Valencia County",4,81,367,165,202
050,35,061,"New Mexico","Valencia County",4,82,334,156,178
050,35,061,"New Mexico","Valencia County",4,83,292,137,155
050,35,061,"New Mexico","Valencia County",4,84,247,107,140
050,35,061,"New Mexico","Valencia County",4,85,1280,559,721
050,35,061,"New Mexico","Valencia County",5,0,822,422,400
050,35,061,"New Mexico","Valencia County",5,1,880,453,427
050,35,061,"New Mexico","Valencia County",5,2,852,465,387
050,35,061,"New Mexico","Valencia County",5,3,880,443,437
050,35,061,"New Mexico","Valencia County",5,4,863,443,420
050,35,061,"New Mexico","Valencia County",5,5,934,458,476
050,35,061,"New Mexico","Valencia County",5,6,998,498,500
050,35,061,"New Mexico","Valencia County",5,7,990,492,498
050,35,061,"New Mexico","Valencia County",5,8,975,499,476
050,35,061,"New Mexico","Valencia County",5,9,985,496,489
050,35,061,"New Mexico","Valencia County",5,10,1049,535,514
050,35,061,"New Mexico","Valencia County",5,11,1002,509,493
050,35,061,"New Mexico","Valencia County",5,12,1076,549,527
050,35,061,"New Mexico","Valencia County",5,13,1099,571,528
050,35,061,"New Mexico","Valencia County",5,14,1151,595,556
050,35,061,"New Mexico","Valencia County",5,15,1207,658,549
050,35,061,"New Mexico","Valencia County",5,16,1165,613,552
050,35,061,"New Mexico","Valencia County",5,17,1126,587,539
050,35,061,"New Mexico","Valencia County",5,18,1035,540,495
050,35,061,"New Mexico","Valencia County",5,19,931,487,444
050,35,061,"New Mexico","Valencia County",5,20,884,462,422
050,35,061,"New Mexico","Valencia County",5,21,965,527,438
050,35,061,"New Mexico","Valencia County",5,22,941,492,449
050,35,061,"New Mexico","Valencia County",5,23,993,511,482
050,35,061,"New Mexico","Valencia County",5,24,1009,516,493
050,35,061,"New Mexico","Valencia County",5,25,1029,490,539
050,35,061,"New Mexico","Valencia County",5,26,974,484,490
050,35,061,"New Mexico","Valencia County",5,27,1017,532,485
050,35,061,"New Mexico","Valencia County",5,28,1010,524,486
050,35,061,"New Mexico","Valencia County",5,29,955,488,467
050,35,061,"New Mexico","Valencia County",5,30,1017,508,509
050,35,061,"New Mexico","Valencia County",5,31,1010,516,494
050,35,061,"New Mexico","Valencia County",5,32,1019,551,468
050,35,061,"New Mexico","Valencia County",5,33,1040,572,468
050,35,061,"New Mexico","Valencia County",5,34,1026,524,502
050,35,061,"New Mexico","Valencia County",5,35,986,489,497
050,35,061,"New Mexico","Valencia County",5,36,1021,502,519
050,35,061,"New Mexico","Valencia County",5,37,1002,502,500
050,35,061,"New Mexico","Valencia County",5,38,1044,508,536
050,35,061,"New Mexico","Valencia County",5,39,980,478,502
050,35,061,"New Mexico","Valencia County",5,40,1016,498,518
050,35,061,"New Mexico","Valencia County",5,41,1018,518,500
050,35,061,"New Mexico","Valencia County",5,42,1007,534,473
050,35,061,"New Mexico","Valencia County",5,43,937,496,441
050,35,061,"New Mexico","Valencia County",5,44,909,469,440
050,35,061,"New Mexico","Valencia County",5,45,899,453,446
050,35,061,"New Mexico","Valencia County",5,46,896,442,454
050,35,061,"New Mexico","Valencia County",5,47,887,453,434
050,35,061,"New Mexico","Valencia County",5,48,918,490,428
050,35,061,"New Mexico","Valencia County",5,49,852,461,391
050,35,061,"New Mexico","Valencia County",5,50,874,466,408
050,35,061,"New Mexico","Valencia County",5,51,927,444,483
050,35,061,"New Mexico","Valencia County",5,52,961,504,457
050,35,061,"New Mexico","Valencia County",5,53,928,464,464
050,35,061,"New Mexico","Valencia County",5,54,992,469,523
050,35,061,"New Mexico","Valencia County",5,55,893,482,411
050,35,061,"New Mexico","Valencia County",5,56,901,432,469
050,35,061,"New Mexico","Valencia County",5,57,911,445,466
050,35,061,"New Mexico","Valencia County",5,58,997,486,511
050,35,061,"New Mexico","Valencia County",5,59,978,473,505
050,35,061,"New Mexico","Valencia County",5,60,1064,544,520
050,35,061,"New Mexico","Valencia County",5,61,1167,619,548
050,35,061,"New Mexico","Valencia County",5,62,1056,513,543
050,35,061,"New Mexico","Valencia County",5,63,1110,517,593
050,35,061,"New Mexico","Valencia County",5,64,1059,495,564
050,35,061,"New Mexico","Valencia County",5,65,1001,476,525
050,35,061,"New Mexico","Valencia County",5,66,929,454,475
050,35,061,"New Mexico","Valencia County",5,67,924,434,490
050,35,061,"New Mexico","Valencia County",5,68,956,458,498
050,35,061,"New Mexico","Valencia County",5,69,925,457,468
050,35,061,"New Mexico","Valencia County",5,70,892,432,460
050,35,061,"New Mexico","Valencia County",5,71,868,398,470
050,35,061,"New Mexico","Valencia County",5,72,820,388,432
050,35,061,"New Mexico","Valencia County",5,73,790,380,410
050,35,061,"New Mexico","Valencia County",5,74,789,385,404
050,35,061,"New Mexico","Valencia County",5,75,747,367,380
050,35,061,"New Mexico","Valencia County",5,76,783,390,393
050,35,061,"New Mexico","Valencia County",5,77,562,282,280
050,35,061,"New Mexico","Valencia County",5,78,515,236,279
050,35,061,"New Mexico","Valencia County",5,79,470,205,265
050,35,061,"New Mexico","Valencia County",5,80,444,191,253
050,35,061,"New Mexico","Valencia County",5,81,399,181,218
050,35,061,"New Mexico","Valencia County",5,82,344,153,191
050,35,061,"New Mexico","Valencia County",5,83,309,141,168
050,35,061,"New Mexico","Valencia County",5,84,261,118,143
050,35,061,"New Mexico","Valencia County",5,85,1314,578,736

