"SUMLEV","STATE","COUNTY","STNAME","CTYNAME","YEAR","AGE","TOT_POP","TOT_MALE","TOT_FEMALE"
050,34,001,"New Jersey","Atlantic County",1,0,2813,1434,1379
050,34,001,"New Jersey","Atlantic County",1,1,2835,1440,1395
050,34,001,"New Jersey","Atlantic County",1,2,2918,1493,1425
050,34,001,"New Jersey","Atlantic County",1,3,2929,1513,1416
050,34,001,"New Jersey","Atlantic County",1,4,2973,1505,1468
050,34,001,"New Jersey","Atlantic County",1,5,3123,1598,1525
050,34,001,"New Jersey","Atlantic County",1,6,3166,1638,1528
050,34,001,"New Jersey","Atlantic County",1,7,3234,1642,1592
050,34,001,"New Jersey","Atlantic County",1,8,3325,1717,1608
050,34,001,"New Jersey","Atlantic County",1,9,3324,1731,1593
050,34,001,"New Jersey","Atlantic County",1,10,3330,1724,1606
050,34,001,"New Jersey","Atlantic County",1,11,3453,1781,1672
050,34,001,"New Jersey","Atlantic County",1,12,3549,1820,1729
050,34,001,"New Jersey","Atlantic County",1,13,3476,1730,1746
050,34,001,"New Jersey","Atlantic County",1,14,3502,1784,1718
050,34,001,"New Jersey","Atlantic County",1,15,3525,1820,1705
050,34,001,"New Jersey","Atlantic County",1,16,3460,1790,1670
050,34,001,"New Jersey","Atlantic County",1,17,3482,1802,1680
050,34,001,"New Jersey","Atlantic County",1,18,3453,1776,1677
050,34,001,"New Jersey","Atlantic County",1,19,3531,1776,1755
050,34,001,"New Jersey","Atlantic County",1,20,3572,1771,1801
050,34,001,"New Jersey","Atlantic County",1,21,3537,1769,1768
050,34,001,"New Jersey","Atlantic County",1,22,3470,1784,1686
050,34,001,"New Jersey","Atlantic County",1,23,3340,1666,1674
050,34,001,"New Jersey","Atlantic County",1,24,3375,1694,1681
050,34,001,"New Jersey","Atlantic County",1,25,3430,1732,1698
050,34,001,"New Jersey","Atlantic County",1,26,3422,1743,1679
050,34,001,"New Jersey","Atlantic County",1,27,3369,1661,1708
050,34,001,"New Jersey","Atlantic County",1,28,3359,1676,1683
050,34,001,"New Jersey","Atlantic County",1,29,3296,1663,1633
050,34,001,"New Jersey","Atlantic County",1,30,3206,1625,1581
050,34,001,"New Jersey","Atlantic County",1,31,3200,1587,1613
050,34,001,"New Jersey","Atlantic County",1,32,3143,1531,1612
050,34,001,"New Jersey","Atlantic County",1,33,3135,1550,1585
050,34,001,"New Jersey","Atlantic County",1,34,3161,1556,1605
050,34,001,"New Jersey","Atlantic County",1,35,3133,1590,1543
050,34,001,"New Jersey","Atlantic County",1,36,3093,1544,1549
050,34,001,"New Jersey","Atlantic County",1,37,3134,1523,1611
050,34,001,"New Jersey","Atlantic County",1,38,3045,1481,1564
050,34,001,"New Jersey","Atlantic County",1,39,2966,1450,1516
050,34,001,"New Jersey","Atlantic County",1,40,3096,1514,1582
050,34,001,"New Jersey","Atlantic County",1,41,3036,1424,1612
050,34,001,"New Jersey","Atlantic County",1,42,3023,1478,1545
050,34,001,"New Jersey","Atlantic County",1,43,2970,1460,1510
050,34,001,"New Jersey","Atlantic County",1,44,3007,1434,1573
050,34,001,"New Jersey","Atlantic County",1,45,3086,1497,1589
050,34,001,"New Jersey","Atlantic County",1,46,3059,1476,1583
050,34,001,"New Jersey","Atlantic County",1,47,3294,1560,1734
050,34,001,"New Jersey","Atlantic County",1,48,3603,1656,1947
050,34,001,"New Jersey","Atlantic County",1,49,3882,1839,2043
050,34,001,"New Jersey","Atlantic County",1,50,3708,1775,1933
050,34,001,"New Jersey","Atlantic County",1,51,3632,1727,1905
050,34,001,"New Jersey","Atlantic County",1,52,3706,1799,1907
050,34,001,"New Jersey","Atlantic County",1,53,3794,1830,1964
050,34,001,"New Jersey","Atlantic County",1,54,3978,1922,2056
050,34,001,"New Jersey","Atlantic County",1,55,4117,1968,2149
050,34,001,"New Jersey","Atlantic County",1,56,4345,2085,2260
050,34,001,"New Jersey","Atlantic County",1,57,4249,2075,2174
050,34,001,"New Jersey","Atlantic County",1,58,4301,2110,2191
050,34,001,"New Jersey","Atlantic County",1,59,4357,2136,2221
050,34,001,"New Jersey","Atlantic County",1,60,4216,2045,2171
050,34,001,"New Jersey","Atlantic County",1,61,4241,2015,2226
050,34,001,"New Jersey","Atlantic County",1,62,4205,1994,2211
050,34,001,"New Jersey","Atlantic County",1,63,4059,1950,2109
050,34,001,"New Jersey","Atlantic County",1,64,3951,1910,2041
050,34,001,"New Jersey","Atlantic County",1,65,3708,1803,1905
050,34,001,"New Jersey","Atlantic County",1,66,3513,1659,1854
050,34,001,"New Jersey","Atlantic County",1,67,3318,1569,1749
050,34,001,"New Jersey","Atlantic County",1,68,3213,1551,1662
050,34,001,"New Jersey","Atlantic County",1,69,2994,1424,1570
050,34,001,"New Jersey","Atlantic County",1,70,2886,1344,1542
050,34,001,"New Jersey","Atlantic County",1,71,2802,1304,1498
050,34,001,"New Jersey","Atlantic County",1,72,2839,1337,1502
050,34,001,"New Jersey","Atlantic County",1,73,2917,1393,1524
050,34,001,"New Jersey","Atlantic County",1,74,2120,1007,1113
050,34,001,"New Jersey","Atlantic County",1,75,2070,929,1141
050,34,001,"New Jersey","Atlantic County",1,76,1981,890,1091
050,34,001,"New Jersey","Atlantic County",1,77,2011,886,1125
050,34,001,"New Jersey","Atlantic County",1,78,1704,715,989
050,34,001,"New Jersey","Atlantic County",1,79,1484,658,826
050,34,001,"New Jersey","Atlantic County",1,80,1366,601,765
050,34,001,"New Jersey","Atlantic County",1,81,1267,556,711
050,34,001,"New Jersey","Atlantic County",1,82,1205,521,684
050,34,001,"New Jersey","Atlantic County",1,83,1054,449,605
050,34,001,"New Jersey","Atlantic County",1,84,941,385,556
050,34,001,"New Jersey","Atlantic County",1,85,5441,1921,3520
050,34,001,"New Jersey","Atlantic County",2,0,2810,1439,1371
050,34,001,"New Jersey","Atlantic County",2,1,2829,1439,1390
050,34,001,"New Jersey","Atlantic County",2,2,2899,1480,1419
050,34,001,"New Jersey","Atlantic County",2,3,2914,1505,1409
050,34,001,"New Jersey","Atlantic County",2,4,2964,1510,1454
050,34,001,"New Jersey","Atlantic County",2,5,3086,1577,1509
050,34,001,"New Jersey","Atlantic County",2,6,3156,1630,1526
050,34,001,"New Jersey","Atlantic County",2,7,3212,1637,1575
050,34,001,"New Jersey","Atlantic County",2,8,3292,1695,1597
050,34,001,"New Jersey","Atlantic County",2,9,3325,1729,1596
050,34,001,"New Jersey","Atlantic County",2,10,3326,1727,1599
050,34,001,"New Jersey","Atlantic County",2,11,3411,1762,1649
050,34,001,"New Jersey","Atlantic County",2,12,3542,1816,1726
050,34,001,"New Jersey","Atlantic County",2,13,3489,1749,1740
050,34,001,"New Jersey","Atlantic County",2,14,3493,1772,1721
050,34,001,"New Jersey","Atlantic County",2,15,3518,1813,1705
050,34,001,"New Jersey","Atlantic County",2,16,3480,1801,1679
050,34,001,"New Jersey","Atlantic County",2,17,3472,1797,1675
050,34,001,"New Jersey","Atlantic County",2,18,3432,1764,1668
050,34,001,"New Jersey","Atlantic County",2,19,3524,1773,1751
050,34,001,"New Jersey","Atlantic County",2,20,3602,1784,1818
050,34,001,"New Jersey","Atlantic County",2,21,3555,1786,1769
050,34,001,"New Jersey","Atlantic County",2,22,3469,1779,1690
050,34,001,"New Jersey","Atlantic County",2,23,3321,1672,1649
050,34,001,"New Jersey","Atlantic County",2,24,3346,1676,1670
050,34,001,"New Jersey","Atlantic County",2,25,3409,1717,1692
050,34,001,"New Jersey","Atlantic County",2,26,3422,1739,1683
050,34,001,"New Jersey","Atlantic County",2,27,3371,1682,1689
050,34,001,"New Jersey","Atlantic County",2,28,3360,1670,1690
050,34,001,"New Jersey","Atlantic County",2,29,3307,1658,1649
050,34,001,"New Jersey","Atlantic County",2,30,3246,1637,1609
050,34,001,"New Jersey","Atlantic County",2,31,3184,1589,1595
050,34,001,"New Jersey","Atlantic County",2,32,3145,1541,1604
050,34,001,"New Jersey","Atlantic County",2,33,3136,1543,1593
050,34,001,"New Jersey","Atlantic County",2,34,3154,1555,1599
050,34,001,"New Jersey","Atlantic County",2,35,3150,1587,1563
050,34,001,"New Jersey","Atlantic County",2,36,3079,1543,1536
050,34,001,"New Jersey","Atlantic County",2,37,3130,1530,1600
050,34,001,"New Jersey","Atlantic County",2,38,3082,1500,1582
050,34,001,"New Jersey","Atlantic County",2,39,2971,1452,1519
050,34,001,"New Jersey","Atlantic County",2,40,3077,1503,1574
050,34,001,"New Jersey","Atlantic County",2,41,3042,1443,1599
050,34,001,"New Jersey","Atlantic County",2,42,3004,1456,1548
050,34,001,"New Jersey","Atlantic County",2,43,2995,1468,1527
050,34,001,"New Jersey","Atlantic County",2,44,2970,1427,1543
050,34,001,"New Jersey","Atlantic County",2,45,3081,1489,1592
050,34,001,"New Jersey","Atlantic County",2,46,3054,1473,1581
050,34,001,"New Jersey","Atlantic County",2,47,3229,1534,1695
050,34,001,"New Jersey","Atlantic County",2,48,3524,1629,1895
050,34,001,"New Jersey","Atlantic County",2,49,3817,1801,2016
050,34,001,"New Jersey","Atlantic County",2,50,3745,1787,1958
050,34,001,"New Jersey","Atlantic County",2,51,3635,1732,1903
050,34,001,"New Jersey","Atlantic County",2,52,3682,1779,1903
050,34,001,"New Jersey","Atlantic County",2,53,3767,1818,1949
050,34,001,"New Jersey","Atlantic County",2,54,3918,1893,2025
050,34,001,"New Jersey","Atlantic County",2,55,4088,1960,2128
050,34,001,"New Jersey","Atlantic County",2,56,4300,2062,2238
050,34,001,"New Jersey","Atlantic County",2,57,4269,2073,2196
050,34,001,"New Jersey","Atlantic County",2,58,4281,2095,2186
050,34,001,"New Jersey","Atlantic County",2,59,4345,2129,2216
050,34,001,"New Jersey","Atlantic County",2,60,4242,2063,2179
050,34,001,"New Jersey","Atlantic County",2,61,4195,2001,2194
050,34,001,"New Jersey","Atlantic County",2,62,4194,1992,2202
050,34,001,"New Jersey","Atlantic County",2,63,4122,1974,2148
050,34,001,"New Jersey","Atlantic County",2,64,3936,1901,2035
050,34,001,"New Jersey","Atlantic County",2,65,3757,1828,1929
050,34,001,"New Jersey","Atlantic County",2,66,3542,1680,1862
050,34,001,"New Jersey","Atlantic County",2,67,3345,1581,1764
050,34,001,"New Jersey","Atlantic County",2,68,3210,1534,1676
050,34,001,"New Jersey","Atlantic County",2,69,3053,1456,1597
050,34,001,"New Jersey","Atlantic County",2,70,2883,1341,1542
050,34,001,"New Jersey","Atlantic County",2,71,2801,1302,1499
050,34,001,"New Jersey","Atlantic County",2,72,2783,1302,1481
050,34,001,"New Jersey","Atlantic County",2,73,3003,1429,1574
050,34,001,"New Jersey","Atlantic County",2,74,2171,1029,1142
050,34,001,"New Jersey","Atlantic County",2,75,2080,944,1136
050,34,001,"New Jersey","Atlantic County",2,76,1963,877,1086
050,34,001,"New Jersey","Atlantic County",2,77,2026,892,1134
050,34,001,"New Jersey","Atlantic County",2,78,1733,736,997
050,34,001,"New Jersey","Atlantic County",2,79,1508,657,851
050,34,001,"New Jersey","Atlantic County",2,80,1373,609,764
050,34,001,"New Jersey","Atlantic County",2,81,1266,556,710
050,34,001,"New Jersey","Atlantic County",2,82,1205,516,689
050,34,001,"New Jersey","Atlantic County",2,83,1050,445,605
050,34,001,"New Jersey","Atlantic County",2,84,939,388,551
050,34,001,"New Jersey","Atlantic County",2,85,5374,1898,3476
050,34,001,"New Jersey","Atlantic County",3,0,2690,1415,1275
050,34,001,"New Jersey","Atlantic County",3,1,2803,1470,1333
050,34,001,"New Jersey","Atlantic County",3,2,2883,1460,1423
050,34,001,"New Jersey","Atlantic County",3,3,2921,1517,1404
050,34,001,"New Jersey","Atlantic County",3,4,2967,1553,1414
050,34,001,"New Jersey","Atlantic County",3,5,2967,1510,1457
050,34,001,"New Jersey","Atlantic County",3,6,3134,1597,1537
050,34,001,"New Jersey","Atlantic County",3,7,3174,1642,1532
050,34,001,"New Jersey","Atlantic County",3,8,3232,1672,1560
050,34,001,"New Jersey","Atlantic County",3,9,3313,1714,1599
050,34,001,"New Jersey","Atlantic County",3,10,3343,1741,1602
050,34,001,"New Jersey","Atlantic County",3,11,3354,1746,1608
050,34,001,"New Jersey","Atlantic County",3,12,3380,1752,1628
050,34,001,"New Jersey","Atlantic County",3,13,3544,1812,1732
050,34,001,"New Jersey","Atlantic County",3,14,3478,1751,1727
050,34,001,"New Jersey","Atlantic County",3,15,3469,1767,1702
050,34,001,"New Jersey","Atlantic County",3,16,3492,1807,1685
050,34,001,"New Jersey","Atlantic County",3,17,3474,1781,1693
050,34,001,"New Jersey","Atlantic County",3,18,3404,1741,1663
050,34,001,"New Jersey","Atlantic County",3,19,3479,1756,1723
050,34,001,"New Jersey","Atlantic County",3,20,3584,1763,1821
050,34,001,"New Jersey","Atlantic County",3,21,3681,1843,1838
050,34,001,"New Jersey","Atlantic County",3,22,3454,1761,1693
050,34,001,"New Jersey","Atlantic County",3,23,3353,1711,1642
050,34,001,"New Jersey","Atlantic County",3,24,3343,1684,1659
050,34,001,"New Jersey","Atlantic County",3,25,3298,1648,1650
050,34,001,"New Jersey","Atlantic County",3,26,3457,1750,1707
050,34,001,"New Jersey","Atlantic County",3,27,3428,1728,1700
050,34,001,"New Jersey","Atlantic County",3,28,3436,1726,1710
050,34,001,"New Jersey","Atlantic County",3,29,3420,1678,1742
050,34,001,"New Jersey","Atlantic County",3,30,3325,1657,1668
050,34,001,"New Jersey","Atlantic County",3,31,3305,1665,1640
050,34,001,"New Jersey","Atlantic County",3,32,3207,1614,1593
050,34,001,"New Jersey","Atlantic County",3,33,3183,1563,1620
050,34,001,"New Jersey","Atlantic County",3,34,3138,1548,1590
050,34,001,"New Jersey","Atlantic County",3,35,3148,1540,1608
050,34,001,"New Jersey","Atlantic County",3,36,3165,1587,1578
050,34,001,"New Jersey","Atlantic County",3,37,3097,1546,1551
050,34,001,"New Jersey","Atlantic County",3,38,3142,1541,1601
050,34,001,"New Jersey","Atlantic County",3,39,3116,1527,1589
050,34,001,"New Jersey","Atlantic County",3,40,2995,1457,1538
050,34,001,"New Jersey","Atlantic County",3,41,3105,1509,1596
050,34,001,"New Jersey","Atlantic County",3,42,3080,1472,1608
050,34,001,"New Jersey","Atlantic County",3,43,3021,1471,1550
050,34,001,"New Jersey","Atlantic County",3,44,2986,1471,1515
050,34,001,"New Jersey","Atlantic County",3,45,2979,1435,1544
050,34,001,"New Jersey","Atlantic County",3,46,3066,1468,1598
050,34,001,"New Jersey","Atlantic County",3,47,3094,1498,1596
050,34,001,"New Jersey","Atlantic County",3,48,3195,1517,1678
050,34,001,"New Jersey","Atlantic County",3,49,3507,1609,1898
050,34,001,"New Jersey","Atlantic County",3,50,3816,1778,2038
050,34,001,"New Jersey","Atlantic County",3,51,3752,1813,1939
050,34,001,"New Jersey","Atlantic County",3,52,3662,1740,1922
050,34,001,"New Jersey","Atlantic County",3,53,3705,1788,1917
050,34,001,"New Jersey","Atlantic County",3,54,3758,1817,1941
050,34,001,"New Jersey","Atlantic County",3,55,3916,1878,2038
050,34,001,"New Jersey","Atlantic County",3,56,4066,1945,2121
050,34,001,"New Jersey","Atlantic County",3,57,4260,2021,2239
050,34,001,"New Jersey","Atlantic County",3,58,4252,2045,2207
050,34,001,"New Jersey","Atlantic County",3,59,4280,2079,2201
050,34,001,"New Jersey","Atlantic County",3,60,4335,2120,2215
050,34,001,"New Jersey","Atlantic County",3,61,4169,2026,2143
050,34,001,"New Jersey","Atlantic County",3,62,4197,2001,2196
050,34,001,"New Jersey","Atlantic County",3,63,4157,1981,2176
050,34,001,"New Jersey","Atlantic County",3,64,4118,1969,2149
050,34,001,"New Jersey","Atlantic County",3,65,3922,1875,2047
050,34,001,"New Jersey","Atlantic County",3,66,3749,1822,1927
050,34,001,"New Jersey","Atlantic County",3,67,3516,1668,1848
050,34,001,"New Jersey","Atlantic County",3,68,3308,1576,1732
050,34,001,"New Jersey","Atlantic County",3,69,3154,1496,1658
050,34,001,"New Jersey","Atlantic County",3,70,3019,1439,1580
050,34,001,"New Jersey","Atlantic County",3,71,2839,1318,1521
050,34,001,"New Jersey","Atlantic County",3,72,2749,1274,1475
050,34,001,"New Jersey","Atlantic County",3,73,2704,1265,1439
050,34,001,"New Jersey","Atlantic County",3,74,2916,1384,1532
050,34,001,"New Jersey","Atlantic County",3,75,2118,997,1121
050,34,001,"New Jersey","Atlantic County",3,76,1991,890,1101
050,34,001,"New Jersey","Atlantic County",3,77,1886,834,1052
050,34,001,"New Jersey","Atlantic County",3,78,1906,836,1070
050,34,001,"New Jersey","Atlantic County",3,79,1651,693,958
050,34,001,"New Jersey","Atlantic County",3,80,1437,626,811
050,34,001,"New Jersey","Atlantic County",3,81,1301,571,730
050,34,001,"New Jersey","Atlantic County",3,82,1172,497,675
050,34,001,"New Jersey","Atlantic County",3,83,1100,476,624
050,34,001,"New Jersey","Atlantic County",3,84,958,400,558
050,34,001,"New Jersey","Atlantic County",3,85,5308,1890,3418
050,34,001,"New Jersey","Atlantic County",4,0,2741,1378,1363
050,34,001,"New Jersey","Atlantic County",4,1,2771,1452,1319
050,34,001,"New Jersey","Atlantic County",4,2,2841,1492,1349
050,34,001,"New Jersey","Atlantic County",4,3,2933,1499,1434
050,34,001,"New Jersey","Atlantic County",4,4,2951,1522,1429
050,34,001,"New Jersey","Atlantic County",4,5,2999,1567,1432
050,34,001,"New Jersey","Atlantic County",4,6,2983,1521,1462
050,34,001,"New Jersey","Atlantic County",4,7,3148,1613,1535
050,34,001,"New Jersey","Atlantic County",4,8,3187,1652,1535
050,34,001,"New Jersey","Atlantic County",4,9,3239,1678,1561
050,34,001,"New Jersey","Atlantic County",4,10,3300,1698,1602
050,34,001,"New Jersey","Atlantic County",4,11,3370,1752,1618
050,34,001,"New Jersey","Atlantic County",4,12,3377,1762,1615
050,34,001,"New Jersey","Atlantic County",4,13,3406,1762,1644
050,34,001,"New Jersey","Atlantic County",4,14,3530,1804,1726
050,34,001,"New Jersey","Atlantic County",4,15,3495,1760,1735
050,34,001,"New Jersey","Atlantic County",4,16,3502,1797,1705
050,34,001,"New Jersey","Atlantic County",4,17,3510,1804,1706
050,34,001,"New Jersey","Atlantic County",4,18,3409,1753,1656
050,34,001,"New Jersey","Atlantic County",4,19,3361,1687,1674
050,34,001,"New Jersey","Atlantic County",4,20,3485,1712,1773
050,34,001,"New Jersey","Atlantic County",4,21,3630,1815,1815
050,34,001,"New Jersey","Atlantic County",4,22,3635,1840,1795
050,34,001,"New Jersey","Atlantic County",4,23,3261,1655,1606
050,34,001,"New Jersey","Atlantic County",4,24,3315,1694,1621
050,34,001,"New Jersey","Atlantic County",4,25,3311,1683,1628
050,34,001,"New Jersey","Atlantic County",4,26,3316,1660,1656
050,34,001,"New Jersey","Atlantic County",4,27,3383,1697,1686
050,34,001,"New Jersey","Atlantic County",4,28,3405,1729,1676
050,34,001,"New Jersey","Atlantic County",4,29,3438,1699,1739
050,34,001,"New Jersey","Atlantic County",4,30,3439,1667,1772
050,34,001,"New Jersey","Atlantic County",4,31,3341,1682,1659
050,34,001,"New Jersey","Atlantic County",4,32,3329,1703,1626
050,34,001,"New Jersey","Atlantic County",4,33,3225,1634,1591
050,34,001,"New Jersey","Atlantic County",4,34,3231,1591,1640
050,34,001,"New Jersey","Atlantic County",4,35,3180,1562,1618
050,34,001,"New Jersey","Atlantic County",4,36,3147,1537,1610
050,34,001,"New Jersey","Atlantic County",4,37,3195,1582,1613
050,34,001,"New Jersey","Atlantic County",4,38,3087,1558,1529
050,34,001,"New Jersey","Atlantic County",4,39,3120,1513,1607
050,34,001,"New Jersey","Atlantic County",4,40,3162,1546,1616
050,34,001,"New Jersey","Atlantic County",4,41,3020,1472,1548
050,34,001,"New Jersey","Atlantic County",4,42,3130,1532,1598
050,34,001,"New Jersey","Atlantic County",4,43,3071,1469,1602
050,34,001,"New Jersey","Atlantic County",4,44,3031,1467,1564
050,34,001,"New Jersey","Atlantic County",4,45,3005,1475,1530
050,34,001,"New Jersey","Atlantic County",4,46,2961,1418,1543
050,34,001,"New Jersey","Atlantic County",4,47,3060,1478,1582
050,34,001,"New Jersey","Atlantic County",4,48,3081,1483,1598
050,34,001,"New Jersey","Atlantic County",4,49,3219,1541,1678
050,34,001,"New Jersey","Atlantic County",4,50,3513,1598,1915
050,34,001,"New Jersey","Atlantic County",4,51,3827,1781,2046
050,34,001,"New Jersey","Atlantic County",4,52,3722,1795,1927
050,34,001,"New Jersey","Atlantic County",4,53,3644,1715,1929
050,34,001,"New Jersey","Atlantic County",4,54,3687,1776,1911
050,34,001,"New Jersey","Atlantic County",4,55,3756,1800,1956
050,34,001,"New Jersey","Atlantic County",4,56,3903,1863,2040
050,34,001,"New Jersey","Atlantic County",4,57,4043,1939,2104
050,34,001,"New Jersey","Atlantic County",4,58,4221,1992,2229
050,34,001,"New Jersey","Atlantic County",4,59,4222,2024,2198
050,34,001,"New Jersey","Atlantic County",4,60,4270,2077,2193
050,34,001,"New Jersey","Atlantic County",4,61,4267,2066,2201
050,34,001,"New Jersey","Atlantic County",4,62,4130,2007,2123
050,34,001,"New Jersey","Atlantic County",4,63,4148,1978,2170
050,34,001,"New Jersey","Atlantic County",4,64,4138,1949,2189
050,34,001,"New Jersey","Atlantic County",4,65,4073,1953,2120
050,34,001,"New Jersey","Atlantic County",4,66,3865,1839,2026
050,34,001,"New Jersey","Atlantic County",4,67,3714,1811,1903
050,34,001,"New Jersey","Atlantic County",4,68,3455,1629,1826
050,34,001,"New Jersey","Atlantic County",4,69,3273,1567,1706
050,34,001,"New Jersey","Atlantic County",4,70,3139,1469,1670
050,34,001,"New Jersey","Atlantic County",4,71,2988,1424,1564
050,34,001,"New Jersey","Atlantic County",4,72,2801,1302,1499
050,34,001,"New Jersey","Atlantic County",4,73,2691,1242,1449
050,34,001,"New Jersey","Atlantic County",4,74,2627,1228,1399
050,34,001,"New Jersey","Atlantic County",4,75,2830,1317,1513
050,34,001,"New Jersey","Atlantic County",4,76,2059,957,1102
050,34,001,"New Jersey","Atlantic County",4,77,1927,859,1068
050,34,001,"New Jersey","Atlantic County",4,78,1796,794,1002
050,34,001,"New Jersey","Atlantic County",4,79,1827,792,1035
050,34,001,"New Jersey","Atlantic County",4,80,1552,646,906
050,34,001,"New Jersey","Atlantic County",4,81,1362,571,791
050,34,001,"New Jersey","Atlantic County",4,82,1219,516,703
050,34,001,"New Jersey","Atlantic County",4,83,1090,462,628
050,34,001,"New Jersey","Atlantic County",4,84,993,431,562
050,34,001,"New Jersey","Atlantic County",4,85,5344,1942,3402
050,34,001,"New Jersey","Atlantic County",5,0,2746,1385,1361
050,34,001,"New Jersey","Atlantic County",5,1,2762,1373,1389
050,34,001,"New Jersey","Atlantic County",5,2,2739,1441,1298
050,34,001,"New Jersey","Atlantic County",5,3,2853,1478,1375
050,34,001,"New Jersey","Atlantic County",5,4,2949,1513,1436
050,34,001,"New Jersey","Atlantic County",5,5,2973,1534,1439
050,34,001,"New Jersey","Atlantic County",5,6,2985,1568,1417
050,34,001,"New Jersey","Atlantic County",5,7,2963,1513,1450
050,34,001,"New Jersey","Atlantic County",5,8,3135,1593,1542
050,34,001,"New Jersey","Atlantic County",5,9,3182,1640,1542
050,34,001,"New Jersey","Atlantic County",5,10,3258,1714,1544
050,34,001,"New Jersey","Atlantic County",5,11,3321,1708,1613
050,34,001,"New Jersey","Atlantic County",5,12,3358,1741,1617
050,34,001,"New Jersey","Atlantic County",5,13,3399,1768,1631
050,34,001,"New Jersey","Atlantic County",5,14,3416,1759,1657
050,34,001,"New Jersey","Atlantic County",5,15,3539,1817,1722
050,34,001,"New Jersey","Atlantic County",5,16,3493,1763,1730
050,34,001,"New Jersey","Atlantic County",5,17,3519,1796,1723
050,34,001,"New Jersey","Atlantic County",5,18,3413,1762,1651
050,34,001,"New Jersey","Atlantic County",5,19,3388,1700,1688
050,34,001,"New Jersey","Atlantic County",5,20,3427,1667,1760
050,34,001,"New Jersey","Atlantic County",5,21,3544,1774,1770
050,34,001,"New Jersey","Atlantic County",5,22,3605,1846,1759
050,34,001,"New Jersey","Atlantic County",5,23,3529,1791,1738
050,34,001,"New Jersey","Atlantic County",5,24,3252,1653,1599
050,34,001,"New Jersey","Atlantic County",5,25,3224,1651,1573
050,34,001,"New Jersey","Atlantic County",5,26,3269,1637,1632
050,34,001,"New Jersey","Atlantic County",5,27,3259,1645,1614
050,34,001,"New Jersey","Atlantic County",5,28,3342,1653,1689
050,34,001,"New Jersey","Atlantic County",5,29,3336,1661,1675
050,34,001,"New Jersey","Atlantic County",5,30,3386,1683,1703
050,34,001,"New Jersey","Atlantic County",5,31,3429,1647,1782
050,34,001,"New Jersey","Atlantic County",5,32,3391,1712,1679
050,34,001,"New Jersey","Atlantic County",5,33,3309,1689,1620
050,34,001,"New Jersey","Atlantic County",5,34,3251,1636,1615
050,34,001,"New Jersey","Atlantic County",5,35,3192,1579,1613
050,34,001,"New Jersey","Atlantic County",5,36,3216,1589,1627
050,34,001,"New Jersey","Atlantic County",5,37,3153,1544,1609
050,34,001,"New Jersey","Atlantic County",5,38,3164,1571,1593
050,34,001,"New Jersey","Atlantic County",5,39,3057,1531,1526
050,34,001,"New Jersey","Atlantic County",5,40,3155,1510,1645
050,34,001,"New Jersey","Atlantic County",5,41,3202,1558,1644
050,34,001,"New Jersey","Atlantic County",5,42,2998,1457,1541
050,34,001,"New Jersey","Atlantic County",5,43,3158,1548,1610
050,34,001,"New Jersey","Atlantic County",5,44,3083,1473,1610
050,34,001,"New Jersey","Atlantic County",5,45,3012,1461,1551
050,34,001,"New Jersey","Atlantic County",5,46,2977,1463,1514
050,34,001,"New Jersey","Atlantic County",5,47,2963,1431,1532
050,34,001,"New Jersey","Atlantic County",5,48,3037,1470,1567
050,34,001,"New Jersey","Atlantic County",5,49,3081,1470,1611
050,34,001,"New Jersey","Atlantic County",5,50,3217,1527,1690
050,34,001,"New Jersey","Atlantic County",5,51,3509,1604,1905
050,34,001,"New Jersey","Atlantic County",5,52,3819,1778,2041
050,34,001,"New Jersey","Atlantic County",5,53,3711,1785,1926
050,34,001,"New Jersey","Atlantic County",5,54,3611,1709,1902
050,34,001,"New Jersey","Atlantic County",5,55,3651,1765,1886
050,34,001,"New Jersey","Atlantic County",5,56,3763,1798,1965
050,34,001,"New Jersey","Atlantic County",5,57,3860,1819,2041
050,34,001,"New Jersey","Atlantic County",5,58,4018,1927,2091
050,34,001,"New Jersey","Atlantic County",5,59,4204,1982,2222
050,34,001,"New Jersey","Atlantic County",5,60,4208,2022,2186
050,34,001,"New Jersey","Atlantic County",5,61,4195,2016,2179
050,34,001,"New Jersey","Atlantic County",5,62,4239,2060,2179
050,34,001,"New Jersey","Atlantic County",5,63,4125,1979,2146
050,34,001,"New Jersey","Atlantic County",5,64,4120,1943,2177
050,34,001,"New Jersey","Atlantic County",5,65,4123,1941,2182
050,34,001,"New Jersey","Atlantic County",5,66,4017,1924,2093
050,34,001,"New Jersey","Atlantic County",5,67,3820,1815,2005
050,34,001,"New Jersey","Atlantic County",5,68,3677,1795,1882
050,34,001,"New Jersey","Atlantic County",5,69,3406,1595,1811
050,34,001,"New Jersey","Atlantic County",5,70,3208,1528,1680
050,34,001,"New Jersey","Atlantic County",5,71,3064,1438,1626
050,34,001,"New Jersey","Atlantic County",5,72,2927,1386,1541
050,34,001,"New Jersey","Atlantic County",5,73,2745,1268,1477
050,34,001,"New Jersey","Atlantic County",5,74,2611,1207,1404
050,34,001,"New Jersey","Atlantic County",5,75,2567,1184,1383
050,34,001,"New Jersey","Atlantic County",5,76,2712,1254,1458
050,34,001,"New Jersey","Atlantic County",5,77,1985,918,1067
050,34,001,"New Jersey","Atlantic County",5,78,1847,820,1027
050,34,001,"New Jersey","Atlantic County",5,79,1715,757,958
050,34,001,"New Jersey","Atlantic County",5,80,1737,756,981
050,34,001,"New Jersey","Atlantic County",5,81,1489,613,876
050,34,001,"New Jersey","Atlantic County",5,82,1282,527,755
050,34,001,"New Jersey","Atlantic County",5,83,1127,482,645
050,34,001,"New Jersey","Atlantic County",5,84,1001,418,583
050,34,001,"New Jersey","Atlantic County",5,85,5511,2054,3457
050,34,003,"New Jersey","Bergen County",1,0,9073,4635,4438
050,34,003,"New Jersey","Bergen County",1,1,9457,4790,4667
050,34,003,"New Jersey","Bergen County",1,2,9856,5055,4801
050,34,003,"New Jersey","Bergen County",1,3,10249,5247,5002
050,34,003,"New Jersey","Bergen County",1,4,10796,5537,5259
050,34,003,"New Jersey","Bergen County",1,5,10658,5401,5257
050,34,003,"New Jersey","Bergen County",1,6,10710,5483,5227
050,34,003,"New Jersey","Bergen County",1,7,10982,5579,5403
050,34,003,"New Jersey","Bergen County",1,8,11048,5690,5358
050,34,003,"New Jersey","Bergen County",1,9,11420,5850,5570
050,34,003,"New Jersey","Bergen County",1,10,11790,6020,5770
050,34,003,"New Jersey","Bergen County",1,11,11951,6108,5843
050,34,003,"New Jersey","Bergen County",1,12,12578,6464,6114
050,34,003,"New Jersey","Bergen County",1,13,12508,6415,6093
050,34,003,"New Jersey","Bergen County",1,14,12268,6269,5999
050,34,003,"New Jersey","Bergen County",1,15,12602,6435,6167
050,34,003,"New Jersey","Bergen County",1,16,13016,6657,6359
050,34,003,"New Jersey","Bergen County",1,17,12688,6527,6161
050,34,003,"New Jersey","Bergen County",1,18,11217,5860,5357
050,34,003,"New Jersey","Bergen County",1,19,9975,5107,4868
050,34,003,"New Jersey","Bergen County",1,20,10470,5303,5167
050,34,003,"New Jersey","Bergen County",1,21,10841,5430,5411
050,34,003,"New Jersey","Bergen County",1,22,11001,5506,5495
050,34,003,"New Jersey","Bergen County",1,23,10973,5475,5498
050,34,003,"New Jersey","Bergen County",1,24,10792,5505,5287
050,34,003,"New Jersey","Bergen County",1,25,10841,5556,5285
050,34,003,"New Jersey","Bergen County",1,26,10623,5343,5280
050,34,003,"New Jersey","Bergen County",1,27,10506,5255,5251
050,34,003,"New Jersey","Bergen County",1,28,10266,5165,5101
050,34,003,"New Jersey","Bergen County",1,29,10296,5174,5122
050,34,003,"New Jersey","Bergen County",1,30,10390,5231,5159
050,34,003,"New Jersey","Bergen County",1,31,10690,5445,5245
050,34,003,"New Jersey","Bergen County",1,32,11145,5551,5594
050,34,003,"New Jersey","Bergen County",1,33,11658,5801,5857
050,34,003,"New Jersey","Bergen County",1,34,11995,6014,5981
050,34,003,"New Jersey","Bergen County",1,35,12214,6047,6167
050,34,003,"New Jersey","Bergen County",1,36,12248,6033,6215
050,34,003,"New Jersey","Bergen County",1,37,12828,6437,6391
050,34,003,"New Jersey","Bergen County",1,38,13187,6540,6647
050,34,003,"New Jersey","Bergen County",1,39,13075,6418,6657
050,34,003,"New Jersey","Bergen County",1,40,13134,6449,6685
050,34,003,"New Jersey","Bergen County",1,41,13018,6385,6633
050,34,003,"New Jersey","Bergen County",1,42,12951,6355,6596
050,34,003,"New Jersey","Bergen County",1,43,12610,6157,6453
050,34,003,"New Jersey","Bergen County",1,44,12741,6249,6492
050,34,003,"New Jersey","Bergen County",1,45,12898,6345,6553
050,34,003,"New Jersey","Bergen County",1,46,12633,6249,6384
050,34,003,"New Jersey","Bergen County",1,47,12948,6426,6522
050,34,003,"New Jersey","Bergen County",1,48,13457,6716,6741
050,34,003,"New Jersey","Bergen County",1,49,14339,7108,7231
050,34,003,"New Jersey","Bergen County",1,50,14179,7004,7175
050,34,003,"New Jersey","Bergen County",1,51,13928,6850,7078
050,34,003,"New Jersey","Bergen County",1,52,13792,6713,7079
050,34,003,"New Jersey","Bergen County",1,53,13856,6712,7144
050,34,003,"New Jersey","Bergen County",1,54,14120,6919,7201
050,34,003,"New Jersey","Bergen County",1,55,14600,7157,7443
050,34,003,"New Jersey","Bergen County",1,56,14702,7167,7535
050,34,003,"New Jersey","Bergen County",1,57,14600,7276,7324
050,34,003,"New Jersey","Bergen County",1,58,14285,7086,7199
050,34,003,"New Jersey","Bergen County",1,59,14153,6973,7180
050,34,003,"New Jersey","Bergen County",1,60,13774,6778,6996
050,34,003,"New Jersey","Bergen County",1,61,13487,6555,6932
050,34,003,"New Jersey","Bergen County",1,62,13237,6395,6842
050,34,003,"New Jersey","Bergen County",1,63,12689,6188,6501
050,34,003,"New Jersey","Bergen County",1,64,12377,5947,6430
050,34,003,"New Jersey","Bergen County",1,65,11903,5753,6150
050,34,003,"New Jersey","Bergen County",1,66,10957,5268,5689
050,34,003,"New Jersey","Bergen County",1,67,10376,4958,5418
050,34,003,"New Jersey","Bergen County",1,68,9816,4678,5138
050,34,003,"New Jersey","Bergen County",1,69,9088,4229,4859
050,34,003,"New Jersey","Bergen County",1,70,8921,4193,4728
050,34,003,"New Jersey","Bergen County",1,71,8729,4064,4665
050,34,003,"New Jersey","Bergen County",1,72,8917,4118,4799
050,34,003,"New Jersey","Bergen County",1,73,8935,4157,4778
050,34,003,"New Jersey","Bergen County",1,74,6652,3080,3572
050,34,003,"New Jersey","Bergen County",1,75,6313,2806,3507
050,34,003,"New Jersey","Bergen County",1,76,6213,2704,3509
050,34,003,"New Jersey","Bergen County",1,77,6232,2737,3495
050,34,003,"New Jersey","Bergen County",1,78,5403,2336,3067
050,34,003,"New Jersey","Bergen County",1,79,4944,2089,2855
050,34,003,"New Jersey","Bergen County",1,80,4593,1941,2652
050,34,003,"New Jersey","Bergen County",1,81,4389,1887,2502
050,34,003,"New Jersey","Bergen County",1,82,4077,1682,2395
050,34,003,"New Jersey","Bergen County",1,83,3745,1522,2223
050,34,003,"New Jersey","Bergen County",1,84,3539,1397,2142
050,34,003,"New Jersey","Bergen County",1,85,22612,7934,14678
050,34,003,"New Jersey","Bergen County",2,0,9049,4679,4370
050,34,003,"New Jersey","Bergen County",2,1,9377,4761,4616
050,34,003,"New Jersey","Bergen County",2,2,9801,5023,4778
050,34,003,"New Jersey","Bergen County",2,3,10170,5215,4955
050,34,003,"New Jersey","Bergen County",2,4,10712,5494,5218
050,34,003,"New Jersey","Bergen County",2,5,10741,5464,5277
050,34,003,"New Jersey","Bergen County",2,6,10744,5490,5254
050,34,003,"New Jersey","Bergen County",2,7,10928,5565,5363
050,34,003,"New Jersey","Bergen County",2,8,11007,5648,5359
050,34,003,"New Jersey","Bergen County",2,9,11328,5809,5519
050,34,003,"New Jersey","Bergen County",2,10,11721,5988,5733
050,34,003,"New Jersey","Bergen County",2,11,11868,6066,5802
050,34,003,"New Jersey","Bergen County",2,12,12493,6407,6086
050,34,003,"New Jersey","Bergen County",2,13,12507,6417,6090
050,34,003,"New Jersey","Bergen County",2,14,12331,6308,6023
050,34,003,"New Jersey","Bergen County",2,15,12548,6403,6145
050,34,003,"New Jersey","Bergen County",2,16,12924,6603,6321
050,34,003,"New Jersey","Bergen County",2,17,12776,6563,6213
050,34,003,"New Jersey","Bergen County",2,18,11213,5840,5373
050,34,003,"New Jersey","Bergen County",2,19,9991,5120,4871
050,34,003,"New Jersey","Bergen County",2,20,10570,5359,5211
050,34,003,"New Jersey","Bergen County",2,21,10832,5432,5400
050,34,003,"New Jersey","Bergen County",2,22,10953,5472,5481
050,34,003,"New Jersey","Bergen County",2,23,10934,5463,5471
050,34,003,"New Jersey","Bergen County",2,24,10793,5489,5304
050,34,003,"New Jersey","Bergen County",2,25,10764,5522,5242
050,34,003,"New Jersey","Bergen County",2,26,10642,5385,5257
050,34,003,"New Jersey","Bergen County",2,27,10488,5249,5239
050,34,003,"New Jersey","Bergen County",2,28,10374,5211,5163
050,34,003,"New Jersey","Bergen County",2,29,10320,5183,5137
050,34,003,"New Jersey","Bergen County",2,30,10473,5266,5207
050,34,003,"New Jersey","Bergen County",2,31,10638,5393,5245
050,34,003,"New Jersey","Bergen County",2,32,11089,5550,5539
050,34,003,"New Jersey","Bergen County",2,33,11539,5745,5794
050,34,003,"New Jersey","Bergen County",2,34,11937,5970,5967
050,34,003,"New Jersey","Bergen County",2,35,12234,6074,6160
050,34,003,"New Jersey","Bergen County",2,36,12205,6023,6182
050,34,003,"New Jersey","Bergen County",2,37,12752,6367,6385
050,34,003,"New Jersey","Bergen County",2,38,13203,6575,6628
050,34,003,"New Jersey","Bergen County",2,39,13083,6441,6642
050,34,003,"New Jersey","Bergen County",2,40,13233,6504,6729
050,34,003,"New Jersey","Bergen County",2,41,13040,6398,6642
050,34,003,"New Jersey","Bergen County",2,42,12929,6351,6578
050,34,003,"New Jersey","Bergen County",2,43,12743,6224,6519
050,34,003,"New Jersey","Bergen County",2,44,12632,6192,6440
050,34,003,"New Jersey","Bergen County",2,45,12916,6353,6563
050,34,003,"New Jersey","Bergen County",2,46,12664,6258,6406
050,34,003,"New Jersey","Bergen County",2,47,12841,6365,6476
050,34,003,"New Jersey","Bergen County",2,48,13324,6644,6680
050,34,003,"New Jersey","Bergen County",2,49,14121,7024,7097
050,34,003,"New Jersey","Bergen County",2,50,14213,7024,7189
050,34,003,"New Jersey","Bergen County",2,51,13904,6837,7067
050,34,003,"New Jersey","Bergen County",2,52,13803,6736,7067
050,34,003,"New Jersey","Bergen County",2,53,13760,6669,7091
050,34,003,"New Jersey","Bergen County",2,54,13982,6836,7146
050,34,003,"New Jersey","Bergen County",2,55,14449,7084,7365
050,34,003,"New Jersey","Bergen County",2,56,14664,7157,7507
050,34,003,"New Jersey","Bergen County",2,57,14587,7221,7366
050,34,003,"New Jersey","Bergen County",2,58,14289,7086,7203
050,34,003,"New Jersey","Bergen County",2,59,14116,6963,7153
050,34,003,"New Jersey","Bergen County",2,60,13820,6804,7016
050,34,003,"New Jersey","Bergen County",2,61,13438,6545,6893
050,34,003,"New Jersey","Bergen County",2,62,13200,6369,6831
050,34,003,"New Jersey","Bergen County",2,63,12814,6222,6592
050,34,003,"New Jersey","Bergen County",2,64,12282,5900,6382
050,34,003,"New Jersey","Bergen County",2,65,11921,5748,6173
050,34,003,"New Jersey","Bergen County",2,66,11123,5342,5781
050,34,003,"New Jersey","Bergen County",2,67,10409,4975,5434
050,34,003,"New Jersey","Bergen County",2,68,9819,4680,5139
050,34,003,"New Jersey","Bergen County",2,69,9214,4304,4910
050,34,003,"New Jersey","Bergen County",2,70,8858,4126,4732
050,34,003,"New Jersey","Bergen County",2,71,8685,4047,4638
050,34,003,"New Jersey","Bergen County",2,72,8686,4013,4673
050,34,003,"New Jersey","Bergen County",2,73,9201,4268,4933
050,34,003,"New Jersey","Bergen County",2,74,6779,3123,3656
050,34,003,"New Jersey","Bergen County",2,75,6337,2829,3508
050,34,003,"New Jersey","Bergen County",2,76,6117,2661,3456
050,34,003,"New Jersey","Bergen County",2,77,6230,2722,3508
050,34,003,"New Jersey","Bergen County",2,78,5448,2352,3096
050,34,003,"New Jersey","Bergen County",2,79,4957,2097,2860
050,34,003,"New Jersey","Bergen County",2,80,4590,1916,2674
050,34,003,"New Jersey","Bergen County",2,81,4326,1853,2473
050,34,003,"New Jersey","Bergen County",2,82,4079,1686,2393
050,34,003,"New Jersey","Bergen County",2,83,3700,1501,2199
050,34,003,"New Jersey","Bergen County",2,84,3478,1380,2098
050,34,003,"New Jersey","Bergen County",2,85,21917,7680,14237
050,34,003,"New Jersey","Bergen County",3,0,8899,4562,4337
050,34,003,"New Jersey","Bergen County",3,1,9405,4878,4527
050,34,003,"New Jersey","Bergen County",3,2,9638,4900,4738
050,34,003,"New Jersey","Bergen County",3,3,10092,5148,4944
050,34,003,"New Jersey","Bergen County",3,4,10283,5280,5003
050,34,003,"New Jersey","Bergen County",3,5,10877,5565,5312
050,34,003,"New Jersey","Bergen County",3,6,10817,5492,5325
050,34,003,"New Jersey","Bergen County",3,7,10800,5522,5278
050,34,003,"New Jersey","Bergen County",3,8,11022,5594,5428
050,34,003,"New Jersey","Bergen County",3,9,11051,5680,5371
050,34,003,"New Jersey","Bergen County",3,10,11367,5813,5554
050,34,003,"New Jersey","Bergen County",3,11,11719,5976,5743
050,34,003,"New Jersey","Bergen County",3,12,11935,6086,5849
050,34,003,"New Jersey","Bergen County",3,13,12540,6431,6109
050,34,003,"New Jersey","Bergen County",3,14,12578,6443,6135
050,34,003,"New Jersey","Bergen County",3,15,12342,6314,6028
050,34,003,"New Jersey","Bergen County",3,16,12517,6369,6148
050,34,003,"New Jersey","Bergen County",3,17,12914,6594,6320
050,34,003,"New Jersey","Bergen County",3,18,11510,5975,5535
050,34,003,"New Jersey","Bergen County",3,19,9796,5041,4755
050,34,003,"New Jersey","Bergen County",3,20,10510,5373,5137
050,34,003,"New Jersey","Bergen County",3,21,11013,5562,5451
050,34,003,"New Jersey","Bergen County",3,22,11022,5545,5477
050,34,003,"New Jersey","Bergen County",3,23,10954,5534,5420
050,34,003,"New Jersey","Bergen County",3,24,10994,5532,5462
050,34,003,"New Jersey","Bergen County",3,25,10814,5496,5318
050,34,003,"New Jersey","Bergen County",3,26,10910,5615,5295
050,34,003,"New Jersey","Bergen County",3,27,10643,5326,5317
050,34,003,"New Jersey","Bergen County",3,28,10717,5368,5349
050,34,003,"New Jersey","Bergen County",3,29,10557,5321,5236
050,34,003,"New Jersey","Bergen County",3,30,10661,5379,5282
050,34,003,"New Jersey","Bergen County",3,31,10937,5523,5414
050,34,003,"New Jersey","Bergen County",3,32,11068,5584,5484
050,34,003,"New Jersey","Bergen County",3,33,11574,5809,5765
050,34,003,"New Jersey","Bergen County",3,34,11885,5897,5988
050,34,003,"New Jersey","Bergen County",3,35,12221,6134,6087
050,34,003,"New Jersey","Bergen County",3,36,12397,6082,6315
050,34,003,"New Jersey","Bergen County",3,37,12499,6119,6380
050,34,003,"New Jersey","Bergen County",3,38,12881,6455,6426
050,34,003,"New Jersey","Bergen County",3,39,13401,6707,6694
050,34,003,"New Jersey","Bergen County",3,40,13226,6494,6732
050,34,003,"New Jersey","Bergen County",3,41,13222,6534,6688
050,34,003,"New Jersey","Bergen County",3,42,13107,6429,6678
050,34,003,"New Jersey","Bergen County",3,43,13011,6400,6611
050,34,003,"New Jersey","Bergen County",3,44,12859,6272,6587
050,34,003,"New Jersey","Bergen County",3,45,12637,6221,6416
050,34,003,"New Jersey","Bergen County",3,46,12880,6355,6525
050,34,003,"New Jersey","Bergen County",3,47,12620,6240,6380
050,34,003,"New Jersey","Bergen County",3,48,12773,6329,6444
050,34,003,"New Jersey","Bergen County",3,49,13230,6588,6642
050,34,003,"New Jersey","Bergen County",3,50,14044,7007,7037
050,34,003,"New Jersey","Bergen County",3,51,14077,6987,7090
050,34,003,"New Jersey","Bergen County",3,52,13766,6782,6984
050,34,003,"New Jersey","Bergen County",3,53,13637,6665,6972
050,34,003,"New Jersey","Bergen County",3,54,13590,6570,7020
050,34,003,"New Jersey","Bergen County",3,55,13858,6771,7087
050,34,003,"New Jersey","Bergen County",3,56,14292,7043,7249
050,34,003,"New Jersey","Bergen County",3,57,14379,7000,7379
050,34,003,"New Jersey","Bergen County",3,58,14340,7098,7242
050,34,003,"New Jersey","Bergen County",3,59,14062,6965,7097
050,34,003,"New Jersey","Bergen County",3,60,13889,6846,7043
050,34,003,"New Jersey","Bergen County",3,61,13578,6681,6897
050,34,003,"New Jersey","Bergen County",3,62,13141,6379,6762
050,34,003,"New Jersey","Bergen County",3,63,12842,6161,6681
050,34,003,"New Jersey","Bergen County",3,64,12499,6063,6436
050,34,003,"New Jersey","Bergen County",3,65,11984,5759,6225
050,34,003,"New Jersey","Bergen County",3,66,11608,5573,6035
050,34,003,"New Jersey","Bergen County",3,67,10763,5142,5621
050,34,003,"New Jersey","Bergen County",3,68,10120,4814,5306
050,34,003,"New Jersey","Bergen County",3,69,9533,4517,5016
050,34,003,"New Jersey","Bergen County",3,70,8965,4144,4821
050,34,003,"New Jersey","Bergen County",3,71,8617,3997,4620
050,34,003,"New Jersey","Bergen County",3,72,8463,3908,4555
050,34,003,"New Jersey","Bergen County",3,73,8463,3878,4585
050,34,003,"New Jersey","Bergen County",3,74,8966,4119,4847
050,34,003,"New Jersey","Bergen County",3,75,6560,3009,3551
050,34,003,"New Jersey","Bergen County",3,76,6184,2732,3452
050,34,003,"New Jersey","Bergen County",3,77,5932,2567,3365
050,34,003,"New Jersey","Bergen County",3,78,5957,2588,3369
050,34,003,"New Jersey","Bergen County",3,79,5265,2261,3004
050,34,003,"New Jersey","Bergen County",3,80,4768,1963,2805
050,34,003,"New Jersey","Bergen County",3,81,4397,1845,2552
050,34,003,"New Jersey","Bergen County",3,82,4125,1732,2393
050,34,003,"New Jersey","Bergen County",3,83,3835,1560,2275
050,34,003,"New Jersey","Bergen County",3,84,3500,1396,2104
050,34,003,"New Jersey","Bergen County",3,85,22059,7777,14282
050,34,003,"New Jersey","Bergen County",4,0,9307,4732,4575
050,34,003,"New Jersey","Bergen County",4,1,9206,4691,4515
050,34,003,"New Jersey","Bergen County",4,2,9585,4976,4609
050,34,003,"New Jersey","Bergen County",4,3,9798,4992,4806
050,34,003,"New Jersey","Bergen County",4,4,10311,5285,5026
050,34,003,"New Jersey","Bergen County",4,5,10438,5365,5073
050,34,003,"New Jersey","Bergen County",4,6,11025,5623,5402
050,34,003,"New Jersey","Bergen County",4,7,10842,5519,5323
050,34,003,"New Jersey","Bergen County",4,8,10947,5578,5369
050,34,003,"New Jersey","Bergen County",4,9,11052,5631,5421
050,34,003,"New Jersey","Bergen County",4,10,11083,5684,5399
050,34,003,"New Jersey","Bergen County",4,11,11424,5828,5596
050,34,003,"New Jersey","Bergen County",4,12,11771,6002,5769
050,34,003,"New Jersey","Bergen County",4,13,11946,6075,5871
050,34,003,"New Jersey","Bergen County",4,14,12528,6412,6116
050,34,003,"New Jersey","Bergen County",4,15,12637,6482,6155
050,34,003,"New Jersey","Bergen County",4,16,12352,6339,6013
050,34,003,"New Jersey","Bergen County",4,17,12585,6403,6182
050,34,003,"New Jersey","Bergen County",4,18,11561,5986,5575
050,34,003,"New Jersey","Bergen County",4,19,9885,5106,4779
050,34,003,"New Jersey","Bergen County",4,20,10183,5211,4972
050,34,003,"New Jersey","Bergen County",4,21,10860,5497,5363
050,34,003,"New Jersey","Bergen County",4,22,11110,5581,5529
050,34,003,"New Jersey","Bergen County",4,23,10821,5429,5392
050,34,003,"New Jersey","Bergen County",4,24,10750,5415,5335
050,34,003,"New Jersey","Bergen County",4,25,10793,5435,5358
050,34,003,"New Jersey","Bergen County",4,26,10641,5442,5199
050,34,003,"New Jersey","Bergen County",4,27,10719,5423,5296
050,34,003,"New Jersey","Bergen County",4,28,10618,5340,5278
050,34,003,"New Jersey","Bergen County",4,29,10740,5377,5363
050,34,003,"New Jersey","Bergen County",4,30,10613,5354,5259
050,34,003,"New Jersey","Bergen County",4,31,10829,5435,5394
050,34,003,"New Jersey","Bergen County",4,32,11198,5688,5510
050,34,003,"New Jersey","Bergen County",4,33,11359,5699,5660
050,34,003,"New Jersey","Bergen County",4,34,11690,5820,5870
050,34,003,"New Jersey","Bergen County",4,35,12065,5999,6066
050,34,003,"New Jersey","Bergen County",4,36,12406,6196,6210
050,34,003,"New Jersey","Bergen County",4,37,12648,6215,6433
050,34,003,"New Jersey","Bergen County",4,38,12597,6210,6387
050,34,003,"New Jersey","Bergen County",4,39,12916,6457,6459
050,34,003,"New Jersey","Bergen County",4,40,13521,6719,6802
050,34,003,"New Jersey","Bergen County",4,41,13248,6458,6790
050,34,003,"New Jersey","Bergen County",4,42,13293,6569,6724
050,34,003,"New Jersey","Bergen County",4,43,13166,6493,6673
050,34,003,"New Jersey","Bergen County",4,44,12990,6379,6611
050,34,003,"New Jersey","Bergen County",4,45,12811,6194,6617
050,34,003,"New Jersey","Bergen County",4,46,12682,6268,6414
050,34,003,"New Jersey","Bergen County",4,47,12916,6374,6542
050,34,003,"New Jersey","Bergen County",4,48,12579,6185,6394
050,34,003,"New Jersey","Bergen County",4,49,12784,6345,6439
050,34,003,"New Jersey","Bergen County",4,50,13179,6575,6604
050,34,003,"New Jersey","Bergen County",4,51,13941,6953,6988
050,34,003,"New Jersey","Bergen County",4,52,13921,6902,7019
050,34,003,"New Jersey","Bergen County",4,53,13608,6705,6903
050,34,003,"New Jersey","Bergen County",4,54,13514,6608,6906
050,34,003,"New Jersey","Bergen County",4,55,13484,6546,6938
050,34,003,"New Jersey","Bergen County",4,56,13628,6666,6962
050,34,003,"New Jersey","Bergen County",4,57,14066,6944,7122
050,34,003,"New Jersey","Bergen County",4,58,14119,6855,7264
050,34,003,"New Jersey","Bergen County",4,59,14089,6989,7100
050,34,003,"New Jersey","Bergen County",4,60,13817,6874,6943
050,34,003,"New Jersey","Bergen County",4,61,13609,6703,6906
050,34,003,"New Jersey","Bergen County",4,62,13282,6498,6784
050,34,003,"New Jersey","Bergen County",4,63,12837,6222,6615
050,34,003,"New Jersey","Bergen County",4,64,12541,5984,6557
050,34,003,"New Jersey","Bergen County",4,65,12178,5916,6262
050,34,003,"New Jersey","Bergen County",4,66,11597,5524,6073
050,34,003,"New Jersey","Bergen County",4,67,11236,5390,5846
050,34,003,"New Jersey","Bergen County",4,68,10434,4965,5469
050,34,003,"New Jersey","Bergen County",4,69,9840,4670,5170
050,34,003,"New Jersey","Bergen County",4,70,9272,4372,4900
050,34,003,"New Jersey","Bergen County",4,71,8729,4016,4713
050,34,003,"New Jersey","Bergen County",4,72,8342,3835,4507
050,34,003,"New Jersey","Bergen County",4,73,8234,3783,4451
050,34,003,"New Jersey","Bergen County",4,74,8232,3745,4487
050,34,003,"New Jersey","Bergen County",4,75,8670,3944,4726
050,34,003,"New Jersey","Bergen County",4,76,6387,2903,3484
050,34,003,"New Jersey","Bergen County",4,77,6008,2662,3346
050,34,003,"New Jersey","Bergen County",4,78,5682,2447,3235
050,34,003,"New Jersey","Bergen County",4,79,5790,2500,3290
050,34,003,"New Jersey","Bergen County",4,80,5006,2136,2870
050,34,003,"New Jersey","Bergen County",4,81,4543,1883,2660
050,34,003,"New Jersey","Bergen County",4,82,4195,1702,2493
050,34,003,"New Jersey","Bergen County",4,83,3875,1603,2272
050,34,003,"New Jersey","Bergen County",4,84,3626,1476,2150
050,34,003,"New Jersey","Bergen County",4,85,22200,7936,14264
050,34,003,"New Jersey","Bergen County",5,0,9236,4697,4539
050,34,003,"New Jersey","Bergen County",5,1,9707,4972,4735
050,34,003,"New Jersey","Bergen County",5,2,9503,4795,4708
050,34,003,"New Jersey","Bergen County",5,3,9878,5143,4735
050,34,003,"New Jersey","Bergen County",5,4,10057,5154,4903
050,34,003,"New Jersey","Bergen County",5,5,10461,5369,5092
050,34,003,"New Jersey","Bergen County",5,6,10691,5462,5229
050,34,003,"New Jersey","Bergen County",5,7,11171,5741,5430
050,34,003,"New Jersey","Bergen County",5,8,11028,5604,5424
050,34,003,"New Jersey","Bergen County",5,9,11122,5659,5463
050,34,003,"New Jersey","Bergen County",5,10,11179,5680,5499
050,34,003,"New Jersey","Bergen County",5,11,11175,5722,5453
050,34,003,"New Jersey","Bergen County",5,12,11515,5880,5635
050,34,003,"New Jersey","Bergen County",5,13,11872,6039,5833
050,34,003,"New Jersey","Bergen County",5,14,12018,6091,5927
050,34,003,"New Jersey","Bergen County",5,15,12683,6493,6190
050,34,003,"New Jersey","Bergen County",5,16,12698,6545,6153
050,34,003,"New Jersey","Bergen County",5,17,12340,6310,6030
050,34,003,"New Jersey","Bergen County",5,18,11311,5818,5493
050,34,003,"New Jersey","Bergen County",5,19,10070,5141,4929
050,34,003,"New Jersey","Bergen County",5,20,10589,5434,5155
050,34,003,"New Jersey","Bergen County",5,21,10633,5408,5225
050,34,003,"New Jersey","Bergen County",5,22,11043,5591,5452
050,34,003,"New Jersey","Bergen County",5,23,11014,5563,5451
050,34,003,"New Jersey","Bergen County",5,24,10746,5404,5342
050,34,003,"New Jersey","Bergen County",5,25,10713,5402,5311
050,34,003,"New Jersey","Bergen County",5,26,10782,5408,5374
050,34,003,"New Jersey","Bergen County",5,27,10611,5343,5268
050,34,003,"New Jersey","Bergen County",5,28,10772,5418,5354
050,34,003,"New Jersey","Bergen County",5,29,10734,5371,5363
050,34,003,"New Jersey","Bergen County",5,30,10958,5468,5490
050,34,003,"New Jersey","Bergen County",5,31,10893,5501,5392
050,34,003,"New Jersey","Bergen County",5,32,11147,5556,5591
050,34,003,"New Jersey","Bergen County",5,33,11627,5882,5745
050,34,003,"New Jersey","Bergen County",5,34,11643,5852,5791
050,34,003,"New Jersey","Bergen County",5,35,12064,5982,6082
050,34,003,"New Jersey","Bergen County",5,36,12246,6090,6156
050,34,003,"New Jersey","Bergen County",5,37,12745,6405,6340
050,34,003,"New Jersey","Bergen County",5,38,12778,6244,6534
050,34,003,"New Jersey","Bergen County",5,39,12789,6332,6457
050,34,003,"New Jersey","Bergen County",5,40,13196,6576,6620
050,34,003,"New Jersey","Bergen County",5,41,13630,6743,6887
050,34,003,"New Jersey","Bergen County",5,42,13328,6510,6818
050,34,003,"New Jersey","Bergen County",5,43,13426,6667,6759
050,34,003,"New Jersey","Bergen County",5,44,13268,6577,6691
050,34,003,"New Jersey","Bergen County",5,45,13068,6389,6679
050,34,003,"New Jersey","Bergen County",5,46,12847,6244,6603
050,34,003,"New Jersey","Bergen County",5,47,12635,6237,6398
050,34,003,"New Jersey","Bergen County",5,48,12900,6364,6536
050,34,003,"New Jersey","Bergen County",5,49,12625,6219,6406
050,34,003,"New Jersey","Bergen County",5,50,12754,6331,6423
050,34,003,"New Jersey","Bergen County",5,51,13129,6573,6556
050,34,003,"New Jersey","Bergen County",5,52,13826,6862,6964
050,34,003,"New Jersey","Bergen County",5,53,13802,6827,6975
050,34,003,"New Jersey","Bergen County",5,54,13510,6627,6883
050,34,003,"New Jersey","Bergen County",5,55,13425,6608,6817
050,34,003,"New Jersey","Bergen County",5,56,13307,6459,6848
050,34,003,"New Jersey","Bergen County",5,57,13434,6587,6847
050,34,003,"New Jersey","Bergen County",5,58,13879,6850,7029
050,34,003,"New Jersey","Bergen County",5,59,13942,6771,7171
050,34,003,"New Jersey","Bergen County",5,60,13942,6908,7034
050,34,003,"New Jersey","Bergen County",5,61,13572,6769,6803
050,34,003,"New Jersey","Bergen County",5,62,13383,6550,6833
050,34,003,"New Jersey","Bergen County",5,63,13092,6393,6699
050,34,003,"New Jersey","Bergen County",5,64,12552,6076,6476
050,34,003,"New Jersey","Bergen County",5,65,12274,5868,6406
050,34,003,"New Jersey","Bergen County",5,66,11873,5731,6142
050,34,003,"New Jersey","Bergen County",5,67,11338,5384,5954
050,34,003,"New Jersey","Bergen County",5,68,10998,5267,5731
050,34,003,"New Jersey","Bergen County",5,69,10189,4839,5350
050,34,003,"New Jersey","Bergen County",5,70,9635,4534,5101
050,34,003,"New Jersey","Bergen County",5,71,9068,4264,4804
050,34,003,"New Jersey","Bergen County",5,72,8520,3917,4603
050,34,003,"New Jersey","Bergen County",5,73,8143,3735,4408
050,34,003,"New Jersey","Bergen County",5,74,8037,3681,4356
050,34,003,"New Jersey","Bergen County",5,75,8035,3634,4401
050,34,003,"New Jersey","Bergen County",5,76,8427,3806,4621
050,34,003,"New Jersey","Bergen County",5,77,6218,2812,3406
050,34,003,"New Jersey","Bergen County",5,78,5803,2566,3237
050,34,003,"New Jersey","Bergen County",5,79,5514,2356,3158
050,34,003,"New Jersey","Bergen County",5,80,5547,2377,3170
050,34,003,"New Jersey","Bergen County",5,81,4798,2046,2752
050,34,003,"New Jersey","Bergen County",5,82,4348,1753,2595
050,34,003,"New Jersey","Bergen County",5,83,3958,1587,2371
050,34,003,"New Jersey","Bergen County",5,84,3692,1527,2165
050,34,003,"New Jersey","Bergen County",5,85,22607,8189,14418
050,34,005,"New Jersey","Burlington County",1,0,4414,2260,2154
050,34,005,"New Jersey","Burlington County",1,1,4551,2380,2171
050,34,005,"New Jersey","Burlington County",1,2,4667,2430,2237
050,34,005,"New Jersey","Burlington County",1,3,4780,2403,2377
050,34,005,"New Jersey","Burlington County",1,4,4924,2506,2418
050,34,005,"New Jersey","Burlington County",1,5,5063,2576,2487
050,34,005,"New Jersey","Burlington County",1,6,5159,2636,2523
050,34,005,"New Jersey","Burlington County",1,7,5144,2648,2496
050,34,005,"New Jersey","Burlington County",1,8,5133,2571,2562
050,34,005,"New Jersey","Burlington County",1,9,5269,2684,2585
050,34,005,"New Jersey","Burlington County",1,10,5537,2793,2744
050,34,005,"New Jersey","Burlington County",1,11,5727,2927,2800
050,34,005,"New Jersey","Burlington County",1,12,5962,3008,2954
050,34,005,"New Jersey","Burlington County",1,13,6013,3025,2988
050,34,005,"New Jersey","Burlington County",1,14,6038,3098,2940
050,34,005,"New Jersey","Burlington County",1,15,6011,3070,2941
050,34,005,"New Jersey","Burlington County",1,16,6109,3068,3041
050,34,005,"New Jersey","Burlington County",1,17,5955,3013,2942
050,34,005,"New Jersey","Burlington County",1,18,5088,2671,2417
050,34,005,"New Jersey","Burlington County",1,19,4396,2381,2015
050,34,005,"New Jersey","Burlington County",1,20,4908,2628,2280
050,34,005,"New Jersey","Burlington County",1,21,5068,2644,2424
050,34,005,"New Jersey","Burlington County",1,22,5320,2720,2600
050,34,005,"New Jersey","Burlington County",1,23,5387,2776,2611
050,34,005,"New Jersey","Burlington County",1,24,5495,2814,2681
050,34,005,"New Jersey","Burlington County",1,25,5667,2900,2767
050,34,005,"New Jersey","Burlington County",1,26,5628,2849,2779
050,34,005,"New Jersey","Burlington County",1,27,6088,3237,2851
050,34,005,"New Jersey","Burlington County",1,28,5902,3106,2796
050,34,005,"New Jersey","Burlington County",1,29,5828,3062,2766
050,34,005,"New Jersey","Burlington County",1,30,5687,2962,2725
050,34,005,"New Jersey","Burlington County",1,31,5706,2981,2725
050,34,005,"New Jersey","Burlington County",1,32,5681,2882,2799
050,34,005,"New Jersey","Burlington County",1,33,5763,2918,2845
050,34,005,"New Jersey","Burlington County",1,34,5821,2932,2889
050,34,005,"New Jersey","Burlington County",1,35,5870,2936,2934
050,34,005,"New Jersey","Burlington County",1,36,5788,2926,2862
050,34,005,"New Jersey","Burlington County",1,37,5943,2949,2994
050,34,005,"New Jersey","Burlington County",1,38,6075,3174,2901
050,34,005,"New Jersey","Burlington County",1,39,6078,3104,2974
050,34,005,"New Jersey","Burlington County",1,40,5990,2930,3060
050,34,005,"New Jersey","Burlington County",1,41,5928,3010,2918
050,34,005,"New Jersey","Burlington County",1,42,5903,3061,2842
050,34,005,"New Jersey","Burlington County",1,43,5759,3037,2722
050,34,005,"New Jersey","Burlington County",1,44,5496,2724,2772
050,34,005,"New Jersey","Burlington County",1,45,5573,2713,2860
050,34,005,"New Jersey","Burlington County",1,46,5659,2777,2882
050,34,005,"New Jersey","Burlington County",1,47,5645,2769,2876
050,34,005,"New Jersey","Burlington County",1,48,6336,3302,3034
050,34,005,"New Jersey","Burlington County",1,49,6824,3467,3357
050,34,005,"New Jersey","Burlington County",1,50,6667,3411,3256
050,34,005,"New Jersey","Burlington County",1,51,6514,3220,3294
050,34,005,"New Jersey","Burlington County",1,52,6454,3188,3266
050,34,005,"New Jersey","Burlington County",1,53,6628,3248,3380
050,34,005,"New Jersey","Burlington County",1,54,6870,3333,3537
050,34,005,"New Jersey","Burlington County",1,55,7229,3492,3737
050,34,005,"New Jersey","Burlington County",1,56,7328,3548,3780
050,34,005,"New Jersey","Burlington County",1,57,7383,3582,3801
050,34,005,"New Jersey","Burlington County",1,58,7291,3562,3729
050,34,005,"New Jersey","Burlington County",1,59,7261,3592,3669
050,34,005,"New Jersey","Burlington County",1,60,7220,3635,3585
050,34,005,"New Jersey","Burlington County",1,61,6813,3317,3496
050,34,005,"New Jersey","Burlington County",1,62,6660,3372,3288
050,34,005,"New Jersey","Burlington County",1,63,6488,3204,3284
050,34,005,"New Jersey","Burlington County",1,64,5873,2779,3094
050,34,005,"New Jersey","Burlington County",1,65,5618,2689,2929
050,34,005,"New Jersey","Burlington County",1,66,5223,2411,2812
050,34,005,"New Jersey","Burlington County",1,67,5075,2383,2692
050,34,005,"New Jersey","Burlington County",1,68,4914,2286,2628
050,34,005,"New Jersey","Burlington County",1,69,4582,2148,2434
050,34,005,"New Jersey","Burlington County",1,70,4499,2124,2375
050,34,005,"New Jersey","Burlington County",1,71,4366,1974,2392
050,34,005,"New Jersey","Burlington County",1,72,4475,2022,2453
050,34,005,"New Jersey","Burlington County",1,73,4511,2063,2448
050,34,005,"New Jersey","Burlington County",1,74,3170,1391,1779
050,34,005,"New Jersey","Burlington County",1,75,3079,1361,1718
050,34,005,"New Jersey","Burlington County",1,76,3112,1344,1768
050,34,005,"New Jersey","Burlington County",1,77,3212,1391,1821
050,34,005,"New Jersey","Burlington County",1,78,2761,1201,1560
050,34,005,"New Jersey","Burlington County",1,79,2356,1028,1328
050,34,005,"New Jersey","Burlington County",1,80,2077,830,1247
050,34,005,"New Jersey","Burlington County",1,81,2089,835,1254
050,34,005,"New Jersey","Burlington County",1,82,1968,814,1154
050,34,005,"New Jersey","Burlington County",1,83,1776,727,1049
050,34,005,"New Jersey","Burlington County",1,84,1560,617,943
050,34,005,"New Jersey","Burlington County",1,85,10011,3478,6533
050,34,005,"New Jersey","Burlington County",2,0,4391,2275,2116
050,34,005,"New Jersey","Burlington County",2,1,4530,2359,2171
050,34,005,"New Jersey","Burlington County",2,2,4667,2430,2237
050,34,005,"New Jersey","Burlington County",2,3,4764,2415,2349
050,34,005,"New Jersey","Burlington County",2,4,4921,2495,2426
050,34,005,"New Jersey","Burlington County",2,5,5051,2569,2482
050,34,005,"New Jersey","Burlington County",2,6,5156,2637,2519
050,34,005,"New Jersey","Burlington County",2,7,5149,2645,2504
050,34,005,"New Jersey","Burlington County",2,8,5129,2586,2543
050,34,005,"New Jersey","Burlington County",2,9,5249,2658,2591
050,34,005,"New Jersey","Burlington County",2,10,5481,2766,2715
050,34,005,"New Jersey","Burlington County",2,11,5672,2887,2785
050,34,005,"New Jersey","Burlington County",2,12,5944,3006,2938
050,34,005,"New Jersey","Burlington County",2,13,6019,3030,2989
050,34,005,"New Jersey","Burlington County",2,14,6034,3083,2951
050,34,005,"New Jersey","Burlington County",2,15,6034,3087,2947
050,34,005,"New Jersey","Burlington County",2,16,6095,3077,3018
050,34,005,"New Jersey","Burlington County",2,17,5984,3020,2964
050,34,005,"New Jersey","Burlington County",2,18,5088,2671,2417
050,34,005,"New Jersey","Burlington County",2,19,4430,2392,2038
050,34,005,"New Jersey","Burlington County",2,20,4941,2647,2294
050,34,005,"New Jersey","Burlington County",2,21,5067,2649,2418
050,34,005,"New Jersey","Burlington County",2,22,5301,2714,2587
050,34,005,"New Jersey","Burlington County",2,23,5418,2788,2630
050,34,005,"New Jersey","Burlington County",2,24,5462,2796,2666
050,34,005,"New Jersey","Burlington County",2,25,5620,2870,2750
050,34,005,"New Jersey","Burlington County",2,26,5657,2859,2798
050,34,005,"New Jersey","Burlington County",2,27,6050,3217,2833
050,34,005,"New Jersey","Burlington County",2,28,5896,3084,2812
050,34,005,"New Jersey","Burlington County",2,29,5884,3102,2782
050,34,005,"New Jersey","Burlington County",2,30,5737,2975,2762
050,34,005,"New Jersey","Burlington County",2,31,5711,2985,2726
050,34,005,"New Jersey","Burlington County",2,32,5658,2864,2794
050,34,005,"New Jersey","Burlington County",2,33,5766,2933,2833
050,34,005,"New Jersey","Burlington County",2,34,5811,2926,2885
050,34,005,"New Jersey","Burlington County",2,35,5930,2984,2946
050,34,005,"New Jersey","Burlington County",2,36,5799,2924,2875
050,34,005,"New Jersey","Burlington County",2,37,5924,2942,2982
050,34,005,"New Jersey","Burlington County",2,38,6106,3164,2942
050,34,005,"New Jersey","Burlington County",2,39,6043,3096,2947
050,34,005,"New Jersey","Burlington County",2,40,6058,2996,3062
050,34,005,"New Jersey","Burlington County",2,41,5971,3017,2954
050,34,005,"New Jersey","Burlington County",2,42,5911,3066,2845
050,34,005,"New Jersey","Burlington County",2,43,5849,3073,2776
050,34,005,"New Jersey","Burlington County",2,44,5467,2728,2739
050,34,005,"New Jersey","Burlington County",2,45,5577,2721,2856
050,34,005,"New Jersey","Burlington County",2,46,5620,2753,2867
050,34,005,"New Jersey","Burlington County",2,47,5632,2765,2867
050,34,005,"New Jersey","Burlington County",2,48,6244,3250,2994
050,34,005,"New Jersey","Burlington County",2,49,6713,3424,3289
050,34,005,"New Jersey","Burlington County",2,50,6699,3416,3283
050,34,005,"New Jersey","Burlington County",2,51,6468,3202,3266
050,34,005,"New Jersey","Burlington County",2,52,6440,3183,3257
050,34,005,"New Jersey","Burlington County",2,53,6586,3248,3338
050,34,005,"New Jersey","Burlington County",2,54,6758,3280,3478
050,34,005,"New Jersey","Burlington County",2,55,7130,3450,3680
050,34,005,"New Jersey","Burlington County",2,56,7286,3515,3771
050,34,005,"New Jersey","Burlington County",2,57,7371,3576,3795
050,34,005,"New Jersey","Burlington County",2,58,7282,3552,3730
050,34,005,"New Jersey","Burlington County",2,59,7280,3593,3687
050,34,005,"New Jersey","Burlington County",2,60,7222,3635,3587
050,34,005,"New Jersey","Burlington County",2,61,6804,3307,3497
050,34,005,"New Jersey","Burlington County",2,62,6680,3351,3329
050,34,005,"New Jersey","Burlington County",2,63,6570,3275,3295
050,34,005,"New Jersey","Burlington County",2,64,5923,2811,3112
050,34,005,"New Jersey","Burlington County",2,65,5663,2703,2960
050,34,005,"New Jersey","Burlington County",2,66,5284,2446,2838
050,34,005,"New Jersey","Burlington County",2,67,5056,2361,2695
050,34,005,"New Jersey","Burlington County",2,68,4888,2278,2610
050,34,005,"New Jersey","Burlington County",2,69,4682,2195,2487
050,34,005,"New Jersey","Burlington County",2,70,4479,2108,2371
050,34,005,"New Jersey","Burlington County",2,71,4345,1966,2379
050,34,005,"New Jersey","Burlington County",2,72,4368,1973,2395
050,34,005,"New Jersey","Burlington County",2,73,4664,2128,2536
050,34,005,"New Jersey","Burlington County",2,74,3279,1452,1827
050,34,005,"New Jersey","Burlington County",2,75,3077,1359,1718
050,34,005,"New Jersey","Burlington County",2,76,3042,1324,1718
050,34,005,"New Jersey","Burlington County",2,77,3215,1385,1830
050,34,005,"New Jersey","Burlington County",2,78,2797,1214,1583
050,34,005,"New Jersey","Burlington County",2,79,2404,1042,1362
050,34,005,"New Jersey","Burlington County",2,80,2112,863,1249
050,34,005,"New Jersey","Burlington County",2,81,2030,813,1217
050,34,005,"New Jersey","Burlington County",2,82,1959,796,1163
050,34,005,"New Jersey","Burlington County",2,83,1776,722,1054
050,34,005,"New Jersey","Burlington County",2,84,1571,625,946
050,34,005,"New Jersey","Burlington County",2,85,9881,3429,6452
050,34,005,"New Jersey","Burlington County",3,0,4414,2266,2148
050,34,005,"New Jersey","Burlington County",3,1,4516,2362,2154
050,34,005,"New Jersey","Burlington County",3,2,4711,2464,2247
050,34,005,"New Jersey","Burlington County",3,3,4809,2534,2275
050,34,005,"New Jersey","Burlington County",3,4,4891,2454,2437
050,34,005,"New Jersey","Burlington County",3,5,5086,2587,2499
050,34,005,"New Jersey","Burlington County",3,6,5121,2611,2510
050,34,005,"New Jersey","Burlington County",3,7,5294,2742,2552
050,34,005,"New Jersey","Burlington County",3,8,5201,2676,2525
050,34,005,"New Jersey","Burlington County",3,9,5226,2616,2610
050,34,005,"New Jersey","Burlington County",3,10,5300,2685,2615
050,34,005,"New Jersey","Burlington County",3,11,5523,2785,2738
050,34,005,"New Jersey","Burlington County",3,12,5729,2894,2835
050,34,005,"New Jersey","Burlington County",3,13,5949,3018,2931
050,34,005,"New Jersey","Burlington County",3,14,6077,3057,3020
050,34,005,"New Jersey","Burlington County",3,15,6027,3084,2943
050,34,005,"New Jersey","Burlington County",3,16,6003,3089,2914
050,34,005,"New Jersey","Burlington County",3,17,6114,3096,3018
050,34,005,"New Jersey","Burlington County",3,18,5241,2741,2500
050,34,005,"New Jersey","Burlington County",3,19,4406,2352,2054
050,34,005,"New Jersey","Burlington County",3,20,4947,2648,2299
050,34,005,"New Jersey","Burlington County",3,21,5136,2690,2446
050,34,005,"New Jersey","Burlington County",3,22,5433,2805,2628
050,34,005,"New Jersey","Burlington County",3,23,5559,2861,2698
050,34,005,"New Jersey","Burlington County",3,24,5598,2857,2741
050,34,005,"New Jersey","Burlington County",3,25,5566,2840,2726
050,34,005,"New Jersey","Burlington County",3,26,5657,2890,2767
050,34,005,"New Jersey","Burlington County",3,27,5997,3152,2845
050,34,005,"New Jersey","Burlington County",3,28,5901,3041,2860
050,34,005,"New Jersey","Burlington County",3,29,6105,3211,2894
050,34,005,"New Jersey","Burlington County",3,30,5975,3075,2900
050,34,005,"New Jersey","Burlington County",3,31,5900,3023,2877
050,34,005,"New Jersey","Burlington County",3,32,5729,2895,2834
050,34,005,"New Jersey","Burlington County",3,33,5950,3042,2908
050,34,005,"New Jersey","Burlington County",3,34,5889,2962,2927
050,34,005,"New Jersey","Burlington County",3,35,6062,3103,2959
050,34,005,"New Jersey","Burlington County",3,36,5956,2973,2983
050,34,005,"New Jersey","Burlington County",3,37,5867,2934,2933
050,34,005,"New Jersey","Burlington County",3,38,6164,3128,3036
050,34,005,"New Jersey","Burlington County",3,39,6082,3118,2964
050,34,005,"New Jersey","Burlington County",3,40,6088,3099,2989
050,34,005,"New Jersey","Burlington County",3,41,6176,3054,3122
050,34,005,"New Jersey","Burlington County",3,42,6072,3113,2959
050,34,005,"New Jersey","Burlington County",3,43,5992,3097,2895
050,34,005,"New Jersey","Burlington County",3,44,5662,2851,2811
050,34,005,"New Jersey","Burlington County",3,45,5451,2686,2765
050,34,005,"New Jersey","Burlington County",3,46,5602,2759,2843
050,34,005,"New Jersey","Burlington County",3,47,5671,2761,2910
050,34,005,"New Jersey","Burlington County",3,48,5939,3084,2855
050,34,005,"New Jersey","Burlington County",3,49,6136,3121,3015
050,34,005,"New Jersey","Burlington County",3,50,6665,3369,3296
050,34,005,"New Jersey","Burlington County",3,51,6499,3225,3274
050,34,005,"New Jersey","Burlington County",3,52,6476,3200,3276
050,34,005,"New Jersey","Burlington County",3,53,6463,3203,3260
050,34,005,"New Jersey","Burlington County",3,54,6471,3124,3347
050,34,005,"New Jersey","Burlington County",3,55,6733,3284,3449
050,34,005,"New Jersey","Burlington County",3,56,6961,3337,3624
050,34,005,"New Jersey","Burlington County",3,57,7262,3560,3702
050,34,005,"New Jersey","Burlington County",3,58,7285,3514,3771
050,34,005,"New Jersey","Burlington County",3,59,7153,3497,3656
050,34,005,"New Jersey","Burlington County",3,60,7275,3658,3617
050,34,005,"New Jersey","Burlington County",3,61,6892,3356,3536
050,34,005,"New Jersey","Burlington County",3,62,6711,3292,3419
050,34,005,"New Jersey","Burlington County",3,63,6658,3362,3296
050,34,005,"New Jersey","Burlington County",3,64,6260,3037,3223
050,34,005,"New Jersey","Burlington County",3,65,5876,2816,3060
050,34,005,"New Jersey","Burlington County",3,66,5475,2544,2931
050,34,005,"New Jersey","Burlington County",3,67,5155,2383,2772
050,34,005,"New Jersey","Burlington County",3,68,4937,2290,2647
050,34,005,"New Jersey","Burlington County",3,69,4856,2273,2583
050,34,005,"New Jersey","Burlington County",3,70,4580,2132,2448
050,34,005,"New Jersey","Burlington County",3,71,4316,1976,2340
050,34,005,"New Jersey","Burlington County",3,72,4255,1923,2332
050,34,005,"New Jersey","Burlington County",3,73,4233,1893,2340
050,34,005,"New Jersey","Burlington County",3,74,4566,2058,2508
050,34,005,"New Jersey","Burlington County",3,75,3182,1407,1775
050,34,005,"New Jersey","Burlington County",3,76,2982,1311,1671
050,34,005,"New Jersey","Burlington County",3,77,2989,1284,1705
050,34,005,"New Jersey","Burlington County",3,78,3116,1335,1781
050,34,005,"New Jersey","Burlington County",3,79,2647,1134,1513
050,34,005,"New Jersey","Burlington County",3,80,2341,1001,1340
050,34,005,"New Jersey","Burlington County",3,81,1997,808,1189
050,34,005,"New Jersey","Burlington County",3,82,1917,759,1158
050,34,005,"New Jersey","Burlington County",3,83,1824,722,1102
050,34,005,"New Jersey","Burlington County",3,84,1629,654,975
050,34,005,"New Jersey","Burlington County",3,85,9942,3448,6494
050,34,005,"New Jersey","Burlington County",4,0,4700,2381,2319
050,34,005,"New Jersey","Burlington County",4,1,4531,2298,2233
050,34,005,"New Jersey","Burlington County",4,2,4690,2476,2214
050,34,005,"New Jersey","Burlington County",4,3,4865,2547,2318
050,34,005,"New Jersey","Burlington County",4,4,4965,2575,2390
050,34,005,"New Jersey","Burlington County",4,5,4987,2500,2487
050,34,005,"New Jersey","Burlington County",4,6,5176,2624,2552
050,34,005,"New Jersey","Burlington County",4,7,5228,2677,2551
050,34,005,"New Jersey","Burlington County",4,8,5332,2745,2587
050,34,005,"New Jersey","Burlington County",4,9,5275,2707,2568
050,34,005,"New Jersey","Burlington County",4,10,5307,2688,2619
050,34,005,"New Jersey","Burlington County",4,11,5338,2722,2616
050,34,005,"New Jersey","Burlington County",4,12,5610,2814,2796
050,34,005,"New Jersey","Burlington County",4,13,5747,2914,2833
050,34,005,"New Jersey","Burlington County",4,14,5979,3024,2955
050,34,005,"New Jersey","Burlington County",4,15,6128,3070,3058
050,34,005,"New Jersey","Burlington County",4,16,6063,3108,2955
050,34,005,"New Jersey","Burlington County",4,17,6066,3141,2925
050,34,005,"New Jersey","Burlington County",4,18,5255,2750,2505
050,34,005,"New Jersey","Burlington County",4,19,4386,2353,2033
050,34,005,"New Jersey","Burlington County",4,20,4777,2545,2232
050,34,005,"New Jersey","Burlington County",4,21,5066,2650,2416
050,34,005,"New Jersey","Burlington County",4,22,5342,2755,2587
050,34,005,"New Jersey","Burlington County",4,23,5524,2883,2641
050,34,005,"New Jersey","Burlington County",4,24,5556,2846,2710
050,34,005,"New Jersey","Burlington County",4,25,5604,2854,2750
050,34,005,"New Jersey","Burlington County",4,26,5535,2809,2726
050,34,005,"New Jersey","Burlington County",4,27,5873,3130,2743
050,34,005,"New Jersey","Burlington County",4,28,5854,2994,2860
050,34,005,"New Jersey","Burlington County",4,29,6109,3199,2910
050,34,005,"New Jersey","Burlington County",4,30,6032,3085,2947
050,34,005,"New Jersey","Burlington County",4,31,6161,3157,3004
050,34,005,"New Jersey","Burlington County",4,32,5906,2968,2938
050,34,005,"New Jersey","Burlington County",4,33,5982,3056,2926
050,34,005,"New Jersey","Burlington County",4,34,5992,3006,2986
050,34,005,"New Jersey","Burlington County",4,35,6166,3127,3039
050,34,005,"New Jersey","Burlington County",4,36,6189,3189,3000
050,34,005,"New Jersey","Burlington County",4,37,6042,2995,3047
050,34,005,"New Jersey","Burlington County",4,38,6070,3060,3010
050,34,005,"New Jersey","Burlington County",4,39,6120,3076,3044
050,34,005,"New Jersey","Burlington County",4,40,6121,3125,2996
050,34,005,"New Jersey","Burlington County",4,41,6203,3182,3021
050,34,005,"New Jersey","Burlington County",4,42,6295,3163,3132
050,34,005,"New Jersey","Burlington County",4,43,6173,3161,3012
050,34,005,"New Jersey","Burlington County",4,44,5795,2890,2905
050,34,005,"New Jersey","Burlington County",4,45,5654,2846,2808
050,34,005,"New Jersey","Burlington County",4,46,5558,2720,2838
050,34,005,"New Jersey","Burlington County",4,47,5609,2765,2844
050,34,005,"New Jersey","Burlington County",4,48,5947,3030,2917
050,34,005,"New Jersey","Burlington County",4,49,5872,3020,2852
050,34,005,"New Jersey","Burlington County",4,50,6004,3026,2978
050,34,005,"New Jersey","Burlington County",4,51,6502,3223,3279
050,34,005,"New Jersey","Burlington County",4,52,6467,3218,3249
050,34,005,"New Jersey","Burlington County",4,53,6499,3240,3259
050,34,005,"New Jersey","Burlington County",4,54,6320,3083,3237
050,34,005,"New Jersey","Burlington County",4,55,6452,3128,3324
050,34,005,"New Jersey","Burlington County",4,56,6599,3176,3423
050,34,005,"New Jersey","Burlington County",4,57,6982,3361,3621
050,34,005,"New Jersey","Burlington County",4,58,7101,3492,3609
050,34,005,"New Jersey","Burlington County",4,59,7172,3464,3708
050,34,005,"New Jersey","Burlington County",4,60,7158,3550,3608
050,34,005,"New Jersey","Burlington County",4,61,6907,3360,3547
050,34,005,"New Jersey","Burlington County",4,62,6827,3391,3436
050,34,005,"New Jersey","Burlington County",4,63,6662,3302,3360
050,34,005,"New Jersey","Burlington County",4,64,6349,3143,3206
050,34,005,"New Jersey","Burlington County",4,65,6216,3058,3158
050,34,005,"New Jersey","Burlington County",4,66,5706,2668,3038
050,34,005,"New Jersey","Burlington County",4,67,5346,2464,2882
050,34,005,"New Jersey","Burlington County",4,68,5049,2324,2725
050,34,005,"New Jersey","Burlington County",4,69,4926,2301,2625
050,34,005,"New Jersey","Burlington County",4,70,4742,2191,2551
050,34,005,"New Jersey","Burlington County",4,71,4438,2009,2429
050,34,005,"New Jersey","Burlington County",4,72,4239,1935,2304
050,34,005,"New Jersey","Burlington County",4,73,4112,1842,2270
050,34,005,"New Jersey","Burlington County",4,74,4130,1832,2298
050,34,005,"New Jersey","Burlington County",4,75,4420,1975,2445
050,34,005,"New Jersey","Burlington County",4,76,3111,1373,1738
050,34,005,"New Jersey","Burlington County",4,77,2882,1258,1624
050,34,005,"New Jersey","Burlington County",4,78,2884,1243,1641
050,34,005,"New Jersey","Burlington County",4,79,2948,1246,1702
050,34,005,"New Jersey","Burlington County",4,80,2569,1085,1484
050,34,005,"New Jersey","Burlington County",4,81,2217,944,1273
050,34,005,"New Jersey","Burlington County",4,82,1906,765,1141
050,34,005,"New Jersey","Burlington County",4,83,1786,688,1098
050,34,005,"New Jersey","Burlington County",4,84,1687,662,1025
050,34,005,"New Jersey","Burlington County",4,85,10031,3517,6514
050,34,005,"New Jersey","Burlington County",5,0,4692,2370,2322
050,34,005,"New Jersey","Burlington County",5,1,4868,2481,2387
050,34,005,"New Jersey","Burlington County",5,2,4657,2351,2306
050,34,005,"New Jersey","Burlington County",5,3,4846,2539,2307
050,34,005,"New Jersey","Burlington County",5,4,5000,2626,2374
050,34,005,"New Jersey","Burlington County",5,5,5065,2634,2431
050,34,005,"New Jersey","Burlington County",5,6,5012,2535,2477
050,34,005,"New Jersey","Burlington County",5,7,5221,2647,2574
050,34,005,"New Jersey","Burlington County",5,8,5307,2741,2566
050,34,005,"New Jersey","Burlington County",5,9,5449,2794,2655
050,34,005,"New Jersey","Burlington County",5,10,5340,2731,2609
050,34,005,"New Jersey","Burlington County",5,11,5320,2684,2636
050,34,005,"New Jersey","Burlington County",5,12,5400,2775,2625
050,34,005,"New Jersey","Burlington County",5,13,5624,2836,2788
050,34,005,"New Jersey","Burlington County",5,14,5761,2931,2830
050,34,005,"New Jersey","Burlington County",5,15,5967,3019,2948
050,34,005,"New Jersey","Burlington County",5,16,6122,3102,3020
050,34,005,"New Jersey","Burlington County",5,17,6097,3143,2954
050,34,005,"New Jersey","Burlington County",5,18,5235,2803,2432
050,34,005,"New Jersey","Burlington County",5,19,4454,2395,2059
050,34,005,"New Jersey","Burlington County",5,20,4878,2601,2277
050,34,005,"New Jersey","Burlington County",5,21,5057,2635,2422
050,34,005,"New Jersey","Burlington County",5,22,5373,2760,2613
050,34,005,"New Jersey","Burlington County",5,23,5485,2881,2604
050,34,005,"New Jersey","Burlington County",5,24,5643,2959,2684
050,34,005,"New Jersey","Burlington County",5,25,5472,2802,2670
050,34,005,"New Jersey","Burlington County",5,26,5534,2801,2733
050,34,005,"New Jersey","Burlington County",5,27,5868,3130,2738
050,34,005,"New Jersey","Burlington County",5,28,5797,3040,2757
050,34,005,"New Jersey","Burlington County",5,29,6038,3162,2876
050,34,005,"New Jersey","Burlington County",5,30,6121,3140,2981
050,34,005,"New Jersey","Burlington County",5,31,6107,3130,2977
050,34,005,"New Jersey","Burlington County",5,32,6170,3104,3066
050,34,005,"New Jersey","Burlington County",5,33,6158,3087,3071
050,34,005,"New Jersey","Burlington County",5,34,6145,3115,3030
050,34,005,"New Jersey","Burlington County",5,35,6173,3161,3012
050,34,005,"New Jersey","Burlington County",5,36,6289,3184,3105
050,34,005,"New Jersey","Burlington County",5,37,6271,3229,3042
050,34,005,"New Jersey","Burlington County",5,38,6323,3202,3121
050,34,005,"New Jersey","Burlington County",5,39,6084,3067,3017
050,34,005,"New Jersey","Burlington County",5,40,6202,3139,3063
050,34,005,"New Jersey","Burlington County",5,41,6270,3247,3023
050,34,005,"New Jersey","Burlington County",5,42,6360,3283,3077
050,34,005,"New Jersey","Burlington County",5,43,6362,3178,3184
050,34,005,"New Jersey","Burlington County",5,44,5969,2952,3017
050,34,005,"New Jersey","Burlington County",5,45,5834,2903,2931
050,34,005,"New Jersey","Burlington County",5,46,5768,2935,2833
050,34,005,"New Jersey","Burlington County",5,47,5556,2745,2811
050,34,005,"New Jersey","Burlington County",5,48,5909,3039,2870
050,34,005,"New Jersey","Burlington County",5,49,5854,2938,2916
050,34,005,"New Jersey","Burlington County",5,50,5832,2996,2836
050,34,005,"New Jersey","Burlington County",5,51,5820,2871,2949
050,34,005,"New Jersey","Burlington County",5,52,6527,3229,3298
050,34,005,"New Jersey","Burlington County",5,53,6553,3286,3267
050,34,005,"New Jersey","Burlington County",5,54,6405,3141,3264
050,34,005,"New Jersey","Burlington County",5,55,6320,3099,3221
050,34,005,"New Jersey","Burlington County",5,56,6272,3016,3256
050,34,005,"New Jersey","Burlington County",5,57,6609,3216,3393
050,34,005,"New Jersey","Burlington County",5,58,6843,3309,3534
050,34,005,"New Jersey","Burlington County",5,59,7044,3466,3578
050,34,005,"New Jersey","Burlington County",5,60,7208,3574,3634
050,34,005,"New Jersey","Burlington County",5,61,6818,3256,3562
050,34,005,"New Jersey","Burlington County",5,62,6816,3367,3449
050,34,005,"New Jersey","Burlington County",5,63,6799,3403,3396
050,34,005,"New Jersey","Burlington County",5,64,6427,3104,3323
050,34,005,"New Jersey","Burlington County",5,65,6301,3143,3158
050,34,005,"New Jersey","Burlington County",5,66,6082,2935,3147
050,34,005,"New Jersey","Burlington County",5,67,5606,2608,2998
050,34,005,"New Jersey","Burlington County",5,68,5272,2411,2861
050,34,005,"New Jersey","Burlington County",5,69,5071,2361,2710
050,34,005,"New Jersey","Burlington County",5,70,4836,2250,2586
050,34,005,"New Jersey","Burlington County",5,71,4596,2078,2518
050,34,005,"New Jersey","Burlington County",5,72,4411,1987,2424
050,34,005,"New Jersey","Burlington County",5,73,4127,1868,2259
050,34,005,"New Jersey","Burlington County",5,74,4035,1805,2230
050,34,005,"New Jersey","Burlington County",5,75,4001,1759,2242
050,34,005,"New Jersey","Burlington County",5,76,4315,1926,2389
050,34,005,"New Jersey","Burlington County",5,77,3021,1328,1693
050,34,005,"New Jersey","Burlington County",5,78,2790,1207,1583
050,34,005,"New Jersey","Burlington County",5,79,2770,1180,1590
050,34,005,"New Jersey","Burlington County",5,80,2863,1192,1671
050,34,005,"New Jersey","Burlington County",5,81,2451,1025,1426
050,34,005,"New Jersey","Burlington County",5,82,2096,885,1211
050,34,005,"New Jersey","Burlington County",5,83,1792,703,1089
050,34,005,"New Jersey","Burlington County",5,84,1664,640,1024
050,34,005,"New Jersey","Burlington County",5,85,10267,3636,6631
050,34,007,"New Jersey","Camden County",1,0,6187,3167,3020
050,34,007,"New Jersey","Camden County",1,1,6291,3224,3067
050,34,007,"New Jersey","Camden County",1,2,6304,3272,3032
050,34,007,"New Jersey","Camden County",1,3,6382,3262,3120
050,34,007,"New Jersey","Camden County",1,4,6419,3269,3150
050,34,007,"New Jersey","Camden County",1,5,6547,3299,3248
050,34,007,"New Jersey","Camden County",1,6,6493,3261,3232
050,34,007,"New Jersey","Camden County",1,7,6448,3277,3171
050,34,007,"New Jersey","Camden County",1,8,6579,3377,3202
050,34,007,"New Jersey","Camden County",1,9,6757,3478,3279
050,34,007,"New Jersey","Camden County",1,10,6830,3522,3308
050,34,007,"New Jersey","Camden County",1,11,6913,3527,3386
050,34,007,"New Jersey","Camden County",1,12,7089,3554,3535
050,34,007,"New Jersey","Camden County",1,13,7138,3651,3487
050,34,007,"New Jersey","Camden County",1,14,6962,3584,3378
050,34,007,"New Jersey","Camden County",1,15,6961,3553,3408
050,34,007,"New Jersey","Camden County",1,16,6978,3587,3391
050,34,007,"New Jersey","Camden County",1,17,6883,3562,3321
050,34,007,"New Jersey","Camden County",1,18,6112,3230,2882
050,34,007,"New Jersey","Camden County",1,19,5302,2738,2564
050,34,007,"New Jersey","Camden County",1,20,5661,2898,2763
050,34,007,"New Jersey","Camden County",1,21,5916,2954,2962
050,34,007,"New Jersey","Camden County",1,22,6048,3011,3037
050,34,007,"New Jersey","Camden County",1,23,6247,3080,3167
050,34,007,"New Jersey","Camden County",1,24,6493,3223,3270
050,34,007,"New Jersey","Camden County",1,25,6655,3265,3390
050,34,007,"New Jersey","Camden County",1,26,6927,3393,3534
050,34,007,"New Jersey","Camden County",1,27,7193,3533,3660
050,34,007,"New Jersey","Camden County",1,28,7253,3568,3685
050,34,007,"New Jersey","Camden County",1,29,7438,3662,3776
050,34,007,"New Jersey","Camden County",1,30,7308,3509,3799
050,34,007,"New Jersey","Camden County",1,31,7305,3591,3714
050,34,007,"New Jersey","Camden County",1,32,7343,3622,3721
050,34,007,"New Jersey","Camden County",1,33,7224,3611,3613
050,34,007,"New Jersey","Camden County",1,34,7352,3643,3709
050,34,007,"New Jersey","Camden County",1,35,7267,3568,3699
050,34,007,"New Jersey","Camden County",1,36,7168,3539,3629
050,34,007,"New Jersey","Camden County",1,37,7163,3543,3620
050,34,007,"New Jersey","Camden County",1,38,6976,3393,3583
050,34,007,"New Jersey","Camden County",1,39,7021,3402,3619
050,34,007,"New Jersey","Camden County",1,40,6981,3406,3575
050,34,007,"New Jersey","Camden County",1,41,6684,3263,3421
050,34,007,"New Jersey","Camden County",1,42,6499,3129,3370
050,34,007,"New Jersey","Camden County",1,43,6262,3040,3222
050,34,007,"New Jersey","Camden County",1,44,6216,2952,3264
050,34,007,"New Jersey","Camden County",1,45,6342,3090,3252
050,34,007,"New Jersey","Camden County",1,46,6214,3024,3190
050,34,007,"New Jersey","Camden County",1,47,6262,3031,3231
050,34,007,"New Jersey","Camden County",1,48,6809,3288,3521
050,34,007,"New Jersey","Camden County",1,49,7315,3500,3815
050,34,007,"New Jersey","Camden County",1,50,7070,3423,3647
050,34,007,"New Jersey","Camden County",1,51,6914,3354,3560
050,34,007,"New Jersey","Camden County",1,52,6783,3332,3451
050,34,007,"New Jersey","Camden County",1,53,6876,3300,3576
050,34,007,"New Jersey","Camden County",1,54,7056,3375,3681
050,34,007,"New Jersey","Camden County",1,55,7276,3442,3834
050,34,007,"New Jersey","Camden County",1,56,7223,3490,3733
050,34,007,"New Jersey","Camden County",1,57,7243,3479,3764
050,34,007,"New Jersey","Camden County",1,58,7403,3590,3813
050,34,007,"New Jersey","Camden County",1,59,7329,3523,3806
050,34,007,"New Jersey","Camden County",1,60,7237,3428,3809
050,34,007,"New Jersey","Camden County",1,61,7086,3407,3679
050,34,007,"New Jersey","Camden County",1,62,6980,3350,3630
050,34,007,"New Jersey","Camden County",1,63,6670,3233,3437
050,34,007,"New Jersey","Camden County",1,64,6413,3043,3370
050,34,007,"New Jersey","Camden County",1,65,6149,2914,3235
050,34,007,"New Jersey","Camden County",1,66,5822,2750,3072
050,34,007,"New Jersey","Camden County",1,67,5492,2532,2960
050,34,007,"New Jersey","Camden County",1,68,5253,2378,2875
050,34,007,"New Jersey","Camden County",1,69,4866,2206,2660
050,34,007,"New Jersey","Camden County",1,70,4700,2118,2582
050,34,007,"New Jersey","Camden County",1,71,4523,2036,2487
050,34,007,"New Jersey","Camden County",1,72,4662,2090,2572
050,34,007,"New Jersey","Camden County",1,73,4683,2089,2594
050,34,007,"New Jersey","Camden County",1,74,3242,1422,1820
050,34,007,"New Jersey","Camden County",1,75,3168,1409,1759
050,34,007,"New Jersey","Camden County",1,76,3151,1415,1736
050,34,007,"New Jersey","Camden County",1,77,3183,1378,1805
050,34,007,"New Jersey","Camden County",1,78,2644,1139,1505
050,34,007,"New Jersey","Camden County",1,79,2285,986,1299
050,34,007,"New Jersey","Camden County",1,80,2080,861,1219
050,34,007,"New Jersey","Camden County",1,81,1961,784,1177
050,34,007,"New Jersey","Camden County",1,82,1812,727,1085
050,34,007,"New Jersey","Camden County",1,83,1643,671,972
050,34,007,"New Jersey","Camden County",1,84,1568,591,977
050,34,007,"New Jersey","Camden County",1,85,9935,3214,6721
050,34,007,"New Jersey","Camden County",2,0,6090,3091,2999
050,34,007,"New Jersey","Camden County",2,1,6285,3219,3066
050,34,007,"New Jersey","Camden County",2,2,6329,3271,3058
050,34,007,"New Jersey","Camden County",2,3,6359,3259,3100
050,34,007,"New Jersey","Camden County",2,4,6428,3272,3156
050,34,007,"New Jersey","Camden County",2,5,6517,3292,3225
050,34,007,"New Jersey","Camden County",2,6,6517,3271,3246
050,34,007,"New Jersey","Camden County",2,7,6457,3263,3194
050,34,007,"New Jersey","Camden County",2,8,6528,3340,3188
050,34,007,"New Jersey","Camden County",2,9,6698,3446,3252
050,34,007,"New Jersey","Camden County",2,10,6802,3507,3295
050,34,007,"New Jersey","Camden County",2,11,6869,3511,3358
050,34,007,"New Jersey","Camden County",2,12,7081,3562,3519
050,34,007,"New Jersey","Camden County",2,13,7104,3623,3481
050,34,007,"New Jersey","Camden County",2,14,6991,3590,3401
050,34,007,"New Jersey","Camden County",2,15,6960,3559,3401
050,34,007,"New Jersey","Camden County",2,16,6980,3582,3398
050,34,007,"New Jersey","Camden County",2,17,6896,3567,3329
050,34,007,"New Jersey","Camden County",2,18,6081,3213,2868
050,34,007,"New Jersey","Camden County",2,19,5320,2757,2563
050,34,007,"New Jersey","Camden County",2,20,5707,2915,2792
050,34,007,"New Jersey","Camden County",2,21,5905,2952,2953
050,34,007,"New Jersey","Camden County",2,22,6102,3028,3074
050,34,007,"New Jersey","Camden County",2,23,6261,3091,3170
050,34,007,"New Jersey","Camden County",2,24,6463,3203,3260
050,34,007,"New Jersey","Camden County",2,25,6633,3264,3369
050,34,007,"New Jersey","Camden County",2,26,6890,3383,3507
050,34,007,"New Jersey","Camden County",2,27,7140,3506,3634
050,34,007,"New Jersey","Camden County",2,28,7261,3572,3689
050,34,007,"New Jersey","Camden County",2,29,7401,3635,3766
050,34,007,"New Jersey","Camden County",2,30,7407,3579,3828
050,34,007,"New Jersey","Camden County",2,31,7302,3576,3726
050,34,007,"New Jersey","Camden County",2,32,7325,3615,3710
050,34,007,"New Jersey","Camden County",2,33,7255,3606,3649
050,34,007,"New Jersey","Camden County",2,34,7343,3647,3696
050,34,007,"New Jersey","Camden County",2,35,7345,3614,3731
050,34,007,"New Jersey","Camden County",2,36,7158,3531,3627
050,34,007,"New Jersey","Camden County",2,37,7175,3550,3625
050,34,007,"New Jersey","Camden County",2,38,7058,3444,3614
050,34,007,"New Jersey","Camden County",2,39,6983,3389,3594
050,34,007,"New Jersey","Camden County",2,40,7034,3425,3609
050,34,007,"New Jersey","Camden County",2,41,6745,3294,3451
050,34,007,"New Jersey","Camden County",2,42,6501,3143,3358
050,34,007,"New Jersey","Camden County",2,43,6350,3075,3275
050,34,007,"New Jersey","Camden County",2,44,6167,2946,3221
050,34,007,"New Jersey","Camden County",2,45,6342,3070,3272
050,34,007,"New Jersey","Camden County",2,46,6217,3023,3194
050,34,007,"New Jersey","Camden County",2,47,6233,3018,3215
050,34,007,"New Jersey","Camden County",2,48,6671,3215,3456
050,34,007,"New Jersey","Camden County",2,49,7204,3455,3749
050,34,007,"New Jersey","Camden County",2,50,7120,3432,3688
050,34,007,"New Jersey","Camden County",2,51,6899,3347,3552
050,34,007,"New Jersey","Camden County",2,52,6802,3331,3471
050,34,007,"New Jersey","Camden County",2,53,6819,3288,3531
050,34,007,"New Jersey","Camden County",2,54,6985,3344,3641
050,34,007,"New Jersey","Camden County",2,55,7189,3404,3785
050,34,007,"New Jersey","Camden County",2,56,7238,3477,3761
050,34,007,"New Jersey","Camden County",2,57,7211,3462,3749
050,34,007,"New Jersey","Camden County",2,58,7322,3545,3777
050,34,007,"New Jersey","Camden County",2,59,7332,3533,3799
050,34,007,"New Jersey","Camden County",2,60,7227,3437,3790
050,34,007,"New Jersey","Camden County",2,61,7065,3375,3690
050,34,007,"New Jersey","Camden County",2,62,6946,3333,3613
050,34,007,"New Jersey","Camden County",2,63,6743,3263,3480
050,34,007,"New Jersey","Camden County",2,64,6408,3051,3357
050,34,007,"New Jersey","Camden County",2,65,6166,2917,3249
050,34,007,"New Jersey","Camden County",2,66,5880,2773,3107
050,34,007,"New Jersey","Camden County",2,67,5525,2564,2961
050,34,007,"New Jersey","Camden County",2,68,5231,2367,2864
050,34,007,"New Jersey","Camden County",2,69,4954,2240,2714
050,34,007,"New Jersey","Camden County",2,70,4696,2112,2584
050,34,007,"New Jersey","Camden County",2,71,4530,2043,2487
050,34,007,"New Jersey","Camden County",2,72,4513,2020,2493
050,34,007,"New Jersey","Camden County",2,73,4833,2161,2672
050,34,007,"New Jersey","Camden County",2,74,3377,1489,1888
050,34,007,"New Jersey","Camden County",2,75,3152,1385,1767
050,34,007,"New Jersey","Camden County",2,76,3083,1390,1693
050,34,007,"New Jersey","Camden County",2,77,3177,1373,1804
050,34,007,"New Jersey","Camden County",2,78,2694,1155,1539
050,34,007,"New Jersey","Camden County",2,79,2324,996,1328
050,34,007,"New Jersey","Camden County",2,80,2102,878,1224
050,34,007,"New Jersey","Camden County",2,81,1943,785,1158
050,34,007,"New Jersey","Camden County",2,82,1809,716,1093
050,34,007,"New Jersey","Camden County",2,83,1627,663,964
050,34,007,"New Jersey","Camden County",2,84,1553,593,960
050,34,007,"New Jersey","Camden County",2,85,9777,3158,6619
050,34,007,"New Jersey","Camden County",3,0,5895,2989,2906
050,34,007,"New Jersey","Camden County",3,1,6168,3149,3019
050,34,007,"New Jersey","Camden County",3,2,6319,3225,3094
050,34,007,"New Jersey","Camden County",3,3,6403,3306,3097
050,34,007,"New Jersey","Camden County",3,4,6423,3280,3143
050,34,007,"New Jersey","Camden County",3,5,6456,3353,3103
050,34,007,"New Jersey","Camden County",3,6,6516,3285,3231
050,34,007,"New Jersey","Camden County",3,7,6599,3324,3275
050,34,007,"New Jersey","Camden County",3,8,6494,3278,3216
050,34,007,"New Jersey","Camden County",3,9,6586,3379,3207
050,34,007,"New Jersey","Camden County",3,10,6729,3479,3250
050,34,007,"New Jersey","Camden County",3,11,6821,3533,3288
050,34,007,"New Jersey","Camden County",3,12,6862,3523,3339
050,34,007,"New Jersey","Camden County",3,13,7080,3541,3539
050,34,007,"New Jersey","Camden County",3,14,7133,3645,3488
050,34,007,"New Jersey","Camden County",3,15,7024,3583,3441
050,34,007,"New Jersey","Camden County",3,16,7000,3581,3419
050,34,007,"New Jersey","Camden County",3,17,6964,3561,3403
050,34,007,"New Jersey","Camden County",3,18,6091,3212,2879
050,34,007,"New Jersey","Camden County",3,19,5233,2706,2527
050,34,007,"New Jersey","Camden County",3,20,5674,2905,2769
050,34,007,"New Jersey","Camden County",3,21,5976,3000,2976
050,34,007,"New Jersey","Camden County",3,22,6202,3069,3133
050,34,007,"New Jersey","Camden County",3,23,6410,3150,3260
050,34,007,"New Jersey","Camden County",3,24,6419,3183,3236
050,34,007,"New Jersey","Camden County",3,25,6552,3253,3299
050,34,007,"New Jersey","Camden County",3,26,6711,3308,3403
050,34,007,"New Jersey","Camden County",3,27,7010,3453,3557
050,34,007,"New Jersey","Camden County",3,28,7264,3529,3735
050,34,007,"New Jersey","Camden County",3,29,7340,3608,3732
050,34,007,"New Jersey","Camden County",3,30,7522,3670,3852
050,34,007,"New Jersey","Camden County",3,31,7552,3650,3902
050,34,007,"New Jersey","Camden County",3,32,7408,3625,3783
050,34,007,"New Jersey","Camden County",3,33,7363,3623,3740
050,34,007,"New Jersey","Camden County",3,34,7364,3670,3694
050,34,007,"New Jersey","Camden County",3,35,7400,3660,3740
050,34,007,"New Jersey","Camden County",3,36,7429,3681,3748
050,34,007,"New Jersey","Camden County",3,37,7234,3532,3702
050,34,007,"New Jersey","Camden County",3,38,7186,3546,3640
050,34,007,"New Jersey","Camden County",3,39,7059,3443,3616
050,34,007,"New Jersey","Camden County",3,40,6961,3380,3581
050,34,007,"New Jersey","Camden County",3,41,7045,3427,3618
050,34,007,"New Jersey","Camden County",3,42,6725,3262,3463
050,34,007,"New Jersey","Camden County",3,43,6510,3166,3344
050,34,007,"New Jersey","Camden County",3,44,6369,3081,3288
050,34,007,"New Jersey","Camden County",3,45,6206,2968,3238
050,34,007,"New Jersey","Camden County",3,46,6297,3044,3253
050,34,007,"New Jersey","Camden County",3,47,6166,2984,3182
050,34,007,"New Jersey","Camden County",3,48,6205,2995,3210
050,34,007,"New Jersey","Camden County",3,49,6661,3223,3438
050,34,007,"New Jersey","Camden County",3,50,7170,3437,3733
050,34,007,"New Jersey","Camden County",3,51,7065,3413,3652
050,34,007,"New Jersey","Camden County",3,52,6794,3304,3490
050,34,007,"New Jersey","Camden County",3,53,6729,3276,3453
050,34,007,"New Jersey","Camden County",3,54,6744,3239,3505
050,34,007,"New Jersey","Camden County",3,55,6832,3243,3589
050,34,007,"New Jersey","Camden County",3,56,7103,3396,3707
050,34,007,"New Jersey","Camden County",3,57,7059,3350,3709
050,34,007,"New Jersey","Camden County",3,58,7063,3406,3657
050,34,007,"New Jersey","Camden County",3,59,7200,3491,3709
050,34,007,"New Jersey","Camden County",3,60,7196,3444,3752
050,34,007,"New Jersey","Camden County",3,61,7078,3348,3730
050,34,007,"New Jersey","Camden County",3,62,6879,3289,3590
050,34,007,"New Jersey","Camden County",3,63,6758,3245,3513
050,34,007,"New Jersey","Camden County",3,64,6569,3161,3408
050,34,007,"New Jersey","Camden County",3,65,6202,2943,3259
050,34,007,"New Jersey","Camden County",3,66,6020,2817,3203
050,34,007,"New Jersey","Camden County",3,67,5709,2688,3021
050,34,007,"New Jersey","Camden County",3,68,5364,2463,2901
050,34,007,"New Jersey","Camden County",3,69,5089,2306,2783
050,34,007,"New Jersey","Camden County",3,70,4825,2153,2672
050,34,007,"New Jersey","Camden County",3,71,4603,2053,2550
050,34,007,"New Jersey","Camden County",3,72,4397,1960,2437
050,34,007,"New Jersey","Camden County",3,73,4359,1930,2429
050,34,007,"New Jersey","Camden County",3,74,4637,2068,2569
050,34,007,"New Jersey","Camden County",3,75,3281,1413,1868
050,34,007,"New Jersey","Camden County",3,76,3028,1344,1684
050,34,007,"New Jersey","Camden County",3,77,2944,1296,1648
050,34,007,"New Jersey","Camden County",3,78,3018,1296,1722
050,34,007,"New Jersey","Camden County",3,79,2595,1100,1495
050,34,007,"New Jersey","Camden County",3,80,2160,911,1249
050,34,007,"New Jersey","Camden County",3,81,1981,832,1149
050,34,007,"New Jersey","Camden County",3,82,1840,741,1099
050,34,007,"New Jersey","Camden County",3,83,1703,668,1035
050,34,007,"New Jersey","Camden County",3,84,1494,588,906
050,34,007,"New Jersey","Camden County",3,85,9589,3139,6450
050,34,007,"New Jersey","Camden County",4,0,6170,3191,2979
050,34,007,"New Jersey","Camden County",4,1,6032,3079,2953
050,34,007,"New Jersey","Camden County",4,2,6230,3145,3085
050,34,007,"New Jersey","Camden County",4,3,6351,3253,3098
050,34,007,"New Jersey","Camden County",4,4,6393,3329,3064
050,34,007,"New Jersey","Camden County",4,5,6478,3315,3163
050,34,007,"New Jersey","Camden County",4,6,6536,3379,3157
050,34,007,"New Jersey","Camden County",4,7,6564,3329,3235
050,34,007,"New Jersey","Camden County",4,8,6733,3373,3360
050,34,007,"New Jersey","Camden County",4,9,6492,3260,3232
050,34,007,"New Jersey","Camden County",4,10,6594,3376,3218
050,34,007,"New Jersey","Camden County",4,11,6715,3470,3245
050,34,007,"New Jersey","Camden County",4,12,6842,3538,3304
050,34,007,"New Jersey","Camden County",4,13,6878,3508,3370
050,34,007,"New Jersey","Camden County",4,14,7134,3575,3559
050,34,007,"New Jersey","Camden County",4,15,7133,3644,3489
050,34,007,"New Jersey","Camden County",4,16,7035,3584,3451
050,34,007,"New Jersey","Camden County",4,17,7015,3589,3426
050,34,007,"New Jersey","Camden County",4,18,6183,3213,2970
050,34,007,"New Jersey","Camden County",4,19,5152,2711,2441
050,34,007,"New Jersey","Camden County",4,20,5475,2812,2663
050,34,007,"New Jersey","Camden County",4,21,5858,2961,2897
050,34,007,"New Jersey","Camden County",4,22,6251,3120,3131
050,34,007,"New Jersey","Camden County",4,23,6424,3187,3237
050,34,007,"New Jersey","Camden County",4,24,6567,3250,3317
050,34,007,"New Jersey","Camden County",4,25,6427,3197,3230
050,34,007,"New Jersey","Camden County",4,26,6585,3266,3319
050,34,007,"New Jersey","Camden County",4,27,6739,3301,3438
050,34,007,"New Jersey","Camden County",4,28,7034,3417,3617
050,34,007,"New Jersey","Camden County",4,29,7279,3535,3744
050,34,007,"New Jersey","Camden County",4,30,7451,3639,3812
050,34,007,"New Jersey","Camden County",4,31,7624,3732,3892
050,34,007,"New Jersey","Camden County",4,32,7655,3668,3987
050,34,007,"New Jersey","Camden County",4,33,7512,3669,3843
050,34,007,"New Jersey","Camden County",4,34,7451,3675,3776
050,34,007,"New Jersey","Camden County",4,35,7384,3681,3703
050,34,007,"New Jersey","Camden County",4,36,7456,3707,3749
050,34,007,"New Jersey","Camden County",4,37,7478,3685,3793
050,34,007,"New Jersey","Camden County",4,38,7288,3529,3759
050,34,007,"New Jersey","Camden County",4,39,7219,3578,3641
050,34,007,"New Jersey","Camden County",4,40,7101,3477,3624
050,34,007,"New Jersey","Camden County",4,41,6982,3407,3575
050,34,007,"New Jersey","Camden County",4,42,6981,3374,3607
050,34,007,"New Jersey","Camden County",4,43,6751,3276,3475
050,34,007,"New Jersey","Camden County",4,44,6538,3183,3355
050,34,007,"New Jersey","Camden County",4,45,6391,3092,3299
050,34,007,"New Jersey","Camden County",4,46,6156,2960,3196
050,34,007,"New Jersey","Camden County",4,47,6289,3024,3265
050,34,007,"New Jersey","Camden County",4,48,6100,2981,3119
050,34,007,"New Jersey","Camden County",4,49,6202,2991,3211
050,34,007,"New Jersey","Camden County",4,50,6600,3176,3424
050,34,007,"New Jersey","Camden County",4,51,7115,3415,3700
050,34,007,"New Jersey","Camden County",4,52,6966,3344,3622
050,34,007,"New Jersey","Camden County",4,53,6742,3283,3459
050,34,007,"New Jersey","Camden County",4,54,6657,3216,3441
050,34,007,"New Jersey","Camden County",4,55,6635,3176,3459
050,34,007,"New Jersey","Camden County",4,56,6725,3195,3530
050,34,007,"New Jersey","Camden County",4,57,6973,3300,3673
050,34,007,"New Jersey","Camden County",4,58,6929,3294,3635
050,34,007,"New Jersey","Camden County",4,59,6955,3349,3606
050,34,007,"New Jersey","Camden County",4,60,7055,3386,3669
050,34,007,"New Jersey","Camden County",4,61,7005,3352,3653
050,34,007,"New Jersey","Camden County",4,62,6921,3257,3664
050,34,007,"New Jersey","Camden County",4,63,6674,3186,3488
050,34,007,"New Jersey","Camden County",4,64,6604,3156,3448
050,34,007,"New Jersey","Camden County",4,65,6336,3024,3312
050,34,007,"New Jersey","Camden County",4,66,6039,2836,3203
050,34,007,"New Jersey","Camden County",4,67,5794,2695,3099
050,34,007,"New Jersey","Camden County",4,68,5544,2585,2959
050,34,007,"New Jersey","Camden County",4,69,5209,2380,2829
050,34,007,"New Jersey","Camden County",4,70,4937,2225,2712
050,34,007,"New Jersey","Camden County",4,71,4696,2092,2604
050,34,007,"New Jersey","Camden County",4,72,4463,1976,2487
050,34,007,"New Jersey","Camden County",4,73,4231,1857,2374
050,34,007,"New Jersey","Camden County",4,74,4203,1865,2338
050,34,007,"New Jersey","Camden County",4,75,4477,1976,2501
050,34,007,"New Jersey","Camden County",4,76,3136,1373,1763
050,34,007,"New Jersey","Camden County",4,77,2905,1261,1644
050,34,007,"New Jersey","Camden County",4,78,2805,1208,1597
050,34,007,"New Jersey","Camden County",4,79,2906,1235,1671
050,34,007,"New Jersey","Camden County",4,80,2442,1022,1420
050,34,007,"New Jersey","Camden County",4,81,2029,847,1182
050,34,007,"New Jersey","Camden County",4,82,1853,762,1091
050,34,007,"New Jersey","Camden County",4,83,1716,676,1040
050,34,007,"New Jersey","Camden County",4,84,1567,604,963
050,34,007,"New Jersey","Camden County",4,85,9497,3201,6296
050,34,007,"New Jersey","Camden County",5,0,6178,3201,2977
050,34,007,"New Jersey","Camden County",5,1,6243,3257,2986
050,34,007,"New Jersey","Camden County",5,2,6120,3128,2992
050,34,007,"New Jersey","Camden County",5,3,6373,3211,3162
050,34,007,"New Jersey","Camden County",5,4,6302,3227,3075
050,34,007,"New Jersey","Camden County",5,5,6455,3358,3097
050,34,007,"New Jersey","Camden County",5,6,6568,3370,3198
050,34,007,"New Jersey","Camden County",5,7,6578,3393,3185
050,34,007,"New Jersey","Camden County",5,8,6668,3367,3301
050,34,007,"New Jersey","Camden County",5,9,6754,3402,3352
050,34,007,"New Jersey","Camden County",5,10,6553,3268,3285
050,34,007,"New Jersey","Camden County",5,11,6666,3429,3237
050,34,007,"New Jersey","Camden County",5,12,6738,3464,3274
050,34,007,"New Jersey","Camden County",5,13,6886,3537,3349
050,34,007,"New Jersey","Camden County",5,14,6960,3527,3433
050,34,007,"New Jersey","Camden County",5,15,7129,3536,3593
050,34,007,"New Jersey","Camden County",5,16,7171,3676,3495
050,34,007,"New Jersey","Camden County",5,17,7012,3568,3444
050,34,007,"New Jersey","Camden County",5,18,6184,3236,2948
050,34,007,"New Jersey","Camden County",5,19,5290,2763,2527
050,34,007,"New Jersey","Camden County",5,20,5478,2849,2629
050,34,007,"New Jersey","Camden County",5,21,5797,2909,2888
050,34,007,"New Jersey","Camden County",5,22,6153,3090,3063
050,34,007,"New Jersey","Camden County",5,23,6463,3213,3250
050,34,007,"New Jersey","Camden County",5,24,6512,3244,3268
050,34,007,"New Jersey","Camden County",5,25,6611,3260,3351
050,34,007,"New Jersey","Camden County",5,26,6464,3191,3273
050,34,007,"New Jersey","Camden County",5,27,6587,3234,3353
050,34,007,"New Jersey","Camden County",5,28,6851,3337,3514
050,34,007,"New Jersey","Camden County",5,29,7198,3518,3680
050,34,007,"New Jersey","Camden County",5,30,7492,3607,3885
050,34,007,"New Jersey","Camden County",5,31,7600,3682,3918
050,34,007,"New Jersey","Camden County",5,32,7815,3856,3959
050,34,007,"New Jersey","Camden County",5,33,7826,3775,4051
050,34,007,"New Jersey","Camden County",5,34,7598,3732,3866
050,34,007,"New Jersey","Camden County",5,35,7635,3783,3852
050,34,007,"New Jersey","Camden County",5,36,7450,3699,3751
050,34,007,"New Jersey","Camden County",5,37,7464,3673,3791
050,34,007,"New Jersey","Camden County",5,38,7566,3689,3877
050,34,007,"New Jersey","Camden County",5,39,7307,3553,3754
050,34,007,"New Jersey","Camden County",5,40,7189,3558,3631
050,34,007,"New Jersey","Camden County",5,41,7092,3448,3644
050,34,007,"New Jersey","Camden County",5,42,7013,3389,3624
050,34,007,"New Jersey","Camden County",5,43,6951,3382,3569
050,34,007,"New Jersey","Camden County",5,44,6768,3258,3510
050,34,007,"New Jersey","Camden County",5,45,6521,3188,3333
050,34,007,"New Jersey","Camden County",5,46,6405,3103,3302
050,34,007,"New Jersey","Camden County",5,47,6142,2927,3215
050,34,007,"New Jersey","Camden County",5,48,6258,3009,3249
050,34,007,"New Jersey","Camden County",5,49,6111,2974,3137
050,34,007,"New Jersey","Camden County",5,50,6199,2980,3219
050,34,007,"New Jersey","Camden County",5,51,6616,3180,3436
050,34,007,"New Jersey","Camden County",5,52,7068,3382,3686
050,34,007,"New Jersey","Camden County",5,53,6905,3318,3587
050,34,007,"New Jersey","Camden County",5,54,6700,3249,3451
050,34,007,"New Jersey","Camden County",5,55,6585,3196,3389
050,34,007,"New Jersey","Camden County",5,56,6567,3127,3440
050,34,007,"New Jersey","Camden County",5,57,6604,3142,3462
050,34,007,"New Jersey","Camden County",5,58,6854,3269,3585
050,34,007,"New Jersey","Camden County",5,59,6820,3255,3565
050,34,007,"New Jersey","Camden County",5,60,6810,3240,3570
050,34,007,"New Jersey","Camden County",5,61,6902,3299,3603
050,34,007,"New Jersey","Camden County",5,62,6839,3278,3561
050,34,007,"New Jersey","Camden County",5,63,6724,3156,3568
050,34,007,"New Jersey","Camden County",5,64,6523,3097,3426
050,34,007,"New Jersey","Camden County",5,65,6416,3064,3352
050,34,007,"New Jersey","Camden County",5,66,6217,2949,3268
050,34,007,"New Jersey","Camden County",5,67,5862,2745,3117
050,34,007,"New Jersey","Camden County",5,68,5654,2597,3057
050,34,007,"New Jersey","Camden County",5,69,5426,2534,2892
050,34,007,"New Jersey","Camden County",5,70,5114,2313,2801
050,34,007,"New Jersey","Camden County",5,71,4820,2161,2659
050,34,007,"New Jersey","Camden County",5,72,4566,2015,2551
050,34,007,"New Jersey","Camden County",5,73,4331,1892,2439
050,34,007,"New Jersey","Camden County",5,74,4107,1808,2299
050,34,007,"New Jersey","Camden County",5,75,4089,1808,2281
050,34,007,"New Jersey","Camden County",5,76,4330,1924,2406
050,34,007,"New Jersey","Camden County",5,77,3022,1294,1728
050,34,007,"New Jersey","Camden County",5,78,2779,1191,1588
050,34,007,"New Jersey","Camden County",5,79,2686,1153,1533
050,34,007,"New Jersey","Camden County",5,80,2751,1146,1605
050,34,007,"New Jersey","Camden County",5,81,2334,969,1365
050,34,007,"New Jersey","Camden County",5,82,1924,783,1141
050,34,007,"New Jersey","Camden County",5,83,1736,706,1030
050,34,007,"New Jersey","Camden County",5,84,1600,623,977
050,34,007,"New Jersey","Camden County",5,85,9571,3282,6289
050,34,009,"New Jersey","Cape May County",1,0,840,425,415
050,34,009,"New Jersey","Cape May County",1,1,844,418,426
050,34,009,"New Jersey","Cape May County",1,2,827,402,425
050,34,009,"New Jersey","Cape May County",1,3,844,402,442
050,34,009,"New Jersey","Cape May County",1,4,906,480,426
050,34,009,"New Jersey","Cape May County",1,5,949,476,473
050,34,009,"New Jersey","Cape May County",1,6,948,475,473
050,34,009,"New Jersey","Cape May County",1,7,913,471,442
050,34,009,"New Jersey","Cape May County",1,8,928,471,457
050,34,009,"New Jersey","Cape May County",1,9,934,462,472
050,34,009,"New Jersey","Cape May County",1,10,1007,501,506
050,34,009,"New Jersey","Cape May County",1,11,1011,506,505
050,34,009,"New Jersey","Cape May County",1,12,1016,509,507
050,34,009,"New Jersey","Cape May County",1,13,1038,505,533
050,34,009,"New Jersey","Cape May County",1,14,997,512,485
050,34,009,"New Jersey","Cape May County",1,15,949,477,472
050,34,009,"New Jersey","Cape May County",1,16,1013,507,506
050,34,009,"New Jersey","Cape May County",1,17,1016,523,493
050,34,009,"New Jersey","Cape May County",1,18,874,481,393
050,34,009,"New Jersey","Cape May County",1,19,741,409,332
050,34,009,"New Jersey","Cape May County",1,20,827,428,399
050,34,009,"New Jersey","Cape May County",1,21,853,440,413
050,34,009,"New Jersey","Cape May County",1,22,922,475,447
050,34,009,"New Jersey","Cape May County",1,23,995,524,471
050,34,009,"New Jersey","Cape May County",1,24,969,504,465
050,34,009,"New Jersey","Cape May County",1,25,981,511,470
050,34,009,"New Jersey","Cape May County",1,26,1021,520,501
050,34,009,"New Jersey","Cape May County",1,27,1007,518,489
050,34,009,"New Jersey","Cape May County",1,28,982,522,460
050,34,009,"New Jersey","Cape May County",1,29,962,516,446
050,34,009,"New Jersey","Cape May County",1,30,936,492,444
050,34,009,"New Jersey","Cape May County",1,31,928,492,436
050,34,009,"New Jersey","Cape May County",1,32,937,472,465
050,34,009,"New Jersey","Cape May County",1,33,1008,513,495
050,34,009,"New Jersey","Cape May County",1,34,1009,520,489
050,34,009,"New Jersey","Cape May County",1,35,938,475,463
050,34,009,"New Jersey","Cape May County",1,36,890,438,452
050,34,009,"New Jersey","Cape May County",1,37,931,461,470
050,34,009,"New Jersey","Cape May County",1,38,925,468,457
050,34,009,"New Jersey","Cape May County",1,39,938,477,461
050,34,009,"New Jersey","Cape May County",1,40,945,476,469
050,34,009,"New Jersey","Cape May County",1,41,895,440,455
050,34,009,"New Jersey","Cape May County",1,42,866,413,453
050,34,009,"New Jersey","Cape May County",1,43,885,420,465
050,34,009,"New Jersey","Cape May County",1,44,843,403,440
050,34,009,"New Jersey","Cape May County",1,45,866,423,443
050,34,009,"New Jersey","Cape May County",1,46,847,413,434
050,34,009,"New Jersey","Cape May County",1,47,902,471,431
050,34,009,"New Jersey","Cape May County",1,48,1003,510,493
050,34,009,"New Jersey","Cape May County",1,49,1134,576,558
050,34,009,"New Jersey","Cape May County",1,50,1120,547,573
050,34,009,"New Jersey","Cape May County",1,51,1159,592,567
050,34,009,"New Jersey","Cape May County",1,52,1161,594,567
050,34,009,"New Jersey","Cape May County",1,53,1194,576,618
050,34,009,"New Jersey","Cape May County",1,54,1307,645,662
050,34,009,"New Jersey","Cape May County",1,55,1421,672,749
050,34,009,"New Jersey","Cape May County",1,56,1476,680,796
050,34,009,"New Jersey","Cape May County",1,57,1564,724,840
050,34,009,"New Jersey","Cape May County",1,58,1670,804,866
050,34,009,"New Jersey","Cape May County",1,59,1632,780,852
050,34,009,"New Jersey","Cape May County",1,60,1610,767,843
050,34,009,"New Jersey","Cape May County",1,61,1706,803,903
050,34,009,"New Jersey","Cape May County",1,62,1711,800,911
050,34,009,"New Jersey","Cape May County",1,63,1736,796,940
050,34,009,"New Jersey","Cape May County",1,64,1730,816,914
050,34,009,"New Jersey","Cape May County",1,65,1740,807,933
050,34,009,"New Jersey","Cape May County",1,66,1742,847,895
050,34,009,"New Jersey","Cape May County",1,67,1700,820,880
050,34,009,"New Jersey","Cape May County",1,68,1637,777,860
050,34,009,"New Jersey","Cape May County",1,69,1543,723,820
050,34,009,"New Jersey","Cape May County",1,70,1543,730,813
050,34,009,"New Jersey","Cape May County",1,71,1543,740,803
050,34,009,"New Jersey","Cape May County",1,72,1546,733,813
050,34,009,"New Jersey","Cape May County",1,73,1566,742,824
050,34,009,"New Jersey","Cape May County",1,74,1085,509,576
050,34,009,"New Jersey","Cape May County",1,75,1053,487,566
050,34,009,"New Jersey","Cape May County",1,76,1093,497,596
050,34,009,"New Jersey","Cape May County",1,77,1104,504,600
050,34,009,"New Jersey","Cape May County",1,78,882,407,475
050,34,009,"New Jersey","Cape May County",1,79,769,334,435
050,34,009,"New Jersey","Cape May County",1,80,686,281,405
050,34,009,"New Jersey","Cape May County",1,81,692,307,385
050,34,009,"New Jersey","Cape May County",1,82,620,264,356
050,34,009,"New Jersey","Cape May County",1,83,528,242,286
050,34,009,"New Jersey","Cape May County",1,84,515,244,271
050,34,009,"New Jersey","Cape May County",1,85,2738,998,1740
050,34,009,"New Jersey","Cape May County",2,0,834,425,409
050,34,009,"New Jersey","Cape May County",2,1,843,418,425
050,34,009,"New Jersey","Cape May County",2,2,834,407,427
050,34,009,"New Jersey","Cape May County",2,3,837,402,435
050,34,009,"New Jersey","Cape May County",2,4,895,460,435
050,34,009,"New Jersey","Cape May County",2,5,941,476,465
050,34,009,"New Jersey","Cape May County",2,6,949,478,471
050,34,009,"New Jersey","Cape May County",2,7,920,470,450
050,34,009,"New Jersey","Cape May County",2,8,919,467,452
050,34,009,"New Jersey","Cape May County",2,9,925,460,465
050,34,009,"New Jersey","Cape May County",2,10,981,486,495
050,34,009,"New Jersey","Cape May County",2,11,1005,500,505
050,34,009,"New Jersey","Cape May County",2,12,1020,511,509
050,34,009,"New Jersey","Cape May County",2,13,1028,506,522
050,34,009,"New Jersey","Cape May County",2,14,1003,509,494
050,34,009,"New Jersey","Cape May County",2,15,961,483,478
050,34,009,"New Jersey","Cape May County",2,16,999,500,499
050,34,009,"New Jersey","Cape May County",2,17,1017,518,499
050,34,009,"New Jersey","Cape May County",2,18,876,479,397
050,34,009,"New Jersey","Cape May County",2,19,740,410,330
050,34,009,"New Jersey","Cape May County",2,20,828,432,396
050,34,009,"New Jersey","Cape May County",2,21,855,440,415
050,34,009,"New Jersey","Cape May County",2,22,912,469,443
050,34,009,"New Jersey","Cape May County",2,23,980,514,466
050,34,009,"New Jersey","Cape May County",2,24,971,508,463
050,34,009,"New Jersey","Cape May County",2,25,979,508,471
050,34,009,"New Jersey","Cape May County",2,26,1007,513,494
050,34,009,"New Jersey","Cape May County",2,27,1001,514,487
050,34,009,"New Jersey","Cape May County",2,28,977,515,462
050,34,009,"New Jersey","Cape May County",2,29,958,512,446
050,34,009,"New Jersey","Cape May County",2,30,945,502,443
050,34,009,"New Jersey","Cape May County",2,31,924,489,435
050,34,009,"New Jersey","Cape May County",2,32,932,473,459
050,34,009,"New Jersey","Cape May County",2,33,989,502,487
050,34,009,"New Jersey","Cape May County",2,34,1009,519,490
050,34,009,"New Jersey","Cape May County",2,35,955,485,470
050,34,009,"New Jersey","Cape May County",2,36,897,447,450
050,34,009,"New Jersey","Cape May County",2,37,920,455,465
050,34,009,"New Jersey","Cape May County",2,38,931,469,462
050,34,009,"New Jersey","Cape May County",2,39,930,470,460
050,34,009,"New Jersey","Cape May County",2,40,946,477,469
050,34,009,"New Jersey","Cape May County",2,41,905,446,459
050,34,009,"New Jersey","Cape May County",2,42,867,414,453
050,34,009,"New Jersey","Cape May County",2,43,886,420,466
050,34,009,"New Jersey","Cape May County",2,44,847,405,442
050,34,009,"New Jersey","Cape May County",2,45,866,421,445
050,34,009,"New Jersey","Cape May County",2,46,848,413,435
050,34,009,"New Jersey","Cape May County",2,47,887,455,432
050,34,009,"New Jersey","Cape May County",2,48,978,501,477
050,34,009,"New Jersey","Cape May County",2,49,1111,567,544
050,34,009,"New Jersey","Cape May County",2,50,1122,557,565
050,34,009,"New Jersey","Cape May County",2,51,1135,573,562
050,34,009,"New Jersey","Cape May County",2,52,1153,590,563
050,34,009,"New Jersey","Cape May County",2,53,1187,580,607
050,34,009,"New Jersey","Cape May County",2,54,1276,625,651
050,34,009,"New Jersey","Cape May County",2,55,1387,658,729
050,34,009,"New Jersey","Cape May County",2,56,1468,679,789
050,34,009,"New Jersey","Cape May County",2,57,1547,717,830
050,34,009,"New Jersey","Cape May County",2,58,1644,784,860
050,34,009,"New Jersey","Cape May County",2,59,1649,789,860
050,34,009,"New Jersey","Cape May County",2,60,1616,767,849
050,34,009,"New Jersey","Cape May County",2,61,1674,793,881
050,34,009,"New Jersey","Cape May County",2,62,1713,800,913
050,34,009,"New Jersey","Cape May County",2,63,1742,802,940
050,34,009,"New Jersey","Cape May County",2,64,1731,809,922
050,34,009,"New Jersey","Cape May County",2,65,1739,813,926
050,34,009,"New Jersey","Cape May County",2,66,1746,839,907
050,34,009,"New Jersey","Cape May County",2,67,1704,823,881
050,34,009,"New Jersey","Cape May County",2,68,1641,782,859
050,34,009,"New Jersey","Cape May County",2,69,1576,741,835
050,34,009,"New Jersey","Cape May County",2,70,1534,725,809
050,34,009,"New Jersey","Cape May County",2,71,1528,727,801
050,34,009,"New Jersey","Cape May County",2,72,1512,720,792
050,34,009,"New Jersey","Cape May County",2,73,1634,775,859
050,34,009,"New Jersey","Cape May County",2,74,1122,527,595
050,34,009,"New Jersey","Cape May County",2,75,1061,495,566
050,34,009,"New Jersey","Cape May County",2,76,1066,485,581
050,34,009,"New Jersey","Cape May County",2,77,1115,508,607
050,34,009,"New Jersey","Cape May County",2,78,914,419,495
050,34,009,"New Jersey","Cape May County",2,79,776,336,440
050,34,009,"New Jersey","Cape May County",2,80,699,293,406
050,34,009,"New Jersey","Cape May County",2,81,681,295,386
050,34,009,"New Jersey","Cape May County",2,82,628,269,359
050,34,009,"New Jersey","Cape May County",2,83,534,239,295
050,34,009,"New Jersey","Cape May County",2,84,508,240,268
050,34,009,"New Jersey","Cape May County",2,85,2714,996,1718
050,34,009,"New Jersey","Cape May County",3,0,755,380,375
050,34,009,"New Jersey","Cape May County",3,1,845,421,424
050,34,009,"New Jersey","Cape May County",3,2,853,428,425
050,34,009,"New Jersey","Cape May County",3,3,820,404,416
050,34,009,"New Jersey","Cape May County",3,4,837,397,440
050,34,009,"New Jersey","Cape May County",3,5,883,463,420
050,34,009,"New Jersey","Cape May County",3,6,944,485,459
050,34,009,"New Jersey","Cape May County",3,7,934,479,455
050,34,009,"New Jersey","Cape May County",3,8,919,461,458
050,34,009,"New Jersey","Cape May County",3,9,904,452,452
050,34,009,"New Jersey","Cape May County",3,10,928,468,460
050,34,009,"New Jersey","Cape May County",3,11,990,490,500
050,34,009,"New Jersey","Cape May County",3,12,1007,504,503
050,34,009,"New Jersey","Cape May County",3,13,1032,519,513
050,34,009,"New Jersey","Cape May County",3,14,1046,526,520
050,34,009,"New Jersey","Cape May County",3,15,1007,505,502
050,34,009,"New Jersey","Cape May County",3,16,953,474,479
050,34,009,"New Jersey","Cape May County",3,17,1020,519,501
050,34,009,"New Jersey","Cape May County",3,18,893,480,413
050,34,009,"New Jersey","Cape May County",3,19,733,404,329
050,34,009,"New Jersey","Cape May County",3,20,811,446,365
050,34,009,"New Jersey","Cape May County",3,21,897,465,432
050,34,009,"New Jersey","Cape May County",3,22,923,462,461
050,34,009,"New Jersey","Cape May County",3,23,944,489,455
050,34,009,"New Jersey","Cape May County",3,24,958,509,449
050,34,009,"New Jersey","Cape May County",3,25,952,493,459
050,34,009,"New Jersey","Cape May County",3,26,980,511,469
050,34,009,"New Jersey","Cape May County",3,27,1021,540,481
050,34,009,"New Jersey","Cape May County",3,28,1015,524,491
050,34,009,"New Jersey","Cape May County",3,29,1009,519,490
050,34,009,"New Jersey","Cape May County",3,30,1003,553,450
050,34,009,"New Jersey","Cape May County",3,31,963,507,456
050,34,009,"New Jersey","Cape May County",3,32,934,491,443
050,34,009,"New Jersey","Cape May County",3,33,952,493,459
050,34,009,"New Jersey","Cape May County",3,34,997,505,492
050,34,009,"New Jersey","Cape May County",3,35,1027,539,488
050,34,009,"New Jersey","Cape May County",3,36,984,496,488
050,34,009,"New Jersey","Cape May County",3,37,893,448,445
050,34,009,"New Jersey","Cape May County",3,38,932,467,465
050,34,009,"New Jersey","Cape May County",3,39,944,465,479
050,34,009,"New Jersey","Cape May County",3,40,961,492,469
050,34,009,"New Jersey","Cape May County",3,41,978,492,486
050,34,009,"New Jersey","Cape May County",3,42,896,428,468
050,34,009,"New Jersey","Cape May County",3,43,854,401,453
050,34,009,"New Jersey","Cape May County",3,44,895,423,472
050,34,009,"New Jersey","Cape May County",3,45,863,423,440
050,34,009,"New Jersey","Cape May County",3,46,866,422,444
050,34,009,"New Jersey","Cape May County",3,47,878,429,449
050,34,009,"New Jersey","Cape May County",3,48,890,457,433
050,34,009,"New Jersey","Cape May County",3,49,996,506,490
050,34,009,"New Jersey","Cape May County",3,50,1132,579,553
050,34,009,"New Jersey","Cape May County",3,51,1132,562,570
050,34,009,"New Jersey","Cape May County",3,52,1145,565,580
050,34,009,"New Jersey","Cape May County",3,53,1169,587,582
050,34,009,"New Jersey","Cape May County",3,54,1235,603,632
050,34,009,"New Jersey","Cape May County",3,55,1316,642,674
050,34,009,"New Jersey","Cape May County",3,56,1426,665,761
050,34,009,"New Jersey","Cape May County",3,57,1482,686,796
050,34,009,"New Jersey","Cape May County",3,58,1600,740,860
050,34,009,"New Jersey","Cape May County",3,59,1675,796,879
050,34,009,"New Jersey","Cape May County",3,60,1700,814,886
050,34,009,"New Jersey","Cape May County",3,61,1700,801,899
050,34,009,"New Jersey","Cape May County",3,62,1714,810,904
050,34,009,"New Jersey","Cape May County",3,63,1768,815,953
050,34,009,"New Jersey","Cape May County",3,64,1801,840,961
050,34,009,"New Jersey","Cape May County",3,65,1768,840,928
050,34,009,"New Jersey","Cape May County",3,66,1766,829,937
050,34,009,"New Jersey","Cape May County",3,67,1768,850,918
050,34,009,"New Jersey","Cape May County",3,68,1701,812,889
050,34,009,"New Jersey","Cape May County",3,69,1636,777,859
050,34,009,"New Jersey","Cape May County",3,70,1572,739,833
050,34,009,"New Jersey","Cape May County",3,71,1508,711,797
050,34,009,"New Jersey","Cape May County",3,72,1512,721,791
050,34,009,"New Jersey","Cape May County",3,73,1466,683,783
050,34,009,"New Jersey","Cape May County",3,74,1611,772,839
050,34,009,"New Jersey","Cape May County",3,75,1110,512,598
050,34,009,"New Jersey","Cape May County",3,76,1021,476,545
050,34,009,"New Jersey","Cape May County",3,77,1024,464,560
050,34,009,"New Jersey","Cape May County",3,78,1052,469,583
050,34,009,"New Jersey","Cape May County",3,79,853,385,468
050,34,009,"New Jersey","Cape May County",3,80,739,328,411
050,34,009,"New Jersey","Cape May County",3,81,661,283,378
050,34,009,"New Jersey","Cape May County",3,82,625,265,360
050,34,009,"New Jersey","Cape May County",3,83,583,248,335
050,34,009,"New Jersey","Cape May County",3,84,492,220,272
050,34,009,"New Jersey","Cape May County",3,85,2724,1036,1688
050,34,009,"New Jersey","Cape May County",4,0,741,393,348
050,34,009,"New Jersey","Cape May County",4,1,764,385,379
050,34,009,"New Jersey","Cape May County",4,2,829,420,409
050,34,009,"New Jersey","Cape May County",4,3,851,425,426
050,34,009,"New Jersey","Cape May County",4,4,815,404,411
050,34,009,"New Jersey","Cape May County",4,5,823,394,429
050,34,009,"New Jersey","Cape May County",4,6,885,461,424
050,34,009,"New Jersey","Cape May County",4,7,928,472,456
050,34,009,"New Jersey","Cape May County",4,8,926,482,444
050,34,009,"New Jersey","Cape May County",4,9,920,464,456
050,34,009,"New Jersey","Cape May County",4,10,914,449,465
050,34,009,"New Jersey","Cape May County",4,11,918,458,460
050,34,009,"New Jersey","Cape May County",4,12,962,473,489
050,34,009,"New Jersey","Cape May County",4,13,991,501,490
050,34,009,"New Jersey","Cape May County",4,14,1037,517,520
050,34,009,"New Jersey","Cape May County",4,15,1028,514,514
050,34,009,"New Jersey","Cape May County",4,16,991,508,483
050,34,009,"New Jersey","Cape May County",4,17,949,479,470
050,34,009,"New Jersey","Cape May County",4,18,886,472,414
050,34,009,"New Jersey","Cape May County",4,19,739,401,338
050,34,009,"New Jersey","Cape May County",4,20,794,427,367
050,34,009,"New Jersey","Cape May County",4,21,853,455,398
050,34,009,"New Jersey","Cape May County",4,22,961,487,474
050,34,009,"New Jersey","Cape May County",4,23,928,475,453
050,34,009,"New Jersey","Cape May County",4,24,873,474,399
050,34,009,"New Jersey","Cape May County",4,25,925,479,446
050,34,009,"New Jersey","Cape May County",4,26,940,479,461
050,34,009,"New Jersey","Cape May County",4,27,936,487,449
050,34,009,"New Jersey","Cape May County",4,28,951,490,461
050,34,009,"New Jersey","Cape May County",4,29,996,504,492
050,34,009,"New Jersey","Cape May County",4,30,1021,516,505
050,34,009,"New Jersey","Cape May County",4,31,993,543,450
050,34,009,"New Jersey","Cape May County",4,32,937,492,445
050,34,009,"New Jersey","Cape May County",4,33,935,492,443
050,34,009,"New Jersey","Cape May County",4,34,949,470,479
050,34,009,"New Jersey","Cape May County",4,35,986,497,489
050,34,009,"New Jersey","Cape May County",4,36,1017,531,486
050,34,009,"New Jersey","Cape May County",4,37,945,473,472
050,34,009,"New Jersey","Cape May County",4,38,868,431,437
050,34,009,"New Jersey","Cape May County",4,39,920,465,455
050,34,009,"New Jersey","Cape May County",4,40,946,482,464
050,34,009,"New Jersey","Cape May County",4,41,959,483,476
050,34,009,"New Jersey","Cape May County",4,42,967,481,486
050,34,009,"New Jersey","Cape May County",4,43,892,422,470
050,34,009,"New Jersey","Cape May County",4,44,845,409,436
050,34,009,"New Jersey","Cape May County",4,45,892,420,472
050,34,009,"New Jersey","Cape May County",4,46,880,435,445
050,34,009,"New Jersey","Cape May County",4,47,879,432,447
050,34,009,"New Jersey","Cape May County",4,48,865,411,454
050,34,009,"New Jersey","Cape May County",4,49,890,452,438
050,34,009,"New Jersey","Cape May County",4,50,999,504,495
050,34,009,"New Jersey","Cape May County",4,51,1125,588,537
050,34,009,"New Jersey","Cape May County",4,52,1127,567,560
050,34,009,"New Jersey","Cape May County",4,53,1148,544,604
050,34,009,"New Jersey","Cape May County",4,54,1226,637,589
050,34,009,"New Jersey","Cape May County",4,55,1244,611,633
050,34,009,"New Jersey","Cape May County",4,56,1341,639,702
050,34,009,"New Jersey","Cape May County",4,57,1440,668,772
050,34,009,"New Jersey","Cape May County",4,58,1530,694,836
050,34,009,"New Jersey","Cape May County",4,59,1622,754,868
050,34,009,"New Jersey","Cape May County",4,60,1723,823,900
050,34,009,"New Jersey","Cape May County",4,61,1743,811,932
050,34,009,"New Jersey","Cape May County",4,62,1712,793,919
050,34,009,"New Jersey","Cape May County",4,63,1781,839,942
050,34,009,"New Jersey","Cape May County",4,64,1813,838,975
050,34,009,"New Jersey","Cape May County",4,65,1843,850,993
050,34,009,"New Jersey","Cape May County",4,66,1812,864,948
050,34,009,"New Jersey","Cape May County",4,67,1814,854,960
050,34,009,"New Jersey","Cape May County",4,68,1755,832,923
050,34,009,"New Jersey","Cape May County",4,69,1732,820,912
050,34,009,"New Jersey","Cape May County",4,70,1649,787,862
050,34,009,"New Jersey","Cape May County",4,71,1555,746,809
050,34,009,"New Jersey","Cape May County",4,72,1504,708,796
050,34,009,"New Jersey","Cape May County",4,73,1502,717,785
050,34,009,"New Jersey","Cape May County",4,74,1439,674,765
050,34,009,"New Jersey","Cape May County",4,75,1600,774,826
050,34,009,"New Jersey","Cape May County",4,76,1070,491,579
050,34,009,"New Jersey","Cape May County",4,77,971,449,522
050,34,009,"New Jersey","Cape May County",4,78,985,448,537
050,34,009,"New Jersey","Cape May County",4,79,1002,436,566
050,34,009,"New Jersey","Cape May County",4,80,814,368,446
050,34,009,"New Jersey","Cape May County",4,81,711,315,396
050,34,009,"New Jersey","Cape May County",4,82,604,247,357
050,34,009,"New Jersey","Cape May County",4,83,567,241,326
050,34,009,"New Jersey","Cape May County",4,84,541,234,307
050,34,009,"New Jersey","Cape May County",4,85,2721,1061,1660
050,34,009,"New Jersey","Cape May County",5,0,741,390,351
050,34,009,"New Jersey","Cape May County",5,1,753,407,346
050,34,009,"New Jersey","Cape May County",5,2,768,389,379
050,34,009,"New Jersey","Cape May County",5,3,825,424,401
050,34,009,"New Jersey","Cape May County",5,4,858,428,430
050,34,009,"New Jersey","Cape May County",5,5,812,412,400
050,34,009,"New Jersey","Cape May County",5,6,820,391,429
050,34,009,"New Jersey","Cape May County",5,7,874,467,407
050,34,009,"New Jersey","Cape May County",5,8,916,474,442
050,34,009,"New Jersey","Cape May County",5,9,920,477,443
050,34,009,"New Jersey","Cape May County",5,10,917,464,453
050,34,009,"New Jersey","Cape May County",5,11,902,442,460
050,34,009,"New Jersey","Cape May County",5,12,894,451,443
050,34,009,"New Jersey","Cape May County",5,13,946,466,480
050,34,009,"New Jersey","Cape May County",5,14,984,495,489
050,34,009,"New Jersey","Cape May County",5,15,1022,500,522
050,34,009,"New Jersey","Cape May County",5,16,1011,504,507
050,34,009,"New Jersey","Cape May County",5,17,1005,519,486
050,34,009,"New Jersey","Cape May County",5,18,816,432,384
050,34,009,"New Jersey","Cape May County",5,19,716,387,329
050,34,009,"New Jersey","Cape May County",5,20,787,423,364
050,34,009,"New Jersey","Cape May County",5,21,832,442,390
050,34,009,"New Jersey","Cape May County",5,22,916,467,449
050,34,009,"New Jersey","Cape May County",5,23,962,477,485
050,34,009,"New Jersey","Cape May County",5,24,917,478,439
050,34,009,"New Jersey","Cape May County",5,25,851,459,392
050,34,009,"New Jersey","Cape May County",5,26,880,461,419
050,34,009,"New Jersey","Cape May County",5,27,924,476,448
050,34,009,"New Jersey","Cape May County",5,28,930,477,453
050,34,009,"New Jersey","Cape May County",5,29,946,493,453
050,34,009,"New Jersey","Cape May County",5,30,956,482,474
050,34,009,"New Jersey","Cape May County",5,31,977,501,476
050,34,009,"New Jersey","Cape May County",5,32,1001,540,461
050,34,009,"New Jersey","Cape May County",5,33,914,486,428
050,34,009,"New Jersey","Cape May County",5,34,936,488,448
050,34,009,"New Jersey","Cape May County",5,35,929,460,469
050,34,009,"New Jersey","Cape May County",5,36,941,481,460
050,34,009,"New Jersey","Cape May County",5,37,977,500,477
050,34,009,"New Jersey","Cape May County",5,38,916,461,455
050,34,009,"New Jersey","Cape May County",5,39,844,423,421
050,34,009,"New Jersey","Cape May County",5,40,915,459,456
050,34,009,"New Jersey","Cape May County",5,41,926,460,466
050,34,009,"New Jersey","Cape May County",5,42,941,469,472
050,34,009,"New Jersey","Cape May County",5,43,956,476,480
050,34,009,"New Jersey","Cape May County",5,44,889,421,468
050,34,009,"New Jersey","Cape May County",5,45,859,419,440
050,34,009,"New Jersey","Cape May County",5,46,896,418,478
050,34,009,"New Jersey","Cape May County",5,47,886,433,453
050,34,009,"New Jersey","Cape May County",5,48,874,428,446
050,34,009,"New Jersey","Cape May County",5,49,871,413,458
050,34,009,"New Jersey","Cape May County",5,50,888,440,448
050,34,009,"New Jersey","Cape May County",5,51,1002,513,489
050,34,009,"New Jersey","Cape May County",5,52,1119,577,542
050,34,009,"New Jersey","Cape May County",5,53,1141,565,576
050,34,009,"New Jersey","Cape May County",5,54,1173,557,616
050,34,009,"New Jersey","Cape May County",5,55,1220,626,594
050,34,009,"New Jersey","Cape May County",5,56,1244,603,641
050,34,009,"New Jersey","Cape May County",5,57,1356,641,715
050,34,009,"New Jersey","Cape May County",5,58,1457,667,790
050,34,009,"New Jersey","Cape May County",5,59,1536,705,831
050,34,009,"New Jersey","Cape May County",5,60,1658,767,891
050,34,009,"New Jersey","Cape May County",5,61,1764,825,939
050,34,009,"New Jersey","Cape May County",5,62,1722,797,925
050,34,009,"New Jersey","Cape May County",5,63,1726,800,926
050,34,009,"New Jersey","Cape May County",5,64,1820,860,960
050,34,009,"New Jersey","Cape May County",5,65,1833,854,979
050,34,009,"New Jersey","Cape May County",5,66,1833,833,1000
050,34,009,"New Jersey","Cape May County",5,67,1817,871,946
050,34,009,"New Jersey","Cape May County",5,68,1815,849,966
050,34,009,"New Jersey","Cape May County",5,69,1745,819,926
050,34,009,"New Jersey","Cape May County",5,70,1700,824,876
050,34,009,"New Jersey","Cape May County",5,71,1618,775,843
050,34,009,"New Jersey","Cape May County",5,72,1526,728,798
050,34,009,"New Jersey","Cape May County",5,73,1483,690,793
050,34,009,"New Jersey","Cape May County",5,74,1451,690,761
050,34,009,"New Jersey","Cape May County",5,75,1420,662,758
050,34,009,"New Jersey","Cape May County",5,76,1571,763,808
050,34,009,"New Jersey","Cape May County",5,77,1022,471,551
050,34,009,"New Jersey","Cape May County",5,78,926,429,497
050,34,009,"New Jersey","Cape May County",5,79,936,420,516
050,34,009,"New Jersey","Cape May County",5,80,962,421,541
050,34,009,"New Jersey","Cape May County",5,81,769,347,422
050,34,009,"New Jersey","Cape May County",5,82,654,282,372
050,34,009,"New Jersey","Cape May County",5,83,557,221,336
050,34,009,"New Jersey","Cape May County",5,84,516,222,294
050,34,009,"New Jersey","Cape May County",5,85,2781,1099,1682
050,34,011,"New Jersey","Cumberland County",1,0,1889,960,929
050,34,011,"New Jersey","Cumberland County",1,1,1882,966,916
050,34,011,"New Jersey","Cumberland County",1,2,2004,1033,971
050,34,011,"New Jersey","Cumberland County",1,3,1925,982,943
050,34,011,"New Jersey","Cumberland County",1,4,1974,1014,960
050,34,011,"New Jersey","Cumberland County",1,5,2045,1037,1008
050,34,011,"New Jersey","Cumberland County",1,6,2051,1006,1045
050,34,011,"New Jersey","Cumberland County",1,7,2084,1035,1049
050,34,011,"New Jersey","Cumberland County",1,8,2165,1034,1131
050,34,011,"New Jersey","Cumberland County",1,9,2183,1107,1076
050,34,011,"New Jersey","Cumberland County",1,10,2199,1099,1100
050,34,011,"New Jersey","Cumberland County",1,11,2267,1165,1102
050,34,011,"New Jersey","Cumberland County",1,12,2275,1189,1086
050,34,011,"New Jersey","Cumberland County",1,13,2298,1180,1118
050,34,011,"New Jersey","Cumberland County",1,14,2209,1103,1106
050,34,011,"New Jersey","Cumberland County",1,15,2080,1027,1053
050,34,011,"New Jersey","Cumberland County",1,16,2041,1018,1023
050,34,011,"New Jersey","Cumberland County",1,17,1982,1030,952
050,34,011,"New Jersey","Cumberland County",1,18,1850,962,888
050,34,011,"New Jersey","Cumberland County",1,19,1689,886,803
050,34,011,"New Jersey","Cumberland County",1,20,1727,900,827
050,34,011,"New Jersey","Cumberland County",1,21,1749,922,827
050,34,011,"New Jersey","Cumberland County",1,22,1777,950,827
050,34,011,"New Jersey","Cumberland County",1,23,1836,985,851
050,34,011,"New Jersey","Cumberland County",1,24,1835,954,881
050,34,011,"New Jersey","Cumberland County",1,25,1900,1005,895
050,34,011,"New Jersey","Cumberland County",1,26,2029,1137,892
050,34,011,"New Jersey","Cumberland County",1,27,2124,1184,940
050,34,011,"New Jersey","Cumberland County",1,28,2182,1190,992
050,34,011,"New Jersey","Cumberland County",1,29,2279,1316,963
050,34,011,"New Jersey","Cumberland County",1,30,2349,1380,969
050,34,011,"New Jersey","Cumberland County",1,31,2252,1329,923
050,34,011,"New Jersey","Cumberland County",1,32,2154,1278,876
050,34,011,"New Jersey","Cumberland County",1,33,2076,1224,852
050,34,011,"New Jersey","Cumberland County",1,34,2126,1237,889
050,34,011,"New Jersey","Cumberland County",1,35,2099,1197,902
050,34,011,"New Jersey","Cumberland County",1,36,2039,1137,902
050,34,011,"New Jersey","Cumberland County",1,37,2112,1162,950
050,34,011,"New Jersey","Cumberland County",1,38,2112,1173,939
050,34,011,"New Jersey","Cumberland County",1,39,2132,1196,936
050,34,011,"New Jersey","Cumberland County",1,40,2086,1146,940
050,34,011,"New Jersey","Cumberland County",1,41,2018,1150,868
050,34,011,"New Jersey","Cumberland County",1,42,1907,1036,871
050,34,011,"New Jersey","Cumberland County",1,43,1926,1047,879
050,34,011,"New Jersey","Cumberland County",1,44,1957,1084,873
050,34,011,"New Jersey","Cumberland County",1,45,1943,1061,882
050,34,011,"New Jersey","Cumberland County",1,46,1868,960,908
050,34,011,"New Jersey","Cumberland County",1,47,1916,996,920
050,34,011,"New Jersey","Cumberland County",1,48,2050,1073,977
050,34,011,"New Jersey","Cumberland County",1,49,2164,1133,1031
050,34,011,"New Jersey","Cumberland County",1,50,1964,1027,937
050,34,011,"New Jersey","Cumberland County",1,51,1950,963,987
050,34,011,"New Jersey","Cumberland County",1,52,1933,926,1007
050,34,011,"New Jersey","Cumberland County",1,53,1934,955,979
050,34,011,"New Jersey","Cumberland County",1,54,1975,980,995
050,34,011,"New Jersey","Cumberland County",1,55,2018,986,1032
050,34,011,"New Jersey","Cumberland County",1,56,2016,995,1021
050,34,011,"New Jersey","Cumberland County",1,57,1997,1003,994
050,34,011,"New Jersey","Cumberland County",1,58,2014,1000,1014
050,34,011,"New Jersey","Cumberland County",1,59,1896,948,948
050,34,011,"New Jersey","Cumberland County",1,60,1871,912,959
050,34,011,"New Jersey","Cumberland County",1,61,1862,879,983
050,34,011,"New Jersey","Cumberland County",1,62,1870,911,959
050,34,011,"New Jersey","Cumberland County",1,63,1825,888,937
050,34,011,"New Jersey","Cumberland County",1,64,1793,920,873
050,34,011,"New Jersey","Cumberland County",1,65,1679,834,845
050,34,011,"New Jersey","Cumberland County",1,66,1552,745,807
050,34,011,"New Jersey","Cumberland County",1,67,1505,709,796
050,34,011,"New Jersey","Cumberland County",1,68,1465,654,811
050,34,011,"New Jersey","Cumberland County",1,69,1356,627,729
050,34,011,"New Jersey","Cumberland County",1,70,1348,664,684
050,34,011,"New Jersey","Cumberland County",1,71,1287,606,681
050,34,011,"New Jersey","Cumberland County",1,72,1323,619,704
050,34,011,"New Jersey","Cumberland County",1,73,1320,619,701
050,34,011,"New Jersey","Cumberland County",1,74,967,442,525
050,34,011,"New Jersey","Cumberland County",1,75,952,420,532
050,34,011,"New Jersey","Cumberland County",1,76,909,392,517
050,34,011,"New Jersey","Cumberland County",1,77,920,393,527
050,34,011,"New Jersey","Cumberland County",1,78,781,337,444
050,34,011,"New Jersey","Cumberland County",1,79,660,280,380
050,34,011,"New Jersey","Cumberland County",1,80,605,264,341
050,34,011,"New Jersey","Cumberland County",1,81,585,239,346
050,34,011,"New Jersey","Cumberland County",1,82,562,212,350
050,34,011,"New Jersey","Cumberland County",1,83,504,207,297
050,34,011,"New Jersey","Cumberland County",1,84,453,190,263
050,34,011,"New Jersey","Cumberland County",1,85,2693,973,1720
050,34,011,"New Jersey","Cumberland County",2,0,1836,941,895
050,34,011,"New Jersey","Cumberland County",2,1,1887,967,920
050,34,011,"New Jersey","Cumberland County",2,2,1981,1021,960
050,34,011,"New Jersey","Cumberland County",2,3,1946,997,949
050,34,011,"New Jersey","Cumberland County",2,4,1964,1008,956
050,34,011,"New Jersey","Cumberland County",2,5,2025,1031,994
050,34,011,"New Jersey","Cumberland County",2,6,2048,1010,1038
050,34,011,"New Jersey","Cumberland County",2,7,2070,1022,1048
050,34,011,"New Jersey","Cumberland County",2,8,2131,1029,1102
050,34,011,"New Jersey","Cumberland County",2,9,2174,1088,1086
050,34,011,"New Jersey","Cumberland County",2,10,2195,1103,1092
050,34,011,"New Jersey","Cumberland County",2,11,2233,1142,1091
050,34,011,"New Jersey","Cumberland County",2,12,2278,1188,1090
050,34,011,"New Jersey","Cumberland County",2,13,2284,1178,1106
050,34,011,"New Jersey","Cumberland County",2,14,2226,1120,1106
050,34,011,"New Jersey","Cumberland County",2,15,2107,1042,1065
050,34,011,"New Jersey","Cumberland County",2,16,2048,1018,1030
050,34,011,"New Jersey","Cumberland County",2,17,1996,1026,970
050,34,011,"New Jersey","Cumberland County",2,18,1824,954,870
050,34,011,"New Jersey","Cumberland County",2,19,1686,882,804
050,34,011,"New Jersey","Cumberland County",2,20,1751,910,841
050,34,011,"New Jersey","Cumberland County",2,21,1756,927,829
050,34,011,"New Jersey","Cumberland County",2,22,1787,959,828
050,34,011,"New Jersey","Cumberland County",2,23,1829,982,847
050,34,011,"New Jersey","Cumberland County",2,24,1832,957,875
050,34,011,"New Jersey","Cumberland County",2,25,1885,997,888
050,34,011,"New Jersey","Cumberland County",2,26,2011,1117,894
050,34,011,"New Jersey","Cumberland County",2,27,2099,1174,925
050,34,011,"New Jersey","Cumberland County",2,28,2169,1194,975
050,34,011,"New Jersey","Cumberland County",2,29,2262,1297,965
050,34,011,"New Jersey","Cumberland County",2,30,2343,1371,972
050,34,011,"New Jersey","Cumberland County",2,31,2245,1316,929
050,34,011,"New Jersey","Cumberland County",2,32,2167,1281,886
050,34,011,"New Jersey","Cumberland County",2,33,2079,1227,852
050,34,011,"New Jersey","Cumberland County",2,34,2101,1222,879
050,34,011,"New Jersey","Cumberland County",2,35,2102,1203,899
050,34,011,"New Jersey","Cumberland County",2,36,2033,1138,895
050,34,011,"New Jersey","Cumberland County",2,37,2084,1150,934
050,34,011,"New Jersey","Cumberland County",2,38,2110,1165,945
050,34,011,"New Jersey","Cumberland County",2,39,2123,1190,933
050,34,011,"New Jersey","Cumberland County",2,40,2095,1150,945
050,34,011,"New Jersey","Cumberland County",2,41,2032,1152,880
050,34,011,"New Jersey","Cumberland County",2,42,1902,1039,863
050,34,011,"New Jersey","Cumberland County",2,43,1919,1045,874
050,34,011,"New Jersey","Cumberland County",2,44,1936,1072,864
050,34,011,"New Jersey","Cumberland County",2,45,1945,1061,884
050,34,011,"New Jersey","Cumberland County",2,46,1865,971,894
050,34,011,"New Jersey","Cumberland County",2,47,1882,972,910
050,34,011,"New Jersey","Cumberland County",2,48,2018,1053,965
050,34,011,"New Jersey","Cumberland County",2,49,2137,1119,1018
050,34,011,"New Jersey","Cumberland County",2,50,1997,1036,961
050,34,011,"New Jersey","Cumberland County",2,51,1938,966,972
050,34,011,"New Jersey","Cumberland County",2,52,1918,922,996
050,34,011,"New Jersey","Cumberland County",2,53,1920,939,981
050,34,011,"New Jersey","Cumberland County",2,54,1961,966,995
050,34,011,"New Jersey","Cumberland County",2,55,1993,977,1016
050,34,011,"New Jersey","Cumberland County",2,56,2012,989,1023
050,34,011,"New Jersey","Cumberland County",2,57,1991,992,999
050,34,011,"New Jersey","Cumberland County",2,58,2002,997,1005
050,34,011,"New Jersey","Cumberland County",2,59,1916,958,958
050,34,011,"New Jersey","Cumberland County",2,60,1867,915,952
050,34,011,"New Jersey","Cumberland County",2,61,1846,877,969
050,34,011,"New Jersey","Cumberland County",2,62,1856,897,959
050,34,011,"New Jersey","Cumberland County",2,63,1832,889,943
050,34,011,"New Jersey","Cumberland County",2,64,1785,903,882
050,34,011,"New Jersey","Cumberland County",2,65,1689,847,842
050,34,011,"New Jersey","Cumberland County",2,66,1576,762,814
050,34,011,"New Jersey","Cumberland County",2,67,1498,707,791
050,34,011,"New Jersey","Cumberland County",2,68,1455,658,797
050,34,011,"New Jersey","Cumberland County",2,69,1369,630,739
050,34,011,"New Jersey","Cumberland County",2,70,1337,648,689
050,34,011,"New Jersey","Cumberland County",2,71,1286,616,670
050,34,011,"New Jersey","Cumberland County",2,72,1291,603,688
050,34,011,"New Jersey","Cumberland County",2,73,1361,642,719
050,34,011,"New Jersey","Cumberland County",2,74,981,450,531
050,34,011,"New Jersey","Cumberland County",2,75,958,426,532
050,34,011,"New Jersey","Cumberland County",2,76,902,387,515
050,34,011,"New Jersey","Cumberland County",2,77,924,398,526
050,34,011,"New Jersey","Cumberland County",2,78,792,342,450
050,34,011,"New Jersey","Cumberland County",2,79,672,283,389
050,34,011,"New Jersey","Cumberland County",2,80,609,262,347
050,34,011,"New Jersey","Cumberland County",2,81,576,238,338
050,34,011,"New Jersey","Cumberland County",2,82,557,214,343
050,34,011,"New Jersey","Cumberland County",2,83,500,200,300
050,34,011,"New Jersey","Cumberland County",2,84,445,183,262
050,34,011,"New Jersey","Cumberland County",2,85,2669,970,1699
050,34,011,"New Jersey","Cumberland County",3,0,1759,910,849
050,34,011,"New Jersey","Cumberland County",3,1,1854,944,910
050,34,011,"New Jersey","Cumberland County",3,2,1891,951,940
050,34,011,"New Jersey","Cumberland County",3,3,1978,1022,956
050,34,011,"New Jersey","Cumberland County",3,4,1959,999,960
050,34,011,"New Jersey","Cumberland County",3,5,1969,999,970
050,34,011,"New Jersey","Cumberland County",3,6,2026,1029,997
050,34,011,"New Jersey","Cumberland County",3,7,2060,1023,1037
050,34,011,"New Jersey","Cumberland County",3,8,2057,1011,1046
050,34,011,"New Jersey","Cumberland County",3,9,2117,1026,1091
050,34,011,"New Jersey","Cumberland County",3,10,2191,1101,1090
050,34,011,"New Jersey","Cumberland County",3,11,2215,1119,1096
050,34,011,"New Jersey","Cumberland County",3,12,2185,1121,1064
050,34,011,"New Jersey","Cumberland County",3,13,2281,1191,1090
050,34,011,"New Jersey","Cumberland County",3,14,2277,1168,1109
050,34,011,"New Jersey","Cumberland County",3,15,2218,1118,1100
050,34,011,"New Jersey","Cumberland County",3,16,2129,1061,1068
050,34,011,"New Jersey","Cumberland County",3,17,2027,1003,1024
050,34,011,"New Jersey","Cumberland County",3,18,1795,932,863
050,34,011,"New Jersey","Cumberland County",3,19,1640,843,797
050,34,011,"New Jersey","Cumberland County",3,20,1754,897,857
050,34,011,"New Jersey","Cumberland County",3,21,1824,965,859
050,34,011,"New Jersey","Cumberland County",3,22,1858,986,872
050,34,011,"New Jersey","Cumberland County",3,23,1815,979,836
050,34,011,"New Jersey","Cumberland County",3,24,1845,983,862
050,34,011,"New Jersey","Cumberland County",3,25,1802,958,844
050,34,011,"New Jersey","Cumberland County",3,26,1912,1009,903
050,34,011,"New Jersey","Cumberland County",3,27,2041,1112,929
050,34,011,"New Jersey","Cumberland County",3,28,2079,1149,930
050,34,011,"New Jersey","Cumberland County",3,29,2156,1196,960
050,34,011,"New Jersey","Cumberland County",3,30,2237,1262,975
050,34,011,"New Jersey","Cumberland County",3,31,2247,1287,960
050,34,011,"New Jersey","Cumberland County",3,32,2160,1234,926
050,34,011,"New Jersey","Cumberland County",3,33,2120,1217,903
050,34,011,"New Jersey","Cumberland County",3,34,2020,1167,853
050,34,011,"New Jersey","Cumberland County",3,35,2015,1143,872
050,34,011,"New Jersey","Cumberland County",3,36,2060,1161,899
050,34,011,"New Jersey","Cumberland County",3,37,1983,1085,898
050,34,011,"New Jersey","Cumberland County",3,38,2004,1089,915
050,34,011,"New Jersey","Cumberland County",3,39,2086,1144,942
050,34,011,"New Jersey","Cumberland County",3,40,2017,1076,941
050,34,011,"New Jersey","Cumberland County",3,41,2072,1150,922
050,34,011,"New Jersey","Cumberland County",3,42,1915,1036,879
050,34,011,"New Jersey","Cumberland County",3,43,1855,1012,843
050,34,011,"New Jersey","Cumberland County",3,44,1907,1033,874
050,34,011,"New Jersey","Cumberland County",3,45,1876,1000,876
050,34,011,"New Jersey","Cumberland County",3,46,1888,1009,879
050,34,011,"New Jersey","Cumberland County",3,47,1800,918,882
050,34,011,"New Jersey","Cumberland County",3,48,1852,933,919
050,34,011,"New Jersey","Cumberland County",3,49,1978,1029,949
050,34,011,"New Jersey","Cumberland County",3,50,2073,1046,1027
050,34,011,"New Jersey","Cumberland County",3,51,1969,987,982
050,34,011,"New Jersey","Cumberland County",3,52,1882,914,968
050,34,011,"New Jersey","Cumberland County",3,53,1879,888,991
050,34,011,"New Jersey","Cumberland County",3,54,1892,918,974
050,34,011,"New Jersey","Cumberland County",3,55,1915,943,972
050,34,011,"New Jersey","Cumberland County",3,56,1948,950,998
050,34,011,"New Jersey","Cumberland County",3,57,1992,964,1028
050,34,011,"New Jersey","Cumberland County",3,58,1939,945,994
050,34,011,"New Jersey","Cumberland County",3,59,1959,974,985
050,34,011,"New Jersey","Cumberland County",3,60,1854,903,951
050,34,011,"New Jersey","Cumberland County",3,61,1805,874,931
050,34,011,"New Jersey","Cumberland County",3,62,1805,861,944
050,34,011,"New Jersey","Cumberland County",3,63,1804,871,933
050,34,011,"New Jersey","Cumberland County",3,64,1784,862,922
050,34,011,"New Jersey","Cumberland County",3,65,1723,881,842
050,34,011,"New Jersey","Cumberland County",3,66,1650,823,827
050,34,011,"New Jersey","Cumberland County",3,67,1519,734,785
050,34,011,"New Jersey","Cumberland County",3,68,1460,689,771
050,34,011,"New Jersey","Cumberland County",3,69,1406,631,775
050,34,011,"New Jersey","Cumberland County",3,70,1307,591,716
050,34,011,"New Jersey","Cumberland County",3,71,1289,625,664
050,34,011,"New Jersey","Cumberland County",3,72,1231,576,655
050,34,011,"New Jersey","Cumberland County",3,73,1254,578,676
050,34,011,"New Jersey","Cumberland County",3,74,1282,607,675
050,34,011,"New Jersey","Cumberland County",3,75,949,428,521
050,34,011,"New Jersey","Cumberland County",3,76,909,398,511
050,34,011,"New Jersey","Cumberland County",3,77,847,365,482
050,34,011,"New Jersey","Cumberland County",3,78,878,371,507
050,34,011,"New Jersey","Cumberland County",3,79,747,314,433
050,34,011,"New Jersey","Cumberland County",3,80,628,251,377
050,34,011,"New Jersey","Cumberland County",3,81,579,238,341
050,34,011,"New Jersey","Cumberland County",3,82,539,219,320
050,34,011,"New Jersey","Cumberland County",3,83,501,189,312
050,34,011,"New Jersey","Cumberland County",3,84,461,177,284
050,34,011,"New Jersey","Cumberland County",3,85,2618,966,1652
050,34,011,"New Jersey","Cumberland County",4,0,1819,932,887
050,34,011,"New Jersey","Cumberland County",4,1,1752,910,842
050,34,011,"New Jersey","Cumberland County",4,2,1877,955,922
050,34,011,"New Jersey","Cumberland County",4,3,1890,961,929
050,34,011,"New Jersey","Cumberland County",4,4,2007,1035,972
050,34,011,"New Jersey","Cumberland County",4,5,1949,989,960
050,34,011,"New Jersey","Cumberland County",4,6,1976,993,983
050,34,011,"New Jersey","Cumberland County",4,7,2059,1072,987
050,34,011,"New Jersey","Cumberland County",4,8,2066,1040,1026
050,34,011,"New Jersey","Cumberland County",4,9,2070,1022,1048
050,34,011,"New Jersey","Cumberland County",4,10,2127,1036,1091
050,34,011,"New Jersey","Cumberland County",4,11,2198,1098,1100
050,34,011,"New Jersey","Cumberland County",4,12,2228,1128,1100
050,34,011,"New Jersey","Cumberland County",4,13,2201,1128,1073
050,34,011,"New Jersey","Cumberland County",4,14,2295,1199,1096
050,34,011,"New Jersey","Cumberland County",4,15,2294,1180,1114
050,34,011,"New Jersey","Cumberland County",4,16,2222,1118,1104
050,34,011,"New Jersey","Cumberland County",4,17,2129,1067,1062
050,34,011,"New Jersey","Cumberland County",4,18,1823,922,901
050,34,011,"New Jersey","Cumberland County",4,19,1601,845,756
050,34,011,"New Jersey","Cumberland County",4,20,1687,869,818
050,34,011,"New Jersey","Cumberland County",4,21,1856,959,897
050,34,011,"New Jersey","Cumberland County",4,22,1889,1005,884
050,34,011,"New Jersey","Cumberland County",4,23,1886,1015,871
050,34,011,"New Jersey","Cumberland County",4,24,1802,982,820
050,34,011,"New Jersey","Cumberland County",4,25,1860,1001,859
050,34,011,"New Jersey","Cumberland County",4,26,1820,975,845
050,34,011,"New Jersey","Cumberland County",4,27,1887,996,891
050,34,011,"New Jersey","Cumberland County",4,28,2018,1105,913
050,34,011,"New Jersey","Cumberland County",4,29,2073,1136,937
050,34,011,"New Jersey","Cumberland County",4,30,2166,1189,977
050,34,011,"New Jersey","Cumberland County",4,31,2193,1201,992
050,34,011,"New Jersey","Cumberland County",4,32,2203,1242,961
050,34,011,"New Jersey","Cumberland County",4,33,2116,1190,926
050,34,011,"New Jersey","Cumberland County",4,34,2075,1163,912
050,34,011,"New Jersey","Cumberland County",4,35,1993,1133,860
050,34,011,"New Jersey","Cumberland County",4,36,1978,1112,866
050,34,011,"New Jersey","Cumberland County",4,37,2025,1137,888
050,34,011,"New Jersey","Cumberland County",4,38,1967,1061,906
050,34,011,"New Jersey","Cumberland County",4,39,1999,1085,914
050,34,011,"New Jersey","Cumberland County",4,40,1995,1060,935
050,34,011,"New Jersey","Cumberland County",4,41,2043,1086,957
050,34,011,"New Jersey","Cumberland County",4,42,2014,1062,952
050,34,011,"New Jersey","Cumberland County",4,43,1865,1014,851
050,34,011,"New Jersey","Cumberland County",4,44,1844,1005,839
050,34,011,"New Jersey","Cumberland County",4,45,1866,970,896
050,34,011,"New Jersey","Cumberland County",4,46,1808,947,861
050,34,011,"New Jersey","Cumberland County",4,47,1824,976,848
050,34,011,"New Jersey","Cumberland County",4,48,1792,895,897
050,34,011,"New Jersey","Cumberland County",4,49,1833,927,906
050,34,011,"New Jersey","Cumberland County",4,50,1904,964,940
050,34,011,"New Jersey","Cumberland County",4,51,2050,1027,1023
050,34,011,"New Jersey","Cumberland County",4,52,1937,960,977
050,34,011,"New Jersey","Cumberland County",4,53,1840,874,966
050,34,011,"New Jersey","Cumberland County",4,54,1876,874,1002
050,34,011,"New Jersey","Cumberland County",4,55,1836,884,952
050,34,011,"New Jersey","Cumberland County",4,56,1888,920,968
050,34,011,"New Jersey","Cumberland County",4,57,1952,961,991
050,34,011,"New Jersey","Cumberland County",4,58,1949,930,1019
050,34,011,"New Jersey","Cumberland County",4,59,1922,933,989
050,34,011,"New Jersey","Cumberland County",4,60,1921,951,970
050,34,011,"New Jersey","Cumberland County",4,61,1818,888,930
050,34,011,"New Jersey","Cumberland County",4,62,1793,874,919
050,34,011,"New Jersey","Cumberland County",4,63,1776,849,927
050,34,011,"New Jersey","Cumberland County",4,64,1747,833,914
050,34,011,"New Jersey","Cumberland County",4,65,1746,840,906
050,34,011,"New Jersey","Cumberland County",4,66,1700,866,834
050,34,011,"New Jersey","Cumberland County",4,67,1593,793,800
050,34,011,"New Jersey","Cumberland County",4,68,1481,711,770
050,34,011,"New Jersey","Cumberland County",4,69,1412,665,747
050,34,011,"New Jersey","Cumberland County",4,70,1366,617,749
050,34,011,"New Jersey","Cumberland County",4,71,1267,572,695
050,34,011,"New Jersey","Cumberland County",4,72,1243,592,651
050,34,011,"New Jersey","Cumberland County",4,73,1180,547,633
050,34,011,"New Jersey","Cumberland County",4,74,1177,537,640
050,34,011,"New Jersey","Cumberland County",4,75,1246,579,667
050,34,011,"New Jersey","Cumberland County",4,76,900,394,506
050,34,011,"New Jersey","Cumberland County",4,77,851,373,478
050,34,011,"New Jersey","Cumberland County",4,78,796,342,454
050,34,011,"New Jersey","Cumberland County",4,79,821,344,477
050,34,011,"New Jersey","Cumberland County",4,80,705,288,417
050,34,011,"New Jersey","Cumberland County",4,81,597,229,368
050,34,011,"New Jersey","Cumberland County",4,82,547,218,329
050,34,011,"New Jersey","Cumberland County",4,83,486,197,289
050,34,011,"New Jersey","Cumberland County",4,84,460,167,293
050,34,011,"New Jersey","Cumberland County",4,85,2604,950,1654
050,34,011,"New Jersey","Cumberland County",5,0,1842,943,899
050,34,011,"New Jersey","Cumberland County",5,1,1872,935,937
050,34,011,"New Jersey","Cumberland County",5,2,1775,921,854
050,34,011,"New Jersey","Cumberland County",5,3,1908,969,939
050,34,011,"New Jersey","Cumberland County",5,4,1897,950,947
050,34,011,"New Jersey","Cumberland County",5,5,2009,1023,986
050,34,011,"New Jersey","Cumberland County",5,6,1992,1012,980
050,34,011,"New Jersey","Cumberland County",5,7,2018,1014,1004
050,34,011,"New Jersey","Cumberland County",5,8,2090,1108,982
050,34,011,"New Jersey","Cumberland County",5,9,2067,1036,1031
050,34,011,"New Jersey","Cumberland County",5,10,2105,1035,1070
050,34,011,"New Jersey","Cumberland County",5,11,2125,1034,1091
050,34,011,"New Jersey","Cumberland County",5,12,2187,1109,1078
050,34,011,"New Jersey","Cumberland County",5,13,2243,1134,1109
050,34,011,"New Jersey","Cumberland County",5,14,2198,1119,1079
050,34,011,"New Jersey","Cumberland County",5,15,2272,1176,1096
050,34,011,"New Jersey","Cumberland County",5,16,2295,1191,1104
050,34,011,"New Jersey","Cumberland County",5,17,2215,1123,1092
050,34,011,"New Jersey","Cumberland County",5,18,1886,947,939
050,34,011,"New Jersey","Cumberland County",5,19,1664,854,810
050,34,011,"New Jersey","Cumberland County",5,20,1715,899,816
050,34,011,"New Jersey","Cumberland County",5,21,1826,944,882
050,34,011,"New Jersey","Cumberland County",5,22,1965,1027,938
050,34,011,"New Jersey","Cumberland County",5,23,1946,1053,893
050,34,011,"New Jersey","Cumberland County",5,24,1942,1046,896
050,34,011,"New Jersey","Cumberland County",5,25,1802,985,817
050,34,011,"New Jersey","Cumberland County",5,26,1885,1030,855
050,34,011,"New Jersey","Cumberland County",5,27,1860,1004,856
050,34,011,"New Jersey","Cumberland County",5,28,1943,1038,905
050,34,011,"New Jersey","Cumberland County",5,29,2076,1168,908
050,34,011,"New Jersey","Cumberland County",5,30,2162,1212,950
050,34,011,"New Jersey","Cumberland County",5,31,2191,1217,974
050,34,011,"New Jersey","Cumberland County",5,32,2195,1207,988
050,34,011,"New Jersey","Cumberland County",5,33,2204,1259,945
050,34,011,"New Jersey","Cumberland County",5,34,2133,1198,935
050,34,011,"New Jersey","Cumberland County",5,35,2109,1188,921
050,34,011,"New Jersey","Cumberland County",5,36,2016,1147,869
050,34,011,"New Jersey","Cumberland County",5,37,1995,1130,865
050,34,011,"New Jersey","Cumberland County",5,38,2006,1111,895
050,34,011,"New Jersey","Cumberland County",5,39,1993,1092,901
050,34,011,"New Jersey","Cumberland County",5,40,1956,1040,916
050,34,011,"New Jersey","Cumberland County",5,41,2077,1126,951
050,34,011,"New Jersey","Cumberland County",5,42,1985,1029,956
050,34,011,"New Jersey","Cumberland County",5,43,2012,1069,943
050,34,011,"New Jersey","Cumberland County",5,44,1923,1051,872
050,34,011,"New Jersey","Cumberland County",5,45,1859,1007,852
050,34,011,"New Jersey","Cumberland County",5,46,1880,987,893
050,34,011,"New Jersey","Cumberland County",5,47,1791,941,850
050,34,011,"New Jersey","Cumberland County",5,48,1864,1000,864
050,34,011,"New Jersey","Cumberland County",5,49,1788,895,893
050,34,011,"New Jersey","Cumberland County",5,50,1779,888,891
050,34,011,"New Jersey","Cumberland County",5,51,1905,956,949
050,34,011,"New Jersey","Cumberland County",5,52,2027,998,1029
050,34,011,"New Jersey","Cumberland County",5,53,1890,942,948
050,34,011,"New Jersey","Cumberland County",5,54,1855,875,980
050,34,011,"New Jersey","Cumberland County",5,55,1827,845,982
050,34,011,"New Jersey","Cumberland County",5,56,1831,881,950
050,34,011,"New Jersey","Cumberland County",5,57,1885,925,960
050,34,011,"New Jersey","Cumberland County",5,58,1930,942,988
050,34,011,"New Jersey","Cumberland County",5,59,1929,918,1011
050,34,011,"New Jersey","Cumberland County",5,60,1894,913,981
050,34,011,"New Jersey","Cumberland County",5,61,1861,918,943
050,34,011,"New Jersey","Cumberland County",5,62,1791,883,908
050,34,011,"New Jersey","Cumberland County",5,63,1752,854,898
050,34,011,"New Jersey","Cumberland County",5,64,1721,820,901
050,34,011,"New Jersey","Cumberland County",5,65,1687,802,885
050,34,011,"New Jersey","Cumberland County",5,66,1725,825,900
050,34,011,"New Jersey","Cumberland County",5,67,1651,840,811
050,34,011,"New Jersey","Cumberland County",5,68,1566,777,789
050,34,011,"New Jersey","Cumberland County",5,69,1441,691,750
050,34,011,"New Jersey","Cumberland County",5,70,1368,648,720
050,34,011,"New Jersey","Cumberland County",5,71,1327,594,733
050,34,011,"New Jersey","Cumberland County",5,72,1231,552,679
050,34,011,"New Jersey","Cumberland County",5,73,1198,565,633
050,34,011,"New Jersey","Cumberland County",5,74,1124,515,609
050,34,011,"New Jersey","Cumberland County",5,75,1161,522,639
050,34,011,"New Jersey","Cumberland County",5,76,1196,547,649
050,34,011,"New Jersey","Cumberland County",5,77,843,376,467
050,34,011,"New Jersey","Cumberland County",5,78,803,348,455
050,34,011,"New Jersey","Cumberland County",5,79,761,319,442
050,34,011,"New Jersey","Cumberland County",5,80,771,316,455
050,34,011,"New Jersey","Cumberland County",5,81,673,267,406
050,34,011,"New Jersey","Cumberland County",5,82,576,215,361
050,34,011,"New Jersey","Cumberland County",5,83,502,195,307
050,34,011,"New Jersey","Cumberland County",5,84,450,176,274
050,34,011,"New Jersey","Cumberland County",5,85,2636,950,1686
050,34,013,"New Jersey","Essex County",1,0,10839,5527,5312
050,34,013,"New Jersey","Essex County",1,1,10835,5579,5256
050,34,013,"New Jersey","Essex County",1,2,11385,5824,5561
050,34,013,"New Jersey","Essex County",1,3,11481,5825,5656
050,34,013,"New Jersey","Essex County",1,4,11663,5939,5724
050,34,013,"New Jersey","Essex County",1,5,11432,5869,5563
050,34,013,"New Jersey","Essex County",1,6,11505,5871,5634
050,34,013,"New Jersey","Essex County",1,7,11477,5824,5653
050,34,013,"New Jersey","Essex County",1,8,11505,5956,5549
050,34,013,"New Jersey","Essex County",1,9,11482,5861,5621
050,34,013,"New Jersey","Essex County",1,10,11726,6084,5642
050,34,013,"New Jersey","Essex County",1,11,11910,6114,5796
050,34,013,"New Jersey","Essex County",1,12,12103,6199,5904
050,34,013,"New Jersey","Essex County",1,13,12000,6104,5896
050,34,013,"New Jersey","Essex County",1,14,11406,5720,5686
050,34,013,"New Jersey","Essex County",1,15,11251,5743,5508
050,34,013,"New Jersey","Essex County",1,16,11402,5841,5561
050,34,013,"New Jersey","Essex County",1,17,11254,5728,5526
050,34,013,"New Jersey","Essex County",1,18,11020,5740,5280
050,34,013,"New Jersey","Essex County",1,19,10803,5666,5137
050,34,013,"New Jersey","Essex County",1,20,11018,5578,5440
050,34,013,"New Jersey","Essex County",1,21,11021,5591,5430
050,34,013,"New Jersey","Essex County",1,22,10971,5430,5541
050,34,013,"New Jersey","Essex County",1,23,10928,5447,5481
050,34,013,"New Jersey","Essex County",1,24,10924,5495,5429
050,34,013,"New Jersey","Essex County",1,25,11000,5477,5523
050,34,013,"New Jersey","Essex County",1,26,11462,5675,5787
050,34,013,"New Jersey","Essex County",1,27,11608,5808,5800
050,34,013,"New Jersey","Essex County",1,28,11998,5925,6073
050,34,013,"New Jersey","Essex County",1,29,12125,5960,6165
050,34,013,"New Jersey","Essex County",1,30,12109,5946,6163
050,34,013,"New Jersey","Essex County",1,31,12062,5997,6065
050,34,013,"New Jersey","Essex County",1,32,11791,5817,5974
050,34,013,"New Jersey","Essex County",1,33,11892,5888,6004
050,34,013,"New Jersey","Essex County",1,34,11933,5869,6064
050,34,013,"New Jersey","Essex County",1,35,11806,5804,6002
050,34,013,"New Jersey","Essex County",1,36,11901,5862,6039
050,34,013,"New Jersey","Essex County",1,37,12100,5846,6254
050,34,013,"New Jersey","Essex County",1,38,12193,5853,6340
050,34,013,"New Jersey","Essex County",1,39,12386,6052,6334
050,34,013,"New Jersey","Essex County",1,40,12471,6037,6434
050,34,013,"New Jersey","Essex County",1,41,12049,5859,6190
050,34,013,"New Jersey","Essex County",1,42,12005,5860,6145
050,34,013,"New Jersey","Essex County",1,43,11826,5748,6078
050,34,013,"New Jersey","Essex County",1,44,11704,5726,5978
050,34,013,"New Jersey","Essex County",1,45,11704,5748,5956
050,34,013,"New Jersey","Essex County",1,46,11536,5565,5971
050,34,013,"New Jersey","Essex County",1,47,11576,5673,5903
050,34,013,"New Jersey","Essex County",1,48,11950,5959,5991
050,34,013,"New Jersey","Essex County",1,49,12577,6214,6363
050,34,013,"New Jersey","Essex County",1,50,12204,5966,6238
050,34,013,"New Jersey","Essex County",1,51,11718,5662,6056
050,34,013,"New Jersey","Essex County",1,52,11512,5664,5848
050,34,013,"New Jersey","Essex County",1,53,11616,5626,5990
050,34,013,"New Jersey","Essex County",1,54,11479,5576,5903
050,34,013,"New Jersey","Essex County",1,55,11485,5605,5880
050,34,013,"New Jersey","Essex County",1,56,11417,5583,5834
050,34,013,"New Jersey","Essex County",1,57,11253,5569,5684
050,34,013,"New Jersey","Essex County",1,58,10899,5284,5615
050,34,013,"New Jersey","Essex County",1,59,10983,5315,5668
050,34,013,"New Jersey","Essex County",1,60,10697,5148,5549
050,34,013,"New Jersey","Essex County",1,61,10375,4945,5430
050,34,013,"New Jersey","Essex County",1,62,10085,4760,5325
050,34,013,"New Jersey","Essex County",1,63,9528,4461,5067
050,34,013,"New Jersey","Essex County",1,64,9142,4215,4927
050,34,013,"New Jersey","Essex County",1,65,8889,4062,4827
050,34,013,"New Jersey","Essex County",1,66,8180,3719,4461
050,34,013,"New Jersey","Essex County",1,67,7633,3462,4171
050,34,013,"New Jersey","Essex County",1,68,7354,3331,4023
050,34,013,"New Jersey","Essex County",1,69,7011,3114,3897
050,34,013,"New Jersey","Essex County",1,70,6712,2946,3766
050,34,013,"New Jersey","Essex County",1,71,6285,2753,3532
050,34,013,"New Jersey","Essex County",1,72,6139,2687,3452
050,34,013,"New Jersey","Essex County",1,73,6141,2698,3443
050,34,013,"New Jersey","Essex County",1,74,4736,2002,2734
050,34,013,"New Jersey","Essex County",1,75,4624,1970,2654
050,34,013,"New Jersey","Essex County",1,76,4304,1814,2490
050,34,013,"New Jersey","Essex County",1,77,4253,1795,2458
050,34,013,"New Jersey","Essex County",1,78,3680,1516,2164
050,34,013,"New Jersey","Essex County",1,79,3252,1290,1962
050,34,013,"New Jersey","Essex County",1,80,3070,1223,1847
050,34,013,"New Jersey","Essex County",1,81,2845,1129,1716
050,34,013,"New Jersey","Essex County",1,82,2685,1034,1651
050,34,013,"New Jersey","Essex County",1,83,2458,940,1518
050,34,013,"New Jersey","Essex County",1,84,2203,815,1388
050,34,013,"New Jersey","Essex County",1,85,14816,4738,10078
050,34,013,"New Jersey","Essex County",2,0,10555,5399,5156
050,34,013,"New Jersey","Essex County",2,1,10853,5574,5279
050,34,013,"New Jersey","Essex County",2,2,11272,5780,5492
050,34,013,"New Jersey","Essex County",2,3,11437,5820,5617
050,34,013,"New Jersey","Essex County",2,4,11603,5909,5694
050,34,013,"New Jersey","Essex County",2,5,11487,5884,5603
050,34,013,"New Jersey","Essex County",2,6,11474,5862,5612
050,34,013,"New Jersey","Essex County",2,7,11448,5826,5622
050,34,013,"New Jersey","Essex County",2,8,11443,5893,5550
050,34,013,"New Jersey","Essex County",2,9,11463,5876,5587
050,34,013,"New Jersey","Essex County",2,10,11626,6010,5616
050,34,013,"New Jersey","Essex County",2,11,11795,6062,5733
050,34,013,"New Jersey","Essex County",2,12,12085,6192,5893
050,34,013,"New Jersey","Essex County",2,13,11965,6100,5865
050,34,013,"New Jersey","Essex County",2,14,11492,5781,5711
050,34,013,"New Jersey","Essex County",2,15,11256,5717,5539
050,34,013,"New Jersey","Essex County",2,16,11351,5810,5541
050,34,013,"New Jersey","Essex County",2,17,11246,5734,5512
050,34,013,"New Jersey","Essex County",2,18,11002,5721,5281
050,34,013,"New Jersey","Essex County",2,19,10825,5668,5157
050,34,013,"New Jersey","Essex County",2,20,11106,5636,5470
050,34,013,"New Jersey","Essex County",2,21,10980,5561,5419
050,34,013,"New Jersey","Essex County",2,22,10941,5442,5499
050,34,013,"New Jersey","Essex County",2,23,10902,5420,5482
050,34,013,"New Jersey","Essex County",2,24,10839,5449,5390
050,34,013,"New Jersey","Essex County",2,25,10991,5489,5502
050,34,013,"New Jersey","Essex County",2,26,11350,5635,5715
050,34,013,"New Jersey","Essex County",2,27,11554,5771,5783
050,34,013,"New Jersey","Essex County",2,28,11922,5913,6009
050,34,013,"New Jersey","Essex County",2,29,12060,5938,6122
050,34,013,"New Jersey","Essex County",2,30,12174,5977,6197
050,34,013,"New Jersey","Essex County",2,31,12037,5973,6064
050,34,013,"New Jersey","Essex County",2,32,11807,5835,5972
050,34,013,"New Jersey","Essex County",2,33,11836,5860,5976
050,34,013,"New Jersey","Essex County",2,34,11920,5865,6055
050,34,013,"New Jersey","Essex County",2,35,11922,5871,6051
050,34,013,"New Jersey","Essex County",2,36,11791,5799,5992
050,34,013,"New Jersey","Essex County",2,37,12037,5839,6198
050,34,013,"New Jersey","Essex County",2,38,12212,5883,6329
050,34,013,"New Jersey","Essex County",2,39,12287,5980,6307
050,34,013,"New Jersey","Essex County",2,40,12522,6066,6456
050,34,013,"New Jersey","Essex County",2,41,12140,5905,6235
050,34,013,"New Jersey","Essex County",2,42,11938,5825,6113
050,34,013,"New Jersey","Essex County",2,43,11915,5795,6120
050,34,013,"New Jersey","Essex County",2,44,11607,5666,5941
050,34,013,"New Jersey","Essex County",2,45,11723,5747,5976
050,34,013,"New Jersey","Essex County",2,46,11496,5566,5930
050,34,013,"New Jersey","Essex County",2,47,11525,5622,5903
050,34,013,"New Jersey","Essex County",2,48,11828,5855,5973
050,34,013,"New Jersey","Essex County",2,49,12417,6139,6278
050,34,013,"New Jersey","Essex County",2,50,12257,6006,6251
050,34,013,"New Jersey","Essex County",2,51,11692,5658,6034
050,34,013,"New Jersey","Essex County",2,52,11537,5662,5875
050,34,013,"New Jersey","Essex County",2,53,11509,5588,5921
050,34,013,"New Jersey","Essex County",2,54,11424,5535,5889
050,34,013,"New Jersey","Essex County",2,55,11437,5568,5869
050,34,013,"New Jersey","Essex County",2,56,11390,5564,5826
050,34,013,"New Jersey","Essex County",2,57,11199,5515,5684
050,34,013,"New Jersey","Essex County",2,58,10919,5312,5607
050,34,013,"New Jersey","Essex County",2,59,10887,5272,5615
050,34,013,"New Jersey","Essex County",2,60,10704,5147,5557
050,34,013,"New Jersey","Essex County",2,61,10348,4936,5412
050,34,013,"New Jersey","Essex County",2,62,10005,4721,5284
050,34,013,"New Jersey","Essex County",2,63,9630,4507,5123
050,34,013,"New Jersey","Essex County",2,64,9082,4191,4891
050,34,013,"New Jersey","Essex County",2,65,8847,4040,4807
050,34,013,"New Jersey","Essex County",2,66,8266,3747,4519
050,34,013,"New Jersey","Essex County",2,67,7644,3452,4192
050,34,013,"New Jersey","Essex County",2,68,7271,3292,3979
050,34,013,"New Jersey","Essex County",2,69,7035,3129,3906
050,34,013,"New Jersey","Essex County",2,70,6673,2921,3752
050,34,013,"New Jersey","Essex County",2,71,6281,2751,3530
050,34,013,"New Jersey","Essex County",2,72,6011,2612,3399
050,34,013,"New Jersey","Essex County",2,73,6241,2726,3515
050,34,013,"New Jersey","Essex County",2,74,4764,2018,2746
050,34,013,"New Jersey","Essex County",2,75,4561,1931,2630
050,34,013,"New Jersey","Essex County",2,76,4277,1804,2473
050,34,013,"New Jersey","Essex County",2,77,4246,1787,2459
050,34,013,"New Jersey","Essex County",2,78,3660,1514,2146
050,34,013,"New Jersey","Essex County",2,79,3285,1297,1988
050,34,013,"New Jersey","Essex County",2,80,3038,1201,1837
050,34,013,"New Jersey","Essex County",2,81,2802,1110,1692
050,34,013,"New Jersey","Essex County",2,82,2657,1019,1638
050,34,013,"New Jersey","Essex County",2,83,2426,922,1504
050,34,013,"New Jersey","Essex County",2,84,2182,807,1375
050,34,013,"New Jersey","Essex County",2,85,14330,4574,9756
050,34,013,"New Jersey","Essex County",3,0,9425,4736,4689
050,34,013,"New Jersey","Essex County",3,1,10634,5399,5235
050,34,013,"New Jersey","Essex County",3,2,10919,5647,5272
050,34,013,"New Jersey","Essex County",3,3,11224,5689,5535
050,34,013,"New Jersey","Essex County",3,4,11300,5756,5544
050,34,013,"New Jersey","Essex County",3,5,11454,5825,5629
050,34,013,"New Jersey","Essex County",3,6,11362,5796,5566
050,34,013,"New Jersey","Essex County",3,7,11344,5788,5556
050,34,013,"New Jersey","Essex County",3,8,11309,5772,5537
050,34,013,"New Jersey","Essex County",3,9,11279,5785,5494
050,34,013,"New Jersey","Essex County",3,10,11352,5806,5546
050,34,013,"New Jersey","Essex County",3,11,11436,5927,5509
050,34,013,"New Jersey","Essex County",3,12,11664,6014,5650
050,34,013,"New Jersey","Essex County",3,13,11878,6066,5812
050,34,013,"New Jersey","Essex County",3,14,11825,6025,5800
050,34,013,"New Jersey","Essex County",3,15,11359,5730,5629
050,34,013,"New Jersey","Essex County",3,16,11064,5627,5437
050,34,013,"New Jersey","Essex County",3,17,11244,5751,5493
050,34,013,"New Jersey","Essex County",3,18,11120,5775,5345
050,34,013,"New Jersey","Essex County",3,19,10686,5607,5079
050,34,013,"New Jersey","Essex County",3,20,11062,5627,5435
050,34,013,"New Jersey","Essex County",3,21,11022,5587,5435
050,34,013,"New Jersey","Essex County",3,22,10703,5380,5323
050,34,013,"New Jersey","Essex County",3,23,10603,5271,5332
050,34,013,"New Jersey","Essex County",3,24,10637,5290,5347
050,34,013,"New Jersey","Essex County",3,25,10683,5358,5325
050,34,013,"New Jersey","Essex County",3,26,10804,5375,5429
050,34,013,"New Jersey","Essex County",3,27,11193,5528,5665
050,34,013,"New Jersey","Essex County",3,28,11466,5757,5709
050,34,013,"New Jersey","Essex County",3,29,11625,5735,5890
050,34,013,"New Jersey","Essex County",3,30,11993,5903,6090
050,34,013,"New Jersey","Essex County",3,31,12155,5920,6235
050,34,013,"New Jersey","Essex County",3,32,12074,5985,6089
050,34,013,"New Jersey","Essex County",3,33,11902,5834,6068
050,34,013,"New Jersey","Essex County",3,34,11920,5859,6061
050,34,013,"New Jersey","Essex County",3,35,12006,5951,6055
050,34,013,"New Jersey","Essex County",3,36,11935,5842,6093
050,34,013,"New Jersey","Essex County",3,37,11878,5868,6010
050,34,013,"New Jersey","Essex County",3,38,12098,5890,6208
050,34,013,"New Jersey","Essex County",3,39,12298,5920,6378
050,34,013,"New Jersey","Essex County",3,40,12231,5925,6306
050,34,013,"New Jersey","Essex County",3,41,12390,6014,6376
050,34,013,"New Jersey","Essex County",3,42,12011,5831,6180
050,34,013,"New Jersey","Essex County",3,43,11828,5810,6018
050,34,013,"New Jersey","Essex County",3,44,11826,5713,6113
050,34,013,"New Jersey","Essex County",3,45,11463,5599,5864
050,34,013,"New Jersey","Essex County",3,46,11548,5682,5866
050,34,013,"New Jersey","Essex County",3,47,11331,5447,5884
050,34,013,"New Jersey","Essex County",3,48,11382,5533,5849
050,34,013,"New Jersey","Essex County",3,49,11632,5756,5876
050,34,013,"New Jersey","Essex County",3,50,12216,6024,6192
050,34,013,"New Jersey","Essex County",3,51,12012,5857,6155
050,34,013,"New Jersey","Essex County",3,52,11510,5568,5942
050,34,013,"New Jersey","Essex County",3,53,11388,5587,5801
050,34,013,"New Jersey","Essex County",3,54,11226,5417,5809
050,34,013,"New Jersey","Essex County",3,55,11200,5393,5807
050,34,013,"New Jersey","Essex County",3,56,11139,5425,5714
050,34,013,"New Jersey","Essex County",3,57,11061,5375,5686
050,34,013,"New Jersey","Essex County",3,58,10894,5345,5549
050,34,013,"New Jersey","Essex County",3,59,10690,5230,5460
050,34,013,"New Jersey","Essex County",3,60,10545,5073,5472
050,34,013,"New Jersey","Essex County",3,61,10447,5004,5443
050,34,013,"New Jersey","Essex County",3,62,10040,4752,5288
050,34,013,"New Jersey","Essex County",3,63,9603,4508,5095
050,34,013,"New Jersey","Essex County",3,64,9340,4392,4948
050,34,013,"New Jersey","Essex County",3,65,8779,4055,4724
050,34,013,"New Jersey","Essex County",3,66,8545,3888,4657
050,34,013,"New Jersey","Essex County",3,67,8024,3608,4416
050,34,013,"New Jersey","Essex County",3,68,7365,3285,4080
050,34,013,"New Jersey","Essex County",3,69,7038,3160,3878
050,34,013,"New Jersey","Essex County",3,70,6785,2995,3790
050,34,013,"New Jersey","Essex County",3,71,6474,2819,3655
050,34,013,"New Jersey","Essex County",3,72,6054,2629,3425
050,34,013,"New Jersey","Essex County",3,73,5837,2537,3300
050,34,013,"New Jersey","Essex County",3,74,6036,2622,3414
050,34,013,"New Jersey","Essex County",3,75,4620,1934,2686
050,34,013,"New Jersey","Essex County",3,76,4375,1851,2524
050,34,013,"New Jersey","Essex County",3,77,4107,1708,2399
050,34,013,"New Jersey","Essex County",3,78,4012,1686,2326
050,34,013,"New Jersey","Essex County",3,79,3495,1422,2073
050,34,013,"New Jersey","Essex County",3,80,3088,1219,1869
050,34,013,"New Jersey","Essex County",3,81,2867,1123,1744
050,34,013,"New Jersey","Essex County",3,82,2630,1018,1612
050,34,013,"New Jersey","Essex County",3,83,2460,939,1521
050,34,013,"New Jersey","Essex County",3,84,2272,848,1424
050,34,013,"New Jersey","Essex County",3,85,14482,4661,9821
050,34,013,"New Jersey","Essex County",4,0,10026,5099,4927
050,34,013,"New Jersey","Essex County",4,1,9472,4804,4668
050,34,013,"New Jersey","Essex County",4,2,10665,5417,5248
050,34,013,"New Jersey","Essex County",4,3,10892,5638,5254
050,34,013,"New Jersey","Essex County",4,4,11195,5719,5476
050,34,013,"New Jersey","Essex County",4,5,11109,5656,5453
050,34,013,"New Jersey","Essex County",4,6,11424,5841,5583
050,34,013,"New Jersey","Essex County",4,7,11304,5763,5541
050,34,013,"New Jersey","Essex County",4,8,11254,5755,5499
050,34,013,"New Jersey","Essex County",4,9,11211,5716,5495
050,34,013,"New Jersey","Essex County",4,10,11246,5771,5475
050,34,013,"New Jersey","Essex County",4,11,11223,5700,5523
050,34,013,"New Jersey","Essex County",4,12,11376,5919,5457
050,34,013,"New Jersey","Essex County",4,13,11555,5939,5616
050,34,013,"New Jersey","Essex County",4,14,11779,6038,5741
050,34,013,"New Jersey","Essex County",4,15,11753,6010,5743
050,34,013,"New Jersey","Essex County",4,16,11235,5701,5534
050,34,013,"New Jersey","Essex County",4,17,11023,5601,5422
050,34,013,"New Jersey","Essex County",4,18,11051,5779,5272
050,34,013,"New Jersey","Essex County",4,19,10669,5603,5066
050,34,013,"New Jersey","Essex County",4,20,10760,5478,5282
050,34,013,"New Jersey","Essex County",4,21,10879,5526,5353
050,34,013,"New Jersey","Essex County",4,22,10703,5433,5270
050,34,013,"New Jersey","Essex County",4,23,10418,5189,5229
050,34,013,"New Jersey","Essex County",4,24,10351,5134,5217
050,34,013,"New Jersey","Essex County",4,25,10526,5230,5296
050,34,013,"New Jersey","Essex County",4,26,10627,5285,5342
050,34,013,"New Jersey","Essex County",4,27,10722,5333,5389
050,34,013,"New Jersey","Essex County",4,28,10917,5425,5492
050,34,013,"New Jersey","Essex County",4,29,11295,5609,5686
050,34,013,"New Jersey","Essex County",4,30,11697,5743,5954
050,34,013,"New Jersey","Essex County",4,31,12003,5908,6095
050,34,013,"New Jersey","Essex County",4,32,12250,5977,6273
050,34,013,"New Jersey","Essex County",4,33,12187,6016,6171
050,34,013,"New Jersey","Essex County",4,34,11981,5889,6092
050,34,013,"New Jersey","Essex County",4,35,11888,5919,5969
050,34,013,"New Jersey","Essex County",4,36,11969,5915,6054
050,34,013,"New Jersey","Essex County",4,37,11906,5803,6103
050,34,013,"New Jersey","Essex County",4,38,12040,5941,6099
050,34,013,"New Jersey","Essex County",4,39,12258,6030,6228
050,34,013,"New Jersey","Essex County",4,40,12160,5805,6355
050,34,013,"New Jersey","Essex County",4,41,12190,5944,6246
050,34,013,"New Jersey","Essex County",4,42,12355,5997,6358
050,34,013,"New Jersey","Essex County",4,43,11928,5833,6095
050,34,013,"New Jersey","Essex County",4,44,11741,5783,5958
050,34,013,"New Jersey","Essex County",4,45,11766,5722,6044
050,34,013,"New Jersey","Essex County",4,46,11367,5560,5807
050,34,013,"New Jersey","Essex County",4,47,11447,5676,5771
050,34,013,"New Jersey","Essex County",4,48,11197,5353,5844
050,34,013,"New Jersey","Essex County",4,49,11190,5454,5736
050,34,013,"New Jersey","Essex County",4,50,11502,5682,5820
050,34,013,"New Jersey","Essex County",4,51,11888,5825,6063
050,34,013,"New Jersey","Essex County",4,52,11869,5820,6049
050,34,013,"New Jersey","Essex County",4,53,11397,5509,5888
050,34,013,"New Jersey","Essex County",4,54,11177,5472,5705
050,34,013,"New Jersey","Essex County",4,55,11053,5337,5716
050,34,013,"New Jersey","Essex County",4,56,10917,5277,5640
050,34,013,"New Jersey","Essex County",4,57,10859,5255,5604
050,34,013,"New Jersey","Essex County",4,58,10715,5164,5551
050,34,013,"New Jersey","Essex County",4,59,10508,5178,5330
050,34,013,"New Jersey","Essex County",4,60,10438,5080,5358
050,34,013,"New Jersey","Essex County",4,61,10292,4913,5379
050,34,013,"New Jersey","Essex County",4,62,10085,4813,5272
050,34,013,"New Jersey","Essex County",4,63,9703,4592,5111
050,34,013,"New Jersey","Essex County",4,64,9303,4355,4948
050,34,013,"New Jersey","Essex County",4,65,8978,4216,4762
050,34,013,"New Jersey","Essex County",4,66,8476,3906,4570
050,34,013,"New Jersey","Essex County",4,67,8206,3713,4493
050,34,013,"New Jersey","Essex County",4,68,7690,3447,4243
050,34,013,"New Jersey","Essex County",4,69,7055,3114,3941
050,34,013,"New Jersey","Essex County",4,70,6744,2993,3751
050,34,013,"New Jersey","Essex County",4,71,6550,2894,3656
050,34,013,"New Jersey","Essex County",4,72,6245,2697,3548
050,34,013,"New Jersey","Essex County",4,73,5871,2544,3327
050,34,013,"New Jersey","Essex County",4,74,5658,2448,3210
050,34,013,"New Jersey","Essex County",4,75,5811,2507,3304
050,34,013,"New Jersey","Essex County",4,76,4445,1849,2596
050,34,013,"New Jersey","Essex County",4,77,4168,1761,2407
050,34,013,"New Jersey","Essex County",4,78,3889,1617,2272
050,34,013,"New Jersey","Essex County",4,79,3837,1581,2256
050,34,013,"New Jersey","Essex County",4,80,3296,1335,1961
050,34,013,"New Jersey","Essex County",4,81,2920,1142,1778
050,34,013,"New Jersey","Essex County",4,82,2707,1039,1668
050,34,013,"New Jersey","Essex County",4,83,2452,941,1511
050,34,013,"New Jersey","Essex County",4,84,2260,856,1404
050,34,013,"New Jersey","Essex County",4,85,14580,4758,9822
050,34,013,"New Jersey","Essex County",5,0,10037,5114,4923
050,34,013,"New Jersey","Essex County",5,1,10293,5235,5058
050,34,013,"New Jersey","Essex County",5,2,9735,4952,4783
050,34,013,"New Jersey","Essex County",5,3,10713,5400,5313
050,34,013,"New Jersey","Essex County",5,4,10962,5635,5327
050,34,013,"New Jersey","Essex County",5,5,11225,5711,5514
050,34,013,"New Jersey","Essex County",5,6,11102,5675,5427
050,34,013,"New Jersey","Essex County",5,7,11374,5812,5562
050,34,013,"New Jersey","Essex County",5,8,11254,5714,5540
050,34,013,"New Jersey","Essex County",5,9,11161,5695,5466
050,34,013,"New Jersey","Essex County",5,10,11209,5718,5491
050,34,013,"New Jersey","Essex County",5,11,11205,5718,5487
050,34,013,"New Jersey","Essex County",5,12,11188,5677,5511
050,34,013,"New Jersey","Essex County",5,13,11351,5858,5493
050,34,013,"New Jersey","Essex County",5,14,11472,5910,5562
050,34,013,"New Jersey","Essex County",5,15,11744,6005,5739
050,34,013,"New Jersey","Essex County",5,16,11664,5951,5713
050,34,013,"New Jersey","Essex County",5,17,11164,5671,5493
050,34,013,"New Jersey","Essex County",5,18,10945,5690,5255
050,34,013,"New Jersey","Essex County",5,19,10801,5692,5109
050,34,013,"New Jersey","Essex County",5,20,10973,5658,5315
050,34,013,"New Jersey","Essex County",5,21,10800,5506,5294
050,34,013,"New Jersey","Essex County",5,22,10823,5458,5365
050,34,013,"New Jersey","Essex County",5,23,10577,5361,5216
050,34,013,"New Jersey","Essex County",5,24,10342,5108,5234
050,34,013,"New Jersey","Essex County",5,25,10305,5085,5220
050,34,013,"New Jersey","Essex County",5,26,10478,5176,5302
050,34,013,"New Jersey","Essex County",5,27,10640,5272,5368
050,34,013,"New Jersey","Essex County",5,28,10584,5270,5314
050,34,013,"New Jersey","Essex County",5,29,10938,5394,5544
050,34,013,"New Jersey","Essex County",5,30,11233,5526,5707
050,34,013,"New Jersey","Essex County",5,31,11856,5851,6005
050,34,013,"New Jersey","Essex County",5,32,12153,5939,6214
050,34,013,"New Jersey","Essex County",5,33,12325,6033,6292
050,34,013,"New Jersey","Essex County",5,34,12318,6042,6276
050,34,013,"New Jersey","Essex County",5,35,12123,6045,6078
050,34,013,"New Jersey","Essex County",5,36,11848,5876,5972
050,34,013,"New Jersey","Essex County",5,37,12077,5927,6150
050,34,013,"New Jersey","Essex County",5,38,12139,5980,6159
050,34,013,"New Jersey","Essex County",5,39,12225,6093,6132
050,34,013,"New Jersey","Essex County",5,40,12167,5966,6201
050,34,013,"New Jersey","Essex County",5,41,12214,5889,6325
050,34,013,"New Jersey","Essex County",5,42,12252,5959,6293
050,34,013,"New Jersey","Essex County",5,43,12401,6003,6398
050,34,013,"New Jersey","Essex County",5,44,11816,5736,6080
050,34,013,"New Jersey","Essex County",5,45,11721,5760,5961
050,34,013,"New Jersey","Essex County",5,46,11753,5750,6003
050,34,013,"New Jersey","Essex County",5,47,11293,5512,5781
050,34,013,"New Jersey","Essex County",5,48,11372,5600,5772
050,34,013,"New Jersey","Essex County",5,49,10997,5233,5764
050,34,013,"New Jersey","Essex County",5,50,11147,5448,5699
050,34,013,"New Jersey","Essex County",5,51,11319,5589,5730
050,34,013,"New Jersey","Essex County",5,52,11788,5791,5997
050,34,013,"New Jersey","Essex County",5,53,11790,5782,6008
050,34,013,"New Jersey","Essex County",5,54,11119,5354,5765
050,34,013,"New Jersey","Essex County",5,55,10988,5391,5597
050,34,013,"New Jersey","Essex County",5,56,10867,5248,5619
050,34,013,"New Jersey","Essex County",5,57,10737,5179,5558
050,34,013,"New Jersey","Essex County",5,58,10646,5094,5552
050,34,013,"New Jersey","Essex County",5,59,10513,5069,5444
050,34,013,"New Jersey","Essex County",5,60,10303,5061,5242
050,34,013,"New Jersey","Essex County",5,61,10205,4975,5230
050,34,013,"New Jersey","Essex County",5,62,10067,4802,5265
050,34,013,"New Jersey","Essex County",5,63,9761,4653,5108
050,34,013,"New Jersey","Essex County",5,64,9369,4399,4970
050,34,013,"New Jersey","Essex County",5,65,9071,4253,4818
050,34,013,"New Jersey","Essex County",5,66,8732,4103,4629
050,34,013,"New Jersey","Essex County",5,67,8203,3770,4433
050,34,013,"New Jersey","Essex County",5,68,7938,3572,4366
050,34,013,"New Jersey","Essex County",5,69,7459,3323,4136
050,34,013,"New Jersey","Essex County",5,70,6823,3002,3821
050,34,013,"New Jersey","Essex County",5,71,6540,2888,3652
050,34,013,"New Jersey","Essex County",5,72,6358,2794,3564
050,34,013,"New Jersey","Essex County",5,73,6060,2602,3458
050,34,013,"New Jersey","Essex County",5,74,5696,2455,3241
050,34,013,"New Jersey","Essex County",5,75,5470,2338,3132
050,34,013,"New Jersey","Essex County",5,76,5581,2403,3178
050,34,013,"New Jersey","Essex County",5,77,4297,1766,2531
050,34,013,"New Jersey","Essex County",5,78,3985,1682,2303
050,34,013,"New Jersey","Essex County",5,79,3760,1532,2228
050,34,013,"New Jersey","Essex County",5,80,3649,1515,2134
050,34,013,"New Jersey","Essex County",5,81,3134,1266,1868
050,34,013,"New Jersey","Essex County",5,82,2763,1058,1705
050,34,013,"New Jersey","Essex County",5,83,2515,965,1550
050,34,013,"New Jersey","Essex County",5,84,2283,870,1413
050,34,013,"New Jersey","Essex County",5,85,14839,4944,9895
050,34,015,"New Jersey","Gloucester County",1,0,2742,1396,1346
050,34,015,"New Jersey","Gloucester County",1,1,2886,1491,1395
050,34,015,"New Jersey","Gloucester County",1,2,3141,1592,1549
050,34,015,"New Jersey","Gloucester County",1,3,3209,1636,1573
050,34,015,"New Jersey","Gloucester County",1,4,3218,1647,1571
050,34,015,"New Jersey","Gloucester County",1,5,3339,1725,1614
050,34,015,"New Jersey","Gloucester County",1,6,3411,1736,1675
050,34,015,"New Jersey","Gloucester County",1,7,3460,1805,1655
050,34,015,"New Jersey","Gloucester County",1,8,3600,1863,1737
050,34,015,"New Jersey","Gloucester County",1,9,3707,1863,1844
050,34,015,"New Jersey","Gloucester County",1,10,3829,1971,1858
050,34,015,"New Jersey","Gloucester County",1,11,3987,2012,1975
050,34,015,"New Jersey","Gloucester County",1,12,4121,2074,2047
050,34,015,"New Jersey","Gloucester County",1,13,4129,2089,2040
050,34,015,"New Jersey","Gloucester County",1,14,4094,2112,1982
050,34,015,"New Jersey","Gloucester County",1,15,4056,2108,1948
050,34,015,"New Jersey","Gloucester County",1,16,4232,2147,2085
050,34,015,"New Jersey","Gloucester County",1,17,4083,2107,1976
050,34,015,"New Jersey","Gloucester County",1,18,3875,2032,1843
050,34,015,"New Jersey","Gloucester County",1,19,4431,2286,2145
050,34,015,"New Jersey","Gloucester County",1,20,4726,2455,2271
050,34,015,"New Jersey","Gloucester County",1,21,4683,2400,2283
050,34,015,"New Jersey","Gloucester County",1,22,4331,2179,2152
050,34,015,"New Jersey","Gloucester County",1,23,3836,1928,1908
050,34,015,"New Jersey","Gloucester County",1,24,3690,1872,1818
050,34,015,"New Jersey","Gloucester County",1,25,3632,1849,1783
050,34,015,"New Jersey","Gloucester County",1,26,3703,1914,1789
050,34,015,"New Jersey","Gloucester County",1,27,3711,1914,1797
050,34,015,"New Jersey","Gloucester County",1,28,3734,1877,1857
050,34,015,"New Jersey","Gloucester County",1,29,3722,1848,1874
050,34,015,"New Jersey","Gloucester County",1,30,3690,1853,1837
050,34,015,"New Jersey","Gloucester County",1,31,3721,1894,1827
050,34,015,"New Jersey","Gloucester County",1,32,3623,1808,1815
050,34,015,"New Jersey","Gloucester County",1,33,3661,1863,1798
050,34,015,"New Jersey","Gloucester County",1,34,3777,1868,1909
050,34,015,"New Jersey","Gloucester County",1,35,3708,1813,1895
050,34,015,"New Jersey","Gloucester County",1,36,3744,1835,1909
050,34,015,"New Jersey","Gloucester County",1,37,3857,1835,2022
050,34,015,"New Jersey","Gloucester County",1,38,3842,1837,2005
050,34,015,"New Jersey","Gloucester County",1,39,3821,1870,1951
050,34,015,"New Jersey","Gloucester County",1,40,3828,1842,1986
050,34,015,"New Jersey","Gloucester County",1,41,3872,1889,1983
050,34,015,"New Jersey","Gloucester County",1,42,3789,1869,1920
050,34,015,"New Jersey","Gloucester County",1,43,3670,1728,1942
050,34,015,"New Jersey","Gloucester County",1,44,3668,1754,1914
050,34,015,"New Jersey","Gloucester County",1,45,3723,1790,1933
050,34,015,"New Jersey","Gloucester County",1,46,3633,1766,1867
050,34,015,"New Jersey","Gloucester County",1,47,3777,1828,1949
050,34,015,"New Jersey","Gloucester County",1,48,4114,1975,2139
050,34,015,"New Jersey","Gloucester County",1,49,4453,2167,2286
050,34,015,"New Jersey","Gloucester County",1,50,4343,2080,2263
050,34,015,"New Jersey","Gloucester County",1,51,4280,2038,2242
050,34,015,"New Jersey","Gloucester County",1,52,4099,1983,2116
050,34,015,"New Jersey","Gloucester County",1,53,4258,2105,2153
050,34,015,"New Jersey","Gloucester County",1,54,4334,2148,2186
050,34,015,"New Jersey","Gloucester County",1,55,4478,2204,2274
050,34,015,"New Jersey","Gloucester County",1,56,4541,2256,2285
050,34,015,"New Jersey","Gloucester County",1,57,4549,2213,2336
050,34,015,"New Jersey","Gloucester County",1,58,4589,2272,2317
050,34,015,"New Jersey","Gloucester County",1,59,4420,2215,2205
050,34,015,"New Jersey","Gloucester County",1,60,4313,2142,2171
050,34,015,"New Jersey","Gloucester County",1,61,4322,2113,2209
050,34,015,"New Jersey","Gloucester County",1,62,4274,2014,2260
050,34,015,"New Jersey","Gloucester County",1,63,4024,1915,2109
050,34,015,"New Jersey","Gloucester County",1,64,3818,1842,1976
050,34,015,"New Jersey","Gloucester County",1,65,3599,1735,1864
050,34,015,"New Jersey","Gloucester County",1,66,3436,1638,1798
050,34,015,"New Jersey","Gloucester County",1,67,3287,1524,1763
050,34,015,"New Jersey","Gloucester County",1,68,3207,1486,1721
050,34,015,"New Jersey","Gloucester County",1,69,2964,1381,1583
050,34,015,"New Jersey","Gloucester County",1,70,2850,1342,1508
050,34,015,"New Jersey","Gloucester County",1,71,2784,1259,1525
050,34,015,"New Jersey","Gloucester County",1,72,2821,1285,1536
050,34,015,"New Jersey","Gloucester County",1,73,2769,1280,1489
050,34,015,"New Jersey","Gloucester County",1,74,1905,867,1038
050,34,015,"New Jersey","Gloucester County",1,75,1876,833,1043
050,34,015,"New Jersey","Gloucester County",1,76,1909,900,1009
050,34,015,"New Jersey","Gloucester County",1,77,1892,844,1048
050,34,015,"New Jersey","Gloucester County",1,78,1553,688,865
050,34,015,"New Jersey","Gloucester County",1,79,1349,573,776
050,34,015,"New Jersey","Gloucester County",1,80,1171,492,679
050,34,015,"New Jersey","Gloucester County",1,81,1130,482,648
050,34,015,"New Jersey","Gloucester County",1,82,1018,418,600
050,34,015,"New Jersey","Gloucester County",1,83,885,353,532
050,34,015,"New Jersey","Gloucester County",1,84,819,332,487
050,34,015,"New Jersey","Gloucester County",1,85,5118,1697,3421
050,34,015,"New Jersey","Gloucester County",2,0,2754,1425,1329
050,34,015,"New Jersey","Gloucester County",2,1,2873,1476,1397
050,34,015,"New Jersey","Gloucester County",2,2,3096,1571,1525
050,34,015,"New Jersey","Gloucester County",2,3,3193,1627,1566
050,34,015,"New Jersey","Gloucester County",2,4,3241,1660,1581
050,34,015,"New Jersey","Gloucester County",2,5,3330,1717,1613
050,34,015,"New Jersey","Gloucester County",2,6,3419,1751,1668
050,34,015,"New Jersey","Gloucester County",2,7,3466,1799,1667
050,34,015,"New Jersey","Gloucester County",2,8,3568,1848,1720
050,34,015,"New Jersey","Gloucester County",2,9,3691,1875,1816
050,34,015,"New Jersey","Gloucester County",2,10,3815,1952,1863
050,34,015,"New Jersey","Gloucester County",2,11,3942,1997,1945
050,34,015,"New Jersey","Gloucester County",2,12,4112,2069,2043
050,34,015,"New Jersey","Gloucester County",2,13,4134,2087,2047
050,34,015,"New Jersey","Gloucester County",2,14,4109,2110,1999
050,34,015,"New Jersey","Gloucester County",2,15,4077,2113,1964
050,34,015,"New Jersey","Gloucester County",2,16,4205,2149,2056
050,34,015,"New Jersey","Gloucester County",2,17,4124,2120,2004
050,34,015,"New Jersey","Gloucester County",2,18,3859,2030,1829
050,34,015,"New Jersey","Gloucester County",2,19,4427,2274,2153
050,34,015,"New Jersey","Gloucester County",2,20,4777,2480,2297
050,34,015,"New Jersey","Gloucester County",2,21,4687,2403,2284
050,34,015,"New Jersey","Gloucester County",2,22,4324,2178,2146
050,34,015,"New Jersey","Gloucester County",2,23,3866,1947,1919
050,34,015,"New Jersey","Gloucester County",2,24,3691,1873,1818
050,34,015,"New Jersey","Gloucester County",2,25,3643,1855,1788
050,34,015,"New Jersey","Gloucester County",2,26,3697,1905,1792
050,34,015,"New Jersey","Gloucester County",2,27,3723,1919,1804
050,34,015,"New Jersey","Gloucester County",2,28,3758,1894,1864
050,34,015,"New Jersey","Gloucester County",2,29,3739,1865,1874
050,34,015,"New Jersey","Gloucester County",2,30,3741,1870,1871
050,34,015,"New Jersey","Gloucester County",2,31,3726,1882,1844
050,34,015,"New Jersey","Gloucester County",2,32,3660,1835,1825
050,34,015,"New Jersey","Gloucester County",2,33,3678,1869,1809
050,34,015,"New Jersey","Gloucester County",2,34,3769,1881,1888
050,34,015,"New Jersey","Gloucester County",2,35,3769,1852,1917
050,34,015,"New Jersey","Gloucester County",2,36,3728,1829,1899
050,34,015,"New Jersey","Gloucester County",2,37,3850,1844,2006
050,34,015,"New Jersey","Gloucester County",2,38,3874,1848,2026
050,34,015,"New Jersey","Gloucester County",2,39,3814,1854,1960
050,34,015,"New Jersey","Gloucester County",2,40,3859,1864,1995
050,34,015,"New Jersey","Gloucester County",2,41,3866,1883,1983
050,34,015,"New Jersey","Gloucester County",2,42,3802,1873,1929
050,34,015,"New Jersey","Gloucester County",2,43,3732,1780,1952
050,34,015,"New Jersey","Gloucester County",2,44,3636,1732,1904
050,34,015,"New Jersey","Gloucester County",2,45,3728,1789,1939
050,34,015,"New Jersey","Gloucester County",2,46,3643,1766,1877
050,34,015,"New Jersey","Gloucester County",2,47,3722,1797,1925
050,34,015,"New Jersey","Gloucester County",2,48,4023,1939,2084
050,34,015,"New Jersey","Gloucester County",2,49,4393,2136,2257
050,34,015,"New Jersey","Gloucester County",2,50,4382,2109,2273
050,34,015,"New Jersey","Gloucester County",2,51,4278,2036,2242
050,34,015,"New Jersey","Gloucester County",2,52,4133,1992,2141
050,34,015,"New Jersey","Gloucester County",2,53,4223,2073,2150
050,34,015,"New Jersey","Gloucester County",2,54,4297,2130,2167
050,34,015,"New Jersey","Gloucester County",2,55,4435,2182,2253
050,34,015,"New Jersey","Gloucester County",2,56,4532,2249,2283
050,34,015,"New Jersey","Gloucester County",2,57,4544,2220,2324
050,34,015,"New Jersey","Gloucester County",2,58,4560,2247,2313
050,34,015,"New Jersey","Gloucester County",2,59,4460,2226,2234
050,34,015,"New Jersey","Gloucester County",2,60,4313,2145,2168
050,34,015,"New Jersey","Gloucester County",2,61,4299,2104,2195
050,34,015,"New Jersey","Gloucester County",2,62,4266,2027,2239
050,34,015,"New Jersey","Gloucester County",2,63,4109,1947,2162
050,34,015,"New Jersey","Gloucester County",2,64,3828,1833,1995
050,34,015,"New Jersey","Gloucester County",2,65,3626,1749,1877
050,34,015,"New Jersey","Gloucester County",2,66,3461,1651,1810
050,34,015,"New Jersey","Gloucester County",2,67,3295,1539,1756
050,34,015,"New Jersey","Gloucester County",2,68,3182,1474,1708
050,34,015,"New Jersey","Gloucester County",2,69,3037,1409,1628
050,34,015,"New Jersey","Gloucester County",2,70,2860,1342,1518
050,34,015,"New Jersey","Gloucester County",2,71,2792,1278,1514
050,34,015,"New Jersey","Gloucester County",2,72,2740,1243,1497
050,34,015,"New Jersey","Gloucester County",2,73,2890,1331,1559
050,34,015,"New Jersey","Gloucester County",2,74,1979,898,1081
050,34,015,"New Jersey","Gloucester County",2,75,1876,837,1039
050,34,015,"New Jersey","Gloucester County",2,76,1874,867,1007
050,34,015,"New Jersey","Gloucester County",2,77,1919,869,1050
050,34,015,"New Jersey","Gloucester County",2,78,1590,708,882
050,34,015,"New Jersey","Gloucester County",2,79,1372,589,783
050,34,015,"New Jersey","Gloucester County",2,80,1181,496,685
050,34,015,"New Jersey","Gloucester County",2,81,1116,474,642
050,34,015,"New Jersey","Gloucester County",2,82,1036,427,609
050,34,015,"New Jersey","Gloucester County",2,83,887,357,530
050,34,015,"New Jersey","Gloucester County",2,84,811,328,483
050,34,015,"New Jersey","Gloucester County",2,85,5027,1674,3353
050,34,015,"New Jersey","Gloucester County",3,0,2813,1466,1347
050,34,015,"New Jersey","Gloucester County",3,1,2942,1547,1395
050,34,015,"New Jersey","Gloucester County",3,2,3038,1548,1490
050,34,015,"New Jersey","Gloucester County",3,3,3204,1628,1576
050,34,015,"New Jersey","Gloucester County",3,4,3293,1680,1613
050,34,015,"New Jersey","Gloucester County",3,5,3313,1698,1615
050,34,015,"New Jersey","Gloucester County",3,6,3402,1740,1662
050,34,015,"New Jersey","Gloucester County",3,7,3491,1774,1717
050,34,015,"New Jersey","Gloucester County",3,8,3530,1833,1697
050,34,015,"New Jersey","Gloucester County",3,9,3643,1890,1753
050,34,015,"New Jersey","Gloucester County",3,10,3735,1890,1845
050,34,015,"New Jersey","Gloucester County",3,11,3908,1988,1920
050,34,015,"New Jersey","Gloucester County",3,12,4000,2021,1979
050,34,015,"New Jersey","Gloucester County",3,13,4171,2087,2084
050,34,015,"New Jersey","Gloucester County",3,14,4179,2121,2058
050,34,015,"New Jersey","Gloucester County",3,15,4102,2100,2002
050,34,015,"New Jersey","Gloucester County",3,16,4069,2098,1971
050,34,015,"New Jersey","Gloucester County",3,17,4216,2139,2077
050,34,015,"New Jersey","Gloucester County",3,18,3967,2087,1880
050,34,015,"New Jersey","Gloucester County",3,19,4367,2231,2136
050,34,015,"New Jersey","Gloucester County",3,20,4727,2434,2293
050,34,015,"New Jersey","Gloucester County",3,21,4768,2461,2307
050,34,015,"New Jersey","Gloucester County",3,22,4358,2209,2149
050,34,015,"New Jersey","Gloucester County",3,23,3945,1998,1947
050,34,015,"New Jersey","Gloucester County",3,24,3765,1921,1844
050,34,015,"New Jersey","Gloucester County",3,25,3690,1861,1829
050,34,015,"New Jersey","Gloucester County",3,26,3621,1844,1777
050,34,015,"New Jersey","Gloucester County",3,27,3740,1923,1817
050,34,015,"New Jersey","Gloucester County",3,28,3728,1904,1824
050,34,015,"New Jersey","Gloucester County",3,29,3813,1936,1877
050,34,015,"New Jersey","Gloucester County",3,30,3894,1957,1937
050,34,015,"New Jersey","Gloucester County",3,31,3897,1922,1975
050,34,015,"New Jersey","Gloucester County",3,32,3843,1933,1910
050,34,015,"New Jersey","Gloucester County",3,33,3805,1901,1904
050,34,015,"New Jersey","Gloucester County",3,34,3826,1950,1876
050,34,015,"New Jersey","Gloucester County",3,35,3893,1922,1971
050,34,015,"New Jersey","Gloucester County",3,36,3928,1924,2004
050,34,015,"New Jersey","Gloucester County",3,37,3808,1882,1926
050,34,015,"New Jersey","Gloucester County",3,38,3908,1850,2058
050,34,015,"New Jersey","Gloucester County",3,39,3948,1878,2070
050,34,015,"New Jersey","Gloucester County",3,40,3873,1887,1986
050,34,015,"New Jersey","Gloucester County",3,41,3921,1897,2024
050,34,015,"New Jersey","Gloucester County",3,42,3916,1896,2020
050,34,015,"New Jersey","Gloucester County",3,43,3846,1900,1946
050,34,015,"New Jersey","Gloucester County",3,44,3745,1811,1934
050,34,015,"New Jersey","Gloucester County",3,45,3681,1765,1916
050,34,015,"New Jersey","Gloucester County",3,46,3741,1776,1965
050,34,015,"New Jersey","Gloucester County",3,47,3656,1784,1872
050,34,015,"New Jersey","Gloucester County",3,48,3725,1803,1922
050,34,015,"New Jersey","Gloucester County",3,49,4006,1945,2061
050,34,015,"New Jersey","Gloucester County",3,50,4373,2114,2259
050,34,015,"New Jersey","Gloucester County",3,51,4365,2094,2271
050,34,015,"New Jersey","Gloucester County",3,52,4250,2029,2221
050,34,015,"New Jersey","Gloucester County",3,53,4073,1968,2105
050,34,015,"New Jersey","Gloucester County",3,54,4187,2053,2134
050,34,015,"New Jersey","Gloucester County",3,55,4243,2095,2148
050,34,015,"New Jersey","Gloucester County",3,56,4406,2162,2244
050,34,015,"New Jersey","Gloucester County",3,57,4496,2240,2256
050,34,015,"New Jersey","Gloucester County",3,58,4471,2175,2296
050,34,015,"New Jersey","Gloucester County",3,59,4455,2227,2228
050,34,015,"New Jersey","Gloucester County",3,60,4392,2174,2218
050,34,015,"New Jersey","Gloucester County",3,61,4244,2092,2152
050,34,015,"New Jersey","Gloucester County",3,62,4228,2071,2157
050,34,015,"New Jersey","Gloucester County",3,63,4186,1976,2210
050,34,015,"New Jersey","Gloucester County",3,64,4002,1895,2107
050,34,015,"New Jersey","Gloucester County",3,65,3739,1765,1974
050,34,015,"New Jersey","Gloucester County",3,66,3535,1696,1839
050,34,015,"New Jersey","Gloucester County",3,67,3379,1599,1780
050,34,015,"New Jersey","Gloucester County",3,68,3235,1490,1745
050,34,015,"New Jersey","Gloucester County",3,69,3113,1434,1679
050,34,015,"New Jersey","Gloucester County",3,70,2979,1383,1596
050,34,015,"New Jersey","Gloucester County",3,71,2797,1315,1482
050,34,015,"New Jersey","Gloucester County",3,72,2711,1233,1478
050,34,015,"New Jersey","Gloucester County",3,73,2648,1199,1449
050,34,015,"New Jersey","Gloucester County",3,74,2848,1305,1543
050,34,015,"New Jersey","Gloucester County",3,75,1890,848,1042
050,34,015,"New Jersey","Gloucester County",3,76,1785,789,996
050,34,015,"New Jersey","Gloucester County",3,77,1767,808,959
050,34,015,"New Jersey","Gloucester County",3,78,1844,827,1017
050,34,015,"New Jersey","Gloucester County",3,79,1517,666,851
050,34,015,"New Jersey","Gloucester County",3,80,1284,552,732
050,34,015,"New Jersey","Gloucester County",3,81,1079,442,637
050,34,015,"New Jersey","Gloucester County",3,82,1048,426,622
050,34,015,"New Jersey","Gloucester County",3,83,936,368,568
050,34,015,"New Jersey","Gloucester County",3,84,791,306,485
050,34,015,"New Jersey","Gloucester County",3,85,4898,1654,3244
050,34,015,"New Jersey","Gloucester County",4,0,3077,1587,1490
050,34,015,"New Jersey","Gloucester County",4,1,2866,1503,1363
050,34,015,"New Jersey","Gloucester County",4,2,3052,1615,1437
050,34,015,"New Jersey","Gloucester County",4,3,3153,1614,1539
050,34,015,"New Jersey","Gloucester County",4,4,3292,1669,1623
050,34,015,"New Jersey","Gloucester County",4,5,3357,1725,1632
050,34,015,"New Jersey","Gloucester County",4,6,3401,1762,1639
050,34,015,"New Jersey","Gloucester County",4,7,3504,1790,1714
050,34,015,"New Jersey","Gloucester County",4,8,3598,1849,1749
050,34,015,"New Jersey","Gloucester County",4,9,3622,1888,1734
050,34,015,"New Jersey","Gloucester County",4,10,3744,1942,1802
050,34,015,"New Jersey","Gloucester County",4,11,3832,1937,1895
050,34,015,"New Jersey","Gloucester County",4,12,3987,2037,1950
050,34,015,"New Jersey","Gloucester County",4,13,4078,2061,2017
050,34,015,"New Jersey","Gloucester County",4,14,4229,2123,2106
050,34,015,"New Jersey","Gloucester County",4,15,4253,2144,2109
050,34,015,"New Jersey","Gloucester County",4,16,4159,2144,2015
050,34,015,"New Jersey","Gloucester County",4,17,4097,2120,1977
050,34,015,"New Jersey","Gloucester County",4,18,4022,2105,1917
050,34,015,"New Jersey","Gloucester County",4,19,4348,2221,2127
050,34,015,"New Jersey","Gloucester County",4,20,4644,2394,2250
050,34,015,"New Jersey","Gloucester County",4,21,4681,2403,2278
050,34,015,"New Jersey","Gloucester County",4,22,4452,2263,2189
050,34,015,"New Jersey","Gloucester County",4,23,3928,2004,1924
050,34,015,"New Jersey","Gloucester County",4,24,3812,1961,1851
050,34,015,"New Jersey","Gloucester County",4,25,3636,1869,1767
050,34,015,"New Jersey","Gloucester County",4,26,3635,1835,1800
050,34,015,"New Jersey","Gloucester County",4,27,3612,1843,1769
050,34,015,"New Jersey","Gloucester County",4,28,3704,1882,1822
050,34,015,"New Jersey","Gloucester County",4,29,3817,1961,1856
050,34,015,"New Jersey","Gloucester County",4,30,3849,1928,1921
050,34,015,"New Jersey","Gloucester County",4,31,3968,2016,1952
050,34,015,"New Jersey","Gloucester County",4,32,4002,1975,2027
050,34,015,"New Jersey","Gloucester County",4,33,3886,1943,1943
050,34,015,"New Jersey","Gloucester County",4,34,3924,1959,1965
050,34,015,"New Jersey","Gloucester County",4,35,3937,1980,1957
050,34,015,"New Jersey","Gloucester County",4,36,4016,1962,2054
050,34,015,"New Jersey","Gloucester County",4,37,4051,1988,2063
050,34,015,"New Jersey","Gloucester County",4,38,3874,1931,1943
050,34,015,"New Jersey","Gloucester County",4,39,4035,1917,2118
050,34,015,"New Jersey","Gloucester County",4,40,4012,1919,2093
050,34,015,"New Jersey","Gloucester County",4,41,3956,1917,2039
050,34,015,"New Jersey","Gloucester County",4,42,3995,1928,2067
050,34,015,"New Jersey","Gloucester County",4,43,3970,1933,2037
050,34,015,"New Jersey","Gloucester County",4,44,3900,1914,1986
050,34,015,"New Jersey","Gloucester County",4,45,3783,1845,1938
050,34,015,"New Jersey","Gloucester County",4,46,3738,1789,1949
050,34,015,"New Jersey","Gloucester County",4,47,3744,1784,1960
050,34,015,"New Jersey","Gloucester County",4,48,3663,1777,1886
050,34,015,"New Jersey","Gloucester County",4,49,3684,1786,1898
050,34,015,"New Jersey","Gloucester County",4,50,3992,1944,2048
050,34,015,"New Jersey","Gloucester County",4,51,4348,2092,2256
050,34,015,"New Jersey","Gloucester County",4,52,4329,2083,2246
050,34,015,"New Jersey","Gloucester County",4,53,4187,1977,2210
050,34,015,"New Jersey","Gloucester County",4,54,4033,1957,2076
050,34,015,"New Jersey","Gloucester County",4,55,4163,2018,2145
050,34,015,"New Jersey","Gloucester County",4,56,4210,2086,2124
050,34,015,"New Jersey","Gloucester County",4,57,4349,2155,2194
050,34,015,"New Jersey","Gloucester County",4,58,4432,2208,2224
050,34,015,"New Jersey","Gloucester County",4,59,4390,2138,2252
050,34,015,"New Jersey","Gloucester County",4,60,4366,2188,2178
050,34,015,"New Jersey","Gloucester County",4,61,4332,2128,2204
050,34,015,"New Jersey","Gloucester County",4,62,4173,2069,2104
050,34,015,"New Jersey","Gloucester County",4,63,4179,2052,2127
050,34,015,"New Jersey","Gloucester County",4,64,4135,1943,2192
050,34,015,"New Jersey","Gloucester County",4,65,3929,1848,2081
050,34,015,"New Jersey","Gloucester County",4,66,3679,1706,1973
050,34,015,"New Jersey","Gloucester County",4,67,3453,1644,1809
050,34,015,"New Jersey","Gloucester County",4,68,3312,1560,1752
050,34,015,"New Jersey","Gloucester County",4,69,3166,1459,1707
050,34,015,"New Jersey","Gloucester County",4,70,3043,1393,1650
050,34,015,"New Jersey","Gloucester County",4,71,2917,1344,1573
050,34,015,"New Jersey","Gloucester County",4,72,2715,1258,1457
050,34,015,"New Jersey","Gloucester County",4,73,2634,1195,1439
050,34,015,"New Jersey","Gloucester County",4,74,2589,1166,1423
050,34,015,"New Jersey","Gloucester County",4,75,2755,1251,1504
050,34,015,"New Jersey","Gloucester County",4,76,1851,829,1022
050,34,015,"New Jersey","Gloucester County",4,77,1712,743,969
050,34,015,"New Jersey","Gloucester County",4,78,1733,790,943
050,34,015,"New Jersey","Gloucester County",4,79,1745,774,971
050,34,015,"New Jersey","Gloucester County",4,80,1441,633,808
050,34,015,"New Jersey","Gloucester County",4,81,1207,501,706
050,34,015,"New Jersey","Gloucester County",4,82,1013,420,593
050,34,015,"New Jersey","Gloucester County",4,83,961,382,579
050,34,015,"New Jersey","Gloucester County",4,84,864,323,541
050,34,015,"New Jersey","Gloucester County",4,85,4851,1652,3199
050,34,015,"New Jersey","Gloucester County",5,0,3058,1585,1473
050,34,015,"New Jersey","Gloucester County",5,1,3196,1630,1566
050,34,015,"New Jersey","Gloucester County",5,2,2908,1536,1372
050,34,015,"New Jersey","Gloucester County",5,3,3073,1637,1436
050,34,015,"New Jersey","Gloucester County",5,4,3246,1681,1565
050,34,015,"New Jersey","Gloucester County",5,5,3379,1700,1679
050,34,015,"New Jersey","Gloucester County",5,6,3393,1735,1658
050,34,015,"New Jersey","Gloucester County",5,7,3493,1811,1682
050,34,015,"New Jersey","Gloucester County",5,8,3526,1804,1722
050,34,015,"New Jersey","Gloucester County",5,9,3694,1904,1790
050,34,015,"New Jersey","Gloucester County",5,10,3691,1926,1765
050,34,015,"New Jersey","Gloucester County",5,11,3761,1941,1820
050,34,015,"New Jersey","Gloucester County",5,12,3896,1968,1928
050,34,015,"New Jersey","Gloucester County",5,13,4044,2043,2001
050,34,015,"New Jersey","Gloucester County",5,14,4115,2086,2029
050,34,015,"New Jersey","Gloucester County",5,15,4272,2168,2104
050,34,015,"New Jersey","Gloucester County",5,16,4281,2156,2125
050,34,015,"New Jersey","Gloucester County",5,17,4166,2137,2029
050,34,015,"New Jersey","Gloucester County",5,18,3930,2099,1831
050,34,015,"New Jersey","Gloucester County",5,19,4444,2247,2197
050,34,015,"New Jersey","Gloucester County",5,20,4707,2427,2280
050,34,015,"New Jersey","Gloucester County",5,21,4627,2371,2256
050,34,015,"New Jersey","Gloucester County",5,22,4341,2189,2152
050,34,015,"New Jersey","Gloucester County",5,23,4044,2065,1979
050,34,015,"New Jersey","Gloucester County",5,24,3804,1933,1871
050,34,015,"New Jersey","Gloucester County",5,25,3742,1921,1821
050,34,015,"New Jersey","Gloucester County",5,26,3622,1834,1788
050,34,015,"New Jersey","Gloucester County",5,27,3655,1821,1834
050,34,015,"New Jersey","Gloucester County",5,28,3580,1824,1756
050,34,015,"New Jersey","Gloucester County",5,29,3747,1874,1873
050,34,015,"New Jersey","Gloucester County",5,30,3844,1965,1879
050,34,015,"New Jersey","Gloucester County",5,31,3875,1930,1945
050,34,015,"New Jersey","Gloucester County",5,32,4042,2036,2006
050,34,015,"New Jersey","Gloucester County",5,33,4083,2006,2077
050,34,015,"New Jersey","Gloucester County",5,34,4015,2018,1997
050,34,015,"New Jersey","Gloucester County",5,35,4001,1990,2011
050,34,015,"New Jersey","Gloucester County",5,36,4040,2040,2000
050,34,015,"New Jersey","Gloucester County",5,37,4058,1969,2089
050,34,015,"New Jersey","Gloucester County",5,38,4084,2000,2084
050,34,015,"New Jersey","Gloucester County",5,39,3936,1958,1978
050,34,015,"New Jersey","Gloucester County",5,40,4077,1947,2130
050,34,015,"New Jersey","Gloucester County",5,41,4064,1938,2126
050,34,015,"New Jersey","Gloucester County",5,42,4031,1961,2070
050,34,015,"New Jersey","Gloucester County",5,43,4024,1952,2072
050,34,015,"New Jersey","Gloucester County",5,44,3986,1952,2034
050,34,015,"New Jersey","Gloucester County",5,45,3931,1921,2010
050,34,015,"New Jersey","Gloucester County",5,46,3754,1830,1924
050,34,015,"New Jersey","Gloucester County",5,47,3746,1802,1944
050,34,015,"New Jersey","Gloucester County",5,48,3707,1766,1941
050,34,015,"New Jersey","Gloucester County",5,49,3648,1766,1882
050,34,015,"New Jersey","Gloucester County",5,50,3667,1768,1899
050,34,015,"New Jersey","Gloucester County",5,51,3982,1922,2060
050,34,015,"New Jersey","Gloucester County",5,52,4289,2077,2212
050,34,015,"New Jersey","Gloucester County",5,53,4291,2053,2238
050,34,015,"New Jersey","Gloucester County",5,54,4098,1939,2159
050,34,015,"New Jersey","Gloucester County",5,55,3979,1928,2051
050,34,015,"New Jersey","Gloucester County",5,56,4121,1990,2131
050,34,015,"New Jersey","Gloucester County",5,57,4171,2078,2093
050,34,015,"New Jersey","Gloucester County",5,58,4293,2120,2173
050,34,015,"New Jersey","Gloucester County",5,59,4367,2156,2211
050,34,015,"New Jersey","Gloucester County",5,60,4342,2112,2230
050,34,015,"New Jersey","Gloucester County",5,61,4298,2148,2150
050,34,015,"New Jersey","Gloucester County",5,62,4281,2106,2175
050,34,015,"New Jersey","Gloucester County",5,63,4131,2050,2081
050,34,015,"New Jersey","Gloucester County",5,64,4127,2010,2117
050,34,015,"New Jersey","Gloucester County",5,65,4105,1929,2176
050,34,015,"New Jersey","Gloucester County",5,66,3889,1819,2070
050,34,015,"New Jersey","Gloucester County",5,67,3600,1654,1946
050,34,015,"New Jersey","Gloucester County",5,68,3425,1616,1809
050,34,015,"New Jersey","Gloucester County",5,69,3260,1530,1730
050,34,015,"New Jersey","Gloucester County",5,70,3105,1426,1679
050,34,015,"New Jersey","Gloucester County",5,71,3016,1377,1639
050,34,015,"New Jersey","Gloucester County",5,72,2854,1305,1549
050,34,015,"New Jersey","Gloucester County",5,73,2661,1240,1421
050,34,015,"New Jersey","Gloucester County",5,74,2574,1162,1412
050,34,015,"New Jersey","Gloucester County",5,75,2513,1109,1404
050,34,015,"New Jersey","Gloucester County",5,76,2695,1232,1463
050,34,015,"New Jersey","Gloucester County",5,77,1779,782,997
050,34,015,"New Jersey","Gloucester County",5,78,1650,704,946
050,34,015,"New Jersey","Gloucester County",5,79,1649,742,907
050,34,015,"New Jersey","Gloucester County",5,80,1663,734,929
050,34,015,"New Jersey","Gloucester County",5,81,1358,591,767
050,34,015,"New Jersey","Gloucester County",5,82,1129,466,663
050,34,015,"New Jersey","Gloucester County",5,83,939,370,569
050,34,015,"New Jersey","Gloucester County",5,84,890,345,545
050,34,015,"New Jersey","Gloucester County",5,85,4851,1704,3147
050,34,017,"New Jersey","Hudson County",1,0,10910,5592,5318
050,34,017,"New Jersey","Hudson County",1,1,10284,5211,5073
050,34,017,"New Jersey","Hudson County",1,2,9841,4992,4849
050,34,017,"New Jersey","Hudson County",1,3,9423,4849,4574
050,34,017,"New Jersey","Hudson County",1,4,9101,4656,4445
050,34,017,"New Jersey","Hudson County",1,5,8578,4383,4195
050,34,017,"New Jersey","Hudson County",1,6,8095,4217,3878
050,34,017,"New Jersey","Hudson County",1,7,7999,4056,3943
050,34,017,"New Jersey","Hudson County",1,8,7818,3980,3838
050,34,017,"New Jersey","Hudson County",1,9,7739,3916,3823
050,34,017,"New Jersey","Hudson County",1,10,7616,3875,3741
050,34,017,"New Jersey","Hudson County",1,11,7509,3815,3694
050,34,017,"New Jersey","Hudson County",1,12,7671,3887,3784
050,34,017,"New Jersey","Hudson County",1,13,7493,3800,3693
050,34,017,"New Jersey","Hudson County",1,14,7183,3654,3529
050,34,017,"New Jersey","Hudson County",1,15,6907,3477,3430
050,34,017,"New Jersey","Hudson County",1,16,6981,3502,3479
050,34,017,"New Jersey","Hudson County",1,17,6834,3472,3362
050,34,017,"New Jersey","Hudson County",1,18,6856,3585,3271
050,34,017,"New Jersey","Hudson County",1,19,6688,3571,3117
050,34,017,"New Jersey","Hudson County",1,20,6785,3634,3151
050,34,017,"New Jersey","Hudson County",1,21,7077,3667,3410
050,34,017,"New Jersey","Hudson County",1,22,7639,3928,3711
050,34,017,"New Jersey","Hudson County",1,23,8980,4543,4437
050,34,017,"New Jersey","Hudson County",1,24,10543,5317,5226
050,34,017,"New Jersey","Hudson County",1,25,11982,6043,5939
050,34,017,"New Jersey","Hudson County",1,26,13254,6545,6709
050,34,017,"New Jersey","Hudson County",1,27,14701,7425,7276
050,34,017,"New Jersey","Hudson County",1,28,15513,7880,7633
050,34,017,"New Jersey","Hudson County",1,29,16487,8402,8085
050,34,017,"New Jersey","Hudson County",1,30,17048,8628,8420
050,34,017,"New Jersey","Hudson County",1,31,16831,8754,8077
050,34,017,"New Jersey","Hudson County",1,32,16143,8469,7674
050,34,017,"New Jersey","Hudson County",1,33,15448,8061,7387
050,34,017,"New Jersey","Hudson County",1,34,15123,7951,7172
050,34,017,"New Jersey","Hudson County",1,35,14427,7534,6893
050,34,017,"New Jersey","Hudson County",1,36,13961,7412,6549
050,34,017,"New Jersey","Hudson County",1,37,13495,7197,6298
050,34,017,"New Jersey","Hudson County",1,38,12677,6728,5949
050,34,017,"New Jersey","Hudson County",1,39,12015,6366,5649
050,34,017,"New Jersey","Hudson County",1,40,11463,5988,5475
050,34,017,"New Jersey","Hudson County",1,41,10693,5581,5112
050,34,017,"New Jersey","Hudson County",1,42,10079,5283,4796
050,34,017,"New Jersey","Hudson County",1,43,9665,5020,4645
050,34,017,"New Jersey","Hudson County",1,44,9249,4812,4437
050,34,017,"New Jersey","Hudson County",1,45,9129,4704,4425
050,34,017,"New Jersey","Hudson County",1,46,8612,4450,4162
050,34,017,"New Jersey","Hudson County",1,47,8647,4466,4181
050,34,017,"New Jersey","Hudson County",1,48,8770,4472,4298
050,34,017,"New Jersey","Hudson County",1,49,9190,4621,4569
050,34,017,"New Jersey","Hudson County",1,50,8711,4289,4422
050,34,017,"New Jersey","Hudson County",1,51,8360,4088,4272
050,34,017,"New Jersey","Hudson County",1,52,8362,4105,4257
050,34,017,"New Jersey","Hudson County",1,53,8447,4228,4219
050,34,017,"New Jersey","Hudson County",1,54,8376,4184,4192
050,34,017,"New Jersey","Hudson County",1,55,8534,4183,4351
050,34,017,"New Jersey","Hudson County",1,56,8546,4264,4282
050,34,017,"New Jersey","Hudson County",1,57,8312,4028,4284
050,34,017,"New Jersey","Hudson County",1,58,8135,4019,4116
050,34,017,"New Jersey","Hudson County",1,59,7993,4027,3966
050,34,017,"New Jersey","Hudson County",1,60,7899,3901,3998
050,34,017,"New Jersey","Hudson County",1,61,7601,3720,3881
050,34,017,"New Jersey","Hudson County",1,62,7283,3536,3747
050,34,017,"New Jersey","Hudson County",1,63,7008,3287,3721
050,34,017,"New Jersey","Hudson County",1,64,6831,3232,3599
050,34,017,"New Jersey","Hudson County",1,65,6597,3057,3540
050,34,017,"New Jersey","Hudson County",1,66,6038,2782,3256
050,34,017,"New Jersey","Hudson County",1,67,5774,2697,3077
050,34,017,"New Jersey","Hudson County",1,68,5518,2527,2991
050,34,017,"New Jersey","Hudson County",1,69,5145,2289,2856
050,34,017,"New Jersey","Hudson County",1,70,4952,2235,2717
050,34,017,"New Jersey","Hudson County",1,71,4746,2157,2589
050,34,017,"New Jersey","Hudson County",1,72,4702,2065,2637
050,34,017,"New Jersey","Hudson County",1,73,4585,1982,2603
050,34,017,"New Jersey","Hudson County",1,74,3599,1517,2082
050,34,017,"New Jersey","Hudson County",1,75,3394,1446,1948
050,34,017,"New Jersey","Hudson County",1,76,3178,1357,1821
050,34,017,"New Jersey","Hudson County",1,77,3147,1287,1860
050,34,017,"New Jersey","Hudson County",1,78,2752,1110,1642
050,34,017,"New Jersey","Hudson County",1,79,2557,1032,1525
050,34,017,"New Jersey","Hudson County",1,80,2440,959,1481
050,34,017,"New Jersey","Hudson County",1,81,2264,875,1389
050,34,017,"New Jersey","Hudson County",1,82,2030,796,1234
050,34,017,"New Jersey","Hudson County",1,83,1865,721,1144
050,34,017,"New Jersey","Hudson County",1,84,1754,684,1070
050,34,017,"New Jersey","Hudson County",1,85,10271,3479,6792
050,34,017,"New Jersey","Hudson County",2,0,10431,5306,5125
050,34,017,"New Jersey","Hudson County",2,1,10238,5192,5046
050,34,017,"New Jersey","Hudson County",2,2,9791,4962,4829
050,34,017,"New Jersey","Hudson County",2,3,9381,4810,4571
050,34,017,"New Jersey","Hudson County",2,4,9062,4638,4424
050,34,017,"New Jersey","Hudson County",2,5,8597,4398,4199
050,34,017,"New Jersey","Hudson County",2,6,8130,4212,3918
050,34,017,"New Jersey","Hudson County",2,7,7935,4053,3882
050,34,017,"New Jersey","Hudson County",2,8,7760,3947,3813
050,34,017,"New Jersey","Hudson County",2,9,7697,3902,3795
050,34,017,"New Jersey","Hudson County",2,10,7583,3855,3728
050,34,017,"New Jersey","Hudson County",2,11,7451,3791,3660
050,34,017,"New Jersey","Hudson County",2,12,7622,3869,3753
050,34,017,"New Jersey","Hudson County",2,13,7492,3805,3687
050,34,017,"New Jersey","Hudson County",2,14,7220,3667,3553
050,34,017,"New Jersey","Hudson County",2,15,6957,3517,3440
050,34,017,"New Jersey","Hudson County",2,16,6939,3482,3457
050,34,017,"New Jersey","Hudson County",2,17,6839,3465,3374
050,34,017,"New Jersey","Hudson County",2,18,6798,3558,3240
050,34,017,"New Jersey","Hudson County",2,19,6652,3554,3098
050,34,017,"New Jersey","Hudson County",2,20,6834,3638,3196
050,34,017,"New Jersey","Hudson County",2,21,7039,3671,3368
050,34,017,"New Jersey","Hudson County",2,22,7656,3934,3722
050,34,017,"New Jersey","Hudson County",2,23,8871,4489,4382
050,34,017,"New Jersey","Hudson County",2,24,10391,5246,5145
050,34,017,"New Jersey","Hudson County",2,25,11832,5953,5879
050,34,017,"New Jersey","Hudson County",2,26,13163,6536,6627
050,34,017,"New Jersey","Hudson County",2,27,14441,7260,7181
050,34,017,"New Jersey","Hudson County",2,28,15404,7841,7563
050,34,017,"New Jersey","Hudson County",2,29,16310,8306,8004
050,34,017,"New Jersey","Hudson County",2,30,16996,8636,8360
050,34,017,"New Jersey","Hudson County",2,31,16768,8678,8090
050,34,017,"New Jersey","Hudson County",2,32,16181,8470,7711
050,34,017,"New Jersey","Hudson County",2,33,15478,8096,7382
050,34,017,"New Jersey","Hudson County",2,34,15060,7906,7154
050,34,017,"New Jersey","Hudson County",2,35,14498,7582,6916
050,34,017,"New Jersey","Hudson County",2,36,13854,7328,6526
050,34,017,"New Jersey","Hudson County",2,37,13477,7177,6300
050,34,017,"New Jersey","Hudson County",2,38,12787,6800,5987
050,34,017,"New Jersey","Hudson County",2,39,11991,6350,5641
050,34,017,"New Jersey","Hudson County",2,40,11560,6063,5497
050,34,017,"New Jersey","Hudson County",2,41,10745,5604,5141
050,34,017,"New Jersey","Hudson County",2,42,10124,5304,4820
050,34,017,"New Jersey","Hudson County",2,43,9715,5048,4667
050,34,017,"New Jersey","Hudson County",2,44,9217,4784,4433
050,34,017,"New Jersey","Hudson County",2,45,9114,4699,4415
050,34,017,"New Jersey","Hudson County",2,46,8668,4475,4193
050,34,017,"New Jersey","Hudson County",2,47,8568,4421,4147
050,34,017,"New Jersey","Hudson County",2,48,8698,4436,4262
050,34,017,"New Jersey","Hudson County",2,49,9049,4560,4489
050,34,017,"New Jersey","Hudson County",2,50,8778,4338,4440
050,34,017,"New Jersey","Hudson County",2,51,8357,4080,4277
050,34,017,"New Jersey","Hudson County",2,52,8333,4085,4248
050,34,017,"New Jersey","Hudson County",2,53,8352,4156,4196
050,34,017,"New Jersey","Hudson County",2,54,8343,4162,4181
050,34,017,"New Jersey","Hudson County",2,55,8474,4171,4303
050,34,017,"New Jersey","Hudson County",2,56,8500,4209,4291
050,34,017,"New Jersey","Hudson County",2,57,8313,4067,4246
050,34,017,"New Jersey","Hudson County",2,58,8128,3999,4129
050,34,017,"New Jersey","Hudson County",2,59,7929,3966,3963
050,34,017,"New Jersey","Hudson County",2,60,7891,3905,3986
050,34,017,"New Jersey","Hudson County",2,61,7577,3706,3871
050,34,017,"New Jersey","Hudson County",2,62,7257,3523,3734
050,34,017,"New Jersey","Hudson County",2,63,7035,3317,3718
050,34,017,"New Jersey","Hudson County",2,64,6759,3187,3572
050,34,017,"New Jersey","Hudson County",2,65,6579,3053,3526
050,34,017,"New Jersey","Hudson County",2,66,6104,2805,3299
050,34,017,"New Jersey","Hudson County",2,67,5749,2658,3091
050,34,017,"New Jersey","Hudson County",2,68,5480,2508,2972
050,34,017,"New Jersey","Hudson County",2,69,5170,2310,2860
050,34,017,"New Jersey","Hudson County",2,70,4933,2209,2724
050,34,017,"New Jersey","Hudson County",2,71,4707,2129,2578
050,34,017,"New Jersey","Hudson County",2,72,4601,2024,2577
050,34,017,"New Jersey","Hudson County",2,73,4663,2026,2637
050,34,017,"New Jersey","Hudson County",2,74,3645,1539,2106
050,34,017,"New Jersey","Hudson County",2,75,3391,1434,1957
050,34,017,"New Jersey","Hudson County",2,76,3160,1340,1820
050,34,017,"New Jersey","Hudson County",2,77,3121,1285,1836
050,34,017,"New Jersey","Hudson County",2,78,2750,1104,1646
050,34,017,"New Jersey","Hudson County",2,79,2546,1021,1525
050,34,017,"New Jersey","Hudson County",2,80,2409,936,1473
050,34,017,"New Jersey","Hudson County",2,81,2234,866,1368
050,34,017,"New Jersey","Hudson County",2,82,2027,783,1244
050,34,017,"New Jersey","Hudson County",2,83,1837,702,1135
050,34,017,"New Jersey","Hudson County",2,84,1709,663,1046
050,34,017,"New Jersey","Hudson County",2,85,9974,3367,6607
050,34,017,"New Jersey","Hudson County",3,0,9149,4639,4510
050,34,017,"New Jersey","Hudson County",3,1,9486,4831,4655
050,34,017,"New Jersey","Hudson County",3,2,9194,4658,4536
050,34,017,"New Jersey","Hudson County",3,3,8853,4525,4328
050,34,017,"New Jersey","Hudson County",3,4,8626,4429,4197
050,34,017,"New Jersey","Hudson County",3,5,8376,4249,4127
050,34,017,"New Jersey","Hudson County",3,6,8022,4115,3907
050,34,017,"New Jersey","Hudson County",3,7,7710,4012,3698
050,34,017,"New Jersey","Hudson County",3,8,7648,3893,3755
050,34,017,"New Jersey","Hudson County",3,9,7487,3806,3681
050,34,017,"New Jersey","Hudson County",3,10,7463,3783,3680
050,34,017,"New Jersey","Hudson County",3,11,7409,3768,3641
050,34,017,"New Jersey","Hudson County",3,12,7197,3634,3563
050,34,017,"New Jersey","Hudson County",3,13,7437,3799,3638
050,34,017,"New Jersey","Hudson County",3,14,7277,3706,3571
050,34,017,"New Jersey","Hudson County",3,15,7074,3611,3463
050,34,017,"New Jersey","Hudson County",3,16,6840,3469,3371
050,34,017,"New Jersey","Hudson County",3,17,6830,3405,3425
050,34,017,"New Jersey","Hudson County",3,18,6729,3490,3239
050,34,017,"New Jersey","Hudson County",3,19,6495,3457,3038
050,34,017,"New Jersey","Hudson County",3,20,6787,3541,3246
050,34,017,"New Jersey","Hudson County",3,21,6997,3680,3317
050,34,017,"New Jersey","Hudson County",3,22,7159,3683,3476
050,34,017,"New Jersey","Hudson County",3,23,8137,4105,4032
050,34,017,"New Jersey","Hudson County",3,24,9432,4781,4651
050,34,017,"New Jersey","Hudson County",3,25,10943,5490,5453
050,34,017,"New Jersey","Hudson County",3,26,12467,6171,6296
050,34,017,"New Jersey","Hudson County",3,27,13395,6649,6746
050,34,017,"New Jersey","Hudson County",3,28,14336,7272,7064
050,34,017,"New Jersey","Hudson County",3,29,15298,7772,7526
050,34,017,"New Jersey","Hudson County",3,30,15791,8089,7702
050,34,017,"New Jersey","Hudson County",3,31,16255,8360,7895
050,34,017,"New Jersey","Hudson County",3,32,15786,8178,7608
050,34,017,"New Jersey","Hudson County",3,33,15088,7894,7194
050,34,017,"New Jersey","Hudson County",3,34,14415,7580,6835
050,34,017,"New Jersey","Hudson County",3,35,13965,7352,6613
050,34,017,"New Jersey","Hudson County",3,36,13430,7041,6389
050,34,017,"New Jersey","Hudson County",3,37,12889,6828,6061
050,34,017,"New Jersey","Hudson County",3,38,12470,6638,5832
050,34,017,"New Jersey","Hudson County",3,39,11836,6317,5519
050,34,017,"New Jersey","Hudson County",3,40,11225,5932,5293
050,34,017,"New Jersey","Hudson County",3,41,10945,5703,5242
050,34,017,"New Jersey","Hudson County",3,42,10175,5299,4876
050,34,017,"New Jersey","Hudson County",3,43,9543,4939,4604
050,34,017,"New Jersey","Hudson County",3,44,9291,4783,4508
050,34,017,"New Jersey","Hudson County",3,45,8824,4517,4307
050,34,017,"New Jersey","Hudson County",3,46,8807,4531,4276
050,34,017,"New Jersey","Hudson County",3,47,8376,4339,4037
050,34,017,"New Jersey","Hudson County",3,48,8298,4250,4048
050,34,017,"New Jersey","Hudson County",3,49,8424,4298,4126
050,34,017,"New Jersey","Hudson County",3,50,8751,4366,4385
050,34,017,"New Jersey","Hudson County",3,51,8522,4189,4333
050,34,017,"New Jersey","Hudson County",3,52,8118,3928,4190
050,34,017,"New Jersey","Hudson County",3,53,8101,3965,4136
050,34,017,"New Jersey","Hudson County",3,54,8121,4033,4088
050,34,017,"New Jersey","Hudson County",3,55,8223,4125,4098
050,34,017,"New Jersey","Hudson County",3,56,8227,4034,4193
050,34,017,"New Jersey","Hudson County",3,57,8209,4045,4164
050,34,017,"New Jersey","Hudson County",3,58,8123,3973,4150
050,34,017,"New Jersey","Hudson County",3,59,7875,3850,4025
050,34,017,"New Jersey","Hudson County",3,60,7702,3853,3849
050,34,017,"New Jersey","Hudson County",3,61,7657,3778,3879
050,34,017,"New Jersey","Hudson County",3,62,7335,3606,3729
050,34,017,"New Jersey","Hudson County",3,63,7016,3398,3618
050,34,017,"New Jersey","Hudson County",3,64,6809,3183,3626
050,34,017,"New Jersey","Hudson County",3,65,6515,3069,3446
050,34,017,"New Jersey","Hudson County",3,66,6359,2911,3448
050,34,017,"New Jersey","Hudson County",3,67,5870,2680,3190
050,34,017,"New Jersey","Hudson County",3,68,5537,2550,2987
050,34,017,"New Jersey","Hudson County",3,69,5274,2424,2850
050,34,017,"New Jersey","Hudson County",3,70,4946,2183,2763
050,34,017,"New Jersey","Hudson County",3,71,4768,2127,2641
050,34,017,"New Jersey","Hudson County",3,72,4535,2030,2505
050,34,017,"New Jersey","Hudson County",3,73,4382,1903,2479
050,34,017,"New Jersey","Hudson County",3,74,4462,1929,2533
050,34,017,"New Jersey","Hudson County",3,75,3468,1464,2004
050,34,017,"New Jersey","Hudson County",3,76,3258,1374,1884
050,34,017,"New Jersey","Hudson County",3,77,3027,1264,1763
050,34,017,"New Jersey","Hudson County",3,78,2952,1206,1746
050,34,017,"New Jersey","Hudson County",3,79,2607,1027,1580
050,34,017,"New Jersey","Hudson County",3,80,2428,953,1475
050,34,017,"New Jersey","Hudson County",3,81,2248,871,1377
050,34,017,"New Jersey","Hudson County",3,82,2111,807,1304
050,34,017,"New Jersey","Hudson County",3,83,1894,722,1172
050,34,017,"New Jersey","Hudson County",3,84,1706,653,1053
050,34,017,"New Jersey","Hudson County",3,85,10226,3465,6761
050,34,017,"New Jersey","Hudson County",4,0,9236,4726,4510
050,34,017,"New Jersey","Hudson County",4,1,8632,4474,4158
050,34,017,"New Jersey","Hudson County",4,2,8886,4552,4334
050,34,017,"New Jersey","Hudson County",4,3,8559,4333,4226
050,34,017,"New Jersey","Hudson County",4,4,8361,4326,4035
050,34,017,"New Jersey","Hudson County",4,5,8143,4146,3997
050,34,017,"New Jersey","Hudson County",4,6,7891,3999,3892
050,34,017,"New Jersey","Hudson County",4,7,7607,3886,3721
050,34,017,"New Jersey","Hudson County",4,8,7384,3848,3536
050,34,017,"New Jersey","Hudson County",4,9,7377,3751,3626
050,34,017,"New Jersey","Hudson County",4,10,7234,3694,3540
050,34,017,"New Jersey","Hudson County",4,11,7307,3700,3607
050,34,017,"New Jersey","Hudson County",4,12,7153,3638,3515
050,34,017,"New Jersey","Hudson County",4,13,7053,3590,3463
050,34,017,"New Jersey","Hudson County",4,14,7309,3686,3623
050,34,017,"New Jersey","Hudson County",4,15,7236,3680,3556
050,34,017,"New Jersey","Hudson County",4,16,6985,3573,3412
050,34,017,"New Jersey","Hudson County",4,17,6806,3469,3337
050,34,017,"New Jersey","Hudson County",4,18,6813,3534,3279
050,34,017,"New Jersey","Hudson County",4,19,6430,3394,3036
050,34,017,"New Jersey","Hudson County",4,20,6615,3455,3160
050,34,017,"New Jersey","Hudson County",4,21,7003,3634,3369
050,34,017,"New Jersey","Hudson County",4,22,7554,3906,3648
050,34,017,"New Jersey","Hudson County",4,23,8304,4168,4136
050,34,017,"New Jersey","Hudson County",4,24,9709,4906,4803
050,34,017,"New Jersey","Hudson County",4,25,10991,5561,5430
050,34,017,"New Jersey","Hudson County",4,26,12675,6290,6385
050,34,017,"New Jersey","Hudson County",4,27,14036,6894,7142
050,34,017,"New Jersey","Hudson County",4,28,14454,7193,7261
050,34,017,"New Jersey","Hudson County",4,29,15195,7746,7449
050,34,017,"New Jersey","Hudson County",4,30,15821,8104,7717
050,34,017,"New Jersey","Hudson County",4,31,16039,8282,7757
050,34,017,"New Jersey","Hudson County",4,32,16042,8298,7744
050,34,017,"New Jersey","Hudson County",4,33,15517,8123,7394
050,34,017,"New Jersey","Hudson County",4,34,14655,7632,7023
050,34,017,"New Jersey","Hudson County",4,35,13988,7312,6676
050,34,017,"New Jersey","Hudson County",4,36,13397,7068,6329
050,34,017,"New Jersey","Hudson County",4,37,12752,6677,6075
050,34,017,"New Jersey","Hudson County",4,38,12167,6485,5682
050,34,017,"New Jersey","Hudson County",4,39,11848,6336,5512
050,34,017,"New Jersey","Hudson County",4,40,11289,5992,5297
050,34,017,"New Jersey","Hudson County",4,41,10681,5623,5058
050,34,017,"New Jersey","Hudson County",4,42,10497,5446,5051
050,34,017,"New Jersey","Hudson County",4,43,9736,5022,4714
050,34,017,"New Jersey","Hudson County",4,44,9228,4743,4485
050,34,017,"New Jersey","Hudson County",4,45,8976,4599,4377
050,34,017,"New Jersey","Hudson County",4,46,8477,4322,4155
050,34,017,"New Jersey","Hudson County",4,47,8540,4377,4163
050,34,017,"New Jersey","Hudson County",4,48,8099,4160,3939
050,34,017,"New Jersey","Hudson County",4,49,8043,4098,3945
050,34,017,"New Jersey","Hudson County",4,50,8186,4160,4026
050,34,017,"New Jersey","Hudson County",4,51,8524,4228,4296
050,34,017,"New Jersey","Hudson County",4,52,8362,4073,4289
050,34,017,"New Jersey","Hudson County",4,53,7953,3845,4108
050,34,017,"New Jersey","Hudson County",4,54,7936,3870,4066
050,34,017,"New Jersey","Hudson County",4,55,8020,3975,4045
050,34,017,"New Jersey","Hudson County",4,56,8084,4021,4063
050,34,017,"New Jersey","Hudson County",4,57,8063,3946,4117
050,34,017,"New Jersey","Hudson County",4,58,7991,3941,4050
050,34,017,"New Jersey","Hudson County",4,59,7967,3879,4088
050,34,017,"New Jersey","Hudson County",4,60,7681,3754,3927
050,34,017,"New Jersey","Hudson County",4,61,7488,3725,3763
050,34,017,"New Jersey","Hudson County",4,62,7432,3654,3778
050,34,017,"New Jersey","Hudson County",4,63,7088,3456,3632
050,34,017,"New Jersey","Hudson County",4,64,6778,3264,3514
050,34,017,"New Jersey","Hudson County",4,65,6599,3060,3539
050,34,017,"New Jersey","Hudson County",4,66,6256,2952,3304
050,34,017,"New Jersey","Hudson County",4,67,6095,2791,3304
050,34,017,"New Jersey","Hudson County",4,68,5638,2562,3076
050,34,017,"New Jersey","Hudson County",4,69,5359,2451,2908
050,34,017,"New Jersey","Hudson County",4,70,5056,2305,2751
050,34,017,"New Jersey","Hudson County",4,71,4749,2084,2665
050,34,017,"New Jersey","Hudson County",4,72,4609,2039,2570
050,34,017,"New Jersey","Hudson County",4,73,4358,1926,2432
050,34,017,"New Jersey","Hudson County",4,74,4167,1780,2387
050,34,017,"New Jersey","Hudson County",4,75,4211,1830,2381
050,34,017,"New Jersey","Hudson County",4,76,3316,1386,1930
050,34,017,"New Jersey","Hudson County",4,77,3105,1296,1809
050,34,017,"New Jersey","Hudson County",4,78,2859,1183,1676
050,34,017,"New Jersey","Hudson County",4,79,2783,1120,1663
050,34,017,"New Jersey","Hudson County",4,80,2463,947,1516
050,34,017,"New Jersey","Hudson County",4,81,2256,880,1376
050,34,017,"New Jersey","Hudson County",4,82,2114,814,1300
050,34,017,"New Jersey","Hudson County",4,83,1965,749,1216
050,34,017,"New Jersey","Hudson County",4,84,1755,678,1077
050,34,017,"New Jersey","Hudson County",4,85,10385,3547,6838
050,34,017,"New Jersey","Hudson County",5,0,9007,4578,4429
050,34,017,"New Jersey","Hudson County",5,1,8607,4388,4219
050,34,017,"New Jersey","Hudson County",5,2,8129,4260,3869
050,34,017,"New Jersey","Hudson County",5,3,8316,4273,4043
050,34,017,"New Jersey","Hudson County",5,4,8107,4097,4010
050,34,017,"New Jersey","Hudson County",5,5,8062,4142,3920
050,34,017,"New Jersey","Hudson County",5,6,7772,3943,3829
050,34,017,"New Jersey","Hudson County",5,7,7578,3859,3719
050,34,017,"New Jersey","Hudson County",5,8,7313,3739,3574
050,34,017,"New Jersey","Hudson County",5,9,7196,3706,3490
050,34,017,"New Jersey","Hudson County",5,10,7196,3655,3541
050,34,017,"New Jersey","Hudson County",5,11,7157,3663,3494
050,34,017,"New Jersey","Hudson County",5,12,7123,3613,3510
050,34,017,"New Jersey","Hudson County",5,13,7024,3564,3460
050,34,017,"New Jersey","Hudson County",5,14,6990,3561,3429
050,34,017,"New Jersey","Hudson County",5,15,7294,3708,3586
050,34,017,"New Jersey","Hudson County",5,16,7225,3659,3566
050,34,017,"New Jersey","Hudson County",5,17,7059,3642,3417
050,34,017,"New Jersey","Hudson County",5,18,6789,3585,3204
050,34,017,"New Jersey","Hudson County",5,19,6578,3457,3121
050,34,017,"New Jersey","Hudson County",5,20,6701,3474,3227
050,34,017,"New Jersey","Hudson County",5,21,6928,3611,3317
050,34,017,"New Jersey","Hudson County",5,22,7645,3942,3703
050,34,017,"New Jersey","Hudson County",5,23,8853,4491,4362
050,34,017,"New Jersey","Hudson County",5,24,9919,5028,4891
050,34,017,"New Jersey","Hudson County",5,25,11374,5841,5533
050,34,017,"New Jersey","Hudson County",5,26,12843,6472,6371
050,34,017,"New Jersey","Hudson County",5,27,14250,7157,7093
050,34,017,"New Jersey","Hudson County",5,28,15209,7556,7653
050,34,017,"New Jersey","Hudson County",5,29,15174,7589,7585
050,34,017,"New Jersey","Hudson County",5,30,15865,8078,7787
050,34,017,"New Jersey","Hudson County",5,31,16073,8288,7785
050,34,017,"New Jersey","Hudson County",5,32,16003,8394,7609
050,34,017,"New Jersey","Hudson County",5,33,15778,8202,7576
050,34,017,"New Jersey","Hudson County",5,34,15021,7894,7127
050,34,017,"New Jersey","Hudson County",5,35,14188,7387,6801
050,34,017,"New Jersey","Hudson County",5,36,13437,7004,6433
050,34,017,"New Jersey","Hudson County",5,37,12826,6771,6055
050,34,017,"New Jersey","Hudson County",5,38,12203,6438,5765
050,34,017,"New Jersey","Hudson County",5,39,11580,6105,5475
050,34,017,"New Jersey","Hudson County",5,40,11302,6003,5299
050,34,017,"New Jersey","Hudson County",5,41,10719,5679,5040
050,34,017,"New Jersey","Hudson County",5,42,10220,5361,4859
050,34,017,"New Jersey","Hudson County",5,43,10103,5208,4895
050,34,017,"New Jersey","Hudson County",5,44,9401,4794,4607
050,34,017,"New Jersey","Hudson County",5,45,8983,4586,4397
050,34,017,"New Jersey","Hudson County",5,46,8758,4470,4288
050,34,017,"New Jersey","Hudson County",5,47,8371,4275,4096
050,34,017,"New Jersey","Hudson County",5,48,8394,4261,4133
050,34,017,"New Jersey","Hudson County",5,49,7921,4027,3894
050,34,017,"New Jersey","Hudson County",5,50,7945,4043,3902
050,34,017,"New Jersey","Hudson County",5,51,8047,4063,3984
050,34,017,"New Jersey","Hudson County",5,52,8386,4145,4241
050,34,017,"New Jersey","Hudson County",5,53,8199,3993,4206
050,34,017,"New Jersey","Hudson County",5,54,7759,3712,4047
050,34,017,"New Jersey","Hudson County",5,55,7852,3822,4030
050,34,017,"New Jersey","Hudson County",5,56,7890,3903,3987
050,34,017,"New Jersey","Hudson County",5,57,7916,3946,3970
050,34,017,"New Jersey","Hudson County",5,58,7908,3845,4063
050,34,017,"New Jersey","Hudson County",5,59,7800,3847,3953
050,34,017,"New Jersey","Hudson County",5,60,7780,3784,3996
050,34,017,"New Jersey","Hudson County",5,61,7530,3667,3863
050,34,017,"New Jersey","Hudson County",5,62,7288,3606,3682
050,34,017,"New Jersey","Hudson County",5,63,7204,3526,3678
050,34,017,"New Jersey","Hudson County",5,64,6909,3365,3544
050,34,017,"New Jersey","Hudson County",5,65,6600,3165,3435
050,34,017,"New Jersey","Hudson County",5,66,6427,2965,3462
050,34,017,"New Jersey","Hudson County",5,67,6051,2839,3212
050,34,017,"New Jersey","Hudson County",5,68,5909,2703,3206
050,34,017,"New Jersey","Hudson County",5,69,5541,2516,3025
050,34,017,"New Jersey","Hudson County",5,70,5153,2336,2817
050,34,017,"New Jersey","Hudson County",5,71,4929,2250,2679
050,34,017,"New Jersey","Hudson County",5,72,4622,2014,2608
050,34,017,"New Jersey","Hudson County",5,73,4409,1936,2473
050,34,017,"New Jersey","Hudson County",5,74,4204,1832,2372
050,34,017,"New Jersey","Hudson County",5,75,3999,1703,2296
050,34,017,"New Jersey","Hudson County",5,76,4074,1751,2323
050,34,017,"New Jersey","Hudson County",5,77,3198,1322,1876
050,34,017,"New Jersey","Hudson County",5,78,2962,1238,1724
050,34,017,"New Jersey","Hudson County",5,79,2717,1123,1594
050,34,017,"New Jersey","Hudson County",5,80,2649,1056,1593
050,34,017,"New Jersey","Hudson County",5,81,2329,883,1446
050,34,017,"New Jersey","Hudson County",5,82,2156,836,1320
050,34,017,"New Jersey","Hudson County",5,83,2007,769,1238
050,34,017,"New Jersey","Hudson County",5,84,1843,708,1135
050,34,017,"New Jersey","Hudson County",5,85,10716,3696,7020
050,34,019,"New Jersey","Hunterdon County",1,0,1002,509,493
050,34,019,"New Jersey","Hunterdon County",1,1,1039,509,530
050,34,019,"New Jersey","Hunterdon County",1,2,1127,553,574
050,34,019,"New Jersey","Hunterdon County",1,3,1151,573,578
050,34,019,"New Jersey","Hunterdon County",1,4,1201,584,617
050,34,019,"New Jersey","Hunterdon County",1,5,1225,581,644
050,34,019,"New Jersey","Hunterdon County",1,6,1264,646,618
050,34,019,"New Jersey","Hunterdon County",1,7,1243,632,611
050,34,019,"New Jersey","Hunterdon County",1,8,1286,671,615
050,34,019,"New Jersey","Hunterdon County",1,9,1342,683,659
050,34,019,"New Jersey","Hunterdon County",1,10,1376,730,646
050,34,019,"New Jersey","Hunterdon County",1,11,1494,780,714
050,34,019,"New Jersey","Hunterdon County",1,12,1540,794,746
050,34,019,"New Jersey","Hunterdon County",1,13,1630,854,776
050,34,019,"New Jersey","Hunterdon County",1,14,1647,846,801
050,34,019,"New Jersey","Hunterdon County",1,15,1736,869,867
050,34,019,"New Jersey","Hunterdon County",1,16,1812,917,895
050,34,019,"New Jersey","Hunterdon County",1,17,1863,933,930
050,34,019,"New Jersey","Hunterdon County",1,18,1581,847,734
050,34,019,"New Jersey","Hunterdon County",1,19,1334,713,621
050,34,019,"New Jersey","Hunterdon County",1,20,1466,759,707
050,34,019,"New Jersey","Hunterdon County",1,21,1501,744,757
050,34,019,"New Jersey","Hunterdon County",1,22,1527,751,776
050,34,019,"New Jersey","Hunterdon County",1,23,1472,725,747
050,34,019,"New Jersey","Hunterdon County",1,24,1363,656,707
050,34,019,"New Jersey","Hunterdon County",1,25,1288,644,644
050,34,019,"New Jersey","Hunterdon County",1,26,1247,642,605
050,34,019,"New Jersey","Hunterdon County",1,27,1267,653,614
050,34,019,"New Jersey","Hunterdon County",1,28,1102,547,555
050,34,019,"New Jersey","Hunterdon County",1,29,1087,571,516
050,34,019,"New Jersey","Hunterdon County",1,30,1112,542,570
050,34,019,"New Jersey","Hunterdon County",1,31,1157,544,613
050,34,019,"New Jersey","Hunterdon County",1,32,1184,550,634
050,34,019,"New Jersey","Hunterdon County",1,33,1283,627,656
050,34,019,"New Jersey","Hunterdon County",1,34,1276,626,650
050,34,019,"New Jersey","Hunterdon County",1,35,1350,683,667
050,34,019,"New Jersey","Hunterdon County",1,36,1369,701,668
050,34,019,"New Jersey","Hunterdon County",1,37,1415,706,709
050,34,019,"New Jersey","Hunterdon County",1,38,1427,710,717
050,34,019,"New Jersey","Hunterdon County",1,39,1507,743,764
050,34,019,"New Jersey","Hunterdon County",1,40,1474,718,756
050,34,019,"New Jersey","Hunterdon County",1,41,1472,708,764
050,34,019,"New Jersey","Hunterdon County",1,42,1531,747,784
050,34,019,"New Jersey","Hunterdon County",1,43,1533,735,798
050,34,019,"New Jersey","Hunterdon County",1,44,1503,742,761
050,34,019,"New Jersey","Hunterdon County",1,45,1531,777,754
050,34,019,"New Jersey","Hunterdon County",1,46,1551,766,785
050,34,019,"New Jersey","Hunterdon County",1,47,1663,802,861
050,34,019,"New Jersey","Hunterdon County",1,48,1857,885,972
050,34,019,"New Jersey","Hunterdon County",1,49,2093,1009,1084
050,34,019,"New Jersey","Hunterdon County",1,50,2057,995,1062
050,34,019,"New Jersey","Hunterdon County",1,51,2084,993,1091
050,34,019,"New Jersey","Hunterdon County",1,52,2064,993,1071
050,34,019,"New Jersey","Hunterdon County",1,53,2178,1059,1119
050,34,019,"New Jersey","Hunterdon County",1,54,2279,1094,1185
050,34,019,"New Jersey","Hunterdon County",1,55,2434,1162,1272
050,34,019,"New Jersey","Hunterdon County",1,56,2460,1194,1266
050,34,019,"New Jersey","Hunterdon County",1,57,2388,1193,1195
050,34,019,"New Jersey","Hunterdon County",1,58,2404,1211,1193
050,34,019,"New Jersey","Hunterdon County",1,59,2335,1183,1152
050,34,019,"New Jersey","Hunterdon County",1,60,2298,1162,1136
050,34,019,"New Jersey","Hunterdon County",1,61,2290,1174,1116
050,34,019,"New Jersey","Hunterdon County",1,62,2252,1125,1127
050,34,019,"New Jersey","Hunterdon County",1,63,2106,1055,1051
050,34,019,"New Jersey","Hunterdon County",1,64,1969,996,973
050,34,019,"New Jersey","Hunterdon County",1,65,1894,948,946
050,34,019,"New Jersey","Hunterdon County",1,66,1801,907,894
050,34,019,"New Jersey","Hunterdon County",1,67,1706,861,845
050,34,019,"New Jersey","Hunterdon County",1,68,1576,797,779
050,34,019,"New Jersey","Hunterdon County",1,69,1436,715,721
050,34,019,"New Jersey","Hunterdon County",1,70,1411,718,693
050,34,019,"New Jersey","Hunterdon County",1,71,1363,692,671
050,34,019,"New Jersey","Hunterdon County",1,72,1376,677,699
050,34,019,"New Jersey","Hunterdon County",1,73,1382,656,726
050,34,019,"New Jersey","Hunterdon County",1,74,981,457,524
050,34,019,"New Jersey","Hunterdon County",1,75,935,447,488
050,34,019,"New Jersey","Hunterdon County",1,76,965,444,521
050,34,019,"New Jersey","Hunterdon County",1,77,978,462,516
050,34,019,"New Jersey","Hunterdon County",1,78,860,402,458
050,34,019,"New Jersey","Hunterdon County",1,79,684,327,357
050,34,019,"New Jersey","Hunterdon County",1,80,638,315,323
050,34,019,"New Jersey","Hunterdon County",1,81,579,253,326
050,34,019,"New Jersey","Hunterdon County",1,82,551,261,290
050,34,019,"New Jersey","Hunterdon County",1,83,437,202,235
050,34,019,"New Jersey","Hunterdon County",1,84,391,161,230
050,34,019,"New Jersey","Hunterdon County",1,85,2907,1008,1899
050,34,019,"New Jersey","Hunterdon County",2,0,1029,526,503
050,34,019,"New Jersey","Hunterdon County",2,1,1037,514,523
050,34,019,"New Jersey","Hunterdon County",2,2,1110,542,568
050,34,019,"New Jersey","Hunterdon County",2,3,1153,570,583
050,34,019,"New Jersey","Hunterdon County",2,4,1199,588,611
050,34,019,"New Jersey","Hunterdon County",2,5,1233,591,642
050,34,019,"New Jersey","Hunterdon County",2,6,1268,638,630
050,34,019,"New Jersey","Hunterdon County",2,7,1257,639,618
050,34,019,"New Jersey","Hunterdon County",2,8,1277,660,617
050,34,019,"New Jersey","Hunterdon County",2,9,1335,683,652
050,34,019,"New Jersey","Hunterdon County",2,10,1370,719,651
050,34,019,"New Jersey","Hunterdon County",2,11,1468,770,698
050,34,019,"New Jersey","Hunterdon County",2,12,1544,797,747
050,34,019,"New Jersey","Hunterdon County",2,13,1608,839,769
050,34,019,"New Jersey","Hunterdon County",2,14,1641,849,792
050,34,019,"New Jersey","Hunterdon County",2,15,1719,866,853
050,34,019,"New Jersey","Hunterdon County",2,16,1797,910,887
050,34,019,"New Jersey","Hunterdon County",2,17,1852,932,920
050,34,019,"New Jersey","Hunterdon County",2,18,1569,831,738
050,34,019,"New Jersey","Hunterdon County",2,19,1324,709,615
050,34,019,"New Jersey","Hunterdon County",2,20,1478,769,709
050,34,019,"New Jersey","Hunterdon County",2,21,1504,752,752
050,34,019,"New Jersey","Hunterdon County",2,22,1511,743,768
050,34,019,"New Jersey","Hunterdon County",2,23,1471,723,748
050,34,019,"New Jersey","Hunterdon County",2,24,1362,657,705
050,34,019,"New Jersey","Hunterdon County",2,25,1288,639,649
050,34,019,"New Jersey","Hunterdon County",2,26,1248,642,606
050,34,019,"New Jersey","Hunterdon County",2,27,1260,647,613
050,34,019,"New Jersey","Hunterdon County",2,28,1152,580,572
050,34,019,"New Jersey","Hunterdon County",2,29,1101,570,531
050,34,019,"New Jersey","Hunterdon County",2,30,1125,557,568
050,34,019,"New Jersey","Hunterdon County",2,31,1145,538,607
050,34,019,"New Jersey","Hunterdon County",2,32,1183,555,628
050,34,019,"New Jersey","Hunterdon County",2,33,1263,613,650
050,34,019,"New Jersey","Hunterdon County",2,34,1282,627,655
050,34,019,"New Jersey","Hunterdon County",2,35,1349,676,673
050,34,019,"New Jersey","Hunterdon County",2,36,1361,698,663
050,34,019,"New Jersey","Hunterdon County",2,37,1414,710,704
050,34,019,"New Jersey","Hunterdon County",2,38,1439,716,723
050,34,019,"New Jersey","Hunterdon County",2,39,1492,736,756
050,34,019,"New Jersey","Hunterdon County",2,40,1493,731,762
050,34,019,"New Jersey","Hunterdon County",2,41,1484,714,770
050,34,019,"New Jersey","Hunterdon County",2,42,1523,744,779
050,34,019,"New Jersey","Hunterdon County",2,43,1550,746,804
050,34,019,"New Jersey","Hunterdon County",2,44,1502,737,765
050,34,019,"New Jersey","Hunterdon County",2,45,1538,776,762
050,34,019,"New Jersey","Hunterdon County",2,46,1553,773,780
050,34,019,"New Jersey","Hunterdon County",2,47,1633,790,843
050,34,019,"New Jersey","Hunterdon County",2,48,1810,866,944
050,34,019,"New Jersey","Hunterdon County",2,49,2047,981,1066
050,34,019,"New Jersey","Hunterdon County",2,50,2064,1000,1064
050,34,019,"New Jersey","Hunterdon County",2,51,2065,990,1075
050,34,019,"New Jersey","Hunterdon County",2,52,2057,987,1070
050,34,019,"New Jersey","Hunterdon County",2,53,2148,1044,1104
050,34,019,"New Jersey","Hunterdon County",2,54,2245,1080,1165
050,34,019,"New Jersey","Hunterdon County",2,55,2387,1140,1247
050,34,019,"New Jersey","Hunterdon County",2,56,2445,1188,1257
050,34,019,"New Jersey","Hunterdon County",2,57,2396,1187,1209
050,34,019,"New Jersey","Hunterdon County",2,58,2388,1206,1182
050,34,019,"New Jersey","Hunterdon County",2,59,2346,1181,1165
050,34,019,"New Jersey","Hunterdon County",2,60,2293,1162,1131
050,34,019,"New Jersey","Hunterdon County",2,61,2273,1160,1113
050,34,019,"New Jersey","Hunterdon County",2,62,2250,1132,1118
050,34,019,"New Jersey","Hunterdon County",2,63,2147,1073,1074
050,34,019,"New Jersey","Hunterdon County",2,64,1977,998,979
050,34,019,"New Jersey","Hunterdon County",2,65,1897,945,952
050,34,019,"New Jersey","Hunterdon County",2,66,1817,912,905
050,34,019,"New Jersey","Hunterdon County",2,67,1719,870,849
050,34,019,"New Jersey","Hunterdon County",2,68,1581,798,783
050,34,019,"New Jersey","Hunterdon County",2,69,1471,735,736
050,34,019,"New Jersey","Hunterdon County",2,70,1406,709,697
050,34,019,"New Jersey","Hunterdon County",2,71,1370,695,675
050,34,019,"New Jersey","Hunterdon County",2,72,1342,664,678
050,34,019,"New Jersey","Hunterdon County",2,73,1438,687,751
050,34,019,"New Jersey","Hunterdon County",2,74,1002,468,534
050,34,019,"New Jersey","Hunterdon County",2,75,941,446,495
050,34,019,"New Jersey","Hunterdon County",2,76,945,433,512
050,34,019,"New Jersey","Hunterdon County",2,77,994,470,524
050,34,019,"New Jersey","Hunterdon County",2,78,864,407,457
050,34,019,"New Jersey","Hunterdon County",2,79,706,339,367
050,34,019,"New Jersey","Hunterdon County",2,80,646,315,331
050,34,019,"New Jersey","Hunterdon County",2,81,575,251,324
050,34,019,"New Jersey","Hunterdon County",2,82,545,256,289
050,34,019,"New Jersey","Hunterdon County",2,83,449,207,242
050,34,019,"New Jersey","Hunterdon County",2,84,391,163,228
050,34,019,"New Jersey","Hunterdon County",2,85,2855,994,1861
050,34,019,"New Jersey","Hunterdon County",3,0,965,483,482
050,34,019,"New Jersey","Hunterdon County",3,1,1125,583,542
050,34,019,"New Jersey","Hunterdon County",3,2,1100,556,544
050,34,019,"New Jersey","Hunterdon County",3,3,1198,579,619
050,34,019,"New Jersey","Hunterdon County",3,4,1229,615,614
050,34,019,"New Jersey","Hunterdon County",3,5,1265,619,646
050,34,019,"New Jersey","Hunterdon County",3,6,1283,624,659
050,34,019,"New Jersey","Hunterdon County",3,7,1343,665,678
050,34,019,"New Jersey","Hunterdon County",3,8,1300,676,624
050,34,019,"New Jersey","Hunterdon County",3,9,1340,679,661
050,34,019,"New Jersey","Hunterdon County",3,10,1376,708,668
050,34,019,"New Jersey","Hunterdon County",3,11,1407,722,685
050,34,019,"New Jersey","Hunterdon County",3,12,1493,779,714
050,34,019,"New Jersey","Hunterdon County",3,13,1564,798,766
050,34,019,"New Jersey","Hunterdon County",3,14,1625,842,783
050,34,019,"New Jersey","Hunterdon County",3,15,1666,863,803
050,34,019,"New Jersey","Hunterdon County",3,16,1723,869,854
050,34,019,"New Jersey","Hunterdon County",3,17,1796,909,887
050,34,019,"New Jersey","Hunterdon County",3,18,1569,804,765
050,34,019,"New Jersey","Hunterdon County",3,19,1255,663,592
050,34,019,"New Jersey","Hunterdon County",3,20,1435,749,686
050,34,019,"New Jersey","Hunterdon County",3,21,1533,801,732
050,34,019,"New Jersey","Hunterdon County",3,22,1571,755,816
050,34,019,"New Jersey","Hunterdon County",3,23,1484,736,748
050,34,019,"New Jersey","Hunterdon County",3,24,1426,698,728
050,34,019,"New Jersey","Hunterdon County",3,25,1295,615,680
050,34,019,"New Jersey","Hunterdon County",3,26,1271,641,630
050,34,019,"New Jersey","Hunterdon County",3,27,1287,672,615
050,34,019,"New Jersey","Hunterdon County",3,28,1254,651,603
050,34,019,"New Jersey","Hunterdon County",3,29,1225,617,608
050,34,019,"New Jersey","Hunterdon County",3,30,1205,608,597
050,34,019,"New Jersey","Hunterdon County",3,31,1218,606,612
050,34,019,"New Jersey","Hunterdon County",3,32,1238,592,646
050,34,019,"New Jersey","Hunterdon County",3,33,1302,631,671
050,34,019,"New Jersey","Hunterdon County",3,34,1340,655,685
050,34,019,"New Jersey","Hunterdon County",3,35,1386,668,718
050,34,019,"New Jersey","Hunterdon County",3,36,1444,735,709
050,34,019,"New Jersey","Hunterdon County",3,37,1451,738,713
050,34,019,"New Jersey","Hunterdon County",3,38,1479,737,742
050,34,019,"New Jersey","Hunterdon County",3,39,1507,749,758
050,34,019,"New Jersey","Hunterdon County",3,40,1523,753,770
050,34,019,"New Jersey","Hunterdon County",3,41,1557,760,797
050,34,019,"New Jersey","Hunterdon County",3,42,1528,758,770
050,34,019,"New Jersey","Hunterdon County",3,43,1568,762,806
050,34,019,"New Jersey","Hunterdon County",3,44,1562,760,802
050,34,019,"New Jersey","Hunterdon County",3,45,1522,748,774
050,34,019,"New Jersey","Hunterdon County",3,46,1605,818,787
050,34,019,"New Jersey","Hunterdon County",3,47,1538,772,766
050,34,019,"New Jersey","Hunterdon County",3,48,1624,797,827
050,34,019,"New Jersey","Hunterdon County",3,49,1783,838,945
050,34,019,"New Jersey","Hunterdon County",3,50,2006,975,1031
050,34,019,"New Jersey","Hunterdon County",3,51,2051,1009,1042
050,34,019,"New Jersey","Hunterdon County",3,52,2027,973,1054
050,34,019,"New Jersey","Hunterdon County",3,53,2033,987,1046
050,34,019,"New Jersey","Hunterdon County",3,54,2127,1041,1086
050,34,019,"New Jersey","Hunterdon County",3,55,2217,1060,1157
050,34,019,"New Jersey","Hunterdon County",3,56,2308,1096,1212
050,34,019,"New Jersey","Hunterdon County",3,57,2402,1157,1245
050,34,019,"New Jersey","Hunterdon County",3,58,2346,1188,1158
050,34,019,"New Jersey","Hunterdon County",3,59,2321,1162,1159
050,34,019,"New Jersey","Hunterdon County",3,60,2308,1167,1141
050,34,019,"New Jersey","Hunterdon County",3,61,2233,1138,1095
050,34,019,"New Jersey","Hunterdon County",3,62,2230,1119,1111
050,34,019,"New Jersey","Hunterdon County",3,63,2182,1075,1107
050,34,019,"New Jersey","Hunterdon County",3,64,2121,1049,1072
050,34,019,"New Jersey","Hunterdon County",3,65,1911,947,964
050,34,019,"New Jersey","Hunterdon County",3,66,1835,910,925
050,34,019,"New Jersey","Hunterdon County",3,67,1780,893,887
050,34,019,"New Jersey","Hunterdon County",3,68,1680,851,829
050,34,019,"New Jersey","Hunterdon County",3,69,1555,787,768
050,34,019,"New Jersey","Hunterdon County",3,70,1450,727,723
050,34,019,"New Jersey","Hunterdon County",3,71,1371,693,678
050,34,019,"New Jersey","Hunterdon County",3,72,1340,674,666
050,34,019,"New Jersey","Hunterdon County",3,73,1324,650,674
050,34,019,"New Jersey","Hunterdon County",3,74,1400,662,738
050,34,019,"New Jersey","Hunterdon County",3,75,961,444,517
050,34,019,"New Jersey","Hunterdon County",3,76,929,427,502
050,34,019,"New Jersey","Hunterdon County",3,77,921,427,494
050,34,019,"New Jersey","Hunterdon County",3,78,977,456,521
050,34,019,"New Jersey","Hunterdon County",3,79,828,381,447
050,34,019,"New Jersey","Hunterdon County",3,80,708,342,366
050,34,019,"New Jersey","Hunterdon County",3,81,620,292,328
050,34,019,"New Jersey","Hunterdon County",3,82,543,247,296
050,34,019,"New Jersey","Hunterdon County",3,83,494,224,270
050,34,019,"New Jersey","Hunterdon County",3,84,433,202,231
050,34,019,"New Jersey","Hunterdon County",3,85,2916,1016,1900
050,34,019,"New Jersey","Hunterdon County",4,0,1107,572,535
050,34,019,"New Jersey","Hunterdon County",4,1,1017,521,496
050,34,019,"New Jersey","Hunterdon County",4,2,1188,608,580
050,34,019,"New Jersey","Hunterdon County",4,3,1164,591,573
050,34,019,"New Jersey","Hunterdon County",4,4,1238,611,627
050,34,019,"New Jersey","Hunterdon County",4,5,1272,641,631
050,34,019,"New Jersey","Hunterdon County",4,6,1311,650,661
050,34,019,"New Jersey","Hunterdon County",4,7,1343,657,686
050,34,019,"New Jersey","Hunterdon County",4,8,1389,702,687
050,34,019,"New Jersey","Hunterdon County",4,9,1333,680,653
050,34,019,"New Jersey","Hunterdon County",4,10,1391,710,681
050,34,019,"New Jersey","Hunterdon County",4,11,1408,723,685
050,34,019,"New Jersey","Hunterdon County",4,12,1445,736,709
050,34,019,"New Jersey","Hunterdon County",4,13,1518,793,725
050,34,019,"New Jersey","Hunterdon County",4,14,1599,823,776
050,34,019,"New Jersey","Hunterdon County",4,15,1647,857,790
050,34,019,"New Jersey","Hunterdon County",4,16,1662,863,799
050,34,019,"New Jersey","Hunterdon County",4,17,1719,869,850
050,34,019,"New Jersey","Hunterdon County",4,18,1494,775,719
050,34,019,"New Jersey","Hunterdon County",4,19,1190,624,566
050,34,019,"New Jersey","Hunterdon County",4,20,1336,690,646
050,34,019,"New Jersey","Hunterdon County",4,21,1482,788,694
050,34,019,"New Jersey","Hunterdon County",4,22,1576,803,773
050,34,019,"New Jersey","Hunterdon County",4,23,1492,721,771
050,34,019,"New Jersey","Hunterdon County",4,24,1341,669,672
050,34,019,"New Jersey","Hunterdon County",4,25,1303,637,666
050,34,019,"New Jersey","Hunterdon County",4,26,1204,588,616
050,34,019,"New Jersey","Hunterdon County",4,27,1229,623,606
050,34,019,"New Jersey","Hunterdon County",4,28,1211,635,576
050,34,019,"New Jersey","Hunterdon County",4,29,1206,617,589
050,34,019,"New Jersey","Hunterdon County",4,30,1263,606,657
050,34,019,"New Jersey","Hunterdon County",4,31,1240,601,639
050,34,019,"New Jersey","Hunterdon County",4,32,1283,652,631
050,34,019,"New Jersey","Hunterdon County",4,33,1321,645,676
050,34,019,"New Jersey","Hunterdon County",4,34,1382,669,713
050,34,019,"New Jersey","Hunterdon County",4,35,1406,673,733
050,34,019,"New Jersey","Hunterdon County",4,36,1462,716,746
050,34,019,"New Jersey","Hunterdon County",4,37,1474,744,730
050,34,019,"New Jersey","Hunterdon County",4,38,1527,778,749
050,34,019,"New Jersey","Hunterdon County",4,39,1555,779,776
050,34,019,"New Jersey","Hunterdon County",4,40,1593,781,812
050,34,019,"New Jersey","Hunterdon County",4,41,1616,793,823
050,34,019,"New Jersey","Hunterdon County",4,42,1572,786,786
050,34,019,"New Jersey","Hunterdon County",4,43,1600,802,798
050,34,019,"New Jersey","Hunterdon County",4,44,1577,766,811
050,34,019,"New Jersey","Hunterdon County",4,45,1572,763,809
050,34,019,"New Jersey","Hunterdon County",4,46,1581,786,795
050,34,019,"New Jersey","Hunterdon County",4,47,1604,803,801
050,34,019,"New Jersey","Hunterdon County",4,48,1553,793,760
050,34,019,"New Jersey","Hunterdon County",4,49,1631,784,847
050,34,019,"New Jersey","Hunterdon County",4,50,1756,835,921
050,34,019,"New Jersey","Hunterdon County",4,51,2028,987,1041
050,34,019,"New Jersey","Hunterdon County",4,52,2035,1003,1032
050,34,019,"New Jersey","Hunterdon County",4,53,2026,967,1059
050,34,019,"New Jersey","Hunterdon County",4,54,1999,961,1038
050,34,019,"New Jersey","Hunterdon County",4,55,2112,1041,1071
050,34,019,"New Jersey","Hunterdon County",4,56,2166,1047,1119
050,34,019,"New Jersey","Hunterdon County",4,57,2269,1081,1188
050,34,019,"New Jersey","Hunterdon County",4,58,2349,1151,1198
050,34,019,"New Jersey","Hunterdon County",4,59,2278,1147,1131
050,34,019,"New Jersey","Hunterdon County",4,60,2279,1143,1136
050,34,019,"New Jersey","Hunterdon County",4,61,2254,1123,1131
050,34,019,"New Jersey","Hunterdon County",4,62,2184,1106,1078
050,34,019,"New Jersey","Hunterdon County",4,63,2182,1089,1093
050,34,019,"New Jersey","Hunterdon County",4,64,2132,1048,1084
050,34,019,"New Jersey","Hunterdon County",4,65,2073,1015,1058
050,34,019,"New Jersey","Hunterdon County",4,66,1838,927,911
050,34,019,"New Jersey","Hunterdon County",4,67,1803,887,916
050,34,019,"New Jersey","Hunterdon County",4,68,1722,850,872
050,34,019,"New Jersey","Hunterdon County",4,69,1633,823,810
050,34,019,"New Jersey","Hunterdon County",4,70,1537,770,767
050,34,019,"New Jersey","Hunterdon County",4,71,1397,707,690
050,34,019,"New Jersey","Hunterdon County",4,72,1355,684,671
050,34,019,"New Jersey","Hunterdon County",4,73,1334,659,675
050,34,019,"New Jersey","Hunterdon County",4,74,1278,624,654
050,34,019,"New Jersey","Hunterdon County",4,75,1362,631,731
050,34,019,"New Jersey","Hunterdon County",4,76,953,426,527
050,34,019,"New Jersey","Hunterdon County",4,77,914,423,491
050,34,019,"New Jersey","Hunterdon County",4,78,903,406,497
050,34,019,"New Jersey","Hunterdon County",4,79,930,434,496
050,34,019,"New Jersey","Hunterdon County",4,80,842,397,445
050,34,019,"New Jersey","Hunterdon County",4,81,680,319,361
050,34,019,"New Jersey","Hunterdon County",4,82,611,300,311
050,34,019,"New Jersey","Hunterdon County",4,83,503,228,275
050,34,019,"New Jersey","Hunterdon County",4,84,474,210,264
050,34,019,"New Jersey","Hunterdon County",4,85,2987,1060,1927
050,34,019,"New Jersey","Hunterdon County",5,0,1114,571,543
050,34,019,"New Jersey","Hunterdon County",5,1,1167,596,571
050,34,019,"New Jersey","Hunterdon County",5,2,1091,562,529
050,34,019,"New Jersey","Hunterdon County",5,3,1243,631,612
050,34,019,"New Jersey","Hunterdon County",5,4,1218,614,604
050,34,019,"New Jersey","Hunterdon County",5,5,1286,636,650
050,34,019,"New Jersey","Hunterdon County",5,6,1298,662,636
050,34,019,"New Jersey","Hunterdon County",5,7,1362,674,688
050,34,019,"New Jersey","Hunterdon County",5,8,1373,684,689
050,34,019,"New Jersey","Hunterdon County",5,9,1417,711,706
050,34,019,"New Jersey","Hunterdon County",5,10,1367,697,670
050,34,019,"New Jersey","Hunterdon County",5,11,1431,737,694
050,34,019,"New Jersey","Hunterdon County",5,12,1420,727,693
050,34,019,"New Jersey","Hunterdon County",5,13,1465,744,721
050,34,019,"New Jersey","Hunterdon County",5,14,1525,789,736
050,34,019,"New Jersey","Hunterdon County",5,15,1619,825,794
050,34,019,"New Jersey","Hunterdon County",5,16,1681,880,801
050,34,019,"New Jersey","Hunterdon County",5,17,1649,850,799
050,34,019,"New Jersey","Hunterdon County",5,18,1448,741,707
050,34,019,"New Jersey","Hunterdon County",5,19,1173,616,557
050,34,019,"New Jersey","Hunterdon County",5,20,1332,678,654
050,34,019,"New Jersey","Hunterdon County",5,21,1429,731,698
050,34,019,"New Jersey","Hunterdon County",5,22,1521,786,735
050,34,019,"New Jersey","Hunterdon County",5,23,1518,771,747
050,34,019,"New Jersey","Hunterdon County",5,24,1361,660,701
050,34,019,"New Jersey","Hunterdon County",5,25,1275,621,654
050,34,019,"New Jersey","Hunterdon County",5,26,1192,566,626
050,34,019,"New Jersey","Hunterdon County",5,27,1172,582,590
050,34,019,"New Jersey","Hunterdon County",5,28,1217,611,606
050,34,019,"New Jersey","Hunterdon County",5,29,1188,612,576
050,34,019,"New Jersey","Hunterdon County",5,30,1278,641,637
050,34,019,"New Jersey","Hunterdon County",5,31,1303,606,697
050,34,019,"New Jersey","Hunterdon County",5,32,1313,634,679
050,34,019,"New Jersey","Hunterdon County",5,33,1370,692,678
050,34,019,"New Jersey","Hunterdon County",5,34,1405,685,720
050,34,019,"New Jersey","Hunterdon County",5,35,1479,718,761
050,34,019,"New Jersey","Hunterdon County",5,36,1461,715,746
050,34,019,"New Jersey","Hunterdon County",5,37,1522,744,778
050,34,019,"New Jersey","Hunterdon County",5,38,1510,771,739
050,34,019,"New Jersey","Hunterdon County",5,39,1577,792,785
050,34,019,"New Jersey","Hunterdon County",5,40,1598,791,807
050,34,019,"New Jersey","Hunterdon County",5,41,1656,809,847
050,34,019,"New Jersey","Hunterdon County",5,42,1644,814,830
050,34,019,"New Jersey","Hunterdon County",5,43,1607,799,808
050,34,019,"New Jersey","Hunterdon County",5,44,1604,800,804
050,34,019,"New Jersey","Hunterdon County",5,45,1609,803,806
050,34,019,"New Jersey","Hunterdon County",5,46,1607,781,826
050,34,019,"New Jersey","Hunterdon County",5,47,1558,771,787
050,34,019,"New Jersey","Hunterdon County",5,48,1607,810,797
050,34,019,"New Jersey","Hunterdon County",5,49,1557,775,782
050,34,019,"New Jersey","Hunterdon County",5,50,1622,805,817
050,34,019,"New Jersey","Hunterdon County",5,51,1750,844,906
050,34,019,"New Jersey","Hunterdon County",5,52,2030,977,1053
050,34,019,"New Jersey","Hunterdon County",5,53,2014,999,1015
050,34,019,"New Jersey","Hunterdon County",5,54,2031,970,1061
050,34,019,"New Jersey","Hunterdon County",5,55,1986,960,1026
050,34,019,"New Jersey","Hunterdon County",5,56,2070,1032,1038
050,34,019,"New Jersey","Hunterdon County",5,57,2163,1034,1129
050,34,019,"New Jersey","Hunterdon County",5,58,2232,1076,1156
050,34,019,"New Jersey","Hunterdon County",5,59,2279,1107,1172
050,34,019,"New Jersey","Hunterdon County",5,60,2254,1145,1109
050,34,019,"New Jersey","Hunterdon County",5,61,2217,1112,1105
050,34,019,"New Jersey","Hunterdon County",5,62,2187,1089,1098
050,34,019,"New Jersey","Hunterdon County",5,63,2130,1086,1044
050,34,019,"New Jersey","Hunterdon County",5,64,2124,1066,1058
050,34,019,"New Jersey","Hunterdon County",5,65,2090,1015,1075
050,34,019,"New Jersey","Hunterdon County",5,66,2030,991,1039
050,34,019,"New Jersey","Hunterdon County",5,67,1788,899,889
050,34,019,"New Jersey","Hunterdon County",5,68,1765,869,896
050,34,019,"New Jersey","Hunterdon County",5,69,1705,835,870
050,34,019,"New Jersey","Hunterdon County",5,70,1636,815,821
050,34,019,"New Jersey","Hunterdon County",5,71,1510,759,751
050,34,019,"New Jersey","Hunterdon County",5,72,1367,698,669
050,34,019,"New Jersey","Hunterdon County",5,73,1335,670,665
050,34,019,"New Jersey","Hunterdon County",5,74,1293,628,665
050,34,019,"New Jersey","Hunterdon County",5,75,1243,597,646
050,34,019,"New Jersey","Hunterdon County",5,76,1317,603,714
050,34,019,"New Jersey","Hunterdon County",5,77,934,417,517
050,34,019,"New Jersey","Hunterdon County",5,78,904,411,493
050,34,019,"New Jersey","Hunterdon County",5,79,844,383,461
050,34,019,"New Jersey","Hunterdon County",5,80,935,444,491
050,34,019,"New Jersey","Hunterdon County",5,81,805,371,434
050,34,019,"New Jersey","Hunterdon County",5,82,658,321,337
050,34,019,"New Jersey","Hunterdon County",5,83,573,274,299
050,34,019,"New Jersey","Hunterdon County",5,84,485,218,267
050,34,019,"New Jersey","Hunterdon County",5,85,3060,1117,1943
050,34,021,"New Jersey","Mercer County",1,0,4228,2171,2057
050,34,021,"New Jersey","Mercer County",1,1,4303,2220,2083
050,34,021,"New Jersey","Mercer County",1,2,4434,2284,2150
050,34,021,"New Jersey","Mercer County",1,3,4570,2329,2241
050,34,021,"New Jersey","Mercer County",1,4,4580,2380,2200
050,34,021,"New Jersey","Mercer County",1,5,4582,2352,2230
050,34,021,"New Jersey","Mercer County",1,6,4597,2360,2237
050,34,021,"New Jersey","Mercer County",1,7,4657,2338,2319
050,34,021,"New Jersey","Mercer County",1,8,4719,2415,2304
050,34,021,"New Jersey","Mercer County",1,9,4827,2500,2327
050,34,021,"New Jersey","Mercer County",1,10,4786,2456,2330
050,34,021,"New Jersey","Mercer County",1,11,4881,2536,2345
050,34,021,"New Jersey","Mercer County",1,12,5025,2628,2397
050,34,021,"New Jersey","Mercer County",1,13,4933,2575,2358
050,34,021,"New Jersey","Mercer County",1,14,4962,2587,2375
050,34,021,"New Jersey","Mercer County",1,15,4926,2560,2366
050,34,021,"New Jersey","Mercer County",1,16,5009,2570,2439
050,34,021,"New Jersey","Mercer County",1,17,5079,2637,2442
050,34,021,"New Jersey","Mercer County",1,18,6113,3001,3112
050,34,021,"New Jersey","Mercer County",1,19,7251,3507,3744
050,34,021,"New Jersey","Mercer County",1,20,6797,3304,3493
050,34,021,"New Jersey","Mercer County",1,21,6612,3207,3405
050,34,021,"New Jersey","Mercer County",1,22,5599,2781,2818
050,34,021,"New Jersey","Mercer County",1,23,4853,2494,2359
050,34,021,"New Jersey","Mercer County",1,24,4866,2505,2361
050,34,021,"New Jersey","Mercer County",1,25,4786,2446,2340
050,34,021,"New Jersey","Mercer County",1,26,4850,2531,2319
050,34,021,"New Jersey","Mercer County",1,27,4899,2545,2354
050,34,021,"New Jersey","Mercer County",1,28,4866,2578,2288
050,34,021,"New Jersey","Mercer County",1,29,4921,2548,2373
050,34,021,"New Jersey","Mercer County",1,30,4879,2566,2313
050,34,021,"New Jersey","Mercer County",1,31,4738,2446,2292
050,34,021,"New Jersey","Mercer County",1,32,4737,2412,2325
050,34,021,"New Jersey","Mercer County",1,33,4691,2364,2327
050,34,021,"New Jersey","Mercer County",1,34,4761,2380,2381
050,34,021,"New Jersey","Mercer County",1,35,4799,2434,2365
050,34,021,"New Jersey","Mercer County",1,36,4885,2481,2404
050,34,021,"New Jersey","Mercer County",1,37,4916,2553,2363
050,34,021,"New Jersey","Mercer County",1,38,5009,2559,2450
050,34,021,"New Jersey","Mercer County",1,39,5030,2519,2511
050,34,021,"New Jersey","Mercer County",1,40,5064,2575,2489
050,34,021,"New Jersey","Mercer County",1,41,5097,2578,2519
050,34,021,"New Jersey","Mercer County",1,42,5091,2571,2520
050,34,021,"New Jersey","Mercer County",1,43,4958,2459,2499
050,34,021,"New Jersey","Mercer County",1,44,5042,2531,2511
050,34,021,"New Jersey","Mercer County",1,45,5096,2584,2512
050,34,021,"New Jersey","Mercer County",1,46,4998,2549,2449
050,34,021,"New Jersey","Mercer County",1,47,5055,2557,2498
050,34,021,"New Jersey","Mercer County",1,48,5343,2642,2701
050,34,021,"New Jersey","Mercer County",1,49,5709,2828,2881
050,34,021,"New Jersey","Mercer County",1,50,5539,2815,2724
050,34,021,"New Jersey","Mercer County",1,51,5238,2628,2610
050,34,021,"New Jersey","Mercer County",1,52,5210,2563,2647
050,34,021,"New Jersey","Mercer County",1,53,5289,2633,2656
050,34,021,"New Jersey","Mercer County",1,54,5363,2667,2696
050,34,021,"New Jersey","Mercer County",1,55,5484,2698,2786
050,34,021,"New Jersey","Mercer County",1,56,5346,2616,2730
050,34,021,"New Jersey","Mercer County",1,57,5336,2655,2681
050,34,021,"New Jersey","Mercer County",1,58,5371,2705,2666
050,34,021,"New Jersey","Mercer County",1,59,5341,2623,2718
050,34,021,"New Jersey","Mercer County",1,60,5131,2539,2592
050,34,021,"New Jersey","Mercer County",1,61,4962,2446,2516
050,34,021,"New Jersey","Mercer County",1,62,4925,2371,2554
050,34,021,"New Jersey","Mercer County",1,63,4691,2309,2382
050,34,021,"New Jersey","Mercer County",1,64,4405,2138,2267
050,34,021,"New Jersey","Mercer County",1,65,4248,1991,2257
050,34,021,"New Jersey","Mercer County",1,66,4008,1893,2115
050,34,021,"New Jersey","Mercer County",1,67,3868,1807,2061
050,34,021,"New Jersey","Mercer County",1,68,3758,1763,1995
050,34,021,"New Jersey","Mercer County",1,69,3467,1634,1833
050,34,021,"New Jersey","Mercer County",1,70,3265,1500,1765
050,34,021,"New Jersey","Mercer County",1,71,3175,1434,1741
050,34,021,"New Jersey","Mercer County",1,72,3126,1406,1720
050,34,021,"New Jersey","Mercer County",1,73,3061,1425,1636
050,34,021,"New Jersey","Mercer County",1,74,2285,998,1287
050,34,021,"New Jersey","Mercer County",1,75,2262,1002,1260
050,34,021,"New Jersey","Mercer County",1,76,2147,934,1213
050,34,021,"New Jersey","Mercer County",1,77,2133,921,1212
050,34,021,"New Jersey","Mercer County",1,78,1880,804,1076
050,34,021,"New Jersey","Mercer County",1,79,1677,723,954
050,34,021,"New Jersey","Mercer County",1,80,1477,617,860
050,34,021,"New Jersey","Mercer County",1,81,1426,578,848
050,34,021,"New Jersey","Mercer County",1,82,1373,553,820
050,34,021,"New Jersey","Mercer County",1,83,1214,497,717
050,34,021,"New Jersey","Mercer County",1,84,1104,427,677
050,34,021,"New Jersey","Mercer County",1,85,7334,2491,4843
050,34,021,"New Jersey","Mercer County",2,0,4205,2155,2050
050,34,021,"New Jersey","Mercer County",2,1,4281,2210,2071
050,34,021,"New Jersey","Mercer County",2,2,4413,2269,2144
050,34,021,"New Jersey","Mercer County",2,3,4527,2315,2212
050,34,021,"New Jersey","Mercer County",2,4,4577,2364,2213
050,34,021,"New Jersey","Mercer County",2,5,4594,2363,2231
050,34,021,"New Jersey","Mercer County",2,6,4606,2358,2248
050,34,021,"New Jersey","Mercer County",2,7,4639,2337,2302
050,34,021,"New Jersey","Mercer County",2,8,4697,2392,2305
050,34,021,"New Jersey","Mercer County",2,9,4805,2487,2318
050,34,021,"New Jersey","Mercer County",2,10,4798,2468,2330
050,34,021,"New Jersey","Mercer County",2,11,4830,2500,2330
050,34,021,"New Jersey","Mercer County",2,12,5001,2611,2390
050,34,021,"New Jersey","Mercer County",2,13,4949,2589,2360
050,34,021,"New Jersey","Mercer County",2,14,4950,2580,2370
050,34,021,"New Jersey","Mercer County",2,15,4936,2565,2371
050,34,021,"New Jersey","Mercer County",2,16,4983,2562,2421
050,34,021,"New Jersey","Mercer County",2,17,5053,2615,2438
050,34,021,"New Jersey","Mercer County",2,18,6110,3003,3107
050,34,021,"New Jersey","Mercer County",2,19,7234,3497,3737
050,34,021,"New Jersey","Mercer County",2,20,6858,3334,3524
050,34,021,"New Jersey","Mercer County",2,21,6585,3195,3390
050,34,021,"New Jersey","Mercer County",2,22,5585,2780,2805
050,34,021,"New Jersey","Mercer County",2,23,4847,2481,2366
050,34,021,"New Jersey","Mercer County",2,24,4826,2484,2342
050,34,021,"New Jersey","Mercer County",2,25,4792,2455,2337
050,34,021,"New Jersey","Mercer County",2,26,4823,2505,2318
050,34,021,"New Jersey","Mercer County",2,27,4856,2526,2330
050,34,021,"New Jersey","Mercer County",2,28,4887,2577,2310
050,34,021,"New Jersey","Mercer County",2,29,4904,2554,2350
050,34,021,"New Jersey","Mercer County",2,30,4914,2573,2341
050,34,021,"New Jersey","Mercer County",2,31,4742,2452,2290
050,34,021,"New Jersey","Mercer County",2,32,4714,2402,2312
050,34,021,"New Jersey","Mercer County",2,33,4673,2360,2313
050,34,021,"New Jersey","Mercer County",2,34,4729,2369,2360
050,34,021,"New Jersey","Mercer County",2,35,4815,2435,2380
050,34,021,"New Jersey","Mercer County",2,36,4831,2449,2382
050,34,021,"New Jersey","Mercer County",2,37,4910,2532,2378
050,34,021,"New Jersey","Mercer County",2,38,5017,2566,2451
050,34,021,"New Jersey","Mercer County",2,39,5003,2521,2482
050,34,021,"New Jersey","Mercer County",2,40,5098,2584,2514
050,34,021,"New Jersey","Mercer County",2,41,5079,2570,2509
050,34,021,"New Jersey","Mercer County",2,42,5069,2561,2508
050,34,021,"New Jersey","Mercer County",2,43,5018,2495,2523
050,34,021,"New Jersey","Mercer County",2,44,4988,2501,2487
050,34,021,"New Jersey","Mercer County",2,45,5092,2573,2519
050,34,021,"New Jersey","Mercer County",2,46,5003,2549,2454
050,34,021,"New Jersey","Mercer County",2,47,5019,2543,2476
050,34,021,"New Jersey","Mercer County",2,48,5272,2626,2646
050,34,021,"New Jersey","Mercer County",2,49,5626,2785,2841
050,34,021,"New Jersey","Mercer County",2,50,5569,2812,2757
050,34,021,"New Jersey","Mercer County",2,51,5256,2643,2613
050,34,021,"New Jersey","Mercer County",2,52,5199,2568,2631
050,34,021,"New Jersey","Mercer County",2,53,5231,2592,2639
050,34,021,"New Jersey","Mercer County",2,54,5316,2643,2673
050,34,021,"New Jersey","Mercer County",2,55,5434,2685,2749
050,34,021,"New Jersey","Mercer County",2,56,5374,2630,2744
050,34,021,"New Jersey","Mercer County",2,57,5318,2635,2683
050,34,021,"New Jersey","Mercer County",2,58,5333,2674,2659
050,34,021,"New Jersey","Mercer County",2,59,5325,2628,2697
050,34,021,"New Jersey","Mercer County",2,60,5156,2545,2611
050,34,021,"New Jersey","Mercer County",2,61,4955,2440,2515
050,34,021,"New Jersey","Mercer County",2,62,4881,2358,2523
050,34,021,"New Jersey","Mercer County",2,63,4736,2318,2418
050,34,021,"New Jersey","Mercer County",2,64,4406,2141,2265
050,34,021,"New Jersey","Mercer County",2,65,4242,2008,2234
050,34,021,"New Jersey","Mercer County",2,66,4035,1894,2141
050,34,021,"New Jersey","Mercer County",2,67,3863,1811,2052
050,34,021,"New Jersey","Mercer County",2,68,3732,1748,1984
050,34,021,"New Jersey","Mercer County",2,69,3527,1659,1868
050,34,021,"New Jersey","Mercer County",2,70,3276,1517,1759
050,34,021,"New Jersey","Mercer County",2,71,3166,1434,1732
050,34,021,"New Jersey","Mercer County",2,72,3063,1378,1685
050,34,021,"New Jersey","Mercer County",2,73,3169,1459,1710
050,34,021,"New Jersey","Mercer County",2,74,2310,1024,1286
050,34,021,"New Jersey","Mercer County",2,75,2246,986,1260
050,34,021,"New Jersey","Mercer County",2,76,2142,937,1205
050,34,021,"New Jersey","Mercer County",2,77,2154,928,1226
050,34,021,"New Jersey","Mercer County",2,78,1872,808,1064
050,34,021,"New Jersey","Mercer County",2,79,1688,726,962
050,34,021,"New Jersey","Mercer County",2,80,1505,632,873
050,34,021,"New Jersey","Mercer County",2,81,1397,571,826
050,34,021,"New Jersey","Mercer County",2,82,1351,543,808
050,34,021,"New Jersey","Mercer County",2,83,1208,497,711
050,34,021,"New Jersey","Mercer County",2,84,1096,428,668
050,34,021,"New Jersey","Mercer County",2,85,7172,2436,4736
050,34,021,"New Jersey","Mercer County",3,0,3891,1976,1915
050,34,021,"New Jersey","Mercer County",3,1,4204,2164,2040
050,34,021,"New Jersey","Mercer County",3,2,4277,2197,2080
050,34,021,"New Jersey","Mercer County",3,3,4446,2275,2171
050,34,021,"New Jersey","Mercer County",3,4,4580,2351,2229
050,34,021,"New Jersey","Mercer County",3,5,4539,2352,2187
050,34,021,"New Jersey","Mercer County",3,6,4620,2367,2253
050,34,021,"New Jersey","Mercer County",3,7,4631,2350,2281
050,34,021,"New Jersey","Mercer County",3,8,4672,2349,2323
050,34,021,"New Jersey","Mercer County",3,9,4716,2419,2297
050,34,021,"New Jersey","Mercer County",3,10,4781,2476,2305
050,34,021,"New Jersey","Mercer County",3,11,4793,2445,2348
050,34,021,"New Jersey","Mercer County",3,12,4832,2493,2339
050,34,021,"New Jersey","Mercer County",3,13,5044,2625,2419
050,34,021,"New Jersey","Mercer County",3,14,4950,2558,2392
050,34,021,"New Jersey","Mercer County",3,15,4919,2539,2380
050,34,021,"New Jersey","Mercer County",3,16,4899,2527,2372
050,34,021,"New Jersey","Mercer County",3,17,4989,2569,2420
050,34,021,"New Jersey","Mercer County",3,18,5680,2848,2832
050,34,021,"New Jersey","Mercer County",3,19,6155,3005,3150
050,34,021,"New Jersey","Mercer County",3,20,6054,2983,3071
050,34,021,"New Jersey","Mercer County",3,21,5897,2894,3003
050,34,021,"New Jersey","Mercer County",3,22,5217,2600,2617
050,34,021,"New Jersey","Mercer County",3,23,4677,2358,2319
050,34,021,"New Jersey","Mercer County",3,24,4737,2408,2329
050,34,021,"New Jersey","Mercer County",3,25,4733,2431,2302
050,34,021,"New Jersey","Mercer County",3,26,4700,2378,2322
050,34,021,"New Jersey","Mercer County",3,27,4790,2464,2326
050,34,021,"New Jersey","Mercer County",3,28,4840,2479,2361
050,34,021,"New Jersey","Mercer County",3,29,4769,2502,2267
050,34,021,"New Jersey","Mercer County",3,30,4888,2552,2336
050,34,021,"New Jersey","Mercer County",3,31,4920,2542,2378
050,34,021,"New Jersey","Mercer County",3,32,4777,2470,2307
050,34,021,"New Jersey","Mercer County",3,33,4714,2411,2303
050,34,021,"New Jersey","Mercer County",3,34,4619,2272,2347
050,34,021,"New Jersey","Mercer County",3,35,4772,2396,2376
050,34,021,"New Jersey","Mercer County",3,36,4918,2474,2444
050,34,021,"New Jersey","Mercer County",3,37,4846,2457,2389
050,34,021,"New Jersey","Mercer County",3,38,4968,2556,2412
050,34,021,"New Jersey","Mercer County",3,39,5014,2526,2488
050,34,021,"New Jersey","Mercer County",3,40,5043,2532,2511
050,34,021,"New Jersey","Mercer County",3,41,5092,2570,2522
050,34,021,"New Jersey","Mercer County",3,42,5087,2583,2504
050,34,021,"New Jersey","Mercer County",3,43,5085,2562,2523
050,34,021,"New Jersey","Mercer County",3,44,5003,2493,2510
050,34,021,"New Jersey","Mercer County",3,45,4987,2475,2512
050,34,021,"New Jersey","Mercer County",3,46,5092,2575,2517
050,34,021,"New Jersey","Mercer County",3,47,4985,2519,2466
050,34,021,"New Jersey","Mercer County",3,48,5002,2530,2472
050,34,021,"New Jersey","Mercer County",3,49,5238,2601,2637
050,34,021,"New Jersey","Mercer County",3,50,5569,2780,2789
050,34,021,"New Jersey","Mercer County",3,51,5465,2757,2708
050,34,021,"New Jersey","Mercer County",3,52,5244,2629,2615
050,34,021,"New Jersey","Mercer County",3,53,5126,2521,2605
050,34,021,"New Jersey","Mercer County",3,54,5141,2553,2588
050,34,021,"New Jersey","Mercer County",3,55,5230,2575,2655
050,34,021,"New Jersey","Mercer County",3,56,5352,2627,2725
050,34,021,"New Jersey","Mercer County",3,57,5284,2608,2676
050,34,021,"New Jersey","Mercer County",3,58,5181,2563,2618
050,34,021,"New Jersey","Mercer County",3,59,5227,2620,2607
050,34,021,"New Jersey","Mercer County",3,60,5219,2555,2664
050,34,021,"New Jersey","Mercer County",3,61,5012,2468,2544
050,34,021,"New Jersey","Mercer County",3,62,4831,2369,2462
050,34,021,"New Jersey","Mercer County",3,63,4761,2283,2478
050,34,021,"New Jersey","Mercer County",3,64,4590,2232,2358
050,34,021,"New Jersey","Mercer County",3,65,4281,2061,2220
050,34,021,"New Jersey","Mercer County",3,66,4122,1946,2176
050,34,021,"New Jersey","Mercer County",3,67,3925,1833,2092
050,34,021,"New Jersey","Mercer County",3,68,3753,1749,2004
050,34,021,"New Jersey","Mercer County",3,69,3665,1718,1947
050,34,021,"New Jersey","Mercer County",3,70,3438,1608,1830
050,34,021,"New Jersey","Mercer County",3,71,3164,1452,1712
050,34,021,"New Jersey","Mercer County",3,72,3104,1401,1703
050,34,021,"New Jersey","Mercer County",3,73,2988,1342,1646
050,34,021,"New Jersey","Mercer County",3,74,3085,1403,1682
050,34,021,"New Jersey","Mercer County",3,75,2263,994,1269
050,34,021,"New Jersey","Mercer County",3,76,2176,953,1223
050,34,021,"New Jersey","Mercer County",3,77,2074,899,1175
050,34,021,"New Jersey","Mercer County",3,78,2079,890,1189
050,34,021,"New Jersey","Mercer County",3,79,1810,774,1036
050,34,021,"New Jersey","Mercer County",3,80,1608,684,924
050,34,021,"New Jersey","Mercer County",3,81,1443,600,843
050,34,021,"New Jersey","Mercer County",3,82,1311,522,789
050,34,021,"New Jersey","Mercer County",3,83,1290,528,762
050,34,021,"New Jersey","Mercer County",3,84,1122,447,675
050,34,021,"New Jersey","Mercer County",3,85,7157,2454,4703
050,34,021,"New Jersey","Mercer County",4,0,4159,2153,2006
050,34,021,"New Jersey","Mercer County",4,1,3895,2011,1884
050,34,021,"New Jersey","Mercer County",4,2,4290,2187,2103
050,34,021,"New Jersey","Mercer County",4,3,4309,2246,2063
050,34,021,"New Jersey","Mercer County",4,4,4504,2301,2203
050,34,021,"New Jersey","Mercer County",4,5,4622,2365,2257
050,34,021,"New Jersey","Mercer County",4,6,4592,2373,2219
050,34,021,"New Jersey","Mercer County",4,7,4651,2385,2266
050,34,021,"New Jersey","Mercer County",4,8,4672,2358,2314
050,34,021,"New Jersey","Mercer County",4,9,4696,2385,2311
050,34,021,"New Jersey","Mercer County",4,10,4751,2456,2295
050,34,021,"New Jersey","Mercer County",4,11,4810,2504,2306
050,34,021,"New Jersey","Mercer County",4,12,4805,2445,2360
050,34,021,"New Jersey","Mercer County",4,13,4812,2470,2342
050,34,021,"New Jersey","Mercer County",4,14,5123,2665,2458
050,34,021,"New Jersey","Mercer County",4,15,4924,2538,2386
050,34,021,"New Jersey","Mercer County",4,16,4942,2549,2393
050,34,021,"New Jersey","Mercer County",4,17,4892,2504,2388
050,34,021,"New Jersey","Mercer County",4,18,5579,2790,2789
050,34,021,"New Jersey","Mercer County",4,19,6145,3043,3102
050,34,021,"New Jersey","Mercer County",4,20,5905,2911,2994
050,34,021,"New Jersey","Mercer County",4,21,5851,2874,2977
050,34,021,"New Jersey","Mercer County",4,22,5190,2618,2572
050,34,021,"New Jersey","Mercer County",4,23,4606,2330,2276
050,34,021,"New Jersey","Mercer County",4,24,4578,2327,2251
050,34,021,"New Jersey","Mercer County",4,25,4597,2334,2263
050,34,021,"New Jersey","Mercer County",4,26,4600,2376,2224
050,34,021,"New Jersey","Mercer County",4,27,4563,2281,2282
050,34,021,"New Jersey","Mercer County",4,28,4767,2467,2300
050,34,021,"New Jersey","Mercer County",4,29,4705,2419,2286
050,34,021,"New Jersey","Mercer County",4,30,4677,2463,2214
050,34,021,"New Jersey","Mercer County",4,31,4879,2496,2383
050,34,021,"New Jersey","Mercer County",4,32,4902,2530,2372
050,34,021,"New Jersey","Mercer County",4,33,4717,2399,2318
050,34,021,"New Jersey","Mercer County",4,34,4727,2423,2304
050,34,021,"New Jersey","Mercer County",4,35,4641,2290,2351
050,34,021,"New Jersey","Mercer County",4,36,4817,2407,2410
050,34,021,"New Jersey","Mercer County",4,37,4937,2503,2434
050,34,021,"New Jersey","Mercer County",4,38,4880,2480,2400
050,34,021,"New Jersey","Mercer County",4,39,4945,2509,2436
050,34,021,"New Jersey","Mercer County",4,40,5021,2505,2516
050,34,021,"New Jersey","Mercer County",4,41,5093,2538,2555
050,34,021,"New Jersey","Mercer County",4,42,5120,2574,2546
050,34,021,"New Jersey","Mercer County",4,43,5087,2575,2512
050,34,021,"New Jersey","Mercer County",4,44,5058,2540,2518
050,34,021,"New Jersey","Mercer County",4,45,5027,2506,2521
050,34,021,"New Jersey","Mercer County",4,46,4987,2490,2497
050,34,021,"New Jersey","Mercer County",4,47,5089,2538,2551
050,34,021,"New Jersey","Mercer County",4,48,4970,2518,2452
050,34,021,"New Jersey","Mercer County",4,49,4942,2475,2467
050,34,021,"New Jersey","Mercer County",4,50,5170,2558,2612
050,34,021,"New Jersey","Mercer County",4,51,5489,2734,2755
050,34,021,"New Jersey","Mercer County",4,52,5425,2730,2695
050,34,021,"New Jersey","Mercer County",4,53,5162,2579,2583
050,34,021,"New Jersey","Mercer County",4,54,5046,2492,2554
050,34,021,"New Jersey","Mercer County",4,55,5037,2527,2510
050,34,021,"New Jersey","Mercer County",4,56,5161,2546,2615
050,34,021,"New Jersey","Mercer County",4,57,5237,2563,2674
050,34,021,"New Jersey","Mercer County",4,58,5204,2556,2648
050,34,021,"New Jersey","Mercer County",4,59,5075,2517,2558
050,34,021,"New Jersey","Mercer County",4,60,5063,2522,2541
050,34,021,"New Jersey","Mercer County",4,61,5085,2469,2616
050,34,021,"New Jersey","Mercer County",4,62,4849,2374,2475
050,34,021,"New Jersey","Mercer County",4,63,4683,2285,2398
050,34,021,"New Jersey","Mercer County",4,64,4638,2248,2390
050,34,021,"New Jersey","Mercer County",4,65,4434,2142,2292
050,34,021,"New Jersey","Mercer County",4,66,4148,2016,2132
050,34,021,"New Jersey","Mercer County",4,67,4053,1919,2134
050,34,021,"New Jersey","Mercer County",4,68,3805,1747,2058
050,34,021,"New Jersey","Mercer County",4,69,3669,1716,1953
050,34,021,"New Jersey","Mercer County",4,70,3541,1655,1886
050,34,021,"New Jersey","Mercer County",4,71,3316,1539,1777
050,34,021,"New Jersey","Mercer County",4,72,3087,1405,1682
050,34,021,"New Jersey","Mercer County",4,73,3031,1364,1667
050,34,021,"New Jersey","Mercer County",4,74,2933,1304,1629
050,34,021,"New Jersey","Mercer County",4,75,3004,1367,1637
050,34,021,"New Jersey","Mercer County",4,76,2165,948,1217
050,34,021,"New Jersey","Mercer County",4,77,2094,915,1179
050,34,021,"New Jersey","Mercer County",4,78,1995,860,1135
050,34,021,"New Jersey","Mercer County",4,79,2006,850,1156
050,34,021,"New Jersey","Mercer County",4,80,1719,718,1001
050,34,021,"New Jersey","Mercer County",4,81,1550,644,906
050,34,021,"New Jersey","Mercer County",4,82,1340,549,791
050,34,021,"New Jersey","Mercer County",4,83,1249,506,743
050,34,021,"New Jersey","Mercer County",4,84,1187,471,716
050,34,021,"New Jersey","Mercer County",4,85,7078,2471,4607
050,34,021,"New Jersey","Mercer County",5,0,4166,2151,2015
050,34,021,"New Jersey","Mercer County",5,1,4224,2141,2083
050,34,021,"New Jersey","Mercer County",5,2,3965,2043,1922
050,34,021,"New Jersey","Mercer County",5,3,4359,2269,2090
050,34,021,"New Jersey","Mercer County",5,4,4357,2254,2103
050,34,021,"New Jersey","Mercer County",5,5,4551,2329,2222
050,34,021,"New Jersey","Mercer County",5,6,4696,2377,2319
050,34,021,"New Jersey","Mercer County",5,7,4650,2405,2245
050,34,021,"New Jersey","Mercer County",5,8,4722,2444,2278
050,34,021,"New Jersey","Mercer County",5,9,4728,2384,2344
050,34,021,"New Jersey","Mercer County",5,10,4742,2418,2324
050,34,021,"New Jersey","Mercer County",5,11,4809,2477,2332
050,34,021,"New Jersey","Mercer County",5,12,4863,2538,2325
050,34,021,"New Jersey","Mercer County",5,13,4843,2475,2368
050,34,021,"New Jersey","Mercer County",5,14,4878,2486,2392
050,34,021,"New Jersey","Mercer County",5,15,5156,2668,2488
050,34,021,"New Jersey","Mercer County",5,16,4946,2544,2402
050,34,021,"New Jersey","Mercer County",5,17,4972,2570,2402
050,34,021,"New Jersey","Mercer County",5,18,5547,2757,2790
050,34,021,"New Jersey","Mercer County",5,19,6164,3039,3125
050,34,021,"New Jersey","Mercer County",5,20,6021,3024,2997
050,34,021,"New Jersey","Mercer County",5,21,5832,2879,2953
050,34,021,"New Jersey","Mercer County",5,22,5233,2622,2611
050,34,021,"New Jersey","Mercer County",5,23,4624,2383,2241
050,34,021,"New Jersey","Mercer County",5,24,4569,2308,2261
050,34,021,"New Jersey","Mercer County",5,25,4509,2286,2223
050,34,021,"New Jersey","Mercer County",5,26,4559,2324,2235
050,34,021,"New Jersey","Mercer County",5,27,4576,2354,2222
050,34,021,"New Jersey","Mercer County",5,28,4511,2286,2225
050,34,021,"New Jersey","Mercer County",5,29,4633,2413,2220
050,34,021,"New Jersey","Mercer County",5,30,4727,2392,2335
050,34,021,"New Jersey","Mercer County",5,31,4603,2379,2224
050,34,021,"New Jersey","Mercer County",5,32,4883,2512,2371
050,34,021,"New Jersey","Mercer County",5,33,4862,2497,2365
050,34,021,"New Jersey","Mercer County",5,34,4700,2349,2351
050,34,021,"New Jersey","Mercer County",5,35,4752,2413,2339
050,34,021,"New Jersey","Mercer County",5,36,4717,2354,2363
050,34,021,"New Jersey","Mercer County",5,37,4904,2475,2429
050,34,021,"New Jersey","Mercer County",5,38,4993,2520,2473
050,34,021,"New Jersey","Mercer County",5,39,4962,2492,2470
050,34,021,"New Jersey","Mercer County",5,40,4963,2509,2454
050,34,021,"New Jersey","Mercer County",5,41,5099,2529,2570
050,34,021,"New Jersey","Mercer County",5,42,5115,2554,2561
050,34,021,"New Jersey","Mercer County",5,43,5186,2613,2573
050,34,021,"New Jersey","Mercer County",5,44,5062,2534,2528
050,34,021,"New Jersey","Mercer County",5,45,5047,2503,2544
050,34,021,"New Jersey","Mercer County",5,46,5045,2511,2534
050,34,021,"New Jersey","Mercer County",5,47,5004,2501,2503
050,34,021,"New Jersey","Mercer County",5,48,5084,2543,2541
050,34,021,"New Jersey","Mercer County",5,49,4938,2497,2441
050,34,021,"New Jersey","Mercer County",5,50,4926,2452,2474
050,34,021,"New Jersey","Mercer County",5,51,5096,2523,2573
050,34,021,"New Jersey","Mercer County",5,52,5444,2697,2747
050,34,021,"New Jersey","Mercer County",5,53,5337,2684,2653
050,34,021,"New Jersey","Mercer County",5,54,5080,2532,2548
050,34,021,"New Jersey","Mercer County",5,55,5002,2484,2518
050,34,021,"New Jersey","Mercer County",5,56,4994,2484,2510
050,34,021,"New Jersey","Mercer County",5,57,5085,2495,2590
050,34,021,"New Jersey","Mercer County",5,58,5164,2512,2652
050,34,021,"New Jersey","Mercer County",5,59,5078,2489,2589
050,34,021,"New Jersey","Mercer County",5,60,4952,2462,2490
050,34,021,"New Jersey","Mercer County",5,61,4961,2448,2513
050,34,021,"New Jersey","Mercer County",5,62,4974,2414,2560
050,34,021,"New Jersey","Mercer County",5,63,4746,2310,2436
050,34,021,"New Jersey","Mercer County",5,64,4561,2225,2336
050,34,021,"New Jersey","Mercer County",5,65,4504,2183,2321
050,34,021,"New Jersey","Mercer County",5,66,4335,2095,2240
050,34,021,"New Jersey","Mercer County",5,67,4012,1956,2056
050,34,021,"New Jersey","Mercer County",5,68,3966,1876,2090
050,34,021,"New Jersey","Mercer County",5,69,3697,1693,2004
050,34,021,"New Jersey","Mercer County",5,70,3588,1678,1910
050,34,021,"New Jersey","Mercer County",5,71,3413,1577,1836
050,34,021,"New Jersey","Mercer County",5,72,3259,1502,1757
050,34,021,"New Jersey","Mercer County",5,73,3013,1375,1638
050,34,021,"New Jersey","Mercer County",5,74,2981,1328,1653
050,34,021,"New Jersey","Mercer County",5,75,2841,1268,1573
050,34,021,"New Jersey","Mercer County",5,76,2921,1322,1599
050,34,021,"New Jersey","Mercer County",5,77,2086,905,1181
050,34,021,"New Jersey","Mercer County",5,78,2022,872,1150
050,34,021,"New Jersey","Mercer County",5,79,1912,827,1085
050,34,021,"New Jersey","Mercer County",5,80,1922,806,1116
050,34,021,"New Jersey","Mercer County",5,81,1668,682,986
050,34,021,"New Jersey","Mercer County",5,82,1454,599,855
050,34,021,"New Jersey","Mercer County",5,83,1267,528,739
050,34,021,"New Jersey","Mercer County",5,84,1175,457,718
050,34,021,"New Jersey","Mercer County",5,85,7184,2559,4625
050,34,023,"New Jersey","Middlesex County",1,0,9032,4625,4407
050,34,023,"New Jersey","Middlesex County",1,1,9276,4759,4517
050,34,023,"New Jersey","Middlesex County",1,2,9886,5067,4819
050,34,023,"New Jersey","Middlesex County",1,3,10193,5245,4948
050,34,023,"New Jersey","Middlesex County",1,4,10244,5290,4954
050,34,023,"New Jersey","Middlesex County",1,5,10188,5199,4989
050,34,023,"New Jersey","Middlesex County",1,6,10186,5185,5001
050,34,023,"New Jersey","Middlesex County",1,7,10313,5337,4976
050,34,023,"New Jersey","Middlesex County",1,8,10525,5423,5102
050,34,023,"New Jersey","Middlesex County",1,9,10625,5501,5124
050,34,023,"New Jersey","Middlesex County",1,10,10755,5485,5270
050,34,023,"New Jersey","Middlesex County",1,11,10986,5589,5397
050,34,023,"New Jersey","Middlesex County",1,12,11321,5690,5631
050,34,023,"New Jersey","Middlesex County",1,13,11239,5638,5601
050,34,023,"New Jersey","Middlesex County",1,14,11022,5587,5435
050,34,023,"New Jersey","Middlesex County",1,15,11058,5627,5431
050,34,023,"New Jersey","Middlesex County",1,16,11296,5795,5501
050,34,023,"New Jersey","Middlesex County",1,17,11188,5755,5433
050,34,023,"New Jersey","Middlesex County",1,18,12596,6500,6096
050,34,023,"New Jersey","Middlesex County",1,19,13031,6765,6266
050,34,023,"New Jersey","Middlesex County",1,20,11768,5980,5788
050,34,023,"New Jersey","Middlesex County",1,21,11422,5783,5639
050,34,023,"New Jersey","Middlesex County",1,22,10656,5389,5267
050,34,023,"New Jersey","Middlesex County",1,23,10347,5215,5132
050,34,023,"New Jersey","Middlesex County",1,24,10550,5404,5146
050,34,023,"New Jersey","Middlesex County",1,25,10505,5217,5288
050,34,023,"New Jersey","Middlesex County",1,26,10814,5342,5472
050,34,023,"New Jersey","Middlesex County",1,27,10949,5473,5476
050,34,023,"New Jersey","Middlesex County",1,28,10846,5480,5366
050,34,023,"New Jersey","Middlesex County",1,29,11090,5624,5466
050,34,023,"New Jersey","Middlesex County",1,30,11354,5680,5674
050,34,023,"New Jersey","Middlesex County",1,31,11430,5801,5629
050,34,023,"New Jersey","Middlesex County",1,32,11361,5775,5586
050,34,023,"New Jersey","Middlesex County",1,33,11590,5833,5757
050,34,023,"New Jersey","Middlesex County",1,34,11943,6100,5843
050,34,023,"New Jersey","Middlesex County",1,35,11948,6075,5873
050,34,023,"New Jersey","Middlesex County",1,36,12060,6120,5940
050,34,023,"New Jersey","Middlesex County",1,37,12289,6305,5984
050,34,023,"New Jersey","Middlesex County",1,38,12290,6309,5981
050,34,023,"New Jersey","Middlesex County",1,39,12188,6158,6030
050,34,023,"New Jersey","Middlesex County",1,40,12076,6131,5945
050,34,023,"New Jersey","Middlesex County",1,41,11753,5915,5838
050,34,023,"New Jersey","Middlesex County",1,42,11701,5860,5841
050,34,023,"New Jersey","Middlesex County",1,43,11757,6001,5756
050,34,023,"New Jersey","Middlesex County",1,44,11589,5907,5682
050,34,023,"New Jersey","Middlesex County",1,45,11417,5769,5648
050,34,023,"New Jersey","Middlesex County",1,46,11222,5730,5492
050,34,023,"New Jersey","Middlesex County",1,47,11364,5758,5606
050,34,023,"New Jersey","Middlesex County",1,48,11700,5971,5729
050,34,023,"New Jersey","Middlesex County",1,49,12095,6127,5968
050,34,023,"New Jersey","Middlesex County",1,50,11841,5963,5878
050,34,023,"New Jersey","Middlesex County",1,51,11646,5848,5798
050,34,023,"New Jersey","Middlesex County",1,52,11529,5727,5802
050,34,023,"New Jersey","Middlesex County",1,53,11542,5821,5721
050,34,023,"New Jersey","Middlesex County",1,54,11727,5909,5818
050,34,023,"New Jersey","Middlesex County",1,55,11899,5904,5995
050,34,023,"New Jersey","Middlesex County",1,56,11968,5964,6004
050,34,023,"New Jersey","Middlesex County",1,57,11925,5885,6040
050,34,023,"New Jersey","Middlesex County",1,58,11791,5815,5976
050,34,023,"New Jersey","Middlesex County",1,59,11695,5723,5972
050,34,023,"New Jersey","Middlesex County",1,60,11470,5569,5901
050,34,023,"New Jersey","Middlesex County",1,61,11276,5560,5716
050,34,023,"New Jersey","Middlesex County",1,62,11227,5543,5684
050,34,023,"New Jersey","Middlesex County",1,63,10714,5248,5466
050,34,023,"New Jersey","Middlesex County",1,64,10166,4905,5261
050,34,023,"New Jersey","Middlesex County",1,65,9827,4752,5075
050,34,023,"New Jersey","Middlesex County",1,66,9265,4464,4801
050,34,023,"New Jersey","Middlesex County",1,67,8842,4262,4580
050,34,023,"New Jersey","Middlesex County",1,68,8398,4040,4358
050,34,023,"New Jersey","Middlesex County",1,69,7838,3658,4180
050,34,023,"New Jersey","Middlesex County",1,70,7395,3402,3993
050,34,023,"New Jersey","Middlesex County",1,71,7055,3298,3757
050,34,023,"New Jersey","Middlesex County",1,72,7159,3311,3848
050,34,023,"New Jersey","Middlesex County",1,73,7225,3307,3918
050,34,023,"New Jersey","Middlesex County",1,74,5249,2368,2881
050,34,023,"New Jersey","Middlesex County",1,75,5092,2309,2783
050,34,023,"New Jersey","Middlesex County",1,76,4888,2171,2717
050,34,023,"New Jersey","Middlesex County",1,77,4933,2180,2753
050,34,023,"New Jersey","Middlesex County",1,78,4164,1819,2345
050,34,023,"New Jersey","Middlesex County",1,79,3735,1584,2151
050,34,023,"New Jersey","Middlesex County",1,80,3526,1492,2034
050,34,023,"New Jersey","Middlesex County",1,81,3304,1391,1913
050,34,023,"New Jersey","Middlesex County",1,82,3091,1269,1822
050,34,023,"New Jersey","Middlesex County",1,83,2742,1132,1610
050,34,023,"New Jersey","Middlesex County",1,84,2492,975,1517
050,34,023,"New Jersey","Middlesex County",1,85,15532,5476,10056
050,34,023,"New Jersey","Middlesex County",2,0,9004,4620,4384
050,34,023,"New Jersey","Middlesex County",2,1,9224,4728,4496
050,34,023,"New Jersey","Middlesex County",2,2,9728,4992,4736
050,34,023,"New Jersey","Middlesex County",2,3,10099,5196,4903
050,34,023,"New Jersey","Middlesex County",2,4,10225,5269,4956
050,34,023,"New Jersey","Middlesex County",2,5,10213,5227,4986
050,34,023,"New Jersey","Middlesex County",2,6,10191,5196,4995
050,34,023,"New Jersey","Middlesex County",2,7,10265,5293,4972
050,34,023,"New Jersey","Middlesex County",2,8,10410,5367,5043
050,34,023,"New Jersey","Middlesex County",2,9,10590,5474,5116
050,34,023,"New Jersey","Middlesex County",2,10,10731,5487,5244
050,34,023,"New Jersey","Middlesex County",2,11,10882,5529,5353
050,34,023,"New Jersey","Middlesex County",2,12,11292,5686,5606
050,34,023,"New Jersey","Middlesex County",2,13,11227,5637,5590
050,34,023,"New Jersey","Middlesex County",2,14,11084,5607,5477
050,34,023,"New Jersey","Middlesex County",2,15,11061,5624,5437
050,34,023,"New Jersey","Middlesex County",2,16,11261,5766,5495
050,34,023,"New Jersey","Middlesex County",2,17,11255,5794,5461
050,34,023,"New Jersey","Middlesex County",2,18,12563,6471,6092
050,34,023,"New Jersey","Middlesex County",2,19,13071,6777,6294
050,34,023,"New Jersey","Middlesex County",2,20,11949,6066,5883
050,34,023,"New Jersey","Middlesex County",2,21,11397,5765,5632
050,34,023,"New Jersey","Middlesex County",2,22,10652,5375,5277
050,34,023,"New Jersey","Middlesex County",2,23,10311,5209,5102
050,34,023,"New Jersey","Middlesex County",2,24,10446,5324,5122
050,34,023,"New Jersey","Middlesex County",2,25,10494,5247,5247
050,34,023,"New Jersey","Middlesex County",2,26,10755,5325,5430
050,34,023,"New Jersey","Middlesex County",2,27,10872,5428,5444
050,34,023,"New Jersey","Middlesex County",2,28,10866,5484,5382
050,34,023,"New Jersey","Middlesex County",2,29,10993,5561,5432
050,34,023,"New Jersey","Middlesex County",2,30,11353,5699,5654
050,34,023,"New Jersey","Middlesex County",2,31,11358,5751,5607
050,34,023,"New Jersey","Middlesex County",2,32,11342,5757,5585
050,34,023,"New Jersey","Middlesex County",2,33,11522,5820,5702
050,34,023,"New Jersey","Middlesex County",2,34,11871,6053,5818
050,34,023,"New Jersey","Middlesex County",2,35,11991,6109,5882
050,34,023,"New Jersey","Middlesex County",2,36,11969,6081,5888
050,34,023,"New Jersey","Middlesex County",2,37,12235,6268,5967
050,34,023,"New Jersey","Middlesex County",2,38,12321,6333,5988
050,34,023,"New Jersey","Middlesex County",2,39,12121,6142,5979
050,34,023,"New Jersey","Middlesex County",2,40,12159,6168,5991
050,34,023,"New Jersey","Middlesex County",2,41,11787,5934,5853
050,34,023,"New Jersey","Middlesex County",2,42,11639,5839,5800
050,34,023,"New Jersey","Middlesex County",2,43,11757,5967,5790
050,34,023,"New Jersey","Middlesex County",2,44,11531,5873,5658
050,34,023,"New Jersey","Middlesex County",2,45,11475,5801,5674
050,34,023,"New Jersey","Middlesex County",2,46,11220,5708,5512
050,34,023,"New Jersey","Middlesex County",2,47,11291,5732,5559
050,34,023,"New Jersey","Middlesex County",2,48,11605,5908,5697
050,34,023,"New Jersey","Middlesex County",2,49,11988,6077,5911
050,34,023,"New Jersey","Middlesex County",2,50,11897,5993,5904
050,34,023,"New Jersey","Middlesex County",2,51,11629,5842,5787
050,34,023,"New Jersey","Middlesex County",2,52,11549,5755,5794
050,34,023,"New Jersey","Middlesex County",2,53,11476,5766,5710
050,34,023,"New Jersey","Middlesex County",2,54,11636,5870,5766
050,34,023,"New Jersey","Middlesex County",2,55,11818,5883,5935
050,34,023,"New Jersey","Middlesex County",2,56,11951,5947,6004
050,34,023,"New Jersey","Middlesex County",2,57,11911,5889,6022
050,34,023,"New Jersey","Middlesex County",2,58,11747,5790,5957
050,34,023,"New Jersey","Middlesex County",2,59,11648,5700,5948
050,34,023,"New Jersey","Middlesex County",2,60,11508,5589,5919
050,34,023,"New Jersey","Middlesex County",2,61,11231,5520,5711
050,34,023,"New Jersey","Middlesex County",2,62,11174,5509,5665
050,34,023,"New Jersey","Middlesex County",2,63,10818,5297,5521
050,34,023,"New Jersey","Middlesex County",2,64,10172,4920,5252
050,34,023,"New Jersey","Middlesex County",2,65,9831,4734,5097
050,34,023,"New Jersey","Middlesex County",2,66,9342,4498,4844
050,34,023,"New Jersey","Middlesex County",2,67,8842,4257,4585
050,34,023,"New Jersey","Middlesex County",2,68,8415,4044,4371
050,34,023,"New Jersey","Middlesex County",2,69,7925,3710,4215
050,34,023,"New Jersey","Middlesex County",2,70,7434,3429,4005
050,34,023,"New Jersey","Middlesex County",2,71,7064,3278,3786
050,34,023,"New Jersey","Middlesex County",2,72,6996,3236,3760
050,34,023,"New Jersey","Middlesex County",2,73,7404,3393,4011
050,34,023,"New Jersey","Middlesex County",2,74,5398,2434,2964
050,34,023,"New Jersey","Middlesex County",2,75,5091,2305,2786
050,34,023,"New Jersey","Middlesex County",2,76,4848,2160,2688
050,34,023,"New Jersey","Middlesex County",2,77,4925,2171,2754
050,34,023,"New Jersey","Middlesex County",2,78,4238,1852,2386
050,34,023,"New Jersey","Middlesex County",2,79,3735,1589,2146
050,34,023,"New Jersey","Middlesex County",2,80,3511,1481,2030
050,34,023,"New Jersey","Middlesex County",2,81,3280,1375,1905
050,34,023,"New Jersey","Middlesex County",2,82,3075,1257,1818
050,34,023,"New Jersey","Middlesex County",2,83,2743,1120,1623
050,34,023,"New Jersey","Middlesex County",2,84,2472,977,1495
050,34,023,"New Jersey","Middlesex County",2,85,15028,5271,9757
050,34,023,"New Jersey","Middlesex County",3,0,8398,4287,4111
050,34,023,"New Jersey","Middlesex County",3,1,9114,4718,4396
050,34,023,"New Jersey","Middlesex County",3,2,9271,4785,4486
050,34,023,"New Jersey","Middlesex County",3,3,9833,5014,4819
050,34,023,"New Jersey","Middlesex County",3,4,10161,5220,4941
050,34,023,"New Jersey","Middlesex County",3,5,10235,5273,4962
050,34,023,"New Jersey","Middlesex County",3,6,10245,5299,4946
050,34,023,"New Jersey","Middlesex County",3,7,10182,5214,4968
050,34,023,"New Jersey","Middlesex County",3,8,10284,5325,4959
050,34,023,"New Jersey","Middlesex County",3,9,10466,5425,5041
050,34,023,"New Jersey","Middlesex County",3,10,10616,5492,5124
050,34,023,"New Jersey","Middlesex County",3,11,10686,5459,5227
050,34,023,"New Jersey","Middlesex County",3,12,10884,5531,5353
050,34,023,"New Jersey","Middlesex County",3,13,11281,5701,5580
050,34,023,"New Jersey","Middlesex County",3,14,11273,5640,5633
050,34,023,"New Jersey","Middlesex County",3,15,11077,5587,5490
050,34,023,"New Jersey","Middlesex County",3,16,11078,5660,5418
050,34,023,"New Jersey","Middlesex County",3,17,11367,5836,5531
050,34,023,"New Jersey","Middlesex County",3,18,12871,6621,6250
050,34,023,"New Jersey","Middlesex County",3,19,13091,6778,6313
050,34,023,"New Jersey","Middlesex County",3,20,12123,6181,5942
050,34,023,"New Jersey","Middlesex County",3,21,11573,5855,5718
050,34,023,"New Jersey","Middlesex County",3,22,10582,5360,5222
050,34,023,"New Jersey","Middlesex County",3,23,10223,5153,5070
050,34,023,"New Jersey","Middlesex County",3,24,10409,5310,5099
050,34,023,"New Jersey","Middlesex County",3,25,10603,5363,5240
050,34,023,"New Jersey","Middlesex County",3,26,10681,5404,5277
050,34,023,"New Jersey","Middlesex County",3,27,10856,5417,5439
050,34,023,"New Jersey","Middlesex County",3,28,11018,5505,5513
050,34,023,"New Jersey","Middlesex County",3,29,11006,5532,5474
050,34,023,"New Jersey","Middlesex County",3,30,11153,5655,5498
050,34,023,"New Jersey","Middlesex County",3,31,11606,5840,5766
050,34,023,"New Jersey","Middlesex County",3,32,11363,5784,5579
050,34,023,"New Jersey","Middlesex County",3,33,11430,5780,5650
050,34,023,"New Jersey","Middlesex County",3,34,11603,5836,5767
050,34,023,"New Jersey","Middlesex County",3,35,11995,6137,5858
050,34,023,"New Jersey","Middlesex County",3,36,12150,6183,5967
050,34,023,"New Jersey","Middlesex County",3,37,11978,6114,5864
050,34,023,"New Jersey","Middlesex County",3,38,12331,6316,6015
050,34,023,"New Jersey","Middlesex County",3,39,12359,6341,6018
050,34,023,"New Jersey","Middlesex County",3,40,12137,6162,5975
050,34,023,"New Jersey","Middlesex County",3,41,12120,6143,5977
050,34,023,"New Jersey","Middlesex County",3,42,11805,5934,5871
050,34,023,"New Jersey","Middlesex County",3,43,11561,5804,5757
050,34,023,"New Jersey","Middlesex County",3,44,11650,5929,5721
050,34,023,"New Jersey","Middlesex County",3,45,11410,5799,5611
050,34,023,"New Jersey","Middlesex County",3,46,11463,5794,5669
050,34,023,"New Jersey","Middlesex County",3,47,11133,5649,5484
050,34,023,"New Jersey","Middlesex County",3,48,11203,5679,5524
050,34,023,"New Jersey","Middlesex County",3,49,11508,5896,5612
050,34,023,"New Jersey","Middlesex County",3,50,11927,6014,5913
050,34,023,"New Jersey","Middlesex County",3,51,11847,5985,5862
050,34,023,"New Jersey","Middlesex County",3,52,11473,5753,5720
050,34,023,"New Jersey","Middlesex County",3,53,11457,5724,5733
050,34,023,"New Jersey","Middlesex County",3,54,11352,5695,5657
050,34,023,"New Jersey","Middlesex County",3,55,11445,5767,5678
050,34,023,"New Jersey","Middlesex County",3,56,11597,5757,5840
050,34,023,"New Jersey","Middlesex County",3,57,11842,5891,5951
050,34,023,"New Jersey","Middlesex County",3,58,11761,5861,5900
050,34,023,"New Jersey","Middlesex County",3,59,11569,5696,5873
050,34,023,"New Jersey","Middlesex County",3,60,11363,5560,5803
050,34,023,"New Jersey","Middlesex County",3,61,11271,5478,5793
050,34,023,"New Jersey","Middlesex County",3,62,10951,5365,5586
050,34,023,"New Jersey","Middlesex County",3,63,10864,5332,5532
050,34,023,"New Jersey","Middlesex County",3,64,10534,5112,5422
050,34,023,"New Jersey","Middlesex County",3,65,9989,4814,5175
050,34,023,"New Jersey","Middlesex County",3,66,9650,4628,5022
050,34,023,"New Jersey","Middlesex County",3,67,9099,4362,4737
050,34,023,"New Jersey","Middlesex County",3,68,8628,4126,4502
050,34,023,"New Jersey","Middlesex County",3,69,8273,3978,4295
050,34,023,"New Jersey","Middlesex County",3,70,7714,3608,4106
050,34,023,"New Jersey","Middlesex County",3,71,7257,3310,3947
050,34,023,"New Jersey","Middlesex County",3,72,6881,3177,3704
050,34,023,"New Jersey","Middlesex County",3,73,6811,3135,3676
050,34,023,"New Jersey","Middlesex County",3,74,7175,3250,3925
050,34,023,"New Jersey","Middlesex County",3,75,5240,2359,2881
050,34,023,"New Jersey","Middlesex County",3,76,4948,2214,2734
050,34,023,"New Jersey","Middlesex County",3,77,4690,2067,2623
050,34,023,"New Jersey","Middlesex County",3,78,4736,2073,2663
050,34,023,"New Jersey","Middlesex County",3,79,4044,1755,2289
050,34,023,"New Jersey","Middlesex County",3,80,3580,1507,2073
050,34,023,"New Jersey","Middlesex County",3,81,3383,1405,1978
050,34,023,"New Jersey","Middlesex County",3,82,3086,1287,1799
050,34,023,"New Jersey","Middlesex County",3,83,2873,1152,1721
050,34,023,"New Jersey","Middlesex County",3,84,2554,1025,1529
050,34,023,"New Jersey","Middlesex County",3,85,15055,5316,9739
050,34,023,"New Jersey","Middlesex County",4,0,8704,4471,4233
050,34,023,"New Jersey","Middlesex County",4,1,8658,4376,4282
050,34,023,"New Jersey","Middlesex County",4,2,9201,4762,4439
050,34,023,"New Jersey","Middlesex County",4,3,9392,4853,4539
050,34,023,"New Jersey","Middlesex County",4,4,9856,5009,4847
050,34,023,"New Jersey","Middlesex County",4,5,10213,5236,4977
050,34,023,"New Jersey","Middlesex County",4,6,10279,5290,4989
050,34,023,"New Jersey","Middlesex County",4,7,10271,5310,4961
050,34,023,"New Jersey","Middlesex County",4,8,10216,5222,4994
050,34,023,"New Jersey","Middlesex County",4,9,10259,5312,4947
050,34,023,"New Jersey","Middlesex County",4,10,10502,5446,5056
050,34,023,"New Jersey","Middlesex County",4,11,10648,5489,5159
050,34,023,"New Jersey","Middlesex County",4,12,10683,5470,5213
050,34,023,"New Jersey","Middlesex County",4,13,10889,5536,5353
050,34,023,"New Jersey","Middlesex County",4,14,11298,5698,5600
050,34,023,"New Jersey","Middlesex County",4,15,11275,5636,5639
050,34,023,"New Jersey","Middlesex County",4,16,11153,5624,5529
050,34,023,"New Jersey","Middlesex County",4,17,11217,5743,5474
050,34,023,"New Jersey","Middlesex County",4,18,12727,6573,6154
050,34,023,"New Jersey","Middlesex County",4,19,13038,6754,6284
050,34,023,"New Jersey","Middlesex County",4,20,11988,6104,5884
050,34,023,"New Jersey","Middlesex County",4,21,11629,5911,5718
050,34,023,"New Jersey","Middlesex County",4,22,10894,5509,5385
050,34,023,"New Jersey","Middlesex County",4,23,10145,5095,5050
050,34,023,"New Jersey","Middlesex County",4,24,10218,5151,5067
050,34,023,"New Jersey","Middlesex County",4,25,10354,5279,5075
050,34,023,"New Jersey","Middlesex County",4,26,10683,5384,5299
050,34,023,"New Jersey","Middlesex County",4,27,10627,5386,5241
050,34,023,"New Jersey","Middlesex County",4,28,10861,5399,5462
050,34,023,"New Jersey","Middlesex County",4,29,10896,5473,5423
050,34,023,"New Jersey","Middlesex County",4,30,11047,5562,5485
050,34,023,"New Jersey","Middlesex County",4,31,11241,5736,5505
050,34,023,"New Jersey","Middlesex County",4,32,11680,5875,5805
050,34,023,"New Jersey","Middlesex County",4,33,11482,5875,5607
050,34,023,"New Jersey","Middlesex County",4,34,11417,5764,5653
050,34,023,"New Jersey","Middlesex County",4,35,11666,5900,5766
050,34,023,"New Jersey","Middlesex County",4,36,11996,6094,5902
050,34,023,"New Jersey","Middlesex County",4,37,12194,6237,5957
050,34,023,"New Jersey","Middlesex County",4,38,11966,6130,5836
050,34,023,"New Jersey","Middlesex County",4,39,12198,6221,5977
050,34,023,"New Jersey","Middlesex County",4,40,12416,6385,6031
050,34,023,"New Jersey","Middlesex County",4,41,12127,6180,5947
050,34,023,"New Jersey","Middlesex County",4,42,12079,6137,5942
050,34,023,"New Jersey","Middlesex County",4,43,11762,5887,5875
050,34,023,"New Jersey","Middlesex County",4,44,11505,5798,5707
050,34,023,"New Jersey","Middlesex County",4,45,11525,5856,5669
050,34,023,"New Jersey","Middlesex County",4,46,11343,5777,5566
050,34,023,"New Jersey","Middlesex County",4,47,11356,5721,5635
050,34,023,"New Jersey","Middlesex County",4,48,11029,5609,5420
050,34,023,"New Jersey","Middlesex County",4,49,11139,5637,5502
050,34,023,"New Jersey","Middlesex County",4,50,11511,5853,5658
050,34,023,"New Jersey","Middlesex County",4,51,11874,6004,5870
050,34,023,"New Jersey","Middlesex County",4,52,11685,5859,5826
050,34,023,"New Jersey","Middlesex County",4,53,11340,5715,5625
050,34,023,"New Jersey","Middlesex County",4,54,11297,5623,5674
050,34,023,"New Jersey","Middlesex County",4,55,11216,5619,5597
050,34,023,"New Jersey","Middlesex County",4,56,11254,5664,5590
050,34,023,"New Jersey","Middlesex County",4,57,11420,5660,5760
050,34,023,"New Jersey","Middlesex County",4,58,11612,5810,5802
050,34,023,"New Jersey","Middlesex County",4,59,11543,5748,5795
050,34,023,"New Jersey","Middlesex County",4,60,11311,5576,5735
050,34,023,"New Jersey","Middlesex County",4,61,11159,5488,5671
050,34,023,"New Jersey","Middlesex County",4,62,11090,5366,5724
050,34,023,"New Jersey","Middlesex County",4,63,10625,5172,5453
050,34,023,"New Jersey","Middlesex County",4,64,10693,5238,5455
050,34,023,"New Jersey","Middlesex County",4,65,10337,5001,5336
050,34,023,"New Jersey","Middlesex County",4,66,9671,4636,5035
050,34,023,"New Jersey","Middlesex County",4,67,9352,4437,4915
050,34,023,"New Jersey","Middlesex County",4,68,8851,4232,4619
050,34,023,"New Jersey","Middlesex County",4,69,8402,4010,4392
050,34,023,"New Jersey","Middlesex County",4,70,8056,3870,4186
050,34,023,"New Jersey","Middlesex County",4,71,7495,3485,4010
050,34,023,"New Jersey","Middlesex County",4,72,7082,3224,3858
050,34,023,"New Jersey","Middlesex County",4,73,6725,3084,3641
050,34,023,"New Jersey","Middlesex County",4,74,6632,3029,3603
050,34,023,"New Jersey","Middlesex County",4,75,6909,3089,3820
050,34,023,"New Jersey","Middlesex County",4,76,5087,2270,2817
050,34,023,"New Jersey","Middlesex County",4,77,4744,2119,2625
050,34,023,"New Jersey","Middlesex County",4,78,4553,2004,2549
050,34,023,"New Jersey","Middlesex County",4,79,4530,1979,2551
050,34,023,"New Jersey","Middlesex County",4,80,3837,1646,2191
050,34,023,"New Jersey","Middlesex County",4,81,3432,1415,2017
050,34,023,"New Jersey","Middlesex County",4,82,3198,1321,1877
050,34,023,"New Jersey","Middlesex County",4,83,2906,1188,1718
050,34,023,"New Jersey","Middlesex County",4,84,2650,1059,1591
050,34,023,"New Jersey","Middlesex County",4,85,15073,5466,9607
050,34,023,"New Jersey","Middlesex County",5,0,8651,4453,4198
050,34,023,"New Jersey","Middlesex County",5,1,8841,4529,4312
050,34,023,"New Jersey","Middlesex County",5,2,8743,4414,4329
050,34,023,"New Jersey","Middlesex County",5,3,9260,4819,4441
050,34,023,"New Jersey","Middlesex County",5,4,9437,4850,4587
050,34,023,"New Jersey","Middlesex County",5,5,9888,5035,4853
050,34,023,"New Jersey","Middlesex County",5,6,10257,5262,4995
050,34,023,"New Jersey","Middlesex County",5,7,10249,5290,4959
050,34,023,"New Jersey","Middlesex County",5,8,10320,5342,4978
050,34,023,"New Jersey","Middlesex County",5,9,10296,5276,5020
050,34,023,"New Jersey","Middlesex County",5,10,10341,5373,4968
050,34,023,"New Jersey","Middlesex County",5,11,10553,5469,5084
050,34,023,"New Jersey","Middlesex County",5,12,10692,5496,5196
050,34,023,"New Jersey","Middlesex County",5,13,10768,5567,5201
050,34,023,"New Jersey","Middlesex County",5,14,10976,5561,5415
050,34,023,"New Jersey","Middlesex County",5,15,11371,5716,5655
050,34,023,"New Jersey","Middlesex County",5,16,11441,5752,5689
050,34,023,"New Jersey","Middlesex County",5,17,11420,5787,5633
050,34,023,"New Jersey","Middlesex County",5,18,12668,6508,6160
050,34,023,"New Jersey","Middlesex County",5,19,13179,6843,6336
050,34,023,"New Jersey","Middlesex County",5,20,12151,6198,5953
050,34,023,"New Jersey","Middlesex County",5,21,11630,5887,5743
050,34,023,"New Jersey","Middlesex County",5,22,10976,5569,5407
050,34,023,"New Jersey","Middlesex County",5,23,10350,5225,5125
050,34,023,"New Jersey","Middlesex County",5,24,10205,5146,5059
050,34,023,"New Jersey","Middlesex County",5,25,10313,5158,5155
050,34,023,"New Jersey","Middlesex County",5,26,10409,5335,5074
050,34,023,"New Jersey","Middlesex County",5,27,10653,5360,5293
050,34,023,"New Jersey","Middlesex County",5,28,10778,5451,5327
050,34,023,"New Jersey","Middlesex County",5,29,10893,5424,5469
050,34,023,"New Jersey","Middlesex County",5,30,11053,5522,5531
050,34,023,"New Jersey","Middlesex County",5,31,11234,5663,5571
050,34,023,"New Jersey","Middlesex County",5,32,11452,5840,5612
050,34,023,"New Jersey","Middlesex County",5,33,11801,5908,5893
050,34,023,"New Jersey","Middlesex County",5,34,11725,5978,5747
050,34,023,"New Jersey","Middlesex County",5,35,11509,5780,5729
050,34,023,"New Jersey","Middlesex County",5,36,11730,5942,5788
050,34,023,"New Jersey","Middlesex County",5,37,11998,6159,5839
050,34,023,"New Jersey","Middlesex County",5,38,12118,6198,5920
050,34,023,"New Jersey","Middlesex County",5,39,11953,6127,5826
050,34,023,"New Jersey","Middlesex County",5,40,12259,6240,6019
050,34,023,"New Jersey","Middlesex County",5,41,12455,6359,6096
050,34,023,"New Jersey","Middlesex County",5,42,12075,6155,5920
050,34,023,"New Jersey","Middlesex County",5,43,12008,6099,5909
050,34,023,"New Jersey","Middlesex County",5,44,11760,5898,5862
050,34,023,"New Jersey","Middlesex County",5,45,11490,5779,5711
050,34,023,"New Jersey","Middlesex County",5,46,11479,5840,5639
050,34,023,"New Jersey","Middlesex County",5,47,11353,5793,5560
050,34,023,"New Jersey","Middlesex County",5,48,11309,5725,5584
050,34,023,"New Jersey","Middlesex County",5,49,11013,5634,5379
050,34,023,"New Jersey","Middlesex County",5,50,11051,5597,5454
050,34,023,"New Jersey","Middlesex County",5,51,11475,5853,5622
050,34,023,"New Jersey","Middlesex County",5,52,11750,5933,5817
050,34,023,"New Jersey","Middlesex County",5,53,11634,5854,5780
050,34,023,"New Jersey","Middlesex County",5,54,11206,5643,5563
050,34,023,"New Jersey","Middlesex County",5,55,11161,5554,5607
050,34,023,"New Jersey","Middlesex County",5,56,11103,5543,5560
050,34,023,"New Jersey","Middlesex County",5,57,11176,5607,5569
050,34,023,"New Jersey","Middlesex County",5,58,11268,5595,5673
050,34,023,"New Jersey","Middlesex County",5,59,11488,5736,5752
050,34,023,"New Jersey","Middlesex County",5,60,11372,5687,5685
050,34,023,"New Jersey","Middlesex County",5,61,11021,5460,5561
050,34,023,"New Jersey","Middlesex County",5,62,10938,5351,5587
050,34,023,"New Jersey","Middlesex County",5,63,10827,5200,5627
050,34,023,"New Jersey","Middlesex County",5,64,10385,5058,5327
050,34,023,"New Jersey","Middlesex County",5,65,10523,5119,5404
050,34,023,"New Jersey","Middlesex County",5,66,10080,4852,5228
050,34,023,"New Jersey","Middlesex County",5,67,9448,4504,4944
050,34,023,"New Jersey","Middlesex County",5,68,9126,4298,4828
050,34,023,"New Jersey","Middlesex County",5,69,8707,4172,4535
050,34,023,"New Jersey","Middlesex County",5,70,8237,3909,4328
050,34,023,"New Jersey","Middlesex County",5,71,7934,3799,4135
050,34,023,"New Jersey","Middlesex County",5,72,7355,3427,3928
050,34,023,"New Jersey","Middlesex County",5,73,6990,3154,3836
050,34,023,"New Jersey","Middlesex County",5,74,6557,2987,3570
050,34,023,"New Jersey","Middlesex County",5,75,6413,2917,3496
050,34,023,"New Jersey","Middlesex County",5,76,6740,3014,3726
050,34,023,"New Jersey","Middlesex County",5,77,4957,2219,2738
050,34,023,"New Jersey","Middlesex County",5,78,4616,2065,2551
050,34,023,"New Jersey","Middlesex County",5,79,4354,1906,2448
050,34,023,"New Jersey","Middlesex County",5,80,4313,1860,2453
050,34,023,"New Jersey","Middlesex County",5,81,3685,1531,2154
050,34,023,"New Jersey","Middlesex County",5,82,3241,1333,1908
050,34,023,"New Jersey","Middlesex County",5,83,3000,1222,1778
050,34,023,"New Jersey","Middlesex County",5,84,2709,1095,1614
050,34,023,"New Jersey","Middlesex County",5,85,15300,5650,9650
050,34,025,"New Jersey","Monmouth County",1,0,6075,3103,2972
050,34,025,"New Jersey","Monmouth County",1,1,6324,3210,3114
050,34,025,"New Jersey","Monmouth County",1,2,6257,3190,3067
050,34,025,"New Jersey","Monmouth County",1,3,6567,3381,3186
050,34,025,"New Jersey","Monmouth County",1,4,6773,3446,3327
050,34,025,"New Jersey","Monmouth County",1,5,6939,3525,3414
050,34,025,"New Jersey","Monmouth County",1,6,6960,3536,3424
050,34,025,"New Jersey","Monmouth County",1,7,7132,3666,3466
050,34,025,"New Jersey","Monmouth County",1,8,7438,3808,3630
050,34,025,"New Jersey","Monmouth County",1,9,7582,3868,3714
050,34,025,"New Jersey","Monmouth County",1,10,7826,4032,3794
050,34,025,"New Jersey","Monmouth County",1,11,8145,4131,4014
050,34,025,"New Jersey","Monmouth County",1,12,8446,4273,4173
050,34,025,"New Jersey","Monmouth County",1,13,8836,4543,4293
050,34,025,"New Jersey","Monmouth County",1,14,8792,4510,4282
050,34,025,"New Jersey","Monmouth County",1,15,8812,4474,4338
050,34,025,"New Jersey","Monmouth County",1,16,9211,4627,4584
050,34,025,"New Jersey","Monmouth County",1,17,9190,4700,4490
050,34,025,"New Jersey","Monmouth County",1,18,8139,4230,3909
050,34,025,"New Jersey","Monmouth County",1,19,7115,3678,3437
050,34,025,"New Jersey","Monmouth County",1,20,7287,3714,3573
050,34,025,"New Jersey","Monmouth County",1,21,7438,3798,3640
050,34,025,"New Jersey","Monmouth County",1,22,7641,3896,3745
050,34,025,"New Jersey","Monmouth County",1,23,7499,3752,3747
050,34,025,"New Jersey","Monmouth County",1,24,7532,3842,3690
050,34,025,"New Jersey","Monmouth County",1,25,7395,3787,3608
050,34,025,"New Jersey","Monmouth County",1,26,7272,3706,3566
050,34,025,"New Jersey","Monmouth County",1,27,7259,3721,3538
050,34,025,"New Jersey","Monmouth County",1,28,6998,3530,3468
050,34,025,"New Jersey","Monmouth County",1,29,6647,3359,3288
050,34,025,"New Jersey","Monmouth County",1,30,6705,3463,3242
050,34,025,"New Jersey","Monmouth County",1,31,6578,3334,3244
050,34,025,"New Jersey","Monmouth County",1,32,6667,3344,3323
050,34,025,"New Jersey","Monmouth County",1,33,6878,3459,3419
050,34,025,"New Jersey","Monmouth County",1,34,7114,3577,3537
050,34,025,"New Jersey","Monmouth County",1,35,7158,3581,3577
050,34,025,"New Jersey","Monmouth County",1,36,7231,3653,3578
050,34,025,"New Jersey","Monmouth County",1,37,7376,3640,3736
050,34,025,"New Jersey","Monmouth County",1,38,7437,3710,3727
050,34,025,"New Jersey","Monmouth County",1,39,7490,3675,3815
050,34,025,"New Jersey","Monmouth County",1,40,7562,3677,3885
050,34,025,"New Jersey","Monmouth County",1,41,7639,3695,3944
050,34,025,"New Jersey","Monmouth County",1,42,7711,3773,3938
050,34,025,"New Jersey","Monmouth County",1,43,7665,3800,3865
050,34,025,"New Jersey","Monmouth County",1,44,7787,3884,3903
050,34,025,"New Jersey","Monmouth County",1,45,7861,3862,3999
050,34,025,"New Jersey","Monmouth County",1,46,7774,3812,3962
050,34,025,"New Jersey","Monmouth County",1,47,8093,3985,4108
050,34,025,"New Jersey","Monmouth County",1,48,8873,4397,4476
050,34,025,"New Jersey","Monmouth County",1,49,9606,4740,4866
050,34,025,"New Jersey","Monmouth County",1,50,9573,4716,4857
050,34,025,"New Jersey","Monmouth County",1,51,9459,4644,4815
050,34,025,"New Jersey","Monmouth County",1,52,9405,4619,4786
050,34,025,"New Jersey","Monmouth County",1,53,9847,4767,5080
050,34,025,"New Jersey","Monmouth County",1,54,10154,4917,5237
050,34,025,"New Jersey","Monmouth County",1,55,10673,5176,5497
050,34,025,"New Jersey","Monmouth County",1,56,10806,5218,5588
050,34,025,"New Jersey","Monmouth County",1,57,10798,5295,5503
050,34,025,"New Jersey","Monmouth County",1,58,10928,5397,5531
050,34,025,"New Jersey","Monmouth County",1,59,10744,5309,5435
050,34,025,"New Jersey","Monmouth County",1,60,10437,5277,5160
050,34,025,"New Jersey","Monmouth County",1,61,10187,5088,5099
050,34,025,"New Jersey","Monmouth County",1,62,9945,4804,5141
050,34,025,"New Jersey","Monmouth County",1,63,9506,4644,4862
050,34,025,"New Jersey","Monmouth County",1,64,9012,4444,4568
050,34,025,"New Jersey","Monmouth County",1,65,8552,4169,4383
050,34,025,"New Jersey","Monmouth County",1,66,8012,3904,4108
050,34,025,"New Jersey","Monmouth County",1,67,7626,3680,3946
050,34,025,"New Jersey","Monmouth County",1,68,7255,3422,3833
050,34,025,"New Jersey","Monmouth County",1,69,6756,3192,3564
050,34,025,"New Jersey","Monmouth County",1,70,6587,3071,3516
050,34,025,"New Jersey","Monmouth County",1,71,6376,2992,3384
050,34,025,"New Jersey","Monmouth County",1,72,6416,3001,3415
050,34,025,"New Jersey","Monmouth County",1,73,6501,3005,3496
050,34,025,"New Jersey","Monmouth County",1,74,4545,2122,2423
050,34,025,"New Jersey","Monmouth County",1,75,4381,2041,2340
050,34,025,"New Jersey","Monmouth County",1,76,4286,1940,2346
050,34,025,"New Jersey","Monmouth County",1,77,4368,1988,2380
050,34,025,"New Jersey","Monmouth County",1,78,3662,1594,2068
050,34,025,"New Jersey","Monmouth County",1,79,3223,1368,1855
050,34,025,"New Jersey","Monmouth County",1,80,2855,1190,1665
050,34,025,"New Jersey","Monmouth County",1,81,2642,1114,1528
050,34,025,"New Jersey","Monmouth County",1,82,2560,1025,1535
050,34,025,"New Jersey","Monmouth County",1,83,2243,906,1337
050,34,025,"New Jersey","Monmouth County",1,84,2163,863,1300
050,34,025,"New Jersey","Monmouth County",1,85,14397,4820,9577
050,34,025,"New Jersey","Monmouth County",2,0,6088,3092,2996
050,34,025,"New Jersey","Monmouth County",2,1,6290,3204,3086
050,34,025,"New Jersey","Monmouth County",2,2,6309,3216,3093
050,34,025,"New Jersey","Monmouth County",2,3,6493,3333,3160
050,34,025,"New Jersey","Monmouth County",2,4,6775,3455,3320
050,34,025,"New Jersey","Monmouth County",2,5,6933,3519,3414
050,34,025,"New Jersey","Monmouth County",2,6,6993,3556,3437
050,34,025,"New Jersey","Monmouth County",2,7,7105,3640,3465
050,34,025,"New Jersey","Monmouth County",2,8,7363,3769,3594
050,34,025,"New Jersey","Monmouth County",2,9,7562,3861,3701
050,34,025,"New Jersey","Monmouth County",2,10,7791,4001,3790
050,34,025,"New Jersey","Monmouth County",2,11,8048,4097,3951
050,34,025,"New Jersey","Monmouth County",2,12,8424,4267,4157
050,34,025,"New Jersey","Monmouth County",2,13,8745,4480,4265
050,34,025,"New Jersey","Monmouth County",2,14,8801,4518,4283
050,34,025,"New Jersey","Monmouth County",2,15,8824,4490,4334
050,34,025,"New Jersey","Monmouth County",2,16,9129,4604,4525
050,34,025,"New Jersey","Monmouth County",2,17,9200,4684,4516
050,34,025,"New Jersey","Monmouth County",2,18,8148,4234,3914
050,34,025,"New Jersey","Monmouth County",2,19,7144,3684,3460
050,34,025,"New Jersey","Monmouth County",2,20,7331,3749,3582
050,34,025,"New Jersey","Monmouth County",2,21,7410,3775,3635
050,34,025,"New Jersey","Monmouth County",2,22,7591,3859,3732
050,34,025,"New Jersey","Monmouth County",2,23,7527,3790,3737
050,34,025,"New Jersey","Monmouth County",2,24,7469,3802,3667
050,34,025,"New Jersey","Monmouth County",2,25,7385,3782,3603
050,34,025,"New Jersey","Monmouth County",2,26,7292,3725,3567
050,34,025,"New Jersey","Monmouth County",2,27,7228,3693,3535
050,34,025,"New Jersey","Monmouth County",2,28,7058,3569,3489
050,34,025,"New Jersey","Monmouth County",2,29,6737,3404,3333
050,34,025,"New Jersey","Monmouth County",2,30,6739,3454,3285
050,34,025,"New Jersey","Monmouth County",2,31,6616,3363,3253
050,34,025,"New Jersey","Monmouth County",2,32,6668,3346,3322
050,34,025,"New Jersey","Monmouth County",2,33,6852,3442,3410
050,34,025,"New Jersey","Monmouth County",2,34,7085,3558,3527
050,34,025,"New Jersey","Monmouth County",2,35,7222,3626,3596
050,34,025,"New Jersey","Monmouth County",2,36,7199,3622,3577
050,34,025,"New Jersey","Monmouth County",2,37,7399,3675,3724
050,34,025,"New Jersey","Monmouth County",2,38,7482,3718,3764
050,34,025,"New Jersey","Monmouth County",2,39,7491,3688,3803
050,34,025,"New Jersey","Monmouth County",2,40,7614,3715,3899
050,34,025,"New Jersey","Monmouth County",2,41,7638,3702,3936
050,34,025,"New Jersey","Monmouth County",2,42,7690,3758,3932
050,34,025,"New Jersey","Monmouth County",2,43,7735,3827,3908
050,34,025,"New Jersey","Monmouth County",2,44,7698,3836,3862
050,34,025,"New Jersey","Monmouth County",2,45,7881,3888,3993
050,34,025,"New Jersey","Monmouth County",2,46,7778,3814,3964
050,34,025,"New Jersey","Monmouth County",2,47,7994,3930,4064
050,34,025,"New Jersey","Monmouth County",2,48,8687,4298,4389
050,34,025,"New Jersey","Monmouth County",2,49,9464,4682,4782
050,34,025,"New Jersey","Monmouth County",2,50,9588,4725,4863
050,34,025,"New Jersey","Monmouth County",2,51,9441,4636,4805
050,34,025,"New Jersey","Monmouth County",2,52,9381,4605,4776
050,34,025,"New Jersey","Monmouth County",2,53,9723,4727,4996
050,34,025,"New Jersey","Monmouth County",2,54,10034,4863,5171
050,34,025,"New Jersey","Monmouth County",2,55,10520,5094,5426
050,34,025,"New Jersey","Monmouth County",2,56,10783,5216,5567
050,34,025,"New Jersey","Monmouth County",2,57,10781,5271,5510
050,34,025,"New Jersey","Monmouth County",2,58,10846,5343,5503
050,34,025,"New Jersey","Monmouth County",2,59,10787,5329,5458
050,34,025,"New Jersey","Monmouth County",2,60,10461,5260,5201
050,34,025,"New Jersey","Monmouth County",2,61,10181,5090,5091
050,34,025,"New Jersey","Monmouth County",2,62,9939,4840,5099
050,34,025,"New Jersey","Monmouth County",2,63,9656,4704,4952
050,34,025,"New Jersey","Monmouth County",2,64,9035,4438,4597
050,34,025,"New Jersey","Monmouth County",2,65,8591,4192,4399
050,34,025,"New Jersey","Monmouth County",2,66,8100,3932,4168
050,34,025,"New Jersey","Monmouth County",2,67,7647,3694,3953
050,34,025,"New Jersey","Monmouth County",2,68,7249,3431,3818
050,34,025,"New Jersey","Monmouth County",2,69,6871,3242,3629
050,34,025,"New Jersey","Monmouth County",2,70,6572,3065,3507
050,34,025,"New Jersey","Monmouth County",2,71,6388,2987,3401
050,34,025,"New Jersey","Monmouth County",2,72,6275,2933,3342
050,34,025,"New Jersey","Monmouth County",2,73,6723,3113,3610
050,34,025,"New Jersey","Monmouth County",2,74,4688,2175,2513
050,34,025,"New Jersey","Monmouth County",2,75,4383,2039,2344
050,34,025,"New Jersey","Monmouth County",2,76,4215,1917,2298
050,34,025,"New Jersey","Monmouth County",2,77,4404,1997,2407
050,34,025,"New Jersey","Monmouth County",2,78,3728,1638,2090
050,34,025,"New Jersey","Monmouth County",2,79,3253,1383,1870
050,34,025,"New Jersey","Monmouth County",2,80,2882,1197,1685
050,34,025,"New Jersey","Monmouth County",2,81,2624,1102,1522
050,34,025,"New Jersey","Monmouth County",2,82,2538,1014,1524
050,34,025,"New Jersey","Monmouth County",2,83,2249,903,1346
050,34,025,"New Jersey","Monmouth County",2,84,2125,851,1274
050,34,025,"New Jersey","Monmouth County",2,85,14050,4743,9307
050,34,025,"New Jersey","Monmouth County",3,0,5935,2961,2974
050,34,025,"New Jersey","Monmouth County",3,1,6346,3180,3166
050,34,025,"New Jersey","Monmouth County",3,2,6634,3349,3285
050,34,025,"New Jersey","Monmouth County",3,3,6503,3327,3176
050,34,025,"New Jersey","Monmouth County",3,4,6661,3409,3252
050,34,025,"New Jersey","Monmouth County",3,5,6946,3534,3412
050,34,025,"New Jersey","Monmouth County",3,6,7050,3555,3495
050,34,025,"New Jersey","Monmouth County",3,7,7130,3630,3500
050,34,025,"New Jersey","Monmouth County",3,8,7164,3667,3497
050,34,025,"New Jersey","Monmouth County",3,9,7474,3827,3647
050,34,025,"New Jersey","Monmouth County",3,10,7610,3909,3701
050,34,025,"New Jersey","Monmouth County",3,11,7871,4059,3812
050,34,025,"New Jersey","Monmouth County",3,12,8125,4127,3998
050,34,025,"New Jersey","Monmouth County",3,13,8473,4299,4174
050,34,025,"New Jersey","Monmouth County",3,14,8825,4508,4317
050,34,025,"New Jersey","Monmouth County",3,15,8829,4525,4304
050,34,025,"New Jersey","Monmouth County",3,16,8863,4526,4337
050,34,025,"New Jersey","Monmouth County",3,17,9111,4601,4510
050,34,025,"New Jersey","Monmouth County",3,18,8371,4306,4065
050,34,025,"New Jersey","Monmouth County",3,19,7096,3629,3467
050,34,025,"New Jersey","Monmouth County",3,20,7276,3732,3544
050,34,025,"New Jersey","Monmouth County",3,21,7515,3825,3690
050,34,025,"New Jersey","Monmouth County",3,22,7770,3917,3853
050,34,025,"New Jersey","Monmouth County",3,23,7633,3877,3756
050,34,025,"New Jersey","Monmouth County",3,24,7566,3813,3753
050,34,025,"New Jersey","Monmouth County",3,25,7413,3787,3626
050,34,025,"New Jersey","Monmouth County",3,26,7386,3804,3582
050,34,025,"New Jersey","Monmouth County",3,27,7390,3745,3645
050,34,025,"New Jersey","Monmouth County",3,28,7288,3695,3593
050,34,025,"New Jersey","Monmouth County",3,29,7154,3618,3536
050,34,025,"New Jersey","Monmouth County",3,30,6995,3477,3518
050,34,025,"New Jersey","Monmouth County",3,31,7082,3592,3490
050,34,025,"New Jersey","Monmouth County",3,32,6942,3517,3425
050,34,025,"New Jersey","Monmouth County",3,33,7027,3509,3518
050,34,025,"New Jersey","Monmouth County",3,34,7143,3567,3576
050,34,025,"New Jersey","Monmouth County",3,35,7352,3671,3681
050,34,025,"New Jersey","Monmouth County",3,36,7525,3764,3761
050,34,025,"New Jersey","Monmouth County",3,37,7511,3774,3737
050,34,025,"New Jersey","Monmouth County",3,38,7588,3742,3846
050,34,025,"New Jersey","Monmouth County",3,39,7687,3816,3871
050,34,025,"New Jersey","Monmouth County",3,40,7642,3768,3874
050,34,025,"New Jersey","Monmouth County",3,41,7725,3761,3964
050,34,025,"New Jersey","Monmouth County",3,42,7764,3783,3981
050,34,025,"New Jersey","Monmouth County",3,43,7786,3805,3981
050,34,025,"New Jersey","Monmouth County",3,44,7868,3937,3931
050,34,025,"New Jersey","Monmouth County",3,45,7800,3890,3910
050,34,025,"New Jersey","Monmouth County",3,46,7925,3901,4024
050,34,025,"New Jersey","Monmouth County",3,47,7809,3831,3978
050,34,025,"New Jersey","Monmouth County",3,48,8106,4001,4105
050,34,025,"New Jersey","Monmouth County",3,49,8703,4307,4396
050,34,025,"New Jersey","Monmouth County",3,50,9471,4714,4757
050,34,025,"New Jersey","Monmouth County",3,51,9607,4727,4880
050,34,025,"New Jersey","Monmouth County",3,52,9417,4612,4805
050,34,025,"New Jersey","Monmouth County",3,53,9407,4619,4788
050,34,025,"New Jersey","Monmouth County",3,54,9654,4664,4990
050,34,025,"New Jersey","Monmouth County",3,55,9989,4848,5141
050,34,025,"New Jersey","Monmouth County",3,56,10479,5079,5400
050,34,025,"New Jersey","Monmouth County",3,57,10612,5133,5479
050,34,025,"New Jersey","Monmouth County",3,58,10599,5147,5452
050,34,025,"New Jersey","Monmouth County",3,59,10680,5276,5404
050,34,025,"New Jersey","Monmouth County",3,60,10650,5258,5392
050,34,025,"New Jersey","Monmouth County",3,61,10319,5168,5151
050,34,025,"New Jersey","Monmouth County",3,62,10010,5006,5004
050,34,025,"New Jersey","Monmouth County",3,63,9708,4716,4992
050,34,025,"New Jersey","Monmouth County",3,64,9462,4579,4883
050,34,025,"New Jersey","Monmouth County",3,65,8819,4302,4517
050,34,025,"New Jersey","Monmouth County",3,66,8440,4111,4329
050,34,025,"New Jersey","Monmouth County",3,67,7960,3849,4111
050,34,025,"New Jersey","Monmouth County",3,68,7533,3623,3910
050,34,025,"New Jersey","Monmouth County",3,69,7065,3329,3736
050,34,025,"New Jersey","Monmouth County",3,70,6727,3159,3568
050,34,025,"New Jersey","Monmouth County",3,71,6345,2930,3415
050,34,025,"New Jersey","Monmouth County",3,72,6228,2892,3336
050,34,025,"New Jersey","Monmouth County",3,73,6095,2826,3269
050,34,025,"New Jersey","Monmouth County",3,74,6545,3012,3533
050,34,025,"New Jersey","Monmouth County",3,75,4527,2081,2446
050,34,025,"New Jersey","Monmouth County",3,76,4246,1966,2280
050,34,025,"New Jersey","Monmouth County",3,77,4084,1858,2226
050,34,025,"New Jersey","Monmouth County",3,78,4246,1891,2355
050,34,025,"New Jersey","Monmouth County",3,79,3583,1552,2031
050,34,025,"New Jersey","Monmouth County",3,80,3097,1291,1806
050,34,025,"New Jersey","Monmouth County",3,81,2738,1139,1599
050,34,025,"New Jersey","Monmouth County",3,82,2506,1014,1492
050,34,025,"New Jersey","Monmouth County",3,83,2357,935,1422
050,34,025,"New Jersey","Monmouth County",3,84,2094,835,1259
050,34,025,"New Jersey","Monmouth County",3,85,13830,4724,9106
050,34,025,"New Jersey","Monmouth County",4,0,6302,3182,3120
050,34,025,"New Jersey","Monmouth County",4,1,6041,3034,3007
050,34,025,"New Jersey","Monmouth County",4,2,6484,3243,3241
050,34,025,"New Jersey","Monmouth County",4,3,6755,3415,3340
050,34,025,"New Jersey","Monmouth County",4,4,6637,3406,3231
050,34,025,"New Jersey","Monmouth County",4,5,6787,3491,3296
050,34,025,"New Jersey","Monmouth County",4,6,7031,3594,3437
050,34,025,"New Jersey","Monmouth County",4,7,7204,3644,3560
050,34,025,"New Jersey","Monmouth County",4,8,7240,3679,3561
050,34,025,"New Jersey","Monmouth County",4,9,7216,3690,3526
050,34,025,"New Jersey","Monmouth County",4,10,7528,3834,3694
050,34,025,"New Jersey","Monmouth County",4,11,7684,3962,3722
050,34,025,"New Jersey","Monmouth County",4,12,7936,4093,3843
050,34,025,"New Jersey","Monmouth County",4,13,8244,4199,4045
050,34,025,"New Jersey","Monmouth County",4,14,8508,4308,4200
050,34,025,"New Jersey","Monmouth County",4,15,8858,4527,4331
050,34,025,"New Jersey","Monmouth County",4,16,8829,4539,4290
050,34,025,"New Jersey","Monmouth County",4,17,8855,4498,4357
050,34,025,"New Jersey","Monmouth County",4,18,8163,4201,3962
050,34,025,"New Jersey","Monmouth County",4,19,7005,3551,3454
050,34,025,"New Jersey","Monmouth County",4,20,6995,3583,3412
050,34,025,"New Jersey","Monmouth County",4,21,7354,3749,3605
050,34,025,"New Jersey","Monmouth County",4,22,7721,3858,3863
050,34,025,"New Jersey","Monmouth County",4,23,7651,3855,3796
050,34,025,"New Jersey","Monmouth County",4,24,7312,3767,3545
050,34,025,"New Jersey","Monmouth County",4,25,7290,3702,3588
050,34,025,"New Jersey","Monmouth County",4,26,7090,3578,3512
050,34,025,"New Jersey","Monmouth County",4,27,7213,3688,3525
050,34,025,"New Jersey","Monmouth County",4,28,7074,3525,3549
050,34,025,"New Jersey","Monmouth County",4,29,7189,3605,3584
050,34,025,"New Jersey","Monmouth County",4,30,7179,3560,3619
050,34,025,"New Jersey","Monmouth County",4,31,6989,3463,3526
050,34,025,"New Jersey","Monmouth County",4,32,7153,3605,3548
050,34,025,"New Jersey","Monmouth County",4,33,7103,3545,3558
050,34,025,"New Jersey","Monmouth County",4,34,7154,3557,3597
050,34,025,"New Jersey","Monmouth County",4,35,7360,3682,3678
050,34,025,"New Jersey","Monmouth County",4,36,7486,3758,3728
050,34,025,"New Jersey","Monmouth County",4,37,7599,3803,3796
050,34,025,"New Jersey","Monmouth County",4,38,7631,3823,3808
050,34,025,"New Jersey","Monmouth County",4,39,7731,3810,3921
050,34,025,"New Jersey","Monmouth County",4,40,7712,3780,3932
050,34,025,"New Jersey","Monmouth County",4,41,7732,3818,3914
050,34,025,"New Jersey","Monmouth County",4,42,7851,3851,4000
050,34,025,"New Jersey","Monmouth County",4,43,7787,3800,3987
050,34,025,"New Jersey","Monmouth County",4,44,7938,3873,4065
050,34,025,"New Jersey","Monmouth County",4,45,7887,3956,3931
050,34,025,"New Jersey","Monmouth County",4,46,7820,3920,3900
050,34,025,"New Jersey","Monmouth County",4,47,7928,3902,4026
050,34,025,"New Jersey","Monmouth County",4,48,7921,3891,4030
050,34,025,"New Jersey","Monmouth County",4,49,8067,3959,4108
050,34,025,"New Jersey","Monmouth County",4,50,8681,4322,4359
050,34,025,"New Jersey","Monmouth County",4,51,9377,4669,4708
050,34,025,"New Jersey","Monmouth County",4,52,9494,4646,4848
050,34,025,"New Jersey","Monmouth County",4,53,9355,4584,4771
050,34,025,"New Jersey","Monmouth County",4,54,9268,4540,4728
050,34,025,"New Jersey","Monmouth County",4,55,9516,4607,4909
050,34,025,"New Jersey","Monmouth County",4,56,9840,4776,5064
050,34,025,"New Jersey","Monmouth County",4,57,10302,5003,5299
050,34,025,"New Jersey","Monmouth County",4,58,10407,5043,5364
050,34,025,"New Jersey","Monmouth County",4,59,10419,5084,5335
050,34,025,"New Jersey","Monmouth County",4,60,10462,5152,5310
050,34,025,"New Jersey","Monmouth County",4,61,10409,5112,5297
050,34,025,"New Jersey","Monmouth County",4,62,10055,5041,5014
050,34,025,"New Jersey","Monmouth County",4,63,9774,4830,4944
050,34,025,"New Jersey","Monmouth County",4,64,9510,4562,4948
050,34,025,"New Jersey","Monmouth County",4,65,9221,4466,4755
050,34,025,"New Jersey","Monmouth County",4,66,8637,4166,4471
050,34,025,"New Jersey","Monmouth County",4,67,8257,4020,4237
050,34,025,"New Jersey","Monmouth County",4,68,7789,3736,4053
050,34,025,"New Jersey","Monmouth County",4,69,7318,3502,3816
050,34,025,"New Jersey","Monmouth County",4,70,6985,3255,3730
050,34,025,"New Jersey","Monmouth County",4,71,6573,3079,3494
050,34,025,"New Jersey","Monmouth County",4,72,6249,2864,3385
050,34,025,"New Jersey","Monmouth County",4,73,6094,2829,3265
050,34,025,"New Jersey","Monmouth County",4,74,5926,2734,3192
050,34,025,"New Jersey","Monmouth County",4,75,6323,2901,3422
050,34,025,"New Jersey","Monmouth County",4,76,4412,2007,2405
050,34,025,"New Jersey","Monmouth County",4,77,4128,1903,2225
050,34,025,"New Jersey","Monmouth County",4,78,3953,1760,2193
050,34,025,"New Jersey","Monmouth County",4,79,4101,1824,2277
050,34,025,"New Jersey","Monmouth County",4,80,3444,1457,1987
050,34,025,"New Jersey","Monmouth County",4,81,2939,1226,1713
050,34,025,"New Jersey","Monmouth County",4,82,2605,1049,1556
050,34,025,"New Jersey","Monmouth County",4,83,2325,922,1403
050,34,025,"New Jersey","Monmouth County",4,84,2215,852,1363
050,34,025,"New Jersey","Monmouth County",4,85,13641,4749,8892
050,34,025,"New Jersey","Monmouth County",5,0,6327,3193,3134
050,34,025,"New Jersey","Monmouth County",5,1,6389,3209,3180
050,34,025,"New Jersey","Monmouth County",5,2,6214,3113,3101
050,34,025,"New Jersey","Monmouth County",5,3,6646,3331,3315
050,34,025,"New Jersey","Monmouth County",5,4,6871,3489,3382
050,34,025,"New Jersey","Monmouth County",5,5,6745,3446,3299
050,34,025,"New Jersey","Monmouth County",5,6,6877,3538,3339
050,34,025,"New Jersey","Monmouth County",5,7,7122,3643,3479
050,34,025,"New Jersey","Monmouth County",5,8,7276,3694,3582
050,34,025,"New Jersey","Monmouth County",5,9,7266,3677,3589
050,34,025,"New Jersey","Monmouth County",5,10,7304,3719,3585
050,34,025,"New Jersey","Monmouth County",5,11,7546,3871,3675
050,34,025,"New Jersey","Monmouth County",5,12,7760,4012,3748
050,34,025,"New Jersey","Monmouth County",5,13,7998,4143,3855
050,34,025,"New Jersey","Monmouth County",5,14,8261,4202,4059
050,34,025,"New Jersey","Monmouth County",5,15,8484,4307,4177
050,34,025,"New Jersey","Monmouth County",5,16,8883,4579,4304
050,34,025,"New Jersey","Monmouth County",5,17,8815,4520,4295
050,34,025,"New Jersey","Monmouth County",5,18,7919,4099,3820
050,34,025,"New Jersey","Monmouth County",5,19,6949,3538,3411
050,34,025,"New Jersey","Monmouth County",5,20,7134,3617,3517
050,34,025,"New Jersey","Monmouth County",5,21,7163,3640,3523
050,34,025,"New Jersey","Monmouth County",5,22,7611,3834,3777
050,34,025,"New Jersey","Monmouth County",5,23,7663,3880,3783
050,34,025,"New Jersey","Monmouth County",5,24,7412,3730,3682
050,34,025,"New Jersey","Monmouth County",5,25,7044,3617,3427
050,34,025,"New Jersey","Monmouth County",5,26,7045,3574,3471
050,34,025,"New Jersey","Monmouth County",5,27,6972,3497,3475
050,34,025,"New Jersey","Monmouth County",5,28,7019,3542,3477
050,34,025,"New Jersey","Monmouth County",5,29,7074,3483,3591
050,34,025,"New Jersey","Monmouth County",5,30,7103,3538,3565
050,34,025,"New Jersey","Monmouth County",5,31,7271,3600,3671
050,34,025,"New Jersey","Monmouth County",5,32,7103,3538,3565
050,34,025,"New Jersey","Monmouth County",5,33,7367,3696,3671
050,34,025,"New Jersey","Monmouth County",5,34,7226,3584,3642
050,34,025,"New Jersey","Monmouth County",5,35,7291,3636,3655
050,34,025,"New Jersey","Monmouth County",5,36,7458,3717,3741
050,34,025,"New Jersey","Monmouth County",5,37,7591,3801,3790
050,34,025,"New Jersey","Monmouth County",5,38,7690,3849,3841
050,34,025,"New Jersey","Monmouth County",5,39,7725,3837,3888
050,34,025,"New Jersey","Monmouth County",5,40,7789,3827,3962
050,34,025,"New Jersey","Monmouth County",5,41,7775,3832,3943
050,34,025,"New Jersey","Monmouth County",5,42,7808,3881,3927
050,34,025,"New Jersey","Monmouth County",5,43,7814,3836,3978
050,34,025,"New Jersey","Monmouth County",5,44,7852,3871,3981
050,34,025,"New Jersey","Monmouth County",5,45,7962,3884,4078
050,34,025,"New Jersey","Monmouth County",5,46,7886,3946,3940
050,34,025,"New Jersey","Monmouth County",5,47,7802,3894,3908
050,34,025,"New Jersey","Monmouth County",5,48,7910,3882,4028
050,34,025,"New Jersey","Monmouth County",5,49,7874,3865,4009
050,34,025,"New Jersey","Monmouth County",5,50,8026,3954,4072
050,34,025,"New Jersey","Monmouth County",5,51,8645,4298,4347
050,34,025,"New Jersey","Monmouth County",5,52,9290,4593,4697
050,34,025,"New Jersey","Monmouth County",5,53,9399,4609,4790
050,34,025,"New Jersey","Monmouth County",5,54,9244,4542,4702
050,34,025,"New Jersey","Monmouth County",5,55,9130,4453,4677
050,34,025,"New Jersey","Monmouth County",5,56,9411,4557,4854
050,34,025,"New Jersey","Monmouth County",5,57,9641,4729,4912
050,34,025,"New Jersey","Monmouth County",5,58,10095,4891,5204
050,34,025,"New Jersey","Monmouth County",5,59,10271,4983,5288
050,34,025,"New Jersey","Monmouth County",5,60,10237,4992,5245
050,34,025,"New Jersey","Monmouth County",5,61,10270,5035,5235
050,34,025,"New Jersey","Monmouth County",5,62,10184,4986,5198
050,34,025,"New Jersey","Monmouth County",5,63,9891,4958,4933
050,34,025,"New Jersey","Monmouth County",5,64,9634,4738,4896
050,34,025,"New Jersey","Monmouth County",5,65,9301,4434,4867
050,34,025,"New Jersey","Monmouth County",5,66,9040,4359,4681
050,34,025,"New Jersey","Monmouth County",5,67,8452,4072,4380
050,34,025,"New Jersey","Monmouth County",5,68,8140,3952,4188
050,34,025,"New Jersey","Monmouth County",5,69,7599,3633,3966
050,34,025,"New Jersey","Monmouth County",5,70,7212,3420,3792
050,34,025,"New Jersey","Monmouth County",5,71,6802,3156,3646
050,34,025,"New Jersey","Monmouth County",5,72,6432,2999,3433
050,34,025,"New Jersey","Monmouth County",5,73,6121,2798,3323
050,34,025,"New Jersey","Monmouth County",5,74,5924,2728,3196
050,34,025,"New Jersey","Monmouth County",5,75,5734,2624,3110
050,34,025,"New Jersey","Monmouth County",5,76,6110,2783,3327
050,34,025,"New Jersey","Monmouth County",5,77,4318,1960,2358
050,34,025,"New Jersey","Monmouth County",5,78,3990,1809,2181
050,34,025,"New Jersey","Monmouth County",5,79,3857,1702,2155
050,34,025,"New Jersey","Monmouth County",5,80,3958,1743,2215
050,34,025,"New Jersey","Monmouth County",5,81,3256,1390,1866
050,34,025,"New Jersey","Monmouth County",5,82,2801,1148,1653
050,34,025,"New Jersey","Monmouth County",5,83,2432,971,1461
050,34,025,"New Jersey","Monmouth County",5,84,2193,852,1341
050,34,025,"New Jersey","Monmouth County",5,85,13673,4805,8868
050,34,027,"New Jersey","Morris County",1,0,4578,2350,2228
050,34,027,"New Jersey","Morris County",1,1,4830,2500,2330
050,34,027,"New Jersey","Morris County",1,2,5086,2655,2431
050,34,027,"New Jersey","Morris County",1,3,5295,2798,2497
050,34,027,"New Jersey","Morris County",1,4,5377,2748,2629
050,34,027,"New Jersey","Morris County",1,5,5479,2822,2657
050,34,027,"New Jersey","Morris County",1,6,5461,2816,2645
050,34,027,"New Jersey","Morris County",1,7,5528,2878,2650
050,34,027,"New Jersey","Morris County",1,8,5618,2947,2671
050,34,027,"New Jersey","Morris County",1,9,5908,3078,2830
050,34,027,"New Jersey","Morris County",1,10,6218,3181,3037
050,34,027,"New Jersey","Morris County",1,11,6374,3266,3108
050,34,027,"New Jersey","Morris County",1,12,6571,3367,3204
050,34,027,"New Jersey","Morris County",1,13,6612,3358,3254
050,34,027,"New Jersey","Morris County",1,14,6831,3508,3323
050,34,027,"New Jersey","Morris County",1,15,6947,3587,3360
050,34,027,"New Jersey","Morris County",1,16,7167,3694,3473
050,34,027,"New Jersey","Morris County",1,17,7213,3729,3484
050,34,027,"New Jersey","Morris County",1,18,6678,3406,3272
050,34,027,"New Jersey","Morris County",1,19,5855,3002,2853
050,34,027,"New Jersey","Morris County",1,20,5982,3016,2966
050,34,027,"New Jersey","Morris County",1,21,6299,3138,3161
050,34,027,"New Jersey","Morris County",1,22,6063,3035,3028
050,34,027,"New Jersey","Morris County",1,23,5793,2954,2839
050,34,027,"New Jersey","Morris County",1,24,5690,2856,2834
050,34,027,"New Jersey","Morris County",1,25,5605,2873,2732
050,34,027,"New Jersey","Morris County",1,26,5617,2909,2708
050,34,027,"New Jersey","Morris County",1,27,5595,2879,2716
050,34,027,"New Jersey","Morris County",1,28,5388,2774,2614
050,34,027,"New Jersey","Morris County",1,29,5315,2764,2551
050,34,027,"New Jersey","Morris County",1,30,5380,2789,2591
050,34,027,"New Jersey","Morris County",1,31,5520,2840,2680
050,34,027,"New Jersey","Morris County",1,32,5716,2930,2786
050,34,027,"New Jersey","Morris County",1,33,5986,3032,2954
050,34,027,"New Jersey","Morris County",1,34,6100,3111,2989
050,34,027,"New Jersey","Morris County",1,35,6216,3147,3069
050,34,027,"New Jersey","Morris County",1,36,6173,3101,3072
050,34,027,"New Jersey","Morris County",1,37,6377,3196,3181
050,34,027,"New Jersey","Morris County",1,38,6452,3222,3230
050,34,027,"New Jersey","Morris County",1,39,6436,3246,3190
050,34,027,"New Jersey","Morris County",1,40,6576,3338,3238
050,34,027,"New Jersey","Morris County",1,41,6521,3261,3260
050,34,027,"New Jersey","Morris County",1,42,6522,3260,3262
050,34,027,"New Jersey","Morris County",1,43,6376,3163,3213
050,34,027,"New Jersey","Morris County",1,44,6365,3216,3149
050,34,027,"New Jersey","Morris County",1,45,6537,3276,3261
050,34,027,"New Jersey","Morris County",1,46,6375,3105,3270
050,34,027,"New Jersey","Morris County",1,47,6703,3252,3451
050,34,027,"New Jersey","Morris County",1,48,7258,3560,3698
050,34,027,"New Jersey","Morris County",1,49,7787,3832,3955
050,34,027,"New Jersey","Morris County",1,50,7758,3864,3894
050,34,027,"New Jersey","Morris County",1,51,7938,3982,3956
050,34,027,"New Jersey","Morris County",1,52,7708,3851,3857
050,34,027,"New Jersey","Morris County",1,53,8058,3982,4076
050,34,027,"New Jersey","Morris County",1,54,8190,4080,4110
050,34,027,"New Jersey","Morris County",1,55,8437,4188,4249
050,34,027,"New Jersey","Morris County",1,56,8488,4209,4279
050,34,027,"New Jersey","Morris County",1,57,8348,4146,4202
050,34,027,"New Jersey","Morris County",1,58,8201,4143,4058
050,34,027,"New Jersey","Morris County",1,59,7998,4017,3981
050,34,027,"New Jersey","Morris County",1,60,7682,3846,3836
050,34,027,"New Jersey","Morris County",1,61,7531,3765,3766
050,34,027,"New Jersey","Morris County",1,62,7263,3571,3692
050,34,027,"New Jersey","Morris County",1,63,6785,3324,3461
050,34,027,"New Jersey","Morris County",1,64,6458,3174,3284
050,34,027,"New Jersey","Morris County",1,65,6062,3000,3062
050,34,027,"New Jersey","Morris County",1,66,5686,2766,2920
050,34,027,"New Jersey","Morris County",1,67,5508,2715,2793
050,34,027,"New Jersey","Morris County",1,68,5245,2535,2710
050,34,027,"New Jersey","Morris County",1,69,4832,2325,2507
050,34,027,"New Jersey","Morris County",1,70,4635,2168,2467
050,34,027,"New Jersey","Morris County",1,71,4556,2092,2464
050,34,027,"New Jersey","Morris County",1,72,4775,2201,2574
050,34,027,"New Jersey","Morris County",1,73,4801,2270,2531
050,34,027,"New Jersey","Morris County",1,74,3472,1553,1919
050,34,027,"New Jersey","Morris County",1,75,3435,1511,1924
050,34,027,"New Jersey","Morris County",1,76,3519,1557,1962
050,34,027,"New Jersey","Morris County",1,77,3578,1569,2009
050,34,027,"New Jersey","Morris County",1,78,2968,1310,1658
050,34,027,"New Jersey","Morris County",1,79,2600,1127,1473
050,34,027,"New Jersey","Morris County",1,80,2446,1017,1429
050,34,027,"New Jersey","Morris County",1,81,2311,959,1352
050,34,027,"New Jersey","Morris County",1,82,2151,903,1248
050,34,027,"New Jersey","Morris County",1,83,1858,742,1116
050,34,027,"New Jersey","Morris County",1,84,1759,715,1044
050,34,027,"New Jersey","Morris County",1,85,11899,4347,7552
050,34,027,"New Jersey","Morris County",2,0,4632,2339,2293
050,34,027,"New Jersey","Morris County",2,1,4790,2471,2319
050,34,027,"New Jersey","Morris County",2,2,5057,2636,2421
050,34,027,"New Jersey","Morris County",2,3,5260,2768,2492
050,34,027,"New Jersey","Morris County",2,4,5386,2772,2614
050,34,027,"New Jersey","Morris County",2,5,5471,2807,2664
050,34,027,"New Jersey","Morris County",2,6,5490,2829,2661
050,34,027,"New Jersey","Morris County",2,7,5525,2872,2653
050,34,027,"New Jersey","Morris County",2,8,5593,2927,2666
050,34,027,"New Jersey","Morris County",2,9,5853,3053,2800
050,34,027,"New Jersey","Morris County",2,10,6155,3162,2993
050,34,027,"New Jersey","Morris County",2,11,6315,3235,3080
050,34,027,"New Jersey","Morris County",2,12,6562,3362,3200
050,34,027,"New Jersey","Morris County",2,13,6605,3364,3241
050,34,027,"New Jersey","Morris County",2,14,6781,3474,3307
050,34,027,"New Jersey","Morris County",2,15,6924,3571,3353
050,34,027,"New Jersey","Morris County",2,16,7118,3673,3445
050,34,027,"New Jersey","Morris County",2,17,7202,3719,3483
050,34,027,"New Jersey","Morris County",2,18,6639,3395,3244
050,34,027,"New Jersey","Morris County",2,19,5914,3027,2887
050,34,027,"New Jersey","Morris County",2,20,6034,3034,3000
050,34,027,"New Jersey","Morris County",2,21,6274,3123,3151
050,34,027,"New Jersey","Morris County",2,22,6045,3031,3014
050,34,027,"New Jersey","Morris County",2,23,5794,2943,2851
050,34,027,"New Jersey","Morris County",2,24,5687,2870,2817
050,34,027,"New Jersey","Morris County",2,25,5588,2853,2735
050,34,027,"New Jersey","Morris County",2,26,5596,2891,2705
050,34,027,"New Jersey","Morris County",2,27,5600,2888,2712
050,34,027,"New Jersey","Morris County",2,28,5459,2810,2649
050,34,027,"New Jersey","Morris County",2,29,5361,2785,2576
050,34,027,"New Jersey","Morris County",2,30,5427,2816,2611
050,34,027,"New Jersey","Morris County",2,31,5498,2828,2670
050,34,027,"New Jersey","Morris County",2,32,5700,2920,2780
050,34,027,"New Jersey","Morris County",2,33,5939,3016,2923
050,34,027,"New Jersey","Morris County",2,34,6115,3113,3002
050,34,027,"New Jersey","Morris County",2,35,6262,3175,3087
050,34,027,"New Jersey","Morris County",2,36,6171,3102,3069
050,34,027,"New Jersey","Morris County",2,37,6371,3197,3174
050,34,027,"New Jersey","Morris County",2,38,6478,3239,3239
050,34,027,"New Jersey","Morris County",2,39,6442,3242,3200
050,34,027,"New Jersey","Morris County",2,40,6597,3344,3253
050,34,027,"New Jersey","Morris County",2,41,6554,3295,3259
050,34,027,"New Jersey","Morris County",2,42,6509,3261,3248
050,34,027,"New Jersey","Morris County",2,43,6449,3208,3241
050,34,027,"New Jersey","Morris County",2,44,6328,3187,3141
050,34,027,"New Jersey","Morris County",2,45,6528,3277,3251
050,34,027,"New Jersey","Morris County",2,46,6394,3136,3258
050,34,027,"New Jersey","Morris County",2,47,6600,3200,3400
050,34,027,"New Jersey","Morris County",2,48,7114,3483,3631
050,34,027,"New Jersey","Morris County",2,49,7658,3764,3894
050,34,027,"New Jersey","Morris County",2,50,7775,3864,3911
050,34,027,"New Jersey","Morris County",2,51,7850,3934,3916
050,34,027,"New Jersey","Morris County",2,52,7731,3865,3866
050,34,027,"New Jersey","Morris County",2,53,7952,3940,4012
050,34,027,"New Jersey","Morris County",2,54,8117,4036,4081
050,34,027,"New Jersey","Morris County",2,55,8357,4151,4206
050,34,027,"New Jersey","Morris County",2,56,8465,4200,4265
050,34,027,"New Jersey","Morris County",2,57,8368,4156,4212
050,34,027,"New Jersey","Morris County",2,58,8179,4115,4064
050,34,027,"New Jersey","Morris County",2,59,8030,4037,3993
050,34,027,"New Jersey","Morris County",2,60,7714,3863,3851
050,34,027,"New Jersey","Morris County",2,61,7497,3754,3743
050,34,027,"New Jersey","Morris County",2,62,7269,3582,3687
050,34,027,"New Jersey","Morris County",2,63,6893,3372,3521
050,34,027,"New Jersey","Morris County",2,64,6458,3167,3291
050,34,027,"New Jersey","Morris County",2,65,6103,3010,3093
050,34,027,"New Jersey","Morris County",2,66,5734,2794,2940
050,34,027,"New Jersey","Morris County",2,67,5485,2690,2795
050,34,027,"New Jersey","Morris County",2,68,5236,2534,2702
050,34,027,"New Jersey","Morris County",2,69,4922,2372,2550
050,34,027,"New Jersey","Morris County",2,70,4640,2182,2458
050,34,027,"New Jersey","Morris County",2,71,4540,2081,2459
050,34,027,"New Jersey","Morris County",2,72,4622,2127,2495
050,34,027,"New Jersey","Morris County",2,73,4969,2327,2642
050,34,027,"New Jersey","Morris County",2,74,3542,1600,1942
050,34,027,"New Jersey","Morris County",2,75,3411,1499,1912
050,34,027,"New Jersey","Morris County",2,76,3435,1506,1929
050,34,027,"New Jersey","Morris County",2,77,3598,1575,2023
050,34,027,"New Jersey","Morris County",2,78,3028,1327,1701
050,34,027,"New Jersey","Morris County",2,79,2623,1138,1485
050,34,027,"New Jersey","Morris County",2,80,2452,1034,1418
050,34,027,"New Jersey","Morris County",2,81,2297,949,1348
050,34,027,"New Jersey","Morris County",2,82,2155,898,1257
050,34,027,"New Jersey","Morris County",2,83,1854,738,1116
050,34,027,"New Jersey","Morris County",2,84,1723,698,1025
050,34,027,"New Jersey","Morris County",2,85,11571,4248,7323
050,34,027,"New Jersey","Morris County",3,0,4764,2489,2275
050,34,027,"New Jersey","Morris County",3,1,4814,2469,2345
050,34,027,"New Jersey","Morris County",3,2,5008,2577,2431
050,34,027,"New Jersey","Morris County",3,3,5268,2738,2530
050,34,027,"New Jersey","Morris County",3,4,5399,2829,2570
050,34,027,"New Jersey","Morris County",3,5,5471,2798,2673
050,34,027,"New Jersey","Morris County",3,6,5601,2904,2697
050,34,027,"New Jersey","Morris County",3,7,5586,2897,2689
050,34,027,"New Jersey","Morris County",3,8,5633,2924,2709
050,34,027,"New Jersey","Morris County",3,9,5650,2937,2713
050,34,027,"New Jersey","Morris County",3,10,5902,3066,2836
050,34,027,"New Jersey","Morris County",3,11,6196,3187,3009
050,34,027,"New Jersey","Morris County",3,12,6359,3264,3095
050,34,027,"New Jersey","Morris County",3,13,6620,3389,3231
050,34,027,"New Jersey","Morris County",3,14,6644,3386,3258
050,34,027,"New Jersey","Morris County",3,15,6804,3506,3298
050,34,027,"New Jersey","Morris County",3,16,6949,3581,3368
050,34,027,"New Jersey","Morris County",3,17,7150,3702,3448
050,34,027,"New Jersey","Morris County",3,18,6506,3398,3108
050,34,027,"New Jersey","Morris County",3,19,5569,2875,2694
050,34,027,"New Jersey","Morris County",3,20,5804,2925,2879
050,34,027,"New Jersey","Morris County",3,21,6077,3048,3029
050,34,027,"New Jersey","Morris County",3,22,6065,3060,3005
050,34,027,"New Jersey","Morris County",3,23,5858,2950,2908
050,34,027,"New Jersey","Morris County",3,24,5752,2914,2838
050,34,027,"New Jersey","Morris County",3,25,5742,2936,2806
050,34,027,"New Jersey","Morris County",3,26,5613,2877,2736
050,34,027,"New Jersey","Morris County",3,27,5758,2969,2789
050,34,027,"New Jersey","Morris County",3,28,5772,2992,2780
050,34,027,"New Jersey","Morris County",3,29,5665,2903,2762
050,34,027,"New Jersey","Morris County",3,30,5624,2885,2739
050,34,027,"New Jersey","Morris County",3,31,5737,2959,2778
050,34,027,"New Jersey","Morris County",3,32,5881,3004,2877
050,34,027,"New Jersey","Morris County",3,33,5979,3039,2940
050,34,027,"New Jersey","Morris County",3,34,6195,3133,3062
050,34,027,"New Jersey","Morris County",3,35,6428,3259,3169
050,34,027,"New Jersey","Morris County",3,36,6499,3307,3192
050,34,027,"New Jersey","Morris County",3,37,6406,3244,3162
050,34,027,"New Jersey","Morris County",3,38,6562,3312,3250
050,34,027,"New Jersey","Morris County",3,39,6628,3344,3284
050,34,027,"New Jersey","Morris County",3,40,6607,3351,3256
050,34,027,"New Jersey","Morris County",3,41,6779,3458,3321
050,34,027,"New Jersey","Morris County",3,42,6647,3340,3307
050,34,027,"New Jersey","Morris County",3,43,6627,3314,3313
050,34,027,"New Jersey","Morris County",3,44,6502,3249,3253
050,34,027,"New Jersey","Morris County",3,45,6393,3234,3159
050,34,027,"New Jersey","Morris County",3,46,6579,3310,3269
050,34,027,"New Jersey","Morris County",3,47,6378,3113,3265
050,34,027,"New Jersey","Morris County",3,48,6596,3197,3399
050,34,027,"New Jersey","Morris County",3,49,7103,3478,3625
050,34,027,"New Jersey","Morris County",3,50,7693,3785,3908
050,34,027,"New Jersey","Morris County",3,51,7799,3895,3904
050,34,027,"New Jersey","Morris County",3,52,7792,3918,3874
050,34,027,"New Jersey","Morris County",3,53,7669,3845,3824
050,34,027,"New Jersey","Morris County",3,54,7839,3888,3951
050,34,027,"New Jersey","Morris County",3,55,8023,3973,4050
050,34,027,"New Jersey","Morris County",3,56,8178,4071,4107
050,34,027,"New Jersey","Morris County",3,57,8351,4164,4187
050,34,027,"New Jersey","Morris County",3,58,8211,4034,4177
050,34,027,"New Jersey","Morris County",3,59,8017,4049,3968
050,34,027,"New Jersey","Morris County",3,60,7893,3931,3962
050,34,027,"New Jersey","Morris County",3,61,7499,3777,3722
050,34,027,"New Jersey","Morris County",3,62,7297,3631,3666
050,34,027,"New Jersey","Morris County",3,63,7047,3475,3572
050,34,027,"New Jersey","Morris County",3,64,6742,3275,3467
050,34,027,"New Jersey","Morris County",3,65,6315,3105,3210
050,34,027,"New Jersey","Morris County",3,66,5864,2870,2994
050,34,027,"New Jersey","Morris County",3,67,5615,2735,2880
050,34,027,"New Jersey","Morris County",3,68,5299,2549,2750
050,34,027,"New Jersey","Morris County",3,69,5126,2486,2640
050,34,027,"New Jersey","Morris County",3,70,4859,2328,2531
050,34,027,"New Jersey","Morris County",3,71,4550,2138,2412
050,34,027,"New Jersey","Morris County",3,72,4477,2063,2414
050,34,027,"New Jersey","Morris County",3,73,4547,2086,2461
050,34,027,"New Jersey","Morris County",3,74,4866,2257,2609
050,34,027,"New Jersey","Morris County",3,75,3456,1556,1900
050,34,027,"New Jersey","Morris County",3,76,3300,1426,1874
050,34,027,"New Jersey","Morris County",3,77,3321,1434,1887
050,34,027,"New Jersey","Morris County",3,78,3476,1496,1980
050,34,027,"New Jersey","Morris County",3,79,2937,1274,1663
050,34,027,"New Jersey","Morris County",3,80,2542,1099,1443
050,34,027,"New Jersey","Morris County",3,81,2344,982,1362
050,34,027,"New Jersey","Morris County",3,82,2181,887,1294
050,34,027,"New Jersey","Morris County",3,83,2040,835,1205
050,34,027,"New Jersey","Morris County",3,84,1758,701,1057
050,34,027,"New Jersey","Morris County",3,85,11541,4241,7300
050,34,027,"New Jersey","Morris County",4,0,5066,2571,2495
050,34,027,"New Jersey","Morris County",4,1,4906,2569,2337
050,34,027,"New Jersey","Morris County",4,2,5034,2585,2449
050,34,027,"New Jersey","Morris County",4,3,5210,2725,2485
050,34,027,"New Jersey","Morris County",4,4,5441,2832,2609
050,34,027,"New Jersey","Morris County",4,5,5597,2899,2698
050,34,027,"New Jersey","Morris County",4,6,5639,2889,2750
050,34,027,"New Jersey","Morris County",4,7,5796,2980,2816
050,34,027,"New Jersey","Morris County",4,8,5691,2960,2731
050,34,027,"New Jersey","Morris County",4,9,5746,2972,2774
050,34,027,"New Jersey","Morris County",4,10,5700,2975,2725
050,34,027,"New Jersey","Morris County",4,11,5914,3103,2811
050,34,027,"New Jersey","Morris County",4,12,6219,3199,3020
050,34,027,"New Jersey","Morris County",4,13,6423,3315,3108
050,34,027,"New Jersey","Morris County",4,14,6624,3390,3234
050,34,027,"New Jersey","Morris County",4,15,6667,3380,3287
050,34,027,"New Jersey","Morris County",4,16,6826,3495,3331
050,34,027,"New Jersey","Morris County",4,17,6946,3584,3362
050,34,027,"New Jersey","Morris County",4,18,6470,3382,3088
050,34,027,"New Jersey","Morris County",4,19,5604,2908,2696
050,34,027,"New Jersey","Morris County",4,20,5704,2884,2820
050,34,027,"New Jersey","Morris County",4,21,6098,3064,3034
050,34,027,"New Jersey","Morris County",4,22,6122,3101,3021
050,34,027,"New Jersey","Morris County",4,23,5715,2908,2807
050,34,027,"New Jersey","Morris County",4,24,5603,2859,2744
050,34,027,"New Jersey","Morris County",4,25,5470,2780,2690
050,34,027,"New Jersey","Morris County",4,26,5627,2889,2738
050,34,027,"New Jersey","Morris County",4,27,5556,2860,2696
050,34,027,"New Jersey","Morris County",4,28,5682,2927,2755
050,34,027,"New Jersey","Morris County",4,29,5738,2961,2777
050,34,027,"New Jersey","Morris County",4,30,5740,2923,2817
050,34,027,"New Jersey","Morris County",4,31,5726,2920,2806
050,34,027,"New Jersey","Morris County",4,32,5955,3050,2905
050,34,027,"New Jersey","Morris County",4,33,6014,3031,2983
050,34,027,"New Jersey","Morris County",4,34,6233,3169,3064
050,34,027,"New Jersey","Morris County",4,35,6392,3260,3132
050,34,027,"New Jersey","Morris County",4,36,6622,3358,3264
050,34,027,"New Jersey","Morris County",4,37,6687,3409,3278
050,34,027,"New Jersey","Morris County",4,38,6613,3371,3242
050,34,027,"New Jersey","Morris County",4,39,6775,3406,3369
050,34,027,"New Jersey","Morris County",4,40,6802,3437,3365
050,34,027,"New Jersey","Morris County",4,41,6756,3421,3335
050,34,027,"New Jersey","Morris County",4,42,6815,3467,3348
050,34,027,"New Jersey","Morris County",4,43,6685,3361,3324
050,34,027,"New Jersey","Morris County",4,44,6629,3321,3308
050,34,027,"New Jersey","Morris County",4,45,6561,3260,3301
050,34,027,"New Jersey","Morris County",4,46,6459,3303,3156
050,34,027,"New Jersey","Morris County",4,47,6579,3296,3283
050,34,027,"New Jersey","Morris County",4,48,6417,3158,3259
050,34,027,"New Jersey","Morris County",4,49,6569,3187,3382
050,34,027,"New Jersey","Morris County",4,50,7079,3488,3591
050,34,027,"New Jersey","Morris County",4,51,7625,3762,3863
050,34,027,"New Jersey","Morris County",4,52,7731,3842,3889
050,34,027,"New Jersey","Morris County",4,53,7681,3894,3787
050,34,027,"New Jersey","Morris County",4,54,7621,3816,3805
050,34,027,"New Jersey","Morris County",4,55,7689,3810,3879
050,34,027,"New Jersey","Morris County",4,56,7801,3869,3932
050,34,027,"New Jersey","Morris County",4,57,8056,4015,4041
050,34,027,"New Jersey","Morris County",4,58,8149,4085,4064
050,34,027,"New Jersey","Morris County",4,59,8043,3955,4088
050,34,027,"New Jersey","Morris County",4,60,7795,3932,3863
050,34,027,"New Jersey","Morris County",4,61,7712,3861,3851
050,34,027,"New Jersey","Morris County",4,62,7318,3670,3648
050,34,027,"New Jersey","Morris County",4,63,7070,3471,3599
050,34,027,"New Jersey","Morris County",4,64,6860,3372,3488
050,34,027,"New Jersey","Morris County",4,65,6585,3217,3368
050,34,027,"New Jersey","Morris County",4,66,6118,2976,3142
050,34,027,"New Jersey","Morris County",4,67,5670,2781,2889
050,34,027,"New Jersey","Morris County",4,68,5476,2619,2857
050,34,027,"New Jersey","Morris County",4,69,5145,2471,2674
050,34,027,"New Jersey","Morris County",4,70,4983,2412,2571
050,34,027,"New Jersey","Morris County",4,71,4745,2256,2489
050,34,027,"New Jersey","Morris County",4,72,4452,2069,2383
050,34,027,"New Jersey","Morris County",4,73,4369,1991,2378
050,34,027,"New Jersey","Morris County",4,74,4437,1998,2439
050,34,027,"New Jersey","Morris County",4,75,4771,2192,2579
050,34,027,"New Jersey","Morris County",4,76,3369,1489,1880
050,34,027,"New Jersey","Morris County",4,77,3204,1376,1828
050,34,027,"New Jersey","Morris County",4,78,3205,1369,1836
050,34,027,"New Jersey","Morris County",4,79,3380,1449,1931
050,34,027,"New Jersey","Morris County",4,80,2845,1211,1634
050,34,027,"New Jersey","Morris County",4,81,2467,1053,1414
050,34,027,"New Jersey","Morris County",4,82,2192,907,1285
050,34,027,"New Jersey","Morris County",4,83,2063,815,1248
050,34,027,"New Jersey","Morris County",4,84,1948,798,1150
050,34,027,"New Jersey","Morris County",4,85,11702,4295,7407
050,34,027,"New Jersey","Morris County",5,0,5059,2567,2492
050,34,027,"New Jersey","Morris County",5,1,5287,2657,2630
050,34,027,"New Jersey","Morris County",5,2,5086,2660,2426
050,34,027,"New Jersey","Morris County",5,3,5267,2725,2542
050,34,027,"New Jersey","Morris County",5,4,5349,2786,2563
050,34,027,"New Jersey","Morris County",5,5,5594,2923,2671
050,34,027,"New Jersey","Morris County",5,6,5691,2925,2766
050,34,027,"New Jersey","Morris County",5,7,5770,2968,2802
050,34,027,"New Jersey","Morris County",5,8,5852,2972,2880
050,34,027,"New Jersey","Morris County",5,9,5797,3030,2767
050,34,027,"New Jersey","Morris County",5,10,5799,3004,2795
050,34,027,"New Jersey","Morris County",5,11,5808,3032,2776
050,34,027,"New Jersey","Morris County",5,12,5993,3121,2872
050,34,027,"New Jersey","Morris County",5,13,6258,3208,3050
050,34,027,"New Jersey","Morris County",5,14,6449,3304,3145
050,34,027,"New Jersey","Morris County",5,15,6684,3422,3262
050,34,027,"New Jersey","Morris County",5,16,6645,3386,3259
050,34,027,"New Jersey","Morris County",5,17,6876,3521,3355
050,34,027,"New Jersey","Morris County",5,18,6345,3291,3054
050,34,027,"New Jersey","Morris County",5,19,5623,2931,2692
050,34,027,"New Jersey","Morris County",5,20,5815,2969,2846
050,34,027,"New Jersey","Morris County",5,21,6060,3046,3014
050,34,027,"New Jersey","Morris County",5,22,6086,3052,3034
050,34,027,"New Jersey","Morris County",5,23,5870,2964,2906
050,34,027,"New Jersey","Morris County",5,24,5562,2809,2753
050,34,027,"New Jersey","Morris County",5,25,5563,2809,2754
050,34,027,"New Jersey","Morris County",5,26,5443,2792,2651
050,34,027,"New Jersey","Morris County",5,27,5618,2892,2726
050,34,027,"New Jersey","Morris County",5,28,5492,2827,2665
050,34,027,"New Jersey","Morris County",5,29,5782,2971,2811
050,34,027,"New Jersey","Morris County",5,30,5802,2960,2842
050,34,027,"New Jersey","Morris County",5,31,5957,3022,2935
050,34,027,"New Jersey","Morris County",5,32,5963,3056,2907
050,34,027,"New Jersey","Morris County",5,33,6199,3158,3041
050,34,027,"New Jersey","Morris County",5,34,6286,3151,3135
050,34,027,"New Jersey","Morris County",5,35,6483,3253,3230
050,34,027,"New Jersey","Morris County",5,36,6627,3347,3280
050,34,027,"New Jersey","Morris County",5,37,6747,3433,3314
050,34,027,"New Jersey","Morris County",5,38,6857,3507,3350
050,34,027,"New Jersey","Morris County",5,39,6754,3479,3275
050,34,027,"New Jersey","Morris County",5,40,6892,3449,3443
050,34,027,"New Jersey","Morris County",5,41,6951,3520,3431
050,34,027,"New Jersey","Morris County",5,42,6891,3478,3413
050,34,027,"New Jersey","Morris County",5,43,6901,3525,3376
050,34,027,"New Jersey","Morris County",5,44,6712,3360,3352
050,34,027,"New Jersey","Morris County",5,45,6683,3330,3353
050,34,027,"New Jersey","Morris County",5,46,6661,3327,3334
050,34,027,"New Jersey","Morris County",5,47,6486,3320,3166
050,34,027,"New Jersey","Morris County",5,48,6603,3305,3298
050,34,027,"New Jersey","Morris County",5,49,6426,3170,3256
050,34,027,"New Jersey","Morris County",5,50,6570,3196,3374
050,34,027,"New Jersey","Morris County",5,51,7097,3484,3613
050,34,027,"New Jersey","Morris County",5,52,7500,3716,3784
050,34,027,"New Jersey","Morris County",5,53,7703,3827,3876
050,34,027,"New Jersey","Morris County",5,54,7617,3843,3774
050,34,027,"New Jersey","Morris County",5,55,7575,3779,3796
050,34,027,"New Jersey","Morris County",5,56,7540,3735,3805
050,34,027,"New Jersey","Morris County",5,57,7743,3815,3928
050,34,027,"New Jersey","Morris County",5,58,7889,3926,3963
050,34,027,"New Jersey","Morris County",5,59,7992,3987,4005
050,34,027,"New Jersey","Morris County",5,60,7902,3899,4003
050,34,027,"New Jersey","Morris County",5,61,7692,3909,3783
050,34,027,"New Jersey","Morris County",5,62,7524,3743,3781
050,34,027,"New Jersey","Morris County",5,63,7197,3580,3617
050,34,027,"New Jersey","Morris County",5,64,6932,3384,3548
050,34,027,"New Jersey","Morris County",5,65,6715,3317,3398
050,34,027,"New Jersey","Morris County",5,66,6371,3090,3281
050,34,027,"New Jersey","Morris County",5,67,5956,2895,3061
050,34,027,"New Jersey","Morris County",5,68,5572,2684,2888
050,34,027,"New Jersey","Morris County",5,69,5387,2585,2802
050,34,027,"New Jersey","Morris County",5,70,5074,2407,2667
050,34,027,"New Jersey","Morris County",5,71,4907,2368,2539
050,34,027,"New Jersey","Morris County",5,72,4675,2222,2453
050,34,027,"New Jersey","Morris County",5,73,4351,2009,2342
050,34,027,"New Jersey","Morris County",5,74,4294,1927,2367
050,34,027,"New Jersey","Morris County",5,75,4378,1969,2409
050,34,027,"New Jersey","Morris County",5,76,4676,2140,2536
050,34,027,"New Jersey","Morris County",5,77,3316,1454,1862
050,34,027,"New Jersey","Morris County",5,78,3098,1320,1778
050,34,027,"New Jersey","Morris County",5,79,3138,1336,1802
050,34,027,"New Jersey","Morris County",5,80,3292,1387,1905
050,34,027,"New Jersey","Morris County",5,81,2772,1173,1599
050,34,027,"New Jersey","Morris County",5,82,2363,1015,1348
050,34,027,"New Jersey","Morris County",5,83,2077,841,1236
050,34,027,"New Jersey","Morris County",5,84,2004,790,1214
050,34,027,"New Jersey","Morris County",5,85,12130,4515,7615
050,34,029,"New Jersey","Ocean County",1,0,9358,4801,4557
050,34,029,"New Jersey","Ocean County",1,1,9399,4860,4539
050,34,029,"New Jersey","Ocean County",1,2,9170,4735,4435
050,34,029,"New Jersey","Ocean County",1,3,9071,4689,4382
050,34,029,"New Jersey","Ocean County",1,4,9085,4657,4428
050,34,029,"New Jersey","Ocean County",1,5,8980,4577,4403
050,34,029,"New Jersey","Ocean County",1,6,8756,4505,4251
050,34,029,"New Jersey","Ocean County",1,7,8746,4485,4261
050,34,029,"New Jersey","Ocean County",1,8,8629,4369,4260
050,34,029,"New Jersey","Ocean County",1,9,8543,4390,4153
050,34,029,"New Jersey","Ocean County",1,10,8451,4349,4102
050,34,029,"New Jersey","Ocean County",1,11,8539,4404,4135
050,34,029,"New Jersey","Ocean County",1,12,8798,4559,4239
050,34,029,"New Jersey","Ocean County",1,13,8784,4477,4307
050,34,029,"New Jersey","Ocean County",1,14,8702,4428,4274
050,34,029,"New Jersey","Ocean County",1,15,8563,4397,4166
050,34,029,"New Jersey","Ocean County",1,16,8524,4378,4146
050,34,029,"New Jersey","Ocean County",1,17,8187,4229,3958
050,34,029,"New Jersey","Ocean County",1,18,6968,3665,3303
050,34,029,"New Jersey","Ocean County",1,19,5562,2909,2653
050,34,029,"New Jersey","Ocean County",1,20,5975,3108,2867
050,34,029,"New Jersey","Ocean County",1,21,6262,3162,3100
050,34,029,"New Jersey","Ocean County",1,22,6697,3298,3399
050,34,029,"New Jersey","Ocean County",1,23,7089,3543,3546
050,34,029,"New Jersey","Ocean County",1,24,7204,3649,3555
050,34,029,"New Jersey","Ocean County",1,25,7218,3611,3607
050,34,029,"New Jersey","Ocean County",1,26,7173,3594,3579
050,34,029,"New Jersey","Ocean County",1,27,7117,3601,3516
050,34,029,"New Jersey","Ocean County",1,28,7099,3581,3518
050,34,029,"New Jersey","Ocean County",1,29,7138,3623,3515
050,34,029,"New Jersey","Ocean County",1,30,6864,3480,3384
050,34,029,"New Jersey","Ocean County",1,31,6598,3308,3290
050,34,029,"New Jersey","Ocean County",1,32,6598,3370,3228
050,34,029,"New Jersey","Ocean County",1,33,6719,3436,3283
050,34,029,"New Jersey","Ocean County",1,34,6796,3465,3331
050,34,029,"New Jersey","Ocean County",1,35,6690,3358,3332
050,34,029,"New Jersey","Ocean County",1,36,6709,3402,3307
050,34,029,"New Jersey","Ocean County",1,37,6819,3427,3392
050,34,029,"New Jersey","Ocean County",1,38,6676,3405,3271
050,34,029,"New Jersey","Ocean County",1,39,6708,3378,3330
050,34,029,"New Jersey","Ocean County",1,40,6558,3358,3200
050,34,029,"New Jersey","Ocean County",1,41,6327,3239,3088
050,34,029,"New Jersey","Ocean County",1,42,6372,3218,3154
050,34,029,"New Jersey","Ocean County",1,43,6295,3192,3103
050,34,029,"New Jersey","Ocean County",1,44,6198,3140,3058
050,34,029,"New Jersey","Ocean County",1,45,6203,3088,3115
050,34,029,"New Jersey","Ocean County",1,46,6127,3047,3080
050,34,029,"New Jersey","Ocean County",1,47,6427,3191,3236
050,34,029,"New Jersey","Ocean County",1,48,6955,3464,3491
050,34,029,"New Jersey","Ocean County",1,49,7447,3679,3768
050,34,029,"New Jersey","Ocean County",1,50,7333,3609,3724
050,34,029,"New Jersey","Ocean County",1,51,7167,3530,3637
050,34,029,"New Jersey","Ocean County",1,52,7225,3523,3702
050,34,029,"New Jersey","Ocean County",1,53,7599,3681,3918
050,34,029,"New Jersey","Ocean County",1,54,7857,3856,4001
050,34,029,"New Jersey","Ocean County",1,55,8234,4030,4204
050,34,029,"New Jersey","Ocean County",1,56,8448,4107,4341
050,34,029,"New Jersey","Ocean County",1,57,8638,4175,4463
050,34,029,"New Jersey","Ocean County",1,58,8827,4287,4540
050,34,029,"New Jersey","Ocean County",1,59,8928,4295,4633
050,34,029,"New Jersey","Ocean County",1,60,8758,4182,4576
050,34,029,"New Jersey","Ocean County",1,61,8871,4180,4691
050,34,029,"New Jersey","Ocean County",1,62,8915,4270,4645
050,34,029,"New Jersey","Ocean County",1,63,8648,4125,4523
050,34,029,"New Jersey","Ocean County",1,64,8594,4005,4589
050,34,029,"New Jersey","Ocean County",1,65,8448,3921,4527
050,34,029,"New Jersey","Ocean County",1,66,8147,3765,4382
050,34,029,"New Jersey","Ocean County",1,67,8004,3668,4336
050,34,029,"New Jersey","Ocean County",1,68,7850,3538,4312
050,34,029,"New Jersey","Ocean County",1,69,7543,3399,4144
050,34,029,"New Jersey","Ocean County",1,70,7420,3284,4136
050,34,029,"New Jersey","Ocean County",1,71,7545,3322,4223
050,34,029,"New Jersey","Ocean County",1,72,7984,3602,4382
050,34,029,"New Jersey","Ocean County",1,73,8385,3810,4575
050,34,029,"New Jersey","Ocean County",1,74,5938,2605,3333
050,34,029,"New Jersey","Ocean County",1,75,5860,2570,3290
050,34,029,"New Jersey","Ocean County",1,76,5945,2622,3323
050,34,029,"New Jersey","Ocean County",1,77,6214,2690,3524
050,34,029,"New Jersey","Ocean County",1,78,5143,2168,2975
050,34,029,"New Jersey","Ocean County",1,79,4423,1879,2544
050,34,029,"New Jersey","Ocean County",1,80,4072,1747,2325
050,34,029,"New Jersey","Ocean County",1,81,3915,1646,2269
050,34,029,"New Jersey","Ocean County",1,82,3745,1554,2191
050,34,029,"New Jersey","Ocean County",1,83,3328,1401,1927
050,34,029,"New Jersey","Ocean County",1,84,3073,1253,1820
050,34,029,"New Jersey","Ocean County",1,85,18338,6413,11925
050,34,029,"New Jersey","Ocean County",2,0,9428,4874,4554
050,34,029,"New Jersey","Ocean County",2,1,9361,4833,4528
050,34,029,"New Jersey","Ocean County",2,2,9241,4774,4467
050,34,029,"New Jersey","Ocean County",2,3,9075,4693,4382
050,34,029,"New Jersey","Ocean County",2,4,9121,4681,4440
050,34,029,"New Jersey","Ocean County",2,5,9031,4609,4422
050,34,029,"New Jersey","Ocean County",2,6,8847,4542,4305
050,34,029,"New Jersey","Ocean County",2,7,8761,4498,4263
050,34,029,"New Jersey","Ocean County",2,8,8656,4396,4260
050,34,029,"New Jersey","Ocean County",2,9,8572,4392,4180
050,34,029,"New Jersey","Ocean County",2,10,8491,4370,4121
050,34,029,"New Jersey","Ocean County",2,11,8514,4397,4117
050,34,029,"New Jersey","Ocean County",2,12,8794,4551,4243
050,34,029,"New Jersey","Ocean County",2,13,8801,4507,4294
050,34,029,"New Jersey","Ocean County",2,14,8736,4445,4291
050,34,029,"New Jersey","Ocean County",2,15,8623,4414,4209
050,34,029,"New Jersey","Ocean County",2,16,8576,4405,4171
050,34,029,"New Jersey","Ocean County",2,17,8303,4282,4021
050,34,029,"New Jersey","Ocean County",2,18,6963,3669,3294
050,34,029,"New Jersey","Ocean County",2,19,5666,2959,2707
050,34,029,"New Jersey","Ocean County",2,20,6071,3146,2925
050,34,029,"New Jersey","Ocean County",2,21,6288,3188,3100
050,34,029,"New Jersey","Ocean County",2,22,6710,3325,3385
050,34,029,"New Jersey","Ocean County",2,23,7098,3549,3549
050,34,029,"New Jersey","Ocean County",2,24,7200,3643,3557
050,34,029,"New Jersey","Ocean County",2,25,7234,3637,3597
050,34,029,"New Jersey","Ocean County",2,26,7202,3614,3588
050,34,029,"New Jersey","Ocean County",2,27,7124,3595,3529
050,34,029,"New Jersey","Ocean County",2,28,7124,3604,3520
050,34,029,"New Jersey","Ocean County",2,29,7142,3622,3520
050,34,029,"New Jersey","Ocean County",2,30,7006,3550,3456
050,34,029,"New Jersey","Ocean County",2,31,6667,3354,3313
050,34,029,"New Jersey","Ocean County",2,32,6607,3357,3250
050,34,029,"New Jersey","Ocean County",2,33,6709,3426,3283
050,34,029,"New Jersey","Ocean County",2,34,6793,3464,3329
050,34,029,"New Jersey","Ocean County",2,35,6768,3408,3360
050,34,029,"New Jersey","Ocean County",2,36,6682,3372,3310
050,34,029,"New Jersey","Ocean County",2,37,6814,3427,3387
050,34,029,"New Jersey","Ocean County",2,38,6748,3428,3320
050,34,029,"New Jersey","Ocean County",2,39,6690,3379,3311
050,34,029,"New Jersey","Ocean County",2,40,6655,3394,3261
050,34,029,"New Jersey","Ocean County",2,41,6382,3263,3119
050,34,029,"New Jersey","Ocean County",2,42,6353,3222,3131
050,34,029,"New Jersey","Ocean County",2,43,6372,3229,3143
050,34,029,"New Jersey","Ocean County",2,44,6185,3135,3050
050,34,029,"New Jersey","Ocean County",2,45,6235,3118,3117
050,34,029,"New Jersey","Ocean County",2,46,6125,3049,3076
050,34,029,"New Jersey","Ocean County",2,47,6342,3151,3191
050,34,029,"New Jersey","Ocean County",2,48,6824,3399,3425
050,34,029,"New Jersey","Ocean County",2,49,7363,3649,3714
050,34,029,"New Jersey","Ocean County",2,50,7374,3626,3748
050,34,029,"New Jersey","Ocean County",2,51,7196,3537,3659
050,34,029,"New Jersey","Ocean County",2,52,7195,3511,3684
050,34,029,"New Jersey","Ocean County",2,53,7506,3634,3872
050,34,029,"New Jersey","Ocean County",2,54,7788,3806,3982
050,34,029,"New Jersey","Ocean County",2,55,8169,3995,4174
050,34,029,"New Jersey","Ocean County",2,56,8455,4106,4349
050,34,029,"New Jersey","Ocean County",2,57,8628,4164,4464
050,34,029,"New Jersey","Ocean County",2,58,8792,4252,4540
050,34,029,"New Jersey","Ocean County",2,59,8977,4325,4652
050,34,029,"New Jersey","Ocean County",2,60,8821,4217,4604
050,34,029,"New Jersey","Ocean County",2,61,8851,4186,4665
050,34,029,"New Jersey","Ocean County",2,62,8914,4249,4665
050,34,029,"New Jersey","Ocean County",2,63,8826,4208,4618
050,34,029,"New Jersey","Ocean County",2,64,8577,4018,4559
050,34,029,"New Jersey","Ocean County",2,65,8495,3938,4557
050,34,029,"New Jersey","Ocean County",2,66,8259,3813,4446
050,34,029,"New Jersey","Ocean County",2,67,8048,3693,4355
050,34,029,"New Jersey","Ocean County",2,68,7831,3540,4291
050,34,029,"New Jersey","Ocean County",2,69,7665,3444,4221
050,34,029,"New Jersey","Ocean County",2,70,7421,3298,4123
050,34,029,"New Jersey","Ocean County",2,71,7489,3293,4196
050,34,029,"New Jersey","Ocean County",2,72,7729,3464,4265
050,34,029,"New Jersey","Ocean County",2,73,8641,3912,4729
050,34,029,"New Jersey","Ocean County",2,74,6105,2705,3400
050,34,029,"New Jersey","Ocean County",2,75,5846,2561,3285
050,34,029,"New Jersey","Ocean County",2,76,5823,2559,3264
050,34,029,"New Jersey","Ocean County",2,77,6208,2690,3518
050,34,029,"New Jersey","Ocean County",2,78,5224,2212,3012
050,34,029,"New Jersey","Ocean County",2,79,4517,1901,2616
050,34,029,"New Jersey","Ocean County",2,80,4079,1734,2345
050,34,029,"New Jersey","Ocean County",2,81,3843,1615,2228
050,34,029,"New Jersey","Ocean County",2,82,3716,1527,2189
050,34,029,"New Jersey","Ocean County",2,83,3307,1382,1925
050,34,029,"New Jersey","Ocean County",2,84,3040,1245,1795
050,34,029,"New Jersey","Ocean County",2,85,18037,6307,11730
050,34,029,"New Jersey","Ocean County",3,0,9728,4954,4774
050,34,029,"New Jersey","Ocean County",3,1,9523,4915,4608
050,34,029,"New Jersey","Ocean County",3,2,9420,4880,4540
050,34,029,"New Jersey","Ocean County",3,3,9343,4839,4504
050,34,029,"New Jersey","Ocean County",3,4,9211,4756,4455
050,34,029,"New Jersey","Ocean County",3,5,9205,4735,4470
050,34,029,"New Jersey","Ocean County",3,6,9087,4635,4452
050,34,029,"New Jersey","Ocean County",3,7,8908,4585,4323
050,34,029,"New Jersey","Ocean County",3,8,8840,4545,4295
050,34,029,"New Jersey","Ocean County",3,9,8724,4406,4318
050,34,029,"New Jersey","Ocean County",3,10,8733,4471,4262
050,34,029,"New Jersey","Ocean County",3,11,8607,4435,4172
050,34,029,"New Jersey","Ocean County",3,12,8615,4454,4161
050,34,029,"New Jersey","Ocean County",3,13,8924,4596,4328
050,34,029,"New Jersey","Ocean County",3,14,8886,4547,4339
050,34,029,"New Jersey","Ocean County",3,15,8843,4479,4364
050,34,029,"New Jersey","Ocean County",3,16,8713,4479,4234
050,34,029,"New Jersey","Ocean County",3,17,8656,4448,4208
050,34,029,"New Jersey","Ocean County",3,18,7216,3831,3385
050,34,029,"New Jersey","Ocean County",3,19,5823,3046,2777
050,34,029,"New Jersey","Ocean County",3,20,6274,3213,3061
050,34,029,"New Jersey","Ocean County",3,21,6577,3336,3241
050,34,029,"New Jersey","Ocean County",3,22,6912,3435,3477
050,34,029,"New Jersey","Ocean County",3,23,7227,3589,3638
050,34,029,"New Jersey","Ocean County",3,24,7368,3726,3642
050,34,029,"New Jersey","Ocean County",3,25,7437,3806,3631
050,34,029,"New Jersey","Ocean County",3,26,7469,3769,3700
050,34,029,"New Jersey","Ocean County",3,27,7432,3725,3707
050,34,029,"New Jersey","Ocean County",3,28,7315,3690,3625
050,34,029,"New Jersey","Ocean County",3,29,7325,3740,3585
050,34,029,"New Jersey","Ocean County",3,30,7369,3715,3654
050,34,029,"New Jersey","Ocean County",3,31,7138,3632,3506
050,34,029,"New Jersey","Ocean County",3,32,6868,3452,3416
050,34,029,"New Jersey","Ocean County",3,33,6800,3424,3376
050,34,029,"New Jersey","Ocean County",3,34,6962,3588,3374
050,34,029,"New Jersey","Ocean County",3,35,6927,3555,3372
050,34,029,"New Jersey","Ocean County",3,36,6878,3454,3424
050,34,029,"New Jersey","Ocean County",3,37,6806,3430,3376
050,34,029,"New Jersey","Ocean County",3,38,6924,3508,3416
050,34,029,"New Jersey","Ocean County",3,39,6844,3478,3366
050,34,029,"New Jersey","Ocean County",3,40,6801,3463,3338
050,34,029,"New Jersey","Ocean County",3,41,6744,3436,3308
050,34,029,"New Jersey","Ocean County",3,42,6485,3295,3190
050,34,029,"New Jersey","Ocean County",3,43,6370,3214,3156
050,34,029,"New Jersey","Ocean County",3,44,6414,3263,3151
050,34,029,"New Jersey","Ocean County",3,45,6235,3167,3068
050,34,029,"New Jersey","Ocean County",3,46,6302,3148,3154
050,34,029,"New Jersey","Ocean County",3,47,6183,3065,3118
050,34,029,"New Jersey","Ocean County",3,48,6367,3182,3185
050,34,029,"New Jersey","Ocean County",3,49,6863,3429,3434
050,34,029,"New Jersey","Ocean County",3,50,7383,3647,3736
050,34,029,"New Jersey","Ocean County",3,51,7454,3658,3796
050,34,029,"New Jersey","Ocean County",3,52,7298,3619,3679
050,34,029,"New Jersey","Ocean County",3,53,7193,3487,3706
050,34,029,"New Jersey","Ocean County",3,54,7570,3659,3911
050,34,029,"New Jersey","Ocean County",3,55,7897,3873,4024
050,34,029,"New Jersey","Ocean County",3,56,8282,4003,4279
050,34,029,"New Jersey","Ocean County",3,57,8604,4192,4412
050,34,029,"New Jersey","Ocean County",3,58,8790,4218,4572
050,34,029,"New Jersey","Ocean County",3,59,8952,4334,4618
050,34,029,"New Jersey","Ocean County",3,60,9132,4405,4727
050,34,029,"New Jersey","Ocean County",3,61,8994,4295,4699
050,34,029,"New Jersey","Ocean County",3,62,8999,4208,4791
050,34,029,"New Jersey","Ocean County",3,63,9198,4363,4835
050,34,029,"New Jersey","Ocean County",3,64,9069,4291,4778
050,34,029,"New Jersey","Ocean County",3,65,8660,4024,4636
050,34,029,"New Jersey","Ocean County",3,66,8576,3959,4617
050,34,029,"New Jersey","Ocean County",3,67,8364,3860,4504
050,34,029,"New Jersey","Ocean County",3,68,8063,3698,4365
050,34,029,"New Jersey","Ocean County",3,69,7859,3540,4319
050,34,029,"New Jersey","Ocean County",3,70,7663,3431,4232
050,34,029,"New Jersey","Ocean County",3,71,7347,3239,4108
050,34,029,"New Jersey","Ocean County",3,72,7453,3265,4188
050,34,029,"New Jersey","Ocean County",3,73,7606,3397,4209
050,34,029,"New Jersey","Ocean County",3,74,8495,3843,4652
050,34,029,"New Jersey","Ocean County",3,75,5941,2602,3339
050,34,029,"New Jersey","Ocean County",3,76,5702,2474,3228
050,34,029,"New Jersey","Ocean County",3,77,5567,2424,3143
050,34,029,"New Jersey","Ocean County",3,78,5955,2565,3390
050,34,029,"New Jersey","Ocean County",3,79,5011,2104,2907
050,34,029,"New Jersey","Ocean County",3,80,4311,1781,2530
050,34,029,"New Jersey","Ocean County",3,81,3865,1611,2254
050,34,029,"New Jersey","Ocean County",3,82,3605,1473,2132
050,34,029,"New Jersey","Ocean County",3,83,3387,1378,2009
050,34,029,"New Jersey","Ocean County",3,84,3043,1249,1794
050,34,029,"New Jersey","Ocean County",3,85,17916,6288,11628
050,34,029,"New Jersey","Ocean County",4,0,10285,5263,5022
050,34,029,"New Jersey","Ocean County",4,1,9705,4978,4727
050,34,029,"New Jersey","Ocean County",4,2,9534,4880,4654
050,34,029,"New Jersey","Ocean County",4,3,9373,4873,4500
050,34,029,"New Jersey","Ocean County",4,4,9275,4807,4468
050,34,029,"New Jersey","Ocean County",4,5,9199,4751,4448
050,34,029,"New Jersey","Ocean County",4,6,9248,4724,4524
050,34,029,"New Jersey","Ocean County",4,7,9106,4625,4481
050,34,029,"New Jersey","Ocean County",4,8,8939,4604,4335
050,34,029,"New Jersey","Ocean County",4,9,8859,4551,4308
050,34,029,"New Jersey","Ocean County",4,10,8739,4413,4326
050,34,029,"New Jersey","Ocean County",4,11,8846,4535,4311
050,34,029,"New Jersey","Ocean County",4,12,8616,4450,4166
050,34,029,"New Jersey","Ocean County",4,13,8690,4501,4189
050,34,029,"New Jersey","Ocean County",4,14,8969,4628,4341
050,34,029,"New Jersey","Ocean County",4,15,8945,4570,4375
050,34,029,"New Jersey","Ocean County",4,16,8873,4488,4385
050,34,029,"New Jersey","Ocean County",4,17,8774,4523,4251
050,34,029,"New Jersey","Ocean County",4,18,7384,3898,3486
050,34,029,"New Jersey","Ocean County",4,19,5780,3062,2718
050,34,029,"New Jersey","Ocean County",4,20,6226,3221,3005
050,34,029,"New Jersey","Ocean County",4,21,6649,3333,3316
050,34,029,"New Jersey","Ocean County",4,22,7063,3536,3527
050,34,029,"New Jersey","Ocean County",4,23,7300,3682,3618
050,34,029,"New Jersey","Ocean County",4,24,7427,3719,3708
050,34,029,"New Jersey","Ocean County",4,25,7378,3742,3636
050,34,029,"New Jersey","Ocean County",4,26,7429,3822,3607
050,34,029,"New Jersey","Ocean County",4,27,7406,3749,3657
050,34,029,"New Jersey","Ocean County",4,28,7364,3689,3675
050,34,029,"New Jersey","Ocean County",4,29,7320,3679,3641
050,34,029,"New Jersey","Ocean County",4,30,7376,3755,3621
050,34,029,"New Jersey","Ocean County",4,31,7405,3713,3692
050,34,029,"New Jersey","Ocean County",4,32,7232,3669,3563
050,34,029,"New Jersey","Ocean County",4,33,6889,3482,3407
050,34,029,"New Jersey","Ocean County",4,34,6816,3445,3371
050,34,029,"New Jersey","Ocean County",4,35,6999,3608,3391
050,34,029,"New Jersey","Ocean County",4,36,6940,3564,3376
050,34,029,"New Jersey","Ocean County",4,37,6918,3456,3462
050,34,029,"New Jersey","Ocean County",4,38,6771,3416,3355
050,34,029,"New Jersey","Ocean County",4,39,6905,3489,3416
050,34,029,"New Jersey","Ocean County",4,40,6862,3496,3366
050,34,029,"New Jersey","Ocean County",4,41,6767,3434,3333
050,34,029,"New Jersey","Ocean County",4,42,6786,3451,3335
050,34,029,"New Jersey","Ocean County",4,43,6463,3281,3182
050,34,029,"New Jersey","Ocean County",4,44,6338,3226,3112
050,34,029,"New Jersey","Ocean County",4,45,6460,3268,3192
050,34,029,"New Jersey","Ocean County",4,46,6278,3187,3091
050,34,029,"New Jersey","Ocean County",4,47,6298,3097,3201
050,34,029,"New Jersey","Ocean County",4,48,6143,3048,3095
050,34,029,"New Jersey","Ocean County",4,49,6358,3202,3156
050,34,029,"New Jersey","Ocean County",4,50,6801,3377,3424
050,34,029,"New Jersey","Ocean County",4,51,7383,3632,3751
050,34,029,"New Jersey","Ocean County",4,52,7513,3683,3830
050,34,029,"New Jersey","Ocean County",4,53,7305,3609,3696
050,34,029,"New Jersey","Ocean County",4,54,7277,3515,3762
050,34,029,"New Jersey","Ocean County",4,55,7707,3728,3979
050,34,029,"New Jersey","Ocean County",4,56,7991,3868,4123
050,34,029,"New Jersey","Ocean County",4,57,8422,4047,4375
050,34,029,"New Jersey","Ocean County",4,58,8730,4220,4510
050,34,029,"New Jersey","Ocean County",4,59,8921,4242,4679
050,34,029,"New Jersey","Ocean County",4,60,9117,4403,4714
050,34,029,"New Jersey","Ocean County",4,61,9319,4478,4841
050,34,029,"New Jersey","Ocean County",4,62,9111,4339,4772
050,34,029,"New Jersey","Ocean County",4,63,9193,4283,4910
050,34,029,"New Jersey","Ocean County",4,64,9333,4393,4940
050,34,029,"New Jersey","Ocean County",4,65,9174,4285,4889
050,34,029,"New Jersey","Ocean County",4,66,8724,4053,4671
050,34,029,"New Jersey","Ocean County",4,67,8657,3968,4689
050,34,029,"New Jersey","Ocean County",4,68,8392,3848,4544
050,34,029,"New Jersey","Ocean County",4,69,8010,3671,4339
050,34,029,"New Jersey","Ocean County",4,70,7869,3520,4349
050,34,029,"New Jersey","Ocean County",4,71,7652,3421,4231
050,34,029,"New Jersey","Ocean County",4,72,7310,3224,4086
050,34,029,"New Jersey","Ocean County",4,73,7390,3248,4142
050,34,029,"New Jersey","Ocean County",4,74,7484,3347,4137
050,34,029,"New Jersey","Ocean County",4,75,8340,3746,4594
050,34,029,"New Jersey","Ocean County",4,76,5812,2519,3293
050,34,029,"New Jersey","Ocean County",4,77,5520,2399,3121
050,34,029,"New Jersey","Ocean County",4,78,5316,2315,3001
050,34,029,"New Jersey","Ocean County",4,79,5751,2457,3294
050,34,029,"New Jersey","Ocean County",4,80,4733,1985,2748
050,34,029,"New Jersey","Ocean County",4,81,4086,1673,2413
050,34,029,"New Jersey","Ocean County",4,82,3620,1480,2140
050,34,029,"New Jersey","Ocean County",4,83,3288,1354,1934
050,34,029,"New Jersey","Ocean County",4,84,3063,1211,1852
050,34,029,"New Jersey","Ocean County",4,85,17644,6181,11463
050,34,029,"New Jersey","Ocean County",5,0,10289,5259,5030
050,34,029,"New Jersey","Ocean County",5,1,10155,5168,4987
050,34,029,"New Jersey","Ocean County",5,2,9618,4948,4670
050,34,029,"New Jersey","Ocean County",5,3,9393,4806,4587
050,34,029,"New Jersey","Ocean County",5,4,9296,4817,4479
050,34,029,"New Jersey","Ocean County",5,5,9199,4760,4439
050,34,029,"New Jersey","Ocean County",5,6,9143,4714,4429
050,34,029,"New Jersey","Ocean County",5,7,9223,4734,4489
050,34,029,"New Jersey","Ocean County",5,8,9057,4603,4454
050,34,029,"New Jersey","Ocean County",5,9,8893,4590,4303
050,34,029,"New Jersey","Ocean County",5,10,8854,4559,4295
050,34,029,"New Jersey","Ocean County",5,11,8761,4432,4329
050,34,029,"New Jersey","Ocean County",5,12,8829,4544,4285
050,34,029,"New Jersey","Ocean County",5,13,8647,4475,4172
050,34,029,"New Jersey","Ocean County",5,14,8710,4528,4182
050,34,029,"New Jersey","Ocean County",5,15,8997,4632,4365
050,34,029,"New Jersey","Ocean County",5,16,8943,4562,4381
050,34,029,"New Jersey","Ocean County",5,17,8887,4518,4369
050,34,029,"New Jersey","Ocean County",5,18,7482,4010,3472
050,34,029,"New Jersey","Ocean County",5,19,5956,3120,2836
050,34,029,"New Jersey","Ocean County",5,20,6350,3307,3043
050,34,029,"New Jersey","Ocean County",5,21,6673,3351,3322
050,34,029,"New Jersey","Ocean County",5,22,7193,3523,3670
050,34,029,"New Jersey","Ocean County",5,23,7449,3765,3684
050,34,029,"New Jersey","Ocean County",5,24,7415,3748,3667
050,34,029,"New Jersey","Ocean County",5,25,7424,3779,3645
050,34,029,"New Jersey","Ocean County",5,26,7344,3717,3627
050,34,029,"New Jersey","Ocean County",5,27,7389,3834,3555
050,34,029,"New Jersey","Ocean County",5,28,7322,3697,3625
050,34,029,"New Jersey","Ocean County",5,29,7341,3681,3660
050,34,029,"New Jersey","Ocean County",5,30,7235,3650,3585
050,34,029,"New Jersey","Ocean County",5,31,7296,3717,3579
050,34,029,"New Jersey","Ocean County",5,32,7368,3682,3686
050,34,029,"New Jersey","Ocean County",5,33,7218,3650,3568
050,34,029,"New Jersey","Ocean County",5,34,6901,3495,3406
050,34,029,"New Jersey","Ocean County",5,35,6797,3418,3379
050,34,029,"New Jersey","Ocean County",5,36,7053,3651,3402
050,34,029,"New Jersey","Ocean County",5,37,6959,3554,3405
050,34,029,"New Jersey","Ocean County",5,38,6886,3437,3449
050,34,029,"New Jersey","Ocean County",5,39,6772,3400,3372
050,34,029,"New Jersey","Ocean County",5,40,6862,3464,3398
050,34,029,"New Jersey","Ocean County",5,41,6831,3495,3336
050,34,029,"New Jersey","Ocean County",5,42,6748,3418,3330
050,34,029,"New Jersey","Ocean County",5,43,6759,3441,3318
050,34,029,"New Jersey","Ocean County",5,44,6433,3277,3156
050,34,029,"New Jersey","Ocean County",5,45,6312,3208,3104
050,34,029,"New Jersey","Ocean County",5,46,6468,3279,3189
050,34,029,"New Jersey","Ocean County",5,47,6269,3175,3094
050,34,029,"New Jersey","Ocean County",5,48,6244,3074,3170
050,34,029,"New Jersey","Ocean County",5,49,6135,3049,3086
050,34,029,"New Jersey","Ocean County",5,50,6333,3168,3165
050,34,029,"New Jersey","Ocean County",5,51,6841,3382,3459
050,34,029,"New Jersey","Ocean County",5,52,7376,3641,3735
050,34,029,"New Jersey","Ocean County",5,53,7497,3654,3843
050,34,029,"New Jersey","Ocean County",5,54,7361,3612,3749
050,34,029,"New Jersey","Ocean County",5,55,7388,3579,3809
050,34,029,"New Jersey","Ocean County",5,56,7743,3736,4007
050,34,029,"New Jersey","Ocean County",5,57,8050,3891,4159
050,34,029,"New Jersey","Ocean County",5,58,8465,4043,4422
050,34,029,"New Jersey","Ocean County",5,59,8812,4251,4561
050,34,029,"New Jersey","Ocean County",5,60,8941,4237,4704
050,34,029,"New Jersey","Ocean County",5,61,9203,4413,4790
050,34,029,"New Jersey","Ocean County",5,62,9419,4492,4927
050,34,029,"New Jersey","Ocean County",5,63,9207,4382,4825
050,34,029,"New Jersey","Ocean County",5,64,9248,4315,4933
050,34,029,"New Jersey","Ocean County",5,65,9427,4420,5007
050,34,029,"New Jersey","Ocean County",5,66,9186,4244,4942
050,34,029,"New Jersey","Ocean County",5,67,8747,4027,4720
050,34,029,"New Jersey","Ocean County",5,68,8609,3923,4686
050,34,029,"New Jersey","Ocean County",5,69,8370,3830,4540
050,34,029,"New Jersey","Ocean County",5,70,7994,3650,4344
050,34,029,"New Jersey","Ocean County",5,71,7815,3507,4308
050,34,029,"New Jersey","Ocean County",5,72,7599,3393,4206
050,34,029,"New Jersey","Ocean County",5,73,7231,3173,4058
050,34,029,"New Jersey","Ocean County",5,74,7249,3178,4071
050,34,029,"New Jersey","Ocean County",5,75,7367,3280,4087
050,34,029,"New Jersey","Ocean County",5,76,8143,3620,4523
050,34,029,"New Jersey","Ocean County",5,77,5632,2433,3199
050,34,029,"New Jersey","Ocean County",5,78,5344,2304,3040
050,34,029,"New Jersey","Ocean County",5,79,5136,2226,2910
050,34,029,"New Jersey","Ocean County",5,80,5448,2325,3123
050,34,029,"New Jersey","Ocean County",5,81,4501,1861,2640
050,34,029,"New Jersey","Ocean County",5,82,3848,1555,2293
050,34,029,"New Jersey","Ocean County",5,83,3355,1377,1978
050,34,029,"New Jersey","Ocean County",5,84,3015,1208,1807
050,34,029,"New Jersey","Ocean County",5,85,17519,6152,11367
050,34,031,"New Jersey","Passaic County",1,0,6566,3357,3209
050,34,031,"New Jersey","Passaic County",1,1,6779,3466,3313
050,34,031,"New Jersey","Passaic County",1,2,6938,3540,3398
050,34,031,"New Jersey","Passaic County",1,3,7061,3591,3470
050,34,031,"New Jersey","Passaic County",1,4,6960,3491,3469
050,34,031,"New Jersey","Passaic County",1,5,6968,3598,3370
050,34,031,"New Jersey","Passaic County",1,6,6839,3582,3257
050,34,031,"New Jersey","Passaic County",1,7,6990,3582,3408
050,34,031,"New Jersey","Passaic County",1,8,6970,3592,3378
050,34,031,"New Jersey","Passaic County",1,9,6975,3579,3396
050,34,031,"New Jersey","Passaic County",1,10,6911,3487,3424
050,34,031,"New Jersey","Passaic County",1,11,6979,3612,3367
050,34,031,"New Jersey","Passaic County",1,12,7260,3702,3558
050,34,031,"New Jersey","Passaic County",1,13,7109,3632,3477
050,34,031,"New Jersey","Passaic County",1,14,7037,3634,3403
050,34,031,"New Jersey","Passaic County",1,15,6991,3573,3418
050,34,031,"New Jersey","Passaic County",1,16,7069,3616,3453
050,34,031,"New Jersey","Passaic County",1,17,7095,3650,3445
050,34,031,"New Jersey","Passaic County",1,18,7155,3575,3580
050,34,031,"New Jersey","Passaic County",1,19,7086,3507,3579
050,34,031,"New Jersey","Passaic County",1,20,7144,3522,3622
050,34,031,"New Jersey","Passaic County",1,21,7058,3520,3538
050,34,031,"New Jersey","Passaic County",1,22,7060,3526,3534
050,34,031,"New Jersey","Passaic County",1,23,6777,3343,3434
050,34,031,"New Jersey","Passaic County",1,24,6792,3404,3388
050,34,031,"New Jersey","Passaic County",1,25,6825,3413,3412
050,34,031,"New Jersey","Passaic County",1,26,6989,3512,3477
050,34,031,"New Jersey","Passaic County",1,27,6974,3477,3497
050,34,031,"New Jersey","Passaic County",1,28,7072,3502,3570
050,34,031,"New Jersey","Passaic County",1,29,7143,3550,3593
050,34,031,"New Jersey","Passaic County",1,30,7287,3587,3700
050,34,031,"New Jersey","Passaic County",1,31,7070,3592,3478
050,34,031,"New Jersey","Passaic County",1,32,6884,3518,3366
050,34,031,"New Jersey","Passaic County",1,33,6858,3517,3341
050,34,031,"New Jersey","Passaic County",1,34,6986,3610,3376
050,34,031,"New Jersey","Passaic County",1,35,6797,3473,3324
050,34,031,"New Jersey","Passaic County",1,36,6622,3297,3325
050,34,031,"New Jersey","Passaic County",1,37,6692,3346,3346
050,34,031,"New Jersey","Passaic County",1,38,6776,3327,3449
050,34,031,"New Jersey","Passaic County",1,39,6745,3386,3359
050,34,031,"New Jersey","Passaic County",1,40,6640,3388,3252
050,34,031,"New Jersey","Passaic County",1,41,6453,3179,3274
050,34,031,"New Jersey","Passaic County",1,42,6612,3279,3333
050,34,031,"New Jersey","Passaic County",1,43,6297,3154,3143
050,34,031,"New Jersey","Passaic County",1,44,6259,3120,3139
050,34,031,"New Jersey","Passaic County",1,45,6356,3118,3238
050,34,031,"New Jersey","Passaic County",1,46,6372,3126,3246
050,34,031,"New Jersey","Passaic County",1,47,6415,3127,3288
050,34,031,"New Jersey","Passaic County",1,48,6696,3262,3434
050,34,031,"New Jersey","Passaic County",1,49,7067,3506,3561
050,34,031,"New Jersey","Passaic County",1,50,7027,3519,3508
050,34,031,"New Jersey","Passaic County",1,51,6812,3396,3416
050,34,031,"New Jersey","Passaic County",1,52,6933,3427,3506
050,34,031,"New Jersey","Passaic County",1,53,6923,3431,3492
050,34,031,"New Jersey","Passaic County",1,54,7086,3452,3634
050,34,031,"New Jersey","Passaic County",1,55,7273,3572,3701
050,34,031,"New Jersey","Passaic County",1,56,7130,3499,3631
050,34,031,"New Jersey","Passaic County",1,57,7129,3535,3594
050,34,031,"New Jersey","Passaic County",1,58,7070,3476,3594
050,34,031,"New Jersey","Passaic County",1,59,6923,3397,3526
050,34,031,"New Jersey","Passaic County",1,60,6810,3342,3468
050,34,031,"New Jersey","Passaic County",1,61,6734,3242,3492
050,34,031,"New Jersey","Passaic County",1,62,6618,3202,3416
050,34,031,"New Jersey","Passaic County",1,63,6204,3023,3181
050,34,031,"New Jersey","Passaic County",1,64,5925,2847,3078
050,34,031,"New Jersey","Passaic County",1,65,5705,2803,2902
050,34,031,"New Jersey","Passaic County",1,66,5434,2693,2741
050,34,031,"New Jersey","Passaic County",1,67,5138,2456,2682
050,34,031,"New Jersey","Passaic County",1,68,4836,2252,2584
050,34,031,"New Jersey","Passaic County",1,69,4611,2140,2471
050,34,031,"New Jersey","Passaic County",1,70,4480,2048,2432
050,34,031,"New Jersey","Passaic County",1,71,4240,1925,2315
050,34,031,"New Jersey","Passaic County",1,72,4294,1922,2372
050,34,031,"New Jersey","Passaic County",1,73,4247,1918,2329
050,34,031,"New Jersey","Passaic County",1,74,3244,1408,1836
050,34,031,"New Jersey","Passaic County",1,75,3048,1343,1705
050,34,031,"New Jersey","Passaic County",1,76,2898,1272,1626
050,34,031,"New Jersey","Passaic County",1,77,2967,1256,1711
050,34,031,"New Jersey","Passaic County",1,78,2538,1071,1467
050,34,031,"New Jersey","Passaic County",1,79,2250,937,1313
050,34,031,"New Jersey","Passaic County",1,80,2225,940,1285
050,34,031,"New Jersey","Passaic County",1,81,2061,867,1194
050,34,031,"New Jersey","Passaic County",1,82,1873,765,1108
050,34,031,"New Jersey","Passaic County",1,83,1638,636,1002
050,34,031,"New Jersey","Passaic County",1,84,1507,611,896
050,34,031,"New Jersey","Passaic County",1,85,9767,3222,6545
050,34,031,"New Jersey","Passaic County",2,0,6563,3334,3229
050,34,031,"New Jersey","Passaic County",2,1,6729,3436,3293
050,34,031,"New Jersey","Passaic County",2,2,6877,3505,3372
050,34,031,"New Jersey","Passaic County",2,3,6984,3547,3437
050,34,031,"New Jersey","Passaic County",2,4,6980,3511,3469
050,34,031,"New Jersey","Passaic County",2,5,6956,3568,3388
050,34,031,"New Jersey","Passaic County",2,6,6873,3588,3285
050,34,031,"New Jersey","Passaic County",2,7,6928,3568,3360
050,34,031,"New Jersey","Passaic County",2,8,6937,3573,3364
050,34,031,"New Jersey","Passaic County",2,9,6954,3574,3380
050,34,031,"New Jersey","Passaic County",2,10,6915,3503,3412
050,34,031,"New Jersey","Passaic County",2,11,6932,3564,3368
050,34,031,"New Jersey","Passaic County",2,12,7210,3691,3519
050,34,031,"New Jersey","Passaic County",2,13,7116,3631,3485
050,34,031,"New Jersey","Passaic County",2,14,7031,3613,3418
050,34,031,"New Jersey","Passaic County",2,15,6992,3580,3412
050,34,031,"New Jersey","Passaic County",2,16,7049,3608,3441
050,34,031,"New Jersey","Passaic County",2,17,7075,3632,3443
050,34,031,"New Jersey","Passaic County",2,18,7147,3591,3556
050,34,031,"New Jersey","Passaic County",2,19,7068,3505,3563
050,34,031,"New Jersey","Passaic County",2,20,7188,3532,3656
050,34,031,"New Jersey","Passaic County",2,21,7052,3502,3550
050,34,031,"New Jersey","Passaic County",2,22,7010,3512,3498
050,34,031,"New Jersey","Passaic County",2,23,6771,3347,3424
050,34,031,"New Jersey","Passaic County",2,24,6747,3365,3382
050,34,031,"New Jersey","Passaic County",2,25,6826,3418,3408
050,34,031,"New Jersey","Passaic County",2,26,6950,3495,3455
050,34,031,"New Jersey","Passaic County",2,27,6955,3473,3482
050,34,031,"New Jersey","Passaic County",2,28,7047,3497,3550
050,34,031,"New Jersey","Passaic County",2,29,7119,3530,3589
050,34,031,"New Jersey","Passaic County",2,30,7270,3583,3687
050,34,031,"New Jersey","Passaic County",2,31,7092,3581,3511
050,34,031,"New Jersey","Passaic County",2,32,6923,3537,3386
050,34,031,"New Jersey","Passaic County",2,33,6848,3512,3336
050,34,031,"New Jersey","Passaic County",2,34,6946,3592,3354
050,34,031,"New Jersey","Passaic County",2,35,6866,3521,3345
050,34,031,"New Jersey","Passaic County",2,36,6611,3309,3302
050,34,031,"New Jersey","Passaic County",2,37,6647,3316,3331
050,34,031,"New Jersey","Passaic County",2,38,6766,3338,3428
050,34,031,"New Jersey","Passaic County",2,39,6702,3348,3354
050,34,031,"New Jersey","Passaic County",2,40,6687,3404,3283
050,34,031,"New Jersey","Passaic County",2,41,6462,3209,3253
050,34,031,"New Jersey","Passaic County",2,42,6517,3231,3286
050,34,031,"New Jersey","Passaic County",2,43,6375,3180,3195
050,34,031,"New Jersey","Passaic County",2,44,6221,3103,3118
050,34,031,"New Jersey","Passaic County",2,45,6332,3115,3217
050,34,031,"New Jersey","Passaic County",2,46,6338,3103,3235
050,34,031,"New Jersey","Passaic County",2,47,6383,3114,3269
050,34,031,"New Jersey","Passaic County",2,48,6608,3217,3391
050,34,031,"New Jersey","Passaic County",2,49,6980,3448,3532
050,34,031,"New Jersey","Passaic County",2,50,7026,3517,3509
050,34,031,"New Jersey","Passaic County",2,51,6803,3390,3413
050,34,031,"New Jersey","Passaic County",2,52,6887,3411,3476
050,34,031,"New Jersey","Passaic County",2,53,6885,3404,3481
050,34,031,"New Jersey","Passaic County",2,54,7011,3428,3583
050,34,031,"New Jersey","Passaic County",2,55,7200,3524,3676
050,34,031,"New Jersey","Passaic County",2,56,7162,3514,3648
050,34,031,"New Jersey","Passaic County",2,57,7089,3496,3593
050,34,031,"New Jersey","Passaic County",2,58,7049,3470,3579
050,34,031,"New Jersey","Passaic County",2,59,6911,3386,3525
050,34,031,"New Jersey","Passaic County",2,60,6810,3344,3466
050,34,031,"New Jersey","Passaic County",2,61,6682,3221,3461
050,34,031,"New Jersey","Passaic County",2,62,6567,3174,3393
050,34,031,"New Jersey","Passaic County",2,63,6279,3048,3231
050,34,031,"New Jersey","Passaic County",2,64,5885,2824,3061
050,34,031,"New Jersey","Passaic County",2,65,5714,2787,2927
050,34,031,"New Jersey","Passaic County",2,66,5435,2675,2760
050,34,031,"New Jersey","Passaic County",2,67,5120,2461,2659
050,34,031,"New Jersey","Passaic County",2,68,4821,2250,2571
050,34,031,"New Jersey","Passaic County",2,69,4635,2150,2485
050,34,031,"New Jersey","Passaic County",2,70,4458,2042,2416
050,34,031,"New Jersey","Passaic County",2,71,4247,1927,2320
050,34,031,"New Jersey","Passaic County",2,72,4182,1864,2318
050,34,031,"New Jersey","Passaic County",2,73,4366,1965,2401
050,34,031,"New Jersey","Passaic County",2,74,3269,1423,1846
050,34,031,"New Jersey","Passaic County",2,75,3059,1336,1723
050,34,031,"New Jersey","Passaic County",2,76,2860,1255,1605
050,34,031,"New Jersey","Passaic County",2,77,2939,1245,1694
050,34,031,"New Jersey","Passaic County",2,78,2550,1068,1482
050,34,031,"New Jersey","Passaic County",2,79,2261,941,1320
050,34,031,"New Jersey","Passaic County",2,80,2181,914,1267
050,34,031,"New Jersey","Passaic County",2,81,2048,863,1185
050,34,031,"New Jersey","Passaic County",2,82,1867,759,1108
050,34,031,"New Jersey","Passaic County",2,83,1622,632,990
050,34,031,"New Jersey","Passaic County",2,84,1491,598,893
050,34,031,"New Jersey","Passaic County",2,85,9513,3152,6361
050,34,031,"New Jersey","Passaic County",3,0,6123,3100,3023
050,34,031,"New Jersey","Passaic County",3,1,6464,3277,3187
050,34,031,"New Jersey","Passaic County",3,2,6683,3442,3241
050,34,031,"New Jersey","Passaic County",3,3,6715,3451,3264
050,34,031,"New Jersey","Passaic County",3,4,6852,3507,3345
050,34,031,"New Jersey","Passaic County",3,5,6846,3481,3365
050,34,031,"New Jersey","Passaic County",3,6,6872,3528,3344
050,34,031,"New Jersey","Passaic County",3,7,6739,3503,3236
050,34,031,"New Jersey","Passaic County",3,8,6821,3513,3308
050,34,031,"New Jersey","Passaic County",3,9,6827,3517,3310
050,34,031,"New Jersey","Passaic County",3,10,6878,3526,3352
050,34,031,"New Jersey","Passaic County",3,11,6859,3461,3398
050,34,031,"New Jersey","Passaic County",3,12,6878,3578,3300
050,34,031,"New Jersey","Passaic County",3,13,7089,3628,3461
050,34,031,"New Jersey","Passaic County",3,14,7036,3581,3455
050,34,031,"New Jersey","Passaic County",3,15,7014,3594,3420
050,34,031,"New Jersey","Passaic County",3,16,6948,3550,3398
050,34,031,"New Jersey","Passaic County",3,17,6980,3579,3401
050,34,031,"New Jersey","Passaic County",3,18,6989,3553,3436
050,34,031,"New Jersey","Passaic County",3,19,6845,3414,3431
050,34,031,"New Jersey","Passaic County",3,20,6920,3391,3529
050,34,031,"New Jersey","Passaic County",3,21,6944,3417,3527
050,34,031,"New Jersey","Passaic County",3,22,6803,3423,3380
050,34,031,"New Jersey","Passaic County",3,23,6723,3400,3323
050,34,031,"New Jersey","Passaic County",3,24,6698,3314,3384
050,34,031,"New Jersey","Passaic County",3,25,6690,3335,3355
050,34,031,"New Jersey","Passaic County",3,26,6752,3362,3390
050,34,031,"New Jersey","Passaic County",3,27,6864,3432,3432
050,34,031,"New Jersey","Passaic County",3,28,6916,3440,3476
050,34,031,"New Jersey","Passaic County",3,29,6969,3455,3514
050,34,031,"New Jersey","Passaic County",3,30,7031,3493,3538
050,34,031,"New Jersey","Passaic County",3,31,7224,3570,3654
050,34,031,"New Jersey","Passaic County",3,32,6991,3577,3414
050,34,031,"New Jersey","Passaic County",3,33,6809,3486,3323
050,34,031,"New Jersey","Passaic County",3,34,6764,3501,3263
050,34,031,"New Jersey","Passaic County",3,35,6883,3580,3303
050,34,031,"New Jersey","Passaic County",3,36,6819,3514,3305
050,34,031,"New Jersey","Passaic County",3,37,6537,3296,3241
050,34,031,"New Jersey","Passaic County",3,38,6628,3322,3306
050,34,031,"New Jersey","Passaic County",3,39,6632,3266,3366
050,34,031,"New Jersey","Passaic County",3,40,6660,3348,3312
050,34,031,"New Jersey","Passaic County",3,41,6655,3375,3280
050,34,031,"New Jersey","Passaic County",3,42,6423,3230,3193
050,34,031,"New Jersey","Passaic County",3,43,6409,3156,3253
050,34,031,"New Jersey","Passaic County",3,44,6248,3128,3120
050,34,031,"New Jersey","Passaic County",3,45,6115,3060,3055
050,34,031,"New Jersey","Passaic County",3,46,6252,3045,3207
050,34,031,"New Jersey","Passaic County",3,47,6334,3093,3241
050,34,031,"New Jersey","Passaic County",3,48,6328,3068,3260
050,34,031,"New Jersey","Passaic County",3,49,6601,3235,3366
050,34,031,"New Jersey","Passaic County",3,50,6923,3400,3523
050,34,031,"New Jersey","Passaic County",3,51,6922,3447,3475
050,34,031,"New Jersey","Passaic County",3,52,6724,3337,3387
050,34,031,"New Jersey","Passaic County",3,53,6728,3291,3437
050,34,031,"New Jersey","Passaic County",3,54,6815,3379,3436
050,34,031,"New Jersey","Passaic County",3,55,6911,3387,3524
050,34,031,"New Jersey","Passaic County",3,56,7046,3445,3601
050,34,031,"New Jersey","Passaic County",3,57,7061,3485,3576
050,34,031,"New Jersey","Passaic County",3,58,6920,3431,3489
050,34,031,"New Jersey","Passaic County",3,59,6895,3381,3514
050,34,031,"New Jersey","Passaic County",3,60,6682,3296,3386
050,34,031,"New Jersey","Passaic County",3,61,6659,3260,3399
050,34,031,"New Jersey","Passaic County",3,62,6526,3151,3375
050,34,031,"New Jersey","Passaic County",3,63,6392,3084,3308
050,34,031,"New Jersey","Passaic County",3,64,6041,2903,3138
050,34,031,"New Jersey","Passaic County",3,65,5728,2723,3005
050,34,031,"New Jersey","Passaic County",3,66,5494,2671,2823
050,34,031,"New Jersey","Passaic County",3,67,5258,2573,2685
050,34,031,"New Jersey","Passaic County",3,68,4968,2383,2585
050,34,031,"New Jersey","Passaic County",3,69,4656,2128,2528
050,34,031,"New Jersey","Passaic County",3,70,4494,2084,2410
050,34,031,"New Jersey","Passaic County",3,71,4292,1960,2332
050,34,031,"New Jersey","Passaic County",3,72,4100,1838,2262
050,34,031,"New Jersey","Passaic County",3,73,4046,1788,2258
050,34,031,"New Jersey","Passaic County",3,74,4192,1869,2323
050,34,031,"New Jersey","Passaic County",3,75,3146,1373,1773
050,34,031,"New Jersey","Passaic County",3,76,2903,1241,1662
050,34,031,"New Jersey","Passaic County",3,77,2775,1189,1586
050,34,031,"New Jersey","Passaic County",3,78,2821,1185,1636
050,34,031,"New Jersey","Passaic County",3,79,2392,1000,1392
050,34,031,"New Jersey","Passaic County",3,80,2153,886,1267
050,34,031,"New Jersey","Passaic County",3,81,2026,829,1197
050,34,031,"New Jersey","Passaic County",3,82,1927,804,1123
050,34,031,"New Jersey","Passaic County",3,83,1735,692,1043
050,34,031,"New Jersey","Passaic County",3,84,1484,552,932
050,34,031,"New Jersey","Passaic County",3,85,9461,3180,6281
050,34,031,"New Jersey","Passaic County",4,0,6349,3210,3139
050,34,031,"New Jersey","Passaic County",4,1,6157,3103,3054
050,34,031,"New Jersey","Passaic County",4,2,6408,3222,3186
050,34,031,"New Jersey","Passaic County",4,3,6542,3358,3184
050,34,031,"New Jersey","Passaic County",4,4,6682,3444,3238
050,34,031,"New Jersey","Passaic County",4,5,6674,3452,3222
050,34,031,"New Jersey","Passaic County",4,6,6776,3447,3329
050,34,031,"New Jersey","Passaic County",4,7,6758,3479,3279
050,34,031,"New Jersey","Passaic County",4,8,6643,3449,3194
050,34,031,"New Jersey","Passaic County",4,9,6800,3503,3297
050,34,031,"New Jersey","Passaic County",4,10,6800,3508,3292
050,34,031,"New Jersey","Passaic County",4,11,6817,3492,3325
050,34,031,"New Jersey","Passaic County",4,12,6827,3440,3387
050,34,031,"New Jersey","Passaic County",4,13,6853,3513,3340
050,34,031,"New Jersey","Passaic County",4,14,7059,3627,3432
050,34,031,"New Jersey","Passaic County",4,15,6979,3545,3434
050,34,031,"New Jersey","Passaic County",4,16,6926,3548,3378
050,34,031,"New Jersey","Passaic County",4,17,6900,3538,3362
050,34,031,"New Jersey","Passaic County",4,18,6939,3537,3402
050,34,031,"New Jersey","Passaic County",4,19,6674,3379,3295
050,34,031,"New Jersey","Passaic County",4,20,6892,3400,3492
050,34,031,"New Jersey","Passaic County",4,21,6826,3323,3503
050,34,031,"New Jersey","Passaic County",4,22,6776,3377,3399
050,34,031,"New Jersey","Passaic County",4,23,6649,3377,3272
050,34,031,"New Jersey","Passaic County",4,24,6614,3354,3260
050,34,031,"New Jersey","Passaic County",4,25,6522,3238,3284
050,34,031,"New Jersey","Passaic County",4,26,6487,3263,3224
050,34,031,"New Jersey","Passaic County",4,27,6585,3239,3346
050,34,031,"New Jersey","Passaic County",4,28,6738,3334,3404
050,34,031,"New Jersey","Passaic County",4,29,6746,3364,3382
050,34,031,"New Jersey","Passaic County",4,30,6925,3370,3555
050,34,031,"New Jersey","Passaic County",4,31,6868,3399,3469
050,34,031,"New Jersey","Passaic County",4,32,7146,3504,3642
050,34,031,"New Jersey","Passaic County",4,33,6875,3518,3357
050,34,031,"New Jersey","Passaic County",4,34,6689,3426,3263
050,34,031,"New Jersey","Passaic County",4,35,6713,3478,3235
050,34,031,"New Jersey","Passaic County",4,36,6740,3507,3233
050,34,031,"New Jersey","Passaic County",4,37,6720,3476,3244
050,34,031,"New Jersey","Passaic County",4,38,6478,3234,3244
050,34,031,"New Jersey","Passaic County",4,39,6534,3285,3249
050,34,031,"New Jersey","Passaic County",4,40,6512,3232,3280
050,34,031,"New Jersey","Passaic County",4,41,6597,3293,3304
050,34,031,"New Jersey","Passaic County",4,42,6534,3307,3227
050,34,031,"New Jersey","Passaic County",4,43,6284,3128,3156
050,34,031,"New Jersey","Passaic County",4,44,6288,3092,3196
050,34,031,"New Jersey","Passaic County",4,45,6165,3107,3058
050,34,031,"New Jersey","Passaic County",4,46,6055,3002,3053
050,34,031,"New Jersey","Passaic County",4,47,6133,3024,3109
050,34,031,"New Jersey","Passaic County",4,48,6212,3042,3170
050,34,031,"New Jersey","Passaic County",4,49,6181,3005,3176
050,34,031,"New Jersey","Passaic County",4,50,6553,3203,3350
050,34,031,"New Jersey","Passaic County",4,51,6836,3369,3467
050,34,031,"New Jersey","Passaic County",4,52,6828,3425,3403
050,34,031,"New Jersey","Passaic County",4,53,6610,3277,3333
050,34,031,"New Jersey","Passaic County",4,54,6578,3201,3377
050,34,031,"New Jersey","Passaic County",4,55,6646,3303,3343
050,34,031,"New Jersey","Passaic County",4,56,6807,3339,3468
050,34,031,"New Jersey","Passaic County",4,57,6865,3360,3505
050,34,031,"New Jersey","Passaic County",4,58,6900,3375,3525
050,34,031,"New Jersey","Passaic County",4,59,6743,3319,3424
050,34,031,"New Jersey","Passaic County",4,60,6725,3305,3420
050,34,031,"New Jersey","Passaic County",4,61,6547,3224,3323
050,34,031,"New Jersey","Passaic County",4,62,6494,3154,3340
050,34,031,"New Jersey","Passaic County",4,63,6289,3060,3229
050,34,031,"New Jersey","Passaic County",4,64,6185,2961,3224
050,34,031,"New Jersey","Passaic County",4,65,5844,2769,3075
050,34,031,"New Jersey","Passaic County",4,66,5507,2587,2920
050,34,031,"New Jersey","Passaic County",4,67,5298,2562,2736
050,34,031,"New Jersey","Passaic County",4,68,5118,2471,2647
050,34,031,"New Jersey","Passaic County",4,69,4850,2306,2544
050,34,031,"New Jersey","Passaic County",4,70,4544,2084,2460
050,34,031,"New Jersey","Passaic County",4,71,4366,2020,2346
050,34,031,"New Jersey","Passaic County",4,72,4150,1891,2259
050,34,031,"New Jersey","Passaic County",4,73,3952,1754,2198
050,34,031,"New Jersey","Passaic County",4,74,3899,1708,2191
050,34,031,"New Jersey","Passaic County",4,75,3994,1763,2231
050,34,031,"New Jersey","Passaic County",4,76,3034,1323,1711
050,34,031,"New Jersey","Passaic County",4,77,2797,1189,1608
050,34,031,"New Jersey","Passaic County",4,78,2656,1130,1526
050,34,031,"New Jersey","Passaic County",4,79,2662,1112,1550
050,34,031,"New Jersey","Passaic County",4,80,2335,966,1369
050,34,031,"New Jersey","Passaic County",4,81,2031,814,1217
050,34,031,"New Jersey","Passaic County",4,82,1921,774,1147
050,34,031,"New Jersey","Passaic County",4,83,1822,745,1077
050,34,031,"New Jersey","Passaic County",4,84,1604,628,976
050,34,031,"New Jersey","Passaic County",4,85,9597,3223,6374
050,34,031,"New Jersey","Passaic County",5,0,6342,3206,3136
050,34,031,"New Jersey","Passaic County",5,1,6430,3220,3210
050,34,031,"New Jersey","Passaic County",5,2,6212,3158,3054
050,34,031,"New Jersey","Passaic County",5,3,6388,3227,3161
050,34,031,"New Jersey","Passaic County",5,4,6580,3384,3196
050,34,031,"New Jersey","Passaic County",5,5,6647,3446,3201
050,34,031,"New Jersey","Passaic County",5,6,6688,3434,3254
050,34,031,"New Jersey","Passaic County",5,7,6718,3418,3300
050,34,031,"New Jersey","Passaic County",5,8,6774,3502,3272
050,34,031,"New Jersey","Passaic County",5,9,6611,3430,3181
050,34,031,"New Jersey","Passaic County",5,10,6873,3529,3344
050,34,031,"New Jersey","Passaic County",5,11,6781,3484,3297
050,34,031,"New Jersey","Passaic County",5,12,6810,3499,3311
050,34,031,"New Jersey","Passaic County",5,13,6822,3433,3389
050,34,031,"New Jersey","Passaic County",5,14,6846,3517,3329
050,34,031,"New Jersey","Passaic County",5,15,7062,3639,3423
050,34,031,"New Jersey","Passaic County",5,16,6964,3521,3443
050,34,031,"New Jersey","Passaic County",5,17,6911,3544,3367
050,34,031,"New Jersey","Passaic County",5,18,6867,3513,3354
050,34,031,"New Jersey","Passaic County",5,19,6726,3409,3317
050,34,031,"New Jersey","Passaic County",5,20,6871,3409,3462
050,34,031,"New Jersey","Passaic County",5,21,6881,3341,3540
050,34,031,"New Jersey","Passaic County",5,22,6778,3353,3425
050,34,031,"New Jersey","Passaic County",5,23,6663,3340,3323
050,34,031,"New Jersey","Passaic County",5,24,6511,3364,3147
050,34,031,"New Jersey","Passaic County",5,25,6640,3360,3280
050,34,031,"New Jersey","Passaic County",5,26,6461,3252,3209
050,34,031,"New Jersey","Passaic County",5,27,6413,3225,3188
050,34,031,"New Jersey","Passaic County",5,28,6642,3244,3398
050,34,031,"New Jersey","Passaic County",5,29,6661,3308,3353
050,34,031,"New Jersey","Passaic County",5,30,6742,3299,3443
050,34,031,"New Jersey","Passaic County",5,31,6861,3308,3553
050,34,031,"New Jersey","Passaic County",5,32,6909,3412,3497
050,34,031,"New Jersey","Passaic County",5,33,7132,3506,3626
050,34,031,"New Jersey","Passaic County",5,34,6913,3547,3366
050,34,031,"New Jersey","Passaic County",5,35,6619,3403,3216
050,34,031,"New Jersey","Passaic County",5,36,6691,3445,3246
050,34,031,"New Jersey","Passaic County",5,37,6668,3484,3184
050,34,031,"New Jersey","Passaic County",5,38,6707,3452,3255
050,34,031,"New Jersey","Passaic County",5,39,6439,3198,3241
050,34,031,"New Jersey","Passaic County",5,40,6441,3250,3191
050,34,031,"New Jersey","Passaic County",5,41,6523,3255,3268
050,34,031,"New Jersey","Passaic County",5,42,6521,3276,3245
050,34,031,"New Jersey","Passaic County",5,43,6426,3233,3193
050,34,031,"New Jersey","Passaic County",5,44,6238,3104,3134
050,34,031,"New Jersey","Passaic County",5,45,6242,3082,3160
050,34,031,"New Jersey","Passaic County",5,46,6149,3083,3066
050,34,031,"New Jersey","Passaic County",5,47,6048,3000,3048
050,34,031,"New Jersey","Passaic County",5,48,6084,3011,3073
050,34,031,"New Jersey","Passaic County",5,49,6154,3035,3119
050,34,031,"New Jersey","Passaic County",5,50,6154,3002,3152
050,34,031,"New Jersey","Passaic County",5,51,6443,3126,3317
050,34,031,"New Jersey","Passaic County",5,52,6765,3335,3430
050,34,031,"New Jersey","Passaic County",5,53,6713,3347,3366
050,34,031,"New Jersey","Passaic County",5,54,6486,3223,3263
050,34,031,"New Jersey","Passaic County",5,55,6519,3188,3331
050,34,031,"New Jersey","Passaic County",5,56,6543,3253,3290
050,34,031,"New Jersey","Passaic County",5,57,6707,3305,3402
050,34,031,"New Jersey","Passaic County",5,58,6721,3281,3440
050,34,031,"New Jersey","Passaic County",5,59,6761,3312,3449
050,34,031,"New Jersey","Passaic County",5,60,6584,3252,3332
050,34,031,"New Jersey","Passaic County",5,61,6579,3227,3352
050,34,031,"New Jersey","Passaic County",5,62,6394,3161,3233
050,34,031,"New Jersey","Passaic County",5,63,6338,3095,3243
050,34,031,"New Jersey","Passaic County",5,64,6126,2955,3171
050,34,031,"New Jersey","Passaic County",5,65,5995,2872,3123
050,34,031,"New Jersey","Passaic County",5,66,5661,2670,2991
050,34,031,"New Jersey","Passaic County",5,67,5358,2521,2837
050,34,031,"New Jersey","Passaic County",5,68,5163,2465,2698
050,34,031,"New Jersey","Passaic County",5,69,4999,2396,2603
050,34,031,"New Jersey","Passaic County",5,70,4729,2256,2473
050,34,031,"New Jersey","Passaic County",5,71,4395,2005,2390
050,34,031,"New Jersey","Passaic County",5,72,4256,1971,2285
050,34,031,"New Jersey","Passaic County",5,73,4075,1855,2220
050,34,031,"New Jersey","Passaic County",5,74,3837,1693,2144
050,34,031,"New Jersey","Passaic County",5,75,3755,1648,2107
050,34,031,"New Jersey","Passaic County",5,76,3870,1707,2163
050,34,031,"New Jersey","Passaic County",5,77,2950,1278,1672
050,34,031,"New Jersey","Passaic County",5,78,2689,1141,1548
050,34,031,"New Jersey","Passaic County",5,79,2527,1062,1465
050,34,031,"New Jersey","Passaic County",5,80,2595,1072,1523
050,34,031,"New Jersey","Passaic County",5,81,2230,904,1326
050,34,031,"New Jersey","Passaic County",5,82,1934,752,1182
050,34,031,"New Jersey","Passaic County",5,83,1825,721,1104
050,34,031,"New Jersey","Passaic County",5,84,1709,685,1024
050,34,031,"New Jersey","Passaic County",5,85,9930,3393,6537
050,34,033,"New Jersey","Salem County",1,0,618,314,304
050,34,033,"New Jersey","Salem County",1,1,665,340,325
050,34,033,"New Jersey","Salem County",1,2,718,345,373
050,34,033,"New Jersey","Salem County",1,3,728,377,351
050,34,033,"New Jersey","Salem County",1,4,736,375,361
050,34,033,"New Jersey","Salem County",1,5,753,382,371
050,34,033,"New Jersey","Salem County",1,6,780,396,384
050,34,033,"New Jersey","Salem County",1,7,775,389,386
050,34,033,"New Jersey","Salem County",1,8,809,387,422
050,34,033,"New Jersey","Salem County",1,9,800,411,389
050,34,033,"New Jersey","Salem County",1,10,827,415,412
050,34,033,"New Jersey","Salem County",1,11,830,425,405
050,34,033,"New Jersey","Salem County",1,12,910,483,427
050,34,033,"New Jersey","Salem County",1,13,851,425,426
050,34,033,"New Jersey","Salem County",1,14,805,401,404
050,34,033,"New Jersey","Salem County",1,15,852,438,414
050,34,033,"New Jersey","Salem County",1,16,846,423,423
050,34,033,"New Jersey","Salem County",1,17,803,400,403
050,34,033,"New Jersey","Salem County",1,18,732,394,338
050,34,033,"New Jersey","Salem County",1,19,610,327,283
050,34,033,"New Jersey","Salem County",1,20,656,342,314
050,34,033,"New Jersey","Salem County",1,21,723,363,360
050,34,033,"New Jersey","Salem County",1,22,735,378,357
050,34,033,"New Jersey","Salem County",1,23,759,391,368
050,34,033,"New Jersey","Salem County",1,24,794,394,400
050,34,033,"New Jersey","Salem County",1,25,803,400,403
050,34,033,"New Jersey","Salem County",1,26,772,404,368
050,34,033,"New Jersey","Salem County",1,27,791,406,385
050,34,033,"New Jersey","Salem County",1,28,837,440,397
050,34,033,"New Jersey","Salem County",1,29,772,373,399
050,34,033,"New Jersey","Salem County",1,30,735,360,375
050,34,033,"New Jersey","Salem County",1,31,732,360,372
050,34,033,"New Jersey","Salem County",1,32,724,357,367
050,34,033,"New Jersey","Salem County",1,33,722,354,368
050,34,033,"New Jersey","Salem County",1,34,739,376,363
050,34,033,"New Jersey","Salem County",1,35,762,380,382
050,34,033,"New Jersey","Salem County",1,36,788,377,411
050,34,033,"New Jersey","Salem County",1,37,782,397,385
050,34,033,"New Jersey","Salem County",1,38,809,428,381
050,34,033,"New Jersey","Salem County",1,39,847,440,407
050,34,033,"New Jersey","Salem County",1,40,804,394,410
050,34,033,"New Jersey","Salem County",1,41,759,367,392
050,34,033,"New Jersey","Salem County",1,42,767,385,382
050,34,033,"New Jersey","Salem County",1,43,763,405,358
050,34,033,"New Jersey","Salem County",1,44,742,386,356
050,34,033,"New Jersey","Salem County",1,45,715,362,353
050,34,033,"New Jersey","Salem County",1,46,743,366,377
050,34,033,"New Jersey","Salem County",1,47,730,347,383
050,34,033,"New Jersey","Salem County",1,48,872,424,448
050,34,033,"New Jersey","Salem County",1,49,918,457,461
050,34,033,"New Jersey","Salem County",1,50,875,431,444
050,34,033,"New Jersey","Salem County",1,51,832,411,421
050,34,033,"New Jersey","Salem County",1,52,856,429,427
050,34,033,"New Jersey","Salem County",1,53,890,450,440
050,34,033,"New Jersey","Salem County",1,54,947,468,479
050,34,033,"New Jersey","Salem County",1,55,978,477,501
050,34,033,"New Jersey","Salem County",1,56,998,478,520
050,34,033,"New Jersey","Salem County",1,57,978,476,502
050,34,033,"New Jersey","Salem County",1,58,1027,485,542
050,34,033,"New Jersey","Salem County",1,59,993,492,501
050,34,033,"New Jersey","Salem County",1,60,1007,495,512
050,34,033,"New Jersey","Salem County",1,61,993,496,497
050,34,033,"New Jersey","Salem County",1,62,968,480,488
050,34,033,"New Jersey","Salem County",1,63,943,451,492
050,34,033,"New Jersey","Salem County",1,64,878,413,465
050,34,033,"New Jersey","Salem County",1,65,858,407,451
050,34,033,"New Jersey","Salem County",1,66,818,386,432
050,34,033,"New Jersey","Salem County",1,67,791,400,391
050,34,033,"New Jersey","Salem County",1,68,744,375,369
050,34,033,"New Jersey","Salem County",1,69,686,349,337
050,34,033,"New Jersey","Salem County",1,70,734,369,365
050,34,033,"New Jersey","Salem County",1,71,710,351,359
050,34,033,"New Jersey","Salem County",1,72,687,330,357
050,34,033,"New Jersey","Salem County",1,73,670,311,359
050,34,033,"New Jersey","Salem County",1,74,481,222,259
050,34,033,"New Jersey","Salem County",1,75,472,206,266
050,34,033,"New Jersey","Salem County",1,76,473,219,254
050,34,033,"New Jersey","Salem County",1,77,450,202,248
050,34,033,"New Jersey","Salem County",1,78,381,182,199
050,34,033,"New Jersey","Salem County",1,79,314,135,179
050,34,033,"New Jersey","Salem County",1,80,304,123,181
050,34,033,"New Jersey","Salem County",1,81,304,140,164
050,34,033,"New Jersey","Salem County",1,82,296,117,179
050,34,033,"New Jersey","Salem County",1,83,233,93,140
050,34,033,"New Jersey","Salem County",1,84,214,85,129
050,34,033,"New Jersey","Salem County",1,85,1504,488,1016
050,34,033,"New Jersey","Salem County",2,0,631,329,302
050,34,033,"New Jersey","Salem County",2,1,658,335,323
050,34,033,"New Jersey","Salem County",2,2,712,347,365
050,34,033,"New Jersey","Salem County",2,3,726,368,358
050,34,033,"New Jersey","Salem County",2,4,741,379,362
050,34,033,"New Jersey","Salem County",2,5,758,384,374
050,34,033,"New Jersey","Salem County",2,6,778,395,383
050,34,033,"New Jersey","Salem County",2,7,778,391,387
050,34,033,"New Jersey","Salem County",2,8,807,393,414
050,34,033,"New Jersey","Salem County",2,9,809,408,401
050,34,033,"New Jersey","Salem County",2,10,822,415,407
050,34,033,"New Jersey","Salem County",2,11,832,423,409
050,34,033,"New Jersey","Salem County",2,12,899,473,426
050,34,033,"New Jersey","Salem County",2,13,867,443,424
050,34,033,"New Jersey","Salem County",2,14,820,410,410
050,34,033,"New Jersey","Salem County",2,15,842,429,413
050,34,033,"New Jersey","Salem County",2,16,851,429,422
050,34,033,"New Jersey","Salem County",2,17,816,407,409
050,34,033,"New Jersey","Salem County",2,18,720,383,337
050,34,033,"New Jersey","Salem County",2,19,611,326,285
050,34,033,"New Jersey","Salem County",2,20,665,349,316
050,34,033,"New Jersey","Salem County",2,21,714,362,352
050,34,033,"New Jersey","Salem County",2,22,737,376,361
050,34,033,"New Jersey","Salem County",2,23,761,393,368
050,34,033,"New Jersey","Salem County",2,24,788,394,394
050,34,033,"New Jersey","Salem County",2,25,798,398,400
050,34,033,"New Jersey","Salem County",2,26,779,401,378
050,34,033,"New Jersey","Salem County",2,27,788,408,380
050,34,033,"New Jersey","Salem County",2,28,828,431,397
050,34,033,"New Jersey","Salem County",2,29,789,389,400
050,34,033,"New Jersey","Salem County",2,30,753,369,384
050,34,033,"New Jersey","Salem County",2,31,734,362,372
050,34,033,"New Jersey","Salem County",2,32,730,360,370
050,34,033,"New Jersey","Salem County",2,33,724,356,368
050,34,033,"New Jersey","Salem County",2,34,738,374,364
050,34,033,"New Jersey","Salem County",2,35,766,383,383
050,34,033,"New Jersey","Salem County",2,36,778,374,404
050,34,033,"New Jersey","Salem County",2,37,783,392,391
050,34,033,"New Jersey","Salem County",2,38,810,423,387
050,34,033,"New Jersey","Salem County",2,39,837,436,401
050,34,033,"New Jersey","Salem County",2,40,819,404,415
050,34,033,"New Jersey","Salem County",2,41,770,371,399
050,34,033,"New Jersey","Salem County",2,42,762,381,381
050,34,033,"New Jersey","Salem County",2,43,774,406,368
050,34,033,"New Jersey","Salem County",2,44,744,389,355
050,34,033,"New Jersey","Salem County",2,45,728,370,358
050,34,033,"New Jersey","Salem County",2,46,730,361,369
050,34,033,"New Jersey","Salem County",2,47,733,355,378
050,34,033,"New Jersey","Salem County",2,48,840,408,432
050,34,033,"New Jersey","Salem County",2,49,908,449,459
050,34,033,"New Jersey","Salem County",2,50,885,437,448
050,34,033,"New Jersey","Salem County",2,51,839,417,422
050,34,033,"New Jersey","Salem County",2,52,850,423,427
050,34,033,"New Jersey","Salem County",2,53,878,444,434
050,34,033,"New Jersey","Salem County",2,54,925,460,465
050,34,033,"New Jersey","Salem County",2,55,967,475,492
050,34,033,"New Jersey","Salem County",2,56,990,476,514
050,34,033,"New Jersey","Salem County",2,57,982,476,506
050,34,033,"New Jersey","Salem County",2,58,1009,478,531
050,34,033,"New Jersey","Salem County",2,59,1005,491,514
050,34,033,"New Jersey","Salem County",2,60,998,491,507
050,34,033,"New Jersey","Salem County",2,61,988,488,500
050,34,033,"New Jersey","Salem County",2,62,969,483,486
050,34,033,"New Jersey","Salem County",2,63,955,461,494
050,34,033,"New Jersey","Salem County",2,64,886,420,466
050,34,033,"New Jersey","Salem County",2,65,862,408,454
050,34,033,"New Jersey","Salem County",2,66,823,385,438
050,34,033,"New Jersey","Salem County",2,67,797,398,399
050,34,033,"New Jersey","Salem County",2,68,748,379,369
050,34,033,"New Jersey","Salem County",2,69,698,354,344
050,34,033,"New Jersey","Salem County",2,70,710,356,354
050,34,033,"New Jersey","Salem County",2,71,707,347,360
050,34,033,"New Jersey","Salem County",2,72,677,328,349
050,34,033,"New Jersey","Salem County",2,73,697,327,370
050,34,033,"New Jersey","Salem County",2,74,485,223,262
050,34,033,"New Jersey","Salem County",2,75,470,206,264
050,34,033,"New Jersey","Salem County",2,76,464,212,252
050,34,033,"New Jersey","Salem County",2,77,455,206,249
050,34,033,"New Jersey","Salem County",2,78,383,182,201
050,34,033,"New Jersey","Salem County",2,79,322,145,177
050,34,033,"New Jersey","Salem County",2,80,303,123,180
050,34,033,"New Jersey","Salem County",2,81,297,133,164
050,34,033,"New Jersey","Salem County",2,82,300,123,177
050,34,033,"New Jersey","Salem County",2,83,238,95,143
050,34,033,"New Jersey","Salem County",2,84,216,86,130
050,34,033,"New Jersey","Salem County",2,85,1477,477,1000
050,34,033,"New Jersey","Salem County",3,0,690,379,311
050,34,033,"New Jersey","Salem County",3,1,653,327,326
050,34,033,"New Jersey","Salem County",3,2,688,358,330
050,34,033,"New Jersey","Salem County",3,3,735,363,372
050,34,033,"New Jersey","Salem County",3,4,744,384,360
050,34,033,"New Jersey","Salem County",3,5,754,374,380
050,34,033,"New Jersey","Salem County",3,6,806,415,391
050,34,033,"New Jersey","Salem County",3,7,801,394,407
050,34,033,"New Jersey","Salem County",3,8,808,398,410
050,34,033,"New Jersey","Salem County",3,9,807,391,416
050,34,033,"New Jersey","Salem County",3,10,824,419,405
050,34,033,"New Jersey","Salem County",3,11,823,409,414
050,34,033,"New Jersey","Salem County",3,12,857,438,419
050,34,033,"New Jersey","Salem County",3,13,901,471,430
050,34,033,"New Jersey","Salem County",3,14,852,436,416
050,34,033,"New Jersey","Salem County",3,15,834,410,424
050,34,033,"New Jersey","Salem County",3,16,847,433,414
050,34,033,"New Jersey","Salem County",3,17,854,443,411
050,34,033,"New Jersey","Salem County",3,18,712,378,334
050,34,033,"New Jersey","Salem County",3,19,608,328,280
050,34,033,"New Jersey","Salem County",3,20,676,367,309
050,34,033,"New Jersey","Salem County",3,21,706,363,343
050,34,033,"New Jersey","Salem County",3,22,751,391,360
050,34,033,"New Jersey","Salem County",3,23,764,391,373
050,34,033,"New Jersey","Salem County",3,24,739,375,364
050,34,033,"New Jersey","Salem County",3,25,780,379,401
050,34,033,"New Jersey","Salem County",3,26,805,411,394
050,34,033,"New Jersey","Salem County",3,27,784,405,379
050,34,033,"New Jersey","Salem County",3,28,796,401,395
050,34,033,"New Jersey","Salem County",3,29,832,428,404
050,34,033,"New Jersey","Salem County",3,30,807,393,414
050,34,033,"New Jersey","Salem County",3,31,787,384,403
050,34,033,"New Jersey","Salem County",3,32,773,381,392
050,34,033,"New Jersey","Salem County",3,33,723,368,355
050,34,033,"New Jersey","Salem County",3,34,726,356,370
050,34,033,"New Jersey","Salem County",3,35,753,383,370
050,34,033,"New Jersey","Salem County",3,36,788,388,400
050,34,033,"New Jersey","Salem County",3,37,784,383,401
050,34,033,"New Jersey","Salem County",3,38,810,407,403
050,34,033,"New Jersey","Salem County",3,39,825,435,390
050,34,033,"New Jersey","Salem County",3,40,854,446,408
050,34,033,"New Jersey","Salem County",3,41,833,415,418
050,34,033,"New Jersey","Salem County",3,42,773,369,404
050,34,033,"New Jersey","Salem County",3,43,750,378,372
050,34,033,"New Jersey","Salem County",3,44,789,407,382
050,34,033,"New Jersey","Salem County",3,45,746,390,356
050,34,033,"New Jersey","Salem County",3,46,743,379,364
050,34,033,"New Jersey","Salem County",3,47,730,362,368
050,34,033,"New Jersey","Salem County",3,48,752,369,383
050,34,033,"New Jersey","Salem County",3,49,832,396,436
050,34,033,"New Jersey","Salem County",3,50,901,454,447
050,34,033,"New Jersey","Salem County",3,51,893,431,462
050,34,033,"New Jersey","Salem County",3,52,835,421,414
050,34,033,"New Jersey","Salem County",3,53,845,427,418
050,34,033,"New Jersey","Salem County",3,54,852,434,418
050,34,033,"New Jersey","Salem County",3,55,912,460,452
050,34,033,"New Jersey","Salem County",3,56,947,462,485
050,34,033,"New Jersey","Salem County",3,57,967,464,503
050,34,033,"New Jersey","Salem County",3,58,966,467,499
050,34,033,"New Jersey","Salem County",3,59,997,464,533
050,34,033,"New Jersey","Salem County",3,60,989,486,503
050,34,033,"New Jersey","Salem County",3,61,979,477,502
050,34,033,"New Jersey","Salem County",3,62,971,481,490
050,34,033,"New Jersey","Salem County",3,63,946,458,488
050,34,033,"New Jersey","Salem County",3,64,941,460,481
050,34,033,"New Jersey","Salem County",3,65,877,410,467
050,34,033,"New Jersey","Salem County",3,66,823,387,436
050,34,033,"New Jersey","Salem County",3,67,792,373,419
050,34,033,"New Jersey","Salem County",3,68,772,382,390
050,34,033,"New Jersey","Salem County",3,69,728,366,362
050,34,033,"New Jersey","Salem County",3,70,689,352,337
050,34,033,"New Jersey","Salem County",3,71,683,340,343
050,34,033,"New Jersey","Salem County",3,72,672,321,351
050,34,033,"New Jersey","Salem County",3,73,646,306,340
050,34,033,"New Jersey","Salem County",3,74,669,313,356
050,34,033,"New Jersey","Salem County",3,75,469,213,256
050,34,033,"New Jersey","Salem County",3,76,447,193,254
050,34,033,"New Jersey","Salem County",3,77,437,198,239
050,34,033,"New Jersey","Salem County",3,78,439,198,241
050,34,033,"New Jersey","Salem County",3,79,361,169,192
050,34,033,"New Jersey","Salem County",3,80,299,133,166
050,34,033,"New Jersey","Salem County",3,81,279,112,167
050,34,033,"New Jersey","Salem County",3,82,277,113,164
050,34,033,"New Jersey","Salem County",3,83,266,112,154
050,34,033,"New Jersey","Salem County",3,84,228,86,142
050,34,033,"New Jersey","Salem County",3,85,1442,460,982
050,34,033,"New Jersey","Salem County",4,0,717,393,324
050,34,033,"New Jersey","Salem County",4,1,704,393,311
050,34,033,"New Jersey","Salem County",4,2,664,335,329
050,34,033,"New Jersey","Salem County",4,3,731,376,355
050,34,033,"New Jersey","Salem County",4,4,752,373,379
050,34,033,"New Jersey","Salem County",4,5,754,392,362
050,34,033,"New Jersey","Salem County",4,6,771,377,394
050,34,033,"New Jersey","Salem County",4,7,823,421,402
050,34,033,"New Jersey","Salem County",4,8,816,400,416
050,34,033,"New Jersey","Salem County",4,9,814,401,413
050,34,033,"New Jersey","Salem County",4,10,821,401,420
050,34,033,"New Jersey","Salem County",4,11,832,425,407
050,34,033,"New Jersey","Salem County",4,12,827,416,411
050,34,033,"New Jersey","Salem County",4,13,851,433,418
050,34,033,"New Jersey","Salem County",4,14,911,480,431
050,34,033,"New Jersey","Salem County",4,15,853,449,404
050,34,033,"New Jersey","Salem County",4,16,865,431,434
050,34,033,"New Jersey","Salem County",4,17,839,417,422
050,34,033,"New Jersey","Salem County",4,18,749,394,355
050,34,033,"New Jersey","Salem County",4,19,568,294,274
050,34,033,"New Jersey","Salem County",4,20,656,352,304
050,34,033,"New Jersey","Salem County",4,21,690,361,329
050,34,033,"New Jersey","Salem County",4,22,744,374,370
050,34,033,"New Jersey","Salem County",4,23,772,390,382
050,34,033,"New Jersey","Salem County",4,24,745,367,378
050,34,033,"New Jersey","Salem County",4,25,765,390,375
050,34,033,"New Jersey","Salem County",4,26,769,385,384
050,34,033,"New Jersey","Salem County",4,27,803,407,396
050,34,033,"New Jersey","Salem County",4,28,769,398,371
050,34,033,"New Jersey","Salem County",4,29,806,413,393
050,34,033,"New Jersey","Salem County",4,30,833,421,412
050,34,033,"New Jersey","Salem County",4,31,831,399,432
050,34,033,"New Jersey","Salem County",4,32,794,391,403
050,34,033,"New Jersey","Salem County",4,33,798,397,401
050,34,033,"New Jersey","Salem County",4,34,750,378,372
050,34,033,"New Jersey","Salem County",4,35,717,354,363
050,34,033,"New Jersey","Salem County",4,36,759,387,372
050,34,033,"New Jersey","Salem County",4,37,785,388,397
050,34,033,"New Jersey","Salem County",4,38,801,389,412
050,34,033,"New Jersey","Salem County",4,39,843,425,418
050,34,033,"New Jersey","Salem County",4,40,848,453,395
050,34,033,"New Jersey","Salem County",4,41,864,449,415
050,34,033,"New Jersey","Salem County",4,42,826,401,425
050,34,033,"New Jersey","Salem County",4,43,793,373,420
050,34,033,"New Jersey","Salem County",4,44,736,370,366
050,34,033,"New Jersey","Salem County",4,45,792,409,383
050,34,033,"New Jersey","Salem County",4,46,739,384,355
050,34,033,"New Jersey","Salem County",4,47,746,381,365
050,34,033,"New Jersey","Salem County",4,48,745,372,373
050,34,033,"New Jersey","Salem County",4,49,758,358,400
050,34,033,"New Jersey","Salem County",4,50,824,395,429
050,34,033,"New Jersey","Salem County",4,51,900,443,457
050,34,033,"New Jersey","Salem County",4,52,893,431,462
050,34,033,"New Jersey","Salem County",4,53,827,424,403
050,34,033,"New Jersey","Salem County",4,54,822,421,401
050,34,033,"New Jersey","Salem County",4,55,864,443,421
050,34,033,"New Jersey","Salem County",4,56,906,456,450
050,34,033,"New Jersey","Salem County",4,57,951,457,494
050,34,033,"New Jersey","Salem County",4,58,962,462,500
050,34,033,"New Jersey","Salem County",4,59,966,469,497
050,34,033,"New Jersey","Salem County",4,60,986,456,530
050,34,033,"New Jersey","Salem County",4,61,972,479,493
050,34,033,"New Jersey","Salem County",4,62,962,468,494
050,34,033,"New Jersey","Salem County",4,63,932,458,474
050,34,033,"New Jersey","Salem County",4,64,908,447,461
050,34,033,"New Jersey","Salem County",4,65,918,447,471
050,34,033,"New Jersey","Salem County",4,66,840,396,444
050,34,033,"New Jersey","Salem County",4,67,802,378,424
050,34,033,"New Jersey","Salem County",4,68,785,365,420
050,34,033,"New Jersey","Salem County",4,69,752,365,387
050,34,033,"New Jersey","Salem County",4,70,707,353,354
050,34,033,"New Jersey","Salem County",4,71,668,343,325
050,34,033,"New Jersey","Salem County",4,72,657,318,339
050,34,033,"New Jersey","Salem County",4,73,656,316,340
050,34,033,"New Jersey","Salem County",4,74,613,286,327
050,34,033,"New Jersey","Salem County",4,75,655,301,354
050,34,033,"New Jersey","Salem County",4,76,458,203,255
050,34,033,"New Jersey","Salem County",4,77,422,183,239
050,34,033,"New Jersey","Salem County",4,78,419,191,228
050,34,033,"New Jersey","Salem County",4,79,411,181,230
050,34,033,"New Jersey","Salem County",4,80,341,156,185
050,34,033,"New Jersey","Salem County",4,81,276,120,156
050,34,033,"New Jersey","Salem County",4,82,275,103,172
050,34,033,"New Jersey","Salem County",4,83,239,105,134
050,34,033,"New Jersey","Salem County",4,84,249,101,148
050,34,033,"New Jersey","Salem County",4,85,1400,448,952
050,34,033,"New Jersey","Salem County",5,0,712,390,322
050,34,033,"New Jersey","Salem County",5,1,728,408,320
050,34,033,"New Jersey","Salem County",5,2,735,405,330
050,34,033,"New Jersey","Salem County",5,3,686,341,345
050,34,033,"New Jersey","Salem County",5,4,736,378,358
050,34,033,"New Jersey","Salem County",5,5,764,374,390
050,34,033,"New Jersey","Salem County",5,6,769,394,375
050,34,033,"New Jersey","Salem County",5,7,783,390,393
050,34,033,"New Jersey","Salem County",5,8,858,433,425
050,34,033,"New Jersey","Salem County",5,9,807,393,414
050,34,033,"New Jersey","Salem County",5,10,806,392,414
050,34,033,"New Jersey","Salem County",5,11,843,425,418
050,34,033,"New Jersey","Salem County",5,12,835,418,417
050,34,033,"New Jersey","Salem County",5,13,833,418,415
050,34,033,"New Jersey","Salem County",5,14,864,437,427
050,34,033,"New Jersey","Salem County",5,15,915,486,429
050,34,033,"New Jersey","Salem County",5,16,851,453,398
050,34,033,"New Jersey","Salem County",5,17,848,418,430
050,34,033,"New Jersey","Salem County",5,18,724,373,351
050,34,033,"New Jersey","Salem County",5,19,600,313,287
050,34,033,"New Jersey","Salem County",5,20,628,325,303
050,34,033,"New Jersey","Salem County",5,21,683,361,322
050,34,033,"New Jersey","Salem County",5,22,742,380,362
050,34,033,"New Jersey","Salem County",5,23,774,389,385
050,34,033,"New Jersey","Salem County",5,24,755,382,373
050,34,033,"New Jersey","Salem County",5,25,758,375,383
050,34,033,"New Jersey","Salem County",5,26,732,374,358
050,34,033,"New Jersey","Salem County",5,27,775,385,390
050,34,033,"New Jersey","Salem County",5,28,794,388,406
050,34,033,"New Jersey","Salem County",5,29,791,403,388
050,34,033,"New Jersey","Salem County",5,30,806,414,392
050,34,033,"New Jersey","Salem County",5,31,831,408,423
050,34,033,"New Jersey","Salem County",5,32,851,414,437
050,34,033,"New Jersey","Salem County",5,33,842,409,433
050,34,033,"New Jersey","Salem County",5,34,810,396,414
050,34,033,"New Jersey","Salem County",5,35,788,385,403
050,34,033,"New Jersey","Salem County",5,36,723,362,361
050,34,033,"New Jersey","Salem County",5,37,789,414,375
050,34,033,"New Jersey","Salem County",5,38,794,396,398
050,34,033,"New Jersey","Salem County",5,39,822,402,420
050,34,033,"New Jersey","Salem County",5,40,853,428,425
050,34,033,"New Jersey","Salem County",5,41,834,435,399
050,34,033,"New Jersey","Salem County",5,42,872,451,421
050,34,033,"New Jersey","Salem County",5,43,849,416,433
050,34,033,"New Jersey","Salem County",5,44,803,385,418
050,34,033,"New Jersey","Salem County",5,45,757,381,376
050,34,033,"New Jersey","Salem County",5,46,791,404,387
050,34,033,"New Jersey","Salem County",5,47,723,373,350
050,34,033,"New Jersey","Salem County",5,48,773,388,385
050,34,033,"New Jersey","Salem County",5,49,756,378,378
050,34,033,"New Jersey","Salem County",5,50,764,357,407
050,34,033,"New Jersey","Salem County",5,51,815,394,421
050,34,033,"New Jersey","Salem County",5,52,911,451,460
050,34,033,"New Jersey","Salem County",5,53,893,428,465
050,34,033,"New Jersey","Salem County",5,54,811,416,395
050,34,033,"New Jersey","Salem County",5,55,835,428,407
050,34,033,"New Jersey","Salem County",5,56,875,451,424
050,34,033,"New Jersey","Salem County",5,57,903,459,444
050,34,033,"New Jersey","Salem County",5,58,934,451,483
050,34,033,"New Jersey","Salem County",5,59,950,454,496
050,34,033,"New Jersey","Salem County",5,60,968,472,496
050,34,033,"New Jersey","Salem County",5,61,970,444,526
050,34,033,"New Jersey","Salem County",5,62,938,459,479
050,34,033,"New Jersey","Salem County",5,63,944,446,498
050,34,033,"New Jersey","Salem County",5,64,905,448,457
050,34,033,"New Jersey","Salem County",5,65,886,434,452
050,34,033,"New Jersey","Salem County",5,66,897,439,458
050,34,033,"New Jersey","Salem County",5,67,819,393,426
050,34,033,"New Jersey","Salem County",5,68,796,371,425
050,34,033,"New Jersey","Salem County",5,69,753,348,405
050,34,033,"New Jersey","Salem County",5,70,743,361,382
050,34,033,"New Jersey","Salem County",5,71,688,343,345
050,34,033,"New Jersey","Salem County",5,72,629,314,315
050,34,033,"New Jersey","Salem County",5,73,635,310,325
050,34,033,"New Jersey","Salem County",5,74,615,291,324
050,34,033,"New Jersey","Salem County",5,75,593,273,320
050,34,033,"New Jersey","Salem County",5,76,626,286,340
050,34,033,"New Jersey","Salem County",5,77,434,192,242
050,34,033,"New Jersey","Salem County",5,78,409,179,230
050,34,033,"New Jersey","Salem County",5,79,391,176,215
050,34,033,"New Jersey","Salem County",5,80,388,163,225
050,34,033,"New Jersey","Salem County",5,81,315,142,173
050,34,033,"New Jersey","Salem County",5,82,264,111,153
050,34,033,"New Jersey","Salem County",5,83,240,98,142
050,34,033,"New Jersey","Salem County",5,84,219,91,128
050,34,033,"New Jersey","Salem County",5,85,1386,456,930
050,34,035,"New Jersey","Somerset County",1,0,3321,1716,1605
050,34,035,"New Jersey","Somerset County",1,1,3506,1827,1679
050,34,035,"New Jersey","Somerset County",1,2,3461,1766,1695
050,34,035,"New Jersey","Somerset County",1,3,3517,1831,1686
050,34,035,"New Jersey","Somerset County",1,4,3700,1909,1791
050,34,035,"New Jersey","Somerset County",1,5,3880,1997,1883
050,34,035,"New Jersey","Somerset County",1,6,3757,1905,1852
050,34,035,"New Jersey","Somerset County",1,7,3904,1961,1943
050,34,035,"New Jersey","Somerset County",1,8,3955,2066,1889
050,34,035,"New Jersey","Somerset County",1,9,4218,2157,2061
050,34,035,"New Jersey","Somerset County",1,10,4246,2170,2076
050,34,035,"New Jersey","Somerset County",1,11,4529,2306,2223
050,34,035,"New Jersey","Somerset County",1,12,4776,2446,2330
050,34,035,"New Jersey","Somerset County",1,13,4776,2507,2269
050,34,035,"New Jersey","Somerset County",1,14,4800,2539,2261
050,34,035,"New Jersey","Somerset County",1,15,4966,2646,2320
050,34,035,"New Jersey","Somerset County",1,16,5042,2630,2412
050,34,035,"New Jersey","Somerset County",1,17,4928,2515,2413
050,34,035,"New Jersey","Somerset County",1,18,4224,2164,2060
050,34,035,"New Jersey","Somerset County",1,19,3624,1860,1764
050,34,035,"New Jersey","Somerset County",1,20,3845,1957,1888
050,34,035,"New Jersey","Somerset County",1,21,3970,1990,1980
050,34,035,"New Jersey","Somerset County",1,22,4134,2091,2043
050,34,035,"New Jersey","Somerset County",1,23,3942,1979,1963
050,34,035,"New Jersey","Somerset County",1,24,3846,1940,1906
050,34,035,"New Jersey","Somerset County",1,25,3837,1901,1936
050,34,035,"New Jersey","Somerset County",1,26,3849,1948,1901
050,34,035,"New Jersey","Somerset County",1,27,3912,2026,1886
050,34,035,"New Jersey","Somerset County",1,28,3744,1906,1838
050,34,035,"New Jersey","Somerset County",1,29,3711,1881,1830
050,34,035,"New Jersey","Somerset County",1,30,3818,1944,1874
050,34,035,"New Jersey","Somerset County",1,31,3710,1874,1836
050,34,035,"New Jersey","Somerset County",1,32,3883,1947,1936
050,34,035,"New Jersey","Somerset County",1,33,3926,1952,1974
050,34,035,"New Jersey","Somerset County",1,34,4048,2001,2047
050,34,035,"New Jersey","Somerset County",1,35,4217,2114,2103
050,34,035,"New Jersey","Somerset County",1,36,4307,2140,2167
050,34,035,"New Jersey","Somerset County",1,37,4313,2112,2201
050,34,035,"New Jersey","Somerset County",1,38,4438,2181,2257
050,34,035,"New Jersey","Somerset County",1,39,4525,2208,2317
050,34,035,"New Jersey","Somerset County",1,40,4643,2292,2351
050,34,035,"New Jersey","Somerset County",1,41,4642,2234,2408
050,34,035,"New Jersey","Somerset County",1,42,4725,2323,2402
050,34,035,"New Jersey","Somerset County",1,43,4670,2296,2374
050,34,035,"New Jersey","Somerset County",1,44,4655,2320,2335
050,34,035,"New Jersey","Somerset County",1,45,4637,2345,2292
050,34,035,"New Jersey","Somerset County",1,46,4705,2369,2336
050,34,035,"New Jersey","Somerset County",1,47,4770,2359,2411
050,34,035,"New Jersey","Somerset County",1,48,5047,2512,2535
050,34,035,"New Jersey","Somerset County",1,49,5406,2699,2707
050,34,035,"New Jersey","Somerset County",1,50,5313,2628,2685
050,34,035,"New Jersey","Somerset County",1,51,5471,2742,2729
050,34,035,"New Jersey","Somerset County",1,52,5254,2613,2641
050,34,035,"New Jersey","Somerset County",1,53,5386,2615,2771
050,34,035,"New Jersey","Somerset County",1,54,5511,2686,2825
050,34,035,"New Jersey","Somerset County",1,55,5682,2777,2905
050,34,035,"New Jersey","Somerset County",1,56,5790,2849,2941
050,34,035,"New Jersey","Somerset County",1,57,5642,2821,2821
050,34,035,"New Jersey","Somerset County",1,58,5548,2799,2749
050,34,035,"New Jersey","Somerset County",1,59,5419,2668,2751
050,34,035,"New Jersey","Somerset County",1,60,5202,2583,2619
050,34,035,"New Jersey","Somerset County",1,61,5088,2515,2573
050,34,035,"New Jersey","Somerset County",1,62,4845,2390,2455
050,34,035,"New Jersey","Somerset County",1,63,4672,2326,2346
050,34,035,"New Jersey","Somerset County",1,64,4406,2164,2242
050,34,035,"New Jersey","Somerset County",1,65,4077,2018,2059
050,34,035,"New Jersey","Somerset County",1,66,3824,1923,1901
050,34,035,"New Jersey","Somerset County",1,67,3566,1737,1829
050,34,035,"New Jersey","Somerset County",1,68,3350,1580,1770
050,34,035,"New Jersey","Somerset County",1,69,3198,1508,1690
050,34,035,"New Jersey","Somerset County",1,70,2952,1378,1574
050,34,035,"New Jersey","Somerset County",1,71,2851,1315,1536
050,34,035,"New Jersey","Somerset County",1,72,2911,1319,1592
050,34,035,"New Jersey","Somerset County",1,73,2860,1315,1545
050,34,035,"New Jersey","Somerset County",1,74,2073,954,1119
050,34,035,"New Jersey","Somerset County",1,75,2017,889,1128
050,34,035,"New Jersey","Somerset County",1,76,2093,894,1199
050,34,035,"New Jersey","Somerset County",1,77,2154,919,1235
050,34,035,"New Jersey","Somerset County",1,78,1817,789,1028
050,34,035,"New Jersey","Somerset County",1,79,1556,668,888
050,34,035,"New Jersey","Somerset County",1,80,1444,605,839
050,34,035,"New Jersey","Somerset County",1,81,1362,579,783
050,34,035,"New Jersey","Somerset County",1,82,1276,541,735
050,34,035,"New Jersey","Somerset County",1,83,1183,463,720
050,34,035,"New Jersey","Somerset County",1,84,1107,442,665
050,34,035,"New Jersey","Somerset County",1,85,7448,2424,5024
050,34,035,"New Jersey","Somerset County",2,0,3286,1670,1616
050,34,035,"New Jersey","Somerset County",2,1,3470,1806,1664
050,34,035,"New Jersey","Somerset County",2,2,3477,1782,1695
050,34,035,"New Jersey","Somerset County",2,3,3517,1821,1696
050,34,035,"New Jersey","Somerset County",2,4,3683,1903,1780
050,34,035,"New Jersey","Somerset County",2,5,3849,1980,1869
050,34,035,"New Jersey","Somerset County",2,6,3807,1936,1871
050,34,035,"New Jersey","Somerset County",2,7,3874,1953,1921
050,34,035,"New Jersey","Somerset County",2,8,3940,2036,1904
050,34,035,"New Jersey","Somerset County",2,9,4160,2140,2020
050,34,035,"New Jersey","Somerset County",2,10,4252,2174,2078
050,34,035,"New Jersey","Somerset County",2,11,4456,2273,2183
050,34,035,"New Jersey","Somerset County",2,12,4744,2426,2318
050,34,035,"New Jersey","Somerset County",2,13,4781,2501,2280
050,34,035,"New Jersey","Somerset County",2,14,4805,2534,2271
050,34,035,"New Jersey","Somerset County",2,15,4931,2621,2310
050,34,035,"New Jersey","Somerset County",2,16,5026,2629,2397
050,34,035,"New Jersey","Somerset County",2,17,4953,2536,2417
050,34,035,"New Jersey","Somerset County",2,18,4193,2160,2033
050,34,035,"New Jersey","Somerset County",2,19,3616,1852,1764
050,34,035,"New Jersey","Somerset County",2,20,3881,1970,1911
050,34,035,"New Jersey","Somerset County",2,21,3967,1999,1968
050,34,035,"New Jersey","Somerset County",2,22,4076,2053,2023
050,34,035,"New Jersey","Somerset County",2,23,3972,2002,1970
050,34,035,"New Jersey","Somerset County",2,24,3849,1944,1905
050,34,035,"New Jersey","Somerset County",2,25,3832,1912,1920
050,34,035,"New Jersey","Somerset County",2,26,3853,1941,1912
050,34,035,"New Jersey","Somerset County",2,27,3881,1996,1885
050,34,035,"New Jersey","Somerset County",2,28,3790,1933,1857
050,34,035,"New Jersey","Somerset County",2,29,3733,1889,1844
050,34,035,"New Jersey","Somerset County",2,30,3818,1937,1881
050,34,035,"New Jersey","Somerset County",2,31,3749,1899,1850
050,34,035,"New Jersey","Somerset County",2,32,3862,1939,1923
050,34,035,"New Jersey","Somerset County",2,33,3935,1964,1971
050,34,035,"New Jersey","Somerset County",2,34,4030,1995,2035
050,34,035,"New Jersey","Somerset County",2,35,4211,2097,2114
050,34,035,"New Jersey","Somerset County",2,36,4283,2128,2155
050,34,035,"New Jersey","Somerset County",2,37,4335,2131,2204
050,34,035,"New Jersey","Somerset County",2,38,4444,2185,2259
050,34,035,"New Jersey","Somerset County",2,39,4505,2204,2301
050,34,035,"New Jersey","Somerset County",2,40,4650,2291,2359
050,34,035,"New Jersey","Somerset County",2,41,4657,2252,2405
050,34,035,"New Jersey","Somerset County",2,42,4692,2295,2397
050,34,035,"New Jersey","Somerset County",2,43,4714,2319,2395
050,34,035,"New Jersey","Somerset County",2,44,4631,2306,2325
050,34,035,"New Jersey","Somerset County",2,45,4665,2355,2310
050,34,035,"New Jersey","Somerset County",2,46,4682,2357,2325
050,34,035,"New Jersey","Somerset County",2,47,4745,2360,2385
050,34,035,"New Jersey","Somerset County",2,48,4990,2485,2505
050,34,035,"New Jersey","Somerset County",2,49,5319,2659,2660
050,34,035,"New Jersey","Somerset County",2,50,5340,2654,2686
050,34,035,"New Jersey","Somerset County",2,51,5401,2701,2700
050,34,035,"New Jersey","Somerset County",2,52,5290,2634,2656
050,34,035,"New Jersey","Somerset County",2,53,5328,2604,2724
050,34,035,"New Jersey","Somerset County",2,54,5444,2652,2792
050,34,035,"New Jersey","Somerset County",2,55,5607,2741,2866
050,34,035,"New Jersey","Somerset County",2,56,5745,2821,2924
050,34,035,"New Jersey","Somerset County",2,57,5666,2822,2844
050,34,035,"New Jersey","Somerset County",2,58,5535,2787,2748
050,34,035,"New Jersey","Somerset County",2,59,5434,2693,2741
050,34,035,"New Jersey","Somerset County",2,60,5230,2589,2641
050,34,035,"New Jersey","Somerset County",2,61,5065,2503,2562
050,34,035,"New Jersey","Somerset County",2,62,4864,2400,2464
050,34,035,"New Jersey","Somerset County",2,63,4717,2340,2377
050,34,035,"New Jersey","Somerset County",2,64,4412,2171,2241
050,34,035,"New Jersey","Somerset County",2,65,4111,2030,2081
050,34,035,"New Jersey","Somerset County",2,66,3846,1925,1921
050,34,035,"New Jersey","Somerset County",2,67,3577,1756,1821
050,34,035,"New Jersey","Somerset County",2,68,3356,1588,1768
050,34,035,"New Jersey","Somerset County",2,69,3216,1513,1703
050,34,035,"New Jersey","Somerset County",2,70,2980,1395,1585
050,34,035,"New Jersey","Somerset County",2,71,2854,1314,1540
050,34,035,"New Jersey","Somerset County",2,72,2838,1288,1550
050,34,035,"New Jersey","Somerset County",2,73,2953,1353,1600
050,34,035,"New Jersey","Somerset County",2,74,2130,978,1152
050,34,035,"New Jersey","Somerset County",2,75,2014,895,1119
050,34,035,"New Jersey","Somerset County",2,76,2040,881,1159
050,34,035,"New Jersey","Somerset County",2,77,2146,910,1236
050,34,035,"New Jersey","Somerset County",2,78,1847,791,1056
050,34,035,"New Jersey","Somerset County",2,79,1579,676,903
050,34,035,"New Jersey","Somerset County",2,80,1447,608,839
050,34,035,"New Jersey","Somerset County",2,81,1347,570,777
050,34,035,"New Jersey","Somerset County",2,82,1273,532,741
050,34,035,"New Jersey","Somerset County",2,83,1185,473,712
050,34,035,"New Jersey","Somerset County",2,84,1091,437,654
050,34,035,"New Jersey","Somerset County",2,85,7275,2387,4888
050,34,035,"New Jersey","Somerset County",3,0,3039,1556,1483
050,34,035,"New Jersey","Somerset County",3,1,3336,1686,1650
050,34,035,"New Jersey","Somerset County",3,2,3485,1806,1679
050,34,035,"New Jersey","Somerset County",3,3,3533,1829,1704
050,34,035,"New Jersey","Somerset County",3,4,3628,1908,1720
050,34,035,"New Jersey","Somerset County",3,5,3799,1964,1835
050,34,035,"New Jersey","Somerset County",3,6,3920,1984,1936
050,34,035,"New Jersey","Somerset County",3,7,3859,1950,1909
050,34,035,"New Jersey","Somerset County",3,8,3952,2005,1947
050,34,035,"New Jersey","Somerset County",3,9,4002,2078,1924
050,34,035,"New Jersey","Somerset County",3,10,4218,2169,2049
050,34,035,"New Jersey","Somerset County",3,11,4302,2221,2081
050,34,035,"New Jersey","Somerset County",3,12,4528,2304,2224
050,34,035,"New Jersey","Somerset County",3,13,4820,2462,2358
050,34,035,"New Jersey","Somerset County",3,14,4828,2538,2290
050,34,035,"New Jersey","Somerset County",3,15,4809,2523,2286
050,34,035,"New Jersey","Somerset County",3,16,4969,2612,2357
050,34,035,"New Jersey","Somerset County",3,17,5040,2629,2411
050,34,035,"New Jersey","Somerset County",3,18,4291,2237,2054
050,34,035,"New Jersey","Somerset County",3,19,3531,1830,1701
050,34,035,"New Jersey","Somerset County",3,20,3856,1932,1924
050,34,035,"New Jersey","Somerset County",3,21,4033,2044,1989
050,34,035,"New Jersey","Somerset County",3,22,4144,2077,2067
050,34,035,"New Jersey","Somerset County",3,23,4073,2016,2057
050,34,035,"New Jersey","Somerset County",3,24,4013,1998,2015
050,34,035,"New Jersey","Somerset County",3,25,3876,1977,1899
050,34,035,"New Jersey","Somerset County",3,26,3885,1924,1961
050,34,035,"New Jersey","Somerset County",3,27,3998,1982,2016
050,34,035,"New Jersey","Somerset County",3,28,3957,2007,1950
050,34,035,"New Jersey","Somerset County",3,29,3927,1998,1929
050,34,035,"New Jersey","Somerset County",3,30,3870,1971,1899
050,34,035,"New Jersey","Somerset County",3,31,3914,1965,1949
050,34,035,"New Jersey","Somerset County",3,32,3900,1954,1946
050,34,035,"New Jersey","Somerset County",3,33,3997,2037,1960
050,34,035,"New Jersey","Somerset County",3,34,4141,2073,2068
050,34,035,"New Jersey","Somerset County",3,35,4186,2083,2103
050,34,035,"New Jersey","Somerset County",3,36,4352,2167,2185
050,34,035,"New Jersey","Somerset County",3,37,4353,2160,2193
050,34,035,"New Jersey","Somerset County",3,38,4484,2233,2251
050,34,035,"New Jersey","Somerset County",3,39,4542,2218,2324
050,34,035,"New Jersey","Somerset County",3,40,4563,2238,2325
050,34,035,"New Jersey","Somerset County",3,41,4772,2359,2413
050,34,035,"New Jersey","Somerset County",3,42,4745,2324,2421
050,34,035,"New Jersey","Somerset County",3,43,4695,2305,2390
050,34,035,"New Jersey","Somerset County",3,44,4810,2383,2427
050,34,035,"New Jersey","Somerset County",3,45,4679,2344,2335
050,34,035,"New Jersey","Somerset County",3,46,4700,2382,2318
050,34,035,"New Jersey","Somerset County",3,47,4728,2369,2359
050,34,035,"New Jersey","Somerset County",3,48,4776,2376,2400
050,34,035,"New Jersey","Somerset County",3,49,4969,2485,2484
050,34,035,"New Jersey","Somerset County",3,50,5288,2649,2639
050,34,035,"New Jersey","Somerset County",3,51,5305,2631,2674
050,34,035,"New Jersey","Somerset County",3,52,5314,2654,2660
050,34,035,"New Jersey","Somerset County",3,53,5236,2605,2631
050,34,035,"New Jersey","Somerset County",3,54,5287,2588,2699
050,34,035,"New Jersey","Somerset County",3,55,5357,2610,2747
050,34,035,"New Jersey","Somerset County",3,56,5512,2701,2811
050,34,035,"New Jersey","Somerset County",3,57,5645,2757,2888
050,34,035,"New Jersey","Somerset County",3,58,5579,2785,2794
050,34,035,"New Jersey","Somerset County",3,59,5428,2742,2686
050,34,035,"New Jersey","Somerset County",3,60,5323,2644,2679
050,34,035,"New Jersey","Somerset County",3,61,5086,2504,2582
050,34,035,"New Jersey","Somerset County",3,62,4947,2420,2527
050,34,035,"New Jersey","Somerset County",3,63,4728,2340,2388
050,34,035,"New Jersey","Somerset County",3,64,4560,2261,2299
050,34,035,"New Jersey","Somerset County",3,65,4277,2115,2162
050,34,035,"New Jersey","Somerset County",3,66,3999,1962,2037
050,34,035,"New Jersey","Somerset County",3,67,3767,1880,1887
050,34,035,"New Jersey","Somerset County",3,68,3493,1705,1788
050,34,035,"New Jersey","Somerset County",3,69,3263,1533,1730
050,34,035,"New Jersey","Somerset County",3,70,3146,1463,1683
050,34,035,"New Jersey","Somerset County",3,71,2901,1351,1550
050,34,035,"New Jersey","Somerset County",3,72,2778,1269,1509
050,34,035,"New Jersey","Somerset County",3,73,2774,1253,1521
050,34,035,"New Jersey","Somerset County",3,74,2884,1311,1573
050,34,035,"New Jersey","Somerset County",3,75,2093,950,1143
050,34,035,"New Jersey","Somerset County",3,76,1993,895,1098
050,34,035,"New Jersey","Somerset County",3,77,1998,861,1137
050,34,035,"New Jersey","Somerset County",3,78,2074,858,1216
050,34,035,"New Jersey","Somerset County",3,79,1802,778,1024
050,34,035,"New Jersey","Somerset County",3,80,1507,644,863
050,34,035,"New Jersey","Somerset County",3,81,1399,591,808
050,34,035,"New Jersey","Somerset County",3,82,1289,530,759
050,34,035,"New Jersey","Somerset County",3,83,1217,509,708
050,34,035,"New Jersey","Somerset County",3,84,1086,427,659
050,34,035,"New Jersey","Somerset County",3,85,7336,2427,4909
050,34,035,"New Jersey","Somerset County",4,0,3220,1611,1609
050,34,035,"New Jersey","Somerset County",4,1,3138,1555,1583
050,34,035,"New Jersey","Somerset County",4,2,3384,1713,1671
050,34,035,"New Jersey","Somerset County",4,3,3530,1826,1704
050,34,035,"New Jersey","Somerset County",4,4,3634,1871,1763
050,34,035,"New Jersey","Somerset County",4,5,3755,1984,1771
050,34,035,"New Jersey","Somerset County",4,6,3868,2009,1859
050,34,035,"New Jersey","Somerset County",4,7,4026,2036,1990
050,34,035,"New Jersey","Somerset County",4,8,3908,1969,1939
050,34,035,"New Jersey","Somerset County",4,9,3975,2014,1961
050,34,035,"New Jersey","Somerset County",4,10,4050,2102,1948
050,34,035,"New Jersey","Somerset County",4,11,4263,2186,2077
050,34,035,"New Jersey","Somerset County",4,12,4337,2222,2115
050,34,035,"New Jersey","Somerset County",4,13,4609,2355,2254
050,34,035,"New Jersey","Somerset County",4,14,4833,2467,2366
050,34,035,"New Jersey","Somerset County",4,15,4870,2540,2330
050,34,035,"New Jersey","Somerset County",4,16,4869,2522,2347
050,34,035,"New Jersey","Somerset County",4,17,5009,2633,2376
050,34,035,"New Jersey","Somerset County",4,18,4349,2296,2053
050,34,035,"New Jersey","Somerset County",4,19,3500,1836,1664
050,34,035,"New Jersey","Somerset County",4,20,3672,1851,1821
050,34,035,"New Jersey","Somerset County",4,21,3965,1968,1997
050,34,035,"New Jersey","Somerset County",4,22,4085,2036,2049
050,34,035,"New Jersey","Somerset County",4,23,4073,2042,2031
050,34,035,"New Jersey","Somerset County",4,24,3940,1943,1997
050,34,035,"New Jersey","Somerset County",4,25,3957,1969,1988
050,34,035,"New Jersey","Somerset County",4,26,3790,1909,1881
050,34,035,"New Jersey","Somerset County",4,27,3812,1890,1922
050,34,035,"New Jersey","Somerset County",4,28,3890,1959,1931
050,34,035,"New Jersey","Somerset County",4,29,4004,2082,1922
050,34,035,"New Jersey","Somerset County",4,30,3962,1991,1971
050,34,035,"New Jersey","Somerset County",4,31,3990,2026,1964
050,34,035,"New Jersey","Somerset County",4,32,3998,1998,2000
050,34,035,"New Jersey","Somerset County",4,33,4112,2059,2053
050,34,035,"New Jersey","Somerset County",4,34,4098,2050,2048
050,34,035,"New Jersey","Somerset County",4,35,4300,2149,2151
050,34,035,"New Jersey","Somerset County",4,36,4379,2187,2192
050,34,035,"New Jersey","Somerset County",4,37,4553,2267,2286
050,34,035,"New Jersey","Somerset County",4,38,4409,2215,2194
050,34,035,"New Jersey","Somerset County",4,39,4632,2324,2308
050,34,035,"New Jersey","Somerset County",4,40,4603,2226,2377
050,34,035,"New Jersey","Somerset County",4,41,4665,2277,2388
050,34,035,"New Jersey","Somerset County",4,42,4866,2433,2433
050,34,035,"New Jersey","Somerset County",4,43,4791,2359,2432
050,34,035,"New Jersey","Somerset County",4,44,4741,2365,2376
050,34,035,"New Jersey","Somerset County",4,45,4858,2419,2439
050,34,035,"New Jersey","Somerset County",4,46,4707,2324,2383
050,34,035,"New Jersey","Somerset County",4,47,4725,2406,2319
050,34,035,"New Jersey","Somerset County",4,48,4725,2373,2352
050,34,035,"New Jersey","Somerset County",4,49,4833,2438,2395
050,34,035,"New Jersey","Somerset County",4,50,4962,2493,2469
050,34,035,"New Jersey","Somerset County",4,51,5255,2613,2642
050,34,035,"New Jersey","Somerset County",4,52,5261,2607,2654
050,34,035,"New Jersey","Somerset County",4,53,5251,2616,2635
050,34,035,"New Jersey","Somerset County",4,54,5148,2567,2581
050,34,035,"New Jersey","Somerset County",4,55,5165,2522,2643
050,34,035,"New Jersey","Somerset County",4,56,5248,2555,2693
050,34,035,"New Jersey","Somerset County",4,57,5421,2655,2766
050,34,035,"New Jersey","Somerset County",4,58,5489,2686,2803
050,34,035,"New Jersey","Somerset County",4,59,5487,2731,2756
050,34,035,"New Jersey","Somerset County",4,60,5308,2675,2633
050,34,035,"New Jersey","Somerset County",4,61,5162,2567,2595
050,34,035,"New Jersey","Somerset County",4,62,4939,2437,2502
050,34,035,"New Jersey","Somerset County",4,63,4785,2320,2465
050,34,035,"New Jersey","Somerset County",4,64,4586,2271,2315
050,34,035,"New Jersey","Somerset County",4,65,4428,2197,2231
050,34,035,"New Jersey","Somerset County",4,66,4131,2026,2105
050,34,035,"New Jersey","Somerset County",4,67,3887,1901,1986
050,34,035,"New Jersey","Somerset County",4,68,3655,1811,1844
050,34,035,"New Jersey","Somerset County",4,69,3435,1639,1796
050,34,035,"New Jersey","Somerset County",4,70,3181,1490,1691
050,34,035,"New Jersey","Somerset County",4,71,3088,1431,1657
050,34,035,"New Jersey","Somerset County",4,72,2866,1331,1535
050,34,035,"New Jersey","Somerset County",4,73,2710,1228,1482
050,34,035,"New Jersey","Somerset County",4,74,2710,1218,1492
050,34,035,"New Jersey","Somerset County",4,75,2803,1259,1544
050,34,035,"New Jersey","Somerset County",4,76,2055,941,1114
050,34,035,"New Jersey","Somerset County",4,77,1984,878,1106
050,34,035,"New Jersey","Somerset County",4,78,1928,813,1115
050,34,035,"New Jersey","Somerset County",4,79,2014,837,1177
050,34,035,"New Jersey","Somerset County",4,80,1741,747,994
050,34,035,"New Jersey","Somerset County",4,81,1450,616,834
050,34,035,"New Jersey","Somerset County",4,82,1348,558,790
050,34,035,"New Jersey","Somerset County",4,83,1244,493,751
050,34,035,"New Jersey","Somerset County",4,84,1134,475,659
050,34,035,"New Jersey","Somerset County",4,85,7526,2522,5004
050,34,035,"New Jersey","Somerset County",5,0,3204,1603,1601
050,34,035,"New Jersey","Somerset County",5,1,3368,1677,1691
050,34,035,"New Jersey","Somerset County",5,2,3208,1586,1622
050,34,035,"New Jersey","Somerset County",5,3,3485,1766,1719
050,34,035,"New Jersey","Somerset County",5,4,3630,1896,1734
050,34,035,"New Jersey","Somerset County",5,5,3745,1938,1807
050,34,035,"New Jersey","Somerset County",5,6,3849,2024,1825
050,34,035,"New Jersey","Somerset County",5,7,4013,2074,1939
050,34,035,"New Jersey","Somerset County",5,8,4086,2049,2037
050,34,035,"New Jersey","Somerset County",5,9,3957,1991,1966
050,34,035,"New Jersey","Somerset County",5,10,4042,2064,1978
050,34,035,"New Jersey","Somerset County",5,11,4122,2133,1989
050,34,035,"New Jersey","Somerset County",5,12,4337,2205,2132
050,34,035,"New Jersey","Somerset County",5,13,4419,2267,2152
050,34,035,"New Jersey","Somerset County",5,14,4632,2376,2256
050,34,035,"New Jersey","Somerset County",5,15,4890,2501,2389
050,34,035,"New Jersey","Somerset County",5,16,4938,2537,2401
050,34,035,"New Jersey","Somerset County",5,17,4938,2551,2387
050,34,035,"New Jersey","Somerset County",5,18,4303,2299,2004
050,34,035,"New Jersey","Somerset County",5,19,3615,1915,1700
050,34,035,"New Jersey","Somerset County",5,20,3708,1909,1799
050,34,035,"New Jersey","Somerset County",5,21,3855,1917,1938
050,34,035,"New Jersey","Somerset County",5,22,4127,2008,2119
050,34,035,"New Jersey","Somerset County",5,23,4020,2018,2002
050,34,035,"New Jersey","Somerset County",5,24,4086,2039,2047
050,34,035,"New Jersey","Somerset County",5,25,3849,1923,1926
050,34,035,"New Jersey","Somerset County",5,26,3960,1950,2010
050,34,035,"New Jersey","Somerset County",5,27,3799,1910,1889
050,34,035,"New Jersey","Somerset County",5,28,3827,1881,1946
050,34,035,"New Jersey","Somerset County",5,29,3951,1968,1983
050,34,035,"New Jersey","Somerset County",5,30,4105,2088,2017
050,34,035,"New Jersey","Somerset County",5,31,4003,1991,2012
050,34,035,"New Jersey","Somerset County",5,32,4024,2014,2010
050,34,035,"New Jersey","Somerset County",5,33,4190,2094,2096
050,34,035,"New Jersey","Somerset County",5,34,4250,2138,2112
050,34,035,"New Jersey","Somerset County",5,35,4220,2118,2102
050,34,035,"New Jersey","Somerset County",5,36,4484,2243,2241
050,34,035,"New Jersey","Somerset County",5,37,4516,2286,2230
050,34,035,"New Jersey","Somerset County",5,38,4737,2386,2351
050,34,035,"New Jersey","Somerset County",5,39,4493,2252,2241
050,34,035,"New Jersey","Somerset County",5,40,4676,2333,2343
050,34,035,"New Jersey","Somerset County",5,41,4656,2258,2398
050,34,035,"New Jersey","Somerset County",5,42,4722,2322,2400
050,34,035,"New Jersey","Somerset County",5,43,4938,2484,2454
050,34,035,"New Jersey","Somerset County",5,44,4822,2376,2446
050,34,035,"New Jersey","Somerset County",5,45,4828,2409,2419
050,34,035,"New Jersey","Somerset County",5,46,4917,2451,2466
050,34,035,"New Jersey","Somerset County",5,47,4705,2316,2389
050,34,035,"New Jersey","Somerset County",5,48,4753,2401,2352
050,34,035,"New Jersey","Somerset County",5,49,4756,2402,2354
050,34,035,"New Jersey","Somerset County",5,50,4826,2423,2403
050,34,035,"New Jersey","Somerset County",5,51,4972,2501,2471
050,34,035,"New Jersey","Somerset County",5,52,5198,2585,2613
050,34,035,"New Jersey","Somerset County",5,53,5180,2570,2610
050,34,035,"New Jersey","Somerset County",5,54,5192,2593,2599
050,34,035,"New Jersey","Somerset County",5,55,5080,2522,2558
050,34,035,"New Jersey","Somerset County",5,56,5061,2490,2571
050,34,035,"New Jersey","Somerset County",5,57,5222,2534,2688
050,34,035,"New Jersey","Somerset County",5,58,5346,2625,2721
050,34,035,"New Jersey","Somerset County",5,59,5400,2636,2764
050,34,035,"New Jersey","Somerset County",5,60,5343,2657,2686
050,34,035,"New Jersey","Somerset County",5,61,5153,2594,2559
050,34,035,"New Jersey","Somerset County",5,62,5026,2514,2512
050,34,035,"New Jersey","Somerset County",5,63,4847,2397,2450
050,34,035,"New Jersey","Somerset County",5,64,4680,2267,2413
050,34,035,"New Jersey","Somerset County",5,65,4421,2176,2245
050,34,035,"New Jersey","Somerset County",5,66,4332,2132,2200
050,34,035,"New Jersey","Somerset County",5,67,4033,1979,2054
050,34,035,"New Jersey","Somerset County",5,68,3788,1833,1955
050,34,035,"New Jersey","Somerset County",5,69,3562,1749,1813
050,34,035,"New Jersey","Somerset County",5,70,3353,1602,1751
050,34,035,"New Jersey","Somerset County",5,71,3107,1453,1654
050,34,035,"New Jersey","Somerset County",5,72,3059,1415,1644
050,34,035,"New Jersey","Somerset County",5,73,2791,1294,1497
050,34,035,"New Jersey","Somerset County",5,74,2681,1214,1467
050,34,035,"New Jersey","Somerset County",5,75,2665,1189,1476
050,34,035,"New Jersey","Somerset County",5,76,2748,1231,1517
050,34,035,"New Jersey","Somerset County",5,77,2005,904,1101
050,34,035,"New Jersey","Somerset County",5,78,1931,845,1086
050,34,035,"New Jersey","Somerset County",5,79,1889,800,1089
050,34,035,"New Jersey","Somerset County",5,80,1965,808,1157
050,34,035,"New Jersey","Somerset County",5,81,1681,721,960
050,34,035,"New Jersey","Somerset County",5,82,1413,580,833
050,34,035,"New Jersey","Somerset County",5,83,1311,522,789
050,34,035,"New Jersey","Somerset County",5,84,1174,476,698
050,34,035,"New Jersey","Somerset County",5,85,7649,2613,5036
050,34,037,"New Jersey","Sussex County",1,0,1236,630,606
050,34,037,"New Jersey","Sussex County",1,1,1284,648,636
050,34,037,"New Jersey","Sussex County",1,2,1310,641,669
050,34,037,"New Jersey","Sussex County",1,3,1303,655,648
050,34,037,"New Jersey","Sussex County",1,4,1416,726,690
050,34,037,"New Jersey","Sussex County",1,5,1405,754,651
050,34,037,"New Jersey","Sussex County",1,6,1414,706,708
050,34,037,"New Jersey","Sussex County",1,7,1429,698,731
050,34,037,"New Jersey","Sussex County",1,8,1517,772,745
050,34,037,"New Jersey","Sussex County",1,9,1533,807,726
050,34,037,"New Jersey","Sussex County",1,10,1578,808,770
050,34,037,"New Jersey","Sussex County",1,11,1650,824,826
050,34,037,"New Jersey","Sussex County",1,12,1738,886,852
050,34,037,"New Jersey","Sussex County",1,13,1770,894,876
050,34,037,"New Jersey","Sussex County",1,14,1823,943,880
050,34,037,"New Jersey","Sussex County",1,15,1874,940,934
050,34,037,"New Jersey","Sussex County",1,16,1956,975,981
050,34,037,"New Jersey","Sussex County",1,17,1984,1011,973
050,34,037,"New Jersey","Sussex County",1,18,1716,908,808
050,34,037,"New Jersey","Sussex County",1,19,1422,760,662
050,34,037,"New Jersey","Sussex County",1,20,1507,771,736
050,34,037,"New Jersey","Sussex County",1,21,1636,841,795
050,34,037,"New Jersey","Sussex County",1,22,1688,834,854
050,34,037,"New Jersey","Sussex County",1,23,1701,871,830
050,34,037,"New Jersey","Sussex County",1,24,1636,858,778
050,34,037,"New Jersey","Sussex County",1,25,1591,820,771
050,34,037,"New Jersey","Sussex County",1,26,1631,858,773
050,34,037,"New Jersey","Sussex County",1,27,1638,840,798
050,34,037,"New Jersey","Sussex County",1,28,1598,859,739
050,34,037,"New Jersey","Sussex County",1,29,1629,871,758
050,34,037,"New Jersey","Sussex County",1,30,1598,825,773
050,34,037,"New Jersey","Sussex County",1,31,1573,845,728
050,34,037,"New Jersey","Sussex County",1,32,1550,804,746
050,34,037,"New Jersey","Sussex County",1,33,1590,804,786
050,34,037,"New Jersey","Sussex County",1,34,1691,866,825
050,34,037,"New Jersey","Sussex County",1,35,1595,816,779
050,34,037,"New Jersey","Sussex County",1,36,1677,872,805
050,34,037,"New Jersey","Sussex County",1,37,1677,868,809
050,34,037,"New Jersey","Sussex County",1,38,1705,891,814
050,34,037,"New Jersey","Sussex County",1,39,1727,866,861
050,34,037,"New Jersey","Sussex County",1,40,1678,851,827
050,34,037,"New Jersey","Sussex County",1,41,1689,860,829
050,34,037,"New Jersey","Sussex County",1,42,1672,858,814
050,34,037,"New Jersey","Sussex County",1,43,1661,834,827
050,34,037,"New Jersey","Sussex County",1,44,1612,813,799
050,34,037,"New Jersey","Sussex County",1,45,1632,801,831
050,34,037,"New Jersey","Sussex County",1,46,1658,801,857
050,34,037,"New Jersey","Sussex County",1,47,1844,919,925
050,34,037,"New Jersey","Sussex County",1,48,2082,1041,1041
050,34,037,"New Jersey","Sussex County",1,49,2254,1122,1132
050,34,037,"New Jersey","Sussex County",1,50,2315,1139,1176
050,34,037,"New Jersey","Sussex County",1,51,2267,1112,1155
050,34,037,"New Jersey","Sussex County",1,52,2289,1127,1162
050,34,037,"New Jersey","Sussex County",1,53,2418,1204,1214
050,34,037,"New Jersey","Sussex County",1,54,2459,1226,1233
050,34,037,"New Jersey","Sussex County",1,55,2533,1293,1240
050,34,037,"New Jersey","Sussex County",1,56,2585,1275,1310
050,34,037,"New Jersey","Sussex County",1,57,2526,1258,1268
050,34,037,"New Jersey","Sussex County",1,58,2629,1351,1278
050,34,037,"New Jersey","Sussex County",1,59,2591,1301,1290
050,34,037,"New Jersey","Sussex County",1,60,2476,1237,1239
050,34,037,"New Jersey","Sussex County",1,61,2477,1251,1226
050,34,037,"New Jersey","Sussex County",1,62,2363,1193,1170
050,34,037,"New Jersey","Sussex County",1,63,2286,1147,1139
050,34,037,"New Jersey","Sussex County",1,64,2161,1042,1119
050,34,037,"New Jersey","Sussex County",1,65,2121,1067,1054
050,34,037,"New Jersey","Sussex County",1,66,1981,1008,973
050,34,037,"New Jersey","Sussex County",1,67,1879,955,924
050,34,037,"New Jersey","Sussex County",1,68,1794,892,902
050,34,037,"New Jersey","Sussex County",1,69,1619,804,815
050,34,037,"New Jersey","Sussex County",1,70,1556,788,768
050,34,037,"New Jersey","Sussex County",1,71,1457,685,772
050,34,037,"New Jersey","Sussex County",1,72,1477,712,765
050,34,037,"New Jersey","Sussex County",1,73,1521,717,804
050,34,037,"New Jersey","Sussex County",1,74,1089,496,593
050,34,037,"New Jersey","Sussex County",1,75,1047,500,547
050,34,037,"New Jersey","Sussex County",1,76,1003,490,513
050,34,037,"New Jersey","Sussex County",1,77,1008,500,508
050,34,037,"New Jersey","Sussex County",1,78,858,398,460
050,34,037,"New Jersey","Sussex County",1,79,683,296,387
050,34,037,"New Jersey","Sussex County",1,80,639,285,354
050,34,037,"New Jersey","Sussex County",1,81,588,282,306
050,34,037,"New Jersey","Sussex County",1,82,528,234,294
050,34,037,"New Jersey","Sussex County",1,83,417,189,228
050,34,037,"New Jersey","Sussex County",1,84,387,171,216
050,34,037,"New Jersey","Sussex County",1,85,2415,838,1577
050,34,037,"New Jersey","Sussex County",2,0,1269,643,626
050,34,037,"New Jersey","Sussex County",2,1,1279,646,633
050,34,037,"New Jersey","Sussex County",2,2,1307,644,663
050,34,037,"New Jersey","Sussex County",2,3,1307,653,654
050,34,037,"New Jersey","Sussex County",2,4,1391,710,681
050,34,037,"New Jersey","Sussex County",2,5,1414,749,665
050,34,037,"New Jersey","Sussex County",2,6,1421,720,701
050,34,037,"New Jersey","Sussex County",2,7,1428,700,728
050,34,037,"New Jersey","Sussex County",2,8,1493,753,740
050,34,037,"New Jersey","Sussex County",2,9,1528,800,728
050,34,037,"New Jersey","Sussex County",2,10,1571,811,760
050,34,037,"New Jersey","Sussex County",2,11,1626,817,809
050,34,037,"New Jersey","Sussex County",2,12,1729,876,853
050,34,037,"New Jersey","Sussex County",2,13,1766,894,872
050,34,037,"New Jersey","Sussex County",2,14,1812,932,880
050,34,037,"New Jersey","Sussex County",2,15,1867,943,924
050,34,037,"New Jersey","Sussex County",2,16,1942,969,973
050,34,037,"New Jersey","Sussex County",2,17,1980,1004,976
050,34,037,"New Jersey","Sussex County",2,18,1703,898,805
050,34,037,"New Jersey","Sussex County",2,19,1421,753,668
050,34,037,"New Jersey","Sussex County",2,20,1529,788,741
050,34,037,"New Jersey","Sussex County",2,21,1615,827,788
050,34,037,"New Jersey","Sussex County",2,22,1685,840,845
050,34,037,"New Jersey","Sussex County",2,23,1697,864,833
050,34,037,"New Jersey","Sussex County",2,24,1634,855,779
050,34,037,"New Jersey","Sussex County",2,25,1589,825,764
050,34,037,"New Jersey","Sussex County",2,26,1617,845,772
050,34,037,"New Jersey","Sussex County",2,27,1628,837,791
050,34,037,"New Jersey","Sussex County",2,28,1613,857,756
050,34,037,"New Jersey","Sussex County",2,29,1627,871,756
050,34,037,"New Jersey","Sussex County",2,30,1625,844,781
050,34,037,"New Jersey","Sussex County",2,31,1582,842,740
050,34,037,"New Jersey","Sussex County",2,32,1562,817,745
050,34,037,"New Jersey","Sussex County",2,33,1586,806,780
050,34,037,"New Jersey","Sussex County",2,34,1676,860,816
050,34,037,"New Jersey","Sussex County",2,35,1643,844,799
050,34,037,"New Jersey","Sussex County",2,36,1654,858,796
050,34,037,"New Jersey","Sussex County",2,37,1687,876,811
050,34,037,"New Jersey","Sussex County",2,38,1713,894,819
050,34,037,"New Jersey","Sussex County",2,39,1723,875,848
050,34,037,"New Jersey","Sussex County",2,40,1710,867,843
050,34,037,"New Jersey","Sussex County",2,41,1681,856,825
050,34,037,"New Jersey","Sussex County",2,42,1667,854,813
050,34,037,"New Jersey","Sussex County",2,43,1677,847,830
050,34,037,"New Jersey","Sussex County",2,44,1611,812,799
050,34,037,"New Jersey","Sussex County",2,45,1639,809,830
050,34,037,"New Jersey","Sussex County",2,46,1647,801,846
050,34,037,"New Jersey","Sussex County",2,47,1794,889,905
050,34,037,"New Jersey","Sussex County",2,48,2027,1016,1011
050,34,037,"New Jersey","Sussex County",2,49,2227,1111,1116
050,34,037,"New Jersey","Sussex County",2,50,2301,1137,1164
050,34,037,"New Jersey","Sussex County",2,51,2271,1118,1153
050,34,037,"New Jersey","Sussex County",2,52,2274,1117,1157
050,34,037,"New Jersey","Sussex County",2,53,2376,1178,1198
050,34,037,"New Jersey","Sussex County",2,54,2427,1211,1216
050,34,037,"New Jersey","Sussex County",2,55,2507,1271,1236
050,34,037,"New Jersey","Sussex County",2,56,2566,1277,1289
050,34,037,"New Jersey","Sussex County",2,57,2524,1257,1267
050,34,037,"New Jersey","Sussex County",2,58,2576,1312,1264
050,34,037,"New Jersey","Sussex County",2,59,2598,1314,1284
050,34,037,"New Jersey","Sussex County",2,60,2490,1248,1242
050,34,037,"New Jersey","Sussex County",2,61,2449,1231,1218
050,34,037,"New Jersey","Sussex County",2,62,2370,1195,1175
050,34,037,"New Jersey","Sussex County",2,63,2305,1161,1144
050,34,037,"New Jersey","Sussex County",2,64,2155,1050,1105
050,34,037,"New Jersey","Sussex County",2,65,2113,1050,1063
050,34,037,"New Jersey","Sussex County",2,66,1994,1009,985
050,34,037,"New Jersey","Sussex County",2,67,1885,960,925
050,34,037,"New Jersey","Sussex County",2,68,1783,889,894
050,34,037,"New Jersey","Sussex County",2,69,1661,826,835
050,34,037,"New Jersey","Sussex County",2,70,1548,781,767
050,34,037,"New Jersey","Sussex County",2,71,1467,702,765
050,34,037,"New Jersey","Sussex County",2,72,1439,688,751
050,34,037,"New Jersey","Sussex County",2,73,1566,738,828
050,34,037,"New Jersey","Sussex County",2,74,1109,510,599
050,34,037,"New Jersey","Sussex County",2,75,1037,487,550
050,34,037,"New Jersey","Sussex County",2,76,991,481,510
050,34,037,"New Jersey","Sussex County",2,77,1015,502,513
050,34,037,"New Jersey","Sussex County",2,78,857,403,454
050,34,037,"New Jersey","Sussex County",2,79,709,315,394
050,34,037,"New Jersey","Sussex County",2,80,637,280,357
050,34,037,"New Jersey","Sussex County",2,81,588,280,308
050,34,037,"New Jersey","Sussex County",2,82,528,240,288
050,34,037,"New Jersey","Sussex County",2,83,424,193,231
050,34,037,"New Jersey","Sussex County",2,84,376,166,210
050,34,037,"New Jersey","Sussex County",2,85,2380,830,1550
050,34,037,"New Jersey","Sussex County",3,0,1341,694,647
050,34,037,"New Jersey","Sussex County",3,1,1391,712,679
050,34,037,"New Jersey","Sussex County",3,2,1341,686,655
050,34,037,"New Jersey","Sussex County",3,3,1390,695,695
050,34,037,"New Jersey","Sussex County",3,4,1372,685,687
050,34,037,"New Jersey","Sussex County",3,5,1470,759,711
050,34,037,"New Jersey","Sussex County",3,6,1479,780,699
050,34,037,"New Jersey","Sussex County",3,7,1481,752,729
050,34,037,"New Jersey","Sussex County",3,8,1460,713,747
050,34,037,"New Jersey","Sussex County",3,9,1542,794,748
050,34,037,"New Jersey","Sussex County",3,10,1553,800,753
050,34,037,"New Jersey","Sussex County",3,11,1626,835,791
050,34,037,"New Jersey","Sussex County",3,12,1674,839,835
050,34,037,"New Jersey","Sussex County",3,13,1748,892,856
050,34,037,"New Jersey","Sussex County",3,14,1790,913,877
050,34,037,"New Jersey","Sussex County",3,15,1866,954,912
050,34,037,"New Jersey","Sussex County",3,16,1887,948,939
050,34,037,"New Jersey","Sussex County",3,17,1967,985,982
050,34,037,"New Jersey","Sussex County",3,18,1706,904,802
050,34,037,"New Jersey","Sussex County",3,19,1392,731,661
050,34,037,"New Jersey","Sussex County",3,20,1537,816,721
050,34,037,"New Jersey","Sussex County",3,21,1595,825,770
050,34,037,"New Jersey","Sussex County",3,22,1668,838,830
050,34,037,"New Jersey","Sussex County",3,23,1675,850,825
050,34,037,"New Jersey","Sussex County",3,24,1656,854,802
050,34,037,"New Jersey","Sussex County",3,25,1610,841,769
050,34,037,"New Jersey","Sussex County",3,26,1604,840,764
050,34,037,"New Jersey","Sussex County",3,27,1680,859,821
050,34,037,"New Jersey","Sussex County",3,28,1687,866,821
050,34,037,"New Jersey","Sussex County",3,29,1718,918,800
050,34,037,"New Jersey","Sussex County",3,30,1725,920,805
050,34,037,"New Jersey","Sussex County",3,31,1756,912,844
050,34,037,"New Jersey","Sussex County",3,32,1719,908,811
050,34,037,"New Jersey","Sussex County",3,33,1666,867,799
050,34,037,"New Jersey","Sussex County",3,34,1689,861,828
050,34,037,"New Jersey","Sussex County",3,35,1827,942,885
050,34,037,"New Jersey","Sussex County",3,36,1757,913,844
050,34,037,"New Jersey","Sussex County",3,37,1753,896,857
050,34,037,"New Jersey","Sussex County",3,38,1758,917,841
050,34,037,"New Jersey","Sussex County",3,39,1835,961,874
050,34,037,"New Jersey","Sussex County",3,40,1817,930,887
050,34,037,"New Jersey","Sussex County",3,41,1797,907,890
050,34,037,"New Jersey","Sussex County",3,42,1733,880,853
050,34,037,"New Jersey","Sussex County",3,43,1742,895,847
050,34,037,"New Jersey","Sussex County",3,44,1718,862,856
050,34,037,"New Jersey","Sussex County",3,45,1662,844,818
050,34,037,"New Jersey","Sussex County",3,46,1680,832,848
050,34,037,"New Jersey","Sussex County",3,47,1684,827,857
050,34,037,"New Jersey","Sussex County",3,48,1829,905,924
050,34,037,"New Jersey","Sussex County",3,49,2027,1012,1015
050,34,037,"New Jersey","Sussex County",3,50,2195,1081,1114
050,34,037,"New Jersey","Sussex County",3,51,2288,1138,1150
050,34,037,"New Jersey","Sussex County",3,52,2273,1121,1152
050,34,037,"New Jersey","Sussex County",3,53,2266,1120,1146
050,34,037,"New Jersey","Sussex County",3,54,2347,1168,1179
050,34,037,"New Jersey","Sussex County",3,55,2407,1192,1215
050,34,037,"New Jersey","Sussex County",3,56,2499,1261,1238
050,34,037,"New Jersey","Sussex County",3,57,2505,1238,1267
050,34,037,"New Jersey","Sussex County",3,58,2464,1221,1243
050,34,037,"New Jersey","Sussex County",3,59,2519,1282,1237
050,34,037,"New Jersey","Sussex County",3,60,2527,1292,1235
050,34,037,"New Jersey","Sussex County",3,61,2461,1233,1228
050,34,037,"New Jersey","Sussex County",3,62,2417,1217,1200
050,34,037,"New Jersey","Sussex County",3,63,2307,1171,1136
050,34,037,"New Jersey","Sussex County",3,64,2245,1133,1112
050,34,037,"New Jersey","Sussex County",3,65,2102,1026,1076
050,34,037,"New Jersey","Sussex County",3,66,2054,1012,1042
050,34,037,"New Jersey","Sussex County",3,67,1915,967,948
050,34,037,"New Jersey","Sussex County",3,68,1836,922,914
050,34,037,"New Jersey","Sussex County",3,69,1719,851,868
050,34,037,"New Jersey","Sussex County",3,70,1606,803,803
050,34,037,"New Jersey","Sussex County",3,71,1511,750,761
050,34,037,"New Jersey","Sussex County",3,72,1409,661,748
050,34,037,"New Jersey","Sussex County",3,73,1386,660,726
050,34,037,"New Jersey","Sussex County",3,74,1520,719,801
050,34,037,"New Jersey","Sussex County",3,75,1058,477,581
050,34,037,"New Jersey","Sussex County",3,76,989,459,530
050,34,037,"New Jersey","Sussex County",3,77,915,440,475
050,34,037,"New Jersey","Sussex County",3,78,980,465,515
050,34,037,"New Jersey","Sussex County",3,79,818,383,435
050,34,037,"New Jersey","Sussex County",3,80,699,308,391
050,34,037,"New Jersey","Sussex County",3,81,579,252,327
050,34,037,"New Jersey","Sussex County",3,82,551,260,291
050,34,037,"New Jersey","Sussex County",3,83,483,219,264
050,34,037,"New Jersey","Sussex County",3,84,389,175,214
050,34,037,"New Jersey","Sussex County",3,85,2402,846,1556
050,34,037,"New Jersey","Sussex County",4,0,1408,718,690
050,34,037,"New Jersey","Sussex County",4,1,1392,732,660
050,34,037,"New Jersey","Sussex County",4,2,1406,727,679
050,34,037,"New Jersey","Sussex County",4,3,1394,715,679
050,34,037,"New Jersey","Sussex County",4,4,1427,726,701
050,34,037,"New Jersey","Sussex County",4,5,1429,727,702
050,34,037,"New Jersey","Sussex County",4,6,1504,782,722
050,34,037,"New Jersey","Sussex County",4,7,1492,791,701
050,34,037,"New Jersey","Sussex County",4,8,1535,776,759
050,34,037,"New Jersey","Sussex County",4,9,1487,718,769
050,34,037,"New Jersey","Sussex County",4,10,1594,821,773
050,34,037,"New Jersey","Sussex County",4,11,1606,824,782
050,34,037,"New Jersey","Sussex County",4,12,1648,855,793
050,34,037,"New Jersey","Sussex County",4,13,1707,853,854
050,34,037,"New Jersey","Sussex County",4,14,1788,911,877
050,34,037,"New Jersey","Sussex County",4,15,1807,932,875
050,34,037,"New Jersey","Sussex County",4,16,1898,978,920
050,34,037,"New Jersey","Sussex County",4,17,1914,961,953
050,34,037,"New Jersey","Sussex County",4,18,1659,857,802
050,34,037,"New Jersey","Sussex County",4,19,1335,715,620
050,34,037,"New Jersey","Sussex County",4,20,1485,768,717
050,34,037,"New Jersey","Sussex County",4,21,1592,836,756
050,34,037,"New Jersey","Sussex County",4,22,1653,856,797
050,34,037,"New Jersey","Sussex County",4,23,1677,851,826
050,34,037,"New Jersey","Sussex County",4,24,1634,824,810
050,34,037,"New Jersey","Sussex County",4,25,1604,840,764
050,34,037,"New Jersey","Sussex County",4,26,1538,807,731
050,34,037,"New Jersey","Sussex County",4,27,1579,837,742
050,34,037,"New Jersey","Sussex County",4,28,1715,864,851
050,34,037,"New Jersey","Sussex County",4,29,1715,894,821
050,34,037,"New Jersey","Sussex County",4,30,1736,918,818
050,34,037,"New Jersey","Sussex County",4,31,1798,941,857
050,34,037,"New Jersey","Sussex County",4,32,1840,950,890
050,34,037,"New Jersey","Sussex County",4,33,1807,957,850
050,34,037,"New Jersey","Sussex County",4,34,1757,912,845
050,34,037,"New Jersey","Sussex County",4,35,1779,904,875
050,34,037,"New Jersey","Sussex County",4,36,1912,993,919
050,34,037,"New Jersey","Sussex County",4,37,1847,962,885
050,34,037,"New Jersey","Sussex County",4,38,1794,907,887
050,34,037,"New Jersey","Sussex County",4,39,1809,950,859
050,34,037,"New Jersey","Sussex County",4,40,1888,969,919
050,34,037,"New Jersey","Sussex County",4,41,1848,945,903
050,34,037,"New Jersey","Sussex County",4,42,1814,901,913
050,34,037,"New Jersey","Sussex County",4,43,1760,893,867
050,34,037,"New Jersey","Sussex County",4,44,1767,913,854
050,34,037,"New Jersey","Sussex County",4,45,1763,892,871
050,34,037,"New Jersey","Sussex County",4,46,1669,836,833
050,34,037,"New Jersey","Sussex County",4,47,1690,828,862
050,34,037,"New Jersey","Sussex County",4,48,1699,835,864
050,34,037,"New Jersey","Sussex County",4,49,1837,911,926
050,34,037,"New Jersey","Sussex County",4,50,1989,990,999
050,34,037,"New Jersey","Sussex County",4,51,2173,1083,1090
050,34,037,"New Jersey","Sussex County",4,52,2261,1131,1130
050,34,037,"New Jersey","Sussex County",4,53,2261,1118,1143
050,34,037,"New Jersey","Sussex County",4,54,2189,1083,1106
050,34,037,"New Jersey","Sussex County",4,55,2252,1123,1129
050,34,037,"New Jersey","Sussex County",4,56,2373,1177,1196
050,34,037,"New Jersey","Sussex County",4,57,2445,1233,1212
050,34,037,"New Jersey","Sussex County",4,58,2455,1213,1242
050,34,037,"New Jersey","Sussex County",4,59,2398,1187,1211
050,34,037,"New Jersey","Sussex County",4,60,2472,1272,1200
050,34,037,"New Jersey","Sussex County",4,61,2478,1265,1213
050,34,037,"New Jersey","Sussex County",4,62,2358,1180,1178
050,34,037,"New Jersey","Sussex County",4,63,2341,1188,1153
050,34,037,"New Jersey","Sussex County",4,64,2230,1135,1095
050,34,037,"New Jersey","Sussex County",4,65,2167,1086,1081
050,34,037,"New Jersey","Sussex County",4,66,2038,987,1051
050,34,037,"New Jersey","Sussex County",4,67,2001,972,1029
050,34,037,"New Jersey","Sussex County",4,68,1849,926,923
050,34,037,"New Jersey","Sussex County",4,69,1772,881,891
050,34,037,"New Jersey","Sussex County",4,70,1669,823,846
050,34,037,"New Jersey","Sussex County",4,71,1556,770,786
050,34,037,"New Jersey","Sussex County",4,72,1448,722,726
050,34,037,"New Jersey","Sussex County",4,73,1350,631,719
050,34,037,"New Jersey","Sussex County",4,74,1337,635,702
050,34,037,"New Jersey","Sussex County",4,75,1435,659,776
050,34,037,"New Jersey","Sussex County",4,76,1003,452,551
050,34,037,"New Jersey","Sussex County",4,77,913,419,494
050,34,037,"New Jersey","Sussex County",4,78,875,409,466
050,34,037,"New Jersey","Sussex County",4,79,918,436,482
050,34,037,"New Jersey","Sussex County",4,80,790,374,416
050,34,037,"New Jersey","Sussex County",4,81,623,272,351
050,34,037,"New Jersey","Sussex County",4,82,538,233,305
050,34,037,"New Jersey","Sussex County",4,83,502,234,268
050,34,037,"New Jersey","Sussex County",4,84,433,203,230
050,34,037,"New Jersey","Sussex County",4,85,2247,824,1423
050,34,037,"New Jersey","Sussex County",5,0,1413,720,693
050,34,037,"New Jersey","Sussex County",5,1,1478,771,707
050,34,037,"New Jersey","Sussex County",5,2,1438,769,669
050,34,037,"New Jersey","Sussex County",5,3,1453,749,704
050,34,037,"New Jersey","Sussex County",5,4,1398,698,700
050,34,037,"New Jersey","Sussex County",5,5,1468,744,724
050,34,037,"New Jersey","Sussex County",5,6,1463,742,721
050,34,037,"New Jersey","Sussex County",5,7,1550,798,752
050,34,037,"New Jersey","Sussex County",5,8,1516,811,705
050,34,037,"New Jersey","Sussex County",5,9,1523,776,747
050,34,037,"New Jersey","Sussex County",5,10,1506,733,773
050,34,037,"New Jersey","Sussex County",5,11,1597,823,774
050,34,037,"New Jersey","Sussex County",5,12,1619,829,790
050,34,037,"New Jersey","Sussex County",5,13,1703,873,830
050,34,037,"New Jersey","Sussex County",5,14,1738,880,858
050,34,037,"New Jersey","Sussex County",5,15,1812,916,896
050,34,037,"New Jersey","Sussex County",5,16,1854,948,906
050,34,037,"New Jersey","Sussex County",5,17,1930,1007,923
050,34,037,"New Jersey","Sussex County",5,18,1611,834,777
050,34,037,"New Jersey","Sussex County",5,19,1317,676,641
050,34,037,"New Jersey","Sussex County",5,20,1460,761,699
050,34,037,"New Jersey","Sussex County",5,21,1573,804,769
050,34,037,"New Jersey","Sussex County",5,22,1652,869,783
050,34,037,"New Jersey","Sussex County",5,23,1646,852,794
050,34,037,"New Jersey","Sussex County",5,24,1659,845,814
050,34,037,"New Jersey","Sussex County",5,25,1586,801,785
050,34,037,"New Jersey","Sussex County",5,26,1584,845,739
050,34,037,"New Jersey","Sussex County",5,27,1561,801,760
050,34,037,"New Jersey","Sussex County",5,28,1629,878,751
050,34,037,"New Jersey","Sussex County",5,29,1740,885,855
050,34,037,"New Jersey","Sussex County",5,30,1797,924,873
050,34,037,"New Jersey","Sussex County",5,31,1799,942,857
050,34,037,"New Jersey","Sussex County",5,32,1852,959,893
050,34,037,"New Jersey","Sussex County",5,33,1900,985,915
050,34,037,"New Jersey","Sussex County",5,34,1845,972,873
050,34,037,"New Jersey","Sussex County",5,35,1847,970,877
050,34,037,"New Jersey","Sussex County",5,36,1830,941,889
050,34,037,"New Jersey","Sussex County",5,37,2015,1053,962
050,34,037,"New Jersey","Sussex County",5,38,1876,975,901
050,34,037,"New Jersey","Sussex County",5,39,1848,936,912
050,34,037,"New Jersey","Sussex County",5,40,1844,968,876
050,34,037,"New Jersey","Sussex County",5,41,1922,995,927
050,34,037,"New Jersey","Sussex County",5,42,1888,962,926
050,34,037,"New Jersey","Sussex County",5,43,1885,944,941
050,34,037,"New Jersey","Sussex County",5,44,1787,915,872
050,34,037,"New Jersey","Sussex County",5,45,1779,926,853
050,34,037,"New Jersey","Sussex County",5,46,1781,906,875
050,34,037,"New Jersey","Sussex County",5,47,1662,825,837
050,34,037,"New Jersey","Sussex County",5,48,1695,844,851
050,34,037,"New Jersey","Sussex County",5,49,1679,826,853
050,34,037,"New Jersey","Sussex County",5,50,1824,918,906
050,34,037,"New Jersey","Sussex County",5,51,1985,987,998
050,34,037,"New Jersey","Sussex County",5,52,2192,1090,1102
050,34,037,"New Jersey","Sussex County",5,53,2255,1134,1121
050,34,037,"New Jersey","Sussex County",5,54,2224,1102,1122
050,34,037,"New Jersey","Sussex County",5,55,2145,1050,1095
050,34,037,"New Jersey","Sussex County",5,56,2249,1126,1123
050,34,037,"New Jersey","Sussex County",5,57,2334,1151,1183
050,34,037,"New Jersey","Sussex County",5,58,2404,1202,1202
050,34,037,"New Jersey","Sussex County",5,59,2398,1195,1203
050,34,037,"New Jersey","Sussex County",5,60,2323,1152,1171
050,34,037,"New Jersey","Sussex County",5,61,2424,1240,1184
050,34,037,"New Jersey","Sussex County",5,62,2421,1234,1187
050,34,037,"New Jersey","Sussex County",5,63,2310,1171,1139
050,34,037,"New Jersey","Sussex County",5,64,2275,1131,1144
050,34,037,"New Jersey","Sussex County",5,65,2177,1113,1064
050,34,037,"New Jersey","Sussex County",5,66,2118,1057,1061
050,34,037,"New Jersey","Sussex County",5,67,2002,970,1032
050,34,037,"New Jersey","Sussex County",5,68,1954,941,1013
050,34,037,"New Jersey","Sussex County",5,69,1782,896,886
050,34,037,"New Jersey","Sussex County",5,70,1733,863,870
050,34,037,"New Jersey","Sussex County",5,71,1607,788,819
050,34,037,"New Jersey","Sussex County",5,72,1506,747,759
050,34,037,"New Jersey","Sussex County",5,73,1419,702,717
050,34,037,"New Jersey","Sussex County",5,74,1313,604,709
050,34,037,"New Jersey","Sussex County",5,75,1286,597,689
050,34,037,"New Jersey","Sussex County",5,76,1399,638,761
050,34,037,"New Jersey","Sussex County",5,77,957,432,525
050,34,037,"New Jersey","Sussex County",5,78,880,400,480
050,34,037,"New Jersey","Sussex County",5,79,836,395,441
050,34,037,"New Jersey","Sussex County",5,80,883,422,461
050,34,037,"New Jersey","Sussex County",5,81,729,343,386
050,34,037,"New Jersey","Sussex County",5,82,577,248,329
050,34,037,"New Jersey","Sussex County",5,83,495,216,279
050,34,037,"New Jersey","Sussex County",5,84,462,218,244
050,34,037,"New Jersey","Sussex County",5,85,2246,857,1389
050,34,039,"New Jersey","Union County",1,0,6859,3512,3347
050,34,039,"New Jersey","Union County",1,1,7154,3717,3437
050,34,039,"New Jersey","Union County",1,2,7262,3733,3529
050,34,039,"New Jersey","Union County",1,3,7452,3846,3606
050,34,039,"New Jersey","Union County",1,4,7503,3805,3698
050,34,039,"New Jersey","Union County",1,5,7363,3724,3639
050,34,039,"New Jersey","Union County",1,6,7333,3728,3605
050,34,039,"New Jersey","Union County",1,7,7405,3751,3654
050,34,039,"New Jersey","Union County",1,8,7543,3829,3714
050,34,039,"New Jersey","Union County",1,9,7658,3852,3806
050,34,039,"New Jersey","Union County",1,10,7737,3929,3808
050,34,039,"New Jersey","Union County",1,11,7911,4036,3875
050,34,039,"New Jersey","Union County",1,12,8094,4143,3951
050,34,039,"New Jersey","Union County",1,13,8045,4116,3929
050,34,039,"New Jersey","Union County",1,14,7879,3993,3886
050,34,039,"New Jersey","Union County",1,15,7838,3978,3860
050,34,039,"New Jersey","Union County",1,16,7698,3935,3763
050,34,039,"New Jersey","Union County",1,17,7721,3967,3754
050,34,039,"New Jersey","Union County",1,18,7108,3653,3455
050,34,039,"New Jersey","Union County",1,19,6557,3398,3159
050,34,039,"New Jersey","Union County",1,20,6632,3414,3218
050,34,039,"New Jersey","Union County",1,21,6790,3399,3391
050,34,039,"New Jersey","Union County",1,22,6864,3426,3438
050,34,039,"New Jersey","Union County",1,23,6777,3360,3417
050,34,039,"New Jersey","Union County",1,24,6685,3316,3369
050,34,039,"New Jersey","Union County",1,25,6765,3413,3352
050,34,039,"New Jersey","Union County",1,26,6771,3416,3355
050,34,039,"New Jersey","Union County",1,27,6953,3488,3465
050,34,039,"New Jersey","Union County",1,28,7013,3523,3490
050,34,039,"New Jersey","Union County",1,29,7173,3605,3568
050,34,039,"New Jersey","Union County",1,30,7335,3692,3643
050,34,039,"New Jersey","Union County",1,31,7300,3695,3605
050,34,039,"New Jersey","Union County",1,32,7393,3753,3640
050,34,039,"New Jersey","Union County",1,33,7514,3781,3733
050,34,039,"New Jersey","Union County",1,34,7803,3858,3945
050,34,039,"New Jersey","Union County",1,35,7852,3977,3875
050,34,039,"New Jersey","Union County",1,36,7777,3874,3903
050,34,039,"New Jersey","Union County",1,37,8019,4051,3968
050,34,039,"New Jersey","Union County",1,38,8049,4013,4036
050,34,039,"New Jersey","Union County",1,39,8280,4123,4157
050,34,039,"New Jersey","Union County",1,40,8304,4191,4113
050,34,039,"New Jersey","Union County",1,41,8051,3967,4084
050,34,039,"New Jersey","Union County",1,42,8121,4052,4069
050,34,039,"New Jersey","Union County",1,43,7785,3856,3929
050,34,039,"New Jersey","Union County",1,44,7700,3839,3861
050,34,039,"New Jersey","Union County",1,45,7786,3946,3840
050,34,039,"New Jersey","Union County",1,46,7669,3918,3751
050,34,039,"New Jersey","Union County",1,47,7765,3948,3817
050,34,039,"New Jersey","Union County",1,48,7989,4003,3986
050,34,039,"New Jersey","Union County",1,49,8309,4174,4135
050,34,039,"New Jersey","Union County",1,50,8225,4103,4122
050,34,039,"New Jersey","Union County",1,51,8098,4039,4059
050,34,039,"New Jersey","Union County",1,52,8010,3909,4101
050,34,039,"New Jersey","Union County",1,53,8128,3976,4152
050,34,039,"New Jersey","Union County",1,54,8102,4010,4092
050,34,039,"New Jersey","Union County",1,55,8286,4122,4164
050,34,039,"New Jersey","Union County",1,56,8291,4102,4189
050,34,039,"New Jersey","Union County",1,57,8113,4015,4098
050,34,039,"New Jersey","Union County",1,58,8031,3979,4052
050,34,039,"New Jersey","Union County",1,59,7880,3846,4034
050,34,039,"New Jersey","Union County",1,60,7721,3880,3841
050,34,039,"New Jersey","Union County",1,61,7449,3687,3762
050,34,039,"New Jersey","Union County",1,62,7271,3608,3663
050,34,039,"New Jersey","Union County",1,63,6887,3342,3545
050,34,039,"New Jersey","Union County",1,64,6469,3067,3402
050,34,039,"New Jersey","Union County",1,65,6069,2855,3214
050,34,039,"New Jersey","Union County",1,66,5729,2708,3021
050,34,039,"New Jersey","Union County",1,67,5492,2605,2887
050,34,039,"New Jersey","Union County",1,68,5173,2397,2776
050,34,039,"New Jersey","Union County",1,69,4854,2283,2571
050,34,039,"New Jersey","Union County",1,70,4648,2130,2518
050,34,039,"New Jersey","Union County",1,71,4454,2007,2447
050,34,039,"New Jersey","Union County",1,72,4372,2017,2355
050,34,039,"New Jersey","Union County",1,73,4481,2019,2462
050,34,039,"New Jersey","Union County",1,74,3348,1450,1898
050,34,039,"New Jersey","Union County",1,75,3115,1393,1722
050,34,039,"New Jersey","Union County",1,76,3088,1406,1682
050,34,039,"New Jersey","Union County",1,77,3013,1307,1706
050,34,039,"New Jersey","Union County",1,78,2607,1069,1538
050,34,039,"New Jersey","Union County",1,79,2351,957,1394
050,34,039,"New Jersey","Union County",1,80,2233,938,1295
050,34,039,"New Jersey","Union County",1,81,2062,847,1215
050,34,039,"New Jersey","Union County",1,82,1894,757,1137
050,34,039,"New Jersey","Union County",1,83,1756,672,1084
050,34,039,"New Jersey","Union County",1,84,1592,610,982
050,34,039,"New Jersey","Union County",1,85,10727,3596,7131
050,34,039,"New Jersey","Union County",2,0,6817,3497,3320
050,34,039,"New Jersey","Union County",2,1,7109,3686,3423
050,34,039,"New Jersey","Union County",2,2,7263,3744,3519
050,34,039,"New Jersey","Union County",2,3,7394,3808,3586
050,34,039,"New Jersey","Union County",2,4,7486,3813,3673
050,34,039,"New Jersey","Union County",2,5,7380,3741,3639
050,34,039,"New Jersey","Union County",2,6,7344,3734,3610
050,34,039,"New Jersey","Union County",2,7,7389,3739,3650
050,34,039,"New Jersey","Union County",2,8,7480,3791,3689
050,34,039,"New Jersey","Union County",2,9,7607,3836,3771
050,34,039,"New Jersey","Union County",2,10,7698,3902,3796
050,34,039,"New Jersey","Union County",2,11,7820,3985,3835
050,34,039,"New Jersey","Union County",2,12,8070,4129,3941
050,34,039,"New Jersey","Union County",2,13,8044,4118,3926
050,34,039,"New Jersey","Union County",2,14,7911,4016,3895
050,34,039,"New Jersey","Union County",2,15,7840,3978,3862
050,34,039,"New Jersey","Union County",2,16,7733,3950,3783
050,34,039,"New Jersey","Union County",2,17,7691,3946,3745
050,34,039,"New Jersey","Union County",2,18,7072,3645,3427
050,34,039,"New Jersey","Union County",2,19,6530,3371,3159
050,34,039,"New Jersey","Union County",2,20,6704,3448,3256
050,34,039,"New Jersey","Union County",2,21,6743,3398,3345
050,34,039,"New Jersey","Union County",2,22,6842,3413,3429
050,34,039,"New Jersey","Union County",2,23,6785,3370,3415
050,34,039,"New Jersey","Union County",2,24,6671,3307,3364
050,34,039,"New Jersey","Union County",2,25,6702,3372,3330
050,34,039,"New Jersey","Union County",2,26,6755,3409,3346
050,34,039,"New Jersey","Union County",2,27,6875,3456,3419
050,34,039,"New Jersey","Union County",2,28,6991,3511,3480
050,34,039,"New Jersey","Union County",2,29,7131,3577,3554
050,34,039,"New Jersey","Union County",2,30,7332,3689,3643
050,34,039,"New Jersey","Union County",2,31,7307,3702,3605
050,34,039,"New Jersey","Union County",2,32,7386,3756,3630
050,34,039,"New Jersey","Union County",2,33,7502,3788,3714
050,34,039,"New Jersey","Union County",2,34,7743,3849,3894
050,34,039,"New Jersey","Union County",2,35,7893,3977,3916
050,34,039,"New Jersey","Union County",2,36,7768,3893,3875
050,34,039,"New Jersey","Union County",2,37,7970,4020,3950
050,34,039,"New Jersey","Union County",2,38,8086,4045,4041
050,34,039,"New Jersey","Union County",2,39,8183,4079,4104
050,34,039,"New Jersey","Union County",2,40,8354,4205,4149
050,34,039,"New Jersey","Union County",2,41,8087,4005,4082
050,34,039,"New Jersey","Union County",2,42,8052,4013,4039
050,34,039,"New Jersey","Union County",2,43,7894,3915,3979
050,34,039,"New Jersey","Union County",2,44,7654,3817,3837
050,34,039,"New Jersey","Union County",2,45,7789,3934,3855
050,34,039,"New Jersey","Union County",2,46,7668,3914,3754
050,34,039,"New Jersey","Union County",2,47,7727,3938,3789
050,34,039,"New Jersey","Union County",2,48,7924,3987,3937
050,34,039,"New Jersey","Union County",2,49,8232,4127,4105
050,34,039,"New Jersey","Union County",2,50,8225,4116,4109
050,34,039,"New Jersey","Union County",2,51,8057,4019,4038
050,34,039,"New Jersey","Union County",2,52,8014,3933,4081
050,34,039,"New Jersey","Union County",2,53,8041,3927,4114
050,34,039,"New Jersey","Union County",2,54,8066,3990,4076
050,34,039,"New Jersey","Union County",2,55,8200,4077,4123
050,34,039,"New Jersey","Union County",2,56,8269,4095,4174
050,34,039,"New Jersey","Union County",2,57,8111,4003,4108
050,34,039,"New Jersey","Union County",2,58,8015,3966,4049
050,34,039,"New Jersey","Union County",2,59,7844,3846,3998
050,34,039,"New Jersey","Union County",2,60,7719,3850,3869
050,34,039,"New Jersey","Union County",2,61,7429,3690,3739
050,34,039,"New Jersey","Union County",2,62,7222,3577,3645
050,34,039,"New Jersey","Union County",2,63,6958,3390,3568
050,34,039,"New Jersey","Union County",2,64,6473,3083,3390
050,34,039,"New Jersey","Union County",2,65,6091,2857,3234
050,34,039,"New Jersey","Union County",2,66,5760,2715,3045
050,34,039,"New Jersey","Union County",2,67,5477,2587,2890
050,34,039,"New Jersey","Union County",2,68,5159,2398,2761
050,34,039,"New Jersey","Union County",2,69,4903,2291,2612
050,34,039,"New Jersey","Union County",2,70,4638,2137,2501
050,34,039,"New Jersey","Union County",2,71,4431,1999,2432
050,34,039,"New Jersey","Union County",2,72,4300,1963,2337
050,34,039,"New Jersey","Union County",2,73,4547,2051,2496
050,34,039,"New Jersey","Union County",2,74,3388,1478,1910
050,34,039,"New Jersey","Union County",2,75,3143,1388,1755
050,34,039,"New Jersey","Union County",2,76,3022,1370,1652
050,34,039,"New Jersey","Union County",2,77,3018,1312,1706
050,34,039,"New Jersey","Union County",2,78,2611,1085,1526
050,34,039,"New Jersey","Union County",2,79,2354,948,1406
050,34,039,"New Jersey","Union County",2,80,2206,915,1291
050,34,039,"New Jersey","Union County",2,81,2008,825,1183
050,34,039,"New Jersey","Union County",2,82,1884,754,1130
050,34,039,"New Jersey","Union County",2,83,1729,665,1064
050,34,039,"New Jersey","Union County",2,84,1571,596,975
050,34,039,"New Jersey","Union County",2,85,10349,3446,6903
050,34,039,"New Jersey","Union County",3,0,6397,3331,3066
050,34,039,"New Jersey","Union County",3,1,6793,3463,3330
050,34,039,"New Jersey","Union County",3,2,7192,3710,3482
050,34,039,"New Jersey","Union County",3,3,7351,3803,3548
050,34,039,"New Jersey","Union County",3,4,7446,3855,3591
050,34,039,"New Jersey","Union County",3,5,7495,3840,3655
050,34,039,"New Jersey","Union County",3,6,7420,3755,3665
050,34,039,"New Jersey","Union County",3,7,7342,3742,3600
050,34,039,"New Jersey","Union County",3,8,7327,3713,3614
050,34,039,"New Jersey","Union County",3,9,7372,3732,3640
050,34,039,"New Jersey","Union County",3,10,7588,3836,3752
050,34,039,"New Jersey","Union County",3,11,7777,3921,3856
050,34,039,"New Jersey","Union County",3,12,7786,3999,3787
050,34,039,"New Jersey","Union County",3,13,8019,4105,3914
050,34,039,"New Jersey","Union County",3,14,7985,4084,3901
050,34,039,"New Jersey","Union County",3,15,7843,4019,3824
050,34,039,"New Jersey","Union County",3,16,7775,3948,3827
050,34,039,"New Jersey","Union County",3,17,7650,3896,3754
050,34,039,"New Jersey","Union County",3,18,7075,3669,3406
050,34,039,"New Jersey","Union County",3,19,6352,3255,3097
050,34,039,"New Jersey","Union County",3,20,6668,3410,3258
050,34,039,"New Jersey","Union County",3,21,6762,3484,3278
050,34,039,"New Jersey","Union County",3,22,6780,3411,3369
050,34,039,"New Jersey","Union County",3,23,6807,3435,3372
050,34,039,"New Jersey","Union County",3,24,6759,3396,3363
050,34,039,"New Jersey","Union County",3,25,6620,3279,3341
050,34,039,"New Jersey","Union County",3,26,6697,3373,3324
050,34,039,"New Jersey","Union County",3,27,6743,3391,3352
050,34,039,"New Jersey","Union County",3,28,6923,3472,3451
050,34,039,"New Jersey","Union County",3,29,7047,3526,3521
050,34,039,"New Jersey","Union County",3,30,7136,3573,3563
050,34,039,"New Jersey","Union County",3,31,7478,3728,3750
050,34,039,"New Jersey","Union County",3,32,7507,3812,3695
050,34,039,"New Jersey","Union County",3,33,7619,3890,3729
050,34,039,"New Jersey","Union County",3,34,7657,3850,3807
050,34,039,"New Jersey","Union County",3,35,7766,3827,3939
050,34,039,"New Jersey","Union County",3,36,8000,4032,3968
050,34,039,"New Jersey","Union County",3,37,7901,3965,3936
050,34,039,"New Jersey","Union County",3,38,8100,4096,4004
050,34,039,"New Jersey","Union County",3,39,8137,4092,4045
050,34,039,"New Jersey","Union County",3,40,8265,4114,4151
050,34,039,"New Jersey","Union County",3,41,8442,4255,4187
050,34,039,"New Jersey","Union County",3,42,8021,3968,4053
050,34,039,"New Jersey","Union County",3,43,8084,4012,4072
050,34,039,"New Jersey","Union County",3,44,7838,3897,3941
050,34,039,"New Jersey","Union County",3,45,7658,3823,3835
050,34,039,"New Jersey","Union County",3,46,7775,3934,3841
050,34,039,"New Jersey","Union County",3,47,7606,3900,3706
050,34,039,"New Jersey","Union County",3,48,7629,3882,3747
050,34,039,"New Jersey","Union County",3,49,7858,3943,3915
050,34,039,"New Jersey","Union County",3,50,8225,4153,4072
050,34,039,"New Jersey","Union County",3,51,8164,4073,4091
050,34,039,"New Jersey","Union County",3,52,7918,3931,3987
050,34,039,"New Jersey","Union County",3,53,7878,3868,4010
050,34,039,"New Jersey","Union County",3,54,7922,3881,4041
050,34,039,"New Jersey","Union County",3,55,7888,3903,3985
050,34,039,"New Jersey","Union County",3,56,8018,3996,4022
050,34,039,"New Jersey","Union County",3,57,8130,4017,4113
050,34,039,"New Jersey","Union County",3,58,7898,3869,4029
050,34,039,"New Jersey","Union County",3,59,7793,3846,3947
050,34,039,"New Jersey","Union County",3,60,7652,3747,3905
050,34,039,"New Jersey","Union County",3,61,7493,3734,3759
050,34,039,"New Jersey","Union County",3,62,7155,3542,3613
050,34,039,"New Jersey","Union County",3,63,6997,3450,3547
050,34,039,"New Jersey","Union County",3,64,6768,3291,3477
050,34,039,"New Jersey","Union County",3,65,6276,2973,3303
050,34,039,"New Jersey","Union County",3,66,5884,2749,3135
050,34,039,"New Jersey","Union County",3,67,5602,2621,2981
050,34,039,"New Jersey","Union County",3,68,5274,2478,2796
050,34,039,"New Jersey","Union County",3,69,5007,2299,2708
050,34,039,"New Jersey","Union County",3,70,4729,2206,2523
050,34,039,"New Jersey","Union County",3,71,4490,2057,2433
050,34,039,"New Jersey","Union County",3,72,4321,1950,2371
050,34,039,"New Jersey","Union County",3,73,4162,1879,2283
050,34,039,"New Jersey","Union County",3,74,4406,1983,2423
050,34,039,"New Jersey","Union County",3,75,3297,1425,1872
050,34,039,"New Jersey","Union County",3,76,3030,1337,1693
050,34,039,"New Jersey","Union County",3,77,2904,1296,1608
050,34,039,"New Jersey","Union County",3,78,2902,1264,1638
050,34,039,"New Jersey","Union County",3,79,2527,1034,1493
050,34,039,"New Jersey","Union County",3,80,2245,889,1356
050,34,039,"New Jersey","Union County",3,81,2064,852,1212
050,34,039,"New Jersey","Union County",3,82,1875,747,1128
050,34,039,"New Jersey","Union County",3,83,1741,695,1046
050,34,039,"New Jersey","Union County",3,84,1604,594,1010
050,34,039,"New Jersey","Union County",3,85,10326,3470,6856
050,34,039,"New Jersey","Union County",4,0,6657,3435,3222
050,34,039,"New Jersey","Union County",4,1,6480,3380,3100
050,34,039,"New Jersey","Union County",4,2,6907,3560,3347
050,34,039,"New Jersey","Union County",4,3,7321,3744,3577
050,34,039,"New Jersey","Union County",4,4,7388,3849,3539
050,34,039,"New Jersey","Union County",4,5,7518,3897,3621
050,34,039,"New Jersey","Union County",4,6,7519,3856,3663
050,34,039,"New Jersey","Union County",4,7,7407,3777,3630
050,34,039,"New Jersey","Union County",4,8,7322,3730,3592
050,34,039,"New Jersey","Union County",4,9,7356,3728,3628
050,34,039,"New Jersey","Union County",4,10,7369,3723,3646
050,34,039,"New Jersey","Union County",4,11,7550,3840,3710
050,34,039,"New Jersey","Union County",4,12,7748,3901,3847
050,34,039,"New Jersey","Union County",4,13,7723,3964,3759
050,34,039,"New Jersey","Union County",4,14,7929,4044,3885
050,34,039,"New Jersey","Union County",4,15,7976,4086,3890
050,34,039,"New Jersey","Union County",4,16,7889,4029,3860
050,34,039,"New Jersey","Union County",4,17,7751,3961,3790
050,34,039,"New Jersey","Union County",4,18,7011,3595,3416
050,34,039,"New Jersey","Union County",4,19,6291,3258,3033
050,34,039,"New Jersey","Union County",4,20,6448,3286,3162
050,34,039,"New Jersey","Union County",4,21,6771,3461,3310
050,34,039,"New Jersey","Union County",4,22,6831,3541,3290
050,34,039,"New Jersey","Union County",4,23,6763,3402,3361
050,34,039,"New Jersey","Union County",4,24,6613,3352,3261
050,34,039,"New Jersey","Union County",4,25,6629,3333,3296
050,34,039,"New Jersey","Union County",4,26,6450,3206,3244
050,34,039,"New Jersey","Union County",4,27,6529,3283,3246
050,34,039,"New Jersey","Union County",4,28,6636,3316,3320
050,34,039,"New Jersey","Union County",4,29,6901,3450,3451
050,34,039,"New Jersey","Union County",4,30,7098,3576,3522
050,34,039,"New Jersey","Union County",4,31,7241,3599,3642
050,34,039,"New Jersey","Union County",4,32,7505,3724,3781
050,34,039,"New Jersey","Union County",4,33,7627,3850,3777
050,34,039,"New Jersey","Union County",4,34,7657,3939,3718
050,34,039,"New Jersey","Union County",4,35,7780,3900,3880
050,34,039,"New Jersey","Union County",4,36,7796,3828,3968
050,34,039,"New Jersey","Union County",4,37,8086,4057,4029
050,34,039,"New Jersey","Union County",4,38,8025,3988,4037
050,34,039,"New Jersey","Union County",4,39,8177,4134,4043
050,34,039,"New Jersey","Union County",4,40,8150,4129,4021
050,34,039,"New Jersey","Union County",4,41,8265,4131,4134
050,34,039,"New Jersey","Union County",4,42,8375,4234,4141
050,34,039,"New Jersey","Union County",4,43,8005,3961,4044
050,34,039,"New Jersey","Union County",4,44,8049,4012,4037
050,34,039,"New Jersey","Union County",4,45,7793,3882,3911
050,34,039,"New Jersey","Union County",4,46,7565,3775,3790
050,34,039,"New Jersey","Union County",4,47,7642,3867,3775
050,34,039,"New Jersey","Union County",4,48,7521,3816,3705
050,34,039,"New Jersey","Union County",4,49,7531,3800,3731
050,34,039,"New Jersey","Union County",4,50,7747,3882,3865
050,34,039,"New Jersey","Union County",4,51,8177,4131,4046
050,34,039,"New Jersey","Union County",4,52,8043,4023,4020
050,34,039,"New Jersey","Union County",4,53,7798,3861,3937
050,34,039,"New Jersey","Union County",4,54,7708,3807,3901
050,34,039,"New Jersey","Union County",4,55,7739,3802,3937
050,34,039,"New Jersey","Union County",4,56,7723,3818,3905
050,34,039,"New Jersey","Union County",4,57,7814,3882,3932
050,34,039,"New Jersey","Union County",4,58,7899,3882,4017
050,34,039,"New Jersey","Union County",4,59,7660,3767,3893
050,34,039,"New Jersey","Union County",4,60,7572,3759,3813
050,34,039,"New Jersey","Union County",4,61,7391,3612,3779
050,34,039,"New Jersey","Union County",4,62,7231,3606,3625
050,34,039,"New Jersey","Union County",4,63,6950,3409,3541
050,34,039,"New Jersey","Union County",4,64,6759,3314,3445
050,34,039,"New Jersey","Union County",4,65,6603,3204,3399
050,34,039,"New Jersey","Union County",4,66,6058,2872,3186
050,34,039,"New Jersey","Union County",4,67,5644,2615,3029
050,34,039,"New Jersey","Union County",4,68,5371,2514,2857
050,34,039,"New Jersey","Union County",4,69,5100,2390,2710
050,34,039,"New Jersey","Union County",4,70,4815,2177,2638
050,34,039,"New Jersey","Union County",4,71,4561,2110,2451
050,34,039,"New Jersey","Union County",4,72,4342,2000,2342
050,34,039,"New Jersey","Union County",4,73,4143,1844,2299
050,34,039,"New Jersey","Union County",4,74,4030,1802,2228
050,34,039,"New Jersey","Union County",4,75,4250,1900,2350
050,34,039,"New Jersey","Union County",4,76,3189,1373,1816
050,34,039,"New Jersey","Union County",4,77,2908,1261,1647
050,34,039,"New Jersey","Union County",4,78,2784,1249,1535
050,34,039,"New Jersey","Union County",4,79,2795,1198,1597
050,34,039,"New Jersey","Union County",4,80,2402,967,1435
050,34,039,"New Jersey","Union County",4,81,2121,835,1286
050,34,039,"New Jersey","Union County",4,82,1935,785,1150
050,34,039,"New Jersey","Union County",4,83,1728,681,1047
050,34,039,"New Jersey","Union County",4,84,1601,616,985
050,34,039,"New Jersey","Union County",4,85,10255,3448,6807
050,34,039,"New Jersey","Union County",5,0,6649,3442,3207
050,34,039,"New Jersey","Union County",5,1,6934,3563,3371
050,34,039,"New Jersey","Union County",5,2,6596,3454,3142
050,34,039,"New Jersey","Union County",5,3,7058,3636,3422
050,34,039,"New Jersey","Union County",5,4,7470,3859,3611
050,34,039,"New Jersey","Union County",5,5,7461,3843,3618
050,34,039,"New Jersey","Union County",5,6,7510,3915,3595
050,34,039,"New Jersey","Union County",5,7,7555,3885,3670
050,34,039,"New Jersey","Union County",5,8,7414,3791,3623
050,34,039,"New Jersey","Union County",5,9,7331,3776,3555
050,34,039,"New Jersey","Union County",5,10,7358,3753,3605
050,34,039,"New Jersey","Union County",5,11,7408,3735,3673
050,34,039,"New Jersey","Union County",5,12,7580,3827,3753
050,34,039,"New Jersey","Union County",5,13,7762,3883,3879
050,34,039,"New Jersey","Union County",5,14,7698,3926,3772
050,34,039,"New Jersey","Union County",5,15,7950,4032,3918
050,34,039,"New Jersey","Union County",5,16,8052,4116,3936
050,34,039,"New Jersey","Union County",5,17,7857,3999,3858
050,34,039,"New Jersey","Union County",5,18,7105,3656,3449
050,34,039,"New Jersey","Union County",5,19,6359,3270,3089
050,34,039,"New Jersey","Union County",5,20,6563,3351,3212
050,34,039,"New Jersey","Union County",5,21,6600,3365,3235
050,34,039,"New Jersey","Union County",5,22,6937,3540,3397
050,34,039,"New Jersey","Union County",5,23,6910,3572,3338
050,34,039,"New Jersey","Union County",5,24,6774,3460,3314
050,34,039,"New Jersey","Union County",5,25,6560,3342,3218
050,34,039,"New Jersey","Union County",5,26,6631,3348,3283
050,34,039,"New Jersey","Union County",5,27,6466,3189,3277
050,34,039,"New Jersey","Union County",5,28,6586,3306,3280
050,34,039,"New Jersey","Union County",5,29,6731,3368,3363
050,34,039,"New Jersey","Union County",5,30,7039,3551,3488
050,34,039,"New Jersey","Union County",5,31,7207,3641,3566
050,34,039,"New Jersey","Union County",5,32,7353,3647,3706
050,34,039,"New Jersey","Union County",5,33,7696,3819,3877
050,34,039,"New Jersey","Union County",5,34,7898,4014,3884
050,34,039,"New Jersey","Union County",5,35,7849,4095,3754
050,34,039,"New Jersey","Union County",5,36,7988,4020,3968
050,34,039,"New Jersey","Union County",5,37,7867,3843,4024
050,34,039,"New Jersey","Union County",5,38,8198,4107,4091
050,34,039,"New Jersey","Union County",5,39,8094,4018,4076
050,34,039,"New Jersey","Union County",5,40,8271,4199,4072
050,34,039,"New Jersey","Union County",5,41,8123,4120,4003
050,34,039,"New Jersey","Union County",5,42,8179,4107,4072
050,34,039,"New Jersey","Union County",5,43,8372,4244,4128
050,34,039,"New Jersey","Union County",5,44,8091,4002,4089
050,34,039,"New Jersey","Union County",5,45,8003,3971,4032
050,34,039,"New Jersey","Union County",5,46,7751,3831,3920
050,34,039,"New Jersey","Union County",5,47,7457,3720,3737
050,34,039,"New Jersey","Union County",5,48,7560,3836,3724
050,34,039,"New Jersey","Union County",5,49,7503,3785,3718
050,34,039,"New Jersey","Union County",5,50,7477,3785,3692
050,34,039,"New Jersey","Union County",5,51,7667,3836,3831
050,34,039,"New Jersey","Union County",5,52,8042,4044,3998
050,34,039,"New Jersey","Union County",5,53,7981,3975,4006
050,34,039,"New Jersey","Union County",5,54,7739,3891,3848
050,34,039,"New Jersey","Union County",5,55,7590,3714,3876
050,34,039,"New Jersey","Union County",5,56,7609,3746,3863
050,34,039,"New Jersey","Union County",5,57,7581,3749,3832
050,34,039,"New Jersey","Union County",5,58,7700,3828,3872
050,34,039,"New Jersey","Union County",5,59,7737,3795,3942
050,34,039,"New Jersey","Union County",5,60,7533,3688,3845
050,34,039,"New Jersey","Union County",5,61,7376,3641,3735
050,34,039,"New Jersey","Union County",5,62,7211,3511,3700
050,34,039,"New Jersey","Union County",5,63,7070,3517,3553
050,34,039,"New Jersey","Union County",5,64,6752,3310,3442
050,34,039,"New Jersey","Union County",5,65,6562,3191,3371
050,34,039,"New Jersey","Union County",5,66,6415,3100,3315
050,34,039,"New Jersey","Union County",5,67,5900,2776,3124
050,34,039,"New Jersey","Union County",5,68,5468,2532,2936
050,34,039,"New Jersey","Union County",5,69,5239,2448,2791
050,34,039,"New Jersey","Union County",5,70,4946,2297,2649
050,34,039,"New Jersey","Union County",5,71,4655,2100,2555
050,34,039,"New Jersey","Union County",5,72,4460,2061,2399
050,34,039,"New Jersey","Union County",5,73,4214,1921,2293
050,34,039,"New Jersey","Union County",5,74,4046,1785,2261
050,34,039,"New Jersey","Union County",5,75,3905,1732,2173
050,34,039,"New Jersey","Union County",5,76,4126,1841,2285
050,34,039,"New Jersey","Union County",5,77,3086,1310,1776
050,34,039,"New Jersey","Union County",5,78,2791,1215,1576
050,34,039,"New Jersey","Union County",5,79,2660,1175,1485
050,34,039,"New Jersey","Union County",5,80,2709,1148,1561
050,34,039,"New Jersey","Union County",5,81,2292,918,1374
050,34,039,"New Jersey","Union County",5,82,1987,759,1228
050,34,039,"New Jersey","Union County",5,83,1828,736,1092
050,34,039,"New Jersey","Union County",5,84,1595,616,979
050,34,039,"New Jersey","Union County",5,85,10413,3545,6868
050,34,041,"New Jersey","Warren County",1,0,1024,530,494
050,34,041,"New Jersey","Warren County",1,1,1046,556,490
050,34,041,"New Jersey","Warren County",1,2,1067,569,498
050,34,041,"New Jersey","Warren County",1,3,1026,505,521
050,34,041,"New Jersey","Warren County",1,4,1000,515,485
050,34,041,"New Jersey","Warren County",1,5,1037,545,492
050,34,041,"New Jersey","Warren County",1,6,1112,574,538
050,34,041,"New Jersey","Warren County",1,7,1064,510,554
050,34,041,"New Jersey","Warren County",1,8,1121,547,574
050,34,041,"New Jersey","Warren County",1,9,1109,584,525
050,34,041,"New Jersey","Warren County",1,10,1214,622,592
050,34,041,"New Jersey","Warren County",1,11,1276,650,626
050,34,041,"New Jersey","Warren County",1,12,1347,694,653
050,34,041,"New Jersey","Warren County",1,13,1409,705,704
050,34,041,"New Jersey","Warren County",1,14,1401,706,695
050,34,041,"New Jersey","Warren County",1,15,1398,702,696
050,34,041,"New Jersey","Warren County",1,16,1443,711,732
050,34,041,"New Jersey","Warren County",1,17,1454,724,730
050,34,041,"New Jersey","Warren County",1,18,1330,695,635
050,34,041,"New Jersey","Warren County",1,19,1194,611,583
050,34,041,"New Jersey","Warren County",1,20,1257,632,625
050,34,041,"New Jersey","Warren County",1,21,1294,631,663
050,34,041,"New Jersey","Warren County",1,22,1258,643,615
050,34,041,"New Jersey","Warren County",1,23,1244,638,606
050,34,041,"New Jersey","Warren County",1,24,1244,623,621
050,34,041,"New Jersey","Warren County",1,25,1241,657,584
050,34,041,"New Jersey","Warren County",1,26,1263,656,607
050,34,041,"New Jersey","Warren County",1,27,1281,656,625
050,34,041,"New Jersey","Warren County",1,28,1261,656,605
050,34,041,"New Jersey","Warren County",1,29,1264,638,626
050,34,041,"New Jersey","Warren County",1,30,1242,652,590
050,34,041,"New Jersey","Warren County",1,31,1231,638,593
050,34,041,"New Jersey","Warren County",1,32,1190,619,571
050,34,041,"New Jersey","Warren County",1,33,1215,624,591
050,34,041,"New Jersey","Warren County",1,34,1245,636,609
050,34,041,"New Jersey","Warren County",1,35,1250,636,614
050,34,041,"New Jersey","Warren County",1,36,1246,636,610
050,34,041,"New Jersey","Warren County",1,37,1313,663,650
050,34,041,"New Jersey","Warren County",1,38,1287,636,651
050,34,041,"New Jersey","Warren County",1,39,1244,592,652
050,34,041,"New Jersey","Warren County",1,40,1292,650,642
050,34,041,"New Jersey","Warren County",1,41,1234,627,607
050,34,041,"New Jersey","Warren County",1,42,1303,666,637
050,34,041,"New Jersey","Warren County",1,43,1263,641,622
050,34,041,"New Jersey","Warren County",1,44,1249,631,618
050,34,041,"New Jersey","Warren County",1,45,1277,634,643
050,34,041,"New Jersey","Warren County",1,46,1273,646,627
050,34,041,"New Jersey","Warren County",1,47,1356,674,682
050,34,041,"New Jersey","Warren County",1,48,1545,756,789
050,34,041,"New Jersey","Warren County",1,49,1658,803,855
050,34,041,"New Jersey","Warren County",1,50,1677,838,839
050,34,041,"New Jersey","Warren County",1,51,1709,856,853
050,34,041,"New Jersey","Warren County",1,52,1679,849,830
050,34,041,"New Jersey","Warren County",1,53,1712,862,850
050,34,041,"New Jersey","Warren County",1,54,1833,916,917
050,34,041,"New Jersey","Warren County",1,55,1862,924,938
050,34,041,"New Jersey","Warren County",1,56,1889,946,943
050,34,041,"New Jersey","Warren County",1,57,1966,962,1004
050,34,041,"New Jersey","Warren County",1,58,1949,967,982
050,34,041,"New Jersey","Warren County",1,59,1865,936,929
050,34,041,"New Jersey","Warren County",1,60,1836,922,914
050,34,041,"New Jersey","Warren County",1,61,1820,920,900
050,34,041,"New Jersey","Warren County",1,62,1801,900,901
050,34,041,"New Jersey","Warren County",1,63,1689,816,873
050,34,041,"New Jersey","Warren County",1,64,1535,749,786
050,34,041,"New Jersey","Warren County",1,65,1451,720,731
050,34,041,"New Jersey","Warren County",1,66,1402,702,700
050,34,041,"New Jersey","Warren County",1,67,1318,642,676
050,34,041,"New Jersey","Warren County",1,68,1273,610,663
050,34,041,"New Jersey","Warren County",1,69,1199,584,615
050,34,041,"New Jersey","Warren County",1,70,1141,557,584
050,34,041,"New Jersey","Warren County",1,71,1101,528,573
050,34,041,"New Jersey","Warren County",1,72,1083,523,560
050,34,041,"New Jersey","Warren County",1,73,1123,513,610
050,34,041,"New Jersey","Warren County",1,74,748,333,415
050,34,041,"New Jersey","Warren County",1,75,752,350,402
050,34,041,"New Jersey","Warren County",1,76,802,359,443
050,34,041,"New Jersey","Warren County",1,77,838,369,469
050,34,041,"New Jersey","Warren County",1,78,670,297,373
050,34,041,"New Jersey","Warren County",1,79,584,265,319
050,34,041,"New Jersey","Warren County",1,80,532,232,300
050,34,041,"New Jersey","Warren County",1,81,485,225,260
050,34,041,"New Jersey","Warren County",1,82,469,205,264
050,34,041,"New Jersey","Warren County",1,83,411,162,249
050,34,041,"New Jersey","Warren County",1,84,389,155,234
050,34,041,"New Jersey","Warren County",1,85,2452,820,1632
050,34,041,"New Jersey","Warren County",2,0,1015,507,508
050,34,041,"New Jersey","Warren County",2,1,1048,554,494
050,34,041,"New Jersey","Warren County",2,2,1069,569,500
050,34,041,"New Jersey","Warren County",2,3,1037,522,515
050,34,041,"New Jersey","Warren County",2,4,1017,516,501
050,34,041,"New Jersey","Warren County",2,5,1035,539,496
050,34,041,"New Jersey","Warren County",2,6,1097,568,529
050,34,041,"New Jersey","Warren County",2,7,1076,525,551
050,34,041,"New Jersey","Warren County",2,8,1102,536,566
050,34,041,"New Jersey","Warren County",2,9,1115,575,540
050,34,041,"New Jersey","Warren County",2,10,1192,615,577
050,34,041,"New Jersey","Warren County",2,11,1255,642,613
050,34,041,"New Jersey","Warren County",2,12,1335,685,650
050,34,041,"New Jersey","Warren County",2,13,1392,701,691
050,34,041,"New Jersey","Warren County",2,14,1403,705,698
050,34,041,"New Jersey","Warren County",2,15,1406,706,700
050,34,041,"New Jersey","Warren County",2,16,1435,713,722
050,34,041,"New Jersey","Warren County",2,17,1449,719,730
050,34,041,"New Jersey","Warren County",2,18,1316,680,636
050,34,041,"New Jersey","Warren County",2,19,1188,608,580
050,34,041,"New Jersey","Warren County",2,20,1272,640,632
050,34,041,"New Jersey","Warren County",2,21,1293,633,660
050,34,041,"New Jersey","Warren County",2,22,1259,638,621
050,34,041,"New Jersey","Warren County",2,23,1244,635,609
050,34,041,"New Jersey","Warren County",2,24,1240,624,616
050,34,041,"New Jersey","Warren County",2,25,1243,646,597
050,34,041,"New Jersey","Warren County",2,26,1264,658,606
050,34,041,"New Jersey","Warren County",2,27,1279,660,619
050,34,041,"New Jersey","Warren County",2,28,1265,654,611
050,34,041,"New Jersey","Warren County",2,29,1265,644,621
050,34,041,"New Jersey","Warren County",2,30,1262,657,605
050,34,041,"New Jersey","Warren County",2,31,1237,644,593
050,34,041,"New Jersey","Warren County",2,32,1204,625,579
050,34,041,"New Jersey","Warren County",2,33,1216,626,590
050,34,041,"New Jersey","Warren County",2,34,1246,638,608
050,34,041,"New Jersey","Warren County",2,35,1264,646,618
050,34,041,"New Jersey","Warren County",2,36,1246,636,610
050,34,041,"New Jersey","Warren County",2,37,1306,660,646
050,34,041,"New Jersey","Warren County",2,38,1310,648,662
050,34,041,"New Jersey","Warren County",2,39,1264,609,655
050,34,041,"New Jersey","Warren County",2,40,1300,649,651
050,34,041,"New Jersey","Warren County",2,41,1245,631,614
050,34,041,"New Jersey","Warren County",2,42,1288,660,628
050,34,041,"New Jersey","Warren County",2,43,1278,650,628
050,34,041,"New Jersey","Warren County",2,44,1243,628,615
050,34,041,"New Jersey","Warren County",2,45,1267,630,637
050,34,041,"New Jersey","Warren County",2,46,1269,640,629
050,34,041,"New Jersey","Warren County",2,47,1336,668,668
050,34,041,"New Jersey","Warren County",2,48,1498,735,763
050,34,041,"New Jersey","Warren County",2,49,1639,797,842
050,34,041,"New Jersey","Warren County",2,50,1677,834,843
050,34,041,"New Jersey","Warren County",2,51,1691,848,843
050,34,041,"New Jersey","Warren County",2,52,1671,845,826
050,34,041,"New Jersey","Warren County",2,53,1703,858,845
050,34,041,"New Jersey","Warren County",2,54,1791,895,896
050,34,041,"New Jersey","Warren County",2,55,1843,917,926
050,34,041,"New Jersey","Warren County",2,56,1884,942,942
050,34,041,"New Jersey","Warren County",2,57,1947,958,989
050,34,041,"New Jersey","Warren County",2,58,1952,969,983
050,34,041,"New Jersey","Warren County",2,59,1885,943,942
050,34,041,"New Jersey","Warren County",2,60,1833,920,913
050,34,041,"New Jersey","Warren County",2,61,1812,913,899
050,34,041,"New Jersey","Warren County",2,62,1800,900,900
050,34,041,"New Jersey","Warren County",2,63,1725,838,887
050,34,041,"New Jersey","Warren County",2,64,1559,758,801
050,34,041,"New Jersey","Warren County",2,65,1464,724,740
050,34,041,"New Jersey","Warren County",2,66,1413,705,708
050,34,041,"New Jersey","Warren County",2,67,1324,648,676
050,34,041,"New Jersey","Warren County",2,68,1272,614,658
050,34,041,"New Jersey","Warren County",2,69,1211,585,626
050,34,041,"New Jersey","Warren County",2,70,1147,560,587
050,34,041,"New Jersey","Warren County",2,71,1104,533,571
050,34,041,"New Jersey","Warren County",2,72,1065,513,552
050,34,041,"New Jersey","Warren County",2,73,1154,536,618
050,34,041,"New Jersey","Warren County",2,74,777,345,432
050,34,041,"New Jersey","Warren County",2,75,750,347,403
050,34,041,"New Jersey","Warren County",2,76,769,347,422
050,34,041,"New Jersey","Warren County",2,77,834,364,470
050,34,041,"New Jersey","Warren County",2,78,685,305,380
050,34,041,"New Jersey","Warren County",2,79,592,263,329
050,34,041,"New Jersey","Warren County",2,80,534,235,299
050,34,041,"New Jersey","Warren County",2,81,477,216,261
050,34,041,"New Jersey","Warren County",2,82,467,207,260
050,34,041,"New Jersey","Warren County",2,83,411,165,246
050,34,041,"New Jersey","Warren County",2,84,379,150,229
050,34,041,"New Jersey","Warren County",2,85,2394,809,1585
050,34,041,"New Jersey","Warren County",3,0,945,478,467
050,34,041,"New Jersey","Warren County",3,1,1027,501,526
050,34,041,"New Jersey","Warren County",3,2,1097,584,513
050,34,041,"New Jersey","Warren County",3,3,1134,602,532
050,34,041,"New Jersey","Warren County",3,4,1061,548,513
050,34,041,"New Jersey","Warren County",3,5,1041,528,513
050,34,041,"New Jersey","Warren County",3,6,1076,558,518
050,34,041,"New Jersey","Warren County",3,7,1140,600,540
050,34,041,"New Jersey","Warren County",3,8,1131,550,581
050,34,041,"New Jersey","Warren County",3,9,1137,549,588
050,34,041,"New Jersey","Warren County",3,10,1142,588,554
050,34,041,"New Jersey","Warren County",3,11,1226,629,597
050,34,041,"New Jersey","Warren County",3,12,1278,650,628
050,34,041,"New Jersey","Warren County",3,13,1354,701,653
050,34,041,"New Jersey","Warren County",3,14,1409,709,700
050,34,041,"New Jersey","Warren County",3,15,1406,696,710
050,34,041,"New Jersey","Warren County",3,16,1401,705,696
050,34,041,"New Jersey","Warren County",3,17,1415,704,711
050,34,041,"New Jersey","Warren County",3,18,1283,645,638
050,34,041,"New Jersey","Warren County",3,19,1102,563,539
050,34,041,"New Jersey","Warren County",3,20,1211,629,582
050,34,041,"New Jersey","Warren County",3,21,1300,660,640
050,34,041,"New Jersey","Warren County",3,22,1255,625,630
050,34,041,"New Jersey","Warren County",3,23,1249,647,602
050,34,041,"New Jersey","Warren County",3,24,1251,637,614
050,34,041,"New Jersey","Warren County",3,25,1214,607,607
050,34,041,"New Jersey","Warren County",3,26,1260,658,602
050,34,041,"New Jersey","Warren County",3,27,1297,689,608
050,34,041,"New Jersey","Warren County",3,28,1344,687,657
050,34,041,"New Jersey","Warren County",3,29,1311,678,633
050,34,041,"New Jersey","Warren County",3,30,1348,678,670
050,34,041,"New Jersey","Warren County",3,31,1331,700,631
050,34,041,"New Jersey","Warren County",3,32,1299,660,639
050,34,041,"New Jersey","Warren County",3,33,1268,658,610
050,34,041,"New Jersey","Warren County",3,34,1310,683,627
050,34,041,"New Jersey","Warren County",3,35,1293,649,644
050,34,041,"New Jersey","Warren County",3,36,1314,663,651
050,34,041,"New Jersey","Warren County",3,37,1292,649,643
050,34,041,"New Jersey","Warren County",3,38,1390,708,682
050,34,041,"New Jersey","Warren County",3,39,1343,662,681
050,34,041,"New Jersey","Warren County",3,40,1342,653,689
050,34,041,"New Jersey","Warren County",3,41,1319,673,646
050,34,041,"New Jersey","Warren County",3,42,1307,674,633
050,34,041,"New Jersey","Warren County",3,43,1283,645,638
050,34,041,"New Jersey","Warren County",3,44,1296,659,637
050,34,041,"New Jersey","Warren County",3,45,1250,629,621
050,34,041,"New Jersey","Warren County",3,46,1299,646,653
050,34,041,"New Jersey","Warren County",3,47,1304,659,645
050,34,041,"New Jersey","Warren County",3,48,1364,689,675
050,34,041,"New Jersey","Warren County",3,49,1513,742,771
050,34,041,"New Jersey","Warren County",3,50,1642,809,833
050,34,041,"New Jersey","Warren County",3,51,1665,815,850
050,34,041,"New Jersey","Warren County",3,52,1672,839,833
050,34,041,"New Jersey","Warren County",3,53,1679,855,824
050,34,041,"New Jersey","Warren County",3,54,1700,854,846
050,34,041,"New Jersey","Warren County",3,55,1764,889,875
050,34,041,"New Jersey","Warren County",3,56,1829,919,910
050,34,041,"New Jersey","Warren County",3,57,1859,928,931
050,34,041,"New Jersey","Warren County",3,58,1920,947,973
050,34,041,"New Jersey","Warren County",3,59,1930,952,978
050,34,041,"New Jersey","Warren County",3,60,1886,942,944
050,34,041,"New Jersey","Warren County",3,61,1793,907,886
050,34,041,"New Jersey","Warren County",3,62,1802,897,905
050,34,041,"New Jersey","Warren County",3,63,1761,872,889
050,34,041,"New Jersey","Warren County",3,64,1707,827,880
050,34,041,"New Jersey","Warren County",3,65,1540,752,788
050,34,041,"New Jersey","Warren County",3,66,1456,715,741
050,34,041,"New Jersey","Warren County",3,67,1386,682,704
050,34,041,"New Jersey","Warren County",3,68,1329,651,678
050,34,041,"New Jersey","Warren County",3,69,1240,591,649
050,34,041,"New Jersey","Warren County",3,70,1205,583,622
050,34,041,"New Jersey","Warren County",3,71,1117,546,571
050,34,041,"New Jersey","Warren County",3,72,1095,534,561
050,34,041,"New Jersey","Warren County",3,73,1055,511,544
050,34,041,"New Jersey","Warren County",3,74,1138,520,618
050,34,041,"New Jersey","Warren County",3,75,744,319,425
050,34,041,"New Jersey","Warren County",3,76,735,337,398
050,34,041,"New Jersey","Warren County",3,77,747,335,412
050,34,041,"New Jersey","Warren County",3,78,808,357,451
050,34,041,"New Jersey","Warren County",3,79,650,287,363
050,34,041,"New Jersey","Warren County",3,80,568,256,312
050,34,041,"New Jersey","Warren County",3,81,517,226,291
050,34,041,"New Jersey","Warren County",3,82,467,205,262
050,34,041,"New Jersey","Warren County",3,83,435,191,244
050,34,041,"New Jersey","Warren County",3,84,381,153,228
050,34,041,"New Jersey","Warren County",3,85,2383,808,1575
050,34,041,"New Jersey","Warren County",4,0,1016,490,526
050,34,041,"New Jersey","Warren County",4,1,968,497,471
050,34,041,"New Jersey","Warren County",4,2,1060,509,551
050,34,041,"New Jersey","Warren County",4,3,1135,606,529
050,34,041,"New Jersey","Warren County",4,4,1175,619,556
050,34,041,"New Jersey","Warren County",4,5,1083,559,524
050,34,041,"New Jersey","Warren County",4,6,1065,546,519
050,34,041,"New Jersey","Warren County",4,7,1096,562,534
050,34,041,"New Jersey","Warren County",4,8,1159,612,547
050,34,041,"New Jersey","Warren County",4,9,1155,563,592
050,34,041,"New Jersey","Warren County",4,10,1149,568,581
050,34,041,"New Jersey","Warren County",4,11,1187,611,576
050,34,041,"New Jersey","Warren County",4,12,1232,638,594
050,34,041,"New Jersey","Warren County",4,13,1289,664,625
050,34,041,"New Jersey","Warren County",4,14,1363,708,655
050,34,041,"New Jersey","Warren County",4,15,1427,716,711
050,34,041,"New Jersey","Warren County",4,16,1403,691,712
050,34,041,"New Jersey","Warren County",4,17,1392,704,688
050,34,041,"New Jersey","Warren County",4,18,1267,651,616
050,34,041,"New Jersey","Warren County",4,19,1063,525,538
050,34,041,"New Jersey","Warren County",4,20,1170,592,578
050,34,041,"New Jersey","Warren County",4,21,1241,639,602
050,34,041,"New Jersey","Warren County",4,22,1346,671,675
050,34,041,"New Jersey","Warren County",4,23,1233,615,618
050,34,041,"New Jersey","Warren County",4,24,1199,630,569
050,34,041,"New Jersey","Warren County",4,25,1243,655,588
050,34,041,"New Jersey","Warren County",4,26,1185,589,596
050,34,041,"New Jersey","Warren County",4,27,1271,649,622
050,34,041,"New Jersey","Warren County",4,28,1338,715,623
050,34,041,"New Jersey","Warren County",4,29,1345,685,660
050,34,041,"New Jersey","Warren County",4,30,1314,677,637
050,34,041,"New Jersey","Warren County",4,31,1407,708,699
050,34,041,"New Jersey","Warren County",4,32,1375,718,657
050,34,041,"New Jersey","Warren County",4,33,1335,684,651
050,34,041,"New Jersey","Warren County",4,34,1316,680,636
050,34,041,"New Jersey","Warren County",4,35,1319,677,642
050,34,041,"New Jersey","Warren County",4,36,1324,668,656
050,34,041,"New Jersey","Warren County",4,37,1344,675,669
050,34,041,"New Jersey","Warren County",4,38,1335,662,673
050,34,041,"New Jersey","Warren County",4,39,1413,727,686
050,34,041,"New Jersey","Warren County",4,40,1382,690,692
050,34,041,"New Jersey","Warren County",4,41,1353,665,688
050,34,041,"New Jersey","Warren County",4,42,1364,703,661
050,34,041,"New Jersey","Warren County",4,43,1296,665,631
050,34,041,"New Jersey","Warren County",4,44,1308,657,651
050,34,041,"New Jersey","Warren County",4,45,1316,678,638
050,34,041,"New Jersey","Warren County",4,46,1291,670,621
050,34,041,"New Jersey","Warren County",4,47,1302,636,666
050,34,041,"New Jersey","Warren County",4,48,1306,658,648
050,34,041,"New Jersey","Warren County",4,49,1363,678,685
050,34,041,"New Jersey","Warren County",4,50,1519,755,764
050,34,041,"New Jersey","Warren County",4,51,1632,801,831
050,34,041,"New Jersey","Warren County",4,52,1627,802,825
050,34,041,"New Jersey","Warren County",4,53,1665,824,841
050,34,041,"New Jersey","Warren County",4,54,1683,855,828
050,34,041,"New Jersey","Warren County",4,55,1678,841,837
050,34,041,"New Jersey","Warren County",4,56,1792,901,891
050,34,041,"New Jersey","Warren County",4,57,1790,904,886
050,34,041,"New Jersey","Warren County",4,58,1837,922,915
050,34,041,"New Jersey","Warren County",4,59,1894,938,956
050,34,041,"New Jersey","Warren County",4,60,1896,929,967
050,34,041,"New Jersey","Warren County",4,61,1829,912,917
050,34,041,"New Jersey","Warren County",4,62,1763,883,880
050,34,041,"New Jersey","Warren County",4,63,1762,867,895
050,34,041,"New Jersey","Warren County",4,64,1709,858,851
050,34,041,"New Jersey","Warren County",4,65,1685,814,871
050,34,041,"New Jersey","Warren County",4,66,1514,738,776
050,34,041,"New Jersey","Warren County",4,67,1415,681,734
050,34,041,"New Jersey","Warren County",4,68,1348,664,684
050,34,041,"New Jersey","Warren County",4,69,1313,639,674
050,34,041,"New Jersey","Warren County",4,70,1205,569,636
050,34,041,"New Jersey","Warren County",4,71,1185,564,621
050,34,041,"New Jersey","Warren County",4,72,1117,551,566
050,34,041,"New Jersey","Warren County",4,73,1074,528,546
050,34,041,"New Jersey","Warren County",4,74,1042,503,539
050,34,041,"New Jersey","Warren County",4,75,1105,499,606
050,34,041,"New Jersey","Warren County",4,76,724,305,419
050,34,041,"New Jersey","Warren County",4,77,713,327,386
050,34,041,"New Jersey","Warren County",4,78,735,328,407
050,34,041,"New Jersey","Warren County",4,79,774,332,442
050,34,041,"New Jersey","Warren County",4,80,618,269,349
050,34,041,"New Jersey","Warren County",4,81,534,242,292
050,34,041,"New Jersey","Warren County",4,82,485,202,283
050,34,041,"New Jersey","Warren County",4,83,424,191,233
050,34,041,"New Jersey","Warren County",4,84,400,176,224
050,34,041,"New Jersey","Warren County",4,85,2399,815,1584
050,34,041,"New Jersey","Warren County",5,0,1014,487,527
050,34,041,"New Jersey","Warren County",5,1,1046,514,532
050,34,041,"New Jersey","Warren County",5,2,990,496,494
050,34,041,"New Jersey","Warren County",5,3,1112,539,573
050,34,041,"New Jersey","Warren County",5,4,1160,616,544
050,34,041,"New Jersey","Warren County",5,5,1201,625,576
050,34,041,"New Jersey","Warren County",5,6,1135,592,543
050,34,041,"New Jersey","Warren County",5,7,1086,546,540
050,34,041,"New Jersey","Warren County",5,8,1121,574,547
050,34,041,"New Jersey","Warren County",5,9,1199,627,572
050,34,041,"New Jersey","Warren County",5,10,1183,583,600
050,34,041,"New Jersey","Warren County",5,11,1181,582,599
050,34,041,"New Jersey","Warren County",5,12,1191,615,576
050,34,041,"New Jersey","Warren County",5,13,1222,635,587
050,34,041,"New Jersey","Warren County",5,14,1302,669,633
050,34,041,"New Jersey","Warren County",5,15,1400,724,676
050,34,041,"New Jersey","Warren County",5,16,1411,704,707
050,34,041,"New Jersey","Warren County",5,17,1436,722,714
050,34,041,"New Jersey","Warren County",5,18,1222,631,591
050,34,041,"New Jersey","Warren County",5,19,1080,547,533
050,34,041,"New Jersey","Warren County",5,20,1138,549,589
050,34,041,"New Jersey","Warren County",5,21,1220,604,616
050,34,041,"New Jersey","Warren County",5,22,1276,657,619
050,34,041,"New Jersey","Warren County",5,23,1300,663,637
050,34,041,"New Jersey","Warren County",5,24,1250,619,631
050,34,041,"New Jersey","Warren County",5,25,1148,592,556
050,34,041,"New Jersey","Warren County",5,26,1209,629,580
050,34,041,"New Jersey","Warren County",5,27,1167,576,591
050,34,041,"New Jersey","Warren County",5,28,1273,653,620
050,34,041,"New Jersey","Warren County",5,29,1336,697,639
050,34,041,"New Jersey","Warren County",5,30,1349,701,648
050,34,041,"New Jersey","Warren County",5,31,1340,691,649
050,34,041,"New Jersey","Warren County",5,32,1415,720,695
050,34,041,"New Jersey","Warren County",5,33,1394,715,679
050,34,041,"New Jersey","Warren County",5,34,1384,699,685
050,34,041,"New Jersey","Warren County",5,35,1334,693,641
050,34,041,"New Jersey","Warren County",5,36,1365,694,671
050,34,041,"New Jersey","Warren County",5,37,1376,687,689
050,34,041,"New Jersey","Warren County",5,38,1412,708,704
050,34,041,"New Jersey","Warren County",5,39,1376,684,692
050,34,041,"New Jersey","Warren County",5,40,1455,749,706
050,34,041,"New Jersey","Warren County",5,41,1366,677,689
050,34,041,"New Jersey","Warren County",5,42,1417,710,707
050,34,041,"New Jersey","Warren County",5,43,1385,726,659
050,34,041,"New Jersey","Warren County",5,44,1310,674,636
050,34,041,"New Jersey","Warren County",5,45,1343,665,678
050,34,041,"New Jersey","Warren County",5,46,1315,687,628
050,34,041,"New Jersey","Warren County",5,47,1305,670,635
050,34,041,"New Jersey","Warren County",5,48,1333,654,679
050,34,041,"New Jersey","Warren County",5,49,1322,663,659
050,34,041,"New Jersey","Warren County",5,50,1353,668,685
050,34,041,"New Jersey","Warren County",5,51,1515,758,757
050,34,041,"New Jersey","Warren County",5,52,1627,800,827
050,34,041,"New Jersey","Warren County",5,53,1630,808,822
050,34,041,"New Jersey","Warren County",5,54,1646,821,825
050,34,041,"New Jersey","Warren County",5,55,1656,843,813
050,34,041,"New Jersey","Warren County",5,56,1659,825,834
050,34,041,"New Jersey","Warren County",5,57,1757,873,884
050,34,041,"New Jersey","Warren County",5,58,1778,906,872
050,34,041,"New Jersey","Warren County",5,59,1797,899,898
050,34,041,"New Jersey","Warren County",5,60,1862,913,949
050,34,041,"New Jersey","Warren County",5,61,1849,915,934
050,34,041,"New Jersey","Warren County",5,62,1810,901,909
050,34,041,"New Jersey","Warren County",5,63,1725,854,871
050,34,041,"New Jersey","Warren County",5,64,1747,866,881
050,34,041,"New Jersey","Warren County",5,65,1694,838,856
050,34,041,"New Jersey","Warren County",5,66,1642,795,847
050,34,041,"New Jersey","Warren County",5,67,1482,711,771
050,34,041,"New Jersey","Warren County",5,68,1385,656,729
050,34,041,"New Jersey","Warren County",5,69,1319,646,673
050,34,041,"New Jersey","Warren County",5,70,1285,630,655
050,34,041,"New Jersey","Warren County",5,71,1179,545,634
050,34,041,"New Jersey","Warren County",5,72,1164,551,613
050,34,041,"New Jersey","Warren County",5,73,1096,548,548
050,34,041,"New Jersey","Warren County",5,74,1049,510,539
050,34,041,"New Jersey","Warren County",5,75,999,476,523
050,34,041,"New Jersey","Warren County",5,76,1080,480,600
050,34,041,"New Jersey","Warren County",5,77,686,290,396
050,34,041,"New Jersey","Warren County",5,78,681,315,366
050,34,041,"New Jersey","Warren County",5,79,692,298,394
050,34,041,"New Jersey","Warren County",5,80,742,319,423
050,34,041,"New Jersey","Warren County",5,81,574,243,331
050,34,041,"New Jersey","Warren County",5,82,518,226,292
050,34,041,"New Jersey","Warren County",5,83,448,186,262
050,34,041,"New Jersey","Warren County",5,84,385,179,206
050,34,041,"New Jersey","Warren County",5,85,2436,842,1594

